88,27,704,3,142,"_dl_boot_bind@90-232@lib/csu/boot.h","lib/csu/boot.h","_dl_boot_bind",90,232
23,6,150,2,23,"_reloc_alpha_got@239-262@lib/csu/boot.h","lib/csu/boot.h","_reloc_alpha_got",239,262
10,3,60,1,17,"___start@71-88@lib/csu/crt0.c","lib/csu/crt0.c","___start",71,88
3,1,14,2,2,"__register_frame_info@55-57@lib/csu/crtbegin.c","lib/csu/crtbegin.c","__register_frame_info",55,57
13,4,72,1,13,"__ctors@89-102@lib/csu/crtbegin.c","lib/csu/crtbegin.c","__ctors",89,102
6,2,28,1,6,"__dtors@105-111@lib/csu/crtbegin.c","lib/csu/crtbegin.c","__dtors",105,111
13,4,57,1,19,"__do_init@127-146@lib/csu/crtbegin.c","lib/csu/crtbegin.c","__do_init",127,146
8,2,25,1,11,"__do_fini@149-160@lib/csu/crtbegin.c","lib/csu/crtbegin.c","__do_fini",149,160
4,1,36,1,3,"atexit@75-78@lib/csu/crtbeginS.c","lib/csu/crtbeginS.c","atexit",75,78
4,1,46,3,3,"pthread_atfork@88-91@lib/csu/crtbeginS.c","lib/csu/crtbeginS.c","pthread_atfork",88,91
13,4,72,1,13,"__ctors@100-113@lib/csu/crtbeginS.c","lib/csu/crtbeginS.c","__ctors",100,113
6,2,28,1,6,"__dtors@116-122@lib/csu/crtbeginS.c","lib/csu/crtbeginS.c","__dtors",116,122
10,4,39,1,15,"_do_init@138-153@lib/csu/crtbeginS.c","lib/csu/crtbeginS.c","_do_init",138,153
10,3,36,1,16,"_do_fini@156-172@lib/csu/crtbeginS.c","lib/csu/crtbeginS.c","_do_fini",156,172
11,4,56,1,11,"bwx_open_mem@58-69@lib/libarch/alpha/bwx.c","lib/libarch/alpha/bwx.c","bwx_open_mem",58,69
7,2,25,1,7,"bwx_close_mem@72-79@lib/libarch/alpha/bwx.c","lib/libarch/alpha/bwx.c","bwx_close_mem",72,79
14,3,115,1,14,"bwx_init@82-96@lib/libarch/alpha/bwx.c","lib/libarch/alpha/bwx.c","bwx_init",82,96
27,7,187,3,30,"bwx_ioperm@99-129@lib/libarch/alpha/bwx.c","lib/libarch/alpha/bwx.c","bwx_ioperm",99,129
5,1,19,1,4,"bwx_inb@132-136@lib/libarch/alpha/bwx.c","lib/libarch/alpha/bwx.c","bwx_inb",132,136
5,1,19,1,4,"bwx_inw@139-143@lib/libarch/alpha/bwx.c","lib/libarch/alpha/bwx.c","bwx_inw",139,143
5,1,19,1,4,"bwx_inl@146-150@lib/libarch/alpha/bwx.c","lib/libarch/alpha/bwx.c","bwx_inl",146,150
6,1,27,2,5,"bwx_outb@153-158@lib/libarch/alpha/bwx.c","lib/libarch/alpha/bwx.c","bwx_outb",153,158
6,1,27,2,5,"bwx_outw@161-166@lib/libarch/alpha/bwx.c","lib/libarch/alpha/bwx.c","bwx_outw",161,166
6,1,27,2,5,"bwx_outl@169-174@lib/libarch/alpha/bwx.c","lib/libarch/alpha/bwx.c","bwx_outl",169,174
34,5,225,2,34,"bwx_map_memory@183-217@lib/libarch/alpha/bwx.c","lib/libarch/alpha/bwx.c","bwx_map_memory",183,217
9,1,61,2,9,"bwx_unmap_memory@220-229@lib/libarch/alpha/bwx.c","lib/libarch/alpha/bwx.c","bwx_unmap_memory",220,229
5,1,28,2,5,"bwx_readb@232-237@lib/libarch/alpha/bwx.c","lib/libarch/alpha/bwx.c","bwx_readb",232,237
5,1,28,2,5,"bwx_readw@240-245@lib/libarch/alpha/bwx.c","lib/libarch/alpha/bwx.c","bwx_readw",240,245
5,1,28,2,5,"bwx_readl@248-253@lib/libarch/alpha/bwx.c","lib/libarch/alpha/bwx.c","bwx_readl",248,253
5,1,32,3,5,"bwx_writeb@256-261@lib/libarch/alpha/bwx.c","lib/libarch/alpha/bwx.c","bwx_writeb",256,261
5,1,32,3,5,"bwx_writew@264-269@lib/libarch/alpha/bwx.c","lib/libarch/alpha/bwx.c","bwx_writew",264,269
5,1,32,3,5,"bwx_writel@272-277@lib/libarch/alpha/bwx.c","lib/libarch/alpha/bwx.c","bwx_writel",272,277
18,4,118,3,22,"ioperm@39-61@lib/libarch/alpha/io.c","lib/libarch/alpha/io.c","ioperm",39,61
4,1,15,1,3,"inb@64-67@lib/libarch/alpha/io.c","lib/libarch/alpha/io.c","inb",64,67
4,1,15,1,3,"inw@70-73@lib/libarch/alpha/io.c","lib/libarch/alpha/io.c","inw",70,73
4,1,15,1,3,"inl@76-79@lib/libarch/alpha/io.c","lib/libarch/alpha/io.c","inl",76,79
4,1,19,2,3,"outb@82-85@lib/libarch/alpha/io.c","lib/libarch/alpha/io.c","outb",82,85
4,1,19,2,3,"outw@88-91@lib/libarch/alpha/io.c","lib/libarch/alpha/io.c","outw",88,91
4,1,19,2,3,"outl@94-97@lib/libarch/alpha/io.c","lib/libarch/alpha/io.c","outl",94,97
4,1,20,2,3,"map_memory@100-103@lib/libarch/alpha/io.c","lib/libarch/alpha/io.c","map_memory",100,103
4,1,20,2,3,"unmap_memory@106-109@lib/libarch/alpha/io.c","lib/libarch/alpha/io.c","unmap_memory",106,109
4,1,21,2,3,"readb@112-115@lib/libarch/alpha/io.c","lib/libarch/alpha/io.c","readb",112,115
4,1,21,2,3,"readw@118-121@lib/libarch/alpha/io.c","lib/libarch/alpha/io.c","readw",118,121
4,1,21,2,3,"readl@124-127@lib/libarch/alpha/io.c","lib/libarch/alpha/io.c","readl",124,127
5,1,31,3,4,"writeb@130-134@lib/libarch/alpha/io.c","lib/libarch/alpha/io.c","writeb",130,134
5,1,31,3,4,"writew@137-141@lib/libarch/alpha/io.c","lib/libarch/alpha/io.c","writew",137,141
5,1,31,3,4,"writel@144-148@lib/libarch/alpha/io.c","lib/libarch/alpha/io.c","writel",144,148
4,1,25,3,3,"writeb_nb@151-154@lib/libarch/alpha/io.c","lib/libarch/alpha/io.c","writeb_nb",151,154
4,1,25,3,3,"writew_nb@157-160@lib/libarch/alpha/io.c","lib/libarch/alpha/io.c","writew_nb",157,160
4,1,25,3,3,"writel_nb@163-166@lib/libarch/alpha/io.c","lib/libarch/alpha/io.c","writel_nb",163,166
15,3,93,1,18,"dense_base@169-187@lib/libarch/alpha/io.c","lib/libarch/alpha/io.c","dense_base",169,187
4,1,16,1,3,"amd64_get_fsbase@39-42@lib/libarch/amd64/amd64_get_fsbase.c","lib/libarch/amd64/amd64_get_fsbase.c","amd64_get_fsbase",39,42
6,1,26,1,7,"amd64_iopl@39-46@lib/libarch/amd64/amd64_iopl.c","lib/libarch/amd64/amd64_iopl.c","amd64_iopl",39,46
4,1,17,1,3,"amd64_set_fsbase@39-42@lib/libarch/amd64/amd64_set_fsbase.c","lib/libarch/amd64/amd64_set_fsbase.c","amd64_set_fsbase",39,42
4,1,13,0,3,"arm_drain_writebuf@41-44@lib/libarch/arm/arm_drain_writebuf.c","lib/libarch/arm/arm_drain_writebuf.c","arm_drain_writebuf",41,44
9,1,39,2,10,"arm_sync_icache@41-51@lib/libarch/arm/arm_sync_icache.c","lib/libarch/arm/arm_sync_icache.c","arm_sync_icache",41,51
4,1,16,1,3,"i386_get_fsbase@39-42@lib/libarch/i386/i386_get_fsbase.c","lib/libarch/i386/i386_get_fsbase.c","i386_get_fsbase",39,42
4,1,16,1,3,"i386_get_gsbase@39-42@lib/libarch/i386/i386_get_gsbase.c","lib/libarch/i386/i386_get_gsbase.c","i386_get_gsbase",39,42
6,1,26,1,7,"i386_iopl@39-46@lib/libarch/i386/i386_iopl.c","lib/libarch/i386/i386_iopl.c","i386_iopl",39,46
4,1,17,1,3,"i386_set_fsbase@39-42@lib/libarch/i386/i386_set_fsbase.c","lib/libarch/i386/i386_set_fsbase.c","i386_set_fsbase",39,42
4,1,17,1,3,"i386_set_gsbase@39-42@lib/libarch/i386/i386_set_gsbase.c","lib/libarch/i386/i386_set_gsbase.c","i386_set_gsbase",39,42
4,1,17,1,4,"i386_vm86@40-44@lib/libarch/i386/i386_vm86.c","lib/libarch/i386/i386_vm86.c","i386_vm86",40,44
6,1,34,2,6,"strtold@39-45@lib/libc/arch/aarch64/gdtoa/strtold.c","lib/libc/arch/aarch64/gdtoa/strtold.c","strtold",39,45
13,1,55,1,14,"_atomic_lock@35-49@lib/libc/arch/aarch64/gen/_atomic_lock.c","lib/libc/arch/aarch64/gen/_atomic_lock.c","_atomic_lock",35,49
6,1,31,1,7,"fabs@26-33@lib/libc/arch/aarch64/gen/fabs.c","lib/libc/arch/aarch64/gen/fabs.c","fabs",26,33
4,1,15,0,3,"__flt_rounds@73-76@lib/libc/arch/aarch64/gen/flt_rounds.c","lib/libc/arch/aarch64/gen/flt_rounds.c","__flt_rounds",73,76
19,11,110,1,21,"__fpclassifyl@23-44@lib/libc/arch/aarch64/gen/fpclassifyl.c","lib/libc/arch/aarch64/gen/fpclassifyl.c","__fpclassifyl",23,44
6,1,32,1,7,"fpgetmask@41-48@lib/libc/arch/aarch64/gen/fpgetmask.c","lib/libc/arch/aarch64/gen/fpgetmask.c","fpgetmask",41,48
6,1,32,1,7,"fpgetround@35-42@lib/libc/arch/aarch64/gen/fpgetround.c","lib/libc/arch/aarch64/gen/fpgetround.c","fpgetround",35,42
6,1,27,1,7,"fpgetsticky@41-48@lib/libc/arch/aarch64/gen/fpgetsticky.c","lib/libc/arch/aarch64/gen/fpgetsticky.c","fpgetsticky",41,48
9,1,73,1,10,"fpsetmask@41-51@lib/libc/arch/aarch64/gen/fpsetmask.c","lib/libc/arch/aarch64/gen/fpsetmask.c","fpsetmask",41,51
9,1,65,1,10,"fpsetround@35-45@lib/libc/arch/aarch64/gen/fpsetround.c","lib/libc/arch/aarch64/gen/fpsetround.c","fpsetround",35,45
9,1,54,1,10,"fpsetsticky@41-51@lib/libc/arch/aarch64/gen/fpsetsticky.c","lib/libc/arch/aarch64/gen/fpsetsticky.c","fpsetsticky",41,51
5,1,30,1,5,"__isfinitel@23-28@lib/libc/arch/aarch64/gen/isfinitel.c","lib/libc/arch/aarch64/gen/isfinitel.c","__isfinitel",23,28
7,5,54,1,7,"__isinfl@23-30@lib/libc/arch/aarch64/gen/isinfl.c","lib/libc/arch/aarch64/gen/isinfl.c","__isinfl",23,30
7,5,56,1,7,"__isnanl@23-30@lib/libc/arch/aarch64/gen/isnanl.c","lib/libc/arch/aarch64/gen/isnanl.c","__isnanl",23,30
5,2,36,1,5,"__isnormall@23-28@lib/libc/arch/aarch64/gen/isnormall.c","lib/libc/arch/aarch64/gen/isnormall.c","__isnormall",23,28
5,1,26,1,5,"__signbitl@23-28@lib/libc/arch/aarch64/gen/signbitl.c","lib/libc/arch/aarch64/gen/signbitl.c","__signbitl",23,28
10,1,54,0,11,"__flt_rounds@46-57@lib/libc/arch/alpha/gen/flt_rounds.c","lib/libc/arch/alpha/gen/flt_rounds.c","__flt_rounds",46,57
4,1,14,1,3,"fpgetmask@40-43@lib/libc/arch/alpha/gen/fpgetmask.c","lib/libc/arch/alpha/gen/fpgetmask.c","fpgetmask",40,43
10,1,54,1,11,"fpgetround@39-50@lib/libc/arch/alpha/gen/fpgetround.c","lib/libc/arch/alpha/gen/fpgetround.c","fpgetround",39,50
4,1,14,1,3,"fpgetsticky@42-45@lib/libc/arch/alpha/gen/fpgetsticky.c","lib/libc/arch/alpha/gen/fpgetsticky.c","fpgetsticky",42,45
7,1,28,1,7,"fpsetmask@40-47@lib/libc/arch/alpha/gen/fpsetmask.c","lib/libc/arch/alpha/gen/fpsetmask.c","fpsetmask",40,47
17,1,109,1,20,"fpsetround@39-59@lib/libc/arch/alpha/gen/fpsetround.c","lib/libc/arch/alpha/gen/fpsetround.c","fpsetround",39,59
7,1,28,1,7,"fpsetsticky@40-47@lib/libc/arch/alpha/gen/fpsetsticky.c","lib/libc/arch/alpha/gen/fpsetsticky.c","fpsetsticky",40,47
6,1,34,2,6,"strtold@39-45@lib/libc/arch/amd64/gdtoa/strtold.c","lib/libc/arch/amd64/gdtoa/strtold.c","strtold",39,45
9,1,43,1,14,"_atomic_lock@12-26@lib/libc/arch/amd64/gen/_atomic_lock.c","lib/libc/arch/amd64/gen/_atomic_lock.c","_atomic_lock",12,26
18,7,92,1,21,"__fpclassifyl@23-44@lib/libc/arch/amd64/gen/fpclassifyl.c","lib/libc/arch/amd64/gen/fpclassifyl.c","__fpclassifyl",23,44
5,1,30,1,5,"__isfinitel@23-28@lib/libc/arch/amd64/gen/isfinitel.c","lib/libc/arch/amd64/gen/isfinitel.c","__isfinitel",23,28
7,3,48,1,8,"__isinfl@23-31@lib/libc/arch/amd64/gen/isinfl.c","lib/libc/arch/amd64/gen/isinfl.c","__isinfl",23,31
7,3,50,1,8,"__isnanl@23-31@lib/libc/arch/amd64/gen/isnanl.c","lib/libc/arch/amd64/gen/isnanl.c","__isnanl",23,31
5,2,36,1,5,"__isnormall@23-28@lib/libc/arch/amd64/gen/isnormall.c","lib/libc/arch/amd64/gen/isnormall.c","__isnormall",23,28
8,1,41,2,7,"ldexp@42-49@lib/libc/arch/amd64/gen/ldexp.c","lib/libc/arch/amd64/gen/ldexp.c","ldexp",42,49
5,1,26,1,5,"__signbitl@23-28@lib/libc/arch/amd64/gen/signbitl.c","lib/libc/arch/amd64/gen/signbitl.c","__signbitl",23,28
25,7,173,3,27,"find_exidx@35-62@lib/libc/arch/arm/dlfcn/exidx.c","lib/libc/arch/arm/dlfcn/exidx.c","find_exidx",35,62
9,2,50,2,9,"dl_unwind_find_exidx@65-74@lib/libc/arch/arm/dlfcn/exidx.c","lib/libc/arch/arm/dlfcn/exidx.c","dl_unwind_find_exidx",65,74
13,1,55,1,14,"_atomic_lock@35-49@lib/libc/arch/arm/gen/_atomic_lock.c","lib/libc/arch/arm/gen/_atomic_lock.c","_atomic_lock",35,49
6,1,31,1,7,"fabs@26-33@lib/libc/arch/arm/gen/fabs.c","lib/libc/arch/arm/gen/fabs.c","fabs",26,33
4,1,15,0,3,"__flt_rounds@73-76@lib/libc/arch/arm/gen/flt_rounds.c","lib/libc/arch/arm/gen/flt_rounds.c","__flt_rounds",73,76
12,3,62,1,16,"_atomic_lock@25-41@lib/libc/arch/hppa/gen/_atomic_lock.c","lib/libc/arch/hppa/gen/_atomic_lock.c","_atomic_lock",25,41
5,1,23,1,5,"fabs@11-16@lib/libc/arch/hppa/gen/fabs.c","lib/libc/arch/hppa/gen/fabs.c","fabs",11,16
6,1,38,0,6,"__flt_rounds@18-24@lib/libc/arch/hppa/gen/flt_rounds.c","lib/libc/arch/hppa/gen/flt_rounds.c","__flt_rounds",18,24
6,1,37,0,6,"fpgetmask@11-17@lib/libc/arch/hppa/gen/fpgetmask.c","lib/libc/arch/hppa/gen/fpgetmask.c","fpgetmask",11,17
6,1,38,1,6,"fpgetround@11-17@lib/libc/arch/hppa/gen/fpgetround.c","lib/libc/arch/hppa/gen/fpgetround.c","fpgetround",11,17
6,1,37,0,6,"fpgetsticky@11-17@lib/libc/arch/hppa/gen/fpgetsticky.c","lib/libc/arch/hppa/gen/fpgetsticky.c","fpgetsticky",11,17
11,1,83,1,11,"fpsetmask@11-22@lib/libc/arch/hppa/gen/fpsetmask.c","lib/libc/arch/hppa/gen/fpsetmask.c","fpsetmask",11,22
12,1,83,1,12,"fpsetround@11-23@lib/libc/arch/hppa/gen/fpsetround.c","lib/libc/arch/hppa/gen/fpsetround.c","fpsetround",11,23
11,1,83,1,11,"fpsetsticky@11-22@lib/libc/arch/hppa/gen/fpsetsticky.c","lib/libc/arch/hppa/gen/fpsetsticky.c","fpsetsticky",11,22
9,1,43,1,14,"_atomic_lock@11-25@lib/libc/arch/i386/gen/_atomic_lock.c","lib/libc/arch/i386/gen/_atomic_lock.c","_atomic_lock",11,25
8,1,41,2,7,"ldexp@41-48@lib/libc/arch/i386/gen/ldexp.c","lib/libc/arch/i386/gen/ldexp.c","ldexp",41,48
8,1,44,1,9,"_atomic_lock@35-44@lib/libc/arch/m88k/gen/_atomic_lock.c","lib/libc/arch/m88k/gen/_atomic_lock.c","_atomic_lock",35,44
6,1,31,0,6,"__flt_rounds@23-29@lib/libc/arch/m88k/gen/flt_rounds.c","lib/libc/arch/m88k/gen/flt_rounds.c","__flt_rounds",23,29
6,1,26,0,6,"fpgetmask@12-18@lib/libc/arch/m88k/gen/fpgetmask.c","lib/libc/arch/m88k/gen/fpgetmask.c","fpgetmask",12,18
6,1,30,1,6,"fpgetround@12-18@lib/libc/arch/m88k/gen/fpgetround.c","lib/libc/arch/m88k/gen/fpgetround.c","fpgetround",12,18
6,1,24,0,6,"fpgetsticky@12-18@lib/libc/arch/m88k/gen/fpgetsticky.c","lib/libc/arch/m88k/gen/fpgetsticky.c","fpgetsticky",12,18
12,1,61,1,15,"fpsetmask@12-27@lib/libc/arch/m88k/gen/fpsetmask.c","lib/libc/arch/m88k/gen/fpsetmask.c","fpsetmask",12,27
12,1,74,1,15,"fpsetround@12-27@lib/libc/arch/m88k/gen/fpsetround.c","lib/libc/arch/m88k/gen/fpsetround.c","fpsetround",12,27
12,1,63,1,15,"fpsetsticky@12-27@lib/libc/arch/m88k/gen/fpsetsticky.c","lib/libc/arch/m88k/gen/fpsetsticky.c","fpsetsticky",12,27
6,1,34,2,6,"strtold@39-45@lib/libc/arch/mips64/gdtoa/strtold.c","lib/libc/arch/mips64/gdtoa/strtold.c","strtold",39,45
15,1,52,1,16,"_atomic_lock@11-27@lib/libc/arch/mips64/gen/_atomic_lock.c","lib/libc/arch/mips64/gen/_atomic_lock.c","_atomic_lock",11,27
8,1,55,3,8,"cacheflush@27-35@lib/libc/arch/mips64/gen/cacheflush.c","lib/libc/arch/mips64/gen/cacheflush.c","cacheflush",27,35
7,1,31,0,7,"__flt_rounds@18-25@lib/libc/arch/mips64/gen/flt_rounds.c","lib/libc/arch/mips64/gen/flt_rounds.c","__flt_rounds",18,25
6,1,21,0,6,"get_fpc_csr@27-33@lib/libc/arch/mips64/gen/fpc_csr.c","lib/libc/arch/mips64/gen/fpc_csr.c","get_fpc_csr",27,33
7,1,33,1,8,"set_fpc_csr@36-44@lib/libc/arch/mips64/gen/fpc_csr.c","lib/libc/arch/mips64/gen/fpc_csr.c","set_fpc_csr",36,44
19,11,110,1,21,"__fpclassifyl@23-44@lib/libc/arch/mips64/gen/fpclassifyl.c","lib/libc/arch/mips64/gen/fpclassifyl.c","__fpclassifyl",23,44
6,1,28,0,6,"fpgetmask@10-16@lib/libc/arch/mips64/gen/fpgetmask.c","lib/libc/arch/mips64/gen/fpgetmask.c","fpgetmask",10,16
6,1,24,1,6,"fpgetround@10-16@lib/libc/arch/mips64/gen/fpgetround.c","lib/libc/arch/mips64/gen/fpgetround.c","fpgetround",10,16
6,1,28,0,6,"fpgetsticky@10-16@lib/libc/arch/mips64/gen/fpgetsticky.c","lib/libc/arch/mips64/gen/fpgetsticky.c","fpgetsticky",10,16
12,1,72,1,15,"fpsetmask@10-25@lib/libc/arch/mips64/gen/fpsetmask.c","lib/libc/arch/mips64/gen/fpsetmask.c","fpsetmask",10,25
12,1,57,1,15,"fpsetround@10-25@lib/libc/arch/mips64/gen/fpsetround.c","lib/libc/arch/mips64/gen/fpsetround.c","fpsetround",10,25
12,1,72,1,15,"fpsetsticky@10-25@lib/libc/arch/mips64/gen/fpsetsticky.c","lib/libc/arch/mips64/gen/fpsetsticky.c","fpsetsticky",10,25
7,5,54,1,7,"__isinfl@23-30@lib/libc/arch/mips64/gen/isinfl.c","lib/libc/arch/mips64/gen/isinfl.c","__isinfl",23,30
7,5,56,1,7,"__isnanl@23-30@lib/libc/arch/mips64/gen/isnanl.c","lib/libc/arch/mips64/gen/isnanl.c","__isnanl",23,30
5,2,36,1,5,"__isnormall@23-28@lib/libc/arch/mips64/gen/isnormall.c","lib/libc/arch/mips64/gen/isnormall.c","__isnormall",23,28
5,1,26,1,5,"__signbitl@23-28@lib/libc/arch/mips64/gen/signbitl.c","lib/libc/arch/mips64/gen/signbitl.c","__signbitl",23,28
12,1,49,1,28,"_atomic_lock@25-53@lib/libc/arch/powerpc/gen/_atomic_lock.c","lib/libc/arch/powerpc/gen/_atomic_lock.c","_atomic_lock",25,53
5,1,28,1,4,"fabs@31-35@lib/libc/arch/powerpc/gen/fabs.c","lib/libc/arch/powerpc/gen/fabs.c","fabs",31,35
8,2,45,1,11,"__flt_rounds@48-59@lib/libc/arch/powerpc/gen/flt_rounds.c","lib/libc/arch/powerpc/gen/flt_rounds.c","__flt_rounds",48,59
6,1,31,0,6,"fpgetmask@37-43@lib/libc/arch/powerpc/gen/fpgetmask.c","lib/libc/arch/powerpc/gen/fpgetmask.c","fpgetmask",37,43
6,1,27,1,6,"fpgetround@37-43@lib/libc/arch/powerpc/gen/fpgetround.c","lib/libc/arch/powerpc/gen/fpgetround.c","fpgetround",37,43
6,1,31,0,6,"fpgetsticky@37-43@lib/libc/arch/powerpc/gen/fpgetsticky.c","lib/libc/arch/powerpc/gen/fpgetsticky.c","fpgetsticky",37,43
11,1,68,1,11,"fpsetmask@37-48@lib/libc/arch/powerpc/gen/fpsetmask.c","lib/libc/arch/powerpc/gen/fpsetmask.c","fpsetmask",37,48
11,1,58,1,11,"fpsetround@37-48@lib/libc/arch/powerpc/gen/fpsetround.c","lib/libc/arch/powerpc/gen/fpsetround.c","fpsetround",37,48
15,2,87,1,15,"fpsetsticky@37-52@lib/libc/arch/powerpc/gen/fpsetsticky.c","lib/libc/arch/powerpc/gen/fpsetsticky.c","fpsetsticky",37,52
10,1,38,1,11,"_atomic_lock@35-46@lib/libc/arch/sh/gen/_atomic_lock.c","lib/libc/arch/sh/gen/_atomic_lock.c","_atomic_lock",35,46
7,2,42,1,10,"fabs@27-37@lib/libc/arch/sh/gen/fabs.c","lib/libc/arch/sh/gen/fabs.c","fabs",27,37
7,2,35,0,10,"__flt_rounds@31-41@lib/libc/arch/sh/gen/flt_rounds.c","lib/libc/arch/sh/gen/flt_rounds.c","__flt_rounds",31,41
6,1,31,0,6,"fpgetmask@23-29@lib/libc/arch/sh/gen/fpgetmask.c","lib/libc/arch/sh/gen/fpgetmask.c","fpgetmask",23,29
6,1,27,1,6,"fpgetround@23-29@lib/libc/arch/sh/gen/fpgetround.c","lib/libc/arch/sh/gen/fpgetround.c","fpgetround",23,29
6,1,31,0,6,"fpgetsticky@23-29@lib/libc/arch/sh/gen/fpgetsticky.c","lib/libc/arch/sh/gen/fpgetsticky.c","fpgetsticky",23,29
11,2,126,1,13,"fpsetmask@23-36@lib/libc/arch/sh/gen/fpsetmask.c","lib/libc/arch/sh/gen/fpsetmask.c","fpsetmask",23,36
13,5,103,1,19,"fpsetround@23-42@lib/libc/arch/sh/gen/fpsetround.c","lib/libc/arch/sh/gen/fpsetround.c","fpsetround",23,42
11,2,126,1,13,"fpsetsticky@23-36@lib/libc/arch/sh/gen/fpsetsticky.c","lib/libc/arch/sh/gen/fpsetsticky.c","fpsetsticky",23,36
10,2,65,1,13,"htonl@45-58@lib/libc/arch/sh/net/htonl.c","lib/libc/arch/sh/net/htonl.c","htonl",45,58
6,2,27,1,7,"htons@45-52@lib/libc/arch/sh/net/htons.c","lib/libc/arch/sh/net/htons.c","htons",45,52
10,2,65,1,13,"ntohl@45-58@lib/libc/arch/sh/net/ntohl.c","lib/libc/arch/sh/net/ntohl.c","ntohl",45,58
6,2,27,1,7,"ntohs@45-52@lib/libc/arch/sh/net/ntohs.c","lib/libc/arch/sh/net/ntohs.c","ntohs",45,52
78,18,636,1,150,"__fpu_add@69-219@lib/libc/arch/sparc64/fpu/fpu_add.c","lib/libc/arch/sparc64/fpu/fpu_add.c","__fpu_add",69,219
49,13,252,3,84,"__fpu_compare@99-183@lib/libc/arch/sparc64/fpu/fpu_compare.c","lib/libc/arch/sparc64/fpu/fpu_compare.c","__fpu_compare",99,183
53,10,360,1,113,"__fpu_div@161-274@lib/libc/arch/sparc64/fpu/fpu_div.c","lib/libc/arch/sparc64/fpu/fpu_div.c","__fpu_div",161,274
14,3,89,2,20,"__fpu_itof@92-112@lib/libc/arch/sparc64/fpu/fpu_explode.c","lib/libc/arch/sparc64/fpu/fpu_explode.c","__fpu_itof",92,112
14,2,79,2,20,"__fpu_uitof@118-138@lib/libc/arch/sparc64/fpu/fpu_explode.c","lib/libc/arch/sparc64/fpu/fpu_explode.c","__fpu_uitof",118,138
15,3,109,2,21,"__fpu_xtof@144-165@lib/libc/arch/sparc64/fpu/fpu_explode.c","lib/libc/arch/sparc64/fpu/fpu_explode.c","__fpu_xtof",144,165
14,2,93,2,20,"__fpu_uxtof@171-191@lib/libc/arch/sparc64/fpu/fpu_explode.c","lib/libc/arch/sparc64/fpu/fpu_explode.c","__fpu_uxtof",171,191
12,1,90,2,13,"__fpu_stof@233-246@lib/libc/arch/sparc64/fpu/fpu_explode.c","lib/libc/arch/sparc64/fpu/fpu_explode.c","__fpu_stof",233,246
14,1,122,3,15,"__fpu_dtof@253-268@lib/libc/arch/sparc64/fpu/fpu_explode.c","lib/libc/arch/sparc64/fpu/fpu_explode.c","__fpu_dtof",253,268
15,1,167,5,19,"__fpu_qtof@274-293@lib/libc/arch/sparc64/fpu/fpu_explode.c","lib/libc/arch/sparc64/fpu/fpu_explode.c","__fpu_qtof",274,293
50,17,365,4,62,"__fpu_explode@303-365@lib/libc/arch/sparc64/fpu/fpu_explode.c","lib/libc/arch/sparc64/fpu/fpu_explode.c","__fpu_explode",303,365
52,12,367,2,72,"fpround@86-158@lib/libc/arch/sparc64/fpu/fpu_implode.c","lib/libc/arch/sparc64/fpu/fpu_implode.c","fpround",86,158
20,5,71,2,24,"toinf@166-190@lib/libc/arch/sparc64/fpu/fpu_implode.c","lib/libc/arch/sparc64/fpu/fpu_implode.c","toinf",166,190
25,7,145,2,40,"__fpu_ftoi@199-239@lib/libc/arch/sparc64/fpu/fpu_implode.c","lib/libc/arch/sparc64/fpu/fpu_implode.c","__fpu_ftoi",199,239
30,7,190,3,45,"__fpu_ftox@248-293@lib/libc/arch/sparc64/fpu/fpu_implode.c","lib/libc/arch/sparc64/fpu/fpu_implode.c","__fpu_ftox",248,293
38,15,339,2,75,"__fpu_ftos@300-375@lib/libc/arch/sparc64/fpu/fpu_implode.c","lib/libc/arch/sparc64/fpu/fpu_implode.c","__fpu_ftos",300,375
48,13,359,3,52,"__fpu_ftod@384-436@lib/libc/arch/sparc64/fpu/fpu_implode.c","lib/libc/arch/sparc64/fpu/fpu_implode.c","__fpu_ftod",384,436
49,13,403,3,54,"__fpu_ftoq@445-499@lib/libc/arch/sparc64/fpu/fpu_implode.c","lib/libc/arch/sparc64/fpu/fpu_implode.c","__fpu_ftoq",445,499
28,7,162,4,37,"__fpu_implode@505-542@lib/libc/arch/sparc64/fpu/fpu_implode.c","lib/libc/arch/sparc64/fpu/fpu_implode.c","__fpu_implode",505,542
69,13,414,1,123,"__fpu_mul@109-232@lib/libc/arch/sparc64/fpu/fpu_mul.c","lib/libc/arch/sparc64/fpu/fpu_mul.c","__fpu_mul",109,232
6,1,33,2,6,"_Q_mul@33-39@lib/libc/arch/sparc64/fpu/fpu_q.c","lib/libc/arch/sparc64/fpu/fpu_q.c","_Q_mul",33,39
6,1,33,2,6,"_Q_div@42-48@lib/libc/arch/sparc64/fpu/fpu_q.c","lib/libc/arch/sparc64/fpu/fpu_q.c","_Q_div",42,48
6,1,33,2,6,"_Q_sub@51-57@lib/libc/arch/sparc64/fpu/fpu_q.c","lib/libc/arch/sparc64/fpu/fpu_q.c","_Q_sub",51,57
6,1,33,2,6,"_Q_add@60-66@lib/libc/arch/sparc64/fpu/fpu_q.c","lib/libc/arch/sparc64/fpu/fpu_q.c","_Q_add",60,66
6,1,33,1,6,"_Q_neg@69-75@lib/libc/arch/sparc64/fpu/fpu_q.c","lib/libc/arch/sparc64/fpu/fpu_q.c","_Q_neg",69,75
6,1,26,1,6,"_Q_sqrt@78-84@lib/libc/arch/sparc64/fpu/fpu_q.c","lib/libc/arch/sparc64/fpu/fpu_q.c","_Q_sqrt",78,84
6,1,24,1,6,"_Q_dtoq@87-93@lib/libc/arch/sparc64/fpu/fpu_q.c","lib/libc/arch/sparc64/fpu/fpu_q.c","_Q_dtoq",87,93
6,1,24,1,6,"_Q_stoq@96-102@lib/libc/arch/sparc64/fpu/fpu_q.c","lib/libc/arch/sparc64/fpu/fpu_q.c","_Q_stoq",96,102
6,1,24,1,6,"_Q_itoq@105-111@lib/libc/arch/sparc64/fpu/fpu_q.c","lib/libc/arch/sparc64/fpu/fpu_q.c","_Q_itoq",105,111
6,1,25,1,6,"_Q_utoq@114-120@lib/libc/arch/sparc64/fpu/fpu_q.c","lib/libc/arch/sparc64/fpu/fpu_q.c","_Q_utoq",114,120
6,1,24,1,6,"_Q_qtod@123-129@lib/libc/arch/sparc64/fpu/fpu_q.c","lib/libc/arch/sparc64/fpu/fpu_q.c","_Q_qtod",123,129
6,1,24,1,6,"_Q_qtoi@132-138@lib/libc/arch/sparc64/fpu/fpu_q.c","lib/libc/arch/sparc64/fpu/fpu_q.c","_Q_qtoi",132,138
6,1,24,1,6,"_Q_qtos@141-147@lib/libc/arch/sparc64/fpu/fpu_q.c","lib/libc/arch/sparc64/fpu/fpu_q.c","_Q_qtos",141,147
6,1,25,1,6,"_Q_qtou@150-156@lib/libc/arch/sparc64/fpu/fpu_q.c","lib/libc/arch/sparc64/fpu/fpu_q.c","_Q_qtou",150,156
4,1,24,2,3,"_Q_feq@159-162@lib/libc/arch/sparc64/fpu/fpu_q.c","lib/libc/arch/sparc64/fpu/fpu_q.c","_Q_feq",159,162
4,1,24,2,3,"_Q_fne@165-168@lib/libc/arch/sparc64/fpu/fpu_q.c","lib/libc/arch/sparc64/fpu/fpu_q.c","_Q_fne",165,168
4,1,24,2,3,"_Q_fge@171-174@lib/libc/arch/sparc64/fpu/fpu_q.c","lib/libc/arch/sparc64/fpu/fpu_q.c","_Q_fge",171,174
4,1,24,2,3,"_Q_fgt@177-180@lib/libc/arch/sparc64/fpu/fpu_q.c","lib/libc/arch/sparc64/fpu/fpu_q.c","_Q_fgt",177,180
4,1,24,2,3,"_Q_flt@183-186@lib/libc/arch/sparc64/fpu/fpu_q.c","lib/libc/arch/sparc64/fpu/fpu_q.c","_Q_flt",183,186
4,1,24,2,3,"_Q_fle@189-192@lib/libc/arch/sparc64/fpu/fpu_q.c","lib/libc/arch/sparc64/fpu/fpu_q.c","_Q_fle",189,192
11,1,114,2,10,"_Qp_sqrt@165-175@lib/libc/arch/sparc64/fpu/fpu_qp.c","lib/libc/arch/sparc64/fpu/fpu_qp.c","_Qp_sqrt",165,175
197,65,1104,2,196,"__fpu_setreg32@32-228@lib/libc/arch/sparc64/fpu/fpu_reg.c","lib/libc/arch/sparc64/fpu/fpu_reg.c","__fpu_setreg32",32,228
101,33,560,2,100,"__fpu_setreg64@231-331@lib/libc/arch/sparc64/fpu/fpu_reg.c","lib/libc/arch/sparc64/fpu/fpu_reg.c","__fpu_setreg64",231,331
199,65,1109,1,199,"__fpu_getreg32@334-533@lib/libc/arch/sparc64/fpu/fpu_reg.c","lib/libc/arch/sparc64/fpu/fpu_reg.c","__fpu_getreg32",334,533
103,33,565,1,103,"__fpu_getreg64@536-639@lib/libc/arch/sparc64/fpu/fpu_reg.c","lib/libc/arch/sparc64/fpu/fpu_reg.c","__fpu_getreg64",536,639
127,19,777,1,207,"__fpu_sqrt@196-403@lib/libc/arch/sparc64/fpu/fpu_sqrt.c","lib/libc/arch/sparc64/fpu/fpu_sqrt.c","__fpu_sqrt",196,403
49,14,409,2,62,"__fpu_shr@73-135@lib/libc/arch/sparc64/fpu/fpu_subr.c","lib/libc/arch/sparc64/fpu/fpu_subr.c","__fpu_shr",73,135
48,9,401,1,61,"__fpu_norm@147-208@lib/libc/arch/sparc64/fpu/fpu_subr.c","lib/libc/arch/sparc64/fpu/fpu_subr.c","__fpu_norm",147,208
11,1,78,1,11,"__fpu_newnan@215-226@lib/libc/arch/sparc64/fpu/fpu_subr.c","lib/libc/arch/sparc64/fpu/fpu_subr.c","__fpu_newnan",215,226
6,1,36,1,30,"_atomic_lock@11-41@lib/libc/arch/sparc64/gen/_atomic_lock.c","lib/libc/arch/sparc64/gen/_atomic_lock.c","_atomic_lock",11,41
6,1,33,0,6,"__flt_rounds@20-26@lib/libc/arch/sparc64/gen/flt_rounds.c","lib/libc/arch/sparc64/gen/flt_rounds.c","__flt_rounds",20,26
6,1,30,0,6,"fpgetmask@11-17@lib/libc/arch/sparc64/gen/fpgetmask.c","lib/libc/arch/sparc64/gen/fpgetmask.c","fpgetmask",11,17
6,1,31,1,6,"fpgetround@11-17@lib/libc/arch/sparc64/gen/fpgetround.c","lib/libc/arch/sparc64/gen/fpgetround.c","fpgetround",11,17
6,1,30,0,6,"fpgetsticky@11-17@lib/libc/arch/sparc64/gen/fpgetsticky.c","lib/libc/arch/sparc64/gen/fpgetsticky.c","fpgetsticky",11,17
12,1,76,1,15,"fpsetmask@11-26@lib/libc/arch/sparc64/gen/fpsetmask.c","lib/libc/arch/sparc64/gen/fpsetmask.c","fpsetmask",11,26
12,1,76,1,15,"fpsetround@11-26@lib/libc/arch/sparc64/gen/fpsetround.c","lib/libc/arch/sparc64/gen/fpsetround.c","fpsetround",11,26
12,1,76,1,15,"fpsetsticky@11-26@lib/libc/arch/sparc64/gen/fpsetsticky.c","lib/libc/arch/sparc64/gen/fpsetsticky.c","fpsetsticky",11,26
5,1,30,1,5,"__isfinitel@23-28@lib/libc/arch/sparc64/gen/isfinitel.c","lib/libc/arch/sparc64/gen/isfinitel.c","__isfinitel",23,28
29,11,161,1,38,"_asr_resolver@65-103@lib/libc/asr/asr.c","lib/libc/asr/asr.c","_asr_resolver",65,103
14,3,71,1,15,"_asr_resolver_done@110-125@lib/libc/asr/asr.c","lib/libc/asr/asr.c","_asr_resolver_done",110,125
4,1,14,1,3,"asr_abort@131-134@lib/libc/asr/asr.c","lib/libc/asr/asr.c","asr_abort",131,134
15,4,110,2,20,"asr_run@142-162@lib/libc/asr/asr.c","lib/libc/asr/asr.c","asr_run",142,162
27,8,193,2,36,"asr_run_sync@169-205@lib/libc/asr/asr.c","lib/libc/asr/asr.c","asr_run_sync",169,205
14,4,98,2,16,"_asr_async_new@214-230@lib/libc/asr/asr.c","lib/libc/asr/asr.c","_asr_async_new",214,230
50,24,346,1,58,"_asr_async_free@236-294@lib/libc/asr/asr.c","lib/libc/asr/asr.c","_asr_async_free",236,294
20,4,103,1,20,"_asr_use_resolver@302-322@lib/libc/asr/asr.c","lib/libc/asr/asr.c","_asr_use_resolver",302,322
5,1,26,1,4,"asr_ctx_ref@325-329@lib/libc/asr/asr.c","lib/libc/asr/asr.c","asr_ctx_ref",325,329
10,4,46,1,10,"_asr_ctx_unref@336-346@lib/libc/asr/asr.c","lib/libc/asr/asr.c","_asr_ctx_unref",336,346
11,4,76,1,12,"asr_ctx_free@349-361@lib/libc/asr/asr.c","lib/libc/asr/asr.c","asr_ctx_free",349,361
32,10,196,1,37,"asr_check_reload@367-404@lib/libc/asr/asr.c","lib/libc/asr/asr.c","asr_check_reload",367,404
26,12,199,4,28,"_asr_make_fqdn@415-443@lib/libc/asr/asr.c","lib/libc/asr/asr.c","_asr_make_fqdn",415,443
8,3,40,1,9,"asr_ndots@449-458@lib/libc/asr/asr.c","lib/libc/asr/asr.c","asr_ndots",449,458
16,2,108,1,19,"asr_ctx_create@464-483@lib/libc/asr/asr.c","lib/libc/asr/asr.c","asr_ctx_create",464,483
4,1,11,1,3,"_asr_no_resolver@486-489@lib/libc/asr/asr.c","lib/libc/asr/asr.c","_asr_no_resolver",486,489
12,4,94,2,16,"asr_ctx_add_searchdomain@495-511@lib/libc/asr/asr.c","lib/libc/asr/asr.c","asr_ctx_add_searchdomain",495,511
12,3,79,3,13,"strsplit@514-527@lib/libc/asr/asr.c","lib/libc/asr/asr.c","strsplit",514,527
68,35,654,3,75,"pass0@533-608@lib/libc/asr/asr.c","lib/libc/asr/asr.c","pass0",533,608
26,10,174,2,33,"asr_ctx_from_string@614-647@lib/libc/asr/asr.c","lib/libc/asr/asr.c","asr_ctx_from_string",614,647
19,4,120,2,21,"asr_ctx_from_file@653-674@lib/libc/asr/asr.c","lib/libc/asr/asr.c","asr_ctx_from_file",653,674
25,5,150,2,27,"asr_ctx_parse@681-708@lib/libc/asr/asr.c","lib/libc/asr/asr.c","asr_ctx_parse",681,708
23,6,159,1,25,"asr_ctx_envopts@716-741@lib/libc/asr/asr.c","lib/libc/asr/asr.c","asr_ctx_envopts",716,741
11,4,93,2,13,"asr_parse_nameserver@747-760@lib/libc/asr/asr.c","lib/libc/asr/asr.c","asr_parse_nameserver",747,760
25,6,172,3,27,"_asr_strdname@768-795@lib/libc/asr/asr.c","lib/libc/asr/asr.c","_asr_strdname",768,795
22,5,139,5,26,"_asr_parse_namedb_line@803-829@lib/libc/asr/asr.c","lib/libc/asr/asr.c","_asr_parse_namedb_line",803,829
10,2,54,1,11,"_asr_iter_db@836-847@lib/libc/asr/asr.c","lib/libc/asr/asr.c","_asr_iter_db",836,847
12,7,54,1,11,"rcodetostr@42-53@lib/libc/asr/asr_debug.c","lib/libc/asr/asr_debug.c","rcodetostr",42,53
4,1,28,3,3,"print_dname@56-59@lib/libc/asr/asr_debug.c","lib/libc/asr/asr_debug.c","print_dname",56,59
64,12,459,3,69,"print_rr@62-131@lib/libc/asr/asr_debug.c","lib/libc/asr/asr_debug.c","print_rr",62,131
8,1,63,3,9,"print_query@134-143@lib/libc/asr/asr_debug.c","lib/libc/asr/asr_debug.c","print_query",134,143
18,8,173,3,18,"print_header@146-164@lib/libc/asr/asr_debug.c","lib/libc/asr/asr_debug.c","print_header",146,164
45,13,350,3,54,"_asr_dump_packet@167-221@lib/libc/asr/asr_debug.c","lib/libc/asr/asr_debug.c","_asr_dump_packet",167,221
26,3,163,3,28,"_asr_print_sockaddr@224-252@lib/libc/asr/asr_debug.c","lib/libc/asr/asr_debug.c","_asr_print_sockaddr",224,252
45,7,352,2,50,"_asr_dump_config@255-305@lib/libc/asr/asr_debug.c","lib/libc/asr/asr_debug.c","_asr_dump_config",255,305
21,1,88,1,20,"_asr_statestr@310-330@lib/libc/asr/asr_debug.c","lib/libc/asr/asr_debug.c","_asr_statestr",310,330
16,1,63,1,15,"_asr_querystr@333-348@lib/libc/asr/asr_debug.c","lib/libc/asr/asr_debug.c","_asr_querystr",333,348
9,1,28,1,8,"_asr_transitionstr@351-359@lib/libc/asr/asr_debug.c","lib/libc/asr/asr_debug.c","_asr_transitionstr",351,359
6,3,33,2,6,"dname_check_label@53-59@lib/libc/asr/asr_utils.c","lib/libc/asr/asr_utils.c","dname_check_label",53,59
37,13,220,3,47,"_asr_dname_from_fqdn@62-109@lib/libc/asr/asr_utils.c","lib/libc/asr/asr_utils.c","_asr_dname_from_fqdn",62,109
44,17,313,6,50,"dname_expand@112-162@lib/libc/asr/asr_utils.c","lib/libc/asr/asr_utils.c","dname_expand",112,162
7,1,40,3,6,"_asr_pack_init@165-171@lib/libc/asr/asr_utils.c","lib/libc/asr/asr_utils.c","_asr_pack_init",165,171
7,1,41,3,6,"_asr_unpack_init@174-180@lib/libc/asr/asr_utils.c","lib/libc/asr/asr_utils.c","_asr_unpack_init",174,180
12,3,80,3,14,"unpack_data@183-197@lib/libc/asr/asr_utils.c","lib/libc/asr/asr_utils.c","unpack_data",183,197
7,2,47,2,8,"unpack_u16@200-208@lib/libc/asr/asr_utils.c","lib/libc/asr/asr_utils.c","unpack_u16",200,208
7,2,47,2,8,"unpack_u32@211-219@lib/libc/asr/asr_utils.c","lib/libc/asr/asr_utils.c","unpack_u32",211,219
4,1,26,2,3,"unpack_inaddr@222-225@lib/libc/asr/asr_utils.c","lib/libc/asr/asr_utils.c","unpack_inaddr",222,225
4,1,26,2,3,"unpack_in6addr@228-231@lib/libc/asr/asr_utils.c","lib/libc/asr/asr_utils.c","unpack_in6addr",228,231
16,5,107,3,18,"unpack_dname@234-252@lib/libc/asr/asr_utils.c","lib/libc/asr/asr_utils.c","unpack_dname",234,252
11,2,94,2,12,"_asr_unpack_header@255-267@lib/libc/asr/asr_utils.c","lib/libc/asr/asr_utils.c","_asr_unpack_header",255,267
7,2,66,2,7,"_asr_unpack_query@270-277@lib/libc/asr/asr_utils.c","lib/libc/asr/asr_utils.c","_asr_unpack_query",270,277
61,15,519,2,76,"_asr_unpack_rr@280-356@lib/libc/asr/asr_utils.c","lib/libc/asr/asr_utils.c","_asr_unpack_rr",280,356
12,3,81,3,14,"pack_data@359-373@lib/libc/asr/asr_utils.c","lib/libc/asr/asr_utils.c","pack_data",359,373
5,1,32,2,5,"pack_u16@376-381@lib/libc/asr/asr_utils.c","lib/libc/asr/asr_utils.c","pack_u16",376,381
4,1,31,2,6,"pack_dname@384-390@lib/libc/asr/asr_utils.c","lib/libc/asr/asr_utils.c","pack_dname",384,390
11,1,95,2,12,"_asr_pack_header@393-405@lib/libc/asr/asr_utils.c","lib/libc/asr/asr_utils.c","_asr_pack_header",393,405
7,2,57,4,7,"_asr_pack_query@408-415@lib/libc/asr/asr_utils.c","lib/libc/asr/asr_utils.c","_asr_pack_query",408,415
12,4,90,3,16,"_asr_pack_edns0@418-434@lib/libc/asr/asr_utils.c","lib/libc/asr/asr_utils.c","_asr_pack_edns0",418,434
58,16,392,3,67,"_asr_sockaddr_from_str@437-504@lib/libc/asr/asr_utils.c","lib/libc/asr/asr_utils.c","_asr_sockaddr_from_str",437,504
58,3,501,4,58,"_asr_addr_as_fqdn@507-565@lib/libc/asr/asr_utils.c","lib/libc/asr/asr_utils.c","_asr_addr_as_fqdn",507,565
22,6,138,4,26,"getaddrinfo@28-54@lib/libc/asr/getaddrinfo.c","lib/libc/asr/getaddrinfo.c","getaddrinfo",28,54
33,9,243,4,35,"getaddrinfo_async@74-109@lib/libc/asr/getaddrinfo_async.c","lib/libc/asr/getaddrinfo_async.c","getaddrinfo_async",74,109
286,90,1814,2,346,"getaddrinfo_async_run@113-459@lib/libc/asr/getaddrinfo_async.c","lib/libc/asr/getaddrinfo_async.c","getaddrinfo_async_run",113,459
24,6,158,3,28,"get_port@466-494@lib/libc/asr/getaddrinfo_async.c","lib/libc/asr/getaddrinfo_async.c","get_port",466,494
13,4,86,2,15,"iter_family@501-516@lib/libc/asr/getaddrinfo_async.c","lib/libc/asr/getaddrinfo_async.c","iter_family",501,516
52,17,442,3,59,"addrinfo_add@524-583@lib/libc/asr/getaddrinfo_async.c","lib/libc/asr/getaddrinfo_async.c","addrinfo_add",524,583
31,9,211,3,34,"addrinfo_from_file@586-620@lib/libc/asr/getaddrinfo_async.c","lib/libc/asr/getaddrinfo_async.c","addrinfo_from_file",586,620
48,11,370,3,52,"addrinfo_from_pkt@623-675@lib/libc/asr/getaddrinfo_async.c","lib/libc/asr/getaddrinfo_async.c","addrinfo_from_pkt",623,675
31,9,183,1,41,"addrconfig_setup@678-719@lib/libc/asr/getaddrinfo_async.c","lib/libc/asr/getaddrinfo_async.c","addrconfig_setup",678,719
49,11,398,4,59,"_fillhostent@42-101@lib/libc/asr/gethostnamadr.c","lib/libc/asr/gethostnamadr.c","_fillhostent",42,101
21,4,140,6,26,"_gethostbyname@104-130@lib/libc/asr/gethostnamadr.c","lib/libc/asr/gethostnamadr.c","_gethostbyname",104,130
9,2,50,1,11,"gethostbyname@133-144@lib/libc/asr/gethostnamadr.c","lib/libc/asr/gethostnamadr.c","gethostbyname",133,144
14,3,70,2,17,"gethostbyname2@148-165@lib/libc/asr/gethostnamadr.c","lib/libc/asr/gethostnamadr.c","gethostbyname2",148,165
25,4,145,3,31,"gethostbyaddr@169-200@lib/libc/asr/gethostnamadr.c","lib/libc/asr/gethostnamadr.c","gethostbyaddr",169,200
4,1,23,2,3,"gethostbyname_async@58-61@lib/libc/asr/gethostnamadr_async.c","lib/libc/asr/gethostnamadr_async.c","gethostbyname_async",58,61
28,7,176,3,33,"gethostbyname2_async@65-98@lib/libc/asr/gethostnamadr_async.c","lib/libc/asr/gethostnamadr_async.c","gethostbyname2_async",65,98
9,1,59,4,10,"gethostbyaddr_async@102-112@lib/libc/asr/gethostnamadr_async.c","lib/libc/asr/gethostnamadr_async.c","gethostbyaddr_async",102,112
17,5,119,4,20,"_gethostbyaddr_async_ctx@116-136@lib/libc/asr/gethostnamadr_async.c","lib/libc/asr/gethostnamadr_async.c","_gethostbyaddr_async_ctx",116,136
176,42,1084,2,222,"gethostnamadr_async_run@139-361@lib/libc/asr/gethostnamadr_async.c","lib/libc/asr/gethostnamadr_async.c","gethostnamadr_async_run",139,361
14,4,95,3,14,"hostent_from_addr@367-381@lib/libc/asr/gethostnamadr_async.c","lib/libc/asr/gethostnamadr_async.c","hostent_from_addr",367,381
42,15,302,5,46,"hostent_file_match@388-434@lib/libc/asr/gethostnamadr_async.c","lib/libc/asr/gethostnamadr_async.c","hostent_file_match",388,434
65,23,427,4,72,"hostent_from_packet@440-512@lib/libc/asr/gethostnamadr_async.c","lib/libc/asr/gethostnamadr_async.c","hostent_from_packet",440,512
15,3,122,1,17,"hostent_alloc@515-532@lib/libc/asr/gethostnamadr_async.c","lib/libc/asr/gethostnamadr_async.c","hostent_alloc",515,532
21,5,145,3,24,"hostent_set_cname@535-559@lib/libc/asr/gethostnamadr_async.c","lib/libc/asr/gethostnamadr_async.c","hostent_set_cname",535,559
24,7,170,3,27,"hostent_add_alias@562-589@lib/libc/asr/gethostnamadr_async.c","lib/libc/asr/gethostnamadr_async.c","hostent_add_alias",562,589
15,5,107,3,17,"hostent_add_addr@592-609@lib/libc/asr/gethostnamadr_async.c","lib/libc/asr/gethostnamadr_async.c","hostent_add_addr",592,609
38,11,287,3,48,"asr_print_addr@47-95@lib/libc/asr/getnameinfo.c","lib/libc/asr/getnameinfo.c","asr_print_addr",47,95
32,6,191,4,35,"asr_print_port@110-145@lib/libc/asr/getnameinfo.c","lib/libc/asr/getnameinfo.c","asr_print_port",110,145
46,18,274,7,56,"getnameinfo@148-204@lib/libc/asr/getnameinfo.c","lib/libc/asr/getnameinfo.c","getnameinfo",148,204
27,5,245,8,31,"getnameinfo_async@39-70@lib/libc/asr/getnameinfo_async.c","lib/libc/asr/getnameinfo_async.c","getnameinfo_async",39,70
103,26,705,2,128,"getnameinfo_async_run@74-202@lib/libc/asr/getnameinfo_async.c","lib/libc/asr/getnameinfo_async.c","getnameinfo_async_run",74,202
28,10,253,1,32,"_servname@210-242@lib/libc/asr/getnameinfo_async.c","lib/libc/asr/getnameinfo_async.c","_servname",210,242
29,9,290,1,37,"_numerichost@248-285@lib/libc/asr/getnameinfo_async.c","lib/libc/asr/getnameinfo_async.c","_numerichost",248,285
34,7,261,4,41,"_fillnetent@39-80@lib/libc/asr/getnetnamadr.c","lib/libc/asr/getnetnamadr.c","_fillnetent",39,80
19,3,111,1,24,"getnetbyname@83-107@lib/libc/asr/getnetnamadr.c","lib/libc/asr/getnetnamadr.c","getnetbyname",83,107
19,3,114,2,24,"getnetbyaddr@110-134@lib/libc/asr/getnetnamadr.c","lib/libc/asr/getnetnamadr.c","getnetbyaddr",110,134
24,5,140,2,29,"getnetbyname_async@51-80@lib/libc/asr/getnetnamadr_async.c","lib/libc/asr/getnetnamadr_async.c","getnetbyname_async",51,80
18,3,106,3,21,"getnetbyaddr_async@84-105@lib/libc/asr/getnetnamadr_async.c","lib/libc/asr/getnetnamadr_async.c","getnetbyaddr_async",84,105
134,27,769,2,173,"getnetnamadr_async_run@109-282@lib/libc/asr/getnetnamadr_async.c","lib/libc/asr/getnetnamadr_async.c","getnetnamadr_async_run",109,282
42,13,277,3,46,"netent_file_match@285-331@lib/libc/asr/getnetnamadr_async.c","lib/libc/asr/getnetnamadr_async.c","netent_file_match",285,331
47,15,296,3,52,"netent_from_packet@334-386@lib/libc/asr/getnetnamadr_async.c","lib/libc/asr/getnetnamadr_async.c","netent_from_packet",334,386
13,2,96,1,15,"netent_alloc@389-404@lib/libc/asr/getnetnamadr_async.c","lib/libc/asr/getnetnamadr_async.c","netent_alloc",389,404
21,5,145,3,25,"netent_set_cname@407-432@lib/libc/asr/getnetnamadr_async.c","lib/libc/asr/getnetnamadr_async.c","netent_set_cname",407,432
24,7,172,3,27,"netent_add_alias@435-462@lib/libc/asr/getnetnamadr_async.c","lib/libc/asr/getnetnamadr_async.c","netent_add_alias",435,462
17,3,112,5,21,"getrrsetbyname@29-50@lib/libc/asr/getrrsetbyname.c","lib/libc/asr/getrrsetbyname.c","getrrsetbyname",29,50
25,9,156,1,28,"freerrset@54-82@lib/libc/asr/getrrsetbyname.c","lib/libc/asr/getrrsetbyname.c","freerrset",54,82
23,4,155,5,26,"getrrsetbyname_async@38-64@lib/libc/asr/getrrsetbyname_async.c","lib/libc/asr/getrrsetbyname_async.c","getrrsetbyname_async",38,64
82,18,425,2,101,"getrrsetbyname_async_run@68-169@lib/libc/asr/getrrsetbyname_async.c","lib/libc/asr/getrrsetbyname_async.c","getrrsetbyname_async_run",68,169
76,17,508,3,99,"get_response@258-357@lib/libc/asr/getrrsetbyname_async.c","lib/libc/asr/getrrsetbyname_async.c","get_response",258,357
44,11,337,2,62,"parse_dns_response@363-425@lib/libc/asr/getrrsetbyname_async.c","lib/libc/asr/getrrsetbyname_async.c","parse_dns_response",363,425
34,7,230,4,43,"parse_dns_qsection@428-471@lib/libc/asr/getrrsetbyname_async.c","lib/libc/asr/getrrsetbyname_async.c","parse_dns_qsection",428,471
46,8,312,4,61,"parse_dns_rrsection@474-535@lib/libc/asr/getrrsetbyname_async.c","lib/libc/asr/getrrsetbyname_async.c","parse_dns_rrsection",474,535
9,3,42,1,9,"free_dns_query@538-547@lib/libc/asr/getrrsetbyname_async.c","lib/libc/asr/getrrsetbyname_async.c","free_dns_query",538,547
11,4,55,1,11,"free_dns_rr@550-561@lib/libc/asr/getrrsetbyname_async.c","lib/libc/asr/getrrsetbyname_async.c","free_dns_rr",550,561
10,2,50,1,10,"free_dns_response@564-574@lib/libc/asr/getrrsetbyname_async.c","lib/libc/asr/getrrsetbyname_async.c","free_dns_response",564,574
10,4,54,3,11,"count_dns_rr@577-588@lib/libc/asr/getrrsetbyname_async.c","lib/libc/asr/getrrsetbyname_async.c","count_dns_rr",577,588
37,9,306,1,61,"res_init@38-99@lib/libc/asr/res_init.c","lib/libc/asr/res_init.c","res_init",38,99
38,12,317,9,47,"res_mkquery@33-80@lib/libc/asr/res_mkquery.c","lib/libc/asr/res_mkquery.c","res_mkquery",33,80
25,6,173,6,28,"res_querydomain@87-115@lib/libc/asr/res_mkquery.c","lib/libc/asr/res_mkquery.c","res_querydomain",87,115
32,8,189,5,39,"res_query@30-69@lib/libc/asr/res_query.c","lib/libc/asr/res_query.c","res_query",30,69
32,8,189,5,39,"res_search@73-112@lib/libc/asr/res_query.c","lib/libc/asr/res_query.c","res_search",73,112
10,1,70,4,12,"res_search_async@41-53@lib/libc/asr/res_search_async.c","lib/libc/asr/res_search_async.c","res_search_async",41,53
18,4,123,4,21,"_res_search_async_ctx@57-78@lib/libc/asr/res_search_async.c","lib/libc/asr/res_search_async.c","_res_search_async_ctx",57,78
89,21,528,2,125,"res_search_async_run@83-208@lib/libc/asr/res_search_async.c","lib/libc/asr/res_search_async.c","res_search_async_run",83,208
9,2,64,4,10,"domcat@215-225@lib/libc/asr/res_search_async.c","lib/libc/asr/res_search_async.c","domcat",215,225
50,16,358,4,79,"_asr_iter_domain@246-325@lib/libc/asr/res_search_async.c","lib/libc/asr/res_search_async.c","_asr_iter_domain",246,325
25,6,151,4,31,"res_send@30-61@lib/libc/asr/res_send.c","lib/libc/asr/res_send.c","res_send",30,61
39,5,269,3,43,"res_send_async@53-96@lib/libc/asr/res_send_async.c","lib/libc/asr/res_send_async.c","res_send_async",53,96
10,1,70,4,12,"res_query_async@105-117@lib/libc/asr/res_send_async.c","lib/libc/asr/res_send_async.c","res_query_async",105,117
15,4,104,4,23,"_res_query_async_ctx@121-144@lib/libc/asr/res_send_async.c","lib/libc/asr/res_send_async.c","_res_query_async_ctx",121,144
133,30,709,2,153,"res_send_async_run@147-300@lib/libc/asr/res_send_async.c","lib/libc/asr/res_send_async.c","res_send_async_run",147,300
20,5,112,2,30,"sockaddr_connect@303-333@lib/libc/asr/res_send_async.c","lib/libc/asr/res_send_async.c","sockaddr_connect",303,333
61,12,499,5,70,"setup_query@341-411@lib/libc/asr/res_send_async.c","lib/libc/asr/res_send_async.c","setup_query",341,411
20,4,139,1,25,"udp_send@419-444@lib/libc/asr/res_send_async.c","lib/libc/asr/res_send_async.c","udp_send",419,444
24,4,171,1,29,"udp_recv@452-481@lib/libc/asr/res_send_async.c","lib/libc/asr/res_send_async.c","udp_recv",452,481
51,8,388,1,66,"tcp_write@490-556@lib/libc/asr/res_send_async.c","lib/libc/asr/res_send_async.c","tcp_write",490,556
59,14,470,1,72,"tcp_read@565-637@lib/libc/asr/res_send_async.c","lib/libc/asr/res_send_async.c","tcp_read",565,637
12,3,95,2,14,"ensure_ibuf@644-658@lib/libc/asr/res_send_async.c","lib/libc/asr/res_send_async.c","ensure_ibuf",644,658
57,16,401,1,74,"validate_packet@665-739@lib/libc/asr/res_send_async.c","lib/libc/asr/res_send_async.c","validate_packet",665,739
19,6,162,1,21,"iter_ns@747-768@lib/libc/asr/res_send_async.c","lib/libc/asr/res_send_async.c","iter_ns",747,768
3,1,7,1,2,"sethostent@27-29@lib/libc/asr/sethostent.c","lib/libc/asr/sethostent.c","sethostent",27,29
3,1,6,1,2,"endhostent@32-34@lib/libc/asr/sethostent.c","lib/libc/asr/sethostent.c","endhostent",32,34
5,1,15,1,4,"gethostent@37-41@lib/libc/asr/sethostent.c","lib/libc/asr/sethostent.c","gethostent",37,41
7,2,26,1,6,"wrapv@46-52@lib/libc/citrus/citrus_none.c","lib/libc/citrus/citrus_none.c","wrapv",46,52
11,4,62,3,10,"_citrus_none_ctype_mbrtowc@55-65@lib/libc/citrus/citrus_none.c","lib/libc/citrus/citrus_none.c","_citrus_none_ctype_mbrtowc",55,65
14,5,101,4,16,"_citrus_none_ctype_mbsnrtowcs@68-84@lib/libc/citrus/citrus_none.c","lib/libc/citrus/citrus_none.c","_citrus_none_ctype_mbsnrtowcs",68,84
11,4,52,2,12,"_citrus_none_ctype_wcrtomb@87-99@lib/libc/citrus/citrus_none.c","lib/libc/citrus/citrus_none.c","_citrus_none_ctype_wcrtomb",87,99
32,11,181,4,33,"_citrus_none_ctype_wcsnrtombs@102-135@lib/libc/citrus/citrus_none.c","lib/libc/citrus/citrus_none.c","_citrus_none_ctype_wcsnrtombs",102,135
84,25,500,4,125,"_citrus_utf8_ctype_mbrtowc@44-169@lib/libc/citrus/citrus_utf8.c","lib/libc/citrus/citrus_utf8.c","_citrus_utf8_ctype_mbrtowc",44,169
4,1,25,1,3,"_citrus_utf8_ctype_mbsinit@172-175@lib/libc/citrus/citrus_utf8.c","lib/libc/citrus/citrus_utf8.c","_citrus_utf8_ctype_mbsinit",172,175
63,22,424,5,77,"_citrus_utf8_ctype_mbsnrtowcs@178-255@lib/libc/citrus/citrus_utf8.c","lib/libc/citrus/citrus_utf8.c","_citrus_utf8_ctype_mbsnrtowcs",178,255
37,11,210,3,56,"_citrus_utf8_ctype_wcrtomb@258-314@lib/libc/citrus/citrus_utf8.c","lib/libc/citrus/citrus_utf8.c","_citrus_utf8_ctype_wcrtomb",258,314
56,17,351,5,63,"_citrus_utf8_ctype_wcsnrtombs@317-380@lib/libc/citrus/citrus_utf8.c","lib/libc/citrus/citrus_utf8.c","_citrus_utf8_ctype_wcsnrtombs",317,380
4,1,28,2,3,"creat@34-37@lib/libc/compat-43/creat.c","lib/libc/compat-43/creat.c","creat",34,37
4,1,12,1,3,"getdtablesize@10-13@lib/libc/compat-43/getdtablesize.c","lib/libc/compat-43/getdtablesize.c","getdtablesize",10,13
12,2,70,1,12,"gethostid@36-48@lib/libc/compat-43/gethostid.c","lib/libc/compat-43/gethostid.c","gethostid",36,48
8,2,47,1,8,"getwd@38-46@lib/libc/compat-43/getwd.c","lib/libc/compat-43/getwd.c","getwd",38,46
8,3,43,2,7,"killpg@38-45@lib/libc/compat-43/killpg.c","lib/libc/compat-43/killpg.c","killpg",38,45
9,2,60,1,9,"sethostid@36-45@lib/libc/compat-43/sethostid.c","lib/libc/compat-43/sethostid.c","sethostid",36,45
4,1,20,2,3,"setpgrp@35-38@lib/libc/compat-43/setpgrp.c","lib/libc/compat-43/setpgrp.c","setpgrp",35,38
14,5,89,3,14,"sigvec@33-47@lib/libc/compat-43/sigcompat.c","lib/libc/compat-43/sigcompat.c","sigvec",33,47
9,2,50,1,9,"sigsetmask@50-59@lib/libc/compat-43/sigcompat.c","lib/libc/compat-43/sigcompat.c","sigsetmask",50,59
9,2,50,1,9,"sigblock@62-71@lib/libc/compat-43/sigcompat.c","lib/libc/compat-43/sigcompat.c","sigblock",62,71
4,1,20,1,3,"sigpause@74-77@lib/libc/compat-43/sigcompat.c","lib/libc/compat-43/sigcompat.c","sigpause",74,77
11,4,75,2,12,"_rs_init@71-83@lib/libc/crypt/arc4random.c","lib/libc/crypt/arc4random.c","_rs_init",71,83
14,3,95,1,18,"_rs_stir@86-104@lib/libc/crypt/arc4random.c","lib/libc/crypt/arc4random.c","_rs_stir",86,104
10,4,47,1,9,"_rs_stir_if_needed@107-116@lib/libc/crypt/arc4random.c","lib/libc/crypt/arc4random.c","_rs_stir_if_needed",107,116
15,3,136,2,20,"_rs_rekey@119-139@lib/libc/crypt/arc4random.c","lib/libc/crypt/arc4random.c","_rs_rekey",119,139
21,4,126,2,21,"_rs_random_buf@142-163@lib/libc/crypt/arc4random.c","lib/libc/crypt/arc4random.c","_rs_random_buf",142,163
11,2,93,1,11,"_rs_random_u32@166-177@lib/libc/crypt/arc4random.c","lib/libc/crypt/arc4random.c","_rs_random_u32",166,177
8,1,26,1,8,"arc4random@180-188@lib/libc/crypt/arc4random.c","lib/libc/crypt/arc4random.c","arc4random",180,188
6,1,26,2,5,"arc4random_buf@192-197@lib/libc/crypt/arc4random.c","lib/libc/crypt/arc4random.c","arc4random_buf",192,197
4,1,11,1,3,"_getentropy_fail@32-35@lib/libc/crypt/arc4random.h","lib/libc/crypt/arc4random.h","_getentropy_fail",32,35
17,3,124,2,18,"_rs_allocate@38-56@lib/libc/crypt/arc4random.h","lib/libc/crypt/arc4random.h","_rs_allocate",38,56
3,1,6,1,2,"_rs_forkdetect@59-61@lib/libc/crypt/arc4random.h","lib/libc/crypt/arc4random.h","_rs_forkdetect",59,61
13,4,54,1,23,"arc4random_uniform@33-56@lib/libc/crypt/arc4random_uniform.c","lib/libc/crypt/arc4random_uniform.c","arc4random_uniform",33,56
16,4,95,3,20,"bcrypt_initsalt@66-86@lib/libc/crypt/bcrypt.c","lib/libc/crypt/bcrypt.c","bcrypt_initsalt",66,86
80,19,636,4,108,"bcrypt_hashpass@92-200@lib/libc/crypt/bcrypt.c","lib/libc/crypt/bcrypt.c","bcrypt_hashpass",92,200
10,3,77,4,12,"bcrypt_newhash@206-218@lib/libc/crypt/bcrypt.c","lib/libc/crypt/bcrypt.c","bcrypt_newhash",206,218
13,4,91,2,14,"bcrypt_checkpass@222-236@lib/libc/crypt/bcrypt.c","lib/libc/crypt/bcrypt.c","bcrypt_checkpass",222,236
22,5,127,1,27,"_bcrypt_autorounds@244-271@lib/libc/crypt/bcrypt.c","lib/libc/crypt/bcrypt.c","_bcrypt_autorounds",244,271
29,8,224,3,36,"decode_base64@300-336@lib/libc/crypt/bcrypt.c","lib/libc/crypt/bcrypt.c","decode_base64",300,336
29,4,199,3,29,"encode_base64@343-372@lib/libc/crypt/bcrypt.c","lib/libc/crypt/bcrypt.c","encode_base64",343,372
6,1,29,1,7,"bcrypt_gensalt@378-385@lib/libc/crypt/bcrypt.c","lib/libc/crypt/bcrypt.c","bcrypt_gensalt",378,385
7,2,45,2,8,"bcrypt@388-396@lib/libc/crypt/bcrypt.c","lib/libc/crypt/bcrypt.c","bcrypt",388,396
20,1,281,3,22,"Blowfish_encipher@67-89@lib/libc/crypt/blowfish.c","lib/libc/crypt/blowfish.c","Blowfish_encipher",67,89
20,1,281,3,22,"Blowfish_decipher@93-115@lib/libc/crypt/blowfish.c","lib/libc/crypt/blowfish.c","Blowfish_decipher",93,115
274,1,2116,1,276,"Blowfish_initstate@119-395@lib/libc/crypt/blowfish.c","lib/libc/crypt/blowfish.c","Blowfish_initstate",119,395
16,3,84,3,18,"Blowfish_stream2word@399-417@lib/libc/crypt/blowfish.c","lib/libc/crypt/blowfish.c","Blowfish_stream2word",399,417
29,5,212,3,34,"Blowfish_expand0state@421-455@lib/libc/crypt/blowfish.c","lib/libc/crypt/blowfish.c","Blowfish_expand0state",421,455
34,5,268,5,40,"Blowfish_expandstate@460-500@lib/libc/crypt/blowfish.c","lib/libc/crypt/blowfish.c","Blowfish_expandstate",460,500
5,1,30,3,7,"blf_key@504-511@lib/libc/crypt/blowfish.c","lib/libc/crypt/blowfish.c","blf_key",504,511
10,2,56,3,10,"blf_enc@515-525@lib/libc/crypt/blowfish.c","lib/libc/crypt/blowfish.c","blf_enc",515,525
10,2,56,3,10,"blf_dec@529-539@lib/libc/crypt/blowfish.c","lib/libc/crypt/blowfish.c","blf_dec",529,539
19,2,206,3,19,"blf_ecb_encrypt@543-562@lib/libc/crypt/blowfish.c","lib/libc/crypt/blowfish.c","blf_ecb_encrypt",543,562
19,2,206,3,19,"blf_ecb_decrypt@566-585@lib/libc/crypt/blowfish.c","lib/libc/crypt/blowfish.c","blf_ecb_decrypt",566,585
22,3,239,4,22,"blf_cbc_encrypt@589-611@lib/libc/crypt/blowfish.c","lib/libc/crypt/blowfish.c","blf_cbc_encrypt",589,611
38,4,447,4,38,"blf_cbc_decrypt@615-653@lib/libc/crypt/blowfish.c","lib/libc/crypt/blowfish.c","blf_cbc_decrypt",615,653
7,2,50,2,6,"report@658-664@lib/libc/crypt/blowfish.c","lib/libc/crypt/blowfish.c","report",658,664
24,2,177,1,31,"main@666-697@lib/libc/crypt/blowfish.c","lib/libc/crypt/blowfish.c","main",666,697
22,2,215,4,22,"chacha_keysetup@55-77@lib/libc/crypt/chacha_private.h","lib/libc/crypt/chacha_private.h","chacha_keysetup",55,77
7,1,59,2,6,"chacha_ivsetup@80-86@lib/libc/crypt/chacha_private.h","lib/libc/crypt/chacha_private.h","chacha_ivsetup",80,86
122,10,1066,4,133,"chacha_encrypt_bytes@89-222@lib/libc/crypt/chacha_private.h","lib/libc/crypt/chacha_private.h","chacha_encrypt_bytes",89,222
14,3,65,2,13,"crypt@8-21@lib/libc/crypt/crypt.c","lib/libc/crypt/crypt.c","crypt",8,21
19,7,109,2,25,"crypt_checkpass@25-50@lib/libc/crypt/cryptutil.c","lib/libc/crypt/cryptutil.c","crypt_checkpass",25,50
39,9,253,4,42,"crypt_newhash@54-96@lib/libc/crypt/cryptutil.c","lib/libc/crypt/cryptutil.c","crypt_newhash",54,96
33,8,225,1,42,"__bt_close@56-98@lib/libc/db/btree/bt_close.c","lib/libc/db/btree/bt_close.c","__bt_close",56,98
23,8,147,2,31,"__bt_sync@110-141@lib/libc/db/btree/bt_close.c","lib/libc/db/btree/bt_close.c","__bt_sync",110,141
17,2,117,1,20,"bt_meta@153-173@lib/libc/db/btree/bt_close.c","lib/libc/db/btree/bt_close.c","bt_meta",153,173
60,11,388,3,62,"__bt_pgin@53-115@lib/libc/db/btree/bt_conv.c","lib/libc/db/btree/bt_conv.c","__bt_pgin",53,115
60,11,388,3,62,"__bt_pgout@118-180@lib/libc/db/btree/bt_conv.c","lib/libc/db/btree/bt_conv.c","__bt_pgout",118,180
17,1,92,1,17,"mswap@189-206@lib/libc/db/btree/bt_conv.c","lib/libc/db/btree/bt_conv.c","mswap",189,206
25,5,174,1,33,"__bt_dump@50-83@lib/libc/db/btree/bt_debug.c","lib/libc/db/btree/bt_debug.c","__bt_dump",50,83
18,2,144,1,24,"__bt_dmpage@92-116@lib/libc/db/btree/bt_debug.c","lib/libc/db/btree/bt_debug.c","__bt_dmpage",92,116
8,2,49,2,8,"__bt_dnpage@125-133@lib/libc/db/btree/bt_debug.c","lib/libc/db/btree/bt_debug.c","__bt_dnpage",125,133
75,15,565,1,84,"__bt_dpage@142-226@lib/libc/db/btree/bt_debug.c","lib/libc/db/btree/bt_debug.c","__bt_dpage",142,226
68,16,447,1,71,"__bt_stat@237-308@lib/libc/db/btree/bt_debug.c","lib/libc/db/btree/bt_debug.c","__bt_stat",237,308
46,15,298,3,63,"__bt_delete@57-120@lib/libc/db/btree/bt_delete.c","lib/libc/db/btree/bt_delete.c","__bt_delete",57,120
80,21,685,3,130,"__bt_stkacq@135-265@lib/libc/db/btree/bt_delete.c","lib/libc/db/btree/bt_delete.c","__bt_stkacq",135,265
51,19,355,2,68,"__bt_bdelete@279-347@lib/libc/db/btree/bt_delete.c","lib/libc/db/btree/bt_delete.c","__bt_bdelete",279,347
50,15,401,2,78,"__bt_pdelete@364-442@lib/libc/db/btree/bt_delete.c","lib/libc/db/btree/bt_delete.c","__bt_pdelete",364,442
35,18,365,4,45,"__bt_dleaf@458-503@lib/libc/db/btree/bt_delete.c","lib/libc/db/btree/bt_delete.c","__bt_dleaf",458,503
70,18,531,4,84,"__bt_curdel@519-603@lib/libc/db/btree/bt_delete.c","lib/libc/db/btree/bt_delete.c","__bt_curdel",519,603
17,5,131,2,17,"__bt_relink@614-631@lib/libc/db/btree/bt_delete.c","lib/libc/db/btree/bt_delete.c","__bt_relink",614,631
27,6,190,4,38,"__bt_get@57-95@lib/libc/db/btree/bt_get.c","lib/libc/db/btree/bt_get.c","__bt_get",57,95
167,51,1157,5,245,"__bt_open@83-328@lib/libc/db/btree/bt_open.c","lib/libc/db/btree/bt_open.c","__bt_open",83,328
34,9,246,1,37,"nroot@340-377@lib/libc/db/btree/bt_open.c","lib/libc/db/btree/bt_open.c","nroot",340,377
21,6,153,1,22,"tmp@380-402@lib/libc/db/btree/bt_open.c","lib/libc/db/btree/bt_open.c","tmp",380,402
15,3,56,1,15,"byteorder@405-420@lib/libc/db/btree/bt_open.c","lib/libc/db/btree/bt_open.c","byteorder",405,420
14,3,76,1,18,"__bt_fd@423-441@lib/libc/db/btree/bt_open.c","lib/libc/db/btree/bt_open.c","__bt_fd",423,441
31,9,247,5,42,"__ovfl_get@74-116@lib/libc/db/btree/bt_overflow.c","lib/libc/db/btree/bt_overflow.c","__ovfl_get",74,116
30,5,222,3,38,"__ovfl_put@130-168@lib/libc/db/btree/bt_overflow.c","lib/libc/db/btree/bt_overflow.c","__ovfl_put",130,168
26,9,191,2,33,"__ovfl_delete@181-214@lib/libc/db/btree/bt_overflow.c","lib/libc/db/btree/bt_overflow.c","__ovfl_delete",181,214
8,1,55,2,10,"__bt_free@54-64@lib/libc/db/btree/bt_page.c","lib/libc/db/btree/bt_page.c","__bt_free",54,64
12,2,86,2,12,"__bt_new@78-90@lib/libc/db/btree/bt_page.c","lib/libc/db/btree/bt_page.c","__bt_new",78,90
128,37,954,4,181,"__bt_put@61-242@lib/libc/db/btree/bt_put.c","lib/libc/db/btree/bt_put.c","__bt_put",61,242
40,13,315,4,51,"bt_fast@259-310@lib/libc/db/btree/bt_put.c","lib/libc/db/btree/bt_put.c","bt_fast",259,310
46,16,338,3,66,"__bt_search@60-126@lib/libc/db/btree/bt_search.c","lib/libc/db/btree/bt_search.c","__bt_search",60,126
15,3,119,4,19,"__bt_snext@142-161@lib/libc/db/btree/bt_search.c","lib/libc/db/btree/bt_search.c","__bt_snext",142,161
15,3,126,4,19,"__bt_sprev@177-196@lib/libc/db/btree/bt_search.c","lib/libc/db/btree/bt_search.c","__bt_sprev",177,196
37,10,226,4,53,"__bt_seq@71-124@lib/libc/db/btree/bt_seq.c","lib/libc/db/btree/bt_seq.c","__bt_seq",71,124
49,16,327,4,67,"__bt_seqset@143-210@lib/libc/db/btree/bt_seq.c","lib/libc/db/btree/bt_seq.c","__bt_seqset",143,210
51,13,339,3,82,"__bt_seqadv@227-309@lib/libc/db/btree/bt_seq.c","lib/libc/db/btree/bt_seq.c","__bt_seqadv",227,309
56,15,401,4,85,"__bt_first@326-411@lib/libc/db/btree/bt_seq.c","lib/libc/db/btree/bt_seq.c","__bt_first",326,411
12,2,103,3,14,"__bt_setcur@423-437@lib/libc/db/btree/bt_seq.c","lib/libc/db/btree/bt_seq.c","__bt_setcur",423,437
147,37,1247,7,240,"__bt_split@73-313@lib/libc/db/btree/bt_split.c","lib/libc/db/btree/bt_split.c","__bt_split",73,313
50,10,386,6,82,"bt_page@330-412@lib/libc/db/btree/bt_split.c","lib/libc/db/btree/bt_split.c","bt_page",330,412
22,4,189,6,28,"bt_root@429-457@lib/libc/db/btree/bt_split.c","lib/libc/db/btree/bt_split.c","bt_root",429,457
17,3,169,4,23,"bt_rroot@472-495@lib/libc/db/btree/bt_split.c","lib/libc/db/btree/bt_split.c","bt_rroot",472,495
39,5,317,4,58,"bt_broot@510-568@lib/libc/db/btree/bt_split.c","lib/libc/db/btree/bt_split.c","bt_broot",510,568
116,26,704,6,156,"bt_psplit@585-741@lib/libc/db/btree/bt_split.c","lib/libc/db/btree/bt_split.c","bt_psplit",585,741
9,2,61,2,9,"bt_preserve@759-768@lib/libc/db/btree/bt_split.c","lib/libc/db/btree/bt_split.c","bt_preserve",759,768
8,2,56,1,8,"rec_total@785-793@lib/libc/db/btree/bt_split.c","lib/libc/db/btree/bt_split.c","rec_total",785,793
52,15,423,7,63,"__bt_ret@61-124@lib/libc/db/btree/bt_utils.c","lib/libc/db/btree/bt_utils.c","__bt_ret",61,124
36,9,240,3,45,"__bt_cmp@140-185@lib/libc/db/btree/bt_utils.c","lib/libc/db/btree/bt_utils.c","__bt_cmp",140,185
10,3,100,2,16,"__bt_defcmp@200-216@lib/libc/db/btree/bt_utils.c","lib/libc/db/btree/bt_utils.c","__bt_defcmp",200,216
12,4,105,2,14,"__bt_defpfx@229-243@lib/libc/db/btree/bt_utils.c","lib/libc/db/btree/bt_utils.c","__bt_defpfx",229,243
19,7,139,5,24,"dbopen@44-68@lib/libc/db/db/db.c","lib/libc/db/db/db.c","dbopen",44,68
4,1,11,1,3,"__dberr@72-75@lib/libc/db/db/db.c","lib/libc/db/db/db.c","__dberr",72,75
9,1,150,1,9,"__dbpanic@84-93@lib/libc/db/db/db.c","lib/libc/db/db/db.c","__dbpanic",84,93
103,26,729,5,140,"__hash_open@91-231@lib/libc/db/hash/hash.c","lib/libc/db/hash/hash.c","__hash_open",91,231
11,2,52,1,12,"hash_close@234-246@lib/libc/db/hash/hash.c","lib/libc/db/hash/hash.c","hash_close",234,246
12,3,61,1,13,"hash_fd@249-262@lib/libc/db/hash/hash.c","lib/libc/db/hash/hash.c","hash_fd",249,262
51,13,313,3,56,"init_hash@266-322@lib/libc/db/hash/hash.c","lib/libc/db/hash/hash.c","init_hash",266,322
22,3,213,2,34,"init_htab@330-364@lib/libc/db/hash/hash.c","lib/libc/db/hash/hash.c","init_htab",330,364
38,11,266,1,51,"hdestroy@373-424@lib/libc/db/hash/hash.c","lib/libc/db/hash/hash.c","hdestroy",373,424
17,6,97,2,19,"hash_sync@433-452@lib/libc/db/hash/hash.c","lib/libc/db/hash/hash.c","hash_sync",433,452
29,9,209,1,34,"flush_meta@460-494@lib/libc/db/hash/hash.c","lib/libc/db/hash/hash.c","flush_meta",460,494
10,2,72,4,10,"hash_get@506-516@lib/libc/db/hash/hash.c","lib/libc/db/hash/hash.c","hash_get",506,516
15,5,113,4,15,"hash_put@519-534@lib/libc/db/hash/hash.c","lib/libc/db/hash/hash.c","hash_put",519,534
15,4,99,3,15,"hash_delete@537-552@lib/libc/db/hash/hash.c","lib/libc/db/hash/hash.c","hash_delete",537,552
110,29,680,4,123,"hash_access@558-681@lib/libc/db/hash/hash.c","lib/libc/db/hash/hash.c","hash_access",558,681
77,24,549,4,82,"hash_seq@684-766@lib/libc/db/hash/hash.c","lib/libc/db/hash/hash.c","hash_seq",684,766
32,8,243,1,47,"__expand_table@776-823@lib/libc/db/hash/hash.c","lib/libc/db/hash/hash.c","__expand_table",776,823
11,2,74,3,11,"hash_realloc@830-841@lib/libc/db/hash/hash.c","lib/libc/db/hash/hash.c","hash_realloc",830,841
9,2,60,3,9,"__call_hash@844-853@lib/libc/db/hash/hash.c","lib/libc/db/hash/hash.c","__call_hash",844,853
26,5,174,2,28,"alloc_segs@861-889@lib/libc/db/hash/hash.c","lib/libc/db/hash/hash.c","alloc_segs",861,889
25,2,251,2,25,"swap_header_copy@896-921@lib/libc/db/hash/hash.c","lib/libc/db/hash/hash.c","swap_header_copy",896,921
27,2,176,1,28,"swap_header@924-952@lib/libc/db/hash/hash.c","lib/libc/db/hash/hash.c","swap_header",924,952
79,12,560,4,95,"__big_insert@82-177@lib/libc/db/hash/hash_bigkey.c","lib/libc/db/hash/hash_bigkey.c","__big_insert",82,177
46,13,314,2,68,"__big_delete@191-259@lib/libc/db/hash/hash_bigkey.c","lib/libc/db/hash/hash_bigkey.c","__big_delete",191,259
31,8,217,5,35,"__find_bigpair@268-303@lib/libc/db/hash/hash_bigkey.c","lib/libc/db/hash/hash_bigkey.c","__find_bigpair",268,303
24,8,159,2,32,"__find_last_page@315-347@lib/libc/db/hash/hash_bigkey.c","lib/libc/db/hash/hash_bigkey.c","__find_last_page",315,347
68,13,519,5,80,"__big_return@354-434@lib/libc/db/hash/hash_bigkey.c","lib/libc/db/hash/hash_bigkey.c","__big_return",354,434
45,10,328,4,46,"collect_data@440-486@lib/libc/db/hash/hash_bigkey.c","lib/libc/db/hash/hash_bigkey.c","collect_data",440,486
8,2,78,5,7,"__big_keydata@492-499@lib/libc/db/hash/hash_bigkey.c","lib/libc/db/hash/hash_bigkey.c","__big_keydata",492,499
30,8,254,5,31,"collect_key@506-537@lib/libc/db/hash/hash_bigkey.c","lib/libc/db/hash/hash_bigkey.c","collect_key",506,537
65,13,446,7,94,"__big_split@545-639@lib/libc/db/hash/hash_bigkey.c","lib/libc/db/hash/hash_bigkey.c","__big_split",545,639
38,11,231,4,44,"__get_buf@100-144@lib/libc/db/hash/hash_buf.c","lib/libc/db/hash/hash_buf.c","__get_buf",100,144
90,35,674,3,140,"newbuf@153-293@lib/libc/db/hash/hash_buf.c","lib/libc/db/hash/hash_buf.c","newbuf",153,293
11,1,71,2,20,"__buf_init@296-316@lib/libc/db/hash/hash_buf.c","lib/libc/db/hash/hash_buf.c","__buf_init",296,316
25,10,162,3,28,"__buf_free@319-347@lib/libc/db/hash/hash_buf.c","lib/libc/db/hash/hash_buf.c","__buf_free",319,347
8,1,40,2,7,"__reclaim_buf@350-357@lib/libc/db/hash/hash_buf.c","lib/libc/db/hash/hash_buf.c","__reclaim_buf",350,357
31,11,120,2,37,"__default_hash@41-78@lib/libc/db/hash/hash_func.c","lib/libc/db/hash/hash_func.c","__default_hash",41,78
7,2,42,1,7,"__log2@41-48@lib/libc/db/hash/hash_log2.c","lib/libc/db/hash/hash_log2.c","__log2",41,48
15,1,142,3,22,"putpair@88-110@lib/libc/db/hash/hash_page.c","lib/libc/db/hash/hash_page.c","putpair",88,110
38,7,324,3,50,"__delpair@118-168@lib/libc/db/hash/hash_page.c","lib/libc/db/hash/hash_page.c","__delpair",118,168
61,8,525,3,76,"__split_page@175-251@lib/libc/db/hash/hash_page.c","lib/libc/db/hash/hash_page.c","__split_page",175,251
98,19,718,6,111,"ugly_split@269-380@lib/libc/db/hash/hash_page.c","lib/libc/db/hash/hash_page.c","ugly_split",269,380
50,19,405,4,61,"__addel@390-451@lib/libc/db/hash/hash_page.c","lib/libc/db/hash/hash_page.c","__addel",390,451
28,10,230,2,42,"__add_ovflpage@460-502@lib/libc/db/hash/hash_page.c","lib/libc/db/hash/hash_page.c","__add_ovflpage",460,502
43,13,287,6,45,"__get_page@510-555@lib/libc/db/hash/hash_page.c","lib/libc/db/hash/hash_page.c","__get_page",510,555
31,10,242,5,34,"__put_page@565-599@lib/libc/db/hash/hash_page.c","lib/libc/db/hash/hash_page.c","__put_page",565,599
18,2,166,4,18,"__ibitmap@607-625@lib/libc/db/hash/hash_page.c","lib/libc/db/hash/hash_page.c","__ibitmap",607,625
11,3,57,1,11,"first_free@628-639@lib/libc/db/hash/hash_page.c","lib/libc/db/hash/hash_page.c","first_free",628,639
101,25,777,1,147,"overflow_page@642-789@lib/libc/db/hash/hash_page.c","lib/libc/db/hash/hash_page.c","overflow_page",642,789
24,8,197,2,36,"__free_ovflpage@795-831@lib/libc/db/hash/hash_page.c","lib/libc/db/hash/hash_page.c","__free_ovflpage",795,831
22,7,171,1,24,"open_temp@839-863@lib/libc/db/hash/hash_page.c","lib/libc/db/hash/hash_page.c","open_temp",839,863
21,1,175,3,22,"squeeze_key@870-892@lib/libc/db/hash/hash_page.c","lib/libc/db/hash/hash_page.c","squeeze_key",870,892
13,4,111,2,12,"fetch_bitmap@895-907@lib/libc/db/hash/hash_page.c","lib/libc/db/hash/hash_page.c","fetch_bitmap",895,907
16,5,156,1,16,"print_chain@911-927@lib/libc/db/hash/hash_page.c","lib/libc/db/hash/hash_page.c","print_chain",911,927
26,4,155,4,27,"_dbm_open@60-87@lib/libc/db/hash/ndbm.c","lib/libc/db/hash/ndbm.c","_dbm_open",60,87
7,1,35,3,7,"dbm_open@95-102@lib/libc/db/hash/ndbm.c","lib/libc/db/hash/ndbm.c","dbm_open",95,102
5,1,22,1,5,"dbm_close@109-114@lib/libc/db/hash/ndbm.c","lib/libc/db/hash/ndbm.c","dbm_close",109,114
18,2,100,2,18,"dbm_fetch@123-141@lib/libc/db/hash/ndbm.c","lib/libc/db/hash/ndbm.c","dbm_fetch",123,141
13,2,71,1,13,"dbm_firstkey@150-163@lib/libc/db/hash/ndbm.c","lib/libc/db/hash/ndbm.c","dbm_firstkey",150,163
13,2,71,1,13,"dbm_nextkey@172-185@lib/libc/db/hash/ndbm.c","lib/libc/db/hash/ndbm.c","dbm_nextkey",172,185
14,2,69,2,14,"dbm_delete@194-208@lib/libc/db/hash/ndbm.c","lib/libc/db/hash/ndbm.c","dbm_delete",194,208
13,2,89,4,13,"dbm_store@218-231@lib/libc/db/hash/ndbm.c","lib/libc/db/hash/ndbm.c","dbm_store",218,231
7,1,31,1,7,"dbm_error@235-242@lib/libc/db/hash/ndbm.c","lib/libc/db/hash/ndbm.c","dbm_error",235,242
8,1,35,1,8,"dbm_clearerr@245-253@lib/libc/db/hash/ndbm.c","lib/libc/db/hash/ndbm.c","dbm_clearerr",245,253
5,1,25,1,5,"dbm_dirfno@256-261@lib/libc/db/hash/ndbm.c","lib/libc/db/hash/ndbm.c","dbm_dirfno",256,261
6,1,35,1,7,"dbm_rdonly@264-271@lib/libc/db/hash/ndbm.c","lib/libc/db/hash/ndbm.c","dbm_rdonly",264,271
22,5,156,4,30,"mpool_open@55-85@lib/libc/db/mpool/mpool.c","lib/libc/db/mpool/mpool.c","mpool_open",55,85
7,1,60,4,6,"mpool_filter@92-98@lib/libc/db/mpool/mpool.c","lib/libc/db/mpool/mpool.c","mpool_filter",92,98
22,5,155,3,31,"mpool_new@105-136@lib/libc/db/mpool/mpool.c","lib/libc/db/mpool/mpool.c","mpool_new",105,136
17,3,122,2,23,"mpool_delete@139-162@lib/libc/db/mpool/mpool.c","lib/libc/db/mpool/mpool.c","mpool_delete",139,162
53,13,377,3,87,"mpool_get@169-256@lib/libc/db/mpool/mpool.c","lib/libc/db/mpool/mpool.c","mpool_get",169,256
15,5,99,3,19,"mpool_put@263-282@lib/libc/db/mpool/mpool.c","lib/libc/db/mpool/mpool.c","mpool_put",263,282
10,2,55,1,13,"mpool_close@289-302@lib/libc/db/mpool/mpool.c","lib/libc/db/mpool/mpool.c","mpool_close",289,302
9,4,59,1,12,"mpool_sync@309-321@lib/libc/db/mpool/mpool.c","lib/libc/db/mpool/mpool.c","mpool_sync",309,321
32,9,245,1,49,"mpool_bkt@328-377@lib/libc/db/mpool/mpool.c","lib/libc/db/mpool/mpool.c","mpool_bkt",328,377
14,5,119,2,27,"mpool_write@384-411@lib/libc/db/mpool/mpool.c","lib/libc/db/mpool/mpool.c","mpool_write",384,411
14,5,85,2,18,"mpool_look@418-436@lib/libc/db/mpool/mpool.c","lib/libc/db/mpool/mpool.c","mpool_look",418,436
36,5,267,1,38,"mpool_stat@444-482@lib/libc/db/mpool/mpool.c","lib/libc/db/mpool/mpool.c","mpool_stat",444,482
25,8,140,1,33,"__rec_close@54-87@lib/libc/db/recno/rec_close.c","lib/libc/db/recno/rec_close.c","__rec_close",54,87
53,16,455,2,74,"__rec_sync@99-173@lib/libc/db/recno/rec_close.c","lib/libc/db/recno/rec_close.c","__rec_sync",99,173
36,10,213,3,40,"__rec_delete@58-98@lib/libc/db/recno/rec_delete.c","lib/libc/db/recno/rec_delete.c","__rec_delete",58,98
16,3,103,2,19,"rec_rdelete@111-130@lib/libc/db/recno/rec_delete.c","lib/libc/db/recno/rec_delete.c","rec_rdelete",111,130
24,7,236,3,40,"__rec_dleaf@143-183@lib/libc/db/recno/rec_delete.c","lib/libc/db/recno/rec_delete.c","__rec_dleaf",143,183
31,9,224,4,42,"__rec_get@57-99@lib/libc/db/recno/rec_get.c","lib/libc/db/recno/rec_get.c","__rec_get",57,99
40,12,253,2,41,"__rec_fpipe@112-153@lib/libc/db/recno/rec_get.c","lib/libc/db/recno/rec_get.c","__rec_fpipe",112,153
42,12,290,2,42,"__rec_vpipe@166-208@lib/libc/db/recno/rec_get.c","lib/libc/db/recno/rec_get.c","__rec_vpipe",166,208
34,9,255,2,35,"__rec_fmap@221-256@lib/libc/db/recno/rec_get.c","lib/libc/db/recno/rec_get.c","__rec_fmap",221,256
23,6,163,2,24,"__rec_vmap@269-293@lib/libc/db/recno/rec_get.c","lib/libc/db/recno/rec_get.c","__rec_vmap",269,293
108,27,664,5,132,"__rec_open@50-182@lib/libc/db/recno/rec_open.c","lib/libc/db/recno/rec_open.c","__rec_open",50,182
14,3,76,1,18,"__rec_fd@185-203@lib/libc/db/recno/rec_open.c","lib/libc/db/recno/rec_open.c","__rec_fd",185,203
92,30,657,4,110,"__rec_put@56-166@lib/libc/db/recno/rec_put.c","lib/libc/db/recno/rec_put.c","__rec_put",56,166
60,14,424,4,86,"__rec_iput@180-266@lib/libc/db/recno/rec_put.c","lib/libc/db/recno/rec_put.c","__rec_iput",180,266
55,14,368,3,59,"__rec_search@58-117@lib/libc/db/recno/rec_search.c","lib/libc/db/recno/rec_search.c","__rec_search",58,117
58,20,390,4,67,"__rec_seq@55-122@lib/libc/db/recno/rec_seq.c","lib/libc/db/recno/rec_seq.c","__rec_seq",55,122
42,10,353,5,52,"__rec_ret@53-105@lib/libc/db/recno/rec_utils.c","lib/libc/db/recno/rec_utils.c","__rec_ret",53,105
5,1,20,2,4,"dlopen@57-61@lib/libc/dlfcn/dlfcn_stubs.c","lib/libc/dlfcn/dlfcn_stubs.c","dlopen",57,61
5,1,16,1,4,"dlclose@64-68@lib/libc/dlfcn/dlfcn_stubs.c","lib/libc/dlfcn/dlfcn_stubs.c","dlclose",64,68
5,1,21,2,4,"dlsym@71-75@lib/libc/dlfcn/dlfcn_stubs.c","lib/libc/dlfcn/dlfcn_stubs.c","dlsym",71,75
4,1,19,3,3,"dlctl@78-81@lib/libc/dlfcn/dlfcn_stubs.c","lib/libc/dlfcn/dlfcn_stubs.c","dlctl",78,81
4,1,9,1,3,"dlerror@84-87@lib/libc/dlfcn/dlfcn_stubs.c","lib/libc/dlfcn/dlfcn_stubs.c","dlerror",84,87
8,2,50,2,9,"dl_iterate_phdr@90-99@lib/libc/dlfcn/dlfcn_stubs.c","lib/libc/dlfcn/dlfcn_stubs.c","dl_iterate_phdr",90,99
5,1,23,2,4,"dladdr@102-106@lib/libc/dlfcn/dlfcn_stubs.c","lib/libc/dlfcn/dlfcn_stubs.c","dladdr",102,106
4,1,11,1,3,"__tls_get_addr@121-124@lib/libc/dlfcn/dlfcn_stubs.c","lib/libc/dlfcn/dlfcn_stubs.c","__tls_get_addr",121,124
4,1,10,1,3,"___tls_get_addr@128-131@lib/libc/dlfcn/dlfcn_stubs.c","lib/libc/dlfcn/dlfcn_stubs.c","___tls_get_addr",128,131
38,13,217,3,55,"_csu_finish@75-130@lib/libc/dlfcn/init.c","lib/libc/dlfcn/init.c","_csu_finish",75,130
15,3,100,2,20,"early_static_init@138-158@lib/libc/dlfcn/init.c","lib/libc/dlfcn/init.c","early_static_init",138,158
40,12,291,2,67,"setup_static_tib@174-241@lib/libc/dlfcn/init.c","lib/libc/dlfcn/init.c","setup_static_tib",174,241
16,5,97,2,21,"_static_tls_init@244-265@lib/libc/dlfcn/init.c","lib/libc/dlfcn/init.c","_static_tls_init",244,265
21,7,141,1,31,"_dl_allocate_tib@41-72@lib/libc/dlfcn/tib.c","lib/libc/dlfcn/tib.c","_dl_allocate_tib",41,72
9,4,52,2,15,"_dl_free_tib@75-90@lib/libc/dlfcn/tib.c","lib/libc/dlfcn/tib.c","_dl_free_tib",75,90
18,3,96,1,23,"rv_alloc@42-65@lib/libc/gdtoa/dmisc.c","lib/libc/gdtoa/dmisc.c","rv_alloc",42,65
12,4,69,3,13,"nrv_alloc@71-84@lib/libc/gdtoa/dmisc.c","lib/libc/gdtoa/dmisc.c","nrv_alloc",71,84
8,2,60,1,10,"freedtoa@96-106@lib/libc/gdtoa/dmisc.c","lib/libc/gdtoa/dmisc.c","freedtoa",96,106
89,22,684,2,111,"quorem( b , S)@114-225@lib/libc/gdtoa/dmisc.c","lib/libc/gdtoa/dmisc.c","quorem( b , S)",114,225
552,228,3475,6,758,"dtoa( d0 , mode , ndigits , decpt , sign , rve)@81-839@lib/libc/gdtoa/dtoa.c","lib/libc/gdtoa/dtoa.c","dtoa( d0 , mode , ndigits , decpt , sign , rve)",81,839
34,8,209,3,39,"bitstob@38-77@lib/libc/gdtoa/gdtoa.c","lib/libc/gdtoa/gdtoa.c","bitstob",38,77
568,209,3490,8,709,"gdtoa( fpi , be , bits , kindp , mode , ndigits , decpt , rve)@120-829@lib/libc/gdtoa/gdtoa.c","lib/libc/gdtoa/gdtoa.c","gdtoa( fpi , be , bits , kindp , mode , ndigits , decpt , rve)",120,829
5,4,33,1,4,"switch@7-11@lib/libc/gdtoa/gdtoa_fltrnds.h","lib/libc/gdtoa/gdtoa_fltrnds.h","switch",7,11
5,1,23,1,4,"if@14-18@lib/libc/gdtoa/gdtoa_fltrnds.h","lib/libc/gdtoa/gdtoa_fltrnds.h","if",14,18
26,7,174,2,27,"rshift@38-65@lib/libc/gdtoa/gmisc.c","lib/libc/gdtoa/gmisc.c","rshift",38,65
14,4,80,1,15,"trailz@71-86@lib/libc/gdtoa/gmisc.c","lib/libc/gdtoa/gmisc.c","trailz",71,86
6,2,50,3,6,"htinit@40-46@lib/libc/gdtoa/hd_init.c","lib/libc/gdtoa/hd_init.c","htinit",40,46
6,1,40,1,6,"__hexdig_init_D2A@49-55@lib/libc/gdtoa/hd_init.c","lib/libc/gdtoa/hd_init.c","__hexdig_init_D2A",49,55
13,3,67,2,13,"roundup@49-62@lib/libc/gdtoa/hdtoa.c","lib/libc/gdtoa/hdtoa.c","roundup",49,62
24,11,128,4,25,"dorounding@71-96@lib/libc/gdtoa/hdtoa.c","lib/libc/gdtoa/hdtoa.c","dorounding",71,96
59,19,453,6,89,"__hdtoa@123-212@lib/libc/gdtoa/hdtoa.c","lib/libc/gdtoa/hdtoa.c","__hdtoa",123,212
67,23,510,6,101,"__hldtoa@221-322@lib/libc/gdtoa/hdtoa.c","lib/libc/gdtoa/hdtoa.c","__hldtoa",221,322
5,1,49,6,4,"__hldtoa@328-332@lib/libc/gdtoa/hdtoa.c","lib/libc/gdtoa/hdtoa.c","__hldtoa",328,332
11,2,64,3,12,"L_shift@38-50@lib/libc/gdtoa/hexnan.c","lib/libc/gdtoa/hexnan.c","L_shift",38,50
88,37,586,3,93,"hexnan@57-150@lib/libc/gdtoa/hexnan.c","lib/libc/gdtoa/hexnan.c","hexnan",57,150
46,9,258,6,59,"__ldtoa@47-106@lib/libc/gdtoa/ldtoa.c","lib/libc/gdtoa/ldtoa.c","__ldtoa",47,106
9,2,67,6,9,"__ldtoa@112-121@lib/libc/gdtoa/ldtoa.c","lib/libc/gdtoa/ldtoa.c","__ldtoa",112,121
32,7,216,1,40,"Balloc( k)@52-92@lib/libc/gdtoa/misc.c","lib/libc/gdtoa/misc.c","Balloc( k)",52,92
14,4,64,1,17,"Bfree( v)@99-116@lib/libc/gdtoa/misc.c","lib/libc/gdtoa/misc.c","Bfree( v)",99,116
40,10,182,1,41,"lo0bits( y)@123-164@lib/libc/gdtoa/misc.c","lib/libc/gdtoa/misc.c","lo0bits( y)",123,164
40,9,258,3,52,"multadd( b , m , a)@171-223@lib/libc/gdtoa/misc.c","lib/libc/gdtoa/misc.c","multadd( b , m , a)",171,223
26,7,120,1,27,"hi0bits_D2A( x)@230-257@lib/libc/gdtoa/misc.c","lib/libc/gdtoa/misc.c","hi0bits_D2A( x)",230,257
10,2,46,1,11,"i2b( i)@264-275@lib/libc/gdtoa/misc.c","lib/libc/gdtoa/misc.c","i2b( i)",264,275
93,22,633,2,105,"mult( a , b)@282-387@lib/libc/gdtoa/misc.c","lib/libc/gdtoa/misc.c","mult( a , b)",282,387
54,18,337,2,63,"pow5mult( b , k)@396-459@lib/libc/gdtoa/misc.c","lib/libc/gdtoa/misc.c","pow5mult( b , k)",396,459
45,11,284,2,49,"lshift( b , k)@466-515@lib/libc/gdtoa/misc.c","lib/libc/gdtoa/misc.c","lshift( b , k)",466,515
24,11,156,2,27,"cmp( a , b)@522-549@lib/libc/gdtoa/misc.c","lib/libc/gdtoa/misc.c","cmp( a , b)",522,549
79,16,518,2,91,"diff( a , b)@556-647@lib/libc/gdtoa/misc.c","lib/libc/gdtoa/misc.c","diff( a , b)",556,647
47,18,434,2,60,"b2d( a , e)@654-714@lib/libc/gdtoa/misc.c","lib/libc/gdtoa/misc.c","b2d( a , e)",654,714
93,21,675,3,131,"d2b( dd , e , bits)@723-854@lib/libc/gdtoa/misc.c","lib/libc/gdtoa/misc.c","d2b( dd , e , bits)",723,854
6,2,29,2,6,"strcp_D2A@889-895@lib/libc/gdtoa/misc.c","lib/libc/gdtoa/misc.c","strcp_D2A",889,895
8,2,63,3,8,"memcpy_D2A@901-909@lib/libc/gdtoa/misc.c","lib/libc/gdtoa/misc.c","memcpy_D2A",901,909
36,11,258,5,41,"s2b( s , nd0 , nd , y9 , dplen)@39-80@lib/libc/gdtoa/smisc.c","lib/libc/gdtoa/smisc.c","s2b( s , nd0 , nd , y9 , dplen)",39,80
26,6,196,2,30,"ratio( a , b)@87-117@lib/libc/gdtoa/smisc.c","lib/libc/gdtoa/smisc.c","ratio( a , b)",87,117
13,5,80,2,14,"match( sp , t)@126-140@lib/libc/gdtoa/smisc.c","lib/libc/gdtoa/smisc.c","match( sp , t)",126,140
18,7,144,3,24,"copybits@147-171@lib/libc/gdtoa/smisc.c","lib/libc/gdtoa/smisc.c","copybits",147,171
23,7,124,2,24,"any_on@177-201@lib/libc/gdtoa/smisc.c","lib/libc/gdtoa/smisc.c","any_on",177,201
12,3,90,2,13,"sulp( x , scale)@66-79@lib/libc/gdtoa/strtod.c","lib/libc/gdtoa/strtod.c","sulp( x , scale)",66,79
35,10,185,1,41,"increment@51-92@lib/libc/gdtoa/strtodg.c","lib/libc/gdtoa/strtodg.c","increment",51,92
20,7,102,1,26,"decrement@98-124@lib/libc/gdtoa/strtodg.c","lib/libc/gdtoa/strtodg.c","decrement",98,124
12,4,83,2,13,"all_on@130-143@lib/libc/gdtoa/strtodg.c","lib/libc/gdtoa/strtodg.c","all_on",130,143
23,6,137,2,24,"set_ones@149-173@lib/libc/gdtoa/strtodg.c","lib/libc/gdtoa/strtodg.c","set_ones",149,173
121,35,675,7,130,"rvOK( d , fpi , exp , bits , exact , rd , irv)@181-311@lib/libc/gdtoa/strtodg.c","lib/libc/gdtoa/strtodg.c","rvOK( d , fpi , exp , bits , exact , rd , irv)",181,311
11,5,94,1,17,"mantbits@317-334@lib/libc/gdtoa/strtodg.c","lib/libc/gdtoa/strtodg.c","mantbits",317,334
33,11,216,2,43,"strtof@38-81@lib/libc/gdtoa/strtof.c","lib/libc/gdtoa/strtof.c","strtof",38,81
4,1,23,2,3,"strtold@37-40@lib/libc/gdtoa/strtold.c","lib/libc/gdtoa/strtold.c","strtold",37,40
35,10,245,4,40,"ULtoQ@56-96@lib/libc/gdtoa/strtorQ.c","lib/libc/gdtoa/strtorQ.c","ULtoQ",56,96
17,2,127,4,18,"strtorQ@102-120@lib/libc/gdtoa/strtorQ.c","lib/libc/gdtoa/strtorQ.c","strtorQ",102,120
29,10,171,4,34,"ULtod@38-72@lib/libc/gdtoa/strtord.c","lib/libc/gdtoa/strtord.c","ULtod",38,72
17,2,127,4,18,"strtord@78-96@lib/libc/gdtoa/strtord.c","lib/libc/gdtoa/strtord.c","strtord",78,96
36,10,250,4,41,"ULtox@58-99@lib/libc/gdtoa/strtorx.c","lib/libc/gdtoa/strtorx.c","ULtox",58,99
17,2,127,4,18,"strtorx@105-123@lib/libc/gdtoa/strtorx.c","lib/libc/gdtoa/strtorx.c","strtorx",105,123
58,12,428,2,64,"sum@38-102@lib/libc/gdtoa/sum.c","lib/libc/gdtoa/sum.c","sum",38,102
24,5,144,1,31,"ulp( x)@39-70@lib/libc/gdtoa/ulp.c","lib/libc/gdtoa/ulp.c","ulp( x)",39,70
13,3,94,1,13,"alarm@35-48@lib/libc/gen/alarm.c","lib/libc/gen/alarm.c","alarm",35,48
7,1,37,3,7,"__assert@37-44@lib/libc/gen/assert.c","lib/libc/gen/assert.c","__assert",37,44
7,1,44,4,7,"__assert2@47-54@lib/libc/gen/assert.c","lib/libc/gen/assert.c","__assert2",47,54
1,1,17,2,0,"auth_setstate@150-150@lib/libc/gen/auth_subr.c","lib/libc/gen/auth_subr.c","auth_setstate",150,150
1,1,20,2,0,"auth_set_va_list@151-151@lib/libc/gen/auth_subr.c","lib/libc/gen/auth_subr.c","auth_set_va_list",151,151
1,1,15,1,0,"auth_getstate@152-152@lib/libc/gen/auth_subr.c","lib/libc/gen/auth_subr.c","auth_getstate",152,152
1,1,15,1,0,"auth_getpwd@153-153@lib/libc/gen/auth_subr.c","lib/libc/gen/auth_subr.c","auth_getpwd",153,153
9,2,48,1,10,"auth_open@164-174@lib/libc/gen/auth_subr.c","lib/libc/gen/auth_subr.c","auth_open",164,174
28,6,188,1,40,"auth_clean@181-221@lib/libc/gen/auth_subr.c","lib/libc/gen/auth_subr.c","auth_clean",181,221
40,10,266,1,65,"auth_close@229-294@lib/libc/gen/auth_subr.c","lib/libc/gen/auth_subr.c","auth_close",229,294
20,7,163,1,24,"auth_challenge@302-326@lib/libc/gen/auth_subr.c","lib/libc/gen/auth_subr.c","auth_challenge",302,326
43,18,341,1,48,"auth_setenv@335-383@lib/libc/gen/auth_subr.c","lib/libc/gen/auth_subr.c","auth_setenv",335,383
18,7,163,1,18,"auth_clrenv@390-408@lib/libc/gen/auth_subr.c","lib/libc/gen/auth_subr.c","auth_clrenv",390,408
22,10,108,2,21,"auth_getitem@412-433@lib/libc/gen/auth_subr.c","lib/libc/gen/auth_subr.c","auth_getitem",412,433
74,27,480,3,81,"auth_setitem@437-518@lib/libc/gen/auth_subr.c","lib/libc/gen/auth_subr.c","auth_setitem",437,518
18,4,141,3,20,"auth_setoption@522-542@lib/libc/gen/auth_subr.c","lib/libc/gen/auth_subr.c","auth_setoption",522,542
8,2,40,1,8,"auth_clroptions@546-554@lib/libc/gen/auth_subr.c","lib/libc/gen/auth_subr.c","auth_clroptions",546,554
23,9,166,2,26,"auth_clroption@558-584@lib/libc/gen/auth_subr.c","lib/libc/gen/auth_subr.c","auth_clroption",558,584
20,5,139,3,23,"auth_setdata@588-611@lib/libc/gen/auth_subr.c","lib/libc/gen/auth_subr.c","auth_setdata",588,611
31,14,240,2,41,"auth_setpwd@615-656@lib/libc/gen/auth_subr.c","lib/libc/gen/auth_subr.c","auth_setpwd",615,656
64,25,384,2,73,"auth_getvalue@660-733@lib/libc/gen/auth_subr.c","lib/libc/gen/auth_subr.c","auth_getvalue",660,733
22,9,183,1,23,"auth_check_expire@737-760@lib/libc/gen/auth_subr.c","lib/libc/gen/auth_subr.c","auth_check_expire",737,760
22,9,178,1,23,"auth_check_change@764-787@lib/libc/gen/auth_subr.c","lib/libc/gen/auth_subr.c","auth_check_change",764,787
168,54,1212,3,195,"auth_call@801-996@lib/libc/gen/auth_subr.c","lib/libc/gen/auth_subr.c","auth_call",801,996
36,9,250,2,36,"_recv_fd@1000-1036@lib/libc/gen/auth_subr.c","lib/libc/gen/auth_subr.c","_recv_fd",1000,1036
25,6,175,2,32,"_auth_spool@1039-1071@lib/libc/gen/auth_subr.c","lib/libc/gen/auth_subr.c","_auth_spool",1039,1071
13,2,96,2,15,"_add_rmlist@1074-1089@lib/libc/gen/auth_subr.c","lib/libc/gen/auth_subr.c","_add_rmlist",1074,1089
17,5,159,1,17,"_auth_next_arg@1092-1109@lib/libc/gen/auth_subr.c","lib/libc/gen/auth_subr.c","_auth_next_arg",1092,1109
40,10,234,1,44,"auth_mkvalue@58-102@lib/libc/gen/authenticate.c","lib/libc/gen/authenticate.c","auth_mkvalue",58,102
5,2,22,1,4,"auth_checknologin@106-110@lib/libc/gen/authenticate.c","lib/libc/gen/authenticate.c","auth_checknologin",106,110
33,13,182,2,45,"_auth_checknologin@114-159@lib/libc/gen/authenticate.c","lib/libc/gen/authenticate.c","_auth_checknologin",114,159
11,3,89,1,11,"auth_cat@162-173@lib/libc/gen/authenticate.c","lib/libc/gen/authenticate.c","auth_cat",162,173
113,39,806,4,127,"auth_approval@177-304@lib/libc/gen/authenticate.c","lib/libc/gen/authenticate.c","auth_approval",177,304
42,10,344,4,54,"auth_usercheck@308-362@lib/libc/gen/authenticate.c","lib/libc/gen/authenticate.c","auth_usercheck",308,362
6,2,51,4,7,"auth_userokay@366-373@lib/libc/gen/authenticate.c","lib/libc/gen/authenticate.c","auth_userokay",366,373
39,12,320,4,50,"auth_userchallenge@377-427@lib/libc/gen/authenticate.c","lib/libc/gen/authenticate.c","auth_userchallenge",377,427
38,12,302,3,48,"auth_userresponse@431-479@lib/libc/gen/authenticate.c","lib/libc/gen/authenticate.c","auth_userresponse",431,479
23,9,208,4,28,"auth_verify@492-520@lib/libc/gen/authenticate.c","lib/libc/gen/authenticate.c","auth_verify",492,520
30,10,187,1,38,"basename@25-63@lib/libc/gen/basename.c","lib/libc/gen/basename.c","basename",25,63
7,2,53,1,7,"clock@42-49@lib/libc/gen/clock.c","lib/libc/gen/clock.c","clock",42,49
7,3,38,2,7,"clock_getcpuclockid@24-31@lib/libc/gen/clock_getcpuclockid.c","lib/libc/gen/clock_getcpuclockid.c","clock_getcpuclockid",24,31
12,1,68,1,12,"closedir@42-54@lib/libc/gen/closedir.c","lib/libc/gen/closedir.c","closedir",42,54
55,37,249,3,71,"confstr@56-127@lib/libc/gen/confstr.c","lib/libc/gen/confstr.c","confstr",56,127
9,2,44,1,9,"ctermid@36-45@lib/libc/gen/ctermid.c","lib/libc/gen/ctermid.c","ctermid",36,45
24,7,143,2,27,"daemon@37-64@lib/libc/gen/daemon.c","lib/libc/gen/daemon.c","daemon",37,64
22,8,157,2,22,"devname_nodb@44-66@lib/libc/gen/devname.c","lib/libc/gen/devname.c","devname_nodb",44,66
27,7,171,2,28,"devname@74-102@lib/libc/gen/devname.c","lib/libc/gen/devname.c","devname",74,102
4,1,15,1,3,"dirfd@10-13@lib/libc/gen/dirfd.c","lib/libc/gen/dirfd.c","dirfd",10,13
33,12,199,1,42,"dirname@27-69@lib/libc/gen/dirname.c","lib/libc/gen/dirname.c","dirname",27,69
79,14,698,1,97,"getdiskbyname@48-145@lib/libc/gen/disklabel.c","lib/libc/gen/disklabel.c","getdiskbyname",48,145
10,4,80,2,10,"gettype@148-158@lib/libc/gen/disklabel.c","lib/libc/gen/disklabel.c","gettype",148,158
7,1,38,3,7,"err@35-42@lib/libc/gen/err.c","lib/libc/gen/err.c","err",35,42
7,1,43,4,7,"errc@35-42@lib/libc/gen/errc.c","lib/libc/gen/errc.c","errc",35,42
4,1,16,1,3,"__errno@18-21@lib/libc/gen/errno.c","lib/libc/gen/errno.c","__errno",18,21
6,2,26,1,5,"single_threaded_tcb@40-45@lib/libc/gen/errno.c","lib/libc/gen/errno.c","single_threaded_tcb",40,45
4,1,17,1,3,"single_threaded_errnoptr@48-51@lib/libc/gen/errno.c","lib/libc/gen/errno.c","single_threaded_errnoptr",48,51
4,1,15,1,3,"__errno@57-60@lib/libc/gen/errno.c","lib/libc/gen/errno.c","__errno",57,60
7,1,38,3,7,"errx@35-42@lib/libc/gen/errx.c","lib/libc/gen/errx.c","errx",35,42
23,4,153,3,23,"execl@44-67@lib/libc/gen/exec.c","lib/libc/gen/exec.c","execl",44,67
24,4,166,3,24,"execle@71-95@lib/libc/gen/exec.c","lib/libc/gen/exec.c","execle",71,95
23,4,151,3,23,"execlp@98-121@lib/libc/gen/exec.c","lib/libc/gen/exec.c","execlp",98,121
5,1,33,2,4,"execv@124-128@lib/libc/gen/exec.c","lib/libc/gen/exec.c","execv",124,128
90,23,543,3,112,"execvpe@131-243@lib/libc/gen/exec.c","lib/libc/gen/exec.c","execvpe",131,243
4,1,25,2,3,"execvp@247-250@lib/libc/gen/exec.c","lib/libc/gen/exec.c","execvp",247,250
4,1,15,1,3,"fdatasync@10-13@lib/libc/gen/fdatasync.c","lib/libc/gen/fdatasync.c","fdatasync",10,13
33,12,228,4,36,"classmatch@99-135@lib/libc/gen/fnmatch.c","lib/libc/gen/fnmatch.c","classmatch",99,135
94,52,679,3,137,"fnmatch_ch@144-281@lib/libc/gen/fnmatch.c","lib/libc/gen/fnmatch.c","fnmatch_ch",144,281
116,74,778,3,205,"fnmatch@284-489@lib/libc/gen/fnmatch.c","lib/libc/gen/fnmatch.c","fnmatch",284,489
17,7,85,1,19,"__fpclassify@24-43@lib/libc/gen/fpclassify.c","lib/libc/gen/fpclassify.c","__fpclassify",24,43
17,5,73,1,19,"__fpclassifyf@47-66@lib/libc/gen/fpclassify.c","lib/libc/gen/fpclassify.c","__fpclassifyf",47,66
26,4,148,2,30,"frexp@37-67@lib/libc/gen/frexp.c","lib/libc/gen/frexp.c","frexp",37,67
98,29,634,1,102,"fstabscan@49-151@lib/libc/gen/fstab.c","lib/libc/gen/fstab.c","fstabscan",49,151
6,4,34,1,5,"getfsent@154-159@lib/libc/gen/fstab.c","lib/libc/gen/fstab.c","getfsent",154,159
8,4,44,1,7,"getfsspec@162-169@lib/libc/gen/fstab.c","lib/libc/gen/fstab.c","getfsspec",162,169
8,4,44,1,7,"getfsfile@172-179@lib/libc/gen/fstab.c","lib/libc/gen/fstab.c","getfsfile",172,179
18,6,97,1,21,"setfsent@182-203@lib/libc/gen/fstab.c","lib/libc/gen/fstab.c","setfsent",182,203
7,2,24,1,6,"endfsent@207-213@lib/libc/gen/fstab.c","lib/libc/gen/fstab.c","endfsent",207,213
8,2,69,2,9,"ftok@33-42@lib/libc/gen/ftok.c","lib/libc/gen/ftok.c","ftok",33,42
65,17,460,3,105,"fts_open@71-176@lib/libc/gen/fts.c","lib/libc/gen/fts.c","fts_open",71,176
14,4,121,2,21,"fts_load@180-201@lib/libc/gen/fts.c","lib/libc/gen/fts.c","fts_load",180,201
27,7,161,1,39,"fts_close@204-243@lib/libc/gen/fts.c","lib/libc/gen/fts.c","fts_close",204,243
125,39,857,1,186,"fts_read@255-441@lib/libc/gen/fts.c","lib/libc/gen/fts.c","fts_read",255,441
10,6,57,3,9,"fts_set@451-460@lib/libc/gen/fts.c","lib/libc/gen/fts.c","fts_set",451,460
36,13,228,2,65,"fts_children@464-529@lib/libc/gen/fts.c","lib/libc/gen/fts.c","fts_children",464,529
153,52,996,2,244,"fts_build@547-791@lib/libc/gen/fts.c","lib/libc/gen/fts.c","fts_build",547,791
49,15,327,4,73,"fts_stat@794-867@lib/libc/gen/fts.c","lib/libc/gen/fts.c","fts_stat",794,867
23,5,192,3,31,"fts_sort@870-901@lib/libc/gen/fts.c","lib/libc/gen/fts.c","fts_sort",870,901
17,4,133,3,27,"fts_alloc@904-931@lib/libc/gen/fts.c","lib/libc/gen/fts.c","fts_alloc",904,931
8,2,33,1,9,"fts_lfree@934-943@lib/libc/gen/fts.c","lib/libc/gen/fts.c","fts_lfree",934,943
21,3,119,2,24,"fts_palloc@952-976@lib/libc/gen/fts.c","lib/libc/gen/fts.c","fts_palloc",952,976
11,4,79,2,21,"fts_padjust@983-1004@lib/libc/gen/fts.c","lib/libc/gen/fts.c","fts_padjust",983,1004
8,3,52,1,8,"fts_maxarglen@1007-1015@lib/libc/gen/fts.c","lib/libc/gen/fts.c","fts_maxarglen",1007,1015
26,7,163,4,26,"fts_safe_changedir@1023-1049@lib/libc/gen/fts.c","lib/libc/gen/fts.c","fts_safe_changedir",1023,1049
54,18,270,3,58,"ftw@31-89@lib/libc/gen/ftw.c","lib/libc/gen/ftw.c","ftw",31,89
59,18,340,2,64,"getbsize@37-101@lib/libc/gen/getbsize.c","lib/libc/gen/getbsize.c","getbsize",37,101
6,1,21,1,6,"cgetusedb@72-78@lib/libc/gen/getcap.c","lib/libc/gen/getcap.c","cgetusedb",72,78
15,3,83,1,14,"cgetset@87-101@lib/libc/gen/getcap.c","lib/libc/gen/getcap.c","cgetset",87,101
29,14,161,3,39,"cgetcap@117-156@lib/libc/gen/getcap.c","lib/libc/gen/getcap.c","cgetcap",117,156
5,1,41,3,5,"cgetent@169-174@lib/libc/gen/getcap.c","lib/libc/gen/getcap.c","cgetent",169,174
243,58,1378,7,355,"getent@196-551@lib/libc/gen/getcap.c","lib/libc/gen/getcap.c","getent",196,551
20,6,166,3,26,"cdbget@554-580@lib/libc/gen/getcap.c","lib/libc/gen/getcap.c","cdbget",554,580
27,13,139,2,37,"cgetmatch@587-624@lib/libc/gen/getcap.c","lib/libc/gen/getcap.c","cgetmatch",587,624
5,1,29,2,5,"cgetfirst@628-633@lib/libc/gen/getcap.c","lib/libc/gen/getcap.c","cgetfirst",628,633
11,2,43,1,11,"cgetclose@641-652@lib/libc/gen/getcap.c","lib/libc/gen/getcap.c","cgetclose",641,652
97,23,554,2,142,"cgetnext@661-803@lib/libc/gen/getcap.c","lib/libc/gen/getcap.c","cgetnext",661,803
87,34,497,3,118,"cgetstr@816-934@lib/libc/gen/getcap.c","lib/libc/gen/getcap.c","cgetstr",816,934
41,9,245,3,67,"cgetustr@948-1015@lib/libc/gen/getcap.c","lib/libc/gen/getcap.c","cgetustr",948,1015
35,13,201,3,55,"cgetnum@1025-1080@lib/libc/gen/getcap.c","lib/libc/gen/getcap.c","cgetnum",1025,1080
12,2,78,2,14,"nfcmp@1087-1101@lib/libc/gen/getcap.c","lib/libc/gen/getcap.c","nfcmp",1087,1101
16,5,93,2,19,"getcwd@28-47@lib/libc/gen/getcwd.c","lib/libc/gen/getcwd.c","getcwd",28,47
11,2,70,2,11,"getdomainname@36-47@lib/libc/gen/getdomainname.c","lib/libc/gen/getdomainname.c","getdomainname",36,47
11,4,93,1,11,"_getgrent_yp@82-93@lib/libc/gen/getgrent.c","lib/libc/gen/getgrent.c","_getgrent_yp",82,93
4,1,14,1,3,"getgrent@96-99@lib/libc/gen/getgrent.c","lib/libc/gen/getgrent.c","getgrent",96,99
14,4,81,3,14,"getgrnam_gs@102-116@lib/libc/gen/getgrent.c","lib/libc/gen/getgrent.c","getgrnam_gs",102,116
7,1,57,1,7,"getgrnam@119-126@lib/libc/gen/getgrent.c","lib/libc/gen/getgrent.c","getgrnam",119,126
17,3,89,5,17,"getgrnam_r@129-146@lib/libc/gen/getgrent.c","lib/libc/gen/getgrent.c","getgrnam_r",129,146
14,4,79,3,14,"getgrgid_gs@149-163@lib/libc/gen/getgrent.c","lib/libc/gen/getgrent.c","getgrgid_gs",149,163
7,1,55,1,7,"getgrgid@166-173@lib/libc/gen/getgrent.c","lib/libc/gen/getgrent.c","getgrgid",166,173
17,3,87,5,17,"getgrgid_r@176-193@lib/libc/gen/getgrent.c","lib/libc/gen/getgrent.c","getgrgid_r",176,193
15,6,77,1,23,"start_gr@197-220@lib/libc/gen/getgrent.c","lib/libc/gen/getgrent.c","start_gr",197,220
7,1,22,1,7,"setgrent@223-230@lib/libc/gen/getgrent.c","lib/libc/gen/getgrent.c","setgrent",223,230
13,2,47,1,13,"setgroupent@234-247@lib/libc/gen/getgrent.c","lib/libc/gen/getgrent.c","setgroupent",234,247
16,4,59,1,18,"endgrent_basic@252-270@lib/libc/gen/getgrent.c","lib/libc/gen/getgrent.c","endgrent_basic",252,270
6,1,20,1,5,"endgrent@273-278@lib/libc/gen/getgrent.c","lib/libc/gen/getgrent.c","endgrent",273,278
196,71,1078,6,210,"grscan@282-492@lib/libc/gen/getgrent.c","lib/libc/gen/getgrent.c","grscan",282,492
34,12,218,5,41,"_parse_netid@62-103@lib/libc/gen/getgrouplist.c","lib/libc/gen/getgrouplist.c","_parse_netid",62,103
30,9,184,5,30,"_read_netid@110-140@lib/libc/gen/getgrouplist.c","lib/libc/gen/getgrouplist.c","_read_netid",110,140
76,27,486,4,104,"getgrouplist@144-248@lib/libc/gen/getgrouplist.c","lib/libc/gen/getgrouplist.c","getgrouplist",144,248
11,2,70,2,11,"gethostname@36-47@lib/libc/gen/gethostname.c","lib/libc/gen/gethostname.c","gethostname",36,47
15,3,131,2,16,"getloadavg@46-62@lib/libc/gen/getloadavg.c","lib/libc/gen/getloadavg.c","getloadavg",46,62
13,3,53,1,13,"getlogin@39-52@lib/libc/gen/getlogin.c","lib/libc/gen/getlogin.c","getlogin",39,52
22,6,167,2,22,"getmntinfo@39-61@lib/libc/gen/getmntinfo.c","lib/libc/gen/getmntinfo.c","getmntinfo",39,61
14,3,79,1,14,"_ng_sl_init@90-104@lib/libc/gen/getnetgrent.c","lib/libc/gen/getnetgrent.c","_ng_sl_init",90,104
16,3,102,2,16,"_ng_sl_add@111-127@lib/libc/gen/getnetgrent.c","lib/libc/gen/getnetgrent.c","_ng_sl_add",111,127
9,3,56,2,9,"_ng_sl_free@134-143@lib/libc/gen/getnetgrent.c","lib/libc/gen/getnetgrent.c","_ng_sl_free",134,143
8,3,58,2,9,"_ng_sl_find@150-159@lib/libc/gen/getnetgrent.c","lib/libc/gen/getnetgrent.c","_ng_sl_find",150,159
26,12,185,3,35,"getstring@167-202@lib/libc/gen/getnetgrent.c","lib/libc/gen/getnetgrent.c","getstring",167,202
26,6,151,1,33,"getnetgroup@209-242@lib/libc/gen/getnetgrent.c","lib/libc/gen/getnetgrent.c","getnetgroup",209,242
46,14,245,4,60,"lookup@250-310@lib/libc/gen/getnetgrent.c","lib/libc/gen/getnetgrent.c","lookup",250,310
29,11,181,3,33,"_ng_parse@321-354@lib/libc/gen/getnetgrent.c","lib/libc/gen/getnetgrent.c","_ng_parse",321,354
35,10,181,3,49,"addgroup@361-410@lib/libc/gen/getnetgrent.c","lib/libc/gen/getnetgrent.c","addgroup",361,410
14,10,117,4,16,"in_check@417-433@lib/libc/gen/getnetgrent.c","lib/libc/gen/getnetgrent.c","in_check",417,433
48,12,270,6,61,"in_find@440-501@lib/libc/gen/getnetgrent.c","lib/libc/gen/getnetgrent.c","in_find",440,501
13,4,82,3,14,"_ng_makekey@509-523@lib/libc/gen/getnetgrent.c","lib/libc/gen/getnetgrent.c","_ng_makekey",509,523
5,1,50,3,4,"_ng_print@526-530@lib/libc/gen/getnetgrent.c","lib/libc/gen/getnetgrent.c","_ng_print",526,530
14,5,108,4,14,"in_lookup1@537-551@lib/libc/gen/getnetgrent.c","lib/libc/gen/getnetgrent.c","in_lookup1",537,551
27,10,219,5,37,"in_lookup@558-595@lib/libc/gen/getnetgrent.c","lib/libc/gen/getnetgrent.c","in_lookup",558,595
14,3,76,1,14,"endnetgrent@599-613@lib/libc/gen/getnetgrent.c","lib/libc/gen/getnetgrent.c","endnetgrent",599,613
22,9,137,1,34,"setnetgrent@618-652@lib/libc/gen/getnetgrent.c","lib/libc/gen/getnetgrent.c","setnetgrent",618,652
10,2,58,3,12,"getnetgrent@657-669@lib/libc/gen/getnetgrent.c","lib/libc/gen/getnetgrent.c","getnetgrent",657,669
32,14,236,4,49,"innetgr@674-723@lib/libc/gen/getnetgrent.c","lib/libc/gen/getnetgrent.c","innetgr",674,723
13,3,75,1,13,"getpagesize@36-49@lib/libc/gen/getpagesize.c","lib/libc/gen/getpagesize.c","getpagesize",36,49
4,1,11,1,3,"getprogname@21-24@lib/libc/gen/getprogname.c","lib/libc/gen/getprogname.c","getprogname",21,24
48,11,453,4,73,"__ypproto_set@105-178@lib/libc/gen/getpwent.c","lib/libc/gen/getpwent.c","__ypproto_set",105,178
62,28,505,3,70,"__ypparse@181-251@lib/libc/gen/getpwent.c","lib/libc/gen/getpwent.c","__ypparse",181,251
156,39,833,1,179,"getpwent@255-434@lib/libc/gen/getpwent.c","lib/libc/gen/getpwent.c","getpwent",255,434
15,3,119,1,18,"__has_yppw@442-460@lib/libc/gen/getpwent.c","lib/libc/gen/getpwent.c","__has_yppw",442,460
37,8,192,1,45,"__has_ypmaster@466-511@lib/libc/gen/getpwent.c","lib/libc/gen/getpwent.c","__has_ypmaster",466,511
134,37,784,7,141,"__yppwlookup@514-655@lib/libc/gen/getpwent.c","lib/libc/gen/getpwent.c","__yppwlookup",514,655
19,3,138,5,19,"_pwhashbyname@659-678@lib/libc/gen/getpwent.c","lib/libc/gen/getpwent.c","_pwhashbyname",659,678
15,2,115,5,15,"_pwhashbyuid@681-696@lib/libc/gen/getpwent.c","lib/libc/gen/getpwent.c","_pwhashbyuid",681,696
36,10,214,6,41,"getpwnam_internal@699-740@lib/libc/gen/getpwent.c","lib/libc/gen/getpwent.c","getpwnam_internal",699,740
5,1,42,5,4,"getpwnam_r@743-747@lib/libc/gen/getpwent.c","lib/libc/gen/getpwent.c","getpwnam_r",743,747
12,2,56,1,12,"getpwnam@751-763@lib/libc/gen/getpwent.c","lib/libc/gen/getpwent.c","getpwnam",751,763
12,2,58,1,12,"getpwnam_shadow@766-778@lib/libc/gen/getpwent.c","lib/libc/gen/getpwent.c","getpwnam_shadow",766,778
36,10,208,6,41,"getpwuid_internal@782-823@lib/libc/gen/getpwent.c","lib/libc/gen/getpwent.c","getpwuid_internal",782,823
5,1,40,5,4,"getpwuid_r@827-831@lib/libc/gen/getpwent.c","lib/libc/gen/getpwent.c","getpwuid_r",827,831
12,2,54,1,12,"getpwuid@835-847@lib/libc/gen/getpwent.c","lib/libc/gen/getpwent.c","getpwuid",835,847
12,2,56,1,12,"getpwuid_shadow@850-862@lib/libc/gen/getpwent.c","lib/libc/gen/getpwent.c","getpwuid_shadow",850,862
13,2,53,1,14,"setpassent@866-880@lib/libc/gen/getpwent.c","lib/libc/gen/getpwent.c","setpassent",866,880
4,1,14,1,3,"setpwent@884-887@lib/libc/gen/getpwent.c","lib/libc/gen/getpwent.c","setpwent",884,887
18,3,76,1,20,"endpwent@890-910@lib/libc/gen/getpwent.c","lib/libc/gen/getpwent.c","endpwent",890,910
22,6,113,1,28,"__initdb@913-941@lib/libc/gen/getpwent.c","lib/libc/gen/getpwent.c","__initdb",913,941
34,4,292,5,38,"__hashpw@944-982@lib/libc/gen/getpwent.c","lib/libc/gen/getpwent.c","__hashpw",944,982
10,3,51,1,10,"getttynam@43-53@lib/libc/gen/getttyent.c","lib/libc/gen/getttyent.c","getttynam",43,53
65,28,418,1,73,"getttyent@56-129@lib/libc/gen/getttyent.c","lib/libc/gen/getttyent.c","getttyent",56,129
30,14,173,1,30,"skip@139-169@lib/libc/gen/getttyent.c","lib/libc/gen/getttyent.c","skip",139,169
4,2,27,1,4,"value@172-176@lib/libc/gen/getttyent.c","lib/libc/gen/getttyent.c","value",172,176
9,3,46,1,9,"setttyent@179-188@lib/libc/gen/getttyent.c","lib/libc/gen/getttyent.c","setttyent",179,188
10,2,41,1,10,"endttyent@192-202@lib/libc/gen/getttyent.c","lib/libc/gen/getttyent.c","endttyent",192,202
10,3,41,1,10,"getusershell@53-63@lib/libc/gen/getusershell.c","lib/libc/gen/getusershell.c","getusershell",53,63
10,3,43,1,11,"endusershell@66-77@lib/libc/gen/getusershell.c","lib/libc/gen/getusershell.c","endusershell",66,77
4,1,12,1,4,"setusershell@80-84@lib/libc/gen/getusershell.c","lib/libc/gen/getusershell.c","setusershell",80,84
44,9,262,1,48,"initshells@87-135@lib/libc/gen/getusershell.c","lib/libc/gen/getusershell.c","initshells",87,135
46,15,327,4,51,"glob@167-218@lib/libc/gen/glob.c","lib/libc/gen/glob.c","glob",167,218
9,5,100,3,12,"globexp1@226-238@lib/libc/gen/glob.c","lib/libc/gen/glob.c","globexp1",226,238
65,28,390,4,97,"globexp2@247-344@lib/libc/gen/glob.c","lib/libc/gen/glob.c","globexp2",247,344
39,16,302,4,58,"globtilde@352-410@lib/libc/gen/glob.c","lib/libc/gen/glob.c","globtilde",352,410
12,4,67,3,12,"g_strncmp@413-425@lib/libc/gen/glob.c","lib/libc/gen/glob.c","g_strncmp",413,425
22,7,171,2,24,"g_charclass@428-452@lib/libc/gen/glob.c","lib/libc/gen/glob.c","g_charclass",428,452
103,33,698,3,120,"glob0@462-582@lib/libc/gen/glob.c","lib/libc/gen/glob.c","glob0",462,582
4,1,34,2,3,"compare@585-588@lib/libc/gen/glob.c","lib/libc/gen/glob.c","compare",585,588
6,1,56,2,6,"compare_gps@591-597@lib/libc/gen/glob.c","lib/libc/gen/glob.c","compare_gps",591,597
9,2,69,4,10,"glob1@600-610@lib/libc/gen/glob.c","lib/libc/gen/glob.c","glob1",600,610
54,20,361,8,65,"glob2@618-683@lib/libc/gen/glob.c","lib/libc/gen/glob.c","glob2",618,683
65,18,409,9,82,"glob3@686-768@lib/libc/gen/glob.c","lib/libc/gen/glob.c","glob3",686,768
86,31,647,4,92,"globextend@786-878@lib/libc/gen/glob.c","lib/libc/gen/glob.c","globextend",786,878
64,24,348,3,65,"match@893-958@lib/libc/gen/glob.c","lib/libc/gen/glob.c","match",893,958
19,5,118,1,19,"globfree@962-981@lib/libc/gen/glob.c","lib/libc/gen/glob.c","globfree",962,981
13,4,85,2,15,"g_opendir@984-999@lib/libc/gen/glob.c","lib/libc/gen/glob.c","g_opendir",984,999
9,3,76,3,9,"g_lstat@1002-1011@lib/libc/gen/glob.c","lib/libc/gen/glob.c","g_lstat",1002,1011
9,3,76,3,9,"g_stat@1014-1023@lib/libc/gen/glob.c","lib/libc/gen/glob.c","g_stat",1014,1023
8,3,43,2,7,"g_strchr@1026-1033@lib/libc/gen/glob.c","lib/libc/gen/glob.c","g_strchr",1026,1033
8,3,47,3,8,"g_Ctoc@1036-1044@lib/libc/gen/glob.c","lib/libc/gen/glob.c","g_Ctoc",1036,1044
14,6,136,2,14,"qprintf@1048-1062@lib/libc/gen/glob.c","lib/libc/gen/glob.c","qprintf",1048,1062
10,2,62,2,10,"initgroups@37-47@lib/libc/gen/initgroups.c","lib/libc/gen/initgroups.c","initgroups",37,47
4,1,18,1,3,"isatty@35-38@lib/libc/gen/isatty.c","lib/libc/gen/isatty.c","isatty",35,38
6,3,41,1,6,"__isinf@24-30@lib/libc/gen/isinf.c","lib/libc/gen/isinf.c","__isinf",24,30
5,2,35,1,5,"__isinff@33-38@lib/libc/gen/isinf.c","lib/libc/gen/isinf.c","__isinff",33,38
4,2,39,1,3,"isalnum@42-45@lib/libc/gen/isctype.c","lib/libc/gen/isctype.c","isalnum",42,45
4,2,37,1,3,"isalpha@50-53@lib/libc/gen/isctype.c","lib/libc/gen/isctype.c","isalpha",50,53
4,2,18,1,3,"isblank@58-61@lib/libc/gen/isctype.c","lib/libc/gen/isctype.c","isblank",58,61
4,2,33,1,3,"iscntrl@66-69@lib/libc/gen/isctype.c","lib/libc/gen/isctype.c","iscntrl",66,69
4,2,33,1,3,"isdigit@74-77@lib/libc/gen/isctype.c","lib/libc/gen/isctype.c","isdigit",74,77
4,2,41,1,3,"isgraph@82-85@lib/libc/gen/isctype.c","lib/libc/gen/isctype.c","isgraph",82,85
4,2,33,1,3,"islower@90-93@lib/libc/gen/isctype.c","lib/libc/gen/isctype.c","islower",90,93
4,2,43,1,3,"isprint@98-101@lib/libc/gen/isctype.c","lib/libc/gen/isctype.c","isprint",98,101
4,2,33,1,3,"ispunct@106-109@lib/libc/gen/isctype.c","lib/libc/gen/isctype.c","ispunct",106,109
4,2,33,1,3,"isspace@114-117@lib/libc/gen/isctype.c","lib/libc/gen/isctype.c","isspace",114,117
4,2,33,1,3,"isupper@122-125@lib/libc/gen/isctype.c","lib/libc/gen/isctype.c","isupper",122,125
4,2,37,1,3,"isxdigit@130-133@lib/libc/gen/isctype.c","lib/libc/gen/isctype.c","isxdigit",130,133
4,1,18,1,3,"isascii@138-141@lib/libc/gen/isctype.c","lib/libc/gen/isctype.c","isascii",138,141
4,1,14,1,3,"toascii@146-149@lib/libc/gen/isctype.c","lib/libc/gen/isctype.c","toascii",146,149
4,1,16,1,3,"_toupper@153-156@lib/libc/gen/isctype.c","lib/libc/gen/isctype.c","_toupper",153,156
4,1,16,1,3,"_tolower@160-163@lib/libc/gen/isctype.c","lib/libc/gen/isctype.c","_tolower",160,163
7,2,45,2,8,"isfdtype@27-35@lib/libc/gen/isfdtype.c","lib/libc/gen/isfdtype.c","isfdtype",27,35
5,1,29,1,5,"__isfinite@24-29@lib/libc/gen/isfinite.c","lib/libc/gen/isfinite.c","__isfinite",24,29
5,1,29,1,5,"__isfinitef@32-37@lib/libc/gen/isfinite.c","lib/libc/gen/isfinite.c","__isfinitef",32,37
6,3,43,1,6,"__isnan@24-30@lib/libc/gen/isnan.c","lib/libc/gen/isnan.c","__isnan",24,30
5,2,35,1,5,"__isnanf@33-38@lib/libc/gen/isnan.c","lib/libc/gen/isnan.c","__isnanf",33,38
5,2,35,1,5,"__isnormal@24-29@lib/libc/gen/isnormal.c","lib/libc/gen/isnormal.c","__isnormal",24,29
5,2,35,1,5,"__isnormalf@32-37@lib/libc/gen/isnormal.c","lib/libc/gen/isnormal.c","__isnormalf",32,37
8,1,49,2,7,"_copysign@87-94@lib/libc/gen/ldexp.c","lib/libc/gen/ldexp.c","_copysign",87,94
26,9,225,2,25,"ldexp@97-122@lib/libc/gen/ldexp.c","lib/libc/gen/ldexp.c","ldexp",97,122
34,8,175,3,38,"lockf@38-76@lib/libc/gen/lockf.c","lib/libc/gen/lockf.c","lockf",38,76
56,15,344,1,67,"login_getclass@81-148@lib/libc/gen/login_cap.c","lib/libc/gen/login_cap.c","login_getclass",81,148
50,19,323,3,57,"login_getstyle@152-209@lib/libc/gen/login_cap.c","lib/libc/gen/login_cap.c","login_getstyle",152,209
28,7,145,4,31,"login_getcapstr@213-244@lib/libc/gen/login_cap.c","lib/libc/gen/login_cap.c","login_getcapstr",213,244
76,25,392,4,81,"login_getcaptime@248-329@lib/libc/gen/login_cap.c","lib/libc/gen/login_cap.c","login_getcaptime",248,329
45,12,260,4,50,"login_getcapnum@333-383@lib/libc/gen/login_cap.c","lib/libc/gen/login_cap.c","login_getcapnum",333,383
41,12,244,4,44,"login_getcapsize@387-431@lib/libc/gen/login_cap.c","lib/libc/gen/login_cap.c","login_getcapsize",387,431
6,2,43,3,6,"login_getcapbool@435-441@lib/libc/gen/login_cap.c","lib/libc/gen/login_cap.c","login_getcapbool",435,441
9,2,40,1,8,"login_close@445-453@lib/libc/gen/login_cap.c","lib/libc/gen/login_cap.c","login_close",445,453
59,14,497,4,82,"gsetrl@481-563@lib/libc/gen/login_cap.c","lib/libc/gen/login_cap.c","gsetrl",481,563
11,2,63,2,12,"setclasscontext@566-578@lib/libc/gen/login_cap.c","lib/libc/gen/login_cap.c","setclasscontext",566,578
70,21,484,4,87,"setusercontext@581-668@lib/libc/gen/login_cap.c","lib/libc/gen/login_cap.c","setusercontext",581,668
35,14,235,2,46,"setuserpath@677-723@lib/libc/gen/login_cap.c","lib/libc/gen/login_cap.c","setuserpath",677,723
38,11,228,2,41,"setuserenv@730-771@lib/libc/gen/login_cap.c","lib/libc/gen/login_cap.c","setuserenv",730,771
10,3,73,4,10,"login_setenv@777-787@lib/libc/gen/login_cap.c","lib/libc/gen/login_cap.c","login_setenv",777,787
64,23,338,3,68,"strtosize@803-871@lib/libc/gen/login_cap.c","lib/libc/gen/login_cap.c","strtosize",803,871
9,4,71,3,8,"strtolimit@875-883@lib/libc/gen/login_cap.c","lib/libc/gen/login_cap.c","strtolimit",875,883
41,12,304,2,81,"multiply@886-967@lib/libc/gen/login_cap.c","lib/libc/gen/login_cap.c","multiply",886,967
18,5,130,1,22,"secure_path@970-992@lib/libc/gen/login_cap.c","lib/libc/gen/login_cap.c","secure_path",970,992
112,55,640,3,120,"expandstr@1010-1130@lib/libc/gen/login_cap.c","lib/libc/gen/login_cap.c","expandstr",1010,1130
33,4,266,2,60,"modf@45-105@lib/libc/gen/modf.c","lib/libc/gen/modf.c","modf",45,105
74,22,375,4,77,"nftw@30-107@lib/libc/gen/nftw.c","lib/libc/gen/nftw.c","nftw",30,107
12,6,80,1,13,"nice@41-54@lib/libc/gen/nice.c","lib/libc/gen/nice.c","nice",41,54
15,8,85,1,24,"__elf_is_okay__@60-84@lib/libc/gen/nlist.c","lib/libc/gen/nlist.c","__elf_is_okay__",60,84
141,44,908,2,200,"__fdnlist@87-287@lib/libc/gen/nlist.c","lib/libc/gen/nlist.c","__fdnlist",87,287
10,2,64,2,10,"nlist@291-301@lib/libc/gen/nlist.c","lib/libc/gen/nlist.c","nlist",291,301
11,3,64,1,11,"opendir@48-59@lib/libc/gen/opendir.c","lib/libc/gen/opendir.c","opendir",48,59
17,5,113,1,23,"fdopendir@66-89@lib/libc/gen/opendir.c","lib/libc/gen/opendir.c","fdopendir",66,89
28,5,174,1,31,"__fdopendir@93-124@lib/libc/gen/opendir.c","lib/libc/gen/opendir.c","__fdopendir",93,124
5,2,31,1,5,"pause@15-20@lib/libc/gen/pause.c","lib/libc/gen/pause.c","pause",15,20
64,18,465,2,83,"popen@56-139@lib/libc/gen/popen.c","lib/libc/gen/popen.c","popen",56,139
25,8,162,1,33,"pclose@148-181@lib/libc/gen/popen.c","lib/libc/gen/popen.c","pclose",148,181
2,1,14,1,1,"__posix_spawn_file_actions_entry::SIMPLEQ_ENTRY@53-54@lib/libc/gen/posix_spawn.c","lib/libc/gen/posix_spawn.c","__posix_spawn_file_actions_entry::SIMPLEQ_ENTRY",53,54
36,17,257,1,55,"process_spawnattr@78-133@lib/libc/gen/posix_spawn.c","lib/libc/gen/posix_spawn.c","process_spawnattr",78,133
34,14,208,1,40,"process_file_actions_entry@136-176@lib/libc/gen/posix_spawn.c","lib/libc/gen/posix_spawn.c","process_file_actions_entry",136,176
11,2,49,1,12,"process_file_actions@179-191@lib/libc/gen/posix_spawn.c","lib/libc/gen/posix_spawn.c","process_file_actions",179,191
34,11,180,7,34,"do_posix_spawn@194-228@lib/libc/gen/posix_spawn.c","lib/libc/gen/posix_spawn.c","do_posix_spawn",194,228
7,1,55,6,6,"posix_spawn@231-237@lib/libc/gen/posix_spawn.c","lib/libc/gen/posix_spawn.c","posix_spawn",231,237
7,1,55,6,6,"posix_spawnp@240-246@lib/libc/gen/posix_spawn.c","lib/libc/gen/posix_spawn.c","posix_spawnp",240,246
10,2,51,1,11,"posix_spawn_file_actions_init@253-264@lib/libc/gen/posix_spawn.c","lib/libc/gen/posix_spawn.c","posix_spawn_file_actions_init",253,264
12,3,77,1,16,"posix_spawn_file_actions_destroy@267-283@lib/libc/gen/posix_spawn.c","lib/libc/gen/posix_spawn.c","posix_spawn_file_actions_destroy",267,283
23,4,140,5,28,"posix_spawn_file_actions_addopen@286-314@lib/libc/gen/posix_spawn.c","lib/libc/gen/posix_spawn.c","posix_spawn_file_actions_addopen",286,314
15,4,92,3,20,"posix_spawn_file_actions_adddup2@317-337@lib/libc/gen/posix_spawn.c","lib/libc/gen/posix_spawn.c","posix_spawn_file_actions_adddup2",317,337
14,3,79,2,19,"posix_spawn_file_actions_addclose@340-359@lib/libc/gen/posix_spawn.c","lib/libc/gen/posix_spawn.c","posix_spawn_file_actions_addclose",340,359
9,2,45,1,11,"posix_spawnattr_init@366-377@lib/libc/gen/posix_spawn.c","lib/libc/gen/posix_spawn.c","posix_spawnattr_init",366,377
5,1,19,1,4,"posix_spawnattr_destroy@380-384@lib/libc/gen/posix_spawn.c","lib/libc/gen/posix_spawn.c","posix_spawnattr_destroy",380,384
6,1,30,2,5,"posix_spawnattr_getflags@387-392@lib/libc/gen/posix_spawn.c","lib/libc/gen/posix_spawn.c","posix_spawnattr_getflags",387,392
6,1,30,2,5,"posix_spawnattr_getpgroup@395-400@lib/libc/gen/posix_spawn.c","lib/libc/gen/posix_spawn.c","posix_spawnattr_getpgroup",395,400
6,1,31,2,5,"posix_spawnattr_getschedparam@403-408@lib/libc/gen/posix_spawn.c","lib/libc/gen/posix_spawn.c","posix_spawnattr_getschedparam",403,408
6,1,30,2,5,"posix_spawnattr_getschedpolicy@411-416@lib/libc/gen/posix_spawn.c","lib/libc/gen/posix_spawn.c","posix_spawnattr_getschedpolicy",411,416
6,1,30,2,5,"posix_spawnattr_getsigdefault@419-424@lib/libc/gen/posix_spawn.c","lib/libc/gen/posix_spawn.c","posix_spawnattr_getsigdefault",419,424
6,1,30,2,5,"posix_spawnattr_getsigmask@427-432@lib/libc/gen/posix_spawn.c","lib/libc/gen/posix_spawn.c","posix_spawnattr_getsigmask",427,432
5,1,25,2,4,"posix_spawnattr_setflags@435-439@lib/libc/gen/posix_spawn.c","lib/libc/gen/posix_spawn.c","posix_spawnattr_setflags",435,439
5,1,25,2,4,"posix_spawnattr_setpgroup@442-446@lib/libc/gen/posix_spawn.c","lib/libc/gen/posix_spawn.c","posix_spawnattr_setpgroup",442,446
6,1,31,2,5,"posix_spawnattr_setschedparam@449-454@lib/libc/gen/posix_spawn.c","lib/libc/gen/posix_spawn.c","posix_spawnattr_setschedparam",449,454
5,1,25,2,4,"posix_spawnattr_setschedpolicy@457-461@lib/libc/gen/posix_spawn.c","lib/libc/gen/posix_spawn.c","posix_spawnattr_setschedpolicy",457,461
6,1,30,2,5,"posix_spawnattr_setsigdefault@464-469@lib/libc/gen/posix_spawn.c","lib/libc/gen/posix_spawn.c","posix_spawnattr_setsigdefault",464,469
6,1,30,2,5,"posix_spawnattr_setsigmask@472-477@lib/libc/gen/posix_spawn.c","lib/libc/gen/posix_spawn.c","posix_spawnattr_setsigmask",472,477
20,3,163,2,20,"psignal@43-63@lib/libc/gen/psignal.c","lib/libc/gen/psignal.c","psignal",43,63
25,2,182,1,34,"pw_dup@48-82@lib/libc/gen/pw_dup.c","lib/libc/gen/pw_dup.c","pw_dup",48,82
40,8,284,2,42,"user_from_uid@44-86@lib/libc/gen/pwcache.c","lib/libc/gen/pwcache.c","user_from_uid",44,86
40,8,284,2,42,"group_from_gid@89-131@lib/libc/gen/pwcache.c","lib/libc/gen/pwcache.c","group_from_gid",89,131
4,1,19,1,3,"raise@35-38@lib/libc/gen/raise.c","lib/libc/gen/raise.c","raise",35,38
29,9,188,2,29,"_readdir_unlocked@40-69@lib/libc/gen/readdir.c","lib/libc/gen/readdir.c","_readdir_unlocked",40,69
8,1,42,1,9,"readdir@72-81@lib/libc/gen/readdir.c","lib/libc/gen/readdir.c","readdir",72,81
18,4,109,3,18,"readdir_r@39-57@lib/libc/gen/readdir_r.c","lib/libc/gen/readdir_r.c","readdir_r",39,57
108,33,902,4,137,"readpassphrase@40-177@lib/libc/gen/readpassphrase.c","lib/libc/gen/readpassphrase.c","readpassphrase",40,177
5,1,35,1,5,"getpass@181-186@lib/libc/gen/readpassphrase.c","lib/libc/gen/readpassphrase.c","getpass",181,186
4,1,14,1,4,"handler@188-192@lib/libc/gen/readpassphrase.c","lib/libc/gen/readpassphrase.c","handler",188,192
4,1,15,1,3,"rewinddir@34-37@lib/libc/gen/rewinddir.c","lib/libc/gen/rewinddir.c","rewinddir",34,37
60,16,441,4,80,"scandir@61-141@lib/libc/gen/scandir.c","lib/libc/gen/scandir.c","scandir",61,141
4,1,36,2,3,"alphasort@147-150@lib/libc/gen/scandir.c","lib/libc/gen/scandir.c","alphasort",147,150
25,5,172,2,45,"seekdir@29-74@lib/libc/gen/seekdir.c","lib/libc/gen/seekdir.c","seekdir",29,74
9,2,67,2,9,"setdomainname@36-45@lib/libc/gen/setdomainname.c","lib/libc/gen/setdomainname.c","setdomainname",36,45
9,2,67,2,9,"sethostname@36-45@lib/libc/gen/sethostname.c","lib/libc/gen/sethostname.c","sethostname",36,45
51,20,327,2,65,"getmode@77-142@lib/libc/gen/setmode.c","lib/libc/gen/setmode.c","getmode",77,142
128,43,710,1,174,"setmode@162-336@lib/libc/gen/setmode.c","lib/libc/gen/setmode.c","setmode",162,336
37,17,221,5,40,"addcmd@339-379@lib/libc/gen/setmode.c","lib/libc/gen/setmode.c","addcmd",339,379
11,8,92,1,10,"dumpmode@383-393@lib/libc/gen/setmode.c","lib/libc/gen/setmode.c","dumpmode",383,393
44,13,242,1,46,"compress_mode@403-449@lib/libc/gen/setmode.c","lib/libc/gen/setmode.c","compress_mode",403,449
31,6,213,2,34,"setproctitle@45-79@lib/libc/gen/setproctitle.c","lib/libc/gen/setproctitle.c","setproctitle",45,79
9,2,43,1,9,"setprogname@22-31@lib/libc/gen/setprogname.c","lib/libc/gen/setprogname.c","setprogname",22,31
6,1,45,3,6,"makeshmpath@38-44@lib/libc/gen/shm_open.c","lib/libc/gen/shm_open.c","makeshmpath",38,44
28,8,187,3,31,"shm_open@47-78@lib/libc/gen/shm_open.c","lib/libc/gen/shm_open.c","shm_open",47,78
6,1,33,1,6,"shm_unlink@82-88@lib/libc/gen/shm_open.c","lib/libc/gen/shm_open.c","shm_unlink",82,88
24,5,134,1,26,"shm_mkstemp@91-117@lib/libc/gen/shm_open.c","lib/libc/gen/shm_open.c","shm_mkstemp",91,117
15,3,93,2,15,"siginterrupt@38-53@lib/libc/gen/siginterrupt.c","lib/libc/gen/siginterrupt.c","siginterrupt",38,53
13,3,94,2,13,"signal@40-53@lib/libc/gen/signal.c","lib/libc/gen/signal.c","signal",40,53
5,1,25,1,5,"__signbit@24-29@lib/libc/gen/signbit.c","lib/libc/gen/signbit.c","__signbit",24,29
5,1,25,1,5,"__signbitf@32-37@lib/libc/gen/signbit.c","lib/libc/gen/signbit.c","__signbitf",32,37
5,1,18,1,4,"sigemptyset@44-48@lib/libc/gen/sigsetops.c","lib/libc/gen/sigsetops.c","sigemptyset",44,48
5,1,21,1,4,"sigfillset@52-56@lib/libc/gen/sigsetops.c","lib/libc/gen/sigsetops.c","sigfillset",52,56
9,3,44,2,8,"sigaddset@60-68@lib/libc/gen/sigsetops.c","lib/libc/gen/sigsetops.c","sigaddset",60,68
9,3,44,2,8,"sigdelset@72-80@lib/libc/gen/sigsetops.c","lib/libc/gen/sigsetops.c","sigdelset",72,80
8,3,47,2,7,"sigismember@84-91@lib/libc/gen/sigsetops.c","lib/libc/gen/sigsetops.c","sigismember",84,91
11,3,63,1,14,"sleep@35-49@lib/libc/gen/sleep.c","lib/libc/gen/sleep.c","sleep",35,49
18,5,150,2,20,"cvt_statfs_to_statvfs@24-44@lib/libc/gen/statvfs.c","lib/libc/gen/statvfs.c","cvt_statfs_to_statvfs",24,44
9,2,48,2,9,"fstatvfs@47-56@lib/libc/gen/statvfs.c","lib/libc/gen/statvfs.c","fstatvfs",47,56
9,2,50,2,9,"statvfs@59-68@lib/libc/gen/statvfs.c","lib/libc/gen/statvfs.c","statvfs",59,68
22,7,152,1,23,"fflagstostr@78-101@lib/libc/gen/strtofflags.c","lib/libc/gen/strtofflags.c","fflagstostr",78,101
39,15,235,3,39,"strtofflags@110-149@lib/libc/gen/strtofflags.c","lib/libc/gen/strtofflags.c","strtofflags",110,149
360,172,1770,1,411,"sysconf@61-472@lib/libc/gen/sysconf.c","lib/libc/gen/sysconf.c","sysconf",61,472
7,1,38,3,7,"syslog@43-50@lib/libc/gen/syslog.c","lib/libc/gen/syslog.c","syslog",43,50
4,1,29,3,3,"vsyslog@54-57@lib/libc/gen/syslog.c","lib/libc/gen/syslog.c","vsyslog",54,57
4,1,27,3,3,"openlog@61-64@lib/libc/gen/syslog.c","lib/libc/gen/syslog.c","openlog",61,64
4,1,12,1,3,"closelog@67-70@lib/libc/gen/syslog.c","lib/libc/gen/syslog.c","closelog",67,70
4,1,18,1,3,"setlogmask@74-77@lib/libc/gen/syslog.c","lib/libc/gen/syslog.c","setlogmask",74,77
8,2,38,2,8,"setlogmask_r@81-89@lib/libc/gen/syslog.c","lib/libc/gen/syslog.c","setlogmask_r",81,89
7,1,45,4,7,"syslog_r@49-56@lib/libc/gen/syslog_r.c","lib/libc/gen/syslog_r.c","syslog_r",49,56
4,1,33,4,3,"vsyslog_r@60-63@lib/libc/gen/syslog_r.c","lib/libc/gen/syslog_r.c","vsyslog_r",60,63
87,25,601,5,120,"__vsyslog_r@70-190@lib/libc/gen/syslog_r.c","lib/libc/gen/syslog_r.c","__vsyslog_r",70,190
8,4,59,4,7,"openlog_r@193-200@lib/libc/gen/syslog_r.c","lib/libc/gen/syslog_r.c","openlog_r",193,200
4,1,15,1,3,"closelog_r@204-207@lib/libc/gen/syslog_r.c","lib/libc/gen/syslog_r.c","closelog_r",204,207
8,1,38,1,9,"telldir@39-48@lib/libc/gen/telldir.c","lib/libc/gen/telldir.c","telldir",39,48
9,3,51,1,9,"time@35-44@lib/libc/gen/time.c","lib/libc/gen/time.c","time",35,44
16,4,135,1,16,"times@42-58@lib/libc/gen/times.c","lib/libc/gen/times.c","times",42,58
6,2,34,1,5,"tolower@55-60@lib/libc/gen/tolower_.c","lib/libc/gen/tolower_.c","tolower",55,60
6,2,34,1,5,"toupper@56-61@lib/libc/gen/toupper_.c","lib/libc/gen/toupper_.c","toupper",56,61
5,1,40,2,5,"rb_n2e@47-52@lib/libc/gen/tree.c","lib/libc/gen/tree.c","rb_n2e",47,52
5,1,40,2,5,"rb_e2n@55-60@lib/libc/gen/tree.c","lib/libc/gen/tree.c","rb_e2n",55,60
6,1,40,2,5,"rbe_set@70-75@lib/libc/gen/tree.c","lib/libc/gen/tree.c","rbe_set",70,75
5,1,28,2,4,"rbe_set_blackred@78-82@lib/libc/gen/tree.c","lib/libc/gen/tree.c","rbe_set_blackred",78,82
4,1,30,2,3,"rbe_augment@85-88@lib/libc/gen/tree.c","lib/libc/gen/tree.c","rbe_augment",85,88
5,2,30,2,4,"rbe_if_augment@91-95@lib/libc/gen/tree.c","lib/libc/gen/tree.c","rbe_if_augment",91,95
28,6,178,3,31,"rbe_rotate_left@98-129@lib/libc/gen/tree.c","lib/libc/gen/tree.c","rbe_rotate_left",98,129
28,6,178,3,31,"rbe_rotate_right@132-163@lib/libc/gen/tree.c","lib/libc/gen/tree.c","rbe_rotate_right",132,163
43,10,264,3,49,"rbe_insert_color@166-215@lib/libc/gen/tree.c","lib/libc/gen/tree.c","rbe_insert_color",166,215
77,24,533,4,87,"rbe_remove_color@218-305@lib/libc/gen/tree.c","lib/libc/gen/tree.c","rbe_remove_color",218,305
67,18,426,3,79,"rbe_remove@308-387@lib/libc/gen/tree.c","lib/libc/gen/tree.c","rbe_remove",308,387
7,2,63,3,8,"_rb_remove@390-398@lib/libc/gen/tree.c","lib/libc/gen/tree.c","_rb_remove",390,398
31,6,192,3,37,"_rb_insert@402-439@lib/libc/gen/tree.c","lib/libc/gen/tree.c","_rb_insert",402,439
17,4,106,3,18,"_rb_find@444-462@lib/libc/gen/tree.c","lib/libc/gen/tree.c","_rb_find",444,462
19,4,118,3,20,"_rb_nfind@467-487@lib/libc/gen/tree.c","lib/libc/gen/tree.c","_rb_nfind",467,487
20,8,141,2,21,"_rb_next@491-512@lib/libc/gen/tree.c","lib/libc/gen/tree.c","_rb_next",491,512
20,8,137,2,21,"_rb_prev@516-537@lib/libc/gen/tree.c","lib/libc/gen/tree.c","_rb_prev",516,537
5,2,41,2,5,"_rb_root@541-546@lib/libc/gen/tree.c","lib/libc/gen/tree.c","_rb_root",541,546
10,3,67,2,11,"_rb_min@550-561@lib/libc/gen/tree.c","lib/libc/gen/tree.c","_rb_min",550,561
10,3,67,2,11,"_rb_max@565-576@lib/libc/gen/tree.c","lib/libc/gen/tree.c","_rb_max",565,576
6,2,49,2,5,"_rb_left@580-585@lib/libc/gen/tree.c","lib/libc/gen/tree.c","_rb_left",580,585
6,2,49,2,5,"_rb_right@589-594@lib/libc/gen/tree.c","lib/libc/gen/tree.c","_rb_right",589,594
6,2,49,2,5,"_rb_parent@598-603@lib/libc/gen/tree.c","lib/libc/gen/tree.c","_rb_parent",598,603
6,2,57,3,6,"_rb_set_left@607-613@lib/libc/gen/tree.c","lib/libc/gen/tree.c","_rb_set_left",607,613
6,2,57,3,6,"_rb_set_right@617-623@lib/libc/gen/tree.c","lib/libc/gen/tree.c","_rb_set_right",617,623
6,2,57,3,6,"_rb_set_parent@627-633@lib/libc/gen/tree.c","lib/libc/gen/tree.c","_rb_set_parent",627,633
6,1,52,3,6,"_rb_poison@637-643@lib/libc/gen/tree.c","lib/libc/gen/tree.c","_rb_poison",637,643
7,3,66,3,7,"_rb_check@647-654@lib/libc/gen/tree.c","lib/libc/gen/tree.c","_rb_check",647,654
14,3,69,1,16,"ttyname@47-63@lib/libc/gen/ttyname.c","lib/libc/gen/ttyname.c","ttyname",47,63
38,8,291,3,42,"ttyname_r@67-109@lib/libc/gen/ttyname.c","lib/libc/gen/ttyname.c","ttyname_r",67,109
26,9,181,3,27,"oldttyname@113-140@lib/libc/gen/ttyname.c","lib/libc/gen/ttyname.c","oldttyname",113,140
24,6,127,1,24,"ttyslot@38-62@lib/libc/gen/ttyslot.c","lib/libc/gen/ttyslot.c","ttyslot",38,62
11,2,102,2,14,"ualarm@43-57@lib/libc/gen/ualarm.c","lib/libc/gen/ualarm.c","ualarm",43,57
37,7,338,1,42,"uname@39-81@lib/libc/gen/uname.c","lib/libc/gen/uname.c","uname",39,81
127,42,627,4,154,"unvis@52-206@lib/libc/gen/unvis.c","lib/libc/gen/unvis.c","unvis",52,206
27,7,126,2,27,"strunvis@217-244@lib/libc/gen/unvis.c","lib/libc/gen/unvis.c","strunvis",217,244
38,13,200,3,38,"strnunvis@247-285@lib/libc/gen/unvis.c","lib/libc/gen/unvis.c","strnunvis",247,285
9,2,53,1,11,"usleep@36-47@lib/libc/gen/usleep.c","lib/libc/gen/usleep.c","usleep",36,47
13,2,95,2,13,"utime@36-49@lib/libc/gen/utime.c","lib/libc/gen/utime.c","utime",36,49
7,1,62,1,7,"valloc@35-42@lib/libc/gen/valloc.c","lib/libc/gen/valloc.c","valloc",35,42
12,2,84,3,12,"verr@39-51@lib/libc/gen/verr.c","lib/libc/gen/verr.c","verr",39,51
10,2,80,4,9,"verrc@38-47@lib/libc/gen/verrc.c","lib/libc/gen/verrc.c","verrc",38,47
8,2,60,3,7,"verrx@37-44@lib/libc/gen/verrx.c","lib/libc/gen/verrx.c","verrx",37,44
82,28,483,4,82,"vis@56-138@lib/libc/gen/vis.c","lib/libc/gen/vis.c","vis",56,138
9,2,64,3,9,"strvis@155-164@lib/libc/gen/vis.c","lib/libc/gen/vis.c","strvis",155,164
38,13,252,4,40,"strnvis@168-208@lib/libc/gen/vis.c","lib/libc/gen/vis.c","strnvis",168,208
16,3,101,3,16,"stravis@211-227@lib/libc/gen/vis.c","lib/libc/gen/vis.c","stravis",211,227
13,3,91,4,13,"strvisx@230-243@lib/libc/gen/vis.c","lib/libc/gen/vis.c","strvisx",230,243
11,2,76,2,11,"vwarn@39-50@lib/libc/gen/vwarn.c","lib/libc/gen/vwarn.c","vwarn",39,50
9,2,72,3,8,"vwarnc@38-46@lib/libc/gen/vwarnc.c","lib/libc/gen/vwarnc.c","vwarnc",38,46
7,2,52,2,6,"vwarnx@37-43@lib/libc/gen/vwarnx.c","lib/libc/gen/vwarnx.c","vwarnx",37,43
4,1,22,1,3,"wait@35-38@lib/libc/gen/wait.c","lib/libc/gen/wait.c","wait",35,38
4,1,30,3,3,"wait3@34-37@lib/libc/gen/wait3.c","lib/libc/gen/wait3.c","wait3",34,37
4,1,28,3,3,"waitpid@35-38@lib/libc/gen/waitpid.c","lib/libc/gen/waitpid.c","waitpid",35,38
7,1,33,2,7,"warn@35-42@lib/libc/gen/warn.c","lib/libc/gen/warn.c","warn",35,42
7,1,38,3,7,"warnc@35-42@lib/libc/gen/warnc.c","lib/libc/gen/warnc.c","warnc",35,42
7,1,33,2,7,"warnx@35-42@lib/libc/gen/warnx.c","lib/libc/gen/warnx.c","warnx",35,42
64,13,489,2,78,"monstartup@56-134@lib/libc/gmon/gmon.c","lib/libc/gmon/gmon.c","monstartup",56,134
119,24,826,1,147,"_mcleanup@138-285@lib/libc/gmon/gmon.c","lib/libc/gmon/gmon.c","_mcleanup",138,285
12,2,68,1,14,"moncontrol@293-307@lib/libc/gmon/gmon.c","lib/libc/gmon/gmon.c","moncontrol",293,307
13,2,88,1,13,"hertz@315-328@lib/libc/gmon/gmon.c","lib/libc/gmon/gmon.c","hertz",315,328
74,18,412,2,133,"_MCOUNT_DECL@47-180@lib/libc/gmon/mcount.c","lib/libc/gmon/mcount.c","_MCOUNT_DECL",47,180
16,3,135,2,17,"HASHEnd@39-56@lib/libc/hash/helper.c","lib/libc/hash/helper.c","HASHEnd",39,56
35,10,233,4,38,"HASHFileChunk@60-98@lib/libc/hash/helper.c","lib/libc/hash/helper.c","HASHFileChunk",60,98
4,1,27,2,3,"HASHFile@102-105@lib/libc/hash/helper.c","lib/libc/hash/helper.c","HASHFile",102,105
7,1,46,3,7,"HASHData@109-116@lib/libc/hash/helper.c","lib/libc/hash/helper.c","HASHData",109,116
8,1,50,1,7,"MD5Init@51-58@lib/libc/hash/md5.c","lib/libc/hash/md5.c","MD5Init",51,58
23,5,158,3,31,"MD5Update@66-97@lib/libc/hash/md5.c","lib/libc/hash/md5.c","MD5Update",66,97
12,2,79,1,15,"MD5Pad@105-120@lib/libc/hash/md5.c","lib/libc/hash/md5.c","MD5Pad",105,120
8,2,63,2,8,"MD5Final@127-135@lib/libc/hash/md5.c","lib/libc/hash/md5.c","MD5Final",127,135
84,3,1601,2,93,"MD5Transform@157-250@lib/libc/hash/md5.c","lib/libc/hash/md5.c","MD5Transform",157,250
9,1,59,1,8,"RMD160Init@92-100@lib/libc/hash/rmd160.c","lib/libc/hash/rmd160.c","RMD160Init",92,100
22,5,147,3,24,"RMD160Update@104-128@lib/libc/hash/rmd160.c","lib/libc/hash/rmd160.c","RMD160Update",104,128
11,2,74,1,16,"RMD160Pad@132-148@lib/libc/hash/rmd160.c","lib/libc/hash/rmd160.c","RMD160Pad",132,148
8,2,62,2,8,"RMD160Final@152-160@lib/libc/hash/rmd160.c","lib/libc/hash/rmd160.c","RMD160Final",152,160
189,3,3669,2,209,"RMD160Transform@164-373@lib/libc/hash/rmd160.c","lib/libc/hash/rmd160.c","RMD160Transform",164,373
38,1,1338,2,46,"SHA1Transform@54-100@lib/libc/hash/sha1.c","lib/libc/hash/sha1.c","SHA1Transform",54,100
9,1,59,1,10,"SHA1Init@108-118@lib/libc/hash/sha1.c","lib/libc/hash/sha1.c","SHA1Init",108,118
16,3,162,3,16,"SHA1Update@126-142@lib/libc/hash/sha1.c","lib/libc/hash/sha1.c","SHA1Update",126,142
13,3,112,1,13,"SHA1Pad@150-163@lib/libc/hash/sha1.c","lib/libc/hash/sha1.c","SHA1Pad",150,163
10,2,87,2,10,"SHA1Final@167-177@lib/libc/hash/sha1.c","lib/libc/hash/sha1.c","SHA1Final",167,177
7,1,49,1,6,"SHA224Init@305-311@lib/libc/hash/sha2.c","lib/libc/hash/sha2.c","SHA224Init",305,311
9,3,77,2,14,"SHA224Final@322-336@lib/libc/hash/sha2.c","lib/libc/hash/sha2.c","SHA224Final",322,336
7,1,49,1,6,"SHA256Init@342-348@lib/libc/hash/sha2.c","lib/libc/hash/sha2.c","SHA256Init",342,348
44,3,509,2,53,"SHA256Transform@377-430@lib/libc/hash/sha2.c","lib/libc/hash/sha2.c","SHA256Transform",377,430
57,3,448,2,70,"SHA256Transform@435-505@lib/libc/hash/sha2.c","lib/libc/hash/sha2.c","SHA256Transform",435,505
33,6,229,3,43,"SHA256Update@511-554@lib/libc/hash/sha2.c","lib/libc/hash/sha2.c","SHA256Update",511,554
26,4,179,1,40,"SHA256Pad@558-598@lib/libc/hash/sha2.c","lib/libc/hash/sha2.c","SHA256Pad",558,598
9,3,77,2,14,"SHA256Final@602-616@lib/libc/hash/sha2.c","lib/libc/hash/sha2.c","SHA256Final",602,616
7,1,56,1,6,"SHA512Init@622-628@lib/libc/hash/sha2.c","lib/libc/hash/sha2.c","SHA512Init",622,628
44,3,509,2,53,"SHA512Transform@658-711@lib/libc/hash/sha2.c","lib/libc/hash/sha2.c","SHA512Transform",658,711
57,3,448,2,70,"SHA512Transform@716-786@lib/libc/hash/sha2.c","lib/libc/hash/sha2.c","SHA512Transform",716,786
33,6,229,3,43,"SHA512Update@792-835@lib/libc/hash/sha2.c","lib/libc/hash/sha2.c","SHA512Update",792,835
26,4,201,1,40,"SHA512Pad@839-879@lib/libc/hash/sha2.c","lib/libc/hash/sha2.c","SHA512Pad",839,879
9,3,77,2,14,"SHA512Final@883-897@lib/libc/hash/sha2.c","lib/libc/hash/sha2.c","SHA512Final",883,897
7,1,56,1,6,"SHA384Init@904-910@lib/libc/hash/sha2.c","lib/libc/hash/sha2.c","SHA384Init",904,910
9,3,77,2,15,"SHA384Final@921-936@lib/libc/hash/sha2.c","lib/libc/hash/sha2.c","SHA384Final",921,936
7,1,56,1,6,"SHA512_256Init@941-947@lib/libc/hash/sha2.c","lib/libc/hash/sha2.c","SHA512_256Init",941,947
9,3,77,2,15,"SHA512_256Final@958-973@lib/libc/hash/sha2.c","lib/libc/hash/sha2.c","SHA512_256Final",958,973
12,1,102,2,14,"SipHash_Init@56-70@lib/libc/hash/siphash.c","lib/libc/hash/siphash.c","SipHash_Init",56,70
29,6,213,5,34,"SipHash_Update@74-108@lib/libc/hash/siphash.c","lib/libc/hash/siphash.c","SipHash_Update",74,108
6,1,46,4,6,"SipHash_Final@112-118@lib/libc/hash/siphash.c","lib/libc/hash/siphash.c","SipHash_Final",112,118
15,1,147,3,17,"SipHash_End@122-139@lib/libc/hash/siphash.c","lib/libc/hash/siphash.c","SipHash_End",122,139
7,1,61,5,7,"SipHash@143-150@lib/libc/hash/siphash.c","lib/libc/hash/siphash.c","SipHash",143,150
19,2,244,2,21,"SipHash_Rounds@156-177@lib/libc/hash/siphash.c","lib/libc/hash/siphash.c","SipHash_Rounds",156,177
7,1,51,2,7,"SipHash_CRounds@180-187@lib/libc/hash/siphash.c","lib/libc/hash/siphash.c","SipHash_CRounds",180,187
7,2,30,1,7,"_CurrentRuneLocale@26-33@lib/libc/locale/_CurrentRuneLocale.c","lib/libc/locale/_CurrentRuneLocale.c","_CurrentRuneLocale",26,33
25,7,156,2,27,"___runetype_mb@41-68@lib/libc/locale/___runetype_mb.c","lib/libc/locale/___runetype_mb.c","___runetype_mb",41,68
5,2,17,1,4,"__mb_cur_max@26-30@lib/libc/locale/__mb_cur_max.c","lib/libc/locale/__mb_cur_max.c","__mb_cur_max",26,30
33,15,224,2,47,"_get_locname@35-82@lib/libc/locale/_get_locname.c","lib/libc/locale/_get_locname.c","_get_locname",35,82
87,21,530,2,108,"FUNCNAME@42-150@lib/libc/locale/_wcstod.h","lib/libc/locale/_wcstod.h","FUNCNAME",42,150
75,30,423,3,86,"FUNCNAME@49-135@lib/libc/locale/_wcstol.h","lib/libc/locale/_wcstol.h","FUNCNAME",49,135
57,25,360,3,67,"FUNCNAME@48-115@lib/libc/locale/_wcstoul.h","lib/libc/locale/_wcstoul.h","FUNCNAME",48,115
9,1,84,1,8,"_wctrans_init@74-82@lib/libc/locale/_wctrans.c","lib/libc/locale/_wctrans.c","_wctrans_init",74,82
22,6,141,2,24,"_towctrans_ext@89-113@lib/libc/locale/_wctrans.c","lib/libc/locale/_wctrans.c","_towctrans_ext",89,113
5,2,36,2,4,"_towctrans@38-42@lib/libc/locale/_wctrans_local.h","lib/libc/locale/_wctrans_local.h","_towctrans",38,42
6,2,37,1,5,"_wctrans_lower@45-50@lib/libc/locale/_wctrans_local.h","lib/libc/locale/_wctrans_local.h","_wctrans_lower",45,50
6,2,37,1,5,"_wctrans_upper@53-58@lib/libc/locale/_wctrans_local.h","lib/libc/locale/_wctrans_local.h","_wctrans_upper",53,58
13,3,75,1,18,"btowc@34-52@lib/libc/locale/btowc.c","lib/libc/locale/btowc.c","btowc",34,52
12,6,51,1,13,"duplocale@24-37@lib/libc/locale/duplocale.c","lib/libc/locale/duplocale.c","duplocale",24,37
3,1,13,1,3,"freelocale@10-13@lib/libc/locale/freelocale.c","lib/libc/locale/freelocale.c","freelocale",10,13
4,1,22,2,3,"isalnum_l@28-31@lib/libc/locale/isctype_l.c","lib/libc/locale/isctype_l.c","isalnum_l",28,31
4,1,22,2,3,"isalpha_l@35-38@lib/libc/locale/isctype_l.c","lib/libc/locale/isctype_l.c","isalpha_l",35,38
4,1,22,2,3,"isblank_l@42-45@lib/libc/locale/isctype_l.c","lib/libc/locale/isctype_l.c","isblank_l",42,45
4,1,22,2,3,"iscntrl_l@49-52@lib/libc/locale/isctype_l.c","lib/libc/locale/isctype_l.c","iscntrl_l",49,52
4,1,22,2,3,"isdigit_l@56-59@lib/libc/locale/isctype_l.c","lib/libc/locale/isctype_l.c","isdigit_l",56,59
4,1,22,2,3,"isgraph_l@63-66@lib/libc/locale/isctype_l.c","lib/libc/locale/isctype_l.c","isgraph_l",63,66
4,1,22,2,3,"islower_l@70-73@lib/libc/locale/isctype_l.c","lib/libc/locale/isctype_l.c","islower_l",70,73
4,1,22,2,3,"isprint_l@77-80@lib/libc/locale/isctype_l.c","lib/libc/locale/isctype_l.c","isprint_l",77,80
4,1,22,2,3,"ispunct_l@84-87@lib/libc/locale/isctype_l.c","lib/libc/locale/isctype_l.c","ispunct_l",84,87
4,1,22,2,3,"isspace_l@91-94@lib/libc/locale/isctype_l.c","lib/libc/locale/isctype_l.c","isspace_l",91,94
4,1,22,2,3,"isupper_l@98-101@lib/libc/locale/isctype_l.c","lib/libc/locale/isctype_l.c","isupper_l",98,101
4,1,22,2,3,"isxdigit_l@105-108@lib/libc/locale/isctype_l.c","lib/libc/locale/isctype_l.c","isxdigit_l",105,108
4,1,22,2,3,"tolower_l@112-115@lib/libc/locale/isctype_l.c","lib/libc/locale/isctype_l.c","tolower_l",112,115
4,1,22,2,3,"toupper_l@119-122@lib/libc/locale/isctype_l.c","lib/libc/locale/isctype_l.c","toupper_l",119,122
6,2,37,1,6,"__runetype_w@54-60@lib/libc/locale/iswctype.c","lib/libc/locale/iswctype.c","__runetype_w",54,60
4,1,24,2,3,"__isctype_w@63-66@lib/libc/locale/iswctype.c","lib/libc/locale/iswctype.c","__isctype_w",63,66
4,1,22,1,3,"__toupper_w@69-72@lib/libc/locale/iswctype.c","lib/libc/locale/iswctype.c","__toupper_w",69,72
4,1,22,1,3,"__tolower_w@75-78@lib/libc/locale/iswctype.c","lib/libc/locale/iswctype.c","__tolower_w",75,78
4,1,21,1,3,"iswalnum@81-84@lib/libc/locale/iswctype.c","lib/libc/locale/iswctype.c","iswalnum",81,84
4,1,19,1,3,"iswalpha@87-90@lib/libc/locale/iswctype.c","lib/libc/locale/iswctype.c","iswalpha",87,90
4,1,19,1,3,"iswblank@93-96@lib/libc/locale/iswctype.c","lib/libc/locale/iswctype.c","iswblank",93,96
4,1,19,1,3,"iswcntrl@99-102@lib/libc/locale/iswctype.c","lib/libc/locale/iswctype.c","iswcntrl",99,102
4,1,19,1,3,"iswdigit@105-108@lib/libc/locale/iswctype.c","lib/libc/locale/iswctype.c","iswdigit",105,108
4,1,19,1,3,"iswgraph@111-114@lib/libc/locale/iswctype.c","lib/libc/locale/iswctype.c","iswgraph",111,114
4,1,19,1,3,"iswlower@117-120@lib/libc/locale/iswctype.c","lib/libc/locale/iswctype.c","iswlower",117,120
4,1,19,1,3,"iswprint@123-126@lib/libc/locale/iswctype.c","lib/libc/locale/iswctype.c","iswprint",123,126
4,1,19,1,3,"iswpunct@129-132@lib/libc/locale/iswctype.c","lib/libc/locale/iswctype.c","iswpunct",129,132
4,1,19,1,3,"iswspace@135-138@lib/libc/locale/iswctype.c","lib/libc/locale/iswctype.c","iswspace",135,138
4,1,19,1,3,"iswupper@142-145@lib/libc/locale/iswctype.c","lib/libc/locale/iswctype.c","iswupper",142,145
4,1,19,1,3,"iswxdigit@149-152@lib/libc/locale/iswctype.c","lib/libc/locale/iswctype.c","iswxdigit",149,152
4,1,15,1,3,"towupper@155-158@lib/libc/locale/iswctype.c","lib/libc/locale/iswctype.c","towupper",155,158
4,1,15,1,3,"towlower@161-164@lib/libc/locale/iswctype.c","lib/libc/locale/iswctype.c","towlower",161,164
6,2,40,1,5,"wcwidth@168-173@lib/libc/locale/iswctype.c","lib/libc/locale/iswctype.c","wcwidth",168,173
11,4,90,1,13,"wctrans@177-190@lib/libc/locale/iswctype.c","lib/libc/locale/iswctype.c","wctrans",177,190
8,2,41,2,7,"towctrans@193-200@lib/libc/locale/iswctype.c","lib/libc/locale/iswctype.c","towctrans",193,200
9,3,72,1,9,"wctype@204-213@lib/libc/locale/iswctype.c","lib/libc/locale/iswctype.c","wctype",204,213
7,2,42,2,11,"iswctype@216-227@lib/libc/locale/iswctype.c","lib/libc/locale/iswctype.c","iswctype",216,227
10,3,39,1,10,"__runelocale@59-69@lib/libc/locale/iswctype_l.c","lib/libc/locale/iswctype_l.c","__runelocale",59,69
8,2,57,3,8,"__isctype_wl@72-80@lib/libc/locale/iswctype_l.c","lib/libc/locale/iswctype_l.c","__isctype_wl",72,80
4,1,22,2,3,"iswalnum_l@83-86@lib/libc/locale/iswctype_l.c","lib/libc/locale/iswctype_l.c","iswalnum_l",83,86
4,1,20,2,3,"iswalpha_l@89-92@lib/libc/locale/iswctype_l.c","lib/libc/locale/iswctype_l.c","iswalpha_l",89,92
4,1,20,2,3,"iswblank_l@95-98@lib/libc/locale/iswctype_l.c","lib/libc/locale/iswctype_l.c","iswblank_l",95,98
4,1,20,2,3,"iswcntrl_l@101-104@lib/libc/locale/iswctype_l.c","lib/libc/locale/iswctype_l.c","iswcntrl_l",101,104
4,1,20,2,3,"iswdigit_l@107-110@lib/libc/locale/iswctype_l.c","lib/libc/locale/iswctype_l.c","iswdigit_l",107,110
4,1,20,2,3,"iswgraph_l@113-116@lib/libc/locale/iswctype_l.c","lib/libc/locale/iswctype_l.c","iswgraph_l",113,116
4,1,20,2,3,"iswlower_l@119-122@lib/libc/locale/iswctype_l.c","lib/libc/locale/iswctype_l.c","iswlower_l",119,122
4,1,20,2,3,"iswprint_l@125-128@lib/libc/locale/iswctype_l.c","lib/libc/locale/iswctype_l.c","iswprint_l",125,128
4,1,20,2,3,"iswpunct_l@131-134@lib/libc/locale/iswctype_l.c","lib/libc/locale/iswctype_l.c","iswpunct_l",131,134
4,1,20,2,3,"iswspace_l@137-140@lib/libc/locale/iswctype_l.c","lib/libc/locale/iswctype_l.c","iswspace_l",137,140
4,1,20,2,3,"iswupper_l@143-146@lib/libc/locale/iswctype_l.c","lib/libc/locale/iswctype_l.c","iswupper_l",143,146
4,1,20,2,3,"iswxdigit_l@149-152@lib/libc/locale/iswctype_l.c","lib/libc/locale/iswctype_l.c","iswxdigit_l",149,152
4,1,24,2,3,"towupper_l@155-158@lib/libc/locale/iswctype_l.c","lib/libc/locale/iswctype_l.c","towupper_l",155,158
4,1,24,2,3,"towlower_l@161-164@lib/libc/locale/iswctype_l.c","lib/libc/locale/iswctype_l.c","towlower_l",161,164
12,4,87,2,14,"wctrans_l@168-182@lib/libc/locale/iswctype_l.c","lib/libc/locale/iswctype_l.c","wctrans_l",168,182
5,1,27,3,4,"towctrans_l@191-195@lib/libc/locale/iswctype_l.c","lib/libc/locale/iswctype_l.c","towctrans_l",191,195
10,3,69,2,10,"wctype_l@198-208@lib/libc/locale/iswctype_l.c","lib/libc/locale/iswctype_l.c","wctype_l",198,208
6,2,43,3,6,"iswctype_l@211-217@lib/libc/locale/iswctype_l.c","lib/libc/locale/iswctype_l.c","iswctype_l",211,217
35,3,241,1,39,"localeconv@26-65@lib/libc/locale/localeconv.c","lib/libc/locale/localeconv.c","localeconv",26,65
13,4,91,2,14,"mblen@34-48@lib/libc/locale/mblen.c","lib/libc/locale/mblen.c","mblen",34,48
7,2,47,3,7,"mbrlen@32-39@lib/libc/locale/mbrlen.c","lib/libc/locale/mbrlen.c","mbrlen",32,39
8,1,59,3,8,"mbstowcs@36-44@lib/libc/locale/mbstowcs.c","lib/libc/locale/mbstowcs.c","mbstowcs",36,44
18,4,101,3,21,"mbtowc@36-57@lib/libc/locale/mbtowc.c","lib/libc/locale/mbtowc.c","mbtowc",36,57
6,3,30,1,5,"mbsinit@38-43@lib/libc/locale/multibyte_citrus.c","lib/libc/locale/multibyte_citrus.c","mbsinit",38,43
9,3,65,4,9,"mbrtowc@47-56@lib/libc/locale/multibyte_citrus.c","lib/libc/locale/multibyte_citrus.c","mbrtowc",47,56
7,2,51,4,7,"mbsrtowcs@60-67@lib/libc/locale/multibyte_citrus.c","lib/libc/locale/multibyte_citrus.c","mbsrtowcs",60,67
10,3,72,5,10,"mbsnrtowcs@71-81@lib/libc/locale/multibyte_citrus.c","lib/libc/locale/multibyte_citrus.c","mbsnrtowcs",71,81
9,3,56,3,9,"wcrtomb@85-94@lib/libc/locale/multibyte_citrus.c","lib/libc/locale/multibyte_citrus.c","wcrtomb",85,94
7,2,51,4,7,"wcsrtombs@98-105@lib/libc/locale/multibyte_citrus.c","lib/libc/locale/multibyte_citrus.c","wcsrtombs",98,105
10,3,72,5,10,"wcsnrtombs@109-119@lib/libc/locale/multibyte_citrus.c","lib/libc/locale/multibyte_citrus.c","wcsnrtombs",109,119
24,10,146,3,31,"newlocale@25-56@lib/libc/locale/newlocale.c","lib/libc/locale/newlocale.c","newlocale",25,56
98,54,359,1,99,"nl_langinfo@16-115@lib/libc/locale/nl_langinfo.c","lib/libc/locale/nl_langinfo.c","nl_langinfo",16,115
16,5,79,2,19,"nl_langinfo_l@24-43@lib/libc/locale/nl_langinfo_l.c","lib/libc/locale/nl_langinfo_l.c","nl_langinfo_l",24,43
26,5,182,5,30,"readrange@86-116@lib/libc/locale/rune.c","lib/libc/locale/rune.c","readrange",86,116
40,9,295,2,45,"readentry@119-164@lib/libc/locale/rune.c","lib/libc/locale/rune.c","readentry",119,164
23,4,169,1,25,"find_codeset@168-193@lib/libc/locale/rune.c","lib/libc/locale/rune.c","find_codeset",168,193
10,2,57,1,10,"_freeentry@196-206@lib/libc/locale/rune.c","lib/libc/locale/rune.c","_freeentry",196,206
5,1,28,1,4,"_wctype_init@209-213@lib/libc/locale/rune.c","lib/libc/locale/rune.c","_wctype_init",209,213
73,22,627,1,104,"_Read_RuneMagi@217-321@lib/libc/locale/rune.c","lib/libc/locale/rune.c","_Read_RuneMagi",217,321
40,13,365,1,57,"__make_ctype_tabs@57-114@lib/libc/locale/runeglue.c","lib/libc/locale/runeglue.c","__make_ctype_tabs",57,114
9,3,45,1,9,"freegl@25-34@lib/libc/locale/setlocale.c","lib/libc/locale/setlocale.c","freegl",25,34
15,6,96,1,15,"dupgl@37-52@lib/libc/locale/setlocale.c","lib/libc/locale/setlocale.c","dupgl",37,52
10,3,68,3,11,"changegl@55-66@lib/libc/locale/setlocale.c","lib/libc/locale/setlocale.c","changegl",55,66
87,33,573,2,126,"setlocale@69-195@lib/libc/locale/setlocale.c","lib/libc/locale/setlocale.c","setlocale",69,195
19,8,102,1,20,"uselocale@25-45@lib/libc/locale/uselocale.c","lib/libc/locale/uselocale.c","uselocale",25,45
4,1,24,2,4,"wcscoll@37-41@lib/libc/locale/wcscoll.c","lib/libc/locale/wcscoll.c","wcscoll",37,41
5,1,31,3,4,"wcscoll_l@13-17@lib/libc/locale/wcscoll_l.c","lib/libc/locale/wcscoll_l.c","wcscoll_l",13,17
8,1,59,3,8,"wcstombs@35-43@lib/libc/locale/wcstombs.c","lib/libc/locale/wcstombs.c","wcstombs",35,43
6,2,38,3,5,"wcsxfrm@36-41@lib/libc/locale/wcsxfrm.c","lib/libc/locale/wcsxfrm.c","wcsxfrm",36,41
5,1,35,4,4,"wcsxfrm_l@10-14@lib/libc/locale/wcsxfrm_l.c","lib/libc/locale/wcsxfrm_l.c","wcsxfrm_l",10,14
9,3,62,1,9,"wctob@34-43@lib/libc/locale/wctob.c","lib/libc/locale/wctob.c","wctob",34,43
44,63,492,1,45,"wctoint@34-79@lib/libc/locale/wctoint.h","lib/libc/locale/wctoint.h","wctoint",34,79
12,3,80,2,13,"wctomb@34-47@lib/libc/locale/wctomb.c","lib/libc/locale/wctomb.c","wctomb",34,47
48,8,460,4,55,"b64_ntop@126-181@lib/libc/net/base64.c","lib/libc/net/base64.c","b64_ntop",126,181
93,35,525,3,125,"b64_pton@190-315@lib/libc/net/base64.c","lib/libc/net/base64.c","b64_pton",190,315
9,1,77,1,10,"ether_ntoa@48-58@lib/libc/net/ethers.c","lib/libc/net/ethers.c","ether_ntoa",48,58
20,10,146,2,24,"_ether_aton@61-85@lib/libc/net/ethers.c","lib/libc/net/ethers.c","_ether_aton",61,85
5,2,30,1,5,"ether_aton@88-93@lib/libc/net/ethers.c","lib/libc/net/ethers.c","ether_aton",88,93
50,14,361,2,59,"ether_ntohost@96-155@lib/libc/net/ethers.c","lib/libc/net/ethers.c","ether_ntohost",96,155
43,13,292,2,50,"ether_hostton@158-208@lib/libc/net/ethers.c","lib/libc/net/ethers.c","ether_hostton",158,208
19,7,128,3,23,"ether_line@211-234@lib/libc/net/ethers.c","lib/libc/net/ethers.c","ether_line",211,234
10,2,44,1,10,"freeaddrinfo@39-49@lib/libc/net/freeaddrinfo.c","lib/libc/net/freeaddrinfo.c","freeaddrinfo",39,49
37,16,108,1,36,"gai_strerror@42-78@lib/libc/net/gai_strerror.c","lib/libc/net/gai_strerror.c","gai_strerror",42,78
220,45,1398,1,242,"getifaddrs@48-290@lib/libc/net/getifaddrs.c","lib/libc/net/getifaddrs.c","getifaddrs",48,290
4,1,14,1,3,"freeifaddrs@294-297@lib/libc/net/getifaddrs.c","lib/libc/net/getifaddrs.c","freeifaddrs",294,297
8,2,32,1,7,"setnetent@48-55@lib/libc/net/getnetent.c","lib/libc/net/getnetent.c","setnetent",48,55
8,2,25,1,7,"endnetent@58-65@lib/libc/net/getnetent.c","lib/libc/net/getnetent.c","endnetent",58,65
52,20,353,1,52,"getnetent@68-120@lib/libc/net/getnetent.c","lib/libc/net/getnetent.c","getnetent",68,120
13,2,75,3,13,"getpeereid@23-36@lib/libc/net/getpeereid.c","lib/libc/net/getpeereid.c","getpeereid",23,36
13,5,90,3,13,"getprotobynumber_r@35-48@lib/libc/net/getproto.c","lib/libc/net/getproto.c","getprotobynumber_r",35,48
8,2,43,1,8,"getprotobynumber@52-60@lib/libc/net/getproto.c","lib/libc/net/getproto.c","getprotobynumber",52,60
8,2,45,2,7,"setprotoent_r@42-49@lib/libc/net/getprotoent.c","lib/libc/net/getprotoent.c","setprotoent_r",42,49
13,2,68,1,12,"endprotoent_r@53-65@lib/libc/net/getprotoent.c","lib/libc/net/getprotoent.c","endprotoent_r",53,65
75,27,547,2,75,"getprotoent_r@69-144@lib/libc/net/getprotoent.c","lib/libc/net/getprotoent.c","getprotoent_r",69,144
4,1,15,1,3,"setprotoent@150-153@lib/libc/net/getprotoent.c","lib/libc/net/getprotoent.c","setprotoent",150,153
4,1,12,1,3,"endprotoent@156-159@lib/libc/net/getprotoent.c","lib/libc/net/getprotoent.c","endprotoent",156,159
7,2,35,1,7,"getprotoent@162-169@lib/libc/net/getprotoent.c","lib/libc/net/getprotoent.c","getprotoent",162,169
20,7,133,3,20,"getprotobyname_r@36-56@lib/libc/net/getprotoname.c","lib/libc/net/getprotoname.c","getprotobyname_r",36,56
8,2,45,1,8,"getprotobyname@60-68@lib/libc/net/getprotoname.c","lib/libc/net/getprotoname.c","getprotobyname",60,68
23,9,158,4,23,"getservbyname_r@36-59@lib/libc/net/getservbyname.c","lib/libc/net/getservbyname.c","getservbyname_r",36,59
8,2,52,2,8,"getservbyname@63-71@lib/libc/net/getservbyname.c","lib/libc/net/getservbyname.c","getservbyname",63,71
17,7,113,4,17,"getservbyport_r@36-53@lib/libc/net/getservbyport.c","lib/libc/net/getservbyport.c","getservbyport_r",36,53
8,2,50,2,8,"getservbyport@57-65@lib/libc/net/getservbyport.c","lib/libc/net/getservbyport.c","getservbyport",57,65
8,2,45,2,7,"setservent_r@42-49@lib/libc/net/getservent.c","lib/libc/net/getservent.c","setservent_r",42,49
13,2,68,1,12,"endservent_r@53-65@lib/libc/net/getservent.c","lib/libc/net/getservent.c","endservent_r",53,65
77,27,571,2,77,"getservent_r@69-146@lib/libc/net/getservent.c","lib/libc/net/getservent.c","getservent_r",69,146
4,1,15,1,3,"setservent@152-155@lib/libc/net/getservent.c","lib/libc/net/getservent.c","setservent",152,155
4,1,12,1,3,"endservent@158-161@lib/libc/net/getservent.c","lib/libc/net/getservent.c","endservent",158,161
7,2,35,1,7,"getservent@164-171@lib/libc/net/getservent.c","lib/libc/net/getservent.c","getservent",164,171
19,3,123,1,19,"herror@76-95@lib/libc/net/herror.c","lib/libc/net/herror.c","herror",76,95
8,3,38,1,7,"hstrerror@98-105@lib/libc/net/herror.c","lib/libc/net/herror.c","hstrerror",98,105
6,2,56,1,8,"htonl@13-21@lib/libc/net/htonl.c","lib/libc/net/htonl.c","htonl",13,21
6,2,40,1,8,"htons@13-21@lib/libc/net/htons.c","lib/libc/net/htons.c","htons",13,21
16,4,93,2,18,"if_indextoname@59-77@lib/libc/net/if_indextoname.c","lib/libc/net/if_indextoname.c","if_indextoname",59,77
49,9,318,1,58,"if_nameindex@79-137@lib/libc/net/if_nameindex.c","lib/libc/net/if_nameindex.c","if_nameindex",79,137
4,1,14,1,3,"if_freenameindex@140-143@lib/libc/net/if_nameindex.c","lib/libc/net/if_nameindex.c","if_freenameindex",140,143
17,4,96,1,19,"if_nametoindex@57-76@lib/libc/net/if_nametoindex.c","lib/libc/net/if_nametoindex.c","if_nametoindex",57,76
7,2,35,1,7,"inet_addr@64-71@lib/libc/net/inet_addr.c","lib/libc/net/inet_addr.c","inet_addr",64,71
70,33,514,2,93,"inet_aton@81-174@lib/libc/net/inet_addr.c","lib/libc/net/inet_addr.c","inet_aton",81,174
10,3,61,1,10,"inet_lnaof@40-50@lib/libc/net/inet_lnaof.c","lib/libc/net/inet_lnaof.c","inet_lnaof",40,50
14,4,104,2,14,"inet_makeaddr@39-53@lib/libc/net/inet_makeaddr.c","lib/libc/net/inet_makeaddr.c","inet_makeaddr",39,53
12,3,73,5,11,"inet_net_ntop@45-56@lib/libc/net/inet_net_ntop.c","lib/libc/net/inet_net_ntop.c","inet_net_ntop",45,56
57,20,357,4,65,"inet_net_ntop_ipv4@72-137@lib/libc/net/inet_net_ntop.c","lib/libc/net/inet_net_ntop.c","inet_net_ntop_ipv4",72,137
17,6,114,4,20,"inet_net_ntop_ipv6@140-160@lib/libc/net/inet_net_ntop.c","lib/libc/net/inet_net_ntop.c","inet_net_ntop_ipv6",140,160
12,3,67,4,11,"inet_net_pton@50-61@lib/libc/net/inet_net_pton.c","lib/libc/net/inet_net_pton.c","inet_net_pton",50,61
109,51,738,3,122,"inet_net_pton_ipv4@80-202@lib/libc/net/inet_net_pton.c","lib/libc/net/inet_net_pton.c","inet_net_pton_ipv4",80,202
26,6,153,3,31,"inet_net_pton_ipv6@206-237@lib/libc/net/inet_net_pton.c","lib/libc/net/inet_net_pton.c","inet_net_pton_ipv6",206,237
37,12,197,3,39,"inet_neta@41-80@lib/libc/net/inet_neta.c","lib/libc/net/inet_neta.c","inet_neta",41,80
10,3,76,1,10,"inet_netof@39-49@lib/libc/net/inet_netof.c","lib/libc/net/inet_netof.c","inet_netof",39,49
42,15,272,1,42,"inet_network@42-84@lib/libc/net/inet_network.c","lib/libc/net/inet_network.c","inet_network",42,84
9,1,80,1,10,"inet_ntoa@41-51@lib/libc/net/inet_ntoa.c","lib/libc/net/inet_ntoa.c","inet_ntoa",41,51
12,3,66,4,12,"inet_ntop@45-57@lib/libc/net/inet_ntop.c","lib/libc/net/inet_ntop.c","inet_ntop",45,57
13,3,95,3,13,"inet_ntop4@72-85@lib/libc/net/inet_ntop.c","lib/libc/net/inet_ntop.c","inet_ntop4",72,85
87,35,638,3,111,"inet_ntop6@94-205@lib/libc/net/inet_ntop.c","lib/libc/net/inet_ntop.c","inet_ntop6",94,205
12,3,60,3,12,"inet_pton@47-59@lib/libc/net/inet_pton.c","lib/libc/net/inet_pton.c","inet_pton",47,59
33,10,207,2,36,"inet_pton4@73-109@lib/libc/net/inet_pton.c","lib/libc/net/inet_pton.c","inet_pton4",73,109
82,22,512,2,89,"inet_pton6@124-213@lib/libc/net/inet_pton.c","lib/libc/net/inet_pton.c","inet_pton6",124,213
14,4,71,2,16,"ip6optlen@50-66@lib/libc/net/ip6opt.c","lib/libc/net/ip6opt.c","ip6optlen",50,66
10,4,65,2,11,"inet6_opt_init@74-85@lib/libc/net/ip6opt.c","lib/libc/net/ip6opt.c","inet6_opt_init",74,85
37,17,244,7,65,"inet6_opt_append@88-153@lib/libc/net/ip6opt.c","lib/libc/net/ip6opt.c","inet6_opt_append",88,153
19,6,129,3,22,"inet6_opt_finish@156-178@lib/libc/net/ip6opt.c","lib/libc/net/ip6opt.c","inet6_opt_finish",156,178
5,1,40,4,5,"inet6_opt_set_val@181-186@lib/libc/net/ip6opt.c","lib/libc/net/ip6opt.c","inet6_opt_set_val",181,186
35,9,214,6,45,"inet6_opt_next@189-234@lib/libc/net/ip6opt.c","lib/libc/net/ip6opt.c","inet6_opt_next",189,234
26,7,176,6,38,"inet6_opt_find@237-275@lib/libc/net/ip6opt.c","lib/libc/net/ip6opt.c","inet6_opt_find",237,275
5,1,40,4,7,"inet6_opt_get_val@278-285@lib/libc/net/ip6opt.c","lib/libc/net/ip6opt.c","inet6_opt_get_val",278,285
42,10,254,1,45,"link_ntoa@40-85@lib/libc/net/linkaddr.c","lib/libc/net/linkaddr.c","link_ntoa",40,85
6,2,56,1,8,"ntohl@13-21@lib/libc/net/ntohl.c","lib/libc/net/ntohl.c","ntohl",13,21
6,2,40,1,8,"ntohs@13-21@lib/libc/net/ntohs.c","lib/libc/net/ntohs.c","ntohs",13,21
5,1,48,6,4,"rcmd@53-57@lib/libc/net/rcmd.c","lib/libc/net/rcmd.c","rcmd",53,57
216,44,1468,7,234,"rcmd_af@60-294@lib/libc/net/rcmd.c","lib/libc/net/rcmd.c","rcmd_af",60,294
113,29,862,6,137,"rcmdsh@56-193@lib/libc/net/rcmdsh.c","lib/libc/net/rcmdsh.c","rcmdsh",56,193
4,1,35,4,3,"recv@37-40@lib/libc/net/recv.c","lib/libc/net/recv.c","recv",37,40
54,18,327,5,67,"dn_expand@76-143@lib/libc/net/res_comp.c","lib/libc/net/res_comp.c","dn_expand",76,143
69,23,423,5,72,"dn_comp@159-231@lib/libc/net/res_comp.c","lib/libc/net/res_comp.c","dn_comp",159,231
22,5,96,2,25,"__dn_skipname@237-262@lib/libc/net/res_comp.c","lib/libc/net/res_comp.c","__dn_skipname",237,262
6,3,32,1,5,"mklower@265-270@lib/libc/net/res_comp.c","lib/libc/net/res_comp.c","mklower",265,270
37,13,225,4,42,"dn_find@279-321@lib/libc/net/res_comp.c","lib/libc/net/res_comp.c","dn_find",279,321
21,9,124,1,22,"__res_hnok@348-370@lib/libc/net/res_comp.c","lib/libc/net/res_comp.c","__res_hnok",348,370
10,4,63,1,9,"res_ownok@378-387@lib/libc/net/res_comp.c","lib/libc/net/res_comp.c","res_ownok",378,387
19,9,107,1,22,"res_mailok@394-416@lib/libc/net/res_comp.c","lib/libc/net/res_comp.c","res_mailok",394,416
8,3,42,1,8,"res_dnok@423-431@lib/libc/net/res_comp.c","lib/libc/net/res_comp.c","res_dnok",423,431
6,1,24,1,6,"_getshort@438-444@lib/libc/net/res_comp.c","lib/libc/net/res_comp.c","_getshort",438,444
6,1,24,1,6,"_getlong@448-454@lib/libc/net/res_comp.c","lib/libc/net/res_comp.c","_getlong",448,454
4,1,18,2,3,"__putshort@458-461@lib/libc/net/res_comp.c","lib/libc/net/res_comp.c","__putshort",458,461
4,1,18,2,3,"__putlong@464-467@lib/libc/net/res_comp.c","lib/libc/net/res_comp.c","__putlong",464,467
15,5,90,3,16,"__sym_ntos@154-170@lib/libc/net/res_debug_syms.c","lib/libc/net/res_debug_syms.c","__sym_ntos",154,170
4,1,23,1,3,"__p_type@177-180@lib/libc/net/res_debug_syms.c","lib/libc/net/res_debug_syms.c","__p_type",177,180
4,1,23,1,3,"__p_class@187-190@lib/libc/net/res_debug_syms.c","lib/libc/net/res_debug_syms.c","__p_class",187,190
14,3,74,3,15,"pmod@114-129@lib/libc/net/res_random.c","lib/libc/net/res_random.c","pmod",114,129
19,4,137,1,27,"permute15@135-162@lib/libc/net/res_random.c","lib/libc/net/res_random.c","permute15",135,162
35,9,234,1,52,"res_initid@173-225@lib/libc/net/res_random.c","lib/libc/net/res_random.c","res_initid",173,225
19,4,113,1,26,"__res_randomid@228-254@lib/libc/net/res_random.c","lib/libc/net/res_random.c","__res_randomid",228,254
18,3,112,2,20,"main@259-279@lib/libc/net/res_random.c","lib/libc/net/res_random.c","main",259,279
4,1,16,1,3,"rresvport@52-55@lib/libc/net/rresvport.c","lib/libc/net/rresvport.c","rresvport",52,55
43,8,266,2,47,"rresvport_af@59-106@lib/libc/net/rresvport.c","lib/libc/net/rresvport.c","rresvport_af",59,106
9,2,42,2,8,"inet6_rth_space@47-55@lib/libc/net/rthdr.c","lib/libc/net/rthdr.c","inet6_rth_space",47,55
20,3,117,4,23,"inet6_rth_init@59-82@lib/libc/net/rthdr.c","lib/libc/net/rthdr.c","inet6_rth_init",59,82
17,2,99,2,18,"inet6_rth_add@85-103@lib/libc/net/rthdr.c","lib/libc/net/rthdr.c","inet6_rth_add",85,103
29,4,209,2,38,"inet6_rth_reverse@106-144@lib/libc/net/rthdr.c","lib/libc/net/rthdr.c","inet6_rth_reverse",106,144
16,4,97,1,22,"inet6_rth_segments@147-169@lib/libc/net/rthdr.c","lib/libc/net/rthdr.c","inet6_rth_segments",147,169
19,6,128,2,26,"inet6_rth_getaddr@172-198@lib/libc/net/rthdr.c","lib/libc/net/rthdr.c","inet6_rth_getaddr",172,198
20,4,145,4,21,"ruserok@58-79@lib/libc/net/ruserok.c","lib/libc/net/ruserok.c","ruserok",58,79
57,16,387,5,70,"iruserok_sa@82-152@lib/libc/net/ruserok.c","lib/libc/net/ruserok.c","iruserok_sa",82,152
120,49,753,5,138,"__ivaliduser_sa@155-293@lib/libc/net/ruserok.c","lib/libc/net/ruserok.c","__ivaliduser_sa",155,293
30,6,224,3,38,"__icheckhost@300-338@lib/libc/net/ruserok.c","lib/libc/net/ruserok.c","__icheckhost",300,338
35,7,266,2,46,"__gethostloop@346-392@lib/libc/net/ruserok.c","lib/libc/net/ruserok.c","__gethostloop",346,392
4,1,36,4,3,"send@37-40@lib/libc/net/send.c","lib/libc/net/send.c","send",37,40
7,2,36,1,7,"sockatmark@33-40@lib/libc/net/sockatmark.c","lib/libc/net/sockatmark.c","sockatmark",33,40
12,3,52,1,13,"catclose@40-53@lib/libc/nls/catclose.c","lib/libc/nls/catclose.c","catclose",40,53
47,8,346,4,57,"catgets@39-96@lib/libc/nls/catgets.c","lib/libc/nls/catgets.c","catgets",39,96
95,46,556,2,108,"catopen@52-160@lib/libc/nls/catopen.c","lib/libc/nls/catopen.c","catopen",52,160
37,9,246,1,48,"load_msgcat@164-212@lib/libc/nls/catopen.c","lib/libc/nls/catopen.c","load_msgcat",164,212
46,17,408,1,67,"verify_msgcat@215-282@lib/libc/nls/catopen.c","lib/libc/nls/catopen.c","verify_msgcat",215,282
9,1,95,2,9,"__adddi3@43-52@lib/libc/quad/adddi3.c","lib/libc/quad/adddi3.c","__adddi3",43,52
9,1,63,2,9,"__anddi3@41-50@lib/libc/quad/anddi3.c","lib/libc/quad/anddi3.c","__anddi3",41,50
16,3,124,2,16,"__ashldi3@42-58@lib/libc/quad/ashldi3.c","lib/libc/quad/ashldi3.c","__ashldi3",42,58
18,3,148,2,26,"__ashrdi3@41-67@lib/libc/quad/ashrdi3.c","lib/libc/quad/ashrdi3.c","__ashrdi3",41,67
8,5,97,2,8,"__cmpdi2@43-51@lib/libc/quad/cmpdi2.c","lib/libc/quad/cmpdi2.c","__cmpdi2",43,51
15,4,87,2,17,"__divdi3@42-59@lib/libc/quad/divdi3.c","lib/libc/quad/divdi3.c","__divdi3",42,59
13,4,62,1,12,"__fixdfdi@42-54@lib/libc/quad/fixdfdi.c","lib/libc/quad/fixdfdi.c","__fixdfdi",42,54
13,4,62,1,12,"__fixsfdi@44-56@lib/libc/quad/fixsfdi.c","lib/libc/quad/fixsfdi.c","__fixsfdi",44,56
15,5,91,1,25,"__fixunsdfdi@47-72@lib/libc/quad/fixunsdfdi.c","lib/libc/quad/fixunsdfdi.c","__fixunsdfdi",47,72
26,7,155,1,42,"__fixunssfdi@51-93@lib/libc/quad/fixunssfdi.c","lib/libc/quad/fixunssfdi.c","__fixunssfdi",51,93
13,3,96,1,25,"__floatdidf@41-66@lib/libc/quad/floatdidf.c","lib/libc/quad/floatdidf.c","__floatdidf",41,66
13,3,96,1,27,"__floatdisf@41-68@lib/libc/quad/floatdisf.c","lib/libc/quad/floatdisf.c","__floatdisf",41,68
9,1,66,1,9,"__floatunsdidf@42-51@lib/libc/quad/floatunsdidf.c","lib/libc/quad/floatunsdidf.c","__floatunsdidf",42,51
9,1,63,2,9,"__iordi3@41-50@lib/libc/quad/iordi3.c","lib/libc/quad/iordi3.c","__iordi3",41,50
16,3,124,2,16,"__lshldi3@42-58@lib/libc/quad/lshldi3.c","lib/libc/quad/lshldi3.c","__lshldi3",42,58
16,3,124,2,16,"__lshrdi3@41-57@lib/libc/quad/lshrdi3.c","lib/libc/quad/lshrdi3.c","__lshrdi3",41,57
15,4,83,2,16,"__moddi3@43-59@lib/libc/quad/moddi3.c","lib/libc/quad/moddi3.c","__moddi3",43,59
34,9,248,2,65,"__muldi3@97-162@lib/libc/quad/muldi3.c","lib/libc/quad/muldi3.c","__muldi3",97,162
43,7,289,2,57,"__lmulq@182-239@lib/libc/quad/muldi3.c","lib/libc/quad/muldi3.c","__lmulq",182,239
8,1,67,1,8,"__negdi2@41-49@lib/libc/quad/negdi2.c","lib/libc/quad/negdi2.c","__negdi2",41,49
8,1,52,1,8,"__one_cmpldi2@42-50@lib/libc/quad/notdi2.c","lib/libc/quad/notdi2.c","__one_cmpldi2",42,50
121,22,1120,3,193,"__qdivrem@65-258@lib/libc/quad/qdivrem.c","lib/libc/quad/qdivrem.c","__qdivrem",65,258
8,2,97,3,8,"shl@266-274@lib/libc/quad/qdivrem.c","lib/libc/quad/qdivrem.c","shl",266,274
9,1,95,2,9,"__subdi3@42-51@lib/libc/quad/subdi3.c","lib/libc/quad/subdi3.c","__subdi3",42,51
8,5,97,2,8,"__ucmpdi2@42-50@lib/libc/quad/ucmpdi2.c","lib/libc/quad/ucmpdi2.c","__ucmpdi2",42,50
4,1,26,2,4,"__udivdi3@41-45@lib/libc/quad/udivdi3.c","lib/libc/quad/udivdi3.c","__udivdi3",41,45
6,1,31,2,6,"__umoddi3@41-47@lib/libc/quad/umoddi3.c","lib/libc/quad/umoddi3.c","__umoddi3",41,47
9,1,63,2,9,"__xordi3@41-50@lib/libc/quad/xordi3.c","lib/libc/quad/xordi3.c","__xordi3",41,50
134,41,1005,5,155,"matcher@129-284@lib/libc/regex/engine.c","lib/libc/regex/engine.c","matcher",129,284
158,42,999,5,175,"dissect@290-465@lib/libc/regex/engine.c","lib/libc/regex/engine.c","dissect",290,465
181,71,1446,7,191,"backref@471-662@lib/libc/regex/engine.c","lib/libc/regex/engine.c","backref",471,662
71,33,585,5,82,"fast@668-750@lib/libc/regex/engine.c","lib/libc/regex/engine.c","fast",668,750
66,32,561,5,77,"slow@756-833@lib/libc/regex/engine.c","lib/libc/regex/engine.c","slow",756,833
107,38,663,6,110,"step@840-950@lib/libc/regex/engine.c","lib/libc/regex/engine.c","step",840,950
17,5,142,5,18,"print@957-975@lib/libc/regex/engine.c","lib/libc/regex/engine.c","print",957,975
9,2,88,6,9,"at@981-990@lib/libc/regex/engine.c","lib/libc/regex/engine.c","at",981,990
14,5,106,1,14,"pchar@1009-1023@lib/libc/regex/engine.c","lib/libc/regex/engine.c","pchar",1009,1023
74,13,529,3,93,"regcomp@147-240@lib/libc/regex/regcomp.c","lib/libc/regex/regcomp.c","regcomp",147,240
32,8,176,2,37,"p_ere@246-283@lib/libc/regex/regcomp.c","lib/libc/regex/regcomp.c","p_ere",246,283
121,41,701,1,129,"p_ere_exp@289-418@lib/libc/regex/regcomp.c","lib/libc/regex/regcomp.c","p_ere_exp",289,418
6,2,33,1,5,"p_str@424-429@lib/libc/regex/regcomp.c","lib/libc/regex/regcomp.c","p_str",424,429
24,5,136,3,25,"p_bre@442-467@lib/libc/regex/regcomp.c","lib/libc/regex/regcomp.c","p_bre",442,467
109,35,691,2,116,"p_simp_re@473-589@lib/libc/regex/regcomp.c","lib/libc/regex/regcomp.c","p_simp_re",473,589
11,5,76,1,12,"p_count@595-607@lib/libc/regex/regcomp.c","lib/libc/regex/regcomp.c","p_count",595,607
63,27,457,1,73,"p_bracket@616-689@lib/libc/regex/regcomp.c","lib/libc/regex/regcomp.c","p_bracket",616,689
52,14,302,2,57,"p_b_term@695-752@lib/libc/regex/regcomp.c","lib/libc/regex/regcomp.c","p_b_term",695,752
23,9,178,2,25,"p_b_cclass@758-783@lib/libc/regex/regcomp.c","lib/libc/regex/regcomp.c","p_b_cclass",758,783
6,1,32,2,6,"p_b_eclass@791-797@lib/libc/regex/regcomp.c","lib/libc/regex/regcomp.c","p_b_eclass",791,797
10,2,64,1,12,"p_b_symbol@803-815@lib/libc/regex/regcomp.c","lib/libc/regex/regcomp.c","p_b_symbol",803,815
21,8,141,2,21,"p_b_coll_elem@821-842@lib/libc/regex/regcomp.c","lib/libc/regex/regcomp.c","p_b_coll_elem",821,842
11,3,65,1,10,"othercase@848-858@lib/libc/regex/regcomp.c","lib/libc/regex/regcomp.c","othercase",848,858
17,1,114,2,17,"bothcases@866-883@lib/libc/regex/regcomp.c","lib/libc/regex/regcomp.c","bothcases",866,883
11,5,90,2,11,"ordinary@889-900@lib/libc/regex/regcomp.c","lib/libc/regex/regcomp.c","ordinary",889,900
14,3,53,2,13,"backslash@906-919@lib/libc/regex/regcomp.c","lib/libc/regex/regcomp.c","backslash",906,919
16,1,101,1,16,"nonnewline@927-943@lib/libc/regex/regcomp.c","lib/libc/regex/regcomp.c","nonnewline",927,943
55,11,362,4,64,"repeat@949-1013@lib/libc/regex/regcomp.c","lib/libc/regex/regcomp.c","repeat",949,1013
8,2,43,2,7,"seterr@1019-1026@lib/libc/regex/regcomp.c","lib/libc/regex/regcomp.c","seterr",1019,1026
43,7,359,1,53,"allocset@1032-1085@lib/libc/regex/regcomp.c","lib/libc/regex/regcomp.c","allocset",1032,1085
10,3,81,2,10,"freeset@1091-1101@lib/libc/regex/regcomp.c","lib/libc/regex/regcomp.c","freeset",1091,1101
21,8,170,2,25,"freezeset@1113-1138@lib/libc/regex/regcomp.c","lib/libc/regex/regcomp.c","freezeset",1113,1138
10,3,68,2,10,"firstch@1144-1154@lib/libc/regex/regcomp.c","lib/libc/regex/regcomp.c","firstch",1144,1154
10,3,63,2,10,"nch@1160-1170@lib/libc/regex/regcomp.c","lib/libc/regex/regcomp.c","nch",1160,1170
15,2,107,3,16,"mcadd@1176-1192@lib/libc/regex/regcomp.c","lib/libc/regex/regcomp.c","mcadd",1176,1192
4,1,22,2,3,"mcinvert@1201-1204@lib/libc/regex/regcomp.c","lib/libc/regex/regcomp.c","mcinvert",1201,1204
4,1,22,2,3,"mccase@1213-1216@lib/libc/regex/regcomp.c","lib/libc/regex/regcomp.c","mccase",1213,1216
11,3,88,2,11,"isinsets@1222-1233@lib/libc/regex/regcomp.c","lib/libc/regex/regcomp.c","isinsets",1222,1233
12,3,102,3,12,"samesets@1239-1251@lib/libc/regex/regcomp.c","lib/libc/regex/regcomp.c","samesets",1239,1251
17,8,126,2,19,"categorize@1257-1276@lib/libc/regex/regcomp.c","lib/libc/regex/regcomp.c","categorize",1257,1276
15,3,104,3,15,"dupl@1282-1297@lib/libc/regex/regcomp.c","lib/libc/regex/regcomp.c","dupl",1282,1297
10,4,84,3,16,"doemit@1307-1323@lib/libc/regex/regcomp.c","lib/libc/regex/regcomp.c","doemit",1307,1323
24,5,187,4,29,"doinsert@1329-1358@lib/libc/regex/regcomp.c","lib/libc/regex/regcomp.c","doinsert",1329,1358
7,2,54,3,8,"dofwd@1364-1372@lib/libc/regex/regcomp.c","lib/libc/regex/regcomp.c","dofwd",1364,1372
14,3,74,2,15,"enlarge@1378-1393@lib/libc/regex/regcomp.c","lib/libc/regex/regcomp.c","enlarge",1378,1393
9,2,65,2,8,"stripsnug@1399-1407@lib/libc/regex/regcomp.c","lib/libc/regex/regcomp.c","stripsnug",1399,1407
64,20,352,2,72,"findmust@1419-1491@lib/libc/regex/regcomp.c","lib/libc/regex/regcomp.c","findmust",1419,1491
26,7,123,2,27,"pluscount@1497-1524@lib/libc/regex/regcomp.c","lib/libc/regex/regcomp.c","pluscount",1497,1524
30,7,197,4,33,"regerror@78-111@lib/libc/regex/regerror.c","lib/libc/regex/regerror.c","regerror",78,111
11,4,87,3,12,"regatoi@117-129@lib/libc/regex/regerror.c","lib/libc/regex/regerror.c","regatoi",117,129
16,7,148,5,23,"regexec@140-163@lib/libc/regex/regexec.c","lib/libc/regex/regexec.c","regexec",140,163
16,4,88,1,18,"regfree@50-68@lib/libc/regex/regfree.c","lib/libc/regex/regfree.c","regfree",50,68
24,4,161,1,24,"authnone_create@71-95@lib/libc/rpc/auth_none.c","lib/libc/rpc/auth_none.c","authnone_create",71,95
8,2,53,2,8,"authnone_marshal@99-107@lib/libc/rpc/auth_none.c","lib/libc/rpc/auth_none.c","authnone_marshal",99,107
3,1,9,1,2,"authnone_verf@110-112@lib/libc/rpc/auth_none.c","lib/libc/rpc/auth_none.c","authnone_verf",110,112
4,1,19,2,4,"authnone_validate@115-119@lib/libc/rpc/auth_none.c","lib/libc/rpc/auth_none.c","authnone_validate",115,119
4,1,14,1,4,"authnone_refresh@122-126@lib/libc/rpc/auth_none.c","lib/libc/rpc/auth_none.c","authnone_refresh",122,126
3,1,9,1,2,"authnone_destroy@129-131@lib/libc/rpc/auth_none.c","lib/libc/rpc/auth_none.c","authnone_destroy",129,131
45,6,334,5,68,"authunix_create@92-160@lib/libc/rpc/auth_unix.c","lib/libc/rpc/auth_unix.c","authunix_create",92,160
5,2,17,1,4,"set_rpc_maxgrouplist@172-176@lib/libc/rpc/auth_unix.c","lib/libc/rpc/auth_unix.c","set_rpc_maxgrouplist",172,176
21,5,143,1,21,"authunix_create_default@183-204@lib/libc/rpc/auth_unix.c","lib/libc/rpc/auth_unix.c","authunix_create_default",183,204
3,1,8,1,3,"authunix_nextverf@211-214@lib/libc/rpc/auth_unix.c","lib/libc/rpc/auth_unix.c","authunix_nextverf",211,214
5,1,38,2,5,"authunix_marshal@217-222@lib/libc/rpc/auth_unix.c","lib/libc/rpc/auth_unix.c","authunix_marshal",217,222
24,4,161,2,25,"authunix_validate@225-250@lib/libc/rpc/auth_unix.c","lib/libc/rpc/auth_unix.c","authunix_validate",225,250
33,4,205,1,39,"authunix_refresh@253-292@lib/libc/rpc/auth_unix.c","lib/libc/rpc/auth_unix.c","authunix_refresh",253,292
11,3,110,1,15,"authunix_destroy@295-310@lib/libc/rpc/auth_unix.c","lib/libc/rpc/auth_unix.c","authunix_destroy",295,310
13,3,92,1,14,"marshal_new_auth@317-331@lib/libc/rpc/auth_unix.c","lib/libc/rpc/auth_unix.c","marshal_new_auth",317,331
12,6,109,2,12,"xdr_authunix_parms@48-60@lib/libc/rpc/authunix_prot.c","lib/libc/rpc/authunix_prot.c","xdr_authunix_parms",48,60
4,1,25,2,3,"bindresvport@38-41@lib/libc/rpc/bindresvport.c","lib/libc/rpc/bindresvport.c","bindresvport",38,41
65,13,401,2,76,"bindresvport_sa@48-124@lib/libc/rpc/bindresvport.c","lib/libc/rpc/bindresvport.c","bindresvport_sa",48,124
52,8,311,4,55,"clnt_create@46-101@lib/libc/rpc/clnt_generic.c","lib/libc/rpc/clnt_generic.c","clnt_create",46,101
83,37,468,2,91,"clnt_sperror@51-142@lib/libc/rpc/clnt_perror.c","lib/libc/rpc/clnt_perror.c","clnt_sperror",51,142
4,1,29,2,3,"clnt_perror@146-149@lib/libc/rpc/clnt_perror.c","lib/libc/rpc/clnt_perror.c","clnt_perror",146,149
7,2,48,1,8,"clnt_sperrno@178-186@lib/libc/rpc/clnt_perror.c","lib/libc/rpc/clnt_perror.c","clnt_sperrno",178,186
4,1,23,1,3,"clnt_perrno@190-193@lib/libc/rpc/clnt_perror.c","lib/libc/rpc/clnt_perror.c","clnt_perrno",190,193
22,3,134,1,23,"clnt_spcreateerror@197-220@lib/libc/rpc/clnt_perror.c","lib/libc/rpc/clnt_perror.c","clnt_spcreateerror",197,220
4,1,20,1,3,"clnt_pcreateerror@224-227@lib/libc/rpc/clnt_perror.c","lib/libc/rpc/clnt_perror.c","clnt_pcreateerror",224,227
7,2,48,1,8,"auth_errmsg@242-250@lib/libc/rpc/clnt_perror.c","lib/libc/rpc/clnt_perror.c","auth_errmsg",242,250
36,5,231,2,48,"clntraw_create@84-132@lib/libc/rpc/clnt_raw.c","lib/libc/rpc/clnt_raw.c","clntraw_create",84,132
57,13,395,7,73,"clntraw_call@135-208@lib/libc/rpc/clnt_raw.c","lib/libc/rpc/clnt_raw.c","clntraw_call",135,208
3,1,13,2,2,"clntraw_geterr@211-213@lib/libc/rpc/clnt_raw.c","lib/libc/rpc/clnt_raw.c","clntraw_geterr",211,213
13,2,74,3,13,"clntraw_freeres@216-229@lib/libc/rpc/clnt_raw.c","lib/libc/rpc/clnt_raw.c","clntraw_freeres",216,229
3,1,8,1,2,"clntraw_abort@232-234@lib/libc/rpc/clnt_raw.c","lib/libc/rpc/clnt_raw.c","clntraw_abort",232,234
4,1,20,3,3,"clntraw_control@237-240@lib/libc/rpc/clnt_raw.c","lib/libc/rpc/clnt_raw.c","clntraw_control",237,240
3,1,8,1,2,"clntraw_destroy@243-245@lib/libc/rpc/clnt_raw.c","lib/libc/rpc/clnt_raw.c","clntraw_destroy",243,245
63,14,466,8,67,"callrpc@56-123@lib/libc/rpc/clnt_simple.c","lib/libc/rpc/clnt_simple.c","callrpc",56,123
83,14,619,6,112,"clnttcp_create@112-224@lib/libc/rpc/clnt_tcp.c","lib/libc/rpc/clnt_tcp.c","clnttcp_create",112,224
71,26,561,7,88,"clnttcp_call@228-316@lib/libc/rpc/clnt_tcp.c","lib/libc/rpc/clnt_tcp.c","clnttcp_call",228,316
6,1,34,2,6,"clnttcp_geterr@319-325@lib/libc/rpc/clnt_tcp.c","lib/libc/rpc/clnt_tcp.c","clnttcp_geterr",319,325
7,1,58,3,7,"clnttcp_freeres@328-335@lib/libc/rpc/clnt_tcp.c","lib/libc/rpc/clnt_tcp.c","clnttcp_freeres",328,335
3,1,8,1,2,"clnttcp_abort@338-340@lib/libc/rpc/clnt_tcp.c","lib/libc/rpc/clnt_tcp.c","clnttcp_abort",338,340
19,4,104,3,19,"clnttcp_control@343-362@lib/libc/rpc/clnt_tcp.c","lib/libc/rpc/clnt_tcp.c","clnttcp_control",343,362
11,3,84,1,11,"clnttcp_destroy@366-377@lib/libc/rpc/clnt_tcp.c","lib/libc/rpc/clnt_tcp.c","clnttcp_destroy",366,377
53,12,342,3,59,"readtcp@385-444@lib/libc/rpc/clnt_tcp.c","lib/libc/rpc/clnt_tcp.c","readtcp",385,444
12,3,89,3,12,"writetcp@447-459@lib/libc/rpc/clnt_tcp.c","lib/libc/rpc/clnt_tcp.c","writetcp",447,459
79,11,558,7,81,"clntudp_bufcreate@107-188@lib/libc/rpc/clnt_udp.c","lib/libc/rpc/clnt_udp.c","clntudp_bufcreate",107,188
6,1,43,5,6,"clntudp_create@192-198@lib/libc/rpc/clnt_udp.c","lib/libc/rpc/clnt_udp.c","clntudp_create",192,198
134,32,952,7,169,"clntudp_call@202-371@lib/libc/rpc/clnt_udp.c","lib/libc/rpc/clnt_udp.c","clntudp_call",202,371
5,1,34,2,5,"clntudp_geterr@374-379@lib/libc/rpc/clnt_udp.c","lib/libc/rpc/clnt_udp.c","clntudp_geterr",374,379
7,1,58,3,7,"clntudp_freeres@383-390@lib/libc/rpc/clnt_udp.c","lib/libc/rpc/clnt_udp.c","clntudp_freeres",383,390
3,1,8,1,2,"clntudp_abort@393-395@lib/libc/rpc/clnt_udp.c","lib/libc/rpc/clnt_udp.c","clntudp_abort",393,395
24,6,132,3,24,"clntudp_control@398-422@lib/libc/rpc/clnt_udp.c","lib/libc/rpc/clnt_udp.c","clntudp_control",398,422
10,3,94,1,10,"clntudp_destroy@425-435@lib/libc/rpc/clnt_udp.c","lib/libc/rpc/clnt_udp.c","clntudp_destroy",425,435
24,9,153,1,25,"get_myaddress@59-84@lib/libc/rpc/get_myaddress.c","lib/libc/rpc/get_myaddress.c","get_myaddress",59,84
9,2,43,1,9,"_rpcdata@58-67@lib/libc/rpc/getrpcent.c","lib/libc/rpc/getrpcent.c","_rpcdata",58,67
14,4,68,1,14,"getrpcbynumber@70-84@lib/libc/rpc/getrpcent.c","lib/libc/rpc/getrpcent.c","getrpcbynumber",70,84
17,5,94,1,17,"getrpcbyname@87-104@lib/libc/rpc/getrpcent.c","lib/libc/rpc/getrpcent.c","getrpcbyname",87,104
11,3,57,1,11,"setrpcent@107-118@lib/libc/rpc/getrpcent.c","lib/libc/rpc/getrpcent.c","setrpcent",107,118
10,4,49,1,10,"endrpcent@122-132@lib/libc/rpc/getrpcent.c","lib/libc/rpc/getrpcent.c","endrpcent",122,132
11,4,100,1,12,"getrpcent@136-148@lib/libc/rpc/getrpcent.c","lib/libc/rpc/getrpcent.c","getrpcent",136,148
46,15,321,2,47,"interpret@152-199@lib/libc/rpc/getrpcent.c","lib/libc/rpc/getrpcent.c","interpret",152,199
13,2,114,4,13,"getrpcport@42-55@lib/libc/rpc/getrpcport.c","lib/libc/rpc/getrpcport.c","getrpcport",42,55
30,4,179,4,30,"pmap_set@53-83@lib/libc/rpc/pmap_clnt.c","lib/libc/rpc/pmap_clnt.c","pmap_set",53,83
22,3,140,2,22,"pmap_unset@91-113@lib/libc/rpc/pmap_clnt.c","lib/libc/rpc/pmap_clnt.c","pmap_unset",91,113
22,3,127,1,22,"pmap_getmaps@58-80@lib/libc/rpc/pmap_getmaps.c","lib/libc/rpc/pmap_getmaps.c","pmap_getmaps",58,80
27,4,170,4,27,"pmap_getport@55-82@lib/libc/rpc/pmap_getport.c","lib/libc/rpc/pmap_getport.c","pmap_getport",55,82
8,4,63,2,8,"xdr_pmap@45-53@lib/libc/rpc/pmap_prot.c","lib/libc/rpc/pmap_prot.c","xdr_pmap",45,53
19,7,140,2,29,"xdr_pmaplist@83-112@lib/libc/rpc/pmap_prot2.c","lib/libc/rpc/pmap_prot2.c","xdr_pmaplist",83,112
29,2,185,10,29,"pmap_rmtcall@67-96@lib/libc/rpc/pmap_rmt.c","lib/libc/rpc/pmap_rmt.c","pmap_rmtcall",67,96
22,7,183,2,22,"xdr_rmtcall_args@104-126@lib/libc/rpc/pmap_rmt.c","lib/libc/rpc/pmap_rmt.c","xdr_rmtcall_args",104,126
11,3,88,2,11,"xdr_rmtcallres@134-145@lib/libc/rpc/pmap_rmt.c","lib/libc/rpc/pmap_rmt.c","xdr_rmtcallres",134,145
38,15,235,1,42,"newgetbroadcastnets@155-197@lib/libc/rpc/pmap_rmt.c","lib/libc/rpc/pmap_rmt.c","newgetbroadcastnets",155,197
152,28,926,8,180,"clnt_broadcast@202-382@lib/libc/rpc/pmap_rmt.c","lib/libc/rpc/pmap_rmt.c","clnt_broadcast",202,382
131,37,964,2,142,"xdr_callmsg@43-185@lib/libc/rpc/rpc_callmsg.c","lib/libc/rpc/rpc_callmsg.c","xdr_callmsg",43,185
7,2,52,2,7,"xdr_opaque_auth@56-63@lib/libc/rpc/rpc_prot.c","lib/libc/rpc/rpc_prot.c","xdr_opaque_auth",56,63
4,1,30,2,3,"xdr_des_block@70-73@lib/libc/rpc/rpc_prot.c","lib/libc/rpc/rpc_prot.c","xdr_des_block",70,73
17,6,140,2,19,"xdr_accepted_reply@81-100@lib/libc/rpc/rpc_prot.c","lib/libc/rpc/rpc_prot.c","xdr_accepted_reply",81,100
14,5,114,2,16,"xdr_rejected_reply@107-123@lib/libc/rpc/rpc_prot.c","lib/libc/rpc/rpc_prot.c","xdr_rejected_reply",107,123
9,4,91,2,8,"xdr_replymsg@135-143@lib/libc/rpc/rpc_prot.c","lib/libc/rpc/rpc_prot.c","xdr_replymsg",135,143
12,6,113,2,12,"xdr_callhdr@152-164@lib/libc/rpc/rpc_prot.c","lib/libc/rpc/rpc_prot.c","xdr_callhdr",152,164
26,7,113,2,33,"accepted@170-203@lib/libc/rpc/rpc_prot.c","lib/libc/rpc/rpc_prot.c","accepted",170,203
14,3,69,2,17,"rejected@206-223@lib/libc/rpc/rpc_prot.c","lib/libc/rpc/rpc_prot.c","rejected",206,223
34,7,197,2,42,"_seterr_reply@229-271@lib/libc/rpc/rpc_prot.c","lib/libc/rpc/rpc_prot.c","_seterr_reply",229,271
4,1,16,1,4,"xprt_register@86-90@lib/libc/rpc/svc.c","lib/libc/rpc/svc.c","xprt_register",86,90
23,7,133,1,26,"__xprt_register@96-122@lib/libc/rpc/svc.c","lib/libc/rpc/svc.c","__xprt_register",96,122
54,15,367,1,67,"svc_fd_insert@132-199@lib/libc/rpc/svc.c","lib/libc/rpc/svc.c","svc_fd_insert",132,199
47,17,293,1,59,"svc_fd_remove@207-266@lib/libc/rpc/svc.c","lib/libc/rpc/svc.c","svc_fd_remove",207,266
8,2,38,1,8,"xprt_unregister@272-280@lib/libc/rpc/svc.c","lib/libc/rpc/svc.c","xprt_unregister",272,280
25,5,157,5,26,"svc_register@292-318@lib/libc/rpc/svc.c","lib/libc/rpc/svc.c","svc_register",292,318
15,3,99,2,16,"svc_unregister@325-341@lib/libc/rpc/svc.c","lib/libc/rpc/svc.c","svc_unregister",325,341
13,4,82,3,13,"svc_find@348-361@lib/libc/rpc/svc.c","lib/libc/rpc/svc.c","svc_find",348,361
11,1,81,3,11,"svc_sendreply@369-380@lib/libc/rpc/svc.c","lib/libc/rpc/svc.c","svc_sendreply",369,380
9,1,52,1,9,"svcerr_noproc@387-396@lib/libc/rpc/svc.c","lib/libc/rpc/svc.c","svcerr_noproc",387,396
9,1,52,1,9,"svcerr_decode@402-411@lib/libc/rpc/svc.c","lib/libc/rpc/svc.c","svcerr_decode",402,411
9,1,52,1,9,"svcerr_systemerr@418-427@lib/libc/rpc/svc.c","lib/libc/rpc/svc.c","svcerr_systemerr",418,427
9,1,54,2,9,"svcerr_auth@433-442@lib/libc/rpc/svc.c","lib/libc/rpc/svc.c","svcerr_auth",433,442
4,1,15,1,4,"svcerr_weakauth@449-453@lib/libc/rpc/svc.c","lib/libc/rpc/svc.c","svcerr_weakauth",449,453
9,1,52,1,9,"svcerr_noprog@459-468@lib/libc/rpc/svc.c","lib/libc/rpc/svc.c","svcerr_noprog",459,468
11,1,78,3,11,"svcerr_progvers@475-486@lib/libc/rpc/svc.c","lib/libc/rpc/svc.c","svcerr_progvers",475,486
6,2,42,1,6,"svc_getreq@508-514@lib/libc/rpc/svc.c","lib/libc/rpc/svc.c","svc_getreq",508,514
4,1,15,1,3,"svc_getreqset@518-521@lib/libc/rpc/svc.c","lib/libc/rpc/svc.c","svc_getreqset",518,521
11,3,83,2,11,"svc_getreqset2@524-535@lib/libc/rpc/svc.c","lib/libc/rpc/svc.c","svc_getreqset2",524,535
13,5,96,2,13,"svc_getreq_poll@539-552@lib/libc/rpc/svc.c","lib/libc/rpc/svc.c","svc_getreq_poll",539,552
57,12,352,1,70,"svc_getreq_common@556-626@lib/libc/rpc/svc.c","lib/libc/rpc/svc.c","svc_getreq_common",556,626
12,3,98,2,13,"_authenticate@89-102@lib/libc/rpc/svc_auth.c","lib/libc/rpc/svc_auth.c","_authenticate",89,102
4,1,11,1,6,"_svcauth_null@105-111@lib/libc/rpc/svc_auth.c","lib/libc/rpc/svc_auth.c","_svcauth_null",105,111
60,7,393,2,64,"_svcauth_unix@51-115@lib/libc/rpc/svc_auth_unix.c","lib/libc/rpc/svc_auth_unix.c","_svcauth_unix",51,115
4,1,19,2,3,"_svcauth_short@124-127@lib/libc/rpc/svc_auth_unix.c","lib/libc/rpc/svc_auth_unix.c","_svcauth_short",124,127
15,3,106,1,15,"svcraw_create@74-89@lib/libc/rpc/svc_raw.c","lib/libc/rpc/svc_raw.c","svcraw_create",74,89
4,1,13,1,4,"svcraw_stat@92-96@lib/libc/rpc/svc_raw.c","lib/libc/rpc/svc_raw.c","svcraw_stat",92,96
13,3,75,2,13,"svcraw_recv@99-112@lib/libc/rpc/svc_raw.c","lib/libc/rpc/svc_raw.c","svcraw_recv",99,112
14,3,83,2,14,"svcraw_reply@115-129@lib/libc/rpc/svc_raw.c","lib/libc/rpc/svc_raw.c","svcraw_reply",115,129
7,2,48,3,7,"svcraw_getargs@132-139@lib/libc/rpc/svc_raw.c","lib/libc/rpc/svc_raw.c","svcraw_getargs",132,139
10,2,62,3,10,"svcraw_freeargs@142-152@lib/libc/rpc/svc_raw.c","lib/libc/rpc/svc_raw.c","svcraw_freeargs",142,152
3,1,8,1,2,"svcraw_destroy@155-157@lib/libc/rpc/svc_raw.c","lib/libc/rpc/svc_raw.c","svcraw_destroy",155,157
29,7,141,1,31,"svc_run@46-77@lib/libc/rpc/svc_run.c","lib/libc/rpc/svc_run.c","svc_run",46,77
27,6,184,6,27,"registerrpc@58-85@lib/libc/rpc/svc_simple.c","lib/libc/rpc/svc_simple.c","registerrpc",58,85
31,10,210,2,37,"universal@88-125@lib/libc/rpc/svc_simple.c","lib/libc/rpc/svc_simple.c","universal",88,125
55,13,376,3,55,"svctcp_create@128-183@lib/libc/rpc/svc_tcp.c","lib/libc/rpc/svc_tcp.c","svctcp_create",128,183
4,1,25,3,4,"svcfd_create@191-195@lib/libc/rpc/svc_tcp.c","lib/libc/rpc/svc_tcp.c","svcfd_create",191,195
32,4,228,3,32,"makefd_xprt@198-230@lib/libc/rpc/svc_tcp.c","lib/libc/rpc/svc_tcp.c","makefd_xprt",198,230
45,14,294,2,58,"rendezvous_request@233-291@lib/libc/rpc/svc_tcp.c","lib/libc/rpc/svc_tcp.c","rendezvous_request",233,291
4,1,13,1,4,"rendezvous_stat@294-298@lib/libc/rpc/svc_tcp.c","lib/libc/rpc/svc_tcp.c","rendezvous_stat",294,298
15,3,109,1,17,"svctcp_destroy@301-318@lib/libc/rpc/svc_tcp.c","lib/libc/rpc/svc_tcp.c","svctcp_destroy",301,318
34,8,241,3,38,"readtcp@332-370@lib/libc/rpc/svc_tcp.c","lib/libc/rpc/svc_tcp.c","readtcp",332,370
12,3,88,3,12,"writetcp@377-389@lib/libc/rpc/svc_tcp.c","lib/libc/rpc/svc_tcp.c","writetcp",377,389
10,3,60,1,10,"svctcp_stat@392-402@lib/libc/rpc/svc_tcp.c","lib/libc/rpc/svc_tcp.c","svctcp_stat",392,402
14,2,89,2,14,"svctcp_recv@405-419@lib/libc/rpc/svc_tcp.c","lib/libc/rpc/svc_tcp.c","svctcp_recv",405,419
4,1,43,3,4,"svctcp_getargs@422-426@lib/libc/rpc/svc_tcp.c","lib/libc/rpc/svc_tcp.c","svctcp_getargs",422,426
7,1,55,3,7,"svctcp_freeargs@429-436@lib/libc/rpc/svc_tcp.c","lib/libc/rpc/svc_tcp.c","svctcp_freeargs",429,436
12,1,81,2,12,"svctcp_reply@439-451@lib/libc/rpc/svc_tcp.c","lib/libc/rpc/svc_tcp.c","svctcp_reply",439,451
63,14,443,3,63,"svcudp_bufcreate@98-161@lib/libc/rpc/svc_udp.c","lib/libc/rpc/svc_udp.c","svcudp_bufcreate",98,161
4,1,19,1,4,"svcudp_create@165-169@lib/libc/rpc/svc_udp.c","lib/libc/rpc/svc_udp.c","svcudp_create",165,169
4,1,13,1,4,"svcudp_stat@173-177@lib/libc/rpc/svc_udp.c","lib/libc/rpc/svc_udp.c","svcudp_stat",173,177
30,8,239,2,30,"svcudp_recv@180-210@lib/libc/rpc/svc_udp.c","lib/libc/rpc/svc_udp.c","svcudp_recv",180,210
22,5,153,2,22,"svcudp_reply@213-235@lib/libc/rpc/svc_udp.c","lib/libc/rpc/svc_udp.c","svcudp_reply",213,235
4,1,35,3,4,"svcudp_getargs@238-242@lib/libc/rpc/svc_udp.c","lib/libc/rpc/svc_udp.c","svcudp_getargs",238,242
6,1,47,3,6,"svcudp_freeargs@245-251@lib/libc/rpc/svc_udp.c","lib/libc/rpc/svc_udp.c","svcudp_freeargs",245,251
12,2,98,1,12,"svcudp_destroy@254-266@lib/libc/rpc/svc_udp.c","lib/libc/rpc/svc_udp.c","svcudp_destroy",254,266
25,6,176,2,25,"svcudp_enablecache@327-352@lib/libc/rpc/svc_udp.c","lib/libc/rpc/svc_udp.c","svcudp_enablecache",327,352
46,7,319,2,54,"cache_set@359-413@lib/libc/rpc/svc_udp.c","lib/libc/rpc/svc_udp.c","cache_set",359,413
24,7,194,4,30,"cache_get@420-450@lib/libc/rpc/svc_udp.c","lib/libc/rpc/svc_udp.c","cache_get",420,450
6,1,31,2,6,"xdr_free@66-72@lib/libc/rpc/xdr.c","lib/libc/rpc/xdr.c","xdr_free",66,72
4,1,11,1,6,"xdr_void@79-85@lib/libc/rpc/xdr.c","lib/libc/rpc/xdr.c","xdr_void",79,85
18,5,92,2,21,"xdr_int@93-114@lib/libc/rpc/xdr.c","lib/libc/rpc/xdr.c","xdr_int",93,114
18,5,100,2,21,"xdr_u_int@121-142@lib/libc/rpc/xdr.c","lib/libc/rpc/xdr.c","xdr_u_int",121,142
12,4,60,2,12,"xdr_long@151-163@lib/libc/rpc/xdr.c","lib/libc/rpc/xdr.c","xdr_long",151,163
12,4,67,2,11,"xdr_u_long@171-182@lib/libc/rpc/xdr.c","lib/libc/rpc/xdr.c","xdr_u_long",171,182
18,5,92,2,21,"xdr_int32_t@191-212@lib/libc/rpc/xdr.c","lib/libc/rpc/xdr.c","xdr_int32_t",191,212
18,5,100,2,21,"xdr_u_int32_t@219-240@lib/libc/rpc/xdr.c","lib/libc/rpc/xdr.c","xdr_u_int32_t",219,240
18,5,93,2,21,"xdr_short@248-269@lib/libc/rpc/xdr.c","lib/libc/rpc/xdr.c","xdr_short",248,269
18,5,100,2,21,"xdr_u_short@276-297@lib/libc/rpc/xdr.c","lib/libc/rpc/xdr.c","xdr_u_short",276,297
18,5,92,2,21,"xdr_int16_t@305-326@lib/libc/rpc/xdr.c","lib/libc/rpc/xdr.c","xdr_int16_t",305,326
18,5,100,2,21,"xdr_u_int16_t@332-353@lib/libc/rpc/xdr.c","lib/libc/rpc/xdr.c","xdr_u_int16_t",332,353
10,2,50,2,10,"xdr_char@360-370@lib/libc/rpc/xdr.c","lib/libc/rpc/xdr.c","xdr_char",360,370
10,2,50,2,10,"xdr_u_char@376-386@lib/libc/rpc/xdr.c","lib/libc/rpc/xdr.c","xdr_u_char",376,386
18,7,98,2,21,"xdr_bool@392-413@lib/libc/rpc/xdr.c","lib/libc/rpc/xdr.c","xdr_bool",392,413
13,4,115,2,16,"xdr_enum@420-436@lib/libc/rpc/xdr.c","lib/libc/rpc/xdr.c","xdr_enum",420,436
30,10,180,3,41,"xdr_opaque@445-486@lib/libc/rpc/xdr.c","lib/libc/rpc/xdr.c","xdr_opaque",445,486
32,11,179,4,43,"xdr_bytes@495-538@lib/libc/rpc/xdr.c","lib/libc/rpc/xdr.c","xdr_bytes",495,538
4,1,33,2,4,"xdr_netobj@545-549@lib/libc/rpc/xdr.c","lib/libc/rpc/xdr.c","xdr_netobj",545,549
18,5,109,5,30,"xdr_union@563-593@lib/libc/rpc/xdr.c","lib/libc/rpc/xdr.c","xdr_union",563,593
42,12,207,3,54,"xdr_string@612-666@lib/libc/rpc/xdr.c","lib/libc/rpc/xdr.c","xdr_string",612,666
4,1,22,2,3,"xdr_wrapstring@674-677@lib/libc/rpc/xdr.c","lib/libc/rpc/xdr.c","xdr_wrapstring",674,677
23,7,210,2,24,"xdr_int64_t@680-704@lib/libc/rpc/xdr.c","lib/libc/rpc/xdr.c","xdr_int64_t",680,704
23,7,204,2,24,"xdr_u_int64_t@707-731@lib/libc/rpc/xdr.c","lib/libc/rpc/xdr.c","xdr_u_int64_t",707,731
43,13,231,6,58,"xdr_array@58-116@lib/libc/rpc/xdr_array.c","lib/libc/rpc/xdr_array.c","xdr_array",58,116
13,3,74,5,13,"xdr_vector@130-143@lib/libc/rpc/xdr_array.c","lib/libc/rpc/xdr_array.c","xdr_vector",130,143
17,4,89,2,19,"xdr_float@55-74@lib/libc/rpc/xdr_float.c","lib/libc/rpc/xdr_float.c","xdr_float",55,74
41,10,245,2,50,"xdr_double@77-127@lib/libc/rpc/xdr_float.c","lib/libc/rpc/xdr_float.c","xdr_double",77,127
8,2,66,4,8,"xdrmem_create@91-99@lib/libc/rpc/xdr_mem.c","lib/libc/rpc/xdr_mem.c","xdrmem_create",91,99
3,1,8,1,2,"xdrmem_destroy@103-105@lib/libc/rpc/xdr_mem.c","lib/libc/rpc/xdr_mem.c","xdrmem_destroy",103,105
9,2,67,2,9,"xdrmem_getlong_aligned@108-117@lib/libc/rpc/xdr_mem.c","lib/libc/rpc/xdr_mem.c","xdrmem_getlong_aligned",108,117
9,2,70,2,9,"xdrmem_putlong_aligned@120-129@lib/libc/rpc/xdr_mem.c","lib/libc/rpc/xdr_mem.c","xdrmem_putlong_aligned",120,129
11,2,78,2,11,"xdrmem_getlong_unaligned@132-143@lib/libc/rpc/xdr_mem.c","lib/libc/rpc/xdr_mem.c","xdrmem_getlong_unaligned",132,143
11,2,81,2,11,"xdrmem_putlong_unaligned@146-157@lib/libc/rpc/xdr_mem.c","lib/libc/rpc/xdr_mem.c","xdrmem_putlong_unaligned",146,157
9,2,55,3,9,"xdrmem_getbytes@160-169@lib/libc/rpc/xdr_mem.c","lib/libc/rpc/xdr_mem.c","xdrmem_getbytes",160,169
9,2,55,3,9,"xdrmem_putbytes@172-181@lib/libc/rpc/xdr_mem.c","lib/libc/rpc/xdr_mem.c","xdrmem_putbytes",172,181
4,1,25,1,5,"xdrmem_getpos@184-189@lib/libc/rpc/xdr_mem.c","lib/libc/rpc/xdr_mem.c","xdrmem_getpos",184,189
10,2,66,2,10,"xdrmem_setpos@192-202@lib/libc/rpc/xdr_mem.c","lib/libc/rpc/xdr_mem.c","xdrmem_setpos",192,202
10,2,54,2,10,"xdrmem_inline_aligned@205-215@lib/libc/rpc/xdr_mem.c","lib/libc/rpc/xdr_mem.c","xdrmem_inline_aligned",205,215
4,1,16,2,4,"xdrmem_inline_unaligned@218-222@lib/libc/rpc/xdr_mem.c","lib/libc/rpc/xdr_mem.c","xdrmem_inline_unaligned",218,222
44,4,328,6,55,"xdrrec_create@162-217@lib/libc/rpc/xdr_rec.c","lib/libc/rpc/xdr_rec.c","xdrrec_create",162,217
18,4,165,2,19,"xdrrec_getlong@227-246@lib/libc/rpc/xdr_rec.c","lib/libc/rpc/xdr_rec.c","xdrrec_getlong",227,246
15,3,141,2,19,"xdrrec_putlong@249-268@lib/libc/rpc/xdr_rec.c","lib/libc/rpc/xdr_rec.c","xdrrec_putlong",249,268
22,7,127,3,22,"xdrrec_getbytes@271-293@lib/libc/rpc/xdr_rec.c","lib/libc/rpc/xdr_rec.c","xdrrec_getbytes",271,293
20,5,130,3,20,"xdrrec_putbytes@296-316@lib/libc/rpc/xdr_rec.c","lib/libc/rpc/xdr_rec.c","xdrrec_putbytes",296,316
19,4,104,1,22,"xdrrec_getpos@319-341@lib/libc/rpc/xdr_rec.c","lib/libc/rpc/xdr_rec.c","xdrrec_getpos",319,341
31,10,181,2,34,"xdrrec_setpos@344-378@lib/libc/rpc/xdr_rec.c","lib/libc/rpc/xdr_rec.c","xdrrec_setpos",344,378
24,7,137,2,27,"xdrrec_inline@381-408@lib/libc/rpc/xdr_rec.c","lib/libc/rpc/xdr_rec.c","xdrrec_inline",381,408
7,1,52,1,7,"xdrrec_destroy@411-418@lib/libc/rpc/xdr_rec.c","lib/libc/rpc/xdr_rec.c","xdrrec_destroy",411,418
26,10,164,1,26,"xdrrec_skiprecord@429-455@lib/libc/rpc/xdr_rec.c","lib/libc/rpc/xdr_rec.c","xdrrec_skiprecord",429,455
14,7,104,1,14,"xdrrec_eof@464-478@lib/libc/rpc/xdr_rec.c","lib/libc/rpc/xdr_rec.c","xdrrec_eof",464,478
17,4,143,2,17,"xdrrec_endofrecord@488-505@lib/libc/rpc/xdr_rec.c","lib/libc/rpc/xdr_rec.c","xdrrec_endofrecord",488,505
65,16,442,3,71,"__xdrrec_getrec@513-584@lib/libc/rpc/xdr_rec.c","lib/libc/rpc/xdr_rec.c","__xdrrec_getrec",513,584
9,2,54,2,9,"__xdrrec_setnonblock@588-597@lib/libc/rpc/xdr_rec.c","lib/libc/rpc/xdr_rec.c","__xdrrec_setnonblock",588,597
14,3,152,2,14,"flush_out@604-618@lib/libc/rpc/xdr_rec.c","lib/libc/rpc/xdr_rec.c","flush_out",604,618
18,3,108,1,18,"fill_input_buf@621-639@lib/libc/rpc/xdr_rec.c","lib/libc/rpc/xdr_rec.c","fill_input_buf",621,639
25,7,156,3,26,"get_input_bytes@642-668@lib/libc/rpc/xdr_rec.c","lib/libc/rpc/xdr_rec.c","get_input_bytes",642,668
14,5,100,1,22,"set_input_fragment@671-693@lib/libc/rpc/xdr_rec.c","lib/libc/rpc/xdr_rec.c","set_input_fragment",671,693
16,5,89,2,16,"skip_input_bytes@696-712@lib/libc/rpc/xdr_rec.c","lib/libc/rpc/xdr_rec.c","skip_input_bytes",696,712
6,2,25,1,6,"fix_buf_size@715-721@lib/libc/rpc/xdr_rec.c","lib/libc/rpc/xdr_rec.c","fix_buf_size",715,721
17,3,95,2,18,"realloc_stream@727-745@lib/libc/rpc/xdr_rec.c","lib/libc/rpc/xdr_rec.c","realloc_stream",727,745
26,6,123,4,29,"xdr_reference@57-86@lib/libc/rpc/xdr_reference.c","lib/libc/rpc/xdr_reference.c","xdr_reference",57,86
13,3,79,4,14,"xdr_pointer@110-124@lib/libc/rpc/xdr_reference.c","lib/libc/rpc/xdr_reference.c","xdr_pointer",110,124
8,1,50,3,8,"xdrstdio_create@76-84@lib/libc/rpc/xdr_stdio.c","lib/libc/rpc/xdr_stdio.c","xdrstdio_create",76,84
4,1,22,1,4,"xdrstdio_destroy@91-95@lib/libc/rpc/xdr_stdio.c","lib/libc/rpc/xdr_stdio.c","xdrstdio_destroy",91,95
8,2,62,2,8,"xdrstdio_getlong@98-106@lib/libc/rpc/xdr_stdio.c","lib/libc/rpc/xdr_stdio.c","xdrstdio_getlong",98,106
7,2,60,2,7,"xdrstdio_putlong@109-116@lib/libc/rpc/xdr_stdio.c","lib/libc/rpc/xdr_stdio.c","xdrstdio_putlong",109,116
6,3,56,3,6,"xdrstdio_getbytes@119-125@lib/libc/rpc/xdr_stdio.c","lib/libc/rpc/xdr_stdio.c","xdrstdio_getbytes",119,125
6,3,56,3,6,"xdrstdio_putbytes@128-134@lib/libc/rpc/xdr_stdio.c","lib/libc/rpc/xdr_stdio.c","xdrstdio_putbytes",128,134
4,1,25,1,4,"xdrstdio_getpos@137-141@lib/libc/rpc/xdr_stdio.c","lib/libc/rpc/xdr_stdio.c","xdrstdio_getpos",137,141
5,2,40,2,5,"xdrstdio_setpos@144-149@lib/libc/rpc/xdr_stdio.c","lib/libc/rpc/xdr_stdio.c","xdrstdio_setpos",144,149
4,1,16,2,13,"xdrstdio_inline@152-165@lib/libc/rpc/xdr_stdio.c","lib/libc/rpc/xdr_stdio.c","xdrstdio_inline",152,165
4,1,19,2,5,"__eqdf2@15-20@lib/libc/softfloat/eqdf2.c","lib/libc/softfloat/eqdf2.c","__eqdf2",15,20
4,1,19,2,5,"__eqsf2@15-20@lib/libc/softfloat/eqsf2.c","lib/libc/softfloat/eqsf2.c","__eqsf2",15,20
4,1,9,1,4,"fpgetmask@44-48@lib/libc/softfloat/fpgetmask.c","lib/libc/softfloat/fpgetmask.c","fpgetmask",44,48
4,1,9,1,4,"fpgetround@43-47@lib/libc/softfloat/fpgetround.c","lib/libc/softfloat/fpgetround.c","fpgetround",43,47
4,1,9,1,4,"fpgetsticky@43-47@lib/libc/softfloat/fpgetsticky.c","lib/libc/softfloat/fpgetsticky.c","fpgetsticky",43,47
7,1,21,1,7,"fpsetmask@43-50@lib/libc/softfloat/fpsetmask.c","lib/libc/softfloat/fpsetmask.c","fpsetmask",43,50
7,1,21,1,7,"fpsetround@43-50@lib/libc/softfloat/fpsetround.c","lib/libc/softfloat/fpsetround.c","fpsetround",43,50
7,1,21,1,7,"fpsetsticky@43-50@lib/libc/softfloat/fpsetsticky.c","lib/libc/softfloat/fpsetsticky.c","fpsetsticky",43,50
4,1,20,2,5,"__gedf2@15-20@lib/libc/softfloat/gedf2.c","lib/libc/softfloat/gedf2.c","__gedf2",15,20
4,1,20,2,5,"__gesf2@15-20@lib/libc/softfloat/gesf2.c","lib/libc/softfloat/gesf2.c","__gesf2",15,20
4,1,18,2,5,"__gtdf2@15-20@lib/libc/softfloat/gtdf2.c","lib/libc/softfloat/gtdf2.c","__gtdf2",15,20
4,1,18,2,5,"__gtsf2@15-20@lib/libc/softfloat/gtsf2.c","lib/libc/softfloat/gtsf2.c","__gtsf2",15,20
4,1,20,2,5,"__ledf2@15-20@lib/libc/softfloat/ledf2.c","lib/libc/softfloat/ledf2.c","__ledf2",15,20
4,1,20,2,5,"__lesf2@15-20@lib/libc/softfloat/lesf2.c","lib/libc/softfloat/lesf2.c","__lesf2",15,20
4,1,19,2,5,"__ltdf2@15-20@lib/libc/softfloat/ltdf2.c","lib/libc/softfloat/ltdf2.c","__ltdf2",15,20
4,1,19,2,5,"__ltsf2@15-20@lib/libc/softfloat/ltsf2.c","lib/libc/softfloat/ltsf2.c","__ltsf2",15,20
4,1,19,2,5,"__nedf2@15-20@lib/libc/softfloat/nedf2.c","lib/libc/softfloat/nedf2.c","__nedf2",15,20
4,1,15,1,5,"__negdf2@15-20@lib/libc/softfloat/negdf2.c","lib/libc/softfloat/negdf2.c","__negdf2",15,20
4,1,12,1,5,"__negsf2@15-20@lib/libc/softfloat/negsf2.c","lib/libc/softfloat/negsf2.c","__negsf2",15,20
4,1,19,2,5,"__nesf2@15-20@lib/libc/softfloat/nesf2.c","lib/libc/softfloat/nesf2.c","__nesf2",15,20
14,3,81,3,15,"shift32RightJamming@42-57@lib/libc/softfloat/softfloat-macros.h","lib/libc/softfloat/softfloat-macros.h","shift32RightJamming",42,57
20,4,122,5,21,"shift64Right@69-90@lib/libc/softfloat/softfloat-macros.h","lib/libc/softfloat/softfloat-macros.h","shift64Right",69,90
28,5,182,5,29,"shift64RightJamming@105-134@lib/libc/softfloat/softfloat-macros.h","lib/libc/softfloat/softfloat-macros.h","shift64RightJamming",105,134
47,6,208,7,48,"shift64ExtraRightJamming@157-205@lib/libc/softfloat/softfloat-macros.h","lib/libc/softfloat/softfloat-macros.h","shift64ExtraRightJamming",157,205
7,2,61,5,8,"shortShift64Left@216-224@lib/libc/softfloat/softfloat-macros.h","lib/libc/softfloat/softfloat-macros.h","shortShift64Left",216,224
24,2,107,7,25,"shortShift96Left@236-261@lib/libc/softfloat/softfloat-macros.h","lib/libc/softfloat/softfloat-macros.h","shortShift96Left",236,261
8,1,51,6,9,"add64@272-281@lib/libc/softfloat/softfloat-macros.h","lib/libc/softfloat/softfloat-macros.h","add64",272,281
26,1,111,9,27,"add96@293-320@lib/libc/softfloat/softfloat-macros.h","lib/libc/softfloat/softfloat-macros.h","add96",293,320
6,1,44,6,7,"sub64@332-339@lib/libc/softfloat/softfloat-macros.h","lib/libc/softfloat/softfloat-macros.h","sub64",332,339
26,1,111,9,27,"sub96@351-378@lib/libc/softfloat/softfloat-macros.h","lib/libc/softfloat/softfloat-macros.h","sub96",351,378
20,1,158,4,21,"mul32To64@387-408@lib/libc/softfloat/softfloat-macros.h","lib/libc/softfloat/softfloat-macros.h","mul32To64",387,408
17,1,92,6,18,"mul64By32To96@419-437@lib/libc/softfloat/softfloat-macros.h","lib/libc/softfloat/softfloat-macros.h","mul64By32To96",419,437
26,1,186,8,27,"mul64To128@448-475@lib/libc/softfloat/softfloat-macros.h","lib/libc/softfloat/softfloat-macros.h","mul64To128",448,475
19,5,175,3,20,"estimateDiv64To32@487-507@lib/libc/softfloat/softfloat-macros.h","lib/libc/softfloat/softfloat-macros.h","estimateDiv64To32",487,507
26,4,248,2,27,"estimateSqrt32@521-548@lib/libc/softfloat/softfloat-macros.h","lib/libc/softfloat/softfloat-macros.h","estimateSqrt32",521,548
33,3,582,1,34,"countLeadingZeros32@557-591@lib/libc/softfloat/softfloat-macros.h","lib/libc/softfloat/softfloat-macros.h","countLeadingZeros32",557,591
4,2,29,4,5,"eq64@600-605@lib/libc/softfloat/softfloat-macros.h","lib/libc/softfloat/softfloat-macros.h","eq64",600,605
4,3,37,4,5,"le64@614-619@lib/libc/softfloat/softfloat-macros.h","lib/libc/softfloat/softfloat-macros.h","le64",614,619
4,3,37,4,5,"lt64@628-633@lib/libc/softfloat/softfloat-macros.h","lib/libc/softfloat/softfloat-macros.h","lt64",628,633
4,2,29,4,5,"ne64@642-647@lib/libc/softfloat/softfloat-macros.h","lib/libc/softfloat/softfloat-macros.h","ne64",642,647
7,2,24,1,8,"float_raise@58-66@lib/libc/softfloat/softfloat-specialize.h","lib/libc/softfloat/softfloat-specialize.h","float_raise",58,66
4,1,22,1,5,"float32_is_nan@95-100@lib/libc/softfloat/softfloat-specialize.h","lib/libc/softfloat/softfloat-specialize.h","float32_is_nan",95,100
4,2,29,1,5,"float32_is_signaling_nan@111-116@lib/libc/softfloat/softfloat-specialize.h","lib/libc/softfloat/softfloat-specialize.h","float32_is_signaling_nan",111,116
9,2,54,1,10,"float32ToCommonNaN@125-135@lib/libc/softfloat/softfloat-specialize.h","lib/libc/softfloat/softfloat-specialize.h","float32ToCommonNaN",125,135
4,1,33,1,5,"commonNaNToFloat32@143-148@lib/libc/softfloat/softfloat-specialize.h","lib/libc/softfloat/softfloat-specialize.h","commonNaNToFloat32",143,148
17,4,89,2,18,"propagateFloat32NaN@157-175@lib/libc/softfloat/softfloat-specialize.h","lib/libc/softfloat/softfloat-specialize.h","propagateFloat32NaN",157,175
5,1,28,1,6,"float64_is_nan@193-199@lib/libc/softfloat/softfloat-specialize.h","lib/libc/softfloat/softfloat-specialize.h","float64_is_nan",193,199
6,2,38,1,7,"float64_is_signaling_nan@210-217@lib/libc/softfloat/softfloat-specialize.h","lib/libc/softfloat/softfloat-specialize.h","float64_is_signaling_nan",210,217
9,2,55,1,10,"float64ToCommonNaN@226-236@lib/libc/softfloat/softfloat-specialize.h","lib/libc/softfloat/softfloat-specialize.h","float64ToCommonNaN",226,236
7,1,39,1,8,"commonNaNToFloat64@244-252@lib/libc/softfloat/softfloat-specialize.h","lib/libc/softfloat/softfloat-specialize.h","commonNaNToFloat64",244,252
17,4,101,2,18,"propagateFloat64NaN@261-279@lib/libc/softfloat/softfloat-specialize.h","lib/libc/softfloat/softfloat-specialize.h","propagateFloat64NaN",261,279
4,2,32,1,5,"floatx80_is_nan@299-304@lib/libc/softfloat/softfloat-specialize.h","lib/libc/softfloat/softfloat-specialize.h","floatx80_is_nan",299,304
9,3,53,1,10,"floatx80_is_signaling_nan@312-322@lib/libc/softfloat/softfloat-specialize.h","lib/libc/softfloat/softfloat-specialize.h","floatx80_is_signaling_nan",312,322
9,2,53,1,10,"floatx80ToCommonNaN@331-341@lib/libc/softfloat/softfloat-specialize.h","lib/libc/softfloat/softfloat-specialize.h","floatx80ToCommonNaN",331,341
7,1,51,1,8,"commonNaNToFloatx80@349-357@lib/libc/softfloat/softfloat-specialize.h","lib/libc/softfloat/softfloat-specialize.h","commonNaNToFloatx80",349,357
17,4,99,2,18,"propagateFloatx80NaN@366-384@lib/libc/softfloat/softfloat-specialize.h","lib/libc/softfloat/softfloat-specialize.h","propagateFloatx80NaN",366,384
6,3,44,1,7,"float128_is_nan@405-412@lib/libc/softfloat/softfloat-specialize.h","lib/libc/softfloat/softfloat-specialize.h","float128_is_nan",405,412
6,3,42,1,7,"float128_is_signaling_nan@420-427@lib/libc/softfloat/softfloat-specialize.h","lib/libc/softfloat/softfloat-specialize.h","float128_is_signaling_nan",420,427
8,2,59,1,9,"float128ToCommonNaN@436-445@lib/libc/softfloat/softfloat-specialize.h","lib/libc/softfloat/softfloat-specialize.h","float128ToCommonNaN",436,445
7,1,59,1,8,"commonNaNToFloat128@453-461@lib/libc/softfloat/softfloat-specialize.h","lib/libc/softfloat/softfloat-specialize.h","commonNaNToFloat128",453,461
17,4,99,2,18,"propagateFloat128NaN@470-488@lib/libc/softfloat/softfloat-specialize.h","lib/libc/softfloat/softfloat-specialize.h","propagateFloat128NaN",470,488
4,1,12,1,5,"extractFloat32Frac@107-112@lib/libc/softfloat/softfloat.c","lib/libc/softfloat/softfloat.c","extractFloat32Frac",107,112
4,1,17,1,5,"extractFloat32Exp@119-124@lib/libc/softfloat/softfloat.c","lib/libc/softfloat/softfloat.c","extractFloat32Exp",119,124
4,1,13,1,5,"extractFloat32Sign@131-136@lib/libc/softfloat/softfloat.c","lib/libc/softfloat/softfloat.c","extractFloat32Sign",131,136
7,1,42,3,8,"normalizeFloat32Subnormal@147-155@lib/libc/softfloat/softfloat.c","lib/libc/softfloat/softfloat.c","normalizeFloat32Subnormal",147,155
4,1,40,3,5,"packFloat32@169-174@lib/libc/softfloat/softfloat.c","lib/libc/softfloat/softfloat.c","packFloat32",169,174
49,17,286,3,50,"roundAndPackFloat32@199-249@lib/libc/softfloat/softfloat.c","lib/libc/softfloat/softfloat.c","roundAndPackFloat32",199,249
6,1,40,3,7,"normalizeRoundAndPackFloat32@262-269@lib/libc/softfloat/softfloat.c","lib/libc/softfloat/softfloat.c","normalizeRoundAndPackFloat32",262,269
4,1,18,1,5,"extractFloat64Frac1@277-282@lib/libc/softfloat/softfloat.c","lib/libc/softfloat/softfloat.c","extractFloat64Frac1",277,282
4,1,20,1,5,"extractFloat64Frac0@290-295@lib/libc/softfloat/softfloat.c","lib/libc/softfloat/softfloat.c","extractFloat64Frac0",290,295
4,1,20,1,5,"extractFloat64Exp@302-307@lib/libc/softfloat/softfloat.c","lib/libc/softfloat/softfloat.c","extractFloat64Exp",302,307
4,1,16,1,5,"extractFloat64Sign@314-319@lib/libc/softfloat/softfloat.c","lib/libc/softfloat/softfloat.c","extractFloat64Sign",314,319
27,3,129,5,28,"normalizeFloat64Subnormal@333-361@lib/libc/softfloat/softfloat.c","lib/libc/softfloat/softfloat.c","normalizeFloat64Subnormal",333,361
6,1,58,4,8,"packFloat64@377-385@lib/libc/softfloat/softfloat.c","lib/libc/softfloat/softfloat.c","packFloat64",377,385
70,29,404,5,71,"roundAndPackFloat64@410-481@lib/libc/softfloat/softfloat.c","lib/libc/softfloat/softfloat.c","roundAndPackFloat64",410,481
22,3,120,4,23,"normalizeRoundAndPackFloat64@495-518@lib/libc/softfloat/softfloat.c","lib/libc/softfloat/softfloat.c","normalizeRoundAndPackFloat64",495,518
8,4,61,1,9,"int32_to_float32@527-536@lib/libc/softfloat/softfloat.c","lib/libc/softfloat/softfloat.c","int32_to_float32",527,536
19,4,117,1,20,"int32_to_float64@545-565@lib/libc/softfloat/softfloat.c","lib/libc/softfloat/softfloat.c","int32_to_float64",545,565
56,15,286,1,57,"float32_to_int32@579-636@lib/libc/softfloat/softfloat.c","lib/libc/softfloat/softfloat.c","float32_to_int32",579,636
29,10,170,1,30,"float32_to_int32_round_to_zero@650-680@lib/libc/softfloat/softfloat.c","lib/libc/softfloat/softfloat.c","float32_to_int32_round_to_zero",650,680
20,5,143,1,21,"float32_to_float64@690-711@lib/libc/softfloat/softfloat.c","lib/libc/softfloat/softfloat.c","float32_to_float64",690,711
51,19,273,1,52,"float32_round_to_int@722-774@lib/libc/softfloat/softfloat.c","lib/libc/softfloat/softfloat.c","float32_round_to_int",722,774
60,13,325,3,61,"addFloat32Sigs@786-847@lib/libc/softfloat/softfloat.c","lib/libc/softfloat/softfloat.c","addFloat32Sigs",786,847
64,14,338,3,65,"subFloat32Sigs@858-923@lib/libc/softfloat/softfloat.c","lib/libc/softfloat/softfloat.c","subFloat32Sigs",858,923
12,2,60,2,13,"float32_add@932-945@lib/libc/softfloat/softfloat.c","lib/libc/softfloat/softfloat.c","float32_add",932,945
12,2,60,2,13,"float32_sub@954-967@lib/libc/softfloat/softfloat.c","lib/libc/softfloat/softfloat.c","float32_sub",954,967
49,14,348,2,50,"float32_mul@976-1026@lib/libc/softfloat/softfloat.c","lib/libc/softfloat/softfloat.c","float32_mul",976,1026
59,15,424,2,60,"float32_div@1035-1095@lib/libc/softfloat/softfloat.c","lib/libc/softfloat/softfloat.c","float32_div",1035,1095
75,23,502,2,76,"float32_rem@1105-1181@lib/libc/softfloat/softfloat.c","lib/libc/softfloat/softfloat.c","float32_rem",1105,1181
48,11,328,1,49,"float32_sqrt@1192-1241@lib/libc/softfloat/softfloat.c","lib/libc/softfloat/softfloat.c","float32_sqrt",1192,1241
12,8,93,2,13,"float32_eq@1251-1264@lib/libc/softfloat/softfloat.c","lib/libc/softfloat/softfloat.c","float32_eq",1251,1264
14,8,117,2,15,"float32_le@1274-1289@lib/libc/softfloat/softfloat.c","lib/libc/softfloat/softfloat.c","float32_le",1274,1289
14,8,117,2,15,"float32_lt@1298-1313@lib/libc/softfloat/softfloat.c","lib/libc/softfloat/softfloat.c","float32_lt",1298,1313
10,6,79,2,11,"float32_eq_signaling@1324-1335@lib/libc/softfloat/softfloat.c","lib/libc/softfloat/softfloat.c","float32_eq_signaling",1324,1335
17,10,136,2,18,"float32_le_quiet@1345-1363@lib/libc/softfloat/softfloat.c","lib/libc/softfloat/softfloat.c","float32_le_quiet",1345,1363
16,10,131,2,17,"float32_lt_quiet@1373-1390@lib/libc/softfloat/softfloat.c","lib/libc/softfloat/softfloat.c","float32_lt_quiet",1373,1390
59,16,338,1,60,"float64_to_int32@1405-1465@lib/libc/softfloat/softfloat.c","lib/libc/softfloat/softfloat.c","float64_to_int32",1405,1465
39,12,225,1,40,"float64_to_int32_round_to_zero@1479-1519@lib/libc/softfloat/softfloat.c","lib/libc/softfloat/softfloat.c","float64_to_int32_round_to_zero",1479,1519
20,4,121,1,21,"float64_to_float32@1529-1550@lib/libc/softfloat/softfloat.c","lib/libc/softfloat/softfloat.c","float64_to_float32",1529,1550
91,27,595,1,92,"float64_round_to_int@1561-1653@lib/libc/softfloat/softfloat.c","lib/libc/softfloat/softfloat.c","float64_round_to_int",1561,1653
66,13,405,3,67,"addFloat64Sigs@1665-1732@lib/libc/softfloat/softfloat.c","lib/libc/softfloat/softfloat.c","addFloat64Sigs",1665,1732
70,16,446,3,71,"subFloat64Sigs@1743-1814@lib/libc/softfloat/softfloat.c","lib/libc/softfloat/softfloat.c","subFloat64Sigs",1743,1814
12,2,60,2,13,"float64_add@1823-1836@lib/libc/softfloat/softfloat.c","lib/libc/softfloat/softfloat.c","float64_add",1823,1836
12,2,60,2,13,"float64_sub@1845-1858@lib/libc/softfloat/softfloat.c","lib/libc/softfloat/softfloat.c","float64_sub",1845,1858
52,14,440,2,53,"float64_mul@1867-1920@lib/libc/softfloat/softfloat.c","lib/libc/softfloat/softfloat.c","float64_mul",1867,1920
70,16,651,2,71,"float64_div@1929-2000@lib/libc/softfloat/softfloat.c","lib/libc/softfloat/softfloat.c","float64_div",1929,2000
93,23,775,2,94,"float64_rem@2010-2104@lib/libc/softfloat/softfloat.c","lib/libc/softfloat/softfloat.c","float64_rem",2010,2104
59,13,549,1,60,"float64_sqrt@2115-2175@lib/libc/softfloat/softfloat.c","lib/libc/softfloat/softfloat.c","float64_sqrt",2115,2175
15,8,113,2,16,"float64_eq@2185-2201@lib/libc/softfloat/softfloat.c","lib/libc/softfloat/softfloat.c","float64_eq",2185,2201
20,8,143,2,20,"float64_le@2211-2231@lib/libc/softfloat/softfloat.c","lib/libc/softfloat/softfloat.c","float64_le",2211,2231
20,8,143,2,21,"float64_lt@2240-2261@lib/libc/softfloat/softfloat.c","lib/libc/softfloat/softfloat.c","float64_lt",2240,2261
12,6,93,2,13,"float64_eq_signaling@2272-2285@lib/libc/softfloat/softfloat.c","lib/libc/softfloat/softfloat.c","float64_eq_signaling",2272,2285
18,10,145,2,19,"float64_le_quiet@2295-2314@lib/libc/softfloat/softfloat.c","lib/libc/softfloat/softfloat.c","float64_le_quiet",2295,2314
18,10,145,2,19,"float64_lt_quiet@2324-2343@lib/libc/softfloat/softfloat.c","lib/libc/softfloat/softfloat.c","float64_lt_quiet",2324,2343
10,1,54,2,11,"fail@46-57@lib/libc/softfloat/timesoftfloat.c","lib/libc/softfloat/timesoftfloat.c","fail",46,57
22,4,108,2,23,"reportTime@62-85@lib/libc/softfloat/timesoftfloat.c","lib/libc/softfloat/timesoftfloat.c","reportTime",62,85
24,4,150,1,25,"time_a_int32_z_float32@102-127@lib/libc/softfloat/timesoftfloat.c","lib/libc/softfloat/timesoftfloat.c","time_a_int32_z_float32",102,127
24,4,150,1,25,"time_a_int32_z_float64@129-154@lib/libc/softfloat/timesoftfloat.c","lib/libc/softfloat/timesoftfloat.c","time_a_int32_z_float64",129,154
24,4,150,1,25,"time_a_int32_z_floatx80@158-183@lib/libc/softfloat/timesoftfloat.c","lib/libc/softfloat/timesoftfloat.c","time_a_int32_z_floatx80",158,183
24,4,150,1,25,"time_a_int32_z_float128@189-214@lib/libc/softfloat/timesoftfloat.c","lib/libc/softfloat/timesoftfloat.c","time_a_int32_z_float128",189,214
24,4,150,1,25,"time_a_int64_z_float32@257-282@lib/libc/softfloat/timesoftfloat.c","lib/libc/softfloat/timesoftfloat.c","time_a_int64_z_float32",257,282
24,4,150,1,25,"time_a_int64_z_float64@284-309@lib/libc/softfloat/timesoftfloat.c","lib/libc/softfloat/timesoftfloat.c","time_a_int64_z_float64",284,309
24,4,150,1,25,"time_a_int64_z_floatx80@313-338@lib/libc/softfloat/timesoftfloat.c","lib/libc/softfloat/timesoftfloat.c","time_a_int64_z_floatx80",313,338
24,4,150,1,25,"time_a_int64_z_float128@344-369@lib/libc/softfloat/timesoftfloat.c","lib/libc/softfloat/timesoftfloat.c","time_a_int64_z_float128",344,369
24,4,150,1,25,"time_a_float32_z_int32@388-413@lib/libc/softfloat/timesoftfloat.c","lib/libc/softfloat/timesoftfloat.c","time_a_float32_z_int32",388,413
24,4,150,1,25,"time_a_float32_z_int64@415-440@lib/libc/softfloat/timesoftfloat.c","lib/libc/softfloat/timesoftfloat.c","time_a_float32_z_int64",415,440
24,4,150,1,25,"time_a_float32_z_float64@442-467@lib/libc/softfloat/timesoftfloat.c","lib/libc/softfloat/timesoftfloat.c","time_a_float32_z_float64",442,467
24,4,150,1,25,"time_a_float32_z_floatx80@471-496@lib/libc/softfloat/timesoftfloat.c","lib/libc/softfloat/timesoftfloat.c","time_a_float32_z_floatx80",471,496
24,4,150,1,25,"time_a_float32_z_float128@502-527@lib/libc/softfloat/timesoftfloat.c","lib/libc/softfloat/timesoftfloat.c","time_a_float32_z_float128",502,527
24,4,150,1,25,"time_az_float32@531-556@lib/libc/softfloat/timesoftfloat.c","lib/libc/softfloat/timesoftfloat.c","time_az_float32",531,556
32,6,218,1,33,"time_ab_float32_z_flag@558-591@lib/libc/softfloat/timesoftfloat.c","lib/libc/softfloat/timesoftfloat.c","time_ab_float32_z_flag",558,591
32,6,218,1,33,"time_abz_float32@593-626@lib/libc/softfloat/timesoftfloat.c","lib/libc/softfloat/timesoftfloat.c","time_abz_float32",593,626
24,4,150,1,25,"time_az_float32_pos@639-664@lib/libc/softfloat/timesoftfloat.c","lib/libc/softfloat/timesoftfloat.c","time_az_float32_pos",639,664
24,4,150,1,25,"time_a_float64_z_int32@705-730@lib/libc/softfloat/timesoftfloat.c","lib/libc/softfloat/timesoftfloat.c","time_a_float64_z_int32",705,730
24,4,150,1,25,"time_a_float64_z_int64@732-757@lib/libc/softfloat/timesoftfloat.c","lib/libc/softfloat/timesoftfloat.c","time_a_float64_z_int64",732,757
24,4,150,1,25,"time_a_float64_z_float32@759-784@lib/libc/softfloat/timesoftfloat.c","lib/libc/softfloat/timesoftfloat.c","time_a_float64_z_float32",759,784
24,4,150,1,25,"time_a_float64_z_floatx80@788-813@lib/libc/softfloat/timesoftfloat.c","lib/libc/softfloat/timesoftfloat.c","time_a_float64_z_floatx80",788,813
24,4,150,1,25,"time_a_float64_z_float128@819-844@lib/libc/softfloat/timesoftfloat.c","lib/libc/softfloat/timesoftfloat.c","time_a_float64_z_float128",819,844
24,4,150,1,25,"time_az_float64@848-873@lib/libc/softfloat/timesoftfloat.c","lib/libc/softfloat/timesoftfloat.c","time_az_float64",848,873
32,6,218,1,33,"time_ab_float64_z_flag@875-908@lib/libc/softfloat/timesoftfloat.c","lib/libc/softfloat/timesoftfloat.c","time_ab_float64_z_flag",875,908
32,6,218,1,33,"time_abz_float64@910-943@lib/libc/softfloat/timesoftfloat.c","lib/libc/softfloat/timesoftfloat.c","time_abz_float64",910,943
24,4,150,1,25,"time_az_float64_pos@980-1005@lib/libc/softfloat/timesoftfloat.c","lib/libc/softfloat/timesoftfloat.c","time_az_float64_pos",980,1005
29,4,191,1,30,"time_a_floatx80_z_int32@1051-1081@lib/libc/softfloat/timesoftfloat.c","lib/libc/softfloat/timesoftfloat.c","time_a_floatx80_z_int32",1051,1081
29,4,191,1,30,"time_a_floatx80_z_int64@1083-1113@lib/libc/softfloat/timesoftfloat.c","lib/libc/softfloat/timesoftfloat.c","time_a_floatx80_z_int64",1083,1113
29,4,191,1,30,"time_a_floatx80_z_float32@1115-1145@lib/libc/softfloat/timesoftfloat.c","lib/libc/softfloat/timesoftfloat.c","time_a_floatx80_z_float32",1115,1145
29,4,191,1,30,"time_a_floatx80_z_float64@1147-1177@lib/libc/softfloat/timesoftfloat.c","lib/libc/softfloat/timesoftfloat.c","time_a_floatx80_z_float64",1147,1177
29,4,191,1,30,"time_a_floatx80_z_float128@1181-1211@lib/libc/softfloat/timesoftfloat.c","lib/libc/softfloat/timesoftfloat.c","time_a_floatx80_z_float128",1181,1211
29,4,191,1,30,"time_az_floatx80@1215-1245@lib/libc/softfloat/timesoftfloat.c","lib/libc/softfloat/timesoftfloat.c","time_az_floatx80",1215,1245
39,6,299,1,40,"time_ab_floatx80_z_flag@1247-1287@lib/libc/softfloat/timesoftfloat.c","lib/libc/softfloat/timesoftfloat.c","time_ab_floatx80_z_flag",1247,1287
39,6,299,1,40,"time_abz_floatx80@1289-1329@lib/libc/softfloat/timesoftfloat.c","lib/libc/softfloat/timesoftfloat.c","time_abz_floatx80",1289,1329
29,4,191,1,30,"time_az_floatx80_pos@1369-1399@lib/libc/softfloat/timesoftfloat.c","lib/libc/softfloat/timesoftfloat.c","time_az_floatx80_pos",1369,1399
29,4,191,1,30,"time_a_float128_z_int32@1446-1476@lib/libc/softfloat/timesoftfloat.c","lib/libc/softfloat/timesoftfloat.c","time_a_float128_z_int32",1446,1476
29,4,191,1,30,"time_a_float128_z_int64@1478-1508@lib/libc/softfloat/timesoftfloat.c","lib/libc/softfloat/timesoftfloat.c","time_a_float128_z_int64",1478,1508
29,4,191,1,30,"time_a_float128_z_float32@1510-1540@lib/libc/softfloat/timesoftfloat.c","lib/libc/softfloat/timesoftfloat.c","time_a_float128_z_float32",1510,1540
29,4,191,1,30,"time_a_float128_z_float64@1542-1572@lib/libc/softfloat/timesoftfloat.c","lib/libc/softfloat/timesoftfloat.c","time_a_float128_z_float64",1542,1572
29,4,191,1,30,"time_a_float128_z_floatx80@1576-1606@lib/libc/softfloat/timesoftfloat.c","lib/libc/softfloat/timesoftfloat.c","time_a_float128_z_floatx80",1576,1606
29,4,191,1,30,"time_az_float128@1610-1640@lib/libc/softfloat/timesoftfloat.c","lib/libc/softfloat/timesoftfloat.c","time_az_float128",1610,1640
39,6,299,1,40,"time_ab_float128_z_flag@1642-1682@lib/libc/softfloat/timesoftfloat.c","lib/libc/softfloat/timesoftfloat.c","time_ab_float128_z_flag",1642,1682
39,6,299,1,40,"time_abz_float128@1684-1724@lib/libc/softfloat/timesoftfloat.c","lib/libc/softfloat/timesoftfloat.c","time_abz_float128",1684,1724
29,4,191,1,30,"time_az_float128_pos@1763-1793@lib/libc/softfloat/timesoftfloat.c","lib/libc/softfloat/timesoftfloat.c","time_az_float128_pos",1763,1793
328,113,1090,4,355,"timeFunctionVariety@2048-2403@lib/libc/softfloat/timesoftfloat.c","lib/libc/softfloat/timesoftfloat.c","timeFunctionVariety",2048,2403
68,23,265,4,69,"timeFunction@2406-2475@lib/libc/softfloat/timesoftfloat.c","lib/libc/softfloat/timesoftfloat.c","timeFunction",2406,2475
150,35,637,2,159,"main@2477-2636@lib/libc/softfloat/timesoftfloat.c","lib/libc/softfloat/timesoftfloat.c","main",2477,2636
4,1,29,2,9,"__unorddf2@15-24@lib/libc/softfloat/unorddf2.c","lib/libc/softfloat/unorddf2.c","__unorddf2",15,24
4,1,29,2,9,"__unordsf2@15-24@lib/libc/softfloat/unordsf2.c","lib/libc/softfloat/unordsf2.c","__unordsf2",15,24
36,6,262,3,39,"asprintf@30-69@lib/libc/stdio/asprintf.c","lib/libc/stdio/asprintf.c","asprintf",30,69
6,1,23,1,5,"clearerr@39-44@lib/libc/stdio/clrerr.c","lib/libc/stdio/clrerr.c","clearerr",39,44
9,1,47,3,9,"dprintf@39-48@lib/libc/stdio/dprintf.c","lib/libc/stdio/dprintf.c","dprintf",39,48
23,8,152,1,23,"fclose@40-63@lib/libc/stdio/fclose.c","lib/libc/stdio/fclose.c","fclose",40,63
32,10,236,2,48,"fdopen@43-91@lib/libc/stdio/fdopen.c","lib/libc/stdio/fdopen.c","fdopen",43,91
8,1,33,1,8,"feof@43-51@lib/libc/stdio/feof.c","lib/libc/stdio/feof.c","feof",43,51
8,1,33,1,8,"ferror@43-51@lib/libc/stdio/ferror.c","lib/libc/stdio/ferror.c","ferror",43,51
14,3,74,1,14,"fflush@40-54@lib/libc/stdio/fflush.c","lib/libc/stdio/fflush.c","fflush",40,54
21,6,155,1,29,"__sflush@58-87@lib/libc/stdio/fflush.c","lib/libc/stdio/fflush.c","__sflush",58,87
8,1,33,1,8,"__sflush_locked@90-98@lib/libc/stdio/fflush.c","lib/libc/stdio/fflush.c","__sflush_locked",90,98
4,1,16,1,3,"fgetc@37-40@lib/libc/stdio/fgetc.c","lib/libc/stdio/fgetc.c","fgetc",37,40
11,3,84,2,11,"__slbexpand@43-54@lib/libc/stdio/fgetln.c","lib/libc/stdio/fgetln.c","__slbexpand",43,54
52,10,345,2,81,"fgetln@64-145@lib/libc/stdio/fgetln.c","lib/libc/stdio/fgetln.c","fgetln",64,145
4,1,31,2,3,"fgetpos@40-43@lib/libc/stdio/fgetpos.c","lib/libc/stdio/fgetpos.c","fgetpos",40,43
47,8,250,3,59,"fgets@46-105@lib/libc/stdio/fgets.c","lib/libc/stdio/fgets.c","fgets",46,105
32,6,161,1,40,"__fgetwc_unlock@38-78@lib/libc/stdio/fgetwc.c","lib/libc/stdio/fgetwc.c","__fgetwc_unlock",38,78
8,1,33,1,9,"fgetwc@81-90@lib/libc/stdio/fgetwc.c","lib/libc/stdio/fgetwc.c","fgetwc",81,90
11,3,85,2,11,"__slbexpand@38-49@lib/libc/stdio/fgetwln.c","lib/libc/stdio/fgetwln.c","__slbexpand",38,49
27,8,169,2,41,"fgetwln@52-93@lib/libc/stdio/fgetwln.c","lib/libc/stdio/fgetwln.c","fgetwln",52,93
33,9,159,3,39,"fgetws@40-79@lib/libc/stdio/fgetws.c","lib/libc/stdio/fgetws.c","fgetws",40,79
8,1,33,1,8,"fileno@43-51@lib/libc/stdio/fileno.c","lib/libc/stdio/fileno.c","fileno",43,51
26,3,171,1,26,"moreglue@70-96@lib/libc/stdio/findfp.c","lib/libc/stdio/findfp.c","moreglue",70,96
35,6,218,1,39,"__sfp@102-141@lib/libc/stdio/findfp.c","lib/libc/stdio/findfp.c","__sfp",102,141
4,1,14,1,4,"_cleanup@152-156@lib/libc/stdio/findfp.c","lib/libc/stdio/findfp.c","_cleanup",152,156
15,3,72,1,16,"__sinit@162-178@lib/libc/stdio/findfp.c","lib/libc/stdio/findfp.c","__sinit",162,178
46,11,176,2,59,"__sflags@46-105@lib/libc/stdio/flags.c","lib/libc/stdio/flags.c","__sflags",46,105
4,1,13,1,3,"flockfile@7-10@lib/libc/stdio/flockfile.c","lib/libc/stdio/flockfile.c","flockfile",7,10
6,2,29,1,6,"ftrylockfile@15-21@lib/libc/stdio/flockfile.c","lib/libc/stdio/flockfile.c","ftrylockfile",15,21
4,1,13,1,3,"funlockfile@25-28@lib/libc/stdio/flockfile.c","lib/libc/stdio/flockfile.c","funlockfile",25,28
9,3,75,3,10,"fmemopen_read@36-46@lib/libc/stdio/fmemopen.c","lib/libc/stdio/fmemopen.c","fmemopen_read",36,46
16,6,138,3,19,"fmemopen_write@49-68@lib/libc/stdio/fmemopen.c","lib/libc/stdio/fmemopen.c","fmemopen_write",49,68
21,6,101,3,24,"fmemopen_seek@71-95@lib/libc/stdio/fmemopen.c","lib/libc/stdio/fmemopen.c","fmemopen_seek",71,95
5,1,18,1,5,"fmemopen_close@98-103@lib/libc/stdio/fmemopen.c","lib/libc/stdio/fmemopen.c","fmemopen_close",98,103
7,1,32,1,8,"fmemopen_close_free@106-114@lib/libc/stdio/fmemopen.c","lib/libc/stdio/fmemopen.c","fmemopen_close_free",106,114
55,16,392,3,66,"fmemopen@117-183@lib/libc/stdio/fmemopen.c","lib/libc/stdio/fmemopen.c","fmemopen",117,183
30,6,187,2,42,"fopen@44-86@lib/libc/stdio/fopen.c","lib/libc/stdio/fopen.c","fopen",44,86
9,1,49,3,9,"fprintf@38-47@lib/libc/stdio/fprintf.c","lib/libc/stdio/fprintf.c","fprintf",38,47
17,4,101,1,17,"fpurge@44-61@lib/libc/stdio/fpurge.c","lib/libc/stdio/fpurge.c","fpurge",44,61
4,1,21,2,3,"fputc@38-41@lib/libc/stdio/fputc.c","lib/libc/stdio/fputc.c","fputc",38,41
15,1,93,2,15,"fputs@43-58@lib/libc/stdio/fputs.c","lib/libc/stdio/fputs.c","fputs",43,58
30,4,161,2,35,"__fputwc_unlock@40-75@lib/libc/stdio/fputwc.c","lib/libc/stdio/fputwc.c","__fputwc_unlock",40,75
8,1,38,2,9,"fputwc@78-87@lib/libc/stdio/fputwc.c","lib/libc/stdio/fputwc.c","fputwc",78,87
15,3,76,2,17,"fputws@40-57@lib/libc/stdio/fputws.c","lib/libc/stdio/fputws.c","fputws",40,57
44,11,293,4,60,"fread@43-103@lib/libc/stdio/fread.c","lib/libc/stdio/fread.c","fread",43,103
80,22,528,3,121,"freopen@50-171@lib/libc/stdio/freopen.c","lib/libc/stdio/freopen.c","freopen",50,171
9,1,49,3,9,"fscanf@38-47@lib/libc/stdio/fscanf.c","lib/libc/stdio/fscanf.c","fscanf",38,47
131,38,808,3,196,"fseeko@49-245@lib/libc/stdio/fseek.c","lib/libc/stdio/fseek.c","fseeko",49,245
4,1,26,3,3,"fseek@249-252@lib/libc/stdio/fseek.c","lib/libc/stdio/fseek.c","fseek",249,252
4,1,26,2,3,"fsetpos@40-43@lib/libc/stdio/fsetpos.c","lib/libc/stdio/fsetpos.c","fsetpos",40,43
27,8,161,1,42,"ftello@43-85@lib/libc/stdio/ftell.c","lib/libc/stdio/ftell.c","ftello",43,85
9,2,42,1,8,"ftell@89-97@lib/libc/stdio/ftell.c","lib/libc/stdio/ftell.c","ftell",89,97
29,5,188,5,29,"funopen@39-68@lib/libc/stdio/funopen.c","lib/libc/stdio/funopen.c","funopen",39,68
113,28,761,2,155,"__sfvwrite@49-204@lib/libc/stdio/fvwrite.c","lib/libc/stdio/fvwrite.c","__sfvwrite",49,204
13,5,110,1,13,"_fwalk@40-53@lib/libc/stdio/fwalk.c","lib/libc/stdio/fwalk.c","_fwalk",40,53
18,6,91,2,27,"fwide@37-64@lib/libc/stdio/fwide.c","lib/libc/stdio/fwide.c","fwide",37,64
9,1,51,3,9,"fwprintf@39-48@lib/libc/stdio/fwprintf.c","lib/libc/stdio/fwprintf.c","fwprintf",39,48
26,7,174,4,40,"fwrite@48-88@lib/libc/stdio/fwrite.c","lib/libc/stdio/fwrite.c","fwrite",48,88
9,1,51,3,10,"fwscanf@34-44@lib/libc/stdio/fwscanf.c","lib/libc/stdio/fwscanf.c","fwscanf",34,44
4,1,16,1,3,"getc_unlocked@43-46@lib/libc/stdio/getc.c","lib/libc/stdio/getc.c","getc_unlocked",43,46
8,1,33,1,8,"getc@55-63@lib/libc/stdio/getc.c","lib/libc/stdio/getc.c","getc",55,63
4,1,14,1,3,"getchar_unlocked@42-45@lib/libc/stdio/getchar.c","lib/libc/stdio/getchar.c","getchar_unlocked",42,45
4,1,14,1,3,"getchar@56-59@lib/libc/stdio/getchar.c","lib/libc/stdio/getchar.c","getchar",56,59
66,18,398,4,88,"getdelim@46-134@lib/libc/stdio/getdelim.c","lib/libc/stdio/getdelim.c","getdelim",46,134
4,1,31,3,3,"getline@34-37@lib/libc/stdio/getline.c","lib/libc/stdio/getline.c","getline",34,37
5,2,35,1,5,"getw@37-42@lib/libc/stdio/getw.c","lib/libc/stdio/getw.c","getw",37,42
4,1,14,1,4,"getwc@41-45@lib/libc/stdio/getwc.c","lib/libc/stdio/getwc.c","getwc",41,45
4,1,11,0,4,"getwchar@41-45@lib/libc/stdio/getwchar.c","lib/libc/stdio/getwchar.c","getwchar",41,45
25,5,158,1,25,"__smakebuf@49-74@lib/libc/stdio/makebuf.c","lib/libc/stdio/makebuf.c","__smakebuf",49,74
18,6,125,3,26,"__swhatbuf@80-106@lib/libc/stdio/makebuf.c","lib/libc/stdio/makebuf.c","__swhatbuf",80,106
56,21,361,4,66,"mktemp_internal@45-111@lib/libc/stdio/mktemp.c","lib/libc/stdio/mktemp.c","mktemp_internal",45,111
6,2,34,1,5,"_mktemp@114-119@lib/libc/stdio/mktemp.c","lib/libc/stdio/mktemp.c","_mktemp",114,119
4,1,16,1,3,"mktemp@125-128@lib/libc/stdio/mktemp.c","lib/libc/stdio/mktemp.c","mktemp",125,128
4,1,28,3,3,"mkostemps@131-134@lib/libc/stdio/mktemp.c","lib/libc/stdio/mktemp.c","mkostemps",131,134
4,1,22,1,3,"mkstemp@137-140@lib/libc/stdio/mktemp.c","lib/libc/stdio/mktemp.c","mkstemp",137,140
4,1,25,2,3,"mkostemp@144-147@lib/libc/stdio/mktemp.c","lib/libc/stdio/mktemp.c","mkostemp",144,147
4,1,25,2,3,"mkstemps@151-154@lib/libc/stdio/mktemp.c","lib/libc/stdio/mktemp.c","mkstemps",151,154
6,2,33,1,6,"mkdtemp@157-163@lib/libc/stdio/mktemp.c","lib/libc/stdio/mktemp.c","mkdtemp",157,163
27,6,217,3,34,"memstream_write@39-73@lib/libc/stdio/open_memstream.c","lib/libc/stdio/open_memstream.c","memstream_write",39,73
22,6,115,3,25,"memstream_seek@76-101@lib/libc/stdio/open_memstream.c","lib/libc/stdio/open_memstream.c","memstream_seek",76,101
6,1,25,1,7,"memstream_close@104-111@lib/libc/stdio/open_memstream.c","lib/libc/stdio/open_memstream.c","memstream_close",104,111
37,6,232,2,44,"open_memstream@114-158@lib/libc/stdio/open_memstream.c","lib/libc/stdio/open_memstream.c","open_memstream",114,158
29,6,255,3,36,"wmemstream_write@41-77@lib/libc/stdio/open_wmemstream.c","lib/libc/stdio/open_wmemstream.c","wmemstream_write",41,77
23,6,137,3,31,"wmemstream_seek@80-111@lib/libc/stdio/open_wmemstream.c","lib/libc/stdio/open_wmemstream.c","wmemstream_seek",80,111
6,1,25,1,7,"wmemstream_close@114-121@lib/libc/stdio/open_wmemstream.c","lib/libc/stdio/open_wmemstream.c","wmemstream_close",114,121
38,6,252,2,45,"open_wmemstream@124-169@lib/libc/stdio/open_wmemstream.c","lib/libc/stdio/open_wmemstream.c","open_wmemstream",124,169
22,3,142,1,22,"perror@40-62@lib/libc/stdio/perror.c","lib/libc/stdio/perror.c","perror",40,62
9,1,45,2,9,"printf@38-47@lib/libc/stdio/printf.c","lib/libc/stdio/printf.c","printf",38,47
9,2,47,2,8,"putc_unlocked@44-52@lib/libc/stdio/putc.c","lib/libc/stdio/putc.c","putc_unlocked",44,52
8,1,38,2,8,"putc@61-69@lib/libc/stdio/putc.c","lib/libc/stdio/putc.c","putc",61,69
5,1,23,1,5,"putchar_unlocked@41-46@lib/libc/stdio/putchar.c","lib/libc/stdio/putchar.c","putchar_unlocked",41,46
5,1,23,1,5,"putchar@55-60@lib/libc/stdio/putchar.c","lib/libc/stdio/putchar.c","putchar",55,60
19,2,132,1,19,"puts@43-62@lib/libc/stdio/puts.c","lib/libc/stdio/puts.c","puts",43,62
15,1,88,2,15,"putw@39-54@lib/libc/stdio/putw.c","lib/libc/stdio/putw.c","putw",39,54
4,1,19,2,4,"putwc@41-45@lib/libc/stdio/putwc.c","lib/libc/stdio/putwc.c","putwc",41,45
4,1,15,1,4,"putwchar@41-45@lib/libc/stdio/putwchar.c","lib/libc/stdio/putwchar.c","putwchar",41,45
6,2,41,1,5,"lflush@40-45@lib/libc/stdio/refill.c","lib/libc/stdio/refill.c","lflush",40,45
53,14,340,1,76,"__srefill@52-128@lib/libc/stdio/refill.c","lib/libc/stdio/refill.c","__srefill",52,128
9,3,56,1,9,"remove@40-49@lib/libc/stdio/remove.c","lib/libc/stdio/remove.c","remove",40,49
6,1,29,1,5,"rewind@38-43@lib/libc/stdio/rewind.c","lib/libc/stdio/rewind.c","rewind",38,43
9,2,46,1,8,"__srget@43-51@lib/libc/stdio/rget.c","lib/libc/stdio/rget.c","__srget",43,51
9,1,45,2,9,"scanf@38-47@lib/libc/stdio/scanf.c","lib/libc/stdio/scanf.c","scanf",38,47
4,2,30,2,3,"setbuf@38-41@lib/libc/stdio/setbuf.c","lib/libc/stdio/setbuf.c","setbuf",38,41
4,2,33,3,4,"setbuffer@37-41@lib/libc/stdio/setbuffer.c","lib/libc/stdio/setbuffer.c","setbuffer",37,41
4,1,22,1,4,"setlinebuf@48-52@lib/libc/stdio/setbuffer.c","lib/libc/stdio/setbuffer.c","setlinebuf",48,52
66,18,403,4,117,"setvbuf@43-160@lib/libc/stdio/setvbuf.c","lib/libc/stdio/setvbuf.c","setvbuf",43,160
24,3,152,4,26,"snprintf@41-67@lib/libc/stdio/snprintf.c","lib/libc/stdio/snprintf.c","snprintf",41,67
17,1,117,3,17,"sprintf@46-63@lib/libc/stdio/sprintf.c","lib/libc/stdio/sprintf.c","sprintf",46,63
4,1,20,3,4,"eofread@40-44@lib/libc/stdio/sscanf.c","lib/libc/stdio/sscanf.c","eofread",40,44
17,1,119,3,17,"sscanf@47-64@lib/libc/stdio/sscanf.c","lib/libc/stdio/sscanf.c","sscanf",47,64
11,2,61,3,12,"__sread@43-55@lib/libc/stdio/stdio.c","lib/libc/stdio/stdio.c","__sread",43,55
8,2,64,3,8,"__swrite@58-66@lib/libc/stdio/stdio.c","lib/libc/stdio/stdio.c","__swrite",58,66
13,2,69,3,13,"__sseek@69-82@lib/libc/stdio/stdio.c","lib/libc/stdio/stdio.c","__sseek",69,82
4,1,24,1,3,"__sclose@85-88@lib/libc/stdio/stdio.c","lib/libc/stdio/stdio.c","__sclose",85,88
23,8,149,2,40,"__swbuf@44-84@lib/libc/stdio/wbuf.c","lib/libc/stdio/wbuf.c","__swbuf",44,84
9,1,56,4,10,"swprintf@35-45@lib/libc/stdio/swprintf.c","lib/libc/stdio/swprintf.c","swprintf",35,45
9,1,52,3,10,"swscanf@34-44@lib/libc/stdio/swscanf.c","lib/libc/stdio/swscanf.c","swscanf",34,44
51,21,357,2,57,"tempnam@43-100@lib/libc/stdio/tempnam.c","lib/libc/stdio/tempnam.c","tempnam",43,100
29,4,215,1,36,"tmpfile@45-81@lib/libc/stdio/tmpfile.c","lib/libc/stdio/tmpfile.c","tmpfile",45,81
10,2,56,1,10,"tmpnam@43-53@lib/libc/stdio/tmpnam.c","lib/libc/stdio/tmpnam.c","tmpnam",43,53
25,5,201,1,29,"__submore@47-76@lib/libc/stdio/ungetc.c","lib/libc/stdio/ungetc.c","__submore",47,76
47,13,329,2,66,"ungetc@79-145@lib/libc/stdio/ungetc.c","lib/libc/stdio/ungetc.c","ungetc",79,145
18,4,87,2,28,"__ungetwc@38-66@lib/libc/stdio/ungetwc.c","lib/libc/stdio/ungetwc.c","__ungetwc",38,66
8,1,38,2,8,"ungetwc@69-77@lib/libc/stdio/ungetwc.c","lib/libc/stdio/ungetwc.c","ungetwc",69,77
33,6,248,3,36,"vasprintf@29-65@lib/libc/stdio/vasprintf.c","lib/libc/stdio/vasprintf.c","vasprintf",29,65
5,1,35,3,4,"__dwrite@44-48@lib/libc/stdio/vdprintf.c","lib/libc/stdio/vdprintf.c","__dwrite",44,48
19,3,134,3,22,"vdprintf@51-73@lib/libc/stdio/vdprintf.c","lib/libc/stdio/vdprintf.c","vdprintf",51,73
12,2,63,2,12,"__sprint@100-112@lib/libc/stdio/vfprintf.c","lib/libc/stdio/vfprintf.c","__sprint",100,112
21,4,156,3,26,"__sbprintf@120-146@lib/libc/stdio/vfprintf.c","lib/libc/stdio/vfprintf.c","__sbprintf",120,146
43,11,286,2,51,"__wcsconv@156-207@lib/libc/stdio/vfprintf.c","lib/libc/stdio/vfprintf.c","__wcsconv",156,207
8,1,45,3,8,"vfprintf@258-266@lib/libc/stdio/vfprintf.c","lib/libc/stdio/vfprintf.c","vfprintf",258,266
550,173,2886,3,821,"__vfprintf@270-1091@lib/libc/stdio/vfprintf.c","lib/libc/stdio/vfprintf.c","__vfprintf",270,1091
261,106,1362,4,336,"__find_arguments@1135-1471@lib/libc/stdio/vfprintf.c","lib/libc/stdio/vfprintf.c","__find_arguments",1135,1471
25,5,192,2,27,"__grow_type_table@1477-1504@lib/libc/stdio/vfprintf.c","lib/libc/stdio/vfprintf.c","__grow_type_table",1477,1504
26,7,164,3,32,"exponent@1509-1541@lib/libc/stdio/vfprintf.c","lib/libc/stdio/vfprintf.c","exponent",1509,1541
616,244,3400,3,763,"__svfscanf@100-863@lib/libc/stdio/vfscanf.c","lib/libc/stdio/vfscanf.c","__svfscanf",100,863
46,14,223,2,87,"__sccl@872-959@lib/libc/stdio/vfscanf.c","lib/libc/stdio/vfscanf.c","__sccl",872,959
8,1,45,3,8,"vfscanf@962-970@lib/libc/stdio/vfscanf.c","lib/libc/stdio/vfscanf.c","vfscanf",962,970
21,4,156,3,26,"__sbprintf@98-124@lib/libc/stdio/vfwprintf.c","lib/libc/stdio/vfwprintf.c","__sbprintf",98,124
23,4,154,2,24,"__xfputwc@131-155@lib/libc/stdio/vfwprintf.c","lib/libc/stdio/vfwprintf.c","__xfputwc",131,155
47,16,313,2,63,"__mbsconv@167-230@lib/libc/stdio/vfwprintf.c","lib/libc/stdio/vfwprintf.c","__mbsconv",167,230
547,171,2888,3,798,"__vfwprintf@280-1078@lib/libc/stdio/vfwprintf.c","lib/libc/stdio/vfwprintf.c","__vfwprintf",280,1078
8,1,47,3,9,"vfwprintf@1081-1090@lib/libc/stdio/vfwprintf.c","lib/libc/stdio/vfwprintf.c","vfwprintf",1081,1090
257,103,1333,4,331,"__find_arguments@1135-1466@lib/libc/stdio/vfwprintf.c","lib/libc/stdio/vfwprintf.c","__find_arguments",1135,1466
25,5,192,2,27,"__grow_type_table@1472-1499@lib/libc/stdio/vfwprintf.c","lib/libc/stdio/vfwprintf.c","__grow_type_table",1472,1499
26,7,164,3,32,"exponent@1504-1536@lib/libc/stdio/vfwprintf.c","lib/libc/stdio/vfwprintf.c","exponent",1504,1536
565,234,3162,3,685,"__vfwscanf@103-788@lib/libc/stdio/vfwscanf.c","lib/libc/stdio/vfwscanf.c","__vfwscanf",103,788
8,1,47,3,8,"vfwscanf@791-799@lib/libc/stdio/vfwscanf.c","lib/libc/stdio/vfwscanf.c","vfwscanf",791,799
4,1,24,2,3,"vprintf@37-40@lib/libc/stdio/vprintf.c","lib/libc/stdio/vprintf.c","vprintf",37,40
4,1,24,2,4,"vscanf@37-41@lib/libc/stdio/vscanf.c","lib/libc/stdio/vscanf.c","vscanf",37,41
21,3,138,4,24,"vsnprintf@40-64@lib/libc/stdio/vsnprintf.c","lib/libc/stdio/vsnprintf.c","vsnprintf",40,64
14,1,103,3,14,"vsprintf@45-59@lib/libc/stdio/vsprintf.c","lib/libc/stdio/vsprintf.c","vsprintf",45,59
4,1,20,3,4,"eofread@39-43@lib/libc/stdio/vsscanf.c","lib/libc/stdio/vsscanf.c","eofread",39,43
12,1,98,3,12,"vsscanf@46-58@lib/libc/stdio/vsscanf.c","lib/libc/stdio/vsscanf.c","vsscanf",46,58
50,7,323,4,56,"vswprintf@40-96@lib/libc/stdio/vswprintf.c","lib/libc/stdio/vswprintf.c","vswprintf",40,96
4,1,20,3,3,"eofread@46-49@lib/libc/stdio/vswscanf.c","lib/libc/stdio/vswscanf.c","eofread",46,49
31,4,220,3,36,"vswscanf@52-88@lib/libc/stdio/vswscanf.c","lib/libc/stdio/vswscanf.c","vswscanf",52,88
4,1,25,2,3,"vwprintf@39-42@lib/libc/stdio/vwprintf.c","lib/libc/stdio/vwprintf.c","vwprintf",39,42
4,1,25,2,4,"vwscanf@34-38@lib/libc/stdio/vwscanf.c","lib/libc/stdio/vwscanf.c","vwscanf",34,38
9,1,46,2,9,"wprintf@39-48@lib/libc/stdio/wprintf.c","lib/libc/stdio/wprintf.c","wprintf",39,48
9,1,46,2,10,"wscanf@34-44@lib/libc/stdio/wscanf.c","lib/libc/stdio/wscanf.c","wscanf",34,44
28,10,191,1,42,"__swsetup@44-86@lib/libc/stdio/wsetup.c","lib/libc/stdio/wsetup.c","__swsetup",44,86
4,1,12,1,3,"_Exit@19-22@lib/libc/stdlib/_Exit.c","lib/libc/stdlib/_Exit.c","_Exit",19,22
17,1,193,1,17,"__dorand48@30-47@lib/libc/stdlib/_rand48.c","lib/libc/stdlib/_rand48.c","__dorand48",30,47
28,12,180,1,31,"a64l@11-42@lib/libc/stdlib/a64l.c","lib/libc/stdlib/a64l.c","a64l",11,42
15,1,106,1,25,"abort@38-63@lib/libc/stdlib/abort.c","lib/libc/stdlib/abort.c","abort",38,63
4,2,19,1,3,"abs@34-37@lib/libc/stdlib/abs.c","lib/libc/stdlib/abs.c","abs",34,37
43,9,307,3,43,"__cxa_atexit@66-109@lib/libc/stdlib/atexit.c","lib/libc/stdlib/atexit.c","__cxa_atexit",66,109
4,1,35,1,3,"atexit@118-121@lib/libc/stdlib/atexit.c","lib/libc/stdlib/atexit.c","atexit",118,121
49,14,308,1,69,"__cxa_finalize@130-199@lib/libc/stdlib/atexit.c","lib/libc/stdlib/atexit.c","__cxa_finalize",130,199
32,7,237,1,32,"__atexit_register_cleanup@206-238@lib/libc/stdlib/atexit.c","lib/libc/stdlib/atexit.c","__atexit_register_cleanup",206,238
4,1,23,1,3,"atof@34-37@lib/libc/stdlib/atof.c","lib/libc/stdlib/atof.c","atof",34,37
4,1,28,1,3,"atoi@34-37@lib/libc/stdlib/atoi.c","lib/libc/stdlib/atoi.c","atoi",34,37
4,1,25,1,3,"atol@34-37@lib/libc/stdlib/atol.c","lib/libc/stdlib/atol.c","atol",34,37
5,1,27,1,4,"atoll@34-38@lib/libc/stdlib/atoll.c","lib/libc/stdlib/atoll.c","atoll",34,38
18,4,135,5,18,"bsearch@50-68@lib/libc/stdlib/bsearch.c","lib/libc/stdlib/bsearch.c","bsearch",50,68
11,3,59,2,34,"div@37-71@lib/libc/stdlib/div.c","lib/libc/stdlib/div.c","div",37,71
11,2,78,1,11,"drand48@19-30@lib/libc/stdlib/drand48.c","lib/libc/stdlib/drand48.c","drand48",19,30
51,13,315,6,61,"__cvt@31-92@lib/libc/stdlib/ecvt.c","lib/libc/stdlib/ecvt.c","__cvt",31,92
4,1,36,4,3,"ecvt@95-98@lib/libc/stdlib/ecvt.c","lib/libc/stdlib/ecvt.c","ecvt",95,98
4,1,36,4,3,"fcvt@101-104@lib/libc/stdlib/ecvt.c","lib/libc/stdlib/ecvt.c","fcvt",101,104
7,1,59,1,6,"erand48@19-25@lib/libc/stdlib/erand48.c","lib/libc/stdlib/erand48.c","erand48",19,25
5,1,17,1,8,"exit@48-56@lib/libc/stdlib/exit.c","lib/libc/stdlib/exit.c","exit",48,56
77,23,471,3,90,"gcvt@33-123@lib/libc/stdlib/gcvt.c","lib/libc/stdlib/gcvt.c","gcvt",33,123
18,9,130,3,18,"__findenv@46-64@lib/libc/stdlib/getenv.c","lib/libc/stdlib/getenv.c","__findenv",46,64
8,3,57,1,8,"getenv@71-79@lib/libc/stdlib/getenv.c","lib/libc/stdlib/getenv.c","getenv",71,79
11,2,46,2,12,"gcd@109-121@lib/libc/stdlib/getopt_long.c","lib/libc/stdlib/getopt_long.c","gcd",109,121
23,4,162,4,27,"permute_args@129-156@lib/libc/stdlib/getopt_long.c","lib/libc/stdlib/getopt_long.c","permute_args",129,156
92,32,552,6,118,"parse_long_options@164-282@lib/libc/stdlib/getopt_long.c","lib/libc/stdlib/getopt_long.c","parse_long_options",164,282
137,57,830,6,187,"getopt_internal@289-476@lib/libc/stdlib/getopt_long.c","lib/libc/stdlib/getopt_long.c","getopt_internal",289,476
4,1,36,3,12,"getopt@485-497@lib/libc/stdlib/getopt_long.c","lib/libc/stdlib/getopt_long.c","getopt",485,497
6,1,46,5,6,"getopt_long@504-510@lib/libc/stdlib/getopt_long.c","lib/libc/stdlib/getopt_long.c","getopt_long",504,510
6,1,48,5,6,"getopt_long_only@517-523@lib/libc/stdlib/getopt_long.c","lib/libc/stdlib/getopt_long.c","getopt_long_only",517,523
31,26,267,3,47,"getsubopt@45-92@lib/libc/stdlib/getsubopt.c","lib/libc/stdlib/getsubopt.c","getsubopt",45,92
29,8,161,1,41,"hcreate@88-129@lib/libc/stdlib/hcreate.c","lib/libc/stdlib/hcreate.c","hcreate",88,129
18,4,103,1,19,"hdestroy@132-151@lib/libc/stdlib/hcreate.c","lib/libc/stdlib/hcreate.c","hdestroy",132,151
30,7,205,2,35,"hsearch@154-189@lib/libc/stdlib/hcreate.c","lib/libc/stdlib/hcreate.c","hsearch",154,189
26,6,236,4,40,"heapsort@134-174@lib/libc/stdlib/heapsort.c","lib/libc/stdlib/heapsort.c","heapsort",134,174
7,2,29,1,7,"roundup@108-115@lib/libc/stdlib/icdb.c","lib/libc/stdlib/icdb.c","roundup",108,115
31,9,217,6,32,"icdb_new@118-150@lib/libc/stdlib/icdb.c","lib/libc/stdlib/icdb.c","icdb_new",118,150
46,12,342,3,50,"icdb_open@154-204@lib/libc/stdlib/icdb.c","lib/libc/stdlib/icdb.c","icdb_open",154,204
6,1,47,3,6,"icdb_get@208-214@lib/libc/stdlib/icdb.c","lib/libc/stdlib/icdb.c","icdb_get",208,214
28,5,205,5,30,"icdb_lookup@218-248@lib/libc/stdlib/icdb.c","lib/libc/stdlib/icdb.c","icdb_lookup",218,248
4,1,16,1,3,"icdb_nentries@252-255@lib/libc/stdlib/icdb.c","lib/libc/stdlib/icdb.c","icdb_nentries",252,255
4,1,14,1,3,"icdb_entries@259-262@lib/libc/stdlib/icdb.c","lib/libc/stdlib/icdb.c","icdb_entries",259,262
17,2,130,3,18,"icdb_update@266-284@lib/libc/stdlib/icdb.c","lib/libc/stdlib/icdb.c","icdb_update",266,284
17,4,124,2,17,"icdb_add@288-305@lib/libc/stdlib/icdb.c","lib/libc/stdlib/icdb.c","icdb_add",288,305
31,6,269,1,33,"icdb_rehash@309-342@lib/libc/stdlib/icdb.c","lib/libc/stdlib/icdb.c","icdb_rehash",309,342
23,7,173,2,25,"icdb_save@346-371@lib/libc/stdlib/icdb.c","lib/libc/stdlib/icdb.c","icdb_save",346,371
15,3,93,1,15,"icdb_close@375-390@lib/libc/stdlib/icdb.c","lib/libc/stdlib/icdb.c","icdb_close",375,390
4,2,19,1,3,"imaxabs@35-38@lib/libc/stdlib/imaxabs.c","lib/libc/stdlib/imaxabs.c","imaxabs",35,38
11,3,59,2,13,"imaxdiv@37-50@lib/libc/stdlib/imaxdiv.c","lib/libc/stdlib/imaxdiv.c","imaxdiv",37,50
14,3,81,2,14,"insque@40-54@lib/libc/stdlib/insque.c","lib/libc/stdlib/insque.c","insque",40,54
5,1,38,1,4,"jrand48@18-22@lib/libc/stdlib/jrand48.c","lib/libc/stdlib/jrand48.c","jrand48",18,22
26,7,141,1,31,"l64a@11-42@lib/libc/stdlib/l64a.c","lib/libc/stdlib/l64a.c","l64a",11,42
4,2,19,1,3,"labs@34-37@lib/libc/stdlib/labs.c","lib/libc/stdlib/labs.c","labs",34,37
5,1,20,1,4,"lcong48@18-22@lib/libc/stdlib/lcong48.c","lib/libc/stdlib/lcong48.c","lcong48",18,22
11,1,82,1,10,"lcong48_deterministic@25-35@lib/libc/stdlib/lcong48.c","lib/libc/stdlib/lcong48.c","lcong48_deterministic",25,35
11,3,59,2,13,"ldiv@37-50@lib/libc/stdlib/ldiv.c","lib/libc/stdlib/ldiv.c","ldiv",37,50
4,2,20,1,3,"llabs@35-38@lib/libc/stdlib/llabs.c","lib/libc/stdlib/llabs.c","llabs",35,38
11,3,61,2,13,"lldiv@37-50@lib/libc/stdlib/lldiv.c","lib/libc/stdlib/lldiv.c","lldiv",37,50
7,2,51,1,6,"lrand48@18-24@lib/libc/stdlib/lrand48.c","lib/libc/stdlib/lrand48.c","lrand48",18,24
5,1,41,5,5,"lsearch@44-49@lib/libc/stdlib/lsearch.c","lib/libc/stdlib/lsearch.c","lsearch",44,49
5,1,42,5,4,"lfind@52-56@lib/libc/stdlib/lsearch.c","lib/libc/stdlib/lsearch.c","lfind",52,56
14,4,118,6,25,"linear_base@59-84@lib/libc/stdlib/lsearch.c","lib/libc/stdlib/lsearch.c","linear_base",59,84
7,2,29,1,6,"_MALLOC_LEAVE@230-236@lib/libc/stdlib/malloc.c","lib/libc/stdlib/malloc.c","_MALLOC_LEAVE",230,236
7,2,29,1,6,"_MALLOC_ENTER@239-245@lib/libc/stdlib/malloc.c","lib/libc/stdlib/malloc.c","_MALLOC_ENTER",239,245
11,2,85,1,13,"hash@248-261@lib/libc/stdlib/malloc.c","lib/libc/stdlib/malloc.c","hash",248,261
8,2,40,1,7,"getpool@264-271@lib/libc/stdlib/malloc.c","lib/libc/stdlib/malloc.c","getpool",264,271
15,5,99,3,20,"wrterror@274-294@lib/libc/stdlib/malloc.c","lib/libc/stdlib/malloc.c","wrterror",274,294
5,1,47,1,5,"rbytes_init@297-302@lib/libc/stdlib/malloc.c","lib/libc/stdlib/malloc.c","rbytes_init",297,302
8,2,45,1,8,"getrbyte@305-313@lib/libc/stdlib/malloc.c","lib/libc/stdlib/malloc.c","getrbyte",305,313
61,22,455,4,68,"unmap@323-391@lib/libc/stdlib/malloc.c","lib/libc/stdlib/malloc.c","unmap",323,391
18,5,142,3,18,"zapcacheregion@394-412@lib/libc/stdlib/malloc.c","lib/libc/stdlib/malloc.c","zapcacheregion",394,412
67,25,478,4,70,"map@415-485@lib/libc/stdlib/malloc.c","lib/libc/stdlib/malloc.c","map",415,485
70,23,267,1,71,"omalloc_parseopt@488-559@lib/libc/stdlib/malloc.c","lib/libc/stdlib/malloc.c","omalloc_parseopt",488,559
52,17,269,1,61,"omalloc_init@562-623@lib/libc/stdlib/malloc.c","lib/libc/stdlib/malloc.c","omalloc_init",562,623
32,5,272,1,39,"omalloc_poolinit@629-668@lib/libc/stdlib/malloc.c","lib/libc/stdlib/malloc.c","omalloc_poolinit",629,668
40,7,284,1,44,"omalloc_grow@671-715@lib/libc/stdlib/malloc.c","lib/libc/stdlib/malloc.c","omalloc_grow",671,715
31,6,222,2,34,"alloc_chunk_info@718-752@lib/libc/stdlib/malloc.c","lib/libc/stdlib/malloc.c","alloc_chunk_info",718,752
24,5,166,4,26,"insert@760-786@lib/libc/stdlib/malloc.c","lib/libc/stdlib/malloc.c","insert",760,786
21,7,176,2,21,"find@789-810@lib/libc/stdlib/malloc.c","lib/libc/stdlib/malloc.c","find",789,810
27,11,209,2,30,"delete@813-843@lib/libc/stdlib/malloc.c","lib/libc/stdlib/malloc.c","delete",813,843
48,9,382,3,61,"omalloc_make_chunks@849-910@lib/libc/stdlib/malloc.c","lib/libc/stdlib/malloc.c","omalloc_make_chunks",849,910
15,5,71,1,19,"find_chunksize@913-932@lib/libc/stdlib/malloc.c","lib/libc/stdlib/malloc.c","find_chunksize",913,932
61,22,456,3,76,"malloc_bytes@938-1014@lib/libc/stdlib/malloc.c","lib/libc/stdlib/malloc.c","malloc_bytes",938,1014
7,2,42,3,7,"fill_canary@1017-1024@lib/libc/stdlib/malloc.c","lib/libc/stdlib/malloc.c","fill_canary",1017,1024
17,5,99,4,18,"validate_canary@1027-1045@lib/libc/stdlib/malloc.c","lib/libc/stdlib/malloc.c","validate_canary",1027,1045
19,6,172,4,22,"find_chunknum@1048-1070@lib/libc/stdlib/malloc.c","lib/libc/stdlib/malloc.c","find_chunknum",1048,1070
32,7,253,3,40,"free_bytes@1076-1116@lib/libc/stdlib/malloc.c","lib/libc/stdlib/malloc.c","free_bytes",1076,1116
53,17,354,4,60,"omalloc@1121-1181@lib/libc/stdlib/malloc.c","lib/libc/stdlib/malloc.c","omalloc",1121,1181
11,2,48,1,11,"malloc_recurse@1189-1200@lib/libc/stdlib/malloc.c","lib/libc/stdlib/malloc.c","malloc_recurse",1189,1200
30,10,187,1,37,"_malloc_init@1203-1240@lib/libc/stdlib/malloc.c","lib/libc/stdlib/malloc.c","_malloc_init",1203,1240
25,6,131,1,26,"malloc@1244-1270@lib/libc/stdlib/malloc.c","lib/libc/stdlib/malloc.c","malloc",1244,1270
17,6,112,2,17,"validate_junk@1274-1291@lib/libc/stdlib/malloc.c","lib/libc/stdlib/malloc.c","validate_junk",1274,1291
114,35,733,5,120,"ofree@1294-1414@lib/libc/stdlib/malloc.c","lib/libc/stdlib/malloc.c","ofree",1294,1414
20,4,103,1,22,"free@1417-1439@lib/libc/stdlib/malloc.c","lib/libc/stdlib/malloc.c","free",1417,1439
5,1,23,2,4,"freezero_p@1443-1447@lib/libc/stdlib/malloc.c","lib/libc/stdlib/malloc.c","freezero_p",1443,1447
24,5,124,2,27,"freezero@1450-1477@lib/libc/stdlib/malloc.c","lib/libc/stdlib/malloc.c","freezero",1450,1477
170,56,1147,4,188,"orealloc@1481-1669@lib/libc/stdlib/malloc.c","lib/libc/stdlib/malloc.c","orealloc",1481,1669
25,6,135,2,26,"realloc@1672-1698@lib/libc/stdlib/malloc.c","lib/libc/stdlib/malloc.c","realloc",1672,1698
34,11,189,2,37,"calloc@1709-1746@lib/libc/stdlib/malloc.c","lib/libc/stdlib/malloc.c","calloc",1709,1746
63,17,421,5,73,"orecallocarray@1750-1823@lib/libc/stdlib/malloc.c","lib/libc/stdlib/malloc.c","orecallocarray",1750,1823
37,15,236,4,49,"recallocarray_p@1826-1875@lib/libc/stdlib/malloc.c","lib/libc/stdlib/malloc.c","recallocarray_p",1826,1875
46,17,278,4,53,"recallocarray@1878-1931@lib/libc/stdlib/malloc.c","lib/libc/stdlib/malloc.c","recallocarray",1878,1931
22,9,194,4,31,"mapalign@1936-1967@lib/libc/stdlib/malloc.c","lib/libc/stdlib/malloc.c","mapalign",1936,1967
46,13,293,5,59,"omemalign@1970-2029@lib/libc/stdlib/malloc.c","lib/libc/stdlib/malloc.c","omemalign",1970,2029
34,7,186,3,37,"posix_memalign@2032-2069@lib/libc/stdlib/malloc.c","lib/libc/stdlib/malloc.c","posix_memalign",2032,2069
4,2,44,2,3,"leakcmp@2086-2089@lib/libc/stdlib/malloc.c","lib/libc/stdlib/malloc.c","leakcmp",2086,2089
27,7,175,3,28,"putleakinfo@2096-2124@lib/libc/stdlib/malloc.c","lib/libc/stdlib/malloc.c","putleakinfo",2096,2124
22,5,167,1,23,"dump_leaks@2129-2152@lib/libc/stdlib/malloc.c","lib/libc/stdlib/malloc.c","dump_leaks",2129,2152
21,6,159,4,20,"dump_chunk@2155-2175@lib/libc/stdlib/malloc.c","lib/libc/stdlib/malloc.c","dump_chunk",2155,2175
21,6,146,2,22,"dump_free_chunk_info@2178-2200@lib/libc/stdlib/malloc.c","lib/libc/stdlib/malloc.c","dump_free_chunk_info",2178,2200
12,3,92,2,12,"dump_free_page_info@2203-2215@lib/libc/stdlib/malloc.c","lib/libc/stdlib/malloc.c","dump_free_page_info",2203,2215
43,5,336,3,43,"malloc_dump1@2218-2261@lib/libc/stdlib/malloc.c","lib/libc/stdlib/malloc.c","malloc_dump1",2218,2261
22,5,137,3,23,"malloc_dump@2264-2287@lib/libc/stdlib/malloc.c","lib/libc/stdlib/malloc.c","malloc_dump",2264,2287
8,2,46,1,9,"malloc_gdump@2291-2300@lib/libc/stdlib/malloc.c","lib/libc/stdlib/malloc.c","malloc_gdump",2291,2300
23,3,144,1,24,"malloc_exit@2304-2328@lib/libc/stdlib/malloc.c","lib/libc/stdlib/malloc.c","malloc_exit",2304,2328
124,34,840,4,132,"mergesort@91-223@lib/libc/stdlib/merge.c","lib/libc/stdlib/merge.c","mergesort",91,223
56,17,496,5,65,"setup@251-316@lib/libc/stdlib/merge.c","lib/libc/stdlib/merge.c","setup",251,316
13,4,106,4,13,"insertionsort@323-336@lib/libc/stdlib/merge.c","lib/libc/stdlib/merge.c","insertionsort",323,336
7,2,47,1,6,"mrand48@18-24@lib/libc/stdlib/mrand48.c","lib/libc/stdlib/mrand48.c","mrand48",18,24
5,1,43,1,4,"nrand48@18-22@lib/libc/stdlib/nrand48.c","lib/libc/stdlib/nrand48.c","nrand48",18,22
19,5,107,1,23,"posix_openpt@32-55@lib/libc/stdlib/posix_pty.c","lib/libc/stdlib/posix_pty.c","posix_openpt",32,55
17,4,86,1,18,"ptmname@63-81@lib/libc/stdlib/posix_pty.c","lib/libc/stdlib/posix_pty.c","ptmname",63,81
4,2,18,1,3,"grantpt@87-90@lib/libc/stdlib/posix_pty.c","lib/libc/stdlib/posix_pty.c","grantpt",87,90
4,2,18,1,3,"unlockpt@96-99@lib/libc/stdlib/posix_pty.c","lib/libc/stdlib/posix_pty.c","unlockpt",96,99
11,2,86,1,14,"ptsname@106-120@lib/libc/stdlib/posix_pty.c","lib/libc/stdlib/posix_pty.c","ptsname",106,120
16,5,77,4,15,"swapfunc@78-93@lib/libc/stdlib/qsort.c","lib/libc/stdlib/qsort.c","swapfunc",78,93
6,6,97,4,5,"med3@117-122@lib/libc/stdlib/qsort.c","lib/libc/stdlib/qsort.c","med3",117,122
82,20,601,6,89,"introsort@125-214@lib/libc/stdlib/qsort.c","lib/libc/stdlib/qsort.c","introsort",125,214
15,7,140,4,19,"qsort@217-236@lib/libc/stdlib/qsort.c","lib/libc/stdlib/qsort.c","qsort",217,236
9,1,54,4,9,"radixsort@85-94@lib/libc/stdlib/radixsort.c","lib/libc/stdlib/radixsort.c","radixsort",85,94
16,3,110,4,16,"sradixsort@97-113@lib/libc/stdlib/radixsort.c","lib/libc/stdlib/radixsort.c","sradixsort",97,113
59,16,444,5,83,"r_sort_a@122-205@lib/libc/stdlib/radixsort.c","lib/libc/stdlib/radixsort.c","r_sort_a",122,205
63,16,454,6,66,"r_sort_b@209-275@lib/libc/stdlib/radixsort.c","lib/libc/stdlib/radixsort.c","r_sort_b",209,275
15,6,150,5,16,"simplesort@278-294@lib/libc/stdlib/radixsort.c","lib/libc/stdlib/radixsort.c","simplesort",278,294
5,1,26,1,4,"rand_r@38-42@lib/libc/stdlib/rand.c","lib/libc/stdlib/rand.c","rand_r",38,42
6,2,30,1,5,"rand@51-56@lib/libc/stdlib/rand.c","lib/libc/stdlib/rand.c","rand",51,56
4,1,11,1,3,"srand@64-67@lib/libc/stdlib/rand.c","lib/libc/stdlib/rand.c","srand",64,67
5,1,15,1,4,"srand_deterministic@70-74@lib/libc/stdlib/rand.c","lib/libc/stdlib/rand.c","srand_deterministic",70,74
21,6,146,1,29,"srandom_l@197-226@lib/libc/stdlib/random.c","lib/libc/stdlib/random.c","srandom_l",197,226
4,1,12,1,3,"srandom@229-232@lib/libc/stdlib/random.c","lib/libc/stdlib/random.c","srandom",229,232
4,1,10,1,3,"srandomdev@235-238@lib/libc/stdlib/random.c","lib/libc/stdlib/random.c","srandomdev",235,238
6,1,21,1,5,"srandom_deterministic@241-246@lib/libc/stdlib/random.c","lib/libc/stdlib/random.c","srandom_deterministic",241,246
44,8,254,3,44,"initstate@268-312@lib/libc/stdlib/random.c","lib/libc/stdlib/random.c","initstate",268,312
35,8,201,1,35,"setstate@330-365@lib/libc/stdlib/random.c","lib/libc/stdlib/random.c","setstate",330,365
18,5,105,1,19,"random_l@385-404@lib/libc/stdlib/random.c","lib/libc/stdlib/random.c","random_l",385,404
8,1,26,1,7,"random@407-414@lib/libc/stdlib/random.c","lib/libc/stdlib/random.c","random",407,414
9,5,55,3,8,"reallocarray@30-38@lib/libc/stdlib/reallocarray.c","lib/libc/stdlib/reallocarray.c","reallocarray",30,38
134,35,798,2,171,"realpath@46-217@lib/libc/stdlib/realpath.c","lib/libc/stdlib/realpath.c","realpath",46,217
37,15,238,4,49,"recallocarray@31-80@lib/libc/stdlib/recallocarray.c","lib/libc/stdlib/recallocarray.c","recallocarray",31,80
8,3,51,1,8,"remque@40-48@lib/libc/stdlib/remque.c","lib/libc/stdlib/remque.c","remque",40,48
7,1,30,1,7,"seed48@18-25@lib/libc/stdlib/seed48.c","lib/libc/stdlib/seed48.c","seed48",18,25
16,1,111,1,16,"seed48_deterministic@28-44@lib/libc/stdlib/seed48.c","lib/libc/stdlib/seed48.c","seed48_deterministic",28,44
35,13,259,1,39,"putenv@43-82@lib/libc/stdlib/setenv.c","lib/libc/stdlib/setenv.c","putenv",43,82
55,23,417,3,60,"setenv@91-151@lib/libc/stdlib/setenv.c","lib/libc/stdlib/setenv.c","setenv",91,151
22,9,136,1,24,"unsetenv@159-183@lib/libc/stdlib/setenv.c","lib/libc/stdlib/setenv.c","unsetenv",159,183
5,1,16,1,4,"srand48@20-24@lib/libc/stdlib/srand48.c","lib/libc/stdlib/srand48.c","srand48",20,24
11,1,70,1,10,"srand48_deterministic@27-37@lib/libc/stdlib/srand48.c","lib/libc/stdlib/srand48.c","srand48_deterministic",27,37
79,34,459,3,108,"strtoimax@42-150@lib/libc/stdlib/strtoimax.c","lib/libc/stdlib/strtoimax.c","strtoimax",42,150
79,34,459,3,107,"strtol@43-150@lib/libc/stdlib/strtol.c","lib/libc/stdlib/strtol.c","strtol",43,150
79,34,460,3,108,"strtoll@45-153@lib/libc/stdlib/strtoll.c","lib/libc/stdlib/strtoll.c","strtoll",45,153
35,12,216,4,36,"strtonum@29-65@lib/libc/stdlib/strtonum.c","lib/libc/stdlib/strtonum.c","strtonum",29,65
61,29,397,3,66,"strtoul@43-109@lib/libc/stdlib/strtoul.c","lib/libc/stdlib/strtoul.c","strtoul",43,109
61,29,401,3,66,"strtoull@45-111@lib/libc/stdlib/strtoull.c","lib/libc/stdlib/strtoull.c","strtoull",45,111
61,29,393,3,66,"strtoumax@42-108@lib/libc/stdlib/strtoumax.c","lib/libc/stdlib/strtoumax.c","strtoumax",42,108
32,7,237,1,35,"system@40-75@lib/libc/stdlib/system.c","lib/libc/stdlib/system.c","system",40,75
17,5,148,3,17,"tfind@23-40@lib/libc/stdlib/tfind.c","lib/libc/stdlib/tfind.c","tfind",23,40
24,6,204,3,25,"tsearch@24-49@lib/libc/stdlib/tsearch.c","lib/libc/stdlib/tsearch.c","tsearch",24,49
38,10,330,3,38,"tdelete@53-91@lib/libc/stdlib/tsearch.c","lib/libc/stdlib/tsearch.c","tdelete",53,91
14,5,153,3,13,"trecurse@95-108@lib/libc/stdlib/tsearch.c","lib/libc/stdlib/tsearch.c","trecurse",95,108
6,3,72,2,6,"twalk@112-118@lib/libc/stdlib/tsearch.c","lib/libc/stdlib/tsearch.c","twalk",112,118
13,4,78,3,13,"bcmp@38-51@lib/libc/string/bcmp.c","lib/libc/string/bcmp.c","bcmp",38,51
41,10,304,3,63,"bcopy@49-112@lib/libc/string/bcopy.c","lib/libc/string/bcopy.c","bcopy",49,112
6,2,31,2,6,"bzero@38-44@lib/libc/string/bzero.c","lib/libc/string/bzero.c","bzero",38,44
3,1,10,2,2,"__explicit_bzero_hook@10-12@lib/libc/string/explicit_bzero.c","lib/libc/string/explicit_bzero.c","__explicit_bzero_hook",10,12
5,1,27,2,4,"explicit_bzero@15-19@lib/libc/string/explicit_bzero.c","lib/libc/string/explicit_bzero.c","explicit_bzero",15,19
25,4,136,1,26,"ffs@14-40@lib/libc/string/ffs.c","lib/libc/string/ffs.c","ffs",14,40
13,4,81,4,13,"memccpy@35-48@lib/libc/string/memccpy.c","lib/libc/string/memccpy.c","memccpy",35,48
11,4,72,3,11,"memchr@37-48@lib/libc/string/memchr.c","lib/libc/string/memchr.c","memchr",37,48
11,4,75,3,11,"memcmp@40-51@lib/libc/string/memcmp.c","lib/libc/string/memcmp.c","memcmp",40,51
32,10,254,3,55,"memcpy@53-108@lib/libc/string/memcpy.c","lib/libc/string/memcpy.c","memcpy",53,108
17,7,135,4,26,"memmem@37-63@lib/libc/string/memmem.c","lib/libc/string/memmem.c","memmem",37,63
41,10,307,3,63,"memmove@49-112@lib/libc/string/memmove.c","lib/libc/string/memmove.c","memmove",49,112
12,4,79,3,12,"memrchr@26-38@lib/libc/string/memrchr.c","lib/libc/string/memrchr.c","memrchr",26,38
10,3,53,3,10,"memset@37-47@lib/libc/string/memset.c","lib/libc/string/memset.c","memset",37,47
5,2,38,2,4,"stpcpy@40-44@lib/libc/string/stpcpy.c","lib/libc/string/stpcpy.c","stpcpy",40,44
17,5,98,3,18,"stpncpy@38-56@lib/libc/string/stpncpy.c","lib/libc/string/stpncpy.c","stpncpy",38,56
10,3,89,2,10,"strcasecmp@77-87@lib/libc/string/strcasecmp.c","lib/libc/string/strcasecmp.c","strcasecmp",77,87
15,5,113,3,15,"strncasecmp@91-106@lib/libc/string/strcasecmp.c","lib/libc/string/strcasecmp.c","strncasecmp",91,106
5,1,31,3,4,"strcasecmp_l@10-14@lib/libc/string/strcasecmp_l.c","lib/libc/string/strcasecmp_l.c","strcasecmp_l",10,14
5,1,36,4,4,"strncasecmp_l@17-21@lib/libc/string/strcasecmp_l.c","lib/libc/string/strcasecmp_l.c","strncasecmp_l",17,21
17,5,123,2,17,"strcasestr@43-60@lib/libc/string/strcasestr.c","lib/libc/string/strcasestr.c","strcasestr",43,60
7,3,49,2,7,"strcat@40-47@lib/libc/string/strcat.c","lib/libc/string/strcat.c","strcat",40,47
9,4,52,2,9,"strchr@36-45@lib/libc/string/strchr.c","lib/libc/string/strchr.c","strchr",36,45
7,3,56,2,6,"strcmp@41-47@lib/libc/string/strcmp.c","lib/libc/string/strcmp.c","strcmp",41,47
4,1,24,2,4,"strcoll@40-44@lib/libc/string/strcoll.c","lib/libc/string/strcoll.c","strcoll",40,44
5,1,31,3,4,"strcoll_l@10-14@lib/libc/string/strcoll_l.c","lib/libc/string/strcoll_l.c","strcoll_l",10,14
6,2,44,2,6,"strcpy@40-46@lib/libc/string/strcpy.c","lib/libc/string/strcpy.c","strcpy",40,46
13,4,78,2,18,"strcspn@40-58@lib/libc/string/strcspn.c","lib/libc/string/strcspn.c","strcspn",40,58
10,2,60,1,10,"strdup@39-49@lib/libc/string/strdup.c","lib/libc/string/strdup.c","strdup",39,49
6,1,34,1,6,"strerror@35-41@lib/libc/string/strerror.c","lib/libc/string/strerror.c","strerror",35,41
9,3,58,2,9,"strerror_l@24-33@lib/libc/string/strerror_l.c","lib/libc/string/strerror_l.c","strerror_l",24,33
9,2,33,1,10,"__digits10@10-20@lib/libc/string/strerror_r.c","lib/libc/string/strerror_r.c","__digits10",10,20
30,7,140,5,32,"__itoa@23-55@lib/libc/string/strerror_r.c","lib/libc/string/strerror_r.c","__itoa",23,55
21,6,135,8,22,"__num2string@59-81@lib/libc/string/strerror_r.c","lib/libc/string/strerror_r.c","__num2string",59,81
9,2,51,3,10,"strerror_r@86-96@lib/libc/string/strerror_r.c","lib/libc/string/strerror_r.c","strerror_r",86,96
6,1,33,2,5,"__strsignal@102-107@lib/libc/string/strerror_r.c","lib/libc/string/strerror_r.c","__strsignal",102,107
22,6,128,3,25,"strlcat@30-55@lib/libc/string/strlcat.c","lib/libc/string/strlcat.c","strlcat",30,55
18,7,96,3,22,"strlcpy@28-50@lib/libc/string/strlcpy.c","lib/libc/string/strlcpy.c","strlcpy",28,50
7,2,34,1,7,"strlen@35-42@lib/libc/string/strlen.c","lib/libc/string/strlen.c","strlen",35,42
97,27,405,2,102,"strmode@38-140@lib/libc/string/strmode.c","lib/libc/string/strmode.c","strmode",38,140
16,5,86,3,16,"strncat@41-57@lib/libc/string/strncat.c","lib/libc/string/strncat.c","strncat",41,57
12,5,83,3,12,"strncmp@35-47@lib/libc/string/strncmp.c","lib/libc/string/strncmp.c","strncmp",35,47
15,5,84,3,16,"strncpy@42-58@lib/libc/string/strncpy.c","lib/libc/string/strncpy.c","strncpy",42,58
12,2,67,2,13,"strndup@26-39@lib/libc/string/strndup.c","lib/libc/string/strndup.c","strndup",26,39
7,3,49,2,8,"strnlen@24-32@lib/libc/string/strnlen.c","lib/libc/string/strnlen.c","strnlen",24,32
11,4,79,2,11,"strpbrk@37-48@lib/libc/string/strpbrk.c","lib/libc/string/strpbrk.c","strpbrk",37,48
10,4,54,2,11,"strrchr@36-47@lib/libc/string/strrchr.c","lib/libc/string/strrchr.c","strrchr",36,47
23,6,120,2,24,"strsep@46-70@lib/libc/string/strsep.c","lib/libc/string/strsep.c","strsep",46,70
5,1,22,1,5,"strsignal@34-39@lib/libc/string/strsignal.c","lib/libc/string/strsignal.c","strsignal",34,39
11,3,72,2,14,"strspn@37-51@lib/libc/string/strspn.c","lib/libc/string/strspn.c","strspn",37,51
6,4,85,2,5,"twobyte_strstr@31-36@lib/libc/string/strstr.c","lib/libc/string/strstr.c","twobyte_strstr",31,36
7,4,111,2,6,"threebyte_strstr@39-45@lib/libc/string/strstr.c","lib/libc/string/strstr.c","threebyte_strstr",39,45
7,4,119,2,6,"fourbyte_strstr@48-54@lib/libc/string/strstr.c","lib/libc/string/strstr.c","fourbyte_strstr",48,54
86,30,687,2,106,"twoway_strstr@67-173@lib/libc/string/strstr.c","lib/libc/string/strstr.c","twoway_strstr",67,173
13,10,178,2,16,"strstr@176-192@lib/libc/string/strstr.c","lib/libc/string/strstr.c","strstr",176,192
5,1,29,2,5,"strtok@33-38@lib/libc/string/strtok.c","lib/libc/string/strtok.c","strtok",33,38
33,9,181,3,44,"strtok_r@42-86@lib/libc/string/strtok.c","lib/libc/string/strtok.c","strtok_r",42,86
6,2,42,3,9,"strxfrm@42-51@lib/libc/string/strxfrm.c","lib/libc/string/strxfrm.c","strxfrm",42,51
5,1,35,4,4,"strxfrm_l@10-14@lib/libc/string/strxfrm_l.c","lib/libc/string/strxfrm_l.c","strxfrm_l",10,14
15,2,87,3,15,"swab@20-35@lib/libc/string/swab.c","lib/libc/string/swab.c","swab",20,35
8,2,62,3,8,"timingsafe_bcmp@21-29@lib/libc/string/timingsafe_bcmp.c","lib/libc/string/timingsafe_bcmp.c","timingsafe_bcmp",21,29
14,2,117,3,24,"timingsafe_memcmp@22-46@lib/libc/string/timingsafe_memcmp.c","lib/libc/string/timingsafe_memcmp.c","timingsafe_memcmp",22,46
9,3,69,2,10,"wcscasecmp@33-43@lib/libc/string/wcscasecmp.c","lib/libc/string/wcscasecmp.c","wcscasecmp",33,43
14,5,98,3,15,"wcsncasecmp@47-62@lib/libc/string/wcscasecmp.c","lib/libc/string/wcscasecmp.c","wcsncasecmp",47,62
10,3,76,3,11,"wcscasecmp_l@33-44@lib/libc/string/wcscasecmp_l.c","lib/libc/string/wcscasecmp_l.c","wcscasecmp_l",33,44
15,5,105,4,16,"wcsncasecmp_l@47-63@lib/libc/string/wcscasecmp_l.c","lib/libc/string/wcscasecmp_l.c","wcsncasecmp_l",47,63
15,3,67,2,15,"wcscat@40-55@lib/libc/string/wcscat.c","lib/libc/string/wcscat.c","wcscat",40,55
13,4,56,2,14,"wcschr@35-49@lib/libc/string/wcschr.c","lib/libc/string/wcschr.c","wcschr",35,49
7,3,56,2,8,"wcscmp@43-51@lib/libc/string/wcscmp.c","lib/libc/string/wcscmp.c","wcscmp",43,51
11,2,51,2,12,"wcscpy@40-52@lib/libc/string/wcscpy.c","lib/libc/string/wcscpy.c","wcscpy",40,52
17,4,72,2,18,"wcscspn@35-53@lib/libc/string/wcscspn.c","lib/libc/string/wcscspn.c","wcscspn",35,53
10,2,61,1,12,"wcsdup@19-31@lib/libc/string/wcsdup.c","lib/libc/string/wcsdup.c","wcsdup",19,31
22,6,131,3,25,"wcslcat@30-55@lib/libc/string/wcslcat.c","lib/libc/string/wcslcat.c","wcslcat",30,55
18,7,98,3,22,"wcslcpy@28-50@lib/libc/string/wcslcpy.c","lib/libc/string/wcslcpy.c","wcslcpy",28,50
8,2,31,1,9,"wcslen@35-44@lib/libc/string/wcslen.c","lib/libc/string/wcslen.c","wcslen",35,44
17,4,77,3,17,"wcsncat@35-52@lib/libc/string/wcsncat.c","lib/libc/string/wcsncat.c","wcsncat",35,52
14,5,85,3,15,"wcsncmp@37-52@lib/libc/string/wcsncmp.c","lib/libc/string/wcsncmp.c","wcsncmp",37,52
14,4,63,3,15,"wcsncpy@35-50@lib/libc/string/wcsncpy.c","lib/libc/string/wcsncpy.c","wcsncpy",35,50
17,4,72,2,17,"wcspbrk@35-52@lib/libc/string/wcspbrk.c","lib/libc/string/wcspbrk.c","wcspbrk",35,52
14,4,59,2,14,"wcsrchr@35-49@lib/libc/string/wcsrchr.c","lib/libc/string/wcsrchr.c","wcsrchr",35,49
19,5,80,2,20,"wcsspn@35-55@lib/libc/string/wcsspn.c","lib/libc/string/wcsspn.c","wcsspn",35,55
28,7,125,2,30,"wcsstr@38-68@lib/libc/string/wcsstr.c","lib/libc/string/wcsstr.c","wcsstr",38,68
34,9,189,3,45,"wcstok@48-93@lib/libc/string/wcstok.c","lib/libc/string/wcstok.c","wcstok",48,93
14,4,64,2,15,"wcswidth@35-50@lib/libc/string/wcswidth.c","lib/libc/string/wcswidth.c","wcswidth",35,50
11,3,55,3,11,"wmemchr@35-46@lib/libc/string/wmemchr.c","lib/libc/string/wmemchr.c","wmemchr",35,46
13,4,76,3,14,"wmemcmp@36-50@lib/libc/string/wmemcmp.c","lib/libc/string/wmemcmp.c","wmemcmp",36,50
4,1,35,3,4,"wmemcpy@36-40@lib/libc/string/wmemcpy.c","lib/libc/string/wmemcpy.c","wmemcpy",36,40
4,1,35,3,4,"wmemmove@36-40@lib/libc/string/wmemmove.c","lib/libc/string/wmemmove.c","wmemmove",36,40
11,2,51,3,11,"wmemset@35-46@lib/libc/string/wmemset.c","lib/libc/string/wmemset.c","wmemset",35,46
6,2,25,1,5,"_thread_canceled@21-26@lib/libc/sys/canceled.c","lib/libc/sys/canceled.c","_thread_canceled",21,26
4,1,24,2,3,"ftruncate@44-47@lib/libc/sys/ftruncate.c","lib/libc/sys/ftruncate.c","ftruncate",44,47
4,1,29,3,3,"lseek@44-47@lib/libc/sys/lseek.c","lib/libc/sys/lseek.c","lseek",44,47
4,1,45,6,3,"mmap@45-48@lib/libc/sys/mmap.c","lib/libc/sys/mmap.c","mmap",45,48
4,1,45,6,3,"mquery@19-22@lib/libc/sys/mquery.c","lib/libc/sys/mquery.c","mquery",19,22
4,2,30,3,3,"posix_madvise@9-12@lib/libc/sys/posix_madvise.c","lib/libc/sys/posix_madvise.c","posix_madvise",9,12
4,1,34,4,3,"HIDDEN( pread)@47-50@lib/libc/sys/pread.c","lib/libc/sys/pread.c","HIDDEN( pread)",47,50
4,1,36,4,3,"HIDDEN( preadv)@47-50@lib/libc/sys/preadv.c","lib/libc/sys/preadv.c","HIDDEN( preadv)",47,50
4,2,35,3,3,"pthread_sigmask@23-26@lib/libc/sys/pthread_sigmask.c","lib/libc/sys/pthread_sigmask.c","pthread_sigmask",23,26
5,1,33,4,6,"WRAP( ptrace)@9-15@lib/libc/sys/ptrace.c","lib/libc/sys/ptrace.c","WRAP( ptrace)",9,15
4,1,35,4,3,"HIDDEN( pwrite)@46-49@lib/libc/sys/pwrite.c","lib/libc/sys/pwrite.c","HIDDEN( pwrite)",46,49
4,1,36,4,4,"HIDDEN( pwritev)@47-51@lib/libc/sys/pwritev.c","lib/libc/sys/pwritev.c","HIDDEN( pwritev)",47,51
14,6,94,4,15,"semctl@38-53@lib/libc/sys/semctl.c","lib/libc/sys/semctl.c","semctl",38,53
21,1,163,2,31,"__stack_smash_handler@51-82@lib/libc/sys/stack_protector.c","lib/libc/sys/stack_protector.c","__stack_smash_handler",51,82
5,1,24,3,4,"timer_create@13-17@lib/libc/sys/timer_create.c","lib/libc/sys/timer_create.c","timer_create",13,17
5,1,15,1,4,"timer_delete@10-14@lib/libc/sys/timer_delete.c","lib/libc/sys/timer_delete.c","timer_delete",10,14
5,1,15,1,4,"timer_getoverrun@10-14@lib/libc/sys/timer_getoverrun.c","lib/libc/sys/timer_getoverrun.c","timer_getoverrun",10,14
5,1,20,2,4,"timer_gettime@10-14@lib/libc/sys/timer_gettime.c","lib/libc/sys/timer_gettime.c","timer_gettime",10,14
6,1,29,4,5,"timer_settime@11-16@lib/libc/sys/timer_settime.c","lib/libc/sys/timer_settime.c","timer_settime",11,16
4,1,26,2,3,"truncate@45-48@lib/libc/sys/truncate.c","lib/libc/sys/truncate.c","truncate",45,48
8,1,51,3,8,"accept@22-30@lib/libc/sys/w_accept.c","lib/libc/sys/w_accept.c","accept",22,30
8,1,56,4,8,"accept4@22-30@lib/libc/sys/w_accept4.c","lib/libc/sys/w_accept4.c","accept4",22,30
8,1,35,1,8,"close@22-30@lib/libc/sys/w_close.c","lib/libc/sys/w_close.c","close",22,30
8,1,35,1,8,"closefrom@22-30@lib/libc/sys/w_closefrom.c","lib/libc/sys/w_closefrom.c","closefrom",22,30
8,1,51,3,8,"connect@22-30@lib/libc/sys/w_connect.c","lib/libc/sys/w_connect.c","connect",22,30
35,13,195,3,35,"fcntl@23-58@lib/libc/sys/w_fcntl.c","lib/libc/sys/w_fcntl.c","fcntl",23,58
35,10,195,1,43,"WRAP( fork)@39-82@lib/libc/sys/w_fork.c","lib/libc/sys/w_fork.c","WRAP( fork)",39,82
8,1,35,1,8,"fsync@22-30@lib/libc/sys/w_fsync.c","lib/libc/sys/w_fsync.c","fsync",22,30
8,1,59,5,8,"msgrcv@22-30@lib/libc/sys/w_msgrcv.c","lib/libc/sys/w_msgrcv.c","msgrcv",22,30
8,1,55,4,8,"msgsnd@22-30@lib/libc/sys/w_msgsnd.c","lib/libc/sys/w_msgsnd.c","msgsnd",22,30
8,1,46,3,8,"msync@22-30@lib/libc/sys/w_msync.c","lib/libc/sys/w_msync.c","msync",22,30
8,1,45,2,8,"nanosleep@22-30@lib/libc/sys/w_nanosleep.c","lib/libc/sys/w_nanosleep.c","nanosleep",22,30
15,2,86,3,17,"open@23-40@lib/libc/sys/w_open.c","lib/libc/sys/w_open.c","open",23,40
15,2,91,4,17,"openat@23-40@lib/libc/sys/w_openat.c","lib/libc/sys/w_openat.c","openat",23,40
8,1,50,3,8,"poll@22-30@lib/libc/sys/w_poll.c","lib/libc/sys/w_poll.c","poll",22,30
15,3,96,4,17,"ppoll@23-40@lib/libc/sys/w_ppoll.c","lib/libc/sys/w_ppoll.c","ppoll",23,40
8,1,54,4,8,"pread@22-30@lib/libc/sys/w_pread.c","lib/libc/sys/w_pread.c","pread",22,30
8,1,56,4,8,"preadv@23-31@lib/libc/sys/w_preadv.c","lib/libc/sys/w_preadv.c","preadv",23,31
16,3,107,6,18,"pselect@23-41@lib/libc/sys/w_pselect.c","lib/libc/sys/w_pselect.c","pselect",23,41
8,1,54,4,8,"pwrite@22-30@lib/libc/sys/w_pwrite.c","lib/libc/sys/w_pwrite.c","pwrite",22,30
8,1,55,4,8,"pwritev@23-31@lib/libc/sys/w_pwritev.c","lib/libc/sys/w_pwritev.c","pwritev",23,31
8,1,49,3,8,"read@22-30@lib/libc/sys/w_read.c","lib/libc/sys/w_read.c","read",22,30
8,1,51,3,8,"readv@22-30@lib/libc/sys/w_readv.c","lib/libc/sys/w_readv.c","readv",22,30
9,1,67,6,9,"recvfrom@22-31@lib/libc/sys/w_recvfrom.c","lib/libc/sys/w_recvfrom.c","recvfrom",22,31
8,1,50,3,8,"recvmsg@22-30@lib/libc/sys/w_recvmsg.c","lib/libc/sys/w_recvmsg.c","recvmsg",22,30
9,1,63,5,9,"select@22-31@lib/libc/sys/w_select.c","lib/libc/sys/w_select.c","select",22,31
8,1,50,3,8,"sendmsg@22-30@lib/libc/sys/w_sendmsg.c","lib/libc/sys/w_sendmsg.c","sendmsg",22,30
9,1,67,6,9,"sendto@22-31@lib/libc/sys/w_sendto.c","lib/libc/sys/w_sendto.c","sendto",22,31
14,4,89,3,14,"WRAP( sigaction)@26-40@lib/libc/sys/w_sigaction.c","lib/libc/sys/w_sigaction.c","WRAP( sigaction)",26,40
10,4,67,3,10,"WRAP( sigprocmask)@26-36@lib/libc/sys/w_sigprocmask.c","lib/libc/sys/w_sigprocmask.c","WRAP( sigprocmask)",26,36
14,2,69,1,16,"sigsuspend@23-39@lib/libc/sys/w_sigsuspend.c","lib/libc/sys/w_sigsuspend.c","sigsuspend",23,39
10,3,50,1,10,"WRAP( vfork)@23-33@lib/libc/sys/w_vfork.c","lib/libc/sys/w_vfork.c","WRAP( vfork)",23,33
8,1,55,4,8,"wait4@22-30@lib/libc/sys/w_wait4.c","lib/libc/sys/w_wait4.c","wait4",22,30
8,1,49,3,8,"write@22-30@lib/libc/sys/w_write.c","lib/libc/sys/w_write.c","write",22,30
8,1,50,3,8,"writev@22-30@lib/libc/sys/w_writev.c","lib/libc/sys/w_writev.c","writev",22,30
4,1,17,1,3,"cfgetispeed@34-37@lib/libc/termios/cfgetispeed.c","lib/libc/termios/cfgetispeed.c","cfgetispeed",34,37
4,1,17,1,3,"cfgetospeed@34-37@lib/libc/termios/cfgetospeed.c","lib/libc/termios/cfgetospeed.c","cfgetospeed",34,37
10,1,89,1,9,"cfmakeraw@38-47@lib/libc/termios/cfmakeraw.c","lib/libc/termios/cfmakeraw.c","cfmakeraw",38,47
5,1,23,2,4,"cfsetispeed@34-38@lib/libc/termios/cfsetispeed.c","lib/libc/termios/cfsetispeed.c","cfsetispeed",34,38
5,1,23,2,4,"cfsetospeed@34-38@lib/libc/termios/cfsetospeed.c","lib/libc/termios/cfsetospeed.c","cfsetospeed",34,38
5,1,27,2,4,"cfsetspeed@34-38@lib/libc/termios/cfsetspeed.c","lib/libc/termios/cfsetspeed.c","cfsetspeed",34,38
8,1,39,1,8,"tcdrain@37-45@lib/libc/termios/tcdrain.c","lib/libc/termios/tcdrain.c","tcdrain",37,45
23,9,141,2,24,"tcflow@37-61@lib/libc/termios/tcflow.c","lib/libc/termios/tcflow.c","tcflow",37,61
19,4,73,2,19,"tcflush@37-56@lib/libc/termios/tcflush.c","lib/libc/termios/tcflush.c","tcflush",37,56
4,1,24,2,3,"tcgetattr@35-38@lib/libc/termios/tcgetattr.c","lib/libc/termios/tcgetattr.c","tcgetattr",35,38
7,2,35,1,8,"tcgetpgrp@35-43@lib/libc/termios/tcgetpgrp.c","lib/libc/termios/tcgetpgrp.c","tcgetpgrp",35,43
7,2,35,1,8,"tcgetsid@35-43@lib/libc/termios/tcgetsid.c","lib/libc/termios/tcgetsid.c","tcgetsid",35,43
12,3,82,2,13,"tcsendbreak@36-49@lib/libc/termios/tcsendbreak.c","lib/libc/termios/tcsendbreak.c","tcsendbreak",36,49
20,5,109,3,20,"tcsetattr@36-56@lib/libc/termios/tcsetattr.c","lib/libc/termios/tcsetattr.c","tcsetattr",36,56
6,1,30,2,6,"tcsetpgrp@35-41@lib/libc/termios/tcsetpgrp.c","lib/libc/termios/tcsetpgrp.c","tcsetpgrp",35,41
15,2,107,4,16,"_thread_atfork@45-61@lib/libc/thread/atfork.c","lib/libc/thread/atfork.c","_thread_atfork",45,61
4,1,45,3,3,"pthread_atfork@70-73@lib/libc/thread/atfork.c","lib/libc/thread/atfork.c","pthread_atfork",70,73
4,1,11,1,3,"_thread_canceled@27-30@lib/libc/thread/callbacks.c","lib/libc/thread/callbacks.c","_thread_canceled",27,30
33,3,210,2,42,"_thread_set_callbacks@33-75@lib/libc/thread/callbacks.c","lib/libc/thread/callbacks.c","_thread_set_callbacks",33,75
5,2,20,1,4,"_spinlock@44-48@lib/libc/thread/rthread.c","lib/libc/thread/rthread.c","_spinlock",44,48
4,1,17,1,3,"_spinlocktry@52-55@lib/libc/thread/rthread.c","lib/libc/thread/rthread.c","_spinlocktry",52,55
4,1,14,1,3,"_spinunlock@58-61@lib/libc/thread/rthread.c","lib/libc/thread/rthread.c","_spinunlock",58,61
22,6,119,1,32,"_rthread_init@65-97@lib/libc/thread/rthread.c","lib/libc/thread/rthread.c","_rthread_init",65,97
6,2,25,1,6,"pthread_self@103-109@lib/libc/thread/rthread.c","lib/libc/thread/rthread.c","pthread_self",103,109
23,5,131,1,34,"pthread_exit@113-147@lib/libc/thread/rthread.c","lib/libc/thread/rthread.c","pthread_exit",113,147
4,1,17,2,3,"pthread_equal@151-154@lib/libc/thread/rthread.c","lib/libc/thread/rthread.c","pthread_equal",151,154
13,3,74,2,15,"pthread_cond_init@32-47@lib/libc/thread/rthread_cond.c","lib/libc/thread/rthread_cond.c","pthread_cond_init",32,47
15,3,75,1,19,"pthread_cond_destroy@51-70@lib/libc/thread/rthread_cond.c","lib/libc/thread/rthread_cond.c","pthread_cond_destroy",51,70
36,11,271,3,59,"_rthread_cond_timedwait@73-132@lib/libc/thread/rthread_cond.c","lib/libc/thread/rthread_cond.c","_rthread_cond_timedwait",73,132
15,7,97,3,17,"pthread_cond_timedwait@135-152@lib/libc/thread/rthread_cond.c","lib/libc/thread/rthread_cond.c","pthread_cond_timedwait",135,152
11,3,62,2,12,"pthread_cond_wait@155-167@lib/libc/thread/rthread_cond.c","lib/libc/thread/rthread_cond.c","pthread_cond_wait",155,167
13,2,75,1,17,"pthread_cond_signal@170-187@lib/libc/thread/rthread_cond.c","lib/libc/thread/rthread_cond.c","pthread_cond_signal",170,187
14,3,96,1,21,"pthread_cond_broadcast@190-211@lib/libc/thread/rthread_cond.c","lib/libc/thread/rthread_cond.c","pthread_cond_broadcast",190,211
10,2,50,1,11,"pthread_condattr_init@30-41@lib/libc/thread/rthread_condattr.c","lib/libc/thread/rthread_condattr.c","pthread_condattr_init",30,41
6,1,24,1,6,"pthread_condattr_destroy@44-50@lib/libc/thread/rthread_condattr.c","lib/libc/thread/rthread_condattr.c","pthread_condattr_destroy",44,50
5,1,28,2,4,"pthread_condattr_getclock@53-57@lib/libc/thread/rthread_condattr.c","lib/libc/thread/rthread_condattr.c","pthread_condattr_getclock",53,57
7,3,40,2,6,"pthread_condattr_setclock@60-66@lib/libc/thread/rthread_condattr.c","lib/libc/thread/rthread_condattr.c","pthread_condattr_setclock",60,66
9,2,46,3,8,"_rthread_debug@18-26@lib/libc/thread/rthread_debug.c","lib/libc/thread/rthread_debug.c","_rthread_debug",18,26
12,6,100,2,21,"find_lock@100-121@lib/libc/thread/rthread_file.c","lib/libc/thread/rthread_file.c","find_lock",100,121
23,6,162,2,41,"do_lock@129-170@lib/libc/thread/rthread_file.c","lib/libc/thread/rthread_file.c","do_lock",129,170
19,4,125,1,44,"_thread_flockfile@173-217@lib/libc/thread/rthread_file.c","lib/libc/thread/rthread_file.c","_thread_flockfile",173,217
18,4,105,1,46,"_thread_ftrylockfile@220-266@lib/libc/thread/rthread_file.c","lib/libc/thread/rthread_file.c","_thread_ftrylockfile",220,266
16,5,118,1,36,"_thread_funlockfile@269-305@lib/libc/thread/rthread_file.c","lib/libc/thread/rthread_file.c","_thread_funlockfile",269,305
19,5,108,1,19,"_thread_tag_init@34-53@lib/libc/thread/rthread_libc.c","lib/libc/thread/rthread_libc.c","_thread_tag_init",34,53
11,4,55,1,11,"_thread_tag_lock@59-70@lib/libc/thread/rthread_libc.c","lib/libc/thread/rthread_libc.c","_thread_tag_lock",59,70
11,4,55,1,11,"_thread_tag_unlock@76-87@lib/libc/thread/rthread_libc.c","lib/libc/thread/rthread_libc.c","_thread_tag_unlock",76,87
23,5,119,4,24,"_thread_tag_storage@95-119@lib/libc/thread/rthread_libc.c","lib/libc/thread/rthread_libc.c","_thread_tag_storage",95,119
6,2,34,1,6,"_thread_mutex_lock@122-128@lib/libc/thread/rthread_libc.c","lib/libc/thread/rthread_libc.c","_thread_mutex_lock",122,128
6,2,34,1,6,"_thread_mutex_unlock@131-137@lib/libc/thread/rthread_libc.c","lib/libc/thread/rthread_libc.c","_thread_mutex_unlock",131,137
6,2,34,1,6,"_thread_mutex_destroy@140-146@lib/libc/thread/rthread_libc.c","lib/libc/thread/rthread_libc.c","_thread_mutex_destroy",140,146
4,1,16,1,3,"_thread_malloc_lock@183-186@lib/libc/thread/rthread_libc.c","lib/libc/thread/rthread_libc.c","_thread_malloc_lock",183,186
4,1,16,1,3,"_thread_malloc_unlock@189-192@lib/libc/thread/rthread_libc.c","lib/libc/thread/rthread_libc.c","_thread_malloc_unlock",189,192
10,2,62,1,12,"_thread_malloc_reinit@195-207@lib/libc/thread/rthread_libc.c","lib/libc/thread/rthread_libc.c","_thread_malloc_reinit",195,207
4,1,12,1,3,"_thread_atexit_lock@215-218@lib/libc/thread/rthread_libc.c","lib/libc/thread/rthread_libc.c","_thread_atexit_lock",215,218
4,1,12,1,3,"_thread_atexit_unlock@221-224@lib/libc/thread/rthread_libc.c","lib/libc/thread/rthread_libc.c","_thread_atexit_unlock",221,224
4,1,12,1,3,"_thread_atfork_lock@232-235@lib/libc/thread/rthread_libc.c","lib/libc/thread/rthread_libc.c","_thread_atfork_lock",232,235
4,1,12,1,3,"_thread_atfork_unlock@238-241@lib/libc/thread/rthread_libc.c","lib/libc/thread/rthread_libc.c","_thread_atfork_unlock",238,241
4,1,12,1,3,"_thread_arc4_lock@249-252@lib/libc/thread/rthread_libc.c","lib/libc/thread/rthread_libc.c","_thread_arc4_lock",249,252
4,1,12,1,3,"_thread_arc4_unlock@255-258@lib/libc/thread/rthread_libc.c","lib/libc/thread/rthread_libc.c","_thread_arc4_unlock",255,258
18,4,91,1,21,"_thread_dofork@261-282@lib/libc/thread/rthread_libc.c","lib/libc/thread/rthread_libc.c","_thread_dofork",261,282
17,4,108,2,19,"pthread_mutex_init@50-69@lib/libc/thread/rthread_mutex.c","lib/libc/thread/rthread_mutex.c","pthread_mutex_init",50,69
16,5,86,1,20,"pthread_mutex_destroy@73-93@lib/libc/thread/rthread_mutex.c","lib/libc/thread/rthread_mutex.c","pthread_mutex_destroy",73,93
29,11,167,3,37,"_rthread_mutex_trylock@97-134@lib/libc/thread/rthread_mutex.c","lib/libc/thread/rthread_mutex.c","_rthread_mutex_trylock",97,134
48,15,315,4,69,"_rthread_mutex_timedlock@137-206@lib/libc/thread/rthread_mutex.c","lib/libc/thread/rthread_mutex.c","_rthread_mutex_timedlock",137,206
4,1,22,1,3,"pthread_mutex_trylock@209-212@lib/libc/thread/rthread_mutex.c","lib/libc/thread/rthread_mutex.c","pthread_mutex_trylock",209,212
4,1,28,2,3,"pthread_mutex_timedlock@215-218@lib/libc/thread/rthread_mutex.c","lib/libc/thread/rthread_mutex.c","pthread_mutex_timedlock",215,218
4,1,22,1,3,"pthread_mutex_lock@221-224@lib/libc/thread/rthread_mutex.c","lib/libc/thread/rthread_mutex.c","pthread_mutex_lock",221,224
41,13,234,1,58,"pthread_mutex_unlock@228-286@lib/libc/thread/rthread_mutex.c","lib/libc/thread/rthread_mutex.c","pthread_mutex_unlock",228,286
10,2,58,2,10,"pthread_once@22-32@lib/libc/thread/rthread_once.c","lib/libc/thread/rthread_once.c","pthread_once",22,32
19,4,123,2,20,"pthread_mutex_init@39-59@lib/libc/thread/rthread_sync.c","lib/libc/thread/rthread_sync.c","pthread_mutex_init",39,59
16,5,91,1,18,"pthread_mutex_destroy@63-81@lib/libc/thread/rthread_sync.c","lib/libc/thread/rthread_sync.c","pthread_mutex_destroy",63,81
64,19,424,3,81,"_rthread_mutex_lock@85-166@lib/libc/thread/rthread_sync.c","lib/libc/thread/rthread_sync.c","_rthread_mutex_lock",85,166
4,1,20,1,3,"pthread_mutex_lock@169-172@lib/libc/thread/rthread_sync.c","lib/libc/thread/rthread_sync.c","pthread_mutex_lock",169,172
4,1,20,1,3,"pthread_mutex_trylock@176-179@lib/libc/thread/rthread_sync.c","lib/libc/thread/rthread_sync.c","pthread_mutex_trylock",176,179
4,1,26,2,3,"pthread_mutex_timedlock@182-185@lib/libc/thread/rthread_sync.c","lib/libc/thread/rthread_sync.c","pthread_mutex_timedlock",182,185
34,12,203,1,49,"pthread_mutex_unlock@188-237@lib/libc/thread/rthread_sync.c","lib/libc/thread/rthread_sync.c","pthread_mutex_unlock",188,237
15,3,87,2,16,"pthread_cond_init@244-260@lib/libc/thread/rthread_sync.c","lib/libc/thread/rthread_sync.c","pthread_cond_init",244,260
15,3,74,1,18,"pthread_cond_destroy@264-282@lib/libc/thread/rthread_sync.c","lib/libc/thread/rthread_sync.c","pthread_cond_destroy",264,282
99,25,676,3,153,"pthread_cond_timedwait@285-438@lib/libc/thread/rthread_sync.c","lib/libc/thread/rthread_sync.c","pthread_cond_timedwait",285,438
87,19,601,2,133,"pthread_cond_wait@441-574@lib/libc/thread/rthread_sync.c","lib/libc/thread/rthread_sync.c","pthread_cond_wait",441,574
37,7,248,1,45,"pthread_cond_signal@578-623@lib/libc/thread/rthread_sync.c","lib/libc/thread/rthread_sync.c","pthread_cond_signal",578,623
43,6,299,1,62,"pthread_cond_broadcast@626-688@lib/libc/thread/rthread_sync.c","lib/libc/thread/rthread_sync.c","pthread_cond_broadcast",626,688
24,6,137,2,26,"pthread_key_create@41-67@lib/libc/thread/rthread_tls.c","lib/libc/thread/rthread_tls.c","pthread_key_create",41,67
25,7,138,1,28,"pthread_key_delete@71-99@lib/libc/thread/rthread_tls.c","lib/libc/thread/rthread_tls.c","pthread_key_delete",71,99
25,6,129,1,28,"_rthread_findstorage@102-130@lib/libc/thread/rthread_tls.c","lib/libc/thread/rthread_tls.c","_rthread_findstorage",102,130
10,4,51,1,12,"pthread_getspecific@133-145@lib/libc/thread/rthread_tls.c","lib/libc/thread/rthread_tls.c","pthread_getspecific",133,145
11,4,64,2,13,"pthread_setspecific@149-162@lib/libc/thread/rthread_tls.c","lib/libc/thread/rthread_tls.c","pthread_setspecific",149,162
26,6,163,1,26,"_rthread_tls_destructors@166-192@lib/libc/thread/rthread_tls.c","lib/libc/thread/rthread_tls.c","_rthread_tls_destructors",166,192
4,1,26,2,3,"_wake@23-26@lib/libc/thread/synch.h","lib/libc/thread/synch.h","_wake",23,26
5,2,35,2,4,"_wait@29-33@lib/libc/thread/synch.h","lib/libc/thread/synch.h","_wait",29,33
16,6,137,4,19,"_twait@36-55@lib/libc/thread/synch.h","lib/libc/thread/synch.h","_twait",36,55
4,1,41,4,3,"_requeue@58-61@lib/libc/thread/synch.h","lib/libc/thread/synch.h","_requeue",58,61
40,9,270,3,46,"asctime3@62-108@lib/libc/time/asctime.c","lib/libc/time/asctime.c","asctime3",62,108
4,1,24,2,7,"asctime_r@115-122@lib/libc/time/asctime.c","lib/libc/time/asctime.c","asctime_r",115,122
10,2,62,1,10,"asctime@130-140@lib/libc/time/asctime.c","lib/libc/time/asctime.c","asctime",130,140
4,1,35,2,3,"difftime@10-13@lib/libc/time/difftime.c","lib/libc/time/difftime.c","difftime",10,13
9,3,64,1,9,"detzcode@227-236@lib/libc/time/localtime.c","lib/libc/time/localtime.c","detzcode",227,236
9,3,66,1,9,"detzcode64@239-248@lib/libc/time/localtime.c","lib/libc/time/localtime.c","detzcode64",239,248
35,15,277,1,55,"settzname@251-306@lib/libc/time/localtime.c","lib/libc/time/localtime.c","settzname",251,306
6,2,34,2,5,"differ_by_repeat@309-314@lib/libc/time/localtime.c","lib/libc/time/localtime.c","differ_by_repeat",309,314
200,77,1585,3,223,"tzload@317-540@lib/libc/time/localtime.c","lib/libc/time/localtime.c","tzload",317,540
19,10,142,3,19,"typesequiv@543-562@lib/libc/time/localtime.c","lib/libc/time/localtime.c","typesequiv",543,562
8,6,51,1,8,"getzname@580-588@lib/libc/time/localtime.c","lib/libc/time/localtime.c","getzname",580,588
7,3,37,2,7,"getqzname@600-607@lib/libc/time/localtime.c","lib/libc/time/localtime.c","getqzname",600,607
18,6,112,4,18,"getnum@617-635@lib/libc/time/localtime.c","lib/libc/time/localtime.c","getnum",617,635
23,6,140,2,30,"getsecs@646-676@lib/libc/time/localtime.c","lib/libc/time/localtime.c","getsecs",646,676
15,5,77,2,15,"getoffset@686-701@lib/libc/time/localtime.c","lib/libc/time/localtime.c","getoffset",686,701
34,10,245,2,45,"getrule@711-756@lib/libc/time/localtime.c","lib/libc/time/localtime.c","getrule",711,756
43,12,306,4,83,"transtime@765-848@lib/libc/time/localtime.c","lib/libc/time/localtime.c","transtime",765,848
198,39,1244,3,232,"tzparse@856-1088@lib/libc/time/localtime.c","lib/libc/time/localtime.c","tzparse",856,1088
5,2,34,1,4,"gmtload@1091-1095@lib/libc/time/localtime.c","lib/libc/time/localtime.c","gmtload",1091,1095
16,5,74,1,16,"tzsetwall_basic@1098-1114@lib/libc/time/localtime.c","lib/libc/time/localtime.c","tzsetwall_basic",1098,1114
6,1,20,1,5,"tzsetwall@1124-1129@lib/libc/time/localtime.c","lib/libc/time/localtime.c","tzsetwall",1124,1129
34,11,225,1,39,"tzset_basic@1132-1171@lib/libc/time/localtime.c","lib/libc/time/localtime.c","tzset_basic",1132,1171
6,1,20,1,5,"tzset@1174-1179@lib/libc/time/localtime.c","lib/libc/time/localtime.c","tzset",1174,1179
77,22,512,3,89,"localsub@1192-1281@lib/libc/time/localtime.c","lib/libc/time/localtime.c","localsub",1192,1281
8,1,42,2,7,"localtime_r@1288-1295@lib/libc/time/localtime.c","lib/libc/time/localtime.c","localtime_r",1288,1295
8,2,50,1,8,"localtime@1299-1307@lib/libc/time/localtime.c","lib/libc/time/localtime.c","localtime",1299,1307
22,6,123,3,29,"gmtsub@1315-1344@lib/libc/time/localtime.c","lib/libc/time/localtime.c","gmtsub",1315,1344
4,1,24,2,3,"gmtime_r@1351-1354@lib/libc/time/localtime.c","lib/libc/time/localtime.c","gmtime_r",1351,1354
8,2,50,1,9,"gmtime@1358-1367@lib/libc/time/localtime.c","lib/libc/time/localtime.c","gmtime",1358,1367
4,1,23,2,3,"offtime@1373-1376@lib/libc/time/localtime.c","lib/libc/time/localtime.c","offtime",1373,1376
5,2,43,1,4,"leaps_thru_end_of@1386-1390@lib/libc/time/localtime.c","lib/libc/time/localtime.c","leaps_thru_end_of",1386,1390
107,28,711,4,122,"timesub@1393-1515@lib/libc/time/localtime.c","lib/libc/time/localtime.c","timesub",1393,1515
4,1,18,1,9,"ctime@1518-1527@lib/libc/time/localtime.c","lib/libc/time/localtime.c","ctime",1518,1527
5,1,31,2,5,"ctime_r@1530-1535@lib/libc/time/localtime.c","lib/libc/time/localtime.c","ctime_r",1530,1535
8,3,53,2,14,"increment_overflow@1555-1569@lib/libc/time/localtime.c","lib/libc/time/localtime.c","increment_overflow",1555,1569
8,3,53,2,8,"long_increment_overflow@1572-1580@lib/libc/time/localtime.c","lib/libc/time/localtime.c","long_increment_overflow",1572,1580
9,2,64,3,9,"normalize_overflow@1583-1592@lib/libc/time/localtime.c","lib/libc/time/localtime.c","normalize_overflow",1583,1592
9,2,64,3,9,"long_normalize_overflow@1595-1604@lib/libc/time/localtime.c","lib/libc/time/localtime.c","long_normalize_overflow",1595,1604
11,2,114,2,11,"tmcomp@1607-1618@lib/libc/time/localtime.c","lib/libc/time/localtime.c","tmcomp",1607,1618
138,47,913,5,167,"time2sub@1621-1788@lib/libc/time/localtime.c","lib/libc/time/localtime.c","time2sub",1621,1788
7,2,72,4,12,"time2@1791-1803@lib/libc/time/localtime.c","lib/libc/time/localtime.c","time2",1791,1803
58,18,426,3,71,"time1@1806-1877@lib/libc/time/localtime.c","lib/libc/time/localtime.c","time1",1806,1877
9,1,40,1,9,"mktime@1880-1889@lib/libc/time/localtime.c","lib/libc/time/localtime.c","mktime",1880,1889
6,2,28,1,5,"timelocal@1895-1900@lib/libc/time/localtime.c","lib/libc/time/localtime.c","timelocal",1895,1900
6,2,31,1,5,"timegm@1903-1908@lib/libc/time/localtime.c","lib/libc/time/localtime.c","timegm",1903,1908
6,2,34,2,5,"timeoff@1911-1916@lib/libc/time/localtime.c","lib/libc/time/localtime.c","timeoff",1911,1916
14,3,67,1,14,"leapcorr@1935-1949@lib/libc/time/localtime.c","lib/libc/time/localtime.c","leapcorr",1935,1949
5,1,20,1,4,"time2posix@1952-1956@lib/libc/time/localtime.c","lib/libc/time/localtime.c","time2posix",1952,1956
24,7,125,1,30,"posix2time@1959-1989@lib/libc/time/localtime.c","lib/libc/time/localtime.c","posix2time",1959,1989
16,5,112,4,18,"strftime@121-139@lib/libc/time/strftime.c","lib/libc/time/strftime.c","strftime",121,139
278,90,1561,5,402,"_fmt@143-545@lib/libc/time/strftime.c","lib/libc/time/strftime.c","_fmt",143,545
6,1,57,4,6,"_conv@548-554@lib/libc/time/strftime.c","lib/libc/time/strftime.c","_conv",548,554
6,2,41,3,5,"_add@557-562@lib/libc/time/strftime.c","lib/libc/time/strftime.c","_add",557,562
23,10,171,6,24,"_yconv@573-597@lib/libc/time/strftime.c","lib/libc/time/strftime.c","_yconv",573,597
98,24,584,1,127,"_loc@601-728@lib/libc/time/strftime.c","lib/libc/time/strftime.c","_loc",601,728
5,1,43,5,4,"strftime_l@10-14@lib/libc/time/strftime_l.c","lib/libc/time/strftime_l.c","strftime_l",10,14
4,1,33,3,3,"strptime@82-85@lib/libc/time/strptime.c","lib/libc/time/strptime.c","strptime",82,85
394,149,2456,4,548,"_strptime@89-637@lib/libc/time/strptime.c","lib/libc/time/strptime.c","_strptime",89,637
16,9,117,4,20,"_conv_num@641-661@lib/libc/time/strptime.c","lib/libc/time/strptime.c","_conv_num",641,661
16,4,114,5,19,"_find_string@664-683@lib/libc/time/strptime.c","lib/libc/time/strptime.c","_find_string",664,683
5,2,44,1,4,"leaps_thru_end_of@686-690@lib/libc/time/strptime.c","lib/libc/time/strptime.c","leaps_thru_end_of",686,690
16,4,108,4,16,"wcsftime@119-135@lib/libc/time/wcsftime.c","lib/libc/time/wcsftime.c","wcsftime",119,135
265,83,1571,5,351,"_fmt@138-489@lib/libc/time/wcsftime.c","lib/libc/time/wcsftime.c","_fmt",138,489
6,1,63,4,6,"_conv@492-498@lib/libc/time/wcsftime.c","lib/libc/time/wcsftime.c","_conv",492,498
6,2,42,3,5,"_add@501-506@lib/libc/time/wcsftime.c","lib/libc/time/wcsftime.c","_add",501,506
6,2,45,3,5,"_sadd@509-514@lib/libc/time/wcsftime.c","lib/libc/time/wcsftime.c","_sadd",509,514
24,10,174,6,25,"_yconv@524-549@lib/libc/time/wcsftime.c","lib/libc/time/wcsftime.c","_yconv",524,549
21,9,176,3,26,"uuid_compare@51-77@lib/libc/uuid/uuid_compare.c","lib/libc/uuid/uuid_compare.c","uuid_compare",51,77
12,2,97,2,14,"uuid_create@45-59@lib/libc/uuid/uuid_create.c","lib/libc/uuid/uuid_create.c","uuid_create",45,59
6,2,34,2,6,"uuid_create_nil@42-48@lib/libc/uuid/uuid_create_nil.c","lib/libc/uuid/uuid_create_nil.c","uuid_create_nil",42,48
12,6,93,3,15,"uuid_equal@42-57@lib/libc/uuid/uuid_equal.c","lib/libc/uuid/uuid_equal.c","uuid_equal",42,57
31,12,224,3,48,"uuid_from_string@47-95@lib/libc/uuid/uuid_from_string.c","lib/libc/uuid/uuid_from_string.c","uuid_from_string",47,95
6,3,37,2,10,"uuid_hash@41-51@lib/libc/uuid/uuid_hash.c","lib/libc/uuid/uuid_hash.c","uuid_hash",41,51
9,4,66,2,11,"uuid_is_nil@42-53@lib/libc/uuid/uuid_is_nil.c","lib/libc/uuid/uuid_is_nil.c","uuid_is_nil",42,53
5,1,39,1,5,"be16dec@84-89@lib/libc/uuid/uuid_stream.c","lib/libc/uuid/uuid_stream.c","be16dec",84,89
5,1,62,1,5,"be32dec@92-97@lib/libc/uuid/uuid_stream.c","lib/libc/uuid/uuid_stream.c","be32dec",92,97
5,1,39,1,5,"le16dec@100-105@lib/libc/uuid/uuid_stream.c","lib/libc/uuid/uuid_stream.c","le16dec",100,105
5,1,62,1,5,"le32dec@108-113@lib/libc/uuid/uuid_stream.c","lib/libc/uuid/uuid_stream.c","le32dec",108,113
6,1,44,2,6,"be16enc@116-122@lib/libc/uuid/uuid_stream.c","lib/libc/uuid/uuid_stream.c","be16enc",116,122
8,1,72,2,8,"be32enc@125-133@lib/libc/uuid/uuid_stream.c","lib/libc/uuid/uuid_stream.c","be32enc",125,133
6,1,44,2,6,"le16enc@136-142@lib/libc/uuid/uuid_stream.c","lib/libc/uuid/uuid_stream.c","le16enc",136,142
8,1,72,2,8,"le32enc@145-153@lib/libc/uuid/uuid_stream.c","lib/libc/uuid/uuid_stream.c","le32enc",145,153
12,2,98,2,12,"uuid_enc_le@156-168@lib/libc/uuid/uuid_stream.c","lib/libc/uuid/uuid_stream.c","uuid_enc_le",156,168
12,2,99,2,12,"uuid_dec_le@171-183@lib/libc/uuid/uuid_stream.c","lib/libc/uuid/uuid_stream.c","uuid_dec_le",171,183
12,2,98,2,12,"uuid_enc_be@186-198@lib/libc/uuid/uuid_stream.c","lib/libc/uuid/uuid_stream.c","uuid_enc_be",186,198
12,2,99,2,12,"uuid_dec_be@201-213@lib/libc/uuid/uuid_stream.c","lib/libc/uuid/uuid_stream.c","uuid_dec_be",201,213
17,6,149,3,22,"uuid_to_string@47-69@lib/libc/uuid/uuid_to_string.c","lib/libc/uuid/uuid_to_string.c","uuid_to_string",47,69
12,5,56,1,14,"_yp_check@37-51@lib/libc/yp/_yp_check.c","lib/libc/yp/_yp_check.c","_yp_check",37,51
4,1,22,2,3,"xdr_domainname@34-37@lib/libc/yp/xdr_domainname.c","lib/libc/yp/xdr_domainname.c","xdr_domainname",34,37
5,1,38,2,4,"xdr_keydat@34-38@lib/libc/yp/xdr_keydat.c","lib/libc/yp/xdr_keydat.c","xdr_keydat",34,38
4,1,22,2,3,"xdr_mapname@34-37@lib/libc/yp/xdr_mapname.c","lib/libc/yp/xdr_mapname.c","xdr_mapname",34,37
4,1,22,2,3,"xdr_peername@34-37@lib/libc/yp/xdr_peername.c","lib/libc/yp/xdr_peername.c","xdr_peername",34,37
5,1,38,2,4,"xdr_valdat@34-38@lib/libc/yp/xdr_valdat.c","lib/libc/yp/xdr_valdat.c","xdr_valdat",34,38
7,2,46,2,6,"xdr_ypbind_binding@34-40@lib/libc/yp/xdr_ypbind_binding.c","lib/libc/yp/xdr_ypbind_binding.c","xdr_ypbind_binding",34,40
16,4,80,2,17,"xdr_ypbind_resp@34-51@lib/libc/yp/xdr_ypbind_resp.c","lib/libc/yp/xdr_ypbind_resp.c","xdr_ypbind_resp",34,51
4,1,25,2,3,"xdr_ypbind_resptype@34-37@lib/libc/yp/xdr_ypbind_resptype.c","lib/libc/yp/xdr_ypbind_resptype.c","xdr_ypbind_resptype",34,37
10,3,68,2,9,"xdr_ypbind_setdom@34-43@lib/libc/yp/xdr_ypbind_setdom.c","lib/libc/yp/xdr_ypbind_setdom.c","xdr_ypbind_setdom",34,43
8,2,58,2,7,"xdr_ypmaplist@34-41@lib/libc/yp/xdr_ypmaplist.c","lib/libc/yp/xdr_ypmaplist.c","xdr_ypmaplist",34,41
10,3,68,2,9,"xdr_ypreq_key@34-43@lib/libc/yp/xdr_ypreq_key.c","lib/libc/yp/xdr_ypreq_key.c","xdr_ypreq_key",34,43
7,2,50,2,6,"xdr_ypreq_nokey@34-40@lib/libc/yp/xdr_ypreq_nokey.c","lib/libc/yp/xdr_ypreq_nokey.c","xdr_ypreq_nokey",34,40
14,4,68,2,14,"xdr_ypresp_all@34-48@lib/libc/yp/xdr_ypresp_all.c","lib/libc/yp/xdr_ypresp_all.c","xdr_ypresp_all",34,48
10,3,64,2,9,"xdr_ypresp_key_val@34-43@lib/libc/yp/xdr_ypresp_key_val.c","lib/libc/yp/xdr_ypresp_key_val.c","xdr_ypresp_key_val",34,43
8,2,58,2,7,"xdr_ypresp_maplist@34-41@lib/libc/yp/xdr_ypresp_maplist.c","lib/libc/yp/xdr_ypresp_maplist.c","xdr_ypresp_maplist",34,41
7,2,50,2,6,"xdr_ypresp_master@34-40@lib/libc/yp/xdr_ypresp_master.c","lib/libc/yp/xdr_ypresp_master.c","xdr_ypresp_master",34,40
7,2,50,2,6,"xdr_ypresp_order@34-40@lib/libc/yp/xdr_ypresp_order.c","lib/libc/yp/xdr_ypresp_order.c","xdr_ypresp_order",34,40
7,2,46,2,6,"xdr_ypresp_val@34-40@lib/libc/yp/xdr_ypresp_val.c","lib/libc/yp/xdr_ypresp_val.c","xdr_ypresp_val",34,40
4,1,24,2,3,"xdr_ypstat@34-37@lib/libc/yp/xdr_ypstat.c","lib/libc/yp/xdr_ypstat.c","xdr_ypstat",34,37
51,9,338,2,53,"_xdr_ypresp_all_seq@43-96@lib/libc/yp/yp_all.c","lib/libc/yp/yp_all.c","_xdr_ypresp_all_seq",43,96
40,11,260,3,43,"yp_all@99-142@lib/libc/yp/yp_all.c","lib/libc/yp/yp_all.c","yp_all",99,142
167,42,1082,2,199,"_yp_dobind@51-250@lib/libc/yp/yp_bind.c","lib/libc/yp/yp_bind.c","_yp_dobind",51,250
6,1,29,1,5,"_yp_unbind@253-258@lib/libc/yp/yp_bind.c","lib/libc/yp/yp_bind.c","_yp_unbind",253,258
4,1,17,1,3,"yp_bind@261-264@lib/libc/yp/yp_bind.c","lib/libc/yp/yp_bind.c","yp_bind",261,264
17,4,89,1,17,"yp_unbind@268-285@lib/libc/yp/yp_bind.c","lib/libc/yp/yp_bind.c","yp_unbind",268,285
48,13,384,6,53,"yp_first@39-92@lib/libc/yp/yp_first.c","lib/libc/yp/yp_first.c","yp_first",39,92
11,4,55,1,10,"yp_get_default_domain@38-48@lib/libc/yp/yp_get_default_domain.c","lib/libc/yp/yp_get_default_domain.c","yp_get_default_domain",38,48
24,4,149,2,28,"yp_maplist@38-66@lib/libc/yp/yp_maplist.c","lib/libc/yp/yp_maplist.c","yp_maplist",38,66
35,13,257,3,40,"yp_master@38-78@lib/libc/yp/yp_master.c","lib/libc/yp/yp_master.c","yp_master",38,78
37,11,247,3,46,"yp_order@38-84@lib/libc/yp/yp_order.c","lib/libc/yp/yp_order.c","yp_order",38,84
42,18,142,1,42,"yperr_string@36-78@lib/libc/yp/yperr_string.c","lib/libc/yp/yperr_string.c","yperr_string",36,78
17,4,101,2,19,"__ypexclude_add@36-55@lib/libc/yp/ypexclude.c","lib/libc/yp/ypexclude.c","__ypexclude_add",36,55
9,3,59,2,9,"__ypexclude_is@58-67@lib/libc/yp/ypexclude.c","lib/libc/yp/ypexclude.c","__ypexclude_is",58,67
10,2,59,1,10,"__ypexclude_free@70-80@lib/libc/yp/ypexclude.c","lib/libc/yp/ypexclude.c","__ypexclude_free",70,80
43,10,288,5,52,"ypmatch_add@53-105@lib/libc/yp/ypmatch_cache.c","lib/libc/yp/ypmatch_cache.c","ypmatch_add",53,105
23,7,135,5,26,"ypmatch_find@108-134@lib/libc/yp/ypmatch_cache.c","lib/libc/yp/ypmatch_cache.c","ypmatch_find",108,134
62,21,487,6,73,"yp_match@138-211@lib/libc/yp/ypmatch_cache.c","lib/libc/yp/ypmatch_cache.c","yp_match",138,211
51,15,420,8,56,"yp_next@215-271@lib/libc/yp/ypmatch_cache.c","lib/libc/yp/ypmatch_cache.c","yp_next",215,271
28,12,86,1,27,"ypprot_err@35-62@lib/libc/yp/ypprot_err.c","lib/libc/yp/ypprot_err.c","ypprot_err",35,62
3,2,20,2,2,"__aeabi_cdcmpeq_check_nan@14-16@lib/libcompiler_rt/arm/aeabi_cdcmpeq_check_nan.c","lib/libcompiler_rt/arm/aeabi_cdcmpeq_check_nan.c","__aeabi_cdcmpeq_check_nan",14,16
3,2,20,2,2,"__aeabi_cfcmpeq_check_nan@14-16@lib/libcompiler_rt/arm/aeabi_cfcmpeq_check_nan.c","lib/libcompiler_rt/arm/aeabi_cfcmpeq_check_nan.c","__aeabi_cfcmpeq_check_nan",14,16
3,1,9,1,2,"__aeabi_idiv0@34-36@lib/libcompiler_rt/arm/aeabi_div0.c","lib/libcompiler_rt/arm/aeabi_div0.c","__aeabi_idiv0",34,36
3,1,10,1,2,"__aeabi_ldiv0@39-41@lib/libcompiler_rt/arm/aeabi_div0.c","lib/libcompiler_rt/arm/aeabi_div0.c","__aeabi_ldiv0",39,41
3,1,18,2,2,"__aeabi_drsub@17-19@lib/libcompiler_rt/arm/aeabi_drsub.c","lib/libcompiler_rt/arm/aeabi_drsub.c","__aeabi_drsub",17,19
3,1,18,2,2,"__aeabi_frsub@17-19@lib/libcompiler_rt/arm/aeabi_frsub.c","lib/libcompiler_rt/arm/aeabi_frsub.c","__aeabi_frsub",17,19
5,1,31,1,4,"local_fabs@22-26@lib/libcompiler_rt/ppc/DD.h","lib/libcompiler_rt/ppc/DD.h","local_fabs",22,26
5,1,31,1,4,"high26bits@28-32@lib/libcompiler_rt/ppc/DD.h","lib/libcompiler_rt/ppc/DD.h","high26bits",28,32
5,1,59,2,4,"different_sign@34-38@lib/libcompiler_rt/ppc/DD.h","lib/libcompiler_rt/ppc/DD.h","different_sign",34,38
62,15,815,4,73,"__divtc3@18-91@lib/libcompiler_rt/ppc/divtc3.c","lib/libcompiler_rt/ppc/divtc3.c","__divtc3",18,91
50,7,430,1,92,"__fixtfdi@12-104@lib/libcompiler_rt/ppc/fixtfdi.c","lib/libcompiler_rt/ppc/fixtfdi.c","__fixtfdi",12,104
30,4,248,1,49,"__fixunstfdi@10-59@lib/libcompiler_rt/ppc/fixunstfdi.c","lib/libcompiler_rt/ppc/fixunstfdi.c","__fixunstfdi",10,59
11,1,109,1,26,"__floatditf@10-36@lib/libcompiler_rt/ppc/floatditf.c","lib/libcompiler_rt/ppc/floatditf.c","__floatditf",10,36
14,1,124,1,31,"__floatunditf@10-41@lib/libcompiler_rt/ppc/floatunditf.c","lib/libcompiler_rt/ppc/floatunditf.c","__floatunditf",10,41
49,8,470,2,64,"__gcc_qadd@12-76@lib/libcompiler_rt/ppc/gcc_qadd.c","lib/libcompiler_rt/ppc/gcc_qadd.c","__gcc_qadd",12,76
33,3,292,2,43,"__gcc_qdiv@12-55@lib/libcompiler_rt/ppc/gcc_qdiv.c","lib/libcompiler_rt/ppc/gcc_qdiv.c","__gcc_qdiv",12,55
31,3,272,2,41,"__gcc_qmul@12-53@lib/libcompiler_rt/ppc/gcc_qmul.c","lib/libcompiler_rt/ppc/gcc_qmul.c","__gcc_qmul",12,53
49,8,472,2,64,"__gcc_qsub@12-76@lib/libcompiler_rt/ppc/gcc_qsub.c","lib/libcompiler_rt/ppc/gcc_qsub.c","__gcc_qsub",12,76
60,13,480,4,69,"__multc3@21-90@lib/libcompiler_rt/ppc/multc3.c","lib/libcompiler_rt/ppc/multc3.c","__multc3",21,90
4,1,13,1,3,"__floatdidf@11-14@lib/libcompiler_rt/x86_64/floatdidf.c","lib/libcompiler_rt/x86_64/floatdidf.c","__floatdidf",11,14
4,1,13,1,3,"__floatdisf@9-12@lib/libcompiler_rt/x86_64/floatdisf.c","lib/libcompiler_rt/x86_64/floatdisf.c","__floatdisf",9,12
4,1,14,1,3,"__floatdixf@11-14@lib/libcompiler_rt/x86_64/floatdixf.c","lib/libcompiler_rt/x86_64/floatdixf.c","__floatdixf",11,14
8,2,67,1,7,"__absvdi2@22-29@lib/libcompiler_rt/absvdi2.c","lib/libcompiler_rt/absvdi2.c","__absvdi2",22,29
8,2,64,1,7,"__absvsi2@22-29@lib/libcompiler_rt/absvsi2.c","lib/libcompiler_rt/absvsi2.c","__absvsi2",22,29
8,2,67,1,7,"__absvti2@24-31@lib/libcompiler_rt/absvti2.c","lib/libcompiler_rt/absvti2.c","__absvti2",24,31
3,1,17,2,2,"__adddf3@20-22@lib/libcompiler_rt/adddf3.c","lib/libcompiler_rt/adddf3.c","__adddf3",20,22
3,1,17,2,2,"__addsf3@20-22@lib/libcompiler_rt/addsf3.c","lib/libcompiler_rt/addsf3.c","__addsf3",20,22
3,1,20,2,2,"__addtf3@21-23@lib/libcompiler_rt/addtf3.c","lib/libcompiler_rt/addtf3.c","__addtf3",21,23
15,4,57,2,14,"__addvdi3@22-36@lib/libcompiler_rt/addvdi3.c","lib/libcompiler_rt/addvdi3.c","__addvdi3",22,36
15,4,57,2,14,"__addvsi3@22-36@lib/libcompiler_rt/addvsi3.c","lib/libcompiler_rt/addvsi3.c","__addvsi3",22,36
15,4,57,2,14,"__addvti3@24-38@lib/libcompiler_rt/addvti3.c","lib/libcompiler_rt/addvti3.c","__addvti3",24,38
20,3,136,2,19,"__ashldi3@24-43@lib/libcompiler_rt/ashldi3.c","lib/libcompiler_rt/ashldi3.c","__ashldi3",24,43
20,3,137,2,19,"__ashlti3@24-43@lib/libcompiler_rt/ashlti3.c","lib/libcompiler_rt/ashlti3.c","__ashlti3",24,43
20,3,147,2,20,"__ashrdi3@24-44@lib/libcompiler_rt/ashrdi3.c","lib/libcompiler_rt/ashrdi3.c","__ashrdi3",24,44
20,3,148,2,20,"__ashrti3@24-44@lib/libcompiler_rt/ashrti3.c","lib/libcompiler_rt/ashrti3.c","__ashrti3",24,44
6,2,51,1,5,"unlock@59-64@lib/libcompiler_rt/atomic.c","lib/libcompiler_rt/atomic.c","unlock",59,64
8,2,59,1,7,"lock@65-72@lib/libcompiler_rt/atomic.c","lib/libcompiler_rt/atomic.c","lock",65,72
3,1,13,1,2,"unlock@79-81@lib/libcompiler_rt/atomic.c","lib/libcompiler_rt/atomic.c","unlock",79,81
3,1,13,1,2,"lock@84-86@lib/libcompiler_rt/atomic.c","lib/libcompiler_rt/atomic.c","lock",84,86
3,1,16,1,2,"unlock@92-94@lib/libcompiler_rt/atomic.c","lib/libcompiler_rt/atomic.c","unlock",92,94
6,2,34,1,5,"lock@97-102@lib/libcompiler_rt/atomic.c","lib/libcompiler_rt/atomic.c","lock",97,102
8,1,46,1,14,"lock_for_pointer@109-123@lib/libcompiler_rt/atomic.c","lib/libcompiler_rt/atomic.c","lock_for_pointer",109,123
7,1,49,4,10,"__atomic_load_c@162-172@lib/libcompiler_rt/atomic.c","lib/libcompiler_rt/atomic.c","__atomic_load_c",162,172
7,1,50,4,10,"__atomic_store_c@176-186@lib/libcompiler_rt/atomic.c","lib/libcompiler_rt/atomic.c","__atomic_store_c",176,186
14,2,92,6,17,"__atomic_compare_exchange_c@193-210@lib/libcompiler_rt/atomic.c","lib/libcompiler_rt/atomic.c","__atomic_compare_exchange_c",193,210
8,1,63,5,12,"__atomic_exchange_c@214-226@lib/libcompiler_rt/atomic.c","lib/libcompiler_rt/atomic.c","__atomic_exchange_c",214,226
3,1,23,1,2,"atomic_flag_clear@23-25@lib/libcompiler_rt/atomic_flag_clear.c","lib/libcompiler_rt/atomic_flag_clear.c","atomic_flag_clear",23,25
4,1,26,2,3,"atomic_flag_clear_explicit@23-26@lib/libcompiler_rt/atomic_flag_clear_explicit.c","lib/libcompiler_rt/atomic_flag_clear_explicit.c","atomic_flag_clear_explicit",23,26
3,1,24,1,2,"atomic_flag_test_and_set@23-25@lib/libcompiler_rt/atomic_flag_test_and_set.c","lib/libcompiler_rt/atomic_flag_test_and_set.c","atomic_flag_test_and_set",23,25
4,1,27,2,3,"atomic_flag_test_and_set_explicit@23-26@lib/libcompiler_rt/atomic_flag_test_and_set_explicit.c","lib/libcompiler_rt/atomic_flag_test_and_set_explicit.c","atomic_flag_test_and_set_explicit",23,26
3,1,12,1,2,"atomic_signal_fence@23-25@lib/libcompiler_rt/atomic_signal_fence.c","lib/libcompiler_rt/atomic_signal_fence.c","atomic_signal_fence",23,25
3,1,12,1,2,"atomic_thread_fence@23-25@lib/libcompiler_rt/atomic_thread_fence.c","lib/libcompiler_rt/atomic_thread_fence.c","atomic_thread_fence",23,25
30,1,65,2,38,"clear_mips_cache@43-81@lib/libcompiler_rt/clear_cache.c","lib/libcompiler_rt/clear_cache.c","clear_mips_cache",43,81
41,14,376,2,73,"__clear_cache@96-169@lib/libcompiler_rt/clear_cache.c","lib/libcompiler_rt/clear_cache.c","__clear_cache",96,169
8,1,73,1,7,"__clzdi2@22-29@lib/libcompiler_rt/clzdi2.c","lib/libcompiler_rt/clzdi2.c","__clzdi2",22,29
17,1,143,1,31,"__clzsi2@22-53@lib/libcompiler_rt/clzsi2.c","lib/libcompiler_rt/clzsi2.c","__clzsi2",22,53
8,1,76,1,7,"__clzti2@24-31@lib/libcompiler_rt/clzti2.c","lib/libcompiler_rt/clzti2.c","__clzti2",24,31
16,5,99,2,15,"__cmpdi2@23-38@lib/libcompiler_rt/cmpdi2.c","lib/libcompiler_rt/cmpdi2.c","__cmpdi2",23,38
4,1,20,2,3,"__aeabi_lcmp@46-49@lib/libcompiler_rt/cmpdi2.c","lib/libcompiler_rt/cmpdi2.c","__aeabi_lcmp",46,49
16,5,99,2,15,"__cmpti2@25-40@lib/libcompiler_rt/cmpti2.c","lib/libcompiler_rt/cmpti2.c","__cmpti2",25,40
18,9,131,2,30,"__ledf2@51-81@lib/libcompiler_rt/comparedf2.c","lib/libcompiler_rt/comparedf2.c","__ledf2",51,81
17,9,131,2,18,"__gedf2@96-114@lib/libcompiler_rt/comparedf2.c","lib/libcompiler_rt/comparedf2.c","__gedf2",96,114
5,2,40,2,4,"__unorddf2@119-123@lib/libcompiler_rt/comparedf2.c","lib/libcompiler_rt/comparedf2.c","__unorddf2",119,123
3,1,18,2,2,"__eqdf2@128-130@lib/libcompiler_rt/comparedf2.c","lib/libcompiler_rt/comparedf2.c","__eqdf2",128,130
3,1,18,2,2,"__ltdf2@133-135@lib/libcompiler_rt/comparedf2.c","lib/libcompiler_rt/comparedf2.c","__ltdf2",133,135
3,1,18,2,2,"__nedf2@138-140@lib/libcompiler_rt/comparedf2.c","lib/libcompiler_rt/comparedf2.c","__nedf2",138,140
3,1,18,2,2,"__gtdf2@143-145@lib/libcompiler_rt/comparedf2.c","lib/libcompiler_rt/comparedf2.c","__gtdf2",143,145
18,9,131,2,30,"__lesf2@51-81@lib/libcompiler_rt/comparesf2.c","lib/libcompiler_rt/comparesf2.c","__lesf2",51,81
17,9,131,2,18,"__gesf2@96-114@lib/libcompiler_rt/comparesf2.c","lib/libcompiler_rt/comparesf2.c","__gesf2",96,114
5,2,40,2,4,"__unordsf2@119-123@lib/libcompiler_rt/comparesf2.c","lib/libcompiler_rt/comparesf2.c","__unordsf2",119,123
3,1,18,2,2,"__eqsf2@128-130@lib/libcompiler_rt/comparesf2.c","lib/libcompiler_rt/comparesf2.c","__eqsf2",128,130
3,1,18,2,2,"__ltsf2@133-135@lib/libcompiler_rt/comparesf2.c","lib/libcompiler_rt/comparesf2.c","__ltsf2",133,135
3,1,18,2,2,"__nesf2@138-140@lib/libcompiler_rt/comparesf2.c","lib/libcompiler_rt/comparesf2.c","__nesf2",138,140
3,1,18,2,2,"__gtsf2@143-145@lib/libcompiler_rt/comparesf2.c","lib/libcompiler_rt/comparesf2.c","__gtsf2",143,145
18,9,131,2,29,"__letf2@51-80@lib/libcompiler_rt/comparetf2.c","lib/libcompiler_rt/comparetf2.c","__letf2",51,80
17,9,131,2,18,"__getf2@94-112@lib/libcompiler_rt/comparetf2.c","lib/libcompiler_rt/comparetf2.c","__getf2",94,112
5,2,41,2,4,"__unordtf2@114-118@lib/libcompiler_rt/comparetf2.c","lib/libcompiler_rt/comparetf2.c","__unordtf2",114,118
3,1,18,2,2,"__eqtf2@122-124@lib/libcompiler_rt/comparetf2.c","lib/libcompiler_rt/comparetf2.c","__eqtf2",122,124
3,1,18,2,2,"__lttf2@126-128@lib/libcompiler_rt/comparetf2.c","lib/libcompiler_rt/comparetf2.c","__lttf2",126,128
3,1,18,2,2,"__netf2@130-132@lib/libcompiler_rt/comparetf2.c","lib/libcompiler_rt/comparetf2.c","__netf2",130,132
3,1,18,2,2,"__gttf2@134-136@lib/libcompiler_rt/comparetf2.c","lib/libcompiler_rt/comparetf2.c","__gttf2",134,136
23,4,49,0,26,"isCpuIdSupported@130-156@lib/libcompiler_rt/cpu_model.c","lib/libcompiler_rt/cpu_model.c","isCpuIdSupported",130,156
21,7,154,5,32,"getX86CpuIDAndInfo@163-195@lib/libcompiler_rt/cpu_model.c","lib/libcompiler_rt/cpu_model.c","getX86CpuIDAndInfo",163,195
36,10,236,6,49,"getX86CpuIDAndInfoEx@200-249@lib/libcompiler_rt/cpu_model.c","lib/libcompiler_rt/cpu_model.c","getX86CpuIDAndInfoEx",200,249
9,3,66,2,15,"getX86XCR0@252-267@lib/libcompiler_rt/cpu_model.c","lib/libcompiler_rt/cpu_model.c","getX86XCR0",252,267
10,4,89,3,11,"detectX86FamilyModel@269-280@lib/libcompiler_rt/cpu_model.c","lib/libcompiler_rt/cpu_model.c","detectX86FamilyModel",269,280
229,90,907,6,282,"getIntelProcessorTypeAndSubtype@282-564@lib/libcompiler_rt/cpu_model.c","lib/libcompiler_rt/cpu_model.c","getIntelProcessorTypeAndSubtype",282,564
117,35,429,5,119,"getAMDProcessorTypeAndSubtype@566-685@lib/libcompiler_rt/cpu_model.c","lib/libcompiler_rt/cpu_model.c","getAMDProcessorTypeAndSubtype",566,685
30,9,392,3,34,"getAvailableFeatures@687-721@lib/libcompiler_rt/cpu_model.c","lib/libcompiler_rt/cpu_model.c","getAvailableFeatures",687,721
37,6,262,1,49,"__cpu_indicator_init@746-795@lib/libcompiler_rt/cpu_model.c","lib/libcompiler_rt/cpu_model.c","__cpu_indicator_init",746,795
8,1,73,1,7,"__ctzdi2@22-29@lib/libcompiler_rt/ctzdi2.c","lib/libcompiler_rt/ctzdi2.c","__ctzdi2",22,29
18,1,144,1,35,"__ctzsi2@22-57@lib/libcompiler_rt/ctzsi2.c","lib/libcompiler_rt/ctzsi2.c","__ctzsi2",22,57
8,1,76,1,7,"__ctzti2@24-31@lib/libcompiler_rt/ctzti2.c","lib/libcompiler_rt/ctzti2.c","__ctzti2",24,31
40,19,418,4,39,"__divdc3@21-60@lib/libcompiler_rt/divdc3.c","lib/libcompiler_rt/divdc3.c","__divdc3",21,60
71,16,628,2,160,"__divdf3@25-185@lib/libcompiler_rt/divdf3.c","lib/libcompiler_rt/divdf3.c","__divdf3",25,185
10,1,88,2,9,"__divdi3@20-29@lib/libcompiler_rt/divdi3.c","lib/libcompiler_rt/divdi3.c","__divdi3",20,29
6,1,38,3,5,"__divmoddi4@20-25@lib/libcompiler_rt/divmoddi4.c","lib/libcompiler_rt/divmoddi4.c","__divmoddi4",20,25
6,1,38,3,5,"__divmodsi4@20-25@lib/libcompiler_rt/divmodsi4.c","lib/libcompiler_rt/divmodsi4.c","__divmodsi4",20,25
40,19,394,4,39,"__divsc3@21-60@lib/libcompiler_rt/divsc3.c","lib/libcompiler_rt/divsc3.c","__divsc3",21,60
62,16,543,2,144,"__divsf3@25-169@lib/libcompiler_rt/divsf3.c","lib/libcompiler_rt/divsf3.c","__divsf3",25,169
10,1,84,2,15,"__divsi3@22-37@lib/libcompiler_rt/divsi3.c","lib/libcompiler_rt/divsi3.c","__divsi3",22,37
40,19,406,4,39,"__divtc3@21-60@lib/libcompiler_rt/divtc3.c","lib/libcompiler_rt/divtc3.c","__divtc3",21,60
83,16,776,2,178,"__divtf3@23-201@lib/libcompiler_rt/divtf3.c","lib/libcompiler_rt/divtf3.c","__divtf3",23,201
10,1,88,2,9,"__divti3@22-31@lib/libcompiler_rt/divti3.c","lib/libcompiler_rt/divti3.c","__divti3",22,31
40,19,400,4,39,"__divxc3@22-61@lib/libcompiler_rt/divxc3.c","lib/libcompiler_rt/divxc3.c","__divxc3",22,61
12,4,100,2,16,"emutls_memalign_alloc@45-61@lib/libcompiler_rt/emutls.c","lib/libcompiler_rt/emutls.c","emutls_memalign_alloc",45,61
4,2,28,1,7,"emutls_memalign_free@63-70@lib/libcompiler_rt/emutls.c","lib/libcompiler_rt/emutls.c","emutls_memalign_free",63,70
18,4,142,1,21,"emutls_allocate_object@73-94@lib/libcompiler_rt/emutls.c","lib/libcompiler_rt/emutls.c","emutls_allocate_object",73,94
9,3,62,1,8,"emutls_key_destructor@107-115@lib/libcompiler_rt/emutls.c","lib/libcompiler_rt/emutls.c","emutls_key_destructor",107,115
4,2,22,1,3,"emutls_init@117-120@lib/libcompiler_rt/emutls.c","lib/libcompiler_rt/emutls.c","emutls_init",117,120
15,3,93,1,14,"emutls_get_index@123-137@lib/libcompiler_rt/emutls.c","lib/libcompiler_rt/emutls.c","emutls_get_index",123,137
7,2,38,2,6,"emutls_check_array_set_size@140-146@lib/libcompiler_rt/emutls.c","lib/libcompiler_rt/emutls.c","emutls_check_array_set_size",140,146
3,1,27,1,6,"emutls_new_data_array_size@151-157@lib/libcompiler_rt/emutls.c","lib/libcompiler_rt/emutls.c","emutls_new_data_array_size",151,157
19,5,161,1,18,"emutls_get_address_array@163-181@lib/libcompiler_rt/emutls.c","lib/libcompiler_rt/emutls.c","emutls_get_address_array",163,181
7,2,62,1,6,"__emutls_get_address@183-189@lib/libcompiler_rt/emutls.c","lib/libcompiler_rt/emutls.c","__emutls_get_address",183,189
15,5,145,1,25,"__enable_execute_stack@47-72@lib/libcompiler_rt/enable_execute_stack.c","lib/libcompiler_rt/enable_execute_stack.c","__enable_execute_stack",47,72
7,1,45,4,6,"__eprintf@29-35@lib/libcompiler_rt/eprintf.c","lib/libcompiler_rt/eprintf.c","__eprintf",29,35
3,1,13,1,2,"__extenddftf2@19-21@lib/libcompiler_rt/extenddftf2.c","lib/libcompiler_rt/extenddftf2.c","__extenddftf2",19,21
3,1,12,1,2,"__extendhfsf2@19-21@lib/libcompiler_rt/extendhfsf2.c","lib/libcompiler_rt/extendhfsf2.c","__extendhfsf2",19,21
3,1,13,1,2,"__gnu_h2f_ieee@23-25@lib/libcompiler_rt/extendhfsf2.c","lib/libcompiler_rt/extendhfsf2.c","__gnu_h2f_ieee",23,25
3,1,12,1,2,"__extendsfdf2@17-19@lib/libcompiler_rt/extendsfdf2.c","lib/libcompiler_rt/extendsfdf2.c","__extendsfdf2",17,19
3,1,13,1,2,"__extendsftf2@19-21@lib/libcompiler_rt/extendsftf2.c","lib/libcompiler_rt/extendsftf2.c","__extendsftf2",19,21
12,3,74,1,11,"__ffsdi2@22-33@lib/libcompiler_rt/ffsdi2.c","lib/libcompiler_rt/ffsdi2.c","__ffsdi2",22,33
12,3,74,1,11,"__ffsti2@24-35@lib/libcompiler_rt/ffsti2.c","lib/libcompiler_rt/ffsti2.c","__ffsti2",24,35
7,2,31,1,6,"__fixdfdi@23-29@lib/libcompiler_rt/fixdfdi.c","lib/libcompiler_rt/fixdfdi.c","__fixdfdi",23,29
3,1,13,1,2,"__fixdfdi@42-44@lib/libcompiler_rt/fixdfdi.c","lib/libcompiler_rt/fixdfdi.c","__fixdfdi",42,44
3,1,12,1,2,"__fixdfsi@20-22@lib/libcompiler_rt/fixdfsi.c","lib/libcompiler_rt/fixdfsi.c","__fixdfsi",20,22
3,1,13,1,2,"__fixdfti@22-24@lib/libcompiler_rt/fixdfti.c","lib/libcompiler_rt/fixdfti.c","__fixdfti",22,24
7,2,31,1,6,"__fixsfdi@24-30@lib/libcompiler_rt/fixsfdi.c","lib/libcompiler_rt/fixsfdi.c","__fixsfdi",24,30
3,1,13,1,2,"__fixsfdi@43-45@lib/libcompiler_rt/fixsfdi.c","lib/libcompiler_rt/fixsfdi.c","__fixsfdi",43,45
3,1,12,1,2,"__fixsfsi@20-22@lib/libcompiler_rt/fixsfsi.c","lib/libcompiler_rt/fixsfsi.c","__fixsfsi",20,22
3,1,13,1,2,"__fixsfti@22-24@lib/libcompiler_rt/fixsfti.c","lib/libcompiler_rt/fixsfti.c","__fixsfti",22,24
3,1,13,1,2,"__fixtfdi@20-22@lib/libcompiler_rt/fixtfdi.c","lib/libcompiler_rt/fixtfdi.c","__fixtfdi",20,22
3,1,13,1,2,"__fixtfsi@20-22@lib/libcompiler_rt/fixtfsi.c","lib/libcompiler_rt/fixtfsi.c","__fixtfsi",20,22
3,1,13,1,2,"__fixtfti@20-22@lib/libcompiler_rt/fixtfti.c","lib/libcompiler_rt/fixtfti.c","__fixtfti",20,22
7,2,53,1,6,"__fixunsdfdi@22-28@lib/libcompiler_rt/fixunsdfdi.c","lib/libcompiler_rt/fixunsdfdi.c","__fixunsdfdi",22,28
3,1,13,1,2,"__fixunsdfdi@40-42@lib/libcompiler_rt/fixunsdfdi.c","lib/libcompiler_rt/fixunsdfdi.c","__fixunsdfdi",40,42
3,1,12,1,2,"__fixunsdfsi@19-21@lib/libcompiler_rt/fixunsdfsi.c","lib/libcompiler_rt/fixunsdfsi.c","__fixunsdfsi",19,21
3,1,13,1,2,"__fixunsdfti@20-22@lib/libcompiler_rt/fixunsdfti.c","lib/libcompiler_rt/fixunsdfti.c","__fixunsdfti",20,22
8,2,58,1,7,"__fixunssfdi@22-29@lib/libcompiler_rt/fixunssfdi.c","lib/libcompiler_rt/fixunssfdi.c","__fixunssfdi",22,29
3,1,13,1,2,"__fixunssfdi@41-43@lib/libcompiler_rt/fixunssfdi.c","lib/libcompiler_rt/fixunssfdi.c","__fixunssfdi",41,43
3,1,12,1,2,"__fixunssfsi@23-25@lib/libcompiler_rt/fixunssfsi.c","lib/libcompiler_rt/fixunssfsi.c","__fixunssfsi",23,25
3,1,13,1,2,"__fixunssfti@23-25@lib/libcompiler_rt/fixunssfti.c","lib/libcompiler_rt/fixunssfti.c","__fixunssfti",23,25
3,1,13,1,2,"__fixunstfdi@19-21@lib/libcompiler_rt/fixunstfdi.c","lib/libcompiler_rt/fixunstfdi.c","__fixunstfdi",19,21
3,1,13,1,2,"__fixunstfsi@19-21@lib/libcompiler_rt/fixunstfsi.c","lib/libcompiler_rt/fixunstfsi.c","__fixunstfsi",19,21
3,1,13,1,2,"__fixunstfti@19-21@lib/libcompiler_rt/fixunstfti.c","lib/libcompiler_rt/fixunstfti.c","__fixunstfti",19,21
11,4,95,1,10,"__fixunsxfdi@34-44@lib/libcompiler_rt/fixunsxfdi.c","lib/libcompiler_rt/fixunsxfdi.c","__fixunsxfdi",34,44
11,4,97,1,10,"__fixunsxfsi@33-43@lib/libcompiler_rt/fixunsxfsi.c","lib/libcompiler_rt/fixunsxfsi.c","__fixunsxfsi",33,43
16,5,118,1,15,"__fixunsxfti@33-48@lib/libcompiler_rt/fixunsxfti.c","lib/libcompiler_rt/fixunsxfti.c","__fixunsxfti",33,48
16,4,155,1,15,"__fixxfdi@31-46@lib/libcompiler_rt/fixxfdi.c","lib/libcompiler_rt/fixxfdi.c","__fixxfdi",31,46
19,5,166,1,18,"__fixxfti@31-49@lib/libcompiler_rt/fixxfti.c","lib/libcompiler_rt/fixxfti.c","__fixxfti",31,49
10,1,86,1,12,"__floatdidf@33-45@lib/libcompiler_rt/floatdidf.c","lib/libcompiler_rt/floatdidf.c","__floatdidf",33,45
42,6,273,1,53,"__floatdidf@53-106@lib/libcompiler_rt/floatdidf.c","lib/libcompiler_rt/floatdidf.c","__floatdidf",53,106
41,6,250,1,52,"__floatdisf@28-80@lib/libcompiler_rt/floatdisf.c","lib/libcompiler_rt/floatdisf.c","__floatdisf",28,80
17,3,122,1,28,"__floatditf@20-48@lib/libcompiler_rt/floatditf.c","lib/libcompiler_rt/floatditf.c","__floatditf",20,48
15,2,117,1,14,"__floatdixf@30-44@lib/libcompiler_rt/floatdixf.c","lib/libcompiler_rt/floatdixf.c","__floatdixf",30,44
16,3,113,1,29,"__floatsidf@24-53@lib/libcompiler_rt/floatsidf.c","lib/libcompiler_rt/floatsidf.c","__floatsidf",24,53
24,6,176,1,35,"__floatsisf@24-59@lib/libcompiler_rt/floatsisf.c","lib/libcompiler_rt/floatsisf.c","__floatsisf",24,59
17,3,122,1,28,"__floatsitf@20-48@lib/libcompiler_rt/floatsitf.c","lib/libcompiler_rt/floatsitf.c","__floatsitf",20,48
42,6,273,1,53,"__floattidf@28-81@lib/libcompiler_rt/floattidf.c","lib/libcompiler_rt/floattidf.c","__floattidf",28,81
41,6,251,1,52,"__floattisf@28-80@lib/libcompiler_rt/floattisf.c","lib/libcompiler_rt/floattisf.c","__floattisf",28,80
41,6,256,1,52,"__floattixf@30-82@lib/libcompiler_rt/floattixf.c","lib/libcompiler_rt/floattixf.c","__floattixf",30,82
12,1,108,1,14,"__floatundidf@33-47@lib/libcompiler_rt/floatundidf.c","lib/libcompiler_rt/floatundidf.c","__floatundidf",33,47
39,6,238,1,50,"__floatundidf@55-105@lib/libcompiler_rt/floatundidf.c","lib/libcompiler_rt/floatundidf.c","__floatundidf",55,105
38,6,215,1,49,"__floatundisf@28-77@lib/libcompiler_rt/floatundisf.c","lib/libcompiler_rt/floatundisf.c","__floatundisf",28,77
10,2,86,1,18,"__floatunditf@20-38@lib/libcompiler_rt/floatunditf.c","lib/libcompiler_rt/floatunditf.c","__floatunditf",20,38
12,2,85,1,11,"__floatundixf@29-40@lib/libcompiler_rt/floatundixf.c","lib/libcompiler_rt/floatundixf.c","__floatundixf",29,40
10,2,86,1,18,"__floatunsidf@24-42@lib/libcompiler_rt/floatunsidf.c","lib/libcompiler_rt/floatunsidf.c","__floatunsidf",24,42
18,5,153,1,26,"__floatunsisf@24-50@lib/libcompiler_rt/floatunsisf.c","lib/libcompiler_rt/floatunsisf.c","__floatunsisf",24,50
10,2,87,1,18,"__floatunsitf@20-38@lib/libcompiler_rt/floatunsitf.c","lib/libcompiler_rt/floatunsitf.c","__floatunsitf",20,38
39,6,238,1,50,"__floatuntidf@28-78@lib/libcompiler_rt/floatuntidf.c","lib/libcompiler_rt/floatuntidf.c","__floatuntidf",28,78
38,6,216,1,49,"__floatuntisf@28-77@lib/libcompiler_rt/floatuntisf.c","lib/libcompiler_rt/floatuntisf.c","__floatuntisf",28,77
38,6,221,1,49,"__floatuntixf@30-79@lib/libcompiler_rt/floatuntixf.c","lib/libcompiler_rt/floatuntixf.c","__floatuntixf",30,79
7,3,45,1,9,"src_rep_t_clz@31-40@lib/libcompiler_rt/fp_extend.h","lib/libcompiler_rt/fp_extend.h","src_rep_t_clz",31,40
4,1,31,1,3,"srcToRep@78-81@lib/libcompiler_rt/fp_extend.h","lib/libcompiler_rt/fp_extend.h","srcToRep",78,81
4,1,31,1,3,"dstFromRep@83-86@lib/libcompiler_rt/fp_extend.h","lib/libcompiler_rt/fp_extend.h","dstFromRep",83,86
3,1,13,1,2,"rep_clz@49-51@lib/libcompiler_rt/fp_lib.h","lib/libcompiler_rt/fp_lib.h","rep_clz",49,51
5,1,42,4,4,"wideMultiply@54-58@lib/libcompiler_rt/fp_lib.h","lib/libcompiler_rt/fp_lib.h","wideMultiply",54,58
7,3,45,1,9,"rep_clz@69-78@lib/libcompiler_rt/fp_lib.h","lib/libcompiler_rt/fp_lib.h","rep_clz",69,78
10,1,134,4,12,"wideMultiply@86-98@lib/libcompiler_rt/fp_lib.h","lib/libcompiler_rt/fp_lib.h","wideMultiply",86,98
19,3,94,1,23,"rep_clz@115-138@lib/libcompiler_rt/fp_lib.h","lib/libcompiler_rt/fp_lib.h","rep_clz",115,138
48,1,469,4,51,"wideMultiply@151-202@lib/libcompiler_rt/fp_lib.h","lib/libcompiler_rt/fp_lib.h","wideMultiply",151,202
4,1,31,1,3,"toRep@231-234@lib/libcompiler_rt/fp_lib.h","lib/libcompiler_rt/fp_lib.h","toRep",231,234
4,1,31,1,3,"fromRep@236-239@lib/libcompiler_rt/fp_lib.h","lib/libcompiler_rt/fp_lib.h","fromRep",236,239
5,1,34,1,4,"normalize@241-245@lib/libcompiler_rt/fp_lib.h","lib/libcompiler_rt/fp_lib.h","normalize",241,245
4,1,43,3,3,"wideLeftShift@247-250@lib/libcompiler_rt/fp_lib.h","lib/libcompiler_rt/fp_lib.h","wideLeftShift",247,250
16,3,141,3,15,"wideRightShiftWithSticky@252-267@lib/libcompiler_rt/fp_lib.h","lib/libcompiler_rt/fp_lib.h","wideRightShiftWithSticky",252,267
4,1,31,1,3,"srcToRep@66-69@lib/libcompiler_rt/fp_trunc.h","lib/libcompiler_rt/fp_trunc.h","srcToRep",66,69
4,1,31,1,3,"dstFromRep@71-74@lib/libcompiler_rt/fp_trunc.h","lib/libcompiler_rt/fp_trunc.h","dstFromRep",71,74
14,2,70,1,13,"readULEB128@54-67@lib/libcompiler_rt/gcc_personality_v0.c","lib/libcompiler_rt/gcc_personality_v0.c","readULEB128",54,67
63,18,310,2,73,"readEncodedPointer@70-143@lib/libcompiler_rt/gcc_personality_v0.c","lib/libcompiler_rt/gcc_personality_v0.c","readEncodedPointer",70,143
6,3,31,2,11,"continueUnwind@153-164@lib/libcompiler_rt/gcc_personality_v0.c","lib/libcompiler_rt/gcc_personality_v0.c","continueUnwind",153,164
43,11,310,5,63,"__gcc_personality_v0@188-251@lib/libcompiler_rt/gcc_personality_v0.c","lib/libcompiler_rt/gcc_personality_v0.c","__gcc_personality_v0",188,251
6,2,28,1,5,"__builtin_ctz@93-98@lib/libcompiler_rt/int_lib.h","lib/libcompiler_rt/int_lib.h","__builtin_ctz",93,98
6,2,30,1,5,"__builtin_clz@100-105@lib/libcompiler_rt/int_lib.h","lib/libcompiler_rt/int_lib.h","__builtin_clz",100,105
6,2,30,1,5,"__builtin_clzll@108-113@lib/libcompiler_rt/int_lib.h","lib/libcompiler_rt/int_lib.h","__builtin_clzll",108,113
9,3,61,1,8,"__builtin_clzll@115-123@lib/libcompiler_rt/int_lib.h","lib/libcompiler_rt/int_lib.h","__builtin_clzll",115,123
6,1,34,2,5,"make_ti@103-108@lib/libcompiler_rt/int_types.h","lib/libcompiler_rt/int_types.h","make_ti",103,108
6,1,34,2,5,"make_tu@110-115@lib/libcompiler_rt/int_types.h","lib/libcompiler_rt/int_types.h","make_tu",110,115
3,1,27,3,2,"compilerrt_abort_impl@30-32@lib/libcompiler_rt/int_util.c","lib/libcompiler_rt/int_util.c","compilerrt_abort_impl",30,32
3,1,27,3,2,"compilerrt_abort_impl@44-46@lib/libcompiler_rt/int_util.c","lib/libcompiler_rt/int_util.c","compilerrt_abort_impl",44,46
3,1,20,3,2,"compilerrt_abort_impl@57-59@lib/libcompiler_rt/int_util.c","lib/libcompiler_rt/int_util.c","compilerrt_abort_impl",57,59
20,3,136,2,19,"__lshrdi3@24-43@lib/libcompiler_rt/lshrdi3.c","lib/libcompiler_rt/lshrdi3.c","__lshrdi3",24,43
20,3,137,2,19,"__lshrti3@24-43@lib/libcompiler_rt/lshrti3.c","lib/libcompiler_rt/lshrti3.c","__lshrti3",24,43
11,1,88,2,10,"__moddi3@20-30@lib/libcompiler_rt/moddi3.c","lib/libcompiler_rt/moddi3.c","__moddi3",20,30
4,1,22,2,3,"__modsi3@20-23@lib/libcompiler_rt/modsi3.c","lib/libcompiler_rt/modsi3.c","__modsi3",20,23
11,1,88,2,10,"__modti3@22-32@lib/libcompiler_rt/modti3.c","lib/libcompiler_rt/modti3.c","__modti3",22,32
53,25,394,4,52,"__muldc3@21-73@lib/libcompiler_rt/muldc3.c","lib/libcompiler_rt/muldc3.c","__muldc3",21,73
3,1,17,2,2,"__muldf3@20-22@lib/libcompiler_rt/muldf3.c","lib/libcompiler_rt/muldf3.c","__muldf3",20,22
19,1,207,2,18,"__muldsi3@21-39@lib/libcompiler_rt/muldi3.c","lib/libcompiler_rt/muldi3.c","__muldsi3",21,39
11,1,84,2,10,"__muldi3@46-56@lib/libcompiler_rt/muldi3.c","lib/libcompiler_rt/muldi3.c","__muldi3",46,56
37,12,216,3,36,"__mulodi4@22-58@lib/libcompiler_rt/mulodi4.c","lib/libcompiler_rt/mulodi4.c","__mulodi4",22,58
37,12,216,3,36,"__mulosi4@22-58@lib/libcompiler_rt/mulosi4.c","lib/libcompiler_rt/mulosi4.c","__mulosi4",22,58
37,12,216,3,36,"__muloti4@24-60@lib/libcompiler_rt/muloti4.c","lib/libcompiler_rt/muloti4.c","__muloti4",24,60
53,25,394,4,52,"__mulsc3@21-73@lib/libcompiler_rt/mulsc3.c","lib/libcompiler_rt/mulsc3.c","__mulsc3",21,73
3,1,17,2,2,"__mulsf3@20-22@lib/libcompiler_rt/mulsf3.c","lib/libcompiler_rt/mulsf3.c","__mulsf3",20,22
48,25,392,4,47,"__multc3@21-68@lib/libcompiler_rt/multc3.c","lib/libcompiler_rt/multc3.c","__multc3",21,68
3,1,18,2,2,"__multf3@21-23@lib/libcompiler_rt/multf3.c","lib/libcompiler_rt/multf3.c","__multf3",21,23
19,1,207,2,18,"__mulddi3@23-41@lib/libcompiler_rt/multi3.c","lib/libcompiler_rt/multi3.c","__mulddi3",23,41
11,1,85,2,10,"__multi3@46-56@lib/libcompiler_rt/multi3.c","lib/libcompiler_rt/multi3.c","__multi3",46,56
35,12,204,2,34,"__mulvdi3@22-56@lib/libcompiler_rt/mulvdi3.c","lib/libcompiler_rt/mulvdi3.c","__mulvdi3",22,56
35,12,204,2,34,"__mulvsi3@22-56@lib/libcompiler_rt/mulvsi3.c","lib/libcompiler_rt/mulvsi3.c","__mulvsi3",22,56
35,12,204,2,34,"__mulvti3@24-58@lib/libcompiler_rt/mulvti3.c","lib/libcompiler_rt/mulvti3.c","__mulvti3",24,58
53,25,402,4,52,"__mulxc3@23-75@lib/libcompiler_rt/mulxc3.c","lib/libcompiler_rt/mulxc3.c","__mulxc3",23,75
3,1,17,1,2,"__negdf2@20-22@lib/libcompiler_rt/negdf2.c","lib/libcompiler_rt/negdf2.c","__negdf2",20,22
4,1,11,1,6,"__negdi2@20-26@lib/libcompiler_rt/negdi2.c","lib/libcompiler_rt/negdi2.c","__negdi2",20,26
3,1,17,1,2,"__negsf2@20-22@lib/libcompiler_rt/negsf2.c","lib/libcompiler_rt/negsf2.c","__negsf2",20,22
4,1,11,1,6,"__negti2@22-28@lib/libcompiler_rt/negti2.c","lib/libcompiler_rt/negti2.c","__negti2",22,28
7,2,47,1,6,"__negvdi2@22-28@lib/libcompiler_rt/negvdi2.c","lib/libcompiler_rt/negvdi2.c","__negvdi2",22,28
7,2,47,1,6,"__negvsi2@22-28@lib/libcompiler_rt/negvsi2.c","lib/libcompiler_rt/negvsi2.c","__negvsi2",22,28
7,2,47,1,6,"__negvti2@24-30@lib/libcompiler_rt/negvti2.c","lib/libcompiler_rt/negvti2.c","__negvti2",24,30
6,1,32,1,5,"__paritydi2@20-25@lib/libcompiler_rt/paritydi2.c","lib/libcompiler_rt/paritydi2.c","__paritydi2",20,25
8,1,50,1,7,"__paritysi2@20-27@lib/libcompiler_rt/paritysi2.c","lib/libcompiler_rt/paritysi2.c","__paritysi2",20,27
6,1,32,1,5,"__parityti2@22-27@lib/libcompiler_rt/parityti2.c","lib/libcompiler_rt/parityti2.c","__parityti2",22,27
10,1,106,1,16,"__popcountdi2@20-36@lib/libcompiler_rt/popcountdi2.c","lib/libcompiler_rt/popcountdi2.c","__popcountdi2",20,36
9,1,91,1,13,"__popcountsi2@20-33@lib/libcompiler_rt/popcountsi2.c","lib/libcompiler_rt/popcountsi2.c","__popcountsi2",20,33
14,1,171,1,20,"__popcountti2@22-42@lib/libcompiler_rt/popcountti2.c","lib/libcompiler_rt/popcountti2.c","__popcountti2",22,42
15,5,64,2,14,"__powidf2@20-34@lib/libcompiler_rt/powidf2.c","lib/libcompiler_rt/powidf2.c","__powidf2",20,34
15,5,64,2,14,"__powisf2@20-34@lib/libcompiler_rt/powisf2.c","lib/libcompiler_rt/powisf2.c","__powisf2",20,34
15,5,66,2,14,"__powitf2@22-36@lib/libcompiler_rt/powitf2.c","lib/libcompiler_rt/powitf2.c","__powitf2",22,36
15,5,66,2,14,"__powixf2@22-36@lib/libcompiler_rt/powixf2.c","lib/libcompiler_rt/powixf2.c","__powixf2",22,36
3,1,25,2,2,"__subdf3@22-24@lib/libcompiler_rt/subdf3.c","lib/libcompiler_rt/subdf3.c","__subdf3",22,24
3,1,25,2,2,"__subsf3@22-24@lib/libcompiler_rt/subsf3.c","lib/libcompiler_rt/subsf3.c","__subsf3",22,24
3,1,26,2,2,"__subtf3@23-25@lib/libcompiler_rt/subtf3.c","lib/libcompiler_rt/subtf3.c","__subtf3",23,25
15,4,57,2,14,"__subvdi3@22-36@lib/libcompiler_rt/subvdi3.c","lib/libcompiler_rt/subvdi3.c","__subvdi3",22,36
15,4,57,2,14,"__subvsi3@22-36@lib/libcompiler_rt/subvsi3.c","lib/libcompiler_rt/subvsi3.c","__subvsi3",22,36
15,4,57,2,14,"__subvti3@24-38@lib/libcompiler_rt/subvti3.c","lib/libcompiler_rt/subvti3.c","__subvti3",24,38
17,2,117,4,22,"__trampoline_setup@25-47@lib/libcompiler_rt/trampoline_setup.c","lib/libcompiler_rt/trampoline_setup.c","__trampoline_setup",25,47
3,1,12,1,2,"__truncdfhf2@16-18@lib/libcompiler_rt/truncdfhf2.c","lib/libcompiler_rt/truncdfhf2.c","__truncdfhf2",16,18
3,1,12,1,2,"__truncdfsf2@16-18@lib/libcompiler_rt/truncdfsf2.c","lib/libcompiler_rt/truncdfsf2.c","__truncdfsf2",16,18
3,1,12,1,2,"__truncsfhf2@18-20@lib/libcompiler_rt/truncsfhf2.c","lib/libcompiler_rt/truncsfhf2.c","__truncsfhf2",18,20
3,1,13,1,2,"__gnu_f2h_ieee@22-24@lib/libcompiler_rt/truncsfhf2.c","lib/libcompiler_rt/truncsfhf2.c","__gnu_f2h_ieee",22,24
3,1,14,1,2,"__trunctfdf2@18-20@lib/libcompiler_rt/trunctfdf2.c","lib/libcompiler_rt/trunctfdf2.c","__trunctfdf2",18,20
3,1,14,1,2,"__trunctfsf2@18-20@lib/libcompiler_rt/trunctfsf2.c","lib/libcompiler_rt/trunctfsf2.c","__trunctfsf2",18,20
16,5,99,2,15,"__ucmpdi2@23-38@lib/libcompiler_rt/ucmpdi2.c","lib/libcompiler_rt/ucmpdi2.c","__ucmpdi2",23,38
4,1,20,2,3,"__aeabi_ulcmp@46-49@lib/libcompiler_rt/ucmpdi2.c","lib/libcompiler_rt/ucmpdi2.c","__aeabi_ulcmp",46,49
16,5,99,2,15,"__ucmpti2@25-40@lib/libcompiler_rt/ucmpti2.c","lib/libcompiler_rt/ucmpti2.c","__ucmpti2",25,40
4,1,20,2,3,"__udivdi3@20-23@lib/libcompiler_rt/udivdi3.c","lib/libcompiler_rt/udivdi3.c","__udivdi3",20,23
144,25,1216,3,207,"__udivmoddi4@24-231@lib/libcompiler_rt/udivmoddi4.c","lib/libcompiler_rt/udivmoddi4.c","__udivmoddi4",24,231
6,1,38,3,5,"__udivmodsi4@20-25@lib/libcompiler_rt/udivmodsi4.c","lib/libcompiler_rt/udivmodsi4.c","__udivmodsi4",20,25
145,25,1216,3,210,"__udivmodti4@26-236@lib/libcompiler_rt/udivmodti4.c","lib/libcompiler_rt/udivmodti4.c","__udivmodti4",26,236
30,6,198,2,41,"__udivsi3@25-66@lib/libcompiler_rt/udivsi3.c","lib/libcompiler_rt/udivsi3.c","__udivsi3",25,66
4,1,20,2,3,"__udivti3@22-25@lib/libcompiler_rt/udivti3.c","lib/libcompiler_rt/udivti3.c","__udivti3",22,25
6,1,26,2,5,"__umoddi3@20-25@lib/libcompiler_rt/umoddi3.c","lib/libcompiler_rt/umoddi3.c","__umoddi3",20,25
4,1,22,2,3,"__umodsi3@20-23@lib/libcompiler_rt/umodsi3.c","lib/libcompiler_rt/umodsi3.c","__umodsi3",20,23
6,1,26,2,5,"__umodti3@22-27@lib/libcompiler_rt/umodti3.c","lib/libcompiler_rt/umodti3.c","__umodti3",22,27
10,2,73,6,9,"AES_cbc_encrypt@56-65@lib/libcrypto/aes/aes_cbc.c","lib/libcrypto/aes/aes_cbc.c","AES_cbc_encrypt",56,65
6,1,58,7,5,"AES_cfb128_encrypt@61-66@lib/libcrypto/aes/aes_cfb.c","lib/libcrypto/aes/aes_cfb.c","AES_cfb128_encrypt",61,66
6,1,58,7,5,"AES_cfb1_encrypt@70-75@lib/libcrypto/aes/aes_cfb.c","lib/libcrypto/aes/aes_cfb.c","AES_cfb1_encrypt",70,75
6,1,58,7,5,"AES_cfb8_encrypt@78-83@lib/libcrypto/aes/aes_cfb.c","lib/libcrypto/aes/aes_cfb.c","AES_cfb8_encrypt",78,83
91,17,814,3,95,"AES_set_encrypt_key@628-723@lib/libcrypto/aes/aes_core.c","lib/libcrypto/aes/aes_core.c","AES_set_encrypt_key",628,723
48,4,554,3,53,"AES_set_decrypt_key@729-782@lib/libcrypto/aes/aes_core.c","lib/libcrypto/aes/aes_core.c","AES_set_decrypt_key",729,782
151,6,3255,3,183,"AES_encrypt@789-972@lib/libcrypto/aes/aes_core.c","lib/libcrypto/aes/aes_core.c","AES_encrypt",789,972
151,6,3279,3,183,"AES_decrypt@979-1162@lib/libcrypto/aes/aes_core.c","lib/libcrypto/aes/aes_core.c","AES_decrypt",979,1162
91,17,818,3,95,"AES_set_encrypt_key@1211-1306@lib/libcrypto/aes/aes_core.c","lib/libcrypto/aes/aes_core.c","AES_set_encrypt_key",1211,1306
51,6,480,3,60,"AES_set_decrypt_key@1312-1372@lib/libcrypto/aes/aes_core.c","lib/libcrypto/aes/aes_core.c","AES_set_decrypt_key",1312,1372
7,1,64,7,6,"AES_ctr128_encrypt@56-62@lib/libcrypto/aes/aes_ctr.c","lib/libcrypto/aes/aes_ctr.c","AES_ctr128_encrypt",56,62
8,2,49,4,7,"AES_ecb_encrypt@62-69@lib/libcrypto/aes/aes_ecb.c","lib/libcrypto/aes/aes_ecb.c","AES_ecb_encrypt",62,69
104,20,846,6,114,"AES_ige_encrypt@80-194@lib/libcrypto/aes/aes_ige.c","lib/libcrypto/aes/aes_ige.c","AES_ige_encrypt",80,194
5,2,12,1,7,"AES_options@58-65@lib/libcrypto/aes/aes_misc.c","lib/libcrypto/aes/aes_misc.c","AES_options",58,65
6,1,52,6,5,"AES_ofb128_encrypt@56-61@lib/libcrypto/aes/aes_ofb.c","lib/libcrypto/aes/aes_ofb.c","AES_ofb128_encrypt",56,61
30,7,277,5,31,"AES_wrap_key@64-95@lib/libcrypto/aes/aes_wrap.c","lib/libcrypto/aes/aes_wrap.c","AES_wrap_key",64,95
36,8,304,5,35,"AES_unwrap_key@98-133@lib/libcrypto/aes/aes_wrap.c","lib/libcrypto/aes/aes_wrap.c","AES_unwrap_key",98,133
9,2,75,1,11,"prefetch256@62-73@lib/libcrypto/aes/aes_x86core.c","lib/libcrypto/aes/aes_x86core.c","prefetch256",62,73
90,17,818,3,94,"AES_set_encrypt_key@468-562@lib/libcrypto/aes/aes_x86core.c","lib/libcrypto/aes/aes_x86core.c","AES_set_encrypt_key",468,562
70,7,800,3,82,"AES_set_decrypt_key@568-650@lib/libcrypto/aes/aes_x86core.c","lib/libcrypto/aes/aes_x86core.c","AES_set_decrypt_key",568,650
175,9,1989,3,212,"AES_encrypt@657-869@lib/libcrypto/aes/aes_x86core.c","lib/libcrypto/aes/aes_x86core.c","AES_encrypt",657,869
170,8,1903,3,204,"AES_decrypt@876-1080@lib/libcrypto/aes/aes_x86core.c","lib/libcrypto/aes/aes_x86core.c","AES_decrypt",876,1080
4,1,11,1,3,"_getentropy_fail@38-41@lib/libcrypto/arc4random/arc4random_aix.h","lib/libcrypto/arc4random/arc4random_aix.h","_getentropy_fail",38,41
4,1,10,1,3,"_rs_forkhandler@46-49@lib/libcrypto/arc4random/arc4random_aix.h","lib/libcrypto/arc4random/arc4random_aix.h","_rs_forkhandler",46,49
11,5,58,1,11,"_rs_forkdetect@52-63@lib/libcrypto/arc4random/arc4random_aix.h","lib/libcrypto/arc4random/arc4random_aix.h","_rs_forkdetect",52,63
14,3,121,2,15,"_rs_allocate@66-81@lib/libcrypto/arc4random/arc4random_aix.h","lib/libcrypto/arc4random/arc4random_aix.h","_rs_allocate",66,81
4,1,11,1,3,"_getentropy_fail@44-47@lib/libcrypto/arc4random/arc4random_freebsd.h","lib/libcrypto/arc4random/arc4random_freebsd.h","_getentropy_fail",44,47
4,1,10,1,3,"_rs_forkhandler@52-55@lib/libcrypto/arc4random/arc4random_freebsd.h","lib/libcrypto/arc4random/arc4random_freebsd.h","_rs_forkhandler",52,55
11,5,58,1,11,"_rs_forkdetect@58-69@lib/libcrypto/arc4random/arc4random_freebsd.h","lib/libcrypto/arc4random/arc4random_freebsd.h","_rs_forkdetect",58,69
14,3,121,2,15,"_rs_allocate@72-87@lib/libcrypto/arc4random/arc4random_freebsd.h","lib/libcrypto/arc4random/arc4random_freebsd.h","_rs_allocate",72,87
4,1,11,1,3,"_getentropy_fail@38-41@lib/libcrypto/arc4random/arc4random_hpux.h","lib/libcrypto/arc4random/arc4random_hpux.h","_getentropy_fail",38,41
4,1,10,1,3,"_rs_forkhandler@46-49@lib/libcrypto/arc4random/arc4random_hpux.h","lib/libcrypto/arc4random/arc4random_hpux.h","_rs_forkhandler",46,49
11,5,58,1,11,"_rs_forkdetect@52-63@lib/libcrypto/arc4random/arc4random_hpux.h","lib/libcrypto/arc4random/arc4random_hpux.h","_rs_forkdetect",52,63
14,3,121,2,15,"_rs_allocate@66-81@lib/libcrypto/arc4random/arc4random_hpux.h","lib/libcrypto/arc4random/arc4random_hpux.h","_rs_allocate",66,81
4,1,11,1,3,"_getentropy_fail@44-47@lib/libcrypto/arc4random/arc4random_linux.h","lib/libcrypto/arc4random/arc4random_linux.h","_getentropy_fail",44,47
4,1,10,1,3,"_rs_forkhandler@52-55@lib/libcrypto/arc4random/arc4random_linux.h","lib/libcrypto/arc4random/arc4random_linux.h","_rs_forkhandler",52,55
11,6,62,1,12,"_rs_forkdetect@58-70@lib/libcrypto/arc4random/arc4random_linux.h","lib/libcrypto/arc4random/arc4random_linux.h","_rs_forkdetect",58,70
14,3,121,2,15,"_rs_allocate@73-88@lib/libcrypto/arc4random/arc4random_linux.h","lib/libcrypto/arc4random/arc4random_linux.h","_rs_allocate",73,88
4,1,11,1,3,"_getentropy_fail@44-47@lib/libcrypto/arc4random/arc4random_netbsd.h","lib/libcrypto/arc4random/arc4random_netbsd.h","_getentropy_fail",44,47
4,1,10,1,3,"_rs_forkhandler@52-55@lib/libcrypto/arc4random/arc4random_netbsd.h","lib/libcrypto/arc4random/arc4random_netbsd.h","_rs_forkhandler",52,55
11,5,58,1,11,"_rs_forkdetect@58-69@lib/libcrypto/arc4random/arc4random_netbsd.h","lib/libcrypto/arc4random/arc4random_netbsd.h","_rs_forkdetect",58,69
14,3,121,2,15,"_rs_allocate@72-87@lib/libcrypto/arc4random/arc4random_netbsd.h","lib/libcrypto/arc4random/arc4random_netbsd.h","_rs_allocate",72,87
4,1,11,1,3,"_getentropy_fail@38-41@lib/libcrypto/arc4random/arc4random_osx.h","lib/libcrypto/arc4random/arc4random_osx.h","_getentropy_fail",38,41
4,1,10,1,3,"_rs_forkhandler@46-49@lib/libcrypto/arc4random/arc4random_osx.h","lib/libcrypto/arc4random/arc4random_osx.h","_rs_forkhandler",46,49
11,5,58,1,11,"_rs_forkdetect@52-63@lib/libcrypto/arc4random/arc4random_osx.h","lib/libcrypto/arc4random/arc4random_osx.h","_rs_forkdetect",52,63
14,3,121,2,15,"_rs_allocate@66-81@lib/libcrypto/arc4random/arc4random_osx.h","lib/libcrypto/arc4random/arc4random_osx.h","_rs_allocate",66,81
4,1,11,1,3,"_getentropy_fail@38-41@lib/libcrypto/arc4random/arc4random_solaris.h","lib/libcrypto/arc4random/arc4random_solaris.h","_getentropy_fail",38,41
4,1,10,1,3,"_rs_forkhandler@46-49@lib/libcrypto/arc4random/arc4random_solaris.h","lib/libcrypto/arc4random/arc4random_solaris.h","_rs_forkhandler",46,49
11,5,58,1,11,"_rs_forkdetect@52-63@lib/libcrypto/arc4random/arc4random_solaris.h","lib/libcrypto/arc4random/arc4random_solaris.h","_rs_forkdetect",52,63
14,3,121,2,15,"_rs_allocate@66-81@lib/libcrypto/arc4random/arc4random_solaris.h","lib/libcrypto/arc4random/arc4random_solaris.h","_rs_allocate",66,81
4,1,15,1,3,"_getentropy_fail@46-49@lib/libcrypto/arc4random/arc4random_win.h","lib/libcrypto/arc4random/arc4random_win.h","_getentropy_fail",46,49
15,3,102,2,15,"_rs_allocate@52-67@lib/libcrypto/arc4random/arc4random_win.h","lib/libcrypto/arc4random/arc4random_win.h","_rs_allocate",52,67
3,1,6,1,2,"_rs_forkhandler@70-72@lib/libcrypto/arc4random/arc4random_win.h","lib/libcrypto/arc4random/arc4random_win.h","_rs_forkhandler",70,72
3,1,6,1,2,"_rs_forkdetect@75-77@lib/libcrypto/arc4random/arc4random_win.h","lib/libcrypto/arc4random/arc4random_win.h","_rs_forkdetect",75,77
17,5,95,2,50,"getentropy@69-119@lib/libcrypto/arc4random/getentropy_aix.c","lib/libcrypto/arc4random/getentropy_aix.c","getentropy",69,119
10,3,56,2,10,"gotdata@125-135@lib/libcrypto/arc4random/getentropy_aix.c","lib/libcrypto/arc4random/getentropy_aix.c","gotdata",125,135
41,12,239,4,51,"getentropy_urandom@138-189@lib/libcrypto/arc4random/getentropy_aix.c","lib/libcrypto/arc4random/getentropy_aix.c","getentropy_urandom",138,189
174,26,1440,2,208,"getentropy_fallback@217-425@lib/libcrypto/arc4random/getentropy_aix.c","lib/libcrypto/arc4random/getentropy_aix.c","getentropy_fallback",217,425
17,3,97,2,19,"getentropy_sysctl@33-52@lib/libcrypto/arc4random/getentropy_freebsd.c","lib/libcrypto/arc4random/getentropy_freebsd.c","getentropy_sysctl",33,52
7,3,41,2,7,"getentropy@55-62@lib/libcrypto/arc4random/getentropy_freebsd.c","lib/libcrypto/arc4random/getentropy_freebsd.c","getentropy",55,62
17,5,95,2,50,"getentropy@73-123@lib/libcrypto/arc4random/getentropy_hpux.c","lib/libcrypto/arc4random/getentropy_hpux.c","getentropy",73,123
10,3,56,2,10,"gotdata@129-139@lib/libcrypto/arc4random/getentropy_hpux.c","lib/libcrypto/arc4random/getentropy_hpux.c","gotdata",129,139
41,12,239,4,51,"getentropy_urandom@142-193@lib/libcrypto/arc4random/getentropy_hpux.c","lib/libcrypto/arc4random/getentropy_hpux.c","getentropy_urandom",142,193
171,25,1416,2,198,"getentropy_fallback@221-419@lib/libcrypto/arc4random/getentropy_hpux.c","lib/libcrypto/arc4random/getentropy_hpux.c","getentropy_fallback",221,419
23,9,133,2,90,"getentropy@88-178@lib/libcrypto/arc4random/getentropy_linux.c","lib/libcrypto/arc4random/getentropy_linux.c","getentropy",88,178
10,3,56,2,10,"gotdata@184-194@lib/libcrypto/arc4random/getentropy_linux.c","lib/libcrypto/arc4random/getentropy_linux.c","gotdata",184,194
14,5,80,2,14,"getentropy_getrandom@198-212@lib/libcrypto/arc4random/getentropy_linux.c","lib/libcrypto/arc4random/getentropy_linux.c","getentropy_getrandom",198,212
45,13,258,2,55,"getentropy_urandom@216-271@lib/libcrypto/arc4random/getentropy_linux.c","lib/libcrypto/arc4random/getentropy_linux.c","getentropy_urandom",216,271
25,4,145,2,27,"getentropy_sysctl@275-302@lib/libcrypto/arc4random/getentropy_linux.c","lib/libcrypto/arc4random/getentropy_linux.c","getentropy_sysctl",275,302
6,1,44,3,6,"getentropy_phdr@331-337@lib/libcrypto/arc4random/getentropy_linux.c","lib/libcrypto/arc4random/getentropy_linux.c","getentropy_phdr",331,337
174,31,1433,2,210,"getentropy_fallback@340-550@lib/libcrypto/arc4random/getentropy_linux.c","lib/libcrypto/arc4random/getentropy_linux.c","getentropy_fallback",340,550
17,3,97,2,19,"getentropy_sysctl@33-52@lib/libcrypto/arc4random/getentropy_netbsd.c","lib/libcrypto/arc4random/getentropy_netbsd.c","getentropy_sysctl",33,52
9,3,43,2,9,"getentropy@55-64@lib/libcrypto/arc4random/getentropy_netbsd.c","lib/libcrypto/arc4random/getentropy_netbsd.c","getentropy",55,64
17,5,91,2,53,"getentropy@90-143@lib/libcrypto/arc4random/getentropy_osx.c","lib/libcrypto/arc4random/getentropy_osx.c","getentropy",90,143
10,3,56,2,10,"gotdata@149-159@lib/libcrypto/arc4random/getentropy_osx.c","lib/libcrypto/arc4random/getentropy_osx.c","gotdata",149,159
41,12,231,2,51,"getentropy_urandom@162-213@lib/libcrypto/arc4random/getentropy_osx.c","lib/libcrypto/arc4random/getentropy_osx.c","getentropy_urandom",162,213
181,23,1520,2,216,"getentropy_fallback@224-440@lib/libcrypto/arc4random/getentropy_osx.c","lib/libcrypto/arc4random/getentropy_osx.c","getentropy_fallback",224,440
21,6,120,2,71,"getentropy@78-149@lib/libcrypto/arc4random/getentropy_solaris.c","lib/libcrypto/arc4random/getentropy_solaris.c","getentropy",78,149
10,3,56,2,10,"gotdata@155-165@lib/libcrypto/arc4random/getentropy_solaris.c","lib/libcrypto/arc4random/getentropy_solaris.c","gotdata",155,165
42,14,256,4,52,"getentropy_urandom@168-220@lib/libcrypto/arc4random/getentropy_solaris.c","lib/libcrypto/arc4random/getentropy_solaris.c","getentropy_urandom",168,220
6,1,44,3,6,"getentropy_phdr@248-254@lib/libcrypto/arc4random/getentropy_solaris.c","lib/libcrypto/arc4random/getentropy_solaris.c","getentropy_phdr",248,254
162,24,1340,2,188,"getentropy_fallback@257-445@lib/libcrypto/arc4random/getentropy_solaris.c","lib/libcrypto/arc4random/getentropy_solaris.c","getentropy_fallback",257,445
20,4,102,2,22,"getentropy@37-59@lib/libcrypto/arc4random/getentropy_win.c","lib/libcrypto/arc4random/getentropy_win.c","getentropy",37,59
4,1,26,3,3,"ASN1_BIT_STRING_set@66-69@lib/libcrypto/asn1/a_bitstr.c","lib/libcrypto/asn1/a_bitstr.c","ASN1_BIT_STRING_set",66,69
50,16,294,2,55,"i2c_ASN1_BIT_STRING@72-127@lib/libcrypto/asn1/a_bitstr.c","lib/libcrypto/asn1/a_bitstr.c","i2c_ASN1_BIT_STRING",72,127
45,11,287,3,53,"c2i_ASN1_BIT_STRING@130-183@lib/libcrypto/asn1/a_bitstr.c","lib/libcrypto/asn1/a_bitstr.c","c2i_ASN1_BIT_STRING",130,183
30,10,248,3,34,"ASN1_BIT_STRING_set_bit@188-222@lib/libcrypto/asn1/a_bitstr.c","lib/libcrypto/asn1/a_bitstr.c","ASN1_BIT_STRING_set_bit",188,222
9,4,86,2,9,"ASN1_BIT_STRING_get_bit@225-234@lib/libcrypto/asn1/a_bitstr.c","lib/libcrypto/asn1/a_bitstr.c","ASN1_BIT_STRING_get_bit",225,234
12,6,90,3,16,"ASN1_BIT_STRING_check@243-259@lib/libcrypto/asn1/a_bitstr.c","lib/libcrypto/asn1/a_bitstr.c","ASN1_BIT_STRING_check",243,259
13,2,83,2,14,"i2d_ASN1_BOOLEAN@65-79@lib/libcrypto/asn1/a_bool.c","lib/libcrypto/asn1/a_bool.c","i2d_ASN1_BOOLEAN",65,79
30,5,159,3,33,"d2i_ASN1_BOOLEAN@82-115@lib/libcrypto/asn1/a_bool.c","lib/libcrypto/asn1/a_bool.c","d2i_ASN1_BOOLEAN",82,115
53,13,319,4,60,"d2i_ASN1_type_bytes@70-130@lib/libcrypto/asn1/a_bytes.c","lib/libcrypto/asn1/a_bytes.c","d2i_ASN1_type_bytes",70,130
23,6,157,4,26,"i2d_ASN1_bytes@133-159@lib/libcrypto/asn1/a_bytes.c","lib/libcrypto/asn1/a_bytes.c","i2d_ASN1_bytes",133,159
71,16,422,5,78,"d2i_ASN1_bytes@162-240@lib/libcrypto/asn1/a_bytes.c","lib/libcrypto/asn1/a_bytes.c","d2i_ASN1_bytes",162,240
51,10,327,2,58,"asn1_collate_primitive@248-306@lib/libcrypto/asn1/a_bytes.c","lib/libcrypto/asn1/a_bytes.c","asn1_collate_primitive",248,306
13,2,93,4,13,"ASN1_d2i_fp@71-84@lib/libcrypto/asn1/a_d2i_fp.c","lib/libcrypto/asn1/a_d2i_fp.c","ASN1_d2i_fp",71,84
16,3,107,4,18,"ASN1_d2i_bio@87-105@lib/libcrypto/asn1/a_d2i_fp.c","lib/libcrypto/asn1/a_d2i_fp.c","ASN1_d2i_bio",87,105
16,3,101,3,18,"ASN1_item_d2i_bio@110-128@lib/libcrypto/asn1/a_d2i_fp.c","lib/libcrypto/asn1/a_d2i_fp.c","ASN1_item_d2i_bio",110,128
13,2,82,3,13,"ASN1_item_d2i_fp@131-144@lib/libcrypto/asn1/a_d2i_fp.c","lib/libcrypto/asn1/a_d2i_fp.c","ASN1_item_d2i_fp",131,144
116,31,635,2,140,"asn1_d2i_read_bio@149-289@lib/libcrypto/asn1/a_d2i_fp.c","lib/libcrypto/asn1/a_d2i_fp.c","asn1_d2i_read_bio",149,289
13,3,91,5,14,"ASN1_item_digest@70-84@lib/libcrypto/asn1/a_digest.c","lib/libcrypto/asn1/a_digest.c","ASN1_item_digest",70,84
21,3,124,3,22,"ASN1_dup@67-89@lib/libcrypto/asn1/a_dup.c","lib/libcrypto/asn1/a_dup.c","ASN1_dup",67,89
18,3,102,2,19,"ASN1_item_dup@99-118@lib/libcrypto/asn1/a_dup.c","lib/libcrypto/asn1/a_dup.c","ASN1_item_dup",99,118
32,7,213,2,33,"ASN1_ENUMERATED_set@71-104@lib/libcrypto/asn1/a_enum.c","lib/libcrypto/asn1/a_enum.c","ASN1_ENUMERATED_set",71,104
24,8,138,1,27,"ASN1_ENUMERATED_get@107-134@lib/libcrypto/asn1/a_enum.c","lib/libcrypto/asn1/a_enum.c","ASN1_ENUMERATED_get",107,134
37,9,212,2,40,"BN_to_ASN1_ENUMERATED@137-177@lib/libcrypto/asn1/a_enum.c","lib/libcrypto/asn1/a_enum.c","BN_to_ASN1_ENUMERATED",137,177
9,3,63,2,9,"ASN1_ENUMERATED_to_BN@180-189@lib/libcrypto/asn1/a_enum.c","lib/libcrypto/asn1/a_enum.c","ASN1_ENUMERATED_to_BN",180,189
13,2,80,3,13,"ASN1_i2d_fp@68-81@lib/libcrypto/asn1/a_i2d_fp.c","lib/libcrypto/asn1/a_i2d_fp.c","ASN1_i2d_fp",68,81
27,5,154,3,29,"ASN1_i2d_bio@84-113@lib/libcrypto/asn1/a_i2d_fp.c","lib/libcrypto/asn1/a_i2d_fp.c","ASN1_i2d_bio",84,113
13,2,81,3,13,"ASN1_item_i2d_fp@118-131@lib/libcrypto/asn1/a_i2d_fp.c","lib/libcrypto/asn1/a_i2d_fp.c","ASN1_item_i2d_fp",118,131
23,5,131,3,24,"ASN1_item_i2d_bio@134-158@lib/libcrypto/asn1/a_i2d_fp.c","lib/libcrypto/asn1/a_i2d_fp.c","ASN1_item_i2d_bio",134,158
4,1,15,1,3,"ASN1_INTEGER_dup@67-70@lib/libcrypto/asn1/a_int.c","lib/libcrypto/asn1/a_int.c","ASN1_INTEGER_dup",67,70
16,4,74,2,19,"ASN1_INTEGER_cmp@73-92@lib/libcrypto/asn1/a_int.c","lib/libcrypto/asn1/a_int.c","ASN1_INTEGER_cmp",73,92
55,16,349,2,65,"i2c_ASN1_INTEGER@121-186@lib/libcrypto/asn1/a_int.c","lib/libcrypto/asn1/a_int.c","i2c_ASN1_INTEGER",121,186
66,18,404,3,82,"c2i_ASN1_INTEGER@191-273@lib/libcrypto/asn1/a_int.c","lib/libcrypto/asn1/a_int.c","c2i_ASN1_INTEGER",191,273
50,13,290,3,57,"d2i_ASN1_UINTEGER@282-339@lib/libcrypto/asn1/a_int.c","lib/libcrypto/asn1/a_int.c","d2i_ASN1_UINTEGER",282,339
32,7,213,2,34,"ASN1_INTEGER_set@342-376@lib/libcrypto/asn1/a_int.c","lib/libcrypto/asn1/a_int.c","ASN1_INTEGER_set",342,376
24,8,139,1,27,"ASN1_INTEGER_get@379-406@lib/libcrypto/asn1/a_int.c","lib/libcrypto/asn1/a_int.c","ASN1_INTEGER_get",379,406
37,9,213,2,40,"BN_to_ASN1_INTEGER@409-449@lib/libcrypto/asn1/a_int.c","lib/libcrypto/asn1/a_int.c","BN_to_ASN1_INTEGER",409,449
9,3,64,2,9,"ASN1_INTEGER_to_BN@452-461@lib/libcrypto/asn1/a_int.c","lib/libcrypto/asn1/a_int.c","ASN1_INTEGER_to_BN",452,461
5,1,42,5,4,"ASN1_mbstring_copy@88-92@lib/libcrypto/asn1/a_mbstr.c","lib/libcrypto/asn1/a_mbstr.c","ASN1_mbstring_copy",88,92
141,33,699,7,162,"ASN1_mbstring_ncopy@95-257@lib/libcrypto/asn1/a_mbstr.c","lib/libcrypto/asn1/a_mbstr.c","ASN1_mbstring_ncopy",95,257
43,11,225,5,44,"traverse_string@264-308@lib/libcrypto/asn1/a_mbstr.c","lib/libcrypto/asn1/a_mbstr.c","traverse_string",264,308
7,1,29,2,7,"in_utf8@315-322@lib/libcrypto/asn1/a_mbstr.c","lib/libcrypto/asn1/a_mbstr.c","in_utf8",315,322
11,2,52,2,11,"out_utf8@327-338@lib/libcrypto/asn1/a_mbstr.c","lib/libcrypto/asn1/a_mbstr.c","out_utf8",327,338
17,10,124,2,17,"type_str@345-362@lib/libcrypto/asn1/a_mbstr.c","lib/libcrypto/asn1/a_mbstr.c","type_str",345,362
9,1,43,2,9,"cpy_asc@367-376@lib/libcrypto/asn1/a_mbstr.c","lib/libcrypto/asn1/a_mbstr.c","cpy_asc",367,376
10,1,57,2,10,"cpy_bmp@381-391@lib/libcrypto/asn1/a_mbstr.c","lib/libcrypto/asn1/a_mbstr.c","cpy_bmp",381,391
12,1,83,2,12,"cpy_univ@396-408@lib/libcrypto/asn1/a_mbstr.c","lib/libcrypto/asn1/a_mbstr.c","cpy_univ",396,408
9,1,44,2,10,"cpy_utf8@413-423@lib/libcrypto/asn1/a_mbstr.c","lib/libcrypto/asn1/a_mbstr.c","cpy_utf8",413,423
16,10,99,1,20,"is_printable@427-447@lib/libcrypto/asn1/a_mbstr.c","lib/libcrypto/asn1/a_mbstr.c","is_printable",427,447
16,4,114,2,19,"i2d_ASN1_OBJECT@70-89@lib/libcrypto/asn1/a_object.c","lib/libcrypto/asn1/a_object.c","i2d_ASN1_OBJECT",70,89
116,41,672,4,121,"a2d_ASN1_OBJECT@92-213@lib/libcrypto/asn1/a_object.c","lib/libcrypto/asn1/a_object.c","a2d_ASN1_OBJECT",92,213
4,1,27,3,3,"i2t_ASN1_OBJECT@216-219@lib/libcrypto/asn1/a_object.c","lib/libcrypto/asn1/a_object.c","i2t_ASN1_OBJECT",216,219
24,7,184,2,24,"i2a_ASN1_OBJECT@222-246@lib/libcrypto/asn1/a_object.c","lib/libcrypto/asn1/a_object.c","i2a_ASN1_OBJECT",222,246
25,4,132,3,27,"d2i_ASN1_OBJECT@249-276@lib/libcrypto/asn1/a_object.c","lib/libcrypto/asn1/a_object.c","d2i_ASN1_OBJECT",249,276
48,18,330,3,68,"c2i_ASN1_OBJECT@279-347@lib/libcrypto/asn1/a_object.c","lib/libcrypto/asn1/a_object.c","c2i_ASN1_OBJECT",279,347
16,2,79,1,16,"ASN1_OBJECT_new@350-366@lib/libcrypto/asn1/a_object.c","lib/libcrypto/asn1/a_object.c","ASN1_OBJECT_new",350,366
17,5,108,1,16,"ASN1_OBJECT_free@369-385@lib/libcrypto/asn1/a_object.c","lib/libcrypto/asn1/a_object.c","ASN1_OBJECT_free",369,385
13,1,77,5,13,"ASN1_OBJECT_create@388-401@lib/libcrypto/asn1/a_object.c","lib/libcrypto/asn1/a_object.c","ASN1_OBJECT_create",388,401
4,1,15,1,3,"ASN1_OCTET_STRING_dup@64-67@lib/libcrypto/asn1/a_octet.c","lib/libcrypto/asn1/a_octet.c","ASN1_OCTET_STRING_dup",64,67
4,1,22,2,3,"ASN1_OCTET_STRING_cmp@70-73@lib/libcrypto/asn1/a_octet.c","lib/libcrypto/asn1/a_octet.c","ASN1_OCTET_STRING_cmp",70,73
4,1,27,3,3,"ASN1_OCTET_STRING_set@76-79@lib/libcrypto/asn1/a_octet.c","lib/libcrypto/asn1/a_octet.c","ASN1_OCTET_STRING_set",76,79
31,27,234,2,32,"ASN1_PRINTABLE_type@64-96@lib/libcrypto/asn1/a_print.c","lib/libcrypto/asn1/a_print.c","ASN1_PRINTABLE_type",64,96
26,9,189,1,26,"ASN1_UNIVERSALSTRING_to_string@99-125@lib/libcrypto/asn1/a_print.c","lib/libcrypto/asn1/a_print.c","ASN1_UNIVERSALSTRING_to_string",99,125
11,3,88,2,11,"SetBlobCmp@76-87@lib/libcrypto/asn1/a_set.c","lib/libcrypto/asn1/a_set.c","SetBlobCmp",76,87
53,11,413,6,75,"i2d_ASN1_SET@91-166@lib/libcrypto/asn1/a_set.c","lib/libcrypto/asn1/a_set.c","i2d_ASN1_SET",91,166
58,18,409,7,65,"d2i_ASN1_SET@169-234@lib/libcrypto/asn1/a_set.c","lib/libcrypto/asn1/a_set.c","d2i_ASN1_SET",169,234
11,2,88,7,10,"ASN1_item_sign@128-138@lib/libcrypto/asn1/a_sign.c","lib/libcrypto/asn1/a_sign.c","ASN1_item_sign",128,138
73,18,454,6,91,"ASN1_item_sign_ctx@142-233@lib/libcrypto/asn1/a_sign.c","lib/libcrypto/asn1/a_sign.c","ASN1_item_sign_ctx",142,233
8,3,43,3,7,"send_bio_chars@88-95@lib/libcrypto/asn1/a_strex.c","lib/libcrypto/asn1/a_strex.c","send_bio_chars",88,95
8,3,51,3,7,"send_fp_chars@98-105@lib/libcrypto/asn1/a_strex.c","lib/libcrypto/asn1/a_strex.c","send_fp_chars",98,105
53,19,336,5,57,"do_esc_char@117-174@lib/libcrypto/asn1/a_strex.c","lib/libcrypto/asn1/a_strex.c","do_esc_char",117,174
67,19,411,7,76,"do_buf@185-261@lib/libcrypto/asn1/a_strex.c","lib/libcrypto/asn1/a_strex.c","do_buf",185,261
18,4,119,4,17,"do_hex_dump@266-283@lib/libcrypto/asn1/a_strex.c","lib/libcrypto/asn1/a_strex.c","do_hex_dump",266,283
27,6,187,4,31,"do_dump@292-323@lib/libcrypto/asn1/a_strex.c","lib/libcrypto/asn1/a_strex.c","do_dump",292,323
59,22,372,4,75,"do_print_ex@349-424@lib/libcrypto/asn1/a_strex.c","lib/libcrypto/asn1/a_strex.c","do_print_ex",349,424
8,3,49,3,7,"do_indent@429-436@lib/libcrypto/asn1/a_strex.c","lib/libcrypto/asn1/a_strex.c","do_indent",429,436
124,28,660,5,137,"do_name_ex@442-579@lib/libcrypto/asn1/a_strex.c","lib/libcrypto/asn1/a_strex.c","do_name_ex",442,579
6,2,49,4,5,"X509_NAME_print_ex@584-589@lib/libcrypto/asn1/a_strex.c","lib/libcrypto/asn1/a_strex.c","X509_NAME_print_ex",584,589
14,3,85,4,13,"X509_NAME_print_ex_fp@592-605@lib/libcrypto/asn1/a_strex.c","lib/libcrypto/asn1/a_strex.c","X509_NAME_print_ex_fp",592,605
4,1,28,3,3,"ASN1_STRING_print_ex@608-611@lib/libcrypto/asn1/a_strex.c","lib/libcrypto/asn1/a_strex.c","ASN1_STRING_print_ex",608,611
4,1,28,3,3,"ASN1_STRING_print_ex_fp@614-617@lib/libcrypto/asn1/a_strex.c","lib/libcrypto/asn1/a_strex.c","ASN1_STRING_print_ex_fp",614,617
22,6,137,2,22,"ASN1_STRING_to_UTF8@624-646@lib/libcrypto/asn1/a_strex.c","lib/libcrypto/asn1/a_strex.c","ASN1_STRING_to_UTF8",624,646
4,1,12,1,3,"ASN1_STRING_set_default_mask@81-84@lib/libcrypto/asn1/a_strnid.c","lib/libcrypto/asn1/a_strnid.c","ASN1_STRING_set_default_mask",81,84
4,1,9,1,3,"ASN1_STRING_get_default_mask@87-90@lib/libcrypto/asn1/a_strnid.c","lib/libcrypto/asn1/a_strnid.c","ASN1_STRING_get_default_mask",87,90
23,8,152,1,23,"ASN1_STRING_set_default_mask_asc@102-125@lib/libcrypto/asn1/a_strnid.c","lib/libcrypto/asn1/a_strnid.c","ASN1_STRING_set_default_mask_asc",102,125
23,5,138,5,22,"ASN1_STRING_set_by_NID@133-155@lib/libcrypto/asn1/a_strnid.c","lib/libcrypto/asn1/a_strnid.c","ASN1_STRING_set_by_NID",133,155
5,1,33,2,4,"sk_table_cmp@198-202@lib/libcrypto/asn1/a_strnid.c","lib/libcrypto/asn1/a_strnid.c","sk_table_cmp",198,202
4,1,23,2,3,"table_cmp@209-212@lib/libcrypto/asn1/a_strnid.c","lib/libcrypto/asn1/a_strnid.c","table_cmp",209,212
6,1,36,2,5,"table_cmp_BSEARCH_CMP_FN@216-221@lib/libcrypto/asn1/a_strnid.c","lib/libcrypto/asn1/a_strnid.c","table_cmp_BSEARCH_CMP_FN",216,221
5,1,37,3,4,"OBJ_bsearch_table@224-228@lib/libcrypto/asn1/a_strnid.c","lib/libcrypto/asn1/a_strnid.c","OBJ_bsearch_table",224,228
17,4,85,1,17,"ASN1_STRING_TABLE_get@231-248@lib/libcrypto/asn1/a_strnid.c","lib/libcrypto/asn1/a_strnid.c","ASN1_STRING_TABLE_get",231,248
36,9,200,5,36,"ASN1_STRING_TABLE_add@251-287@lib/libcrypto/asn1/a_strnid.c","lib/libcrypto/asn1/a_strnid.c","ASN1_STRING_TABLE_add",251,287
9,2,35,1,9,"ASN1_STRING_TABLE_cleanup@290-299@lib/libcrypto/asn1/a_strnid.c","lib/libcrypto/asn1/a_strnid.c","ASN1_STRING_TABLE_cleanup",290,299
5,2,21,1,4,"st_free@302-306@lib/libcrypto/asn1/a_strnid.c","lib/libcrypto/asn1/a_strnid.c","st_free",302,306
5,1,38,3,4,"d2i_ASN1_TIME@85-89@lib/libcrypto/asn1/a_time.c","lib/libcrypto/asn1/a_time.c","d2i_ASN1_TIME",85,89
4,1,28,2,3,"i2d_ASN1_TIME@92-95@lib/libcrypto/asn1/a_time.c","lib/libcrypto/asn1/a_time.c","i2d_ASN1_TIME",92,95
4,1,17,1,3,"ASN1_TIME_new@98-101@lib/libcrypto/asn1/a_time.c","lib/libcrypto/asn1/a_time.c","ASN1_TIME_new",98,101
4,1,20,1,3,"ASN1_TIME_free@104-107@lib/libcrypto/asn1/a_time.c","lib/libcrypto/asn1/a_time.c","ASN1_TIME_free",104,107
28,13,203,2,27,"ASN1_time_tm_cmp@33-60@lib/libcrypto/asn1/a_time_tm.c","lib/libcrypto/asn1/a_time_tm.c","ASN1_time_tm_cmp",33,60
10,4,63,1,13,"ASN1_time_tm_clamp_notafter@63-76@lib/libcrypto/asn1/a_time_tm.c","lib/libcrypto/asn1/a_time_tm.c","ASN1_time_tm_clamp_notafter",63,76
13,4,87,1,15,"gentime_string_from_tm@80-95@lib/libcrypto/asn1/a_time_tm.c","lib/libcrypto/asn1/a_time_tm.c","gentime_string_from_tm",80,95
11,4,84,1,13,"utctime_string_from_tm@99-112@lib/libcrypto/asn1/a_time_tm.c","lib/libcrypto/asn1/a_time_tm.c","utctime_string_from_tm",99,112
13,4,67,1,15,"rfc5280_string_from_tm@116-131@lib/libcrypto/asn1/a_time_tm.c","lib/libcrypto/asn1/a_time_tm.c","rfc5280_string_from_tm",116,131
62,25,420,4,76,"ASN1_time_parse@150-226@lib/libcrypto/asn1/a_time_tm.c","lib/libcrypto/asn1/a_time_tm.c","ASN1_time_parse",150,226
18,6,128,3,21,"ASN1_TIME_set_string_internal@233-254@lib/libcrypto/asn1/a_time_tm.c","lib/libcrypto/asn1/a_time_tm.c","ASN1_TIME_set_string_internal",233,254
54,14,259,5,58,"ASN1_TIME_adj_internal@257-315@lib/libcrypto/asn1/a_time_tm.c","lib/libcrypto/asn1/a_time_tm.c","ASN1_TIME_adj_internal",257,315
4,1,25,2,3,"ASN1_TIME_set@318-321@lib/libcrypto/asn1/a_time_tm.c","lib/libcrypto/asn1/a_time_tm.c","ASN1_TIME_set",318,321
7,2,47,2,7,"ASN1_TIME_set_tm@324-331@lib/libcrypto/asn1/a_time_tm.c","lib/libcrypto/asn1/a_time_tm.c","ASN1_TIME_set_tm",324,331
4,1,33,4,3,"ASN1_TIME_adj@334-337@lib/libcrypto/asn1/a_time_tm.c","lib/libcrypto/asn1/a_time_tm.c","ASN1_TIME_adj",334,337
6,3,51,1,5,"ASN1_TIME_check@340-345@lib/libcrypto/asn1/a_time_tm.c","lib/libcrypto/asn1/a_time_tm.c","ASN1_TIME_check",340,345
25,8,183,2,28,"ASN1_TIME_to_generalizedtime@348-376@lib/libcrypto/asn1/a_time_tm.c","lib/libcrypto/asn1/a_time_tm.c","ASN1_TIME_to_generalizedtime",348,376
4,1,25,2,3,"ASN1_TIME_set_string@379-382@lib/libcrypto/asn1/a_time_tm.c","lib/libcrypto/asn1/a_time_tm.c","ASN1_TIME_set_string",379,382
6,2,45,1,5,"ASN1_UTCTIME_check@389-394@lib/libcrypto/asn1/a_time_tm.c","lib/libcrypto/asn1/a_time_tm.c","ASN1_UTCTIME_check",389,394
6,3,42,2,5,"ASN1_UTCTIME_set_string@397-402@lib/libcrypto/asn1/a_time_tm.c","lib/libcrypto/asn1/a_time_tm.c","ASN1_UTCTIME_set_string",397,402
4,1,25,2,3,"ASN1_UTCTIME_set@405-408@lib/libcrypto/asn1/a_time_tm.c","lib/libcrypto/asn1/a_time_tm.c","ASN1_UTCTIME_set",405,408
5,1,33,4,4,"ASN1_UTCTIME_adj@411-415@lib/libcrypto/asn1/a_time_tm.c","lib/libcrypto/asn1/a_time_tm.c","ASN1_UTCTIME_adj",411,415
9,3,74,2,20,"ASN1_UTCTIME_cmp_time_t@418-438@lib/libcrypto/asn1/a_time_tm.c","lib/libcrypto/asn1/a_time_tm.c","ASN1_UTCTIME_cmp_time_t",418,438
6,2,45,1,5,"ASN1_GENERALIZEDTIME_check@445-450@lib/libcrypto/asn1/a_time_tm.c","lib/libcrypto/asn1/a_time_tm.c","ASN1_GENERALIZEDTIME_check",445,450
6,3,42,2,5,"ASN1_GENERALIZEDTIME_set_string@453-458@lib/libcrypto/asn1/a_time_tm.c","lib/libcrypto/asn1/a_time_tm.c","ASN1_GENERALIZEDTIME_set_string",453,458
4,1,25,2,3,"ASN1_GENERALIZEDTIME_set@461-464@lib/libcrypto/asn1/a_time_tm.c","lib/libcrypto/asn1/a_time_tm.c","ASN1_GENERALIZEDTIME_set",461,464
6,1,33,4,5,"ASN1_GENERALIZEDTIME_adj@467-472@lib/libcrypto/asn1/a_time_tm.c","lib/libcrypto/asn1/a_time_tm.c","ASN1_GENERALIZEDTIME_adj",467,472
7,3,41,1,6,"ASN1_TYPE_get@65-71@lib/libcrypto/asn1/a_type.c","lib/libcrypto/asn1/a_type.c","ASN1_TYPE_get",65,71
12,4,78,3,11,"ASN1_TYPE_set@74-85@lib/libcrypto/asn1/a_type.c","lib/libcrypto/asn1/a_type.c","ASN1_TYPE_set",74,85
20,6,119,3,19,"ASN1_TYPE_set1@88-107@lib/libcrypto/asn1/a_type.c","lib/libcrypto/asn1/a_type.c","ASN1_TYPE_set1",88,107
42,27,188,2,45,"ASN1_TYPE_cmp@111-156@lib/libcrypto/asn1/a_type.c","lib/libcrypto/asn1/a_type.c","ASN1_TYPE_cmp",111,156
58,23,440,3,60,"UTF8_getc@79-139@lib/libcrypto/asn1/a_utf8.c","lib/libcrypto/asn1/a_utf8.c","UTF8_getc",79,139
44,14,359,3,43,"UTF8_putc@156-199@lib/libcrypto/asn1/a_utf8.c","lib/libcrypto/asn1/a_utf8.c","UTF8_putc",156,199
70,15,395,5,92,"ASN1_item_verify@75-167@lib/libcrypto/asn1/a_verify.c","lib/libcrypto/asn1/a_verify.c","ASN1_item_verify",75,167
5,1,35,2,4,"ameth_cmp@122-126@lib/libcrypto/asn1/ameth_lib.c","lib/libcrypto/asn1/ameth_lib.c","ameth_cmp",122,126
6,1,40,2,5,"ameth_cmp_BSEARCH_CMP_FN@130-135@lib/libcrypto/asn1/ameth_lib.c","lib/libcrypto/asn1/ameth_lib.c","ameth_cmp_BSEARCH_CMP_FN",130,135
5,1,45,3,4,"OBJ_bsearch_ameth@138-142@lib/libcrypto/asn1/ameth_lib.c","lib/libcrypto/asn1/ameth_lib.c","OBJ_bsearch_ameth",138,142
7,2,34,1,6,"EVP_PKEY_asn1_get_count@145-151@lib/libcrypto/asn1/ameth_lib.c","lib/libcrypto/asn1/ameth_lib.c","EVP_PKEY_asn1_get_count",145,151
10,3,54,1,9,"EVP_PKEY_asn1_get0@154-163@lib/libcrypto/asn1/ameth_lib.c","lib/libcrypto/asn1/ameth_lib.c","EVP_PKEY_asn1_get0",154,163
17,5,97,1,16,"pkey_asn1_find@166-182@lib/libcrypto/asn1/ameth_lib.c","lib/libcrypto/asn1/ameth_lib.c","pkey_asn1_find",166,182
20,6,96,2,23,"EVP_PKEY_asn1_find@191-214@lib/libcrypto/asn1/ameth_lib.c","lib/libcrypto/asn1/ameth_lib.c","EVP_PKEY_asn1_find",191,214
28,9,164,3,32,"EVP_PKEY_asn1_find_str@217-249@lib/libcrypto/asn1/ameth_lib.c","lib/libcrypto/asn1/ameth_lib.c","EVP_PKEY_asn1_find_str",217,249
12,4,53,1,11,"EVP_PKEY_asn1_add0@252-263@lib/libcrypto/asn1/ameth_lib.c","lib/libcrypto/asn1/ameth_lib.c","EVP_PKEY_asn1_add0",252,263
13,3,62,2,13,"EVP_PKEY_asn1_add_alias@266-279@lib/libcrypto/asn1/ameth_lib.c","lib/libcrypto/asn1/ameth_lib.c","EVP_PKEY_asn1_add_alias",266,279
18,7,97,6,17,"EVP_PKEY_asn1_get0_info@282-299@lib/libcrypto/asn1/ameth_lib.c","lib/libcrypto/asn1/ameth_lib.c","EVP_PKEY_asn1_get0_info",282,299
4,1,13,1,3,"EVP_PKEY_get0_asn1@302-305@lib/libcrypto/asn1/ameth_lib.c","lib/libcrypto/asn1/ameth_lib.c","EVP_PKEY_get0_asn1",302,305
47,6,267,4,59,"EVP_PKEY_asn1_new@308-367@lib/libcrypto/asn1/ameth_lib.c","lib/libcrypto/asn1/ameth_lib.c","EVP_PKEY_asn1_new",308,367
24,1,181,2,29,"EVP_PKEY_asn1_copy@370-399@lib/libcrypto/asn1/ameth_lib.c","lib/libcrypto/asn1/ameth_lib.c","EVP_PKEY_asn1_copy",370,399
8,3,41,1,7,"EVP_PKEY_asn1_free@402-409@lib/libcrypto/asn1/ameth_lib.c","lib/libcrypto/asn1/ameth_lib.c","EVP_PKEY_asn1_free",402,409
16,1,139,7,15,"EVP_PKEY_asn1_set_public@412-427@lib/libcrypto/asn1/ameth_lib.c","lib/libcrypto/asn1/ameth_lib.c","EVP_PKEY_asn1_set_public",412,427
10,1,80,4,9,"EVP_PKEY_asn1_set_private@430-439@lib/libcrypto/asn1/ameth_lib.c","lib/libcrypto/asn1/ameth_lib.c","EVP_PKEY_asn1_set_private",430,439
16,1,149,7,15,"EVP_PKEY_asn1_set_param@442-457@lib/libcrypto/asn1/ameth_lib.c","lib/libcrypto/asn1/ameth_lib.c","EVP_PKEY_asn1_set_param",442,457
5,1,25,2,4,"EVP_PKEY_asn1_set_free@460-464@lib/libcrypto/asn1/ameth_lib.c","lib/libcrypto/asn1/ameth_lib.c","EVP_PKEY_asn1_set_free",460,464
5,1,35,2,4,"EVP_PKEY_asn1_set_ctrl@467-471@lib/libcrypto/asn1/ameth_lib.c","lib/libcrypto/asn1/ameth_lib.c","EVP_PKEY_asn1_set_ctrl",467,471
7,2,36,1,8,"ERR_load_ASN1_strings@205-213@lib/libcrypto/asn1/asn1_err.c","lib/libcrypto/asn1/asn1_err.c","ERR_load_ASN1_strings",205,213
8,2,45,2,9,"ASN1_generate_nconf@124-133@lib/libcrypto/asn1/asn1_gen.c","lib/libcrypto/asn1/asn1_gen.c","ASN1_generate_nconf",124,133
85,19,562,2,130,"ASN1_generate_v3@136-266@lib/libcrypto/asn1/asn1_gen.c","lib/libcrypto/asn1/asn1_gen.c","ASN1_generate_v3",136,266
84,27,506,3,102,"asn1_cb@269-371@lib/libcrypto/asn1/asn1_gen.c","lib/libcrypto/asn1/asn1_gen.c","asn1_cb",269,371
42,12,183,4,52,"parse_tagging@374-426@lib/libcrypto/asn1/asn1_gen.c","lib/libcrypto/asn1/asn1_gen.c","parse_tagging",374,426
48,14,290,3,58,"asn1_multi@431-489@lib/libcrypto/asn1/asn1_gen.c","lib/libcrypto/asn1/asn1_gen.c","asn1_multi",431,489
26,5,153,6,34,"append_exp@492-526@lib/libcrypto/asn1/asn1_gen.c","lib/libcrypto/asn1/asn1_gen.c","append_exp",492,526
64,5,449,2,75,"asn1_str2tag@529-604@lib/libcrypto/asn1/asn1_gen.c","lib/libcrypto/asn1/asn1_gen.c","asn1_str2tag",529,604
151,46,754,3,172,"asn1_str2type@607-779@lib/libcrypto/asn1/asn1_gen.c","lib/libcrypto/asn1/asn1_gen.c","asn1_str2type",607,779
19,7,102,3,19,"bitstr_cb@782-801@lib/libcrypto/asn1/asn1_gen.c","lib/libcrypto/asn1/asn1_gen.c","bitstr_cb",782,801
10,5,76,2,11,"_asn1_check_infinite_end@70-81@lib/libcrypto/asn1/asn1_lib.c","lib/libcrypto/asn1/asn1_lib.c","_asn1_check_infinite_end",70,81
4,1,26,2,3,"ASN1_check_infinite_end@84-87@lib/libcrypto/asn1/asn1_lib.c","lib/libcrypto/asn1/asn1_lib.c","ASN1_check_infinite_end",84,87
4,1,21,2,3,"ASN1_const_check_infinite_end@90-93@lib/libcrypto/asn1/asn1_lib.c","lib/libcrypto/asn1/asn1_lib.c","ASN1_const_check_infinite_end",90,93
53,13,309,5,58,"ASN1_get_object@96-154@lib/libcrypto/asn1/asn1_lib.c","lib/libcrypto/asn1/asn1_lib.c","ASN1_get_object",96,154
36,10,197,4,37,"asn1_get_length@157-194@lib/libcrypto/asn1/asn1_lib.c","lib/libcrypto/asn1/asn1_lib.c","asn1_get_length",157,194
28,7,183,5,28,"ASN1_put_object@199-227@lib/libcrypto/asn1/asn1_lib.c","lib/libcrypto/asn1/asn1_lib.c","ASN1_put_object",199,227
8,1,37,1,8,"ASN1_put_eoc@230-238@lib/libcrypto/asn1/asn1_lib.c","lib/libcrypto/asn1/asn1_lib.c","ASN1_put_eoc",230,238
20,4,114,2,20,"asn1_put_length@241-261@lib/libcrypto/asn1/asn1_lib.c","lib/libcrypto/asn1/asn1_lib.c","asn1_put_length",241,261
22,6,90,3,22,"ASN1_object_size@264-286@lib/libcrypto/asn1/asn1_lib.c","lib/libcrypto/asn1/asn1_lib.c","ASN1_object_size",264,286
15,8,116,1,14,"_asn1_Finish@289-303@lib/libcrypto/asn1/asn1_lib.c","lib/libcrypto/asn1/asn1_lib.c","_asn1_Finish",289,303
4,1,18,1,3,"asn1_Finish@306-309@lib/libcrypto/asn1/asn1_lib.c","lib/libcrypto/asn1/asn1_lib.c","asn1_Finish",306,309
4,1,14,1,3,"asn1_const_Finish@312-315@lib/libcrypto/asn1/asn1_lib.c","lib/libcrypto/asn1/asn1_lib.c","asn1_const_Finish",312,315
24,6,184,2,24,"asn1_GetSequence@318-342@lib/libcrypto/asn1/asn1_lib.c","lib/libcrypto/asn1/asn1_lib.c","asn1_GetSequence",318,342
10,3,60,2,9,"ASN1_STRING_copy@345-354@lib/libcrypto/asn1/asn1_lib.c","lib/libcrypto/asn1/asn1_lib.c","ASN1_STRING_copy",345,354
14,4,58,1,14,"ASN1_STRING_dup@357-371@lib/libcrypto/asn1/asn1_lib.c","lib/libcrypto/asn1/asn1_lib.c","ASN1_STRING_dup",357,371
25,7,153,3,25,"ASN1_STRING_set@374-399@lib/libcrypto/asn1/asn1_lib.c","lib/libcrypto/asn1/asn1_lib.c","ASN1_STRING_set",374,399
6,1,38,3,5,"ASN1_STRING_set0@402-407@lib/libcrypto/asn1/asn1_lib.c","lib/libcrypto/asn1/asn1_lib.c","ASN1_STRING_set0",402,407
4,1,14,1,3,"ASN1_STRING_new@410-413@lib/libcrypto/asn1/asn1_lib.c","lib/libcrypto/asn1/asn1_lib.c","ASN1_STRING_new",410,413
14,2,68,1,14,"ASN1_STRING_type_new@416-430@lib/libcrypto/asn1/asn1_lib.c","lib/libcrypto/asn1/asn1_lib.c","ASN1_STRING_type_new",416,430
8,4,49,1,7,"ASN1_STRING_free@433-440@lib/libcrypto/asn1/asn1_lib.c","lib/libcrypto/asn1/asn1_lib.c","ASN1_STRING_free",433,440
13,3,83,2,13,"ASN1_STRING_cmp@443-456@lib/libcrypto/asn1/asn1_lib.c","lib/libcrypto/asn1/asn1_lib.c","ASN1_STRING_cmp",443,456
4,1,20,2,3,"asn1_add_error@459-462@lib/libcrypto/asn1/asn1_lib.c","lib/libcrypto/asn1/asn1_lib.c","asn1_add_error",459,462
4,1,16,1,3,"ASN1_STRING_length@465-468@lib/libcrypto/asn1/asn1_lib.c","lib/libcrypto/asn1/asn1_lib.c","ASN1_STRING_length",465,468
4,1,17,2,3,"ASN1_STRING_length_set@471-474@lib/libcrypto/asn1/asn1_lib.c","lib/libcrypto/asn1/asn1_lib.c","ASN1_STRING_length_set",471,474
4,1,15,1,3,"ASN1_STRING_type@477-480@lib/libcrypto/asn1/asn1_lib.c","lib/libcrypto/asn1/asn1_lib.c","ASN1_STRING_type",477,480
4,1,15,1,3,"ASN1_STRING_data@483-486@lib/libcrypto/asn1/asn1_lib.c","lib/libcrypto/asn1/asn1_lib.c","ASN1_STRING_data",483,486
29,8,198,5,31,"asn1_print_info@71-102@lib/libcrypto/asn1/asn1_par.c","lib/libcrypto/asn1/asn1_par.c","asn1_print_info",71,102
4,1,41,4,3,"ASN1_parse@105-108@lib/libcrypto/asn1/asn1_par.c","lib/libcrypto/asn1/asn1_par.c","ASN1_parse",105,108
4,1,44,5,3,"ASN1_parse_dump@111-114@lib/libcrypto/asn1/asn1_par.c","lib/libcrypto/asn1/asn1_par.c","ASN1_parse_dump",111,114
241,96,1598,7,258,"asn1_parse2@117-375@lib/libcrypto/asn1/asn1_par.c","lib/libcrypto/asn1/asn1_par.c","asn1_parse2",117,375
18,5,117,1,19,"ASN1_tag2str@378-397@lib/libcrypto/asn1/asn1_par.c","lib/libcrypto/asn1/asn1_par.c","ASN1_tag2str",378,397
22,4,121,5,26,"i2d_ASN1_bio_stream@117-143@lib/libcrypto/asn1/asn_mime.c","lib/libcrypto/asn1/asn_mime.c","i2d_ASN1_bio_stream",117,143
17,2,100,5,19,"B64_write_ASN1@148-167@lib/libcrypto/asn1/asn_mime.c","lib/libcrypto/asn1/asn_mime.c","B64_write_ASN1",148,167
9,1,68,6,9,"PEM_write_bio_ASN1_stream@172-181@lib/libcrypto/asn1/asn_mime.c","lib/libcrypto/asn1/asn_mime.c","PEM_write_bio_ASN1_stream",172,181
17,3,98,2,16,"b64_read_asn1@184-200@lib/libcrypto/asn1/asn_mime.c","lib/libcrypto/asn1/asn_mime.c","b64_read_asn1",184,200
58,14,280,2,67,"asn1_write_micalg@205-272@lib/libcrypto/asn1/asn_mime.c","lib/libcrypto/asn1/asn_mime.c","asn1_write_micalg",205,272
79,15,521,8,90,"SMIME_write_ASN1@277-367@lib/libcrypto/asn1/asn_mime.c","lib/libcrypto/asn1/asn_mime.c","SMIME_write_ASN1",277,367
30,8,203,5,46,"asn1_output_data@373-419@lib/libcrypto/asn1/asn_mime.c","lib/libcrypto/asn1/asn_mime.c","asn1_output_data",373,419
82,20,512,3,102,"SMIME_read_ASN1@427-529@lib/libcrypto/asn1/asn_mime.c","lib/libcrypto/asn1/asn_mime.c","SMIME_read_ASN1",427,529
29,8,183,3,33,"SMIME_crlf_copy@533-566@lib/libcrypto/asn1/asn_mime.c","lib/libcrypto/asn1/asn_mime.c","SMIME_crlf_copy",533,566
28,7,175,2,28,"SMIME_text@570-598@lib/libcrypto/asn1/asn_mime.c","lib/libcrypto/asn1/asn_mime.c","SMIME_text",570,598
47,13,284,3,48,"multi_split@605-653@lib/libcrypto/asn1/asn_mime.c","lib/libcrypto/asn1/asn_mime.c","multi_split",605,653
102,31,525,1,119,"mime_parse_hdr@667-786@lib/libcrypto/asn1/asn_mime.c","lib/libcrypto/asn1/asn_mime.c","mime_parse_hdr",667,786
4,1,17,1,3,"strip_ends@789-792@lib/libcrypto/asn1/asn_mime.c","lib/libcrypto/asn1/asn_mime.c","strip_ends",789,792
14,5,73,1,17,"strip_start@796-813@lib/libcrypto/asn1/asn_mime.c","lib/libcrypto/asn1/asn_mime.c","strip_start",796,813
20,6,99,1,22,"strip_end@817-839@lib/libcrypto/asn1/asn_mime.c","lib/libcrypto/asn1/asn_mime.c","strip_end",817,839
31,9,194,2,31,"mime_hdr_new@842-873@lib/libcrypto/asn1/asn_mime.c","lib/libcrypto/asn1/asn_mime.c","mime_hdr_new",842,873
31,8,172,3,32,"mime_hdr_addparam@876-908@lib/libcrypto/asn1/asn_mime.c","lib/libcrypto/asn1/asn_mime.c","mime_hdr_addparam",876,908
6,3,75,2,5,"mime_hdr_cmp@911-916@lib/libcrypto/asn1/asn_mime.c","lib/libcrypto/asn1/asn_mime.c","mime_hdr_cmp",911,916
6,3,75,2,5,"mime_param_cmp@919-924@lib/libcrypto/asn1/asn_mime.c","lib/libcrypto/asn1/asn_mime.c","mime_param_cmp",919,924
10,2,54,2,9,"mime_hdr_find@929-938@lib/libcrypto/asn1/asn_mime.c","lib/libcrypto/asn1/asn_mime.c","mime_hdr_find",929,938
10,2,55,2,9,"mime_param_find@941-950@lib/libcrypto/asn1/asn_mime.c","lib/libcrypto/asn1/asn_mime.c","mime_param_find",941,950
8,2,42,1,7,"mime_hdr_free@953-960@lib/libcrypto/asn1/asn_mime.c","lib/libcrypto/asn1/asn_mime.c","mime_hdr_free",953,960
6,1,27,1,5,"mime_param_free@963-968@lib/libcrypto/asn1/asn_mime.c","lib/libcrypto/asn1/asn_mime.c","mime_param_free",963,968
16,7,109,4,17,"mime_bound_check@976-993@lib/libcrypto/asn1/asn_mime.c","lib/libcrypto/asn1/asn_mime.c","mime_bound_check",976,993
15,4,83,2,15,"strip_eol@996-1011@lib/libcrypto/asn1/asn_mime.c","lib/libcrypto/asn1/asn_mime.c","strip_eol",996,1011
20,4,117,2,20,"oid_module_init@73-93@lib/libcrypto/asn1/asn_moid.c","lib/libcrypto/asn1/asn_moid.c","oid_module_init",73,93
4,1,12,1,3,"oid_module_finish@96-99@lib/libcrypto/asn1/asn_moid.c","lib/libcrypto/asn1/asn_moid.c","oid_module_finish",96,99
4,1,15,1,3,"ASN1_add_oid_module@102-105@lib/libcrypto/asn1/asn_moid.c","lib/libcrypto/asn1/asn_moid.c","ASN1_add_oid_module",102,105
41,10,228,2,45,"do_create@113-158@lib/libcrypto/asn1/asn_moid.c","lib/libcrypto/asn1/asn_moid.c","do_create",113,158
11,2,76,4,11,"ASN1_seq_unpack@71-82@lib/libcrypto/asn1/asn_pack.c","lib/libcrypto/asn1/asn_pack.c","ASN1_seq_unpack",71,82
23,5,130,4,23,"ASN1_seq_pack@89-112@lib/libcrypto/asn1/asn_pack.c","lib/libcrypto/asn1/asn_pack.c","ASN1_seq_pack",89,112
9,2,55,2,9,"ASN1_unpack_string@117-126@lib/libcrypto/asn1/asn_pack.c","lib/libcrypto/asn1/asn_pack.c","ASN1_unpack_string",117,126
32,10,170,3,33,"ASN1_pack_string@131-164@lib/libcrypto/asn1/asn_pack.c","lib/libcrypto/asn1/asn_pack.c","ASN1_pack_string",131,164
28,9,152,3,30,"ASN1_item_pack@171-201@lib/libcrypto/asn1/asn_pack.c","lib/libcrypto/asn1/asn_pack.c","ASN1_item_pack",171,201
9,2,58,2,9,"ASN1_item_unpack@206-215@lib/libcrypto/asn1/asn_pack.c","lib/libcrypto/asn1/asn_pack.c","ASN1_item_unpack",206,215
4,1,12,1,3,"BIO_f_asn1@142-145@lib/libcrypto/asn1/bio_asn1.c","lib/libcrypto/asn1/bio_asn1.c","BIO_f_asn1",142,145
15,3,75,1,14,"asn1_bio_new@148-162@lib/libcrypto/asn1/bio_asn1.c","lib/libcrypto/asn1/bio_asn1.c","asn1_bio_new",148,162
17,2,93,2,16,"asn1_bio_init@165-181@lib/libcrypto/asn1/bio_asn1.c","lib/libcrypto/asn1/bio_asn1.c","asn1_bio_init",165,181
13,2,64,1,13,"asn1_bio_free@184-197@lib/libcrypto/asn1/bio_asn1.c","lib/libcrypto/asn1/bio_asn1.c","asn1_bio_free",184,197
76,22,419,3,92,"asn1_bio_write@200-292@lib/libcrypto/asn1/bio_asn1.c","lib/libcrypto/asn1/bio_asn1.c","asn1_bio_write",200,292
25,6,133,4,25,"asn1_bio_flush_ex@295-320@lib/libcrypto/asn1/bio_asn1.c","lib/libcrypto/asn1/bio_asn1.c","asn1_bio_flush_ex",295,320
13,4,81,5,12,"asn1_bio_setup_ex@323-335@lib/libcrypto/asn1/bio_asn1.c","lib/libcrypto/asn1/bio_asn1.c","asn1_bio_setup_ex",323,335
6,2,37,3,5,"asn1_bio_read@338-343@lib/libcrypto/asn1/bio_asn1.c","lib/libcrypto/asn1/bio_asn1.c","asn1_bio_read",338,343
4,1,26,2,3,"asn1_bio_puts@346-349@lib/libcrypto/asn1/bio_asn1.c","lib/libcrypto/asn1/bio_asn1.c","asn1_bio_puts",346,349
6,2,37,3,5,"asn1_bio_gets@352-357@lib/libcrypto/asn1/bio_asn1.c","lib/libcrypto/asn1/bio_asn1.c","asn1_bio_gets",352,357
6,2,40,3,5,"asn1_bio_callback_ctrl@360-365@lib/libcrypto/asn1/bio_asn1.c","lib/libcrypto/asn1/bio_asn1.c","asn1_bio_callback_ctrl",360,365
63,16,325,4,78,"asn1_bio_ctrl@368-446@lib/libcrypto/asn1/bio_asn1.c","lib/libcrypto/asn1/bio_asn1.c","asn1_bio_ctrl",368,446
8,1,47,4,8,"asn1_bio_set_ex@449-457@lib/libcrypto/asn1/bio_asn1.c","lib/libcrypto/asn1/bio_asn1.c","asn1_bio_set_ex",449,457
12,2,64,4,12,"asn1_bio_get_ex@460-472@lib/libcrypto/asn1/bio_asn1.c","lib/libcrypto/asn1/bio_asn1.c","asn1_bio_get_ex",460,472
4,1,28,3,3,"BIO_asn1_set_prefix@475-478@lib/libcrypto/asn1/bio_asn1.c","lib/libcrypto/asn1/bio_asn1.c","BIO_asn1_set_prefix",475,478
4,1,28,3,3,"BIO_asn1_get_prefix@481-484@lib/libcrypto/asn1/bio_asn1.c","lib/libcrypto/asn1/bio_asn1.c","BIO_asn1_get_prefix",481,484
4,1,28,3,3,"BIO_asn1_set_suffix@487-490@lib/libcrypto/asn1/bio_asn1.c","lib/libcrypto/asn1/bio_asn1.c","BIO_asn1_set_suffix",487,490
4,1,28,3,3,"BIO_asn1_get_suffix@493-496@lib/libcrypto/asn1/bio_asn1.c","lib/libcrypto/asn1/bio_asn1.c","BIO_asn1_get_suffix",493,496
34,7,226,3,49,"BIO_new_NDEF@101-150@lib/libcrypto/asn1/bio_ndef.c","lib/libcrypto/asn1/bio_ndef.c","BIO_new_NDEF",101,150
18,3,124,4,23,"ndef_prefix@153-176@lib/libcrypto/asn1/bio_ndef.c","lib/libcrypto/asn1/bio_ndef.c","ndef_prefix",153,176
12,2,68,4,15,"ndef_prefix_free@179-194@lib/libcrypto/asn1/bio_ndef.c","lib/libcrypto/asn1/bio_ndef.c","ndef_prefix_free",179,194
9,2,62,4,8,"ndef_suffix_free@197-205@lib/libcrypto/asn1/bio_ndef.c","lib/libcrypto/asn1/bio_ndef.c","ndef_suffix_free",197,205
28,4,203,4,35,"ndef_suffix@208-243@lib/libcrypto/asn1/bio_ndef.c","lib/libcrypto/asn1/bio_ndef.c","ndef_suffix",208,243
42,13,243,4,47,"d2i_PrivateKey@77-124@lib/libcrypto/asn1/d2i_pr.c","lib/libcrypto/asn1/d2i_pr.c","d2i_PrivateKey",77,124
31,6,178,3,40,"d2i_AutoPrivateKey@129-169@lib/libcrypto/asn1/d2i_pr.c","lib/libcrypto/asn1/d2i_pr.c","d2i_AutoPrivateKey",129,169
46,14,255,4,56,"d2i_PublicKey@80-136@lib/libcrypto/asn1/d2i_pu.c","lib/libcrypto/asn1/d2i_pu.c","d2i_PublicKey",80,136
12,3,75,3,12,"ASN1_TYPE_set_octetstring@67-79@lib/libcrypto/asn1/evp_asn1.c","lib/libcrypto/asn1/evp_asn1.c","ASN1_TYPE_set_octetstring",67,79
18,4,110,3,18,"ASN1_TYPE_get_octetstring@82-100@lib/libcrypto/asn1/evp_asn1.c","lib/libcrypto/asn1/evp_asn1.c","ASN1_TYPE_get_octetstring",82,100
27,7,181,4,32,"ASN1_TYPE_set_int_octetstring@130-162@lib/libcrypto/asn1/evp_asn1.c","lib/libcrypto/asn1/evp_asn1.c","ASN1_TYPE_set_int_octetstring",130,162
26,8,174,4,32,"ASN1_TYPE_get_int_octetstring@165-197@lib/libcrypto/asn1/evp_asn1.c","lib/libcrypto/asn1/evp_asn1.c","ASN1_TYPE_get_int_octetstring",165,197
29,9,215,2,31,"i2a_ASN1_ENUMERATED@68-99@lib/libcrypto/asn1/f_enum.c","lib/libcrypto/asn1/f_enum.c","i2a_ASN1_ENUMERATED",68,99
90,30,599,4,96,"a2i_ASN1_ENUMERATED@102-198@lib/libcrypto/asn1/f_enum.c","lib/libcrypto/asn1/f_enum.c","a2i_ASN1_ENUMERATED",102,198
34,11,245,2,37,"i2a_ASN1_INTEGER@66-103@lib/libcrypto/asn1/f_int.c","lib/libcrypto/asn1/f_int.c","i2a_ASN1_INTEGER",66,103
89,30,600,4,95,"a2i_ASN1_INTEGER@106-201@lib/libcrypto/asn1/f_int.c","lib/libcrypto/asn1/f_int.c","a2i_ASN1_INTEGER",106,201
29,9,218,3,31,"i2a_ASN1_STRING@66-97@lib/libcrypto/asn1/f_string.c","lib/libcrypto/asn1/f_string.c","i2a_ASN1_STRING",66,97
87,28,568,4,94,"a2i_ASN1_STRING@100-194@lib/libcrypto/asn1/f_string.c","lib/libcrypto/asn1/f_string.c","a2i_ASN1_STRING",100,194
14,5,91,2,13,"i2d_PrivateKey@68-81@lib/libcrypto/asn1/i2d_pr.c","lib/libcrypto/asn1/i2d_pr.c","i2d_PrivateKey",68,81
14,4,85,2,19,"i2d_PublicKey@79-98@lib/libcrypto/asn1/i2d_pu.c","lib/libcrypto/asn1/i2d_pu.c","i2d_PublicKey",79,98
5,1,38,3,4,"d2i_NETSCAPE_ENCRYPTED_PKEY@122-126@lib/libcrypto/asn1/n_pkey.c","lib/libcrypto/asn1/n_pkey.c","d2i_NETSCAPE_ENCRYPTED_PKEY",122,126
4,1,29,2,3,"i2d_NETSCAPE_ENCRYPTED_PKEY@129-132@lib/libcrypto/asn1/n_pkey.c","lib/libcrypto/asn1/n_pkey.c","i2d_NETSCAPE_ENCRYPTED_PKEY",129,132
4,1,17,1,3,"NETSCAPE_ENCRYPTED_PKEY_new@135-138@lib/libcrypto/asn1/n_pkey.c","lib/libcrypto/asn1/n_pkey.c","NETSCAPE_ENCRYPTED_PKEY_new",135,138
4,1,20,1,3,"NETSCAPE_ENCRYPTED_PKEY_free@141-144@lib/libcrypto/asn1/n_pkey.c","lib/libcrypto/asn1/n_pkey.c","NETSCAPE_ENCRYPTED_PKEY_free",141,144
5,1,38,3,4,"d2i_NETSCAPE_PKEY@179-183@lib/libcrypto/asn1/n_pkey.c","lib/libcrypto/asn1/n_pkey.c","d2i_NETSCAPE_PKEY",179,183
4,1,29,2,3,"i2d_NETSCAPE_PKEY@186-189@lib/libcrypto/asn1/n_pkey.c","lib/libcrypto/asn1/n_pkey.c","i2d_NETSCAPE_PKEY",186,189
4,1,17,1,3,"NETSCAPE_PKEY_new@192-195@lib/libcrypto/asn1/n_pkey.c","lib/libcrypto/asn1/n_pkey.c","NETSCAPE_PKEY_new",192,195
4,1,20,1,3,"NETSCAPE_PKEY_free@198-201@lib/libcrypto/asn1/n_pkey.c","lib/libcrypto/asn1/n_pkey.c","NETSCAPE_PKEY_free",198,201
5,1,48,3,4,"i2d_Netscape_RSA@207-211@lib/libcrypto/asn1/n_pkey.c","lib/libcrypto/asn1/n_pkey.c","i2d_Netscape_RSA",207,211
85,18,660,4,107,"i2d_RSA_NET@214-321@lib/libcrypto/asn1/n_pkey.c","lib/libcrypto/asn1/n_pkey.c","i2d_RSA_NET",214,321
5,1,53,4,4,"d2i_Netscape_RSA@325-329@lib/libcrypto/asn1/n_pkey.c","lib/libcrypto/asn1/n_pkey.c","d2i_Netscape_RSA",325,329
31,7,203,5,37,"d2i_RSA_NET@332-369@lib/libcrypto/asn1/n_pkey.c","lib/libcrypto/asn1/n_pkey.c","d2i_RSA_NET",332,369
49,10,389,4,56,"d2i_RSA_NET_2@372-428@lib/libcrypto/asn1/n_pkey.c","lib/libcrypto/asn1/n_pkey.c","d2i_RSA_NET_2",372,428
9,2,53,4,8,"nsseq_cb@66-74@lib/libcrypto/asn1/nsseq.c","lib/libcrypto/asn1/nsseq.c","nsseq_cb",66,74
5,1,38,3,4,"d2i_NETSCAPE_CERT_SEQUENCE@107-111@lib/libcrypto/asn1/nsseq.c","lib/libcrypto/asn1/nsseq.c","d2i_NETSCAPE_CERT_SEQUENCE",107,111
4,1,28,2,3,"i2d_NETSCAPE_CERT_SEQUENCE@114-117@lib/libcrypto/asn1/nsseq.c","lib/libcrypto/asn1/nsseq.c","i2d_NETSCAPE_CERT_SEQUENCE",114,117
4,1,17,1,3,"NETSCAPE_CERT_SEQUENCE_new@120-123@lib/libcrypto/asn1/nsseq.c","lib/libcrypto/asn1/nsseq.c","NETSCAPE_CERT_SEQUENCE_new",120,123
4,1,20,1,3,"NETSCAPE_CERT_SEQUENCE_free@126-129@lib/libcrypto/asn1/nsseq.c","lib/libcrypto/asn1/nsseq.c","NETSCAPE_CERT_SEQUENCE_free",126,129
5,1,38,3,4,"d2i_PBEPARAM@93-97@lib/libcrypto/asn1/p5_pbe.c","lib/libcrypto/asn1/p5_pbe.c","d2i_PBEPARAM",93,97
4,1,28,2,3,"i2d_PBEPARAM@100-103@lib/libcrypto/asn1/p5_pbe.c","lib/libcrypto/asn1/p5_pbe.c","i2d_PBEPARAM",100,103
4,1,17,1,3,"PBEPARAM_new@106-109@lib/libcrypto/asn1/p5_pbe.c","lib/libcrypto/asn1/p5_pbe.c","PBEPARAM_new",106,109
4,1,20,1,3,"PBEPARAM_free@112-115@lib/libcrypto/asn1/p5_pbe.c","lib/libcrypto/asn1/p5_pbe.c","PBEPARAM_free",112,115
42,10,229,5,46,"PKCS5_pbe_set0_algor@121-167@lib/libcrypto/asn1/p5_pbe.c","lib/libcrypto/asn1/p5_pbe.c","PKCS5_pbe_set0_algor",121,167
13,3,70,4,14,"PKCS5_pbe_set@172-186@lib/libcrypto/asn1/p5_pbe.c","lib/libcrypto/asn1/p5_pbe.c","PKCS5_pbe_set",172,186
5,1,38,3,4,"d2i_PBE2PARAM@93-97@lib/libcrypto/asn1/p5_pbev2.c","lib/libcrypto/asn1/p5_pbev2.c","d2i_PBE2PARAM",93,97
4,1,28,2,3,"i2d_PBE2PARAM@100-103@lib/libcrypto/asn1/p5_pbev2.c","lib/libcrypto/asn1/p5_pbev2.c","i2d_PBE2PARAM",100,103
4,1,17,1,3,"PBE2PARAM_new@106-109@lib/libcrypto/asn1/p5_pbev2.c","lib/libcrypto/asn1/p5_pbev2.c","PBE2PARAM_new",106,109
4,1,20,1,3,"PBE2PARAM_free@112-115@lib/libcrypto/asn1/p5_pbev2.c","lib/libcrypto/asn1/p5_pbev2.c","PBE2PARAM_free",112,115
5,1,38,3,4,"d2i_PBKDF2PARAM@153-157@lib/libcrypto/asn1/p5_pbev2.c","lib/libcrypto/asn1/p5_pbev2.c","d2i_PBKDF2PARAM",153,157
4,1,28,2,3,"i2d_PBKDF2PARAM@160-163@lib/libcrypto/asn1/p5_pbev2.c","lib/libcrypto/asn1/p5_pbev2.c","i2d_PBKDF2PARAM",160,163
4,1,17,1,3,"PBKDF2PARAM_new@166-169@lib/libcrypto/asn1/p5_pbev2.c","lib/libcrypto/asn1/p5_pbev2.c","PBKDF2PARAM_new",166,169
4,1,20,1,3,"PBKDF2PARAM_free@172-175@lib/libcrypto/asn1/p5_pbev2.c","lib/libcrypto/asn1/p5_pbev2.c","PBKDF2PARAM_free",172,175
68,15,437,6,101,"PKCS5_pbe2_set_iv@184-285@lib/libcrypto/asn1/p5_pbev2.c","lib/libcrypto/asn1/p5_pbev2.c","PKCS5_pbe2_set_iv",184,285
5,1,37,4,4,"PKCS5_pbe2_set@288-292@lib/libcrypto/asn1/p5_pbev2.c","lib/libcrypto/asn1/p5_pbev2.c","PKCS5_pbe2_set",288,292
56,17,350,5,77,"PKCS5_pbkdf2_set@295-372@lib/libcrypto/asn1/p5_pbev2.c","lib/libcrypto/asn1/p5_pbev2.c","PKCS5_pbkdf2_set",295,372
12,5,91,4,12,"pkey_cb@67-79@lib/libcrypto/asn1/p8_pkey.c","lib/libcrypto/asn1/p8_pkey.c","pkey_cb",67,79
5,1,38,3,4,"d2i_PKCS8_PRIV_KEY_INFO@120-124@lib/libcrypto/asn1/p8_pkey.c","lib/libcrypto/asn1/p8_pkey.c","d2i_PKCS8_PRIV_KEY_INFO",120,124
4,1,28,2,3,"i2d_PKCS8_PRIV_KEY_INFO@127-130@lib/libcrypto/asn1/p8_pkey.c","lib/libcrypto/asn1/p8_pkey.c","i2d_PKCS8_PRIV_KEY_INFO",127,130
4,1,17,1,3,"PKCS8_PRIV_KEY_INFO_new@133-136@lib/libcrypto/asn1/p8_pkey.c","lib/libcrypto/asn1/p8_pkey.c","PKCS8_PRIV_KEY_INFO_new",133,136
4,1,20,1,3,"PKCS8_PRIV_KEY_INFO_free@139-142@lib/libcrypto/asn1/p8_pkey.c","lib/libcrypto/asn1/p8_pkey.c","PKCS8_PRIV_KEY_INFO_free",139,142
30,8,167,7,31,"PKCS8_pkey_set0@145-176@lib/libcrypto/asn1/p8_pkey.c","lib/libcrypto/asn1/p8_pkey.c","PKCS8_pkey_set0",145,176
23,7,158,5,22,"PKCS8_pkey_get0@179-201@lib/libcrypto/asn1/p8_pkey.c","lib/libcrypto/asn1/p8_pkey.c","PKCS8_pkey_get0",179,201
17,4,102,4,17,"ASN1_BIT_STRING_name_print@66-83@lib/libcrypto/asn1/t_bitst.c","lib/libcrypto/asn1/t_bitst.c","ASN1_BIT_STRING_name_print",66,83
13,4,64,4,13,"ASN1_BIT_STRING_set_asc@86-99@lib/libcrypto/asn1/t_bitst.c","lib/libcrypto/asn1/t_bitst.c","ASN1_BIT_STRING_set_asc",86,99
10,4,62,2,10,"ASN1_BIT_STRING_num_asc@102-112@lib/libcrypto/asn1/t_bitst.c","lib/libcrypto/asn1/t_bitst.c","ASN1_BIT_STRING_num_asc",102,112
13,2,74,2,13,"X509_CRL_print_fp@69-82@lib/libcrypto/asn1/t_crl.c","lib/libcrypto/asn1/t_crl.c","X509_CRL_print_fp",69,82
49,7,347,2,55,"X509_CRL_print@85-140@lib/libcrypto/asn1/t_crl.c","lib/libcrypto/asn1/t_crl.c","X509_CRL_print",85,140
45,18,339,5,48,"ASN1_bn_print@66-114@lib/libcrypto/asn1/t_pkey.c","lib/libcrypto/asn1/t_pkey.c","ASN1_bn_print",66,114
13,2,74,2,13,"X509_REQ_print_fp@78-91@lib/libcrypto/asn1/t_req.c","lib/libcrypto/asn1/t_req.c","X509_REQ_print_fp",78,91
156,47,1024,4,167,"X509_REQ_print_ex@94-261@lib/libcrypto/asn1/t_req.c","lib/libcrypto/asn1/t_req.c","X509_REQ_print_ex",94,261
4,1,24,2,3,"X509_REQ_print@264-267@lib/libcrypto/asn1/t_req.c","lib/libcrypto/asn1/t_req.c","X509_REQ_print",264,267
34,8,265,2,35,"NETSCAPE_SPKI_print@77-112@lib/libcrypto/asn1/t_spki.c","lib/libcrypto/asn1/t_spki.c","NETSCAPE_SPKI_print",77,112
4,1,24,2,3,"X509_print_fp@83-86@lib/libcrypto/asn1/t_x509.c","lib/libcrypto/asn1/t_x509.c","X509_print_fp",83,86
13,2,86,4,13,"X509_print_ex_fp@89-102@lib/libcrypto/asn1/t_x509.c","lib/libcrypto/asn1/t_x509.c","X509_print_ex_fp",89,102
4,1,24,2,3,"X509_print@105-108@lib/libcrypto/asn1/t_x509.c","lib/libcrypto/asn1/t_x509.c","X509_print",105,108
126,46,863,4,136,"X509_print_ex@111-247@lib/libcrypto/asn1/t_x509.c","lib/libcrypto/asn1/t_x509.c","X509_print_ex",111,247
37,10,271,2,46,"X509_ocspid_print@249-295@lib/libcrypto/asn1/t_x509.c","lib/libcrypto/asn1/t_x509.c","X509_ocspid_print",249,295
21,8,150,3,22,"X509_signature_dump@298-320@lib/libcrypto/asn1/t_x509.c","lib/libcrypto/asn1/t_x509.c","X509_signature_dump",298,320
23,9,156,3,23,"X509_signature_print@323-346@lib/libcrypto/asn1/t_x509.c","lib/libcrypto/asn1/t_x509.c","X509_signature_print",323,346
27,11,192,2,27,"ASN1_STRING_print@349-376@lib/libcrypto/asn1/t_x509.c","lib/libcrypto/asn1/t_x509.c","ASN1_STRING_print",349,376
9,3,59,2,8,"ASN1_TIME_print@379-387@lib/libcrypto/asn1/t_x509.c","lib/libcrypto/asn1/t_x509.c","ASN1_TIME_print",379,387
47,20,482,2,51,"ASN1_GENERALIZEDTIME_print@395-446@lib/libcrypto/asn1/t_x509.c","lib/libcrypto/asn1/t_x509.c","ASN1_GENERALIZEDTIME_print",395,446
37,16,396,2,40,"ASN1_UTCTIME_print@449-489@lib/libcrypto/asn1/t_x509.c","lib/libcrypto/asn1/t_x509.c","ASN1_UTCTIME_print",449,489
42,17,274,3,45,"X509_NAME_print@492-537@lib/libcrypto/asn1/t_x509.c","lib/libcrypto/asn1/t_x509.c","X509_NAME_print",492,537
50,12,349,3,49,"X509_CERT_AUX_print@69-118@lib/libcrypto/asn1/t_x509a.c","lib/libcrypto/asn1/t_x509a.c","X509_CERT_AUX_print",69,118
6,3,30,1,5,"ASN1_tag2bit@102-107@lib/libcrypto/asn1/tasn_dec.c","lib/libcrypto/asn1/tasn_dec.c","ASN1_tag2bit",102,107
12,3,79,4,12,"ASN1_item_d2i@124-136@lib/libcrypto/asn1/tasn_dec.c","lib/libcrypto/asn1/tasn_dec.c","ASN1_item_d2i",124,136
7,1,48,4,7,"ASN1_template_d2i@139-146@lib/libcrypto/asn1/tasn_dec.c","lib/libcrypto/asn1/tasn_dec.c","ASN1_template_d2i",139,146
226,64,1359,8,295,"ASN1_item_ex_d2i@154-449@lib/libcrypto/asn1/tasn_dec.c","lib/libcrypto/asn1/tasn_dec.c","ASN1_item_ex_d2i",154,449
52,10,287,6,66,"asn1_template_ex_d2i@456-522@lib/libcrypto/asn1/tasn_dec.c","lib/libcrypto/asn1/tasn_dec.c","asn1_template_ex_d2i",456,522
100,21,558,6,114,"asn1_template_noexp_d2i@525-639@lib/libcrypto/asn1/tasn_dec.c","lib/libcrypto/asn1/tasn_dec.c","asn1_template_noexp_d2i",525,639
101,24,584,8,124,"asn1_d2i_ex_primitive@642-766@lib/libcrypto/asn1/tasn_dec.c","lib/libcrypto/asn1/tasn_dec.c","asn1_d2i_ex_primitive",642,766
121,47,626,6,135,"asn1_ex_c2i@771-906@lib/libcrypto/asn1/tasn_dec.c","lib/libcrypto/asn1/tasn_dec.c","asn1_ex_c2i",771,906
37,8,177,3,44,"asn1_find_end@916-960@lib/libcrypto/asn1/tasn_dec.c","lib/libcrypto/asn1/tasn_dec.c","asn1_find_end",916,960
46,13,255,7,54,"asn1_collect@977-1031@lib/libcrypto/asn1/tasn_dec.c","lib/libcrypto/asn1/tasn_dec.c","asn1_collect",977,1031
14,3,76,3,13,"collect_data@1034-1047@lib/libcrypto/asn1/tasn_dec.c","lib/libcrypto/asn1/tasn_dec.c","collect_data",1034,1047
12,4,60,2,12,"asn1_check_eoc@1052-1064@lib/libcrypto/asn1/tasn_dec.c","lib/libcrypto/asn1/tasn_dec.c","asn1_check_eoc",1052,1064
62,17,362,11,74,"asn1_check_tlen@1074-1148@lib/libcrypto/asn1/tasn_dec.c","lib/libcrypto/asn1/tasn_dec.c","asn1_check_tlen",1074,1148
4,1,30,3,3,"ASN1_item_ndef_i2d@82-85@lib/libcrypto/asn1/tasn_enc.c","lib/libcrypto/asn1/tasn_enc.c","ASN1_item_ndef_i2d",82,85
4,1,30,3,3,"ASN1_item_i2d@88-91@lib/libcrypto/asn1/tasn_enc.c","lib/libcrypto/asn1/tasn_enc.c","ASN1_item_i2d",88,91
19,5,128,4,19,"asn1_item_flags_i2d@103-122@lib/libcrypto/asn1/tasn_enc.c","lib/libcrypto/asn1/tasn_enc.c","asn1_item_flags_i2d",103,122
89,32,619,5,113,"ASN1_item_ex_i2d@130-243@lib/libcrypto/asn1/tasn_enc.c","lib/libcrypto/asn1/tasn_enc.c","ASN1_item_ex_i2d",130,243
5,1,33,3,4,"ASN1_template_i2d@246-250@lib/libcrypto/asn1/tasn_enc.c","lib/libcrypto/asn1/tasn_enc.c","ASN1_template_i2d",246,250
88,23,535,5,133,"asn1_template_ex_i2d@253-386@lib/libcrypto/asn1/tasn_enc.c","lib/libcrypto/asn1/tasn_enc.c","asn1_template_ex_i2d",253,386
10,3,82,2,10,"der_cmp@397-407@lib/libcrypto/asn1/tasn_enc.c","lib/libcrypto/asn1/tasn_enc.c","der_cmp",397,407
50,11,380,6,58,"asn1_set_seq_out@412-470@lib/libcrypto/asn1/tasn_enc.c","lib/libcrypto/asn1/tasn_enc.c","asn1_set_seq_out",412,470
35,11,193,5,56,"asn1_i2d_ex_primitive@473-529@lib/libcrypto/asn1/tasn_enc.c","lib/libcrypto/asn1/tasn_enc.c","asn1_i2d_ex_primitive",473,529
98,43,507,4,118,"asn1_ex_i2c@534-652@lib/libcrypto/asn1/tasn_enc.c","lib/libcrypto/asn1/tasn_enc.c","asn1_ex_i2c",534,652
4,1,23,2,3,"ASN1_item_free@71-74@lib/libcrypto/asn1/tasn_fre.c","lib/libcrypto/asn1/tasn_fre.c","ASN1_item_free",71,74
4,1,22,2,3,"ASN1_item_ex_free@77-80@lib/libcrypto/asn1/tasn_fre.c","lib/libcrypto/asn1/tasn_fre.c","ASN1_item_ex_free",77,80
74,27,437,3,85,"asn1_item_combine_free@83-168@lib/libcrypto/asn1/tasn_fre.c","lib/libcrypto/asn1/tasn_fre.c","asn1_item_combine_free",83,168
17,3,112,2,16,"ASN1_template_free@171-187@lib/libcrypto/asn1/tasn_fre.c","lib/libcrypto/asn1/tasn_fre.c","ASN1_template_free",171,187
48,15,236,2,53,"ASN1_primitive_free@190-243@lib/libcrypto/asn1/tasn_fre.c","lib/libcrypto/asn1/tasn_fre.c","ASN1_primitive_free",190,243
7,2,33,1,6,"ASN1_item_new@74-80@lib/libcrypto/asn1/tasn_new.c","lib/libcrypto/asn1/tasn_new.c","ASN1_item_new",74,80
4,1,23,2,3,"ASN1_item_ex_new@85-88@lib/libcrypto/asn1/tasn_new.c","lib/libcrypto/asn1/tasn_new.c","ASN1_item_ex_new",85,88
96,45,532,3,118,"asn1_item_ex_combine_new@91-209@lib/libcrypto/asn1/tasn_new.c","lib/libcrypto/asn1/tasn_new.c","asn1_item_ex_combine_new",91,209
27,10,116,2,30,"asn1_item_clear@212-242@lib/libcrypto/asn1/tasn_new.c","lib/libcrypto/asn1/tasn_new.c","asn1_item_clear",212,242
32,9,164,2,40,"ASN1_template_new@245-285@lib/libcrypto/asn1/tasn_new.c","lib/libcrypto/asn1/tasn_new.c","ASN1_template_new",245,285
7,2,40,2,7,"asn1_template_clear@288-295@lib/libcrypto/asn1/tasn_new.c","lib/libcrypto/asn1/tasn_new.c","asn1_template_clear",288,295
44,15,238,2,49,"ASN1_primitive_new@303-352@lib/libcrypto/asn1/tasn_new.c","lib/libcrypto/asn1/tasn_new.c","ASN1_primitive_new",303,352
20,7,105,2,19,"asn1_primitive_clear@355-374@lib/libcrypto/asn1/tasn_new.c","lib/libcrypto/asn1/tasn_new.c","asn1_primitive_clear",355,374
15,2,69,1,14,"ASN1_PCTX_new@85-99@lib/libcrypto/asn1/tasn_prn.c","lib/libcrypto/asn1/tasn_prn.c","ASN1_PCTX_new",85,99
4,1,13,1,3,"ASN1_PCTX_free@102-105@lib/libcrypto/asn1/tasn_prn.c","lib/libcrypto/asn1/tasn_prn.c","ASN1_PCTX_free",102,105
4,1,13,1,3,"ASN1_PCTX_get_flags@108-111@lib/libcrypto/asn1/tasn_prn.c","lib/libcrypto/asn1/tasn_prn.c","ASN1_PCTX_get_flags",108,111
4,1,18,2,3,"ASN1_PCTX_set_flags@114-117@lib/libcrypto/asn1/tasn_prn.c","lib/libcrypto/asn1/tasn_prn.c","ASN1_PCTX_set_flags",114,117
4,1,13,1,3,"ASN1_PCTX_get_nm_flags@120-123@lib/libcrypto/asn1/tasn_prn.c","lib/libcrypto/asn1/tasn_prn.c","ASN1_PCTX_get_nm_flags",120,123
4,1,18,2,3,"ASN1_PCTX_set_nm_flags@126-129@lib/libcrypto/asn1/tasn_prn.c","lib/libcrypto/asn1/tasn_prn.c","ASN1_PCTX_set_nm_flags",126,129
4,1,13,1,3,"ASN1_PCTX_get_cert_flags@132-135@lib/libcrypto/asn1/tasn_prn.c","lib/libcrypto/asn1/tasn_prn.c","ASN1_PCTX_get_cert_flags",132,135
4,1,18,2,3,"ASN1_PCTX_set_cert_flags@138-141@lib/libcrypto/asn1/tasn_prn.c","lib/libcrypto/asn1/tasn_prn.c","ASN1_PCTX_set_cert_flags",138,141
4,1,13,1,3,"ASN1_PCTX_get_oid_flags@144-147@lib/libcrypto/asn1/tasn_prn.c","lib/libcrypto/asn1/tasn_prn.c","ASN1_PCTX_get_oid_flags",144,147
4,1,18,2,3,"ASN1_PCTX_set_oid_flags@150-153@lib/libcrypto/asn1/tasn_prn.c","lib/libcrypto/asn1/tasn_prn.c","ASN1_PCTX_set_oid_flags",150,153
4,1,13,1,3,"ASN1_PCTX_get_str_flags@156-159@lib/libcrypto/asn1/tasn_prn.c","lib/libcrypto/asn1/tasn_prn.c","ASN1_PCTX_get_str_flags",156,159
4,1,18,2,3,"ASN1_PCTX_set_str_flags@162-165@lib/libcrypto/asn1/tasn_prn.c","lib/libcrypto/asn1/tasn_prn.c","ASN1_PCTX_set_str_flags",162,165
13,3,81,5,13,"ASN1_item_print@184-197@lib/libcrypto/asn1/tasn_prn.c","lib/libcrypto/asn1/tasn_prn.c","ASN1_item_print",184,197
115,47,709,8,131,"asn1_item_print_ctx@200-331@lib/libcrypto/asn1/tasn_prn.c","lib/libcrypto/asn1/tasn_prn.c","asn1_item_print_ctx",200,331
51,17,350,5,53,"asn1_template_print_ctx@334-387@lib/libcrypto/asn1/tasn_prn.c","lib/libcrypto/asn1/tasn_prn.c","asn1_template_print_ctx",334,387
35,15,208,5,35,"asn1_print_fsname@390-425@lib/libcrypto/asn1/tasn_prn.c","lib/libcrypto/asn1/tasn_prn.c","asn1_print_fsname",390,425
18,4,71,3,22,"asn1_print_boolean_ctx@428-450@lib/libcrypto/asn1/tasn_prn.c","lib/libcrypto/asn1/tasn_prn.c","asn1_print_boolean_ctx",428,450
10,2,58,3,9,"asn1_print_integer_ctx@453-462@lib/libcrypto/asn1/tasn_prn.c","lib/libcrypto/asn1/tasn_prn.c","asn1_print_integer_ctx",453,462
12,3,81,3,11,"asn1_print_oid_ctx@465-476@lib/libcrypto/asn1/tasn_prn.c","lib/libcrypto/asn1/tasn_prn.c","asn1_print_oid_ctx",465,476
15,6,104,4,14,"asn1_print_obstring_ctx@479-493@lib/libcrypto/asn1/tasn_prn.c","lib/libcrypto/asn1/tasn_prn.c","asn1_print_obstring_ctx",479,493
90,30,524,7,100,"asn1_primitive_print@496-596@lib/libcrypto/asn1/tasn_prn.c","lib/libcrypto/asn1/tasn_prn.c","asn1_primitive_print",496,596
5,1,38,3,4,"d2i_ASN1_INTEGER@71-75@lib/libcrypto/asn1/tasn_typ.c","lib/libcrypto/asn1/tasn_typ.c","d2i_ASN1_INTEGER",71,75
4,1,28,2,3,"i2d_ASN1_INTEGER@78-81@lib/libcrypto/asn1/tasn_typ.c","lib/libcrypto/asn1/tasn_typ.c","i2d_ASN1_INTEGER",78,81
4,1,17,1,3,"ASN1_INTEGER_new@84-87@lib/libcrypto/asn1/tasn_typ.c","lib/libcrypto/asn1/tasn_typ.c","ASN1_INTEGER_new",84,87
4,1,20,1,3,"ASN1_INTEGER_free@90-93@lib/libcrypto/asn1/tasn_typ.c","lib/libcrypto/asn1/tasn_typ.c","ASN1_INTEGER_free",90,93
5,1,38,3,4,"d2i_ASN1_ENUMERATED@103-107@lib/libcrypto/asn1/tasn_typ.c","lib/libcrypto/asn1/tasn_typ.c","d2i_ASN1_ENUMERATED",103,107
4,1,28,2,3,"i2d_ASN1_ENUMERATED@110-113@lib/libcrypto/asn1/tasn_typ.c","lib/libcrypto/asn1/tasn_typ.c","i2d_ASN1_ENUMERATED",110,113
4,1,17,1,3,"ASN1_ENUMERATED_new@116-119@lib/libcrypto/asn1/tasn_typ.c","lib/libcrypto/asn1/tasn_typ.c","ASN1_ENUMERATED_new",116,119
4,1,20,1,3,"ASN1_ENUMERATED_free@122-125@lib/libcrypto/asn1/tasn_typ.c","lib/libcrypto/asn1/tasn_typ.c","ASN1_ENUMERATED_free",122,125
5,1,38,3,4,"d2i_ASN1_BIT_STRING@135-139@lib/libcrypto/asn1/tasn_typ.c","lib/libcrypto/asn1/tasn_typ.c","d2i_ASN1_BIT_STRING",135,139
4,1,28,2,3,"i2d_ASN1_BIT_STRING@142-145@lib/libcrypto/asn1/tasn_typ.c","lib/libcrypto/asn1/tasn_typ.c","i2d_ASN1_BIT_STRING",142,145
4,1,17,1,3,"ASN1_BIT_STRING_new@148-151@lib/libcrypto/asn1/tasn_typ.c","lib/libcrypto/asn1/tasn_typ.c","ASN1_BIT_STRING_new",148,151
4,1,20,1,3,"ASN1_BIT_STRING_free@154-157@lib/libcrypto/asn1/tasn_typ.c","lib/libcrypto/asn1/tasn_typ.c","ASN1_BIT_STRING_free",154,157
5,1,38,3,4,"d2i_ASN1_OCTET_STRING@167-171@lib/libcrypto/asn1/tasn_typ.c","lib/libcrypto/asn1/tasn_typ.c","d2i_ASN1_OCTET_STRING",167,171
4,1,28,2,3,"i2d_ASN1_OCTET_STRING@174-177@lib/libcrypto/asn1/tasn_typ.c","lib/libcrypto/asn1/tasn_typ.c","i2d_ASN1_OCTET_STRING",174,177
4,1,17,1,3,"ASN1_OCTET_STRING_new@180-183@lib/libcrypto/asn1/tasn_typ.c","lib/libcrypto/asn1/tasn_typ.c","ASN1_OCTET_STRING_new",180,183
4,1,20,1,3,"ASN1_OCTET_STRING_free@186-189@lib/libcrypto/asn1/tasn_typ.c","lib/libcrypto/asn1/tasn_typ.c","ASN1_OCTET_STRING_free",186,189
5,1,38,3,4,"d2i_ASN1_NULL@199-203@lib/libcrypto/asn1/tasn_typ.c","lib/libcrypto/asn1/tasn_typ.c","d2i_ASN1_NULL",199,203
4,1,28,2,3,"i2d_ASN1_NULL@206-209@lib/libcrypto/asn1/tasn_typ.c","lib/libcrypto/asn1/tasn_typ.c","i2d_ASN1_NULL",206,209
4,1,17,1,3,"ASN1_NULL_new@212-215@lib/libcrypto/asn1/tasn_typ.c","lib/libcrypto/asn1/tasn_typ.c","ASN1_NULL_new",212,215
4,1,20,1,3,"ASN1_NULL_free@218-221@lib/libcrypto/asn1/tasn_typ.c","lib/libcrypto/asn1/tasn_typ.c","ASN1_NULL_free",218,221
5,1,38,3,4,"d2i_ASN1_UTF8STRING@238-242@lib/libcrypto/asn1/tasn_typ.c","lib/libcrypto/asn1/tasn_typ.c","d2i_ASN1_UTF8STRING",238,242
4,1,28,2,3,"i2d_ASN1_UTF8STRING@245-248@lib/libcrypto/asn1/tasn_typ.c","lib/libcrypto/asn1/tasn_typ.c","i2d_ASN1_UTF8STRING",245,248
4,1,17,1,3,"ASN1_UTF8STRING_new@251-254@lib/libcrypto/asn1/tasn_typ.c","lib/libcrypto/asn1/tasn_typ.c","ASN1_UTF8STRING_new",251,254
4,1,20,1,3,"ASN1_UTF8STRING_free@257-260@lib/libcrypto/asn1/tasn_typ.c","lib/libcrypto/asn1/tasn_typ.c","ASN1_UTF8STRING_free",257,260
6,1,38,3,5,"d2i_ASN1_PRINTABLESTRING@270-275@lib/libcrypto/asn1/tasn_typ.c","lib/libcrypto/asn1/tasn_typ.c","d2i_ASN1_PRINTABLESTRING",270,275
4,1,28,2,3,"i2d_ASN1_PRINTABLESTRING@278-281@lib/libcrypto/asn1/tasn_typ.c","lib/libcrypto/asn1/tasn_typ.c","i2d_ASN1_PRINTABLESTRING",278,281
4,1,17,1,3,"ASN1_PRINTABLESTRING_new@284-287@lib/libcrypto/asn1/tasn_typ.c","lib/libcrypto/asn1/tasn_typ.c","ASN1_PRINTABLESTRING_new",284,287
4,1,20,1,3,"ASN1_PRINTABLESTRING_free@290-293@lib/libcrypto/asn1/tasn_typ.c","lib/libcrypto/asn1/tasn_typ.c","ASN1_PRINTABLESTRING_free",290,293
5,1,38,3,4,"d2i_ASN1_T61STRING@303-307@lib/libcrypto/asn1/tasn_typ.c","lib/libcrypto/asn1/tasn_typ.c","d2i_ASN1_T61STRING",303,307
4,1,28,2,3,"i2d_ASN1_T61STRING@310-313@lib/libcrypto/asn1/tasn_typ.c","lib/libcrypto/asn1/tasn_typ.c","i2d_ASN1_T61STRING",310,313
4,1,17,1,3,"ASN1_T61STRING_new@316-319@lib/libcrypto/asn1/tasn_typ.c","lib/libcrypto/asn1/tasn_typ.c","ASN1_T61STRING_new",316,319
4,1,20,1,3,"ASN1_T61STRING_free@322-325@lib/libcrypto/asn1/tasn_typ.c","lib/libcrypto/asn1/tasn_typ.c","ASN1_T61STRING_free",322,325
5,1,38,3,4,"d2i_ASN1_IA5STRING@335-339@lib/libcrypto/asn1/tasn_typ.c","lib/libcrypto/asn1/tasn_typ.c","d2i_ASN1_IA5STRING",335,339
4,1,28,2,3,"i2d_ASN1_IA5STRING@342-345@lib/libcrypto/asn1/tasn_typ.c","lib/libcrypto/asn1/tasn_typ.c","i2d_ASN1_IA5STRING",342,345
4,1,17,1,3,"ASN1_IA5STRING_new@348-351@lib/libcrypto/asn1/tasn_typ.c","lib/libcrypto/asn1/tasn_typ.c","ASN1_IA5STRING_new",348,351
4,1,20,1,3,"ASN1_IA5STRING_free@354-357@lib/libcrypto/asn1/tasn_typ.c","lib/libcrypto/asn1/tasn_typ.c","ASN1_IA5STRING_free",354,357
6,1,38,3,5,"d2i_ASN1_GENERALSTRING@367-372@lib/libcrypto/asn1/tasn_typ.c","lib/libcrypto/asn1/tasn_typ.c","d2i_ASN1_GENERALSTRING",367,372
4,1,28,2,3,"i2d_ASN1_GENERALSTRING@375-378@lib/libcrypto/asn1/tasn_typ.c","lib/libcrypto/asn1/tasn_typ.c","i2d_ASN1_GENERALSTRING",375,378
4,1,17,1,3,"ASN1_GENERALSTRING_new@381-384@lib/libcrypto/asn1/tasn_typ.c","lib/libcrypto/asn1/tasn_typ.c","ASN1_GENERALSTRING_new",381,384
4,1,20,1,3,"ASN1_GENERALSTRING_free@387-390@lib/libcrypto/asn1/tasn_typ.c","lib/libcrypto/asn1/tasn_typ.c","ASN1_GENERALSTRING_free",387,390
5,1,38,3,4,"d2i_ASN1_UTCTIME@400-404@lib/libcrypto/asn1/tasn_typ.c","lib/libcrypto/asn1/tasn_typ.c","d2i_ASN1_UTCTIME",400,404
4,1,28,2,3,"i2d_ASN1_UTCTIME@407-410@lib/libcrypto/asn1/tasn_typ.c","lib/libcrypto/asn1/tasn_typ.c","i2d_ASN1_UTCTIME",407,410
4,1,17,1,3,"ASN1_UTCTIME_new@413-416@lib/libcrypto/asn1/tasn_typ.c","lib/libcrypto/asn1/tasn_typ.c","ASN1_UTCTIME_new",413,416
4,1,20,1,3,"ASN1_UTCTIME_free@419-422@lib/libcrypto/asn1/tasn_typ.c","lib/libcrypto/asn1/tasn_typ.c","ASN1_UTCTIME_free",419,422
6,1,38,3,5,"d2i_ASN1_GENERALIZEDTIME@432-437@lib/libcrypto/asn1/tasn_typ.c","lib/libcrypto/asn1/tasn_typ.c","d2i_ASN1_GENERALIZEDTIME",432,437
4,1,28,2,3,"i2d_ASN1_GENERALIZEDTIME@440-443@lib/libcrypto/asn1/tasn_typ.c","lib/libcrypto/asn1/tasn_typ.c","i2d_ASN1_GENERALIZEDTIME",440,443
4,1,17,1,3,"ASN1_GENERALIZEDTIME_new@446-449@lib/libcrypto/asn1/tasn_typ.c","lib/libcrypto/asn1/tasn_typ.c","ASN1_GENERALIZEDTIME_new",446,449
4,1,20,1,3,"ASN1_GENERALIZEDTIME_free@452-455@lib/libcrypto/asn1/tasn_typ.c","lib/libcrypto/asn1/tasn_typ.c","ASN1_GENERALIZEDTIME_free",452,455
6,1,38,3,5,"d2i_ASN1_VISIBLESTRING@465-470@lib/libcrypto/asn1/tasn_typ.c","lib/libcrypto/asn1/tasn_typ.c","d2i_ASN1_VISIBLESTRING",465,470
4,1,28,2,3,"i2d_ASN1_VISIBLESTRING@473-476@lib/libcrypto/asn1/tasn_typ.c","lib/libcrypto/asn1/tasn_typ.c","i2d_ASN1_VISIBLESTRING",473,476
4,1,17,1,3,"ASN1_VISIBLESTRING_new@479-482@lib/libcrypto/asn1/tasn_typ.c","lib/libcrypto/asn1/tasn_typ.c","ASN1_VISIBLESTRING_new",479,482
4,1,20,1,3,"ASN1_VISIBLESTRING_free@485-488@lib/libcrypto/asn1/tasn_typ.c","lib/libcrypto/asn1/tasn_typ.c","ASN1_VISIBLESTRING_free",485,488
6,1,38,3,5,"d2i_ASN1_UNIVERSALSTRING@498-503@lib/libcrypto/asn1/tasn_typ.c","lib/libcrypto/asn1/tasn_typ.c","d2i_ASN1_UNIVERSALSTRING",498,503
4,1,28,2,3,"i2d_ASN1_UNIVERSALSTRING@506-509@lib/libcrypto/asn1/tasn_typ.c","lib/libcrypto/asn1/tasn_typ.c","i2d_ASN1_UNIVERSALSTRING",506,509
4,1,17,1,3,"ASN1_UNIVERSALSTRING_new@512-515@lib/libcrypto/asn1/tasn_typ.c","lib/libcrypto/asn1/tasn_typ.c","ASN1_UNIVERSALSTRING_new",512,515
4,1,20,1,3,"ASN1_UNIVERSALSTRING_free@518-521@lib/libcrypto/asn1/tasn_typ.c","lib/libcrypto/asn1/tasn_typ.c","ASN1_UNIVERSALSTRING_free",518,521
5,1,38,3,4,"d2i_ASN1_BMPSTRING@531-535@lib/libcrypto/asn1/tasn_typ.c","lib/libcrypto/asn1/tasn_typ.c","d2i_ASN1_BMPSTRING",531,535
4,1,28,2,3,"i2d_ASN1_BMPSTRING@538-541@lib/libcrypto/asn1/tasn_typ.c","lib/libcrypto/asn1/tasn_typ.c","i2d_ASN1_BMPSTRING",538,541
4,1,17,1,3,"ASN1_BMPSTRING_new@544-547@lib/libcrypto/asn1/tasn_typ.c","lib/libcrypto/asn1/tasn_typ.c","ASN1_BMPSTRING_new",544,547
4,1,20,1,3,"ASN1_BMPSTRING_free@550-553@lib/libcrypto/asn1/tasn_typ.c","lib/libcrypto/asn1/tasn_typ.c","ASN1_BMPSTRING_free",550,553
5,1,38,3,4,"d2i_ASN1_TYPE@572-576@lib/libcrypto/asn1/tasn_typ.c","lib/libcrypto/asn1/tasn_typ.c","d2i_ASN1_TYPE",572,576
4,1,28,2,3,"i2d_ASN1_TYPE@579-582@lib/libcrypto/asn1/tasn_typ.c","lib/libcrypto/asn1/tasn_typ.c","i2d_ASN1_TYPE",579,582
4,1,17,1,3,"ASN1_TYPE_new@585-588@lib/libcrypto/asn1/tasn_typ.c","lib/libcrypto/asn1/tasn_typ.c","ASN1_TYPE_new",585,588
4,1,20,1,3,"ASN1_TYPE_free@591-594@lib/libcrypto/asn1/tasn_typ.c","lib/libcrypto/asn1/tasn_typ.c","ASN1_TYPE_free",591,594
5,1,38,3,4,"d2i_ASN1_PRINTABLE@610-614@lib/libcrypto/asn1/tasn_typ.c","lib/libcrypto/asn1/tasn_typ.c","d2i_ASN1_PRINTABLE",610,614
4,1,28,2,3,"i2d_ASN1_PRINTABLE@617-620@lib/libcrypto/asn1/tasn_typ.c","lib/libcrypto/asn1/tasn_typ.c","i2d_ASN1_PRINTABLE",617,620
4,1,17,1,3,"ASN1_PRINTABLE_new@623-626@lib/libcrypto/asn1/tasn_typ.c","lib/libcrypto/asn1/tasn_typ.c","ASN1_PRINTABLE_new",623,626
4,1,20,1,3,"ASN1_PRINTABLE_free@629-632@lib/libcrypto/asn1/tasn_typ.c","lib/libcrypto/asn1/tasn_typ.c","ASN1_PRINTABLE_free",629,632
5,1,38,3,4,"d2i_DISPLAYTEXT@646-650@lib/libcrypto/asn1/tasn_typ.c","lib/libcrypto/asn1/tasn_typ.c","d2i_DISPLAYTEXT",646,650
4,1,28,2,3,"i2d_DISPLAYTEXT@653-656@lib/libcrypto/asn1/tasn_typ.c","lib/libcrypto/asn1/tasn_typ.c","i2d_DISPLAYTEXT",653,656
4,1,17,1,3,"DISPLAYTEXT_new@659-662@lib/libcrypto/asn1/tasn_typ.c","lib/libcrypto/asn1/tasn_typ.c","DISPLAYTEXT_new",659,662
4,1,20,1,3,"DISPLAYTEXT_free@665-668@lib/libcrypto/asn1/tasn_typ.c","lib/libcrypto/asn1/tasn_typ.c","DISPLAYTEXT_free",665,668
5,1,38,3,4,"d2i_DIRECTORYSTRING@682-686@lib/libcrypto/asn1/tasn_typ.c","lib/libcrypto/asn1/tasn_typ.c","d2i_DIRECTORYSTRING",682,686
4,1,28,2,3,"i2d_DIRECTORYSTRING@689-692@lib/libcrypto/asn1/tasn_typ.c","lib/libcrypto/asn1/tasn_typ.c","i2d_DIRECTORYSTRING",689,692
4,1,17,1,3,"DIRECTORYSTRING_new@695-698@lib/libcrypto/asn1/tasn_typ.c","lib/libcrypto/asn1/tasn_typ.c","DIRECTORYSTRING_new",695,698
4,1,20,1,3,"DIRECTORYSTRING_free@701-704@lib/libcrypto/asn1/tasn_typ.c","lib/libcrypto/asn1/tasn_typ.c","DIRECTORYSTRING_free",701,704
5,1,38,3,4,"d2i_ASN1_SEQUENCE_ANY@776-780@lib/libcrypto/asn1/tasn_typ.c","lib/libcrypto/asn1/tasn_typ.c","d2i_ASN1_SEQUENCE_ANY",776,780
4,1,29,2,3,"i2d_ASN1_SEQUENCE_ANY@783-786@lib/libcrypto/asn1/tasn_typ.c","lib/libcrypto/asn1/tasn_typ.c","i2d_ASN1_SEQUENCE_ANY",783,786
5,1,38,3,4,"d2i_ASN1_SET_ANY@789-793@lib/libcrypto/asn1/tasn_typ.c","lib/libcrypto/asn1/tasn_typ.c","d2i_ASN1_SET_ANY",789,793
4,1,29,2,3,"i2d_ASN1_SET_ANY@796-799@lib/libcrypto/asn1/tasn_typ.c","lib/libcrypto/asn1/tasn_typ.c","i2d_ASN1_SET_ANY",796,799
5,1,31,2,4,"asn1_get_choice_selector@76-80@lib/libcrypto/asn1/tasn_utl.c","lib/libcrypto/asn1/tasn_utl.c","asn1_get_choice_selector",76,80
8,1,47,3,7,"asn1_set_choice_selector@87-94@lib/libcrypto/asn1/tasn_utl.c","lib/libcrypto/asn1/tasn_utl.c","asn1_set_choice_selector",87,94
18,6,115,3,18,"asn1_do_lock@103-121@lib/libcrypto/asn1/tasn_utl.c","lib/libcrypto/asn1/tasn_utl.c","asn1_do_lock",103,121
10,5,64,2,10,"asn1_get_enc_ptr@124-134@lib/libcrypto/asn1/tasn_utl.c","lib/libcrypto/asn1/tasn_utl.c","asn1_get_enc_ptr",124,134
10,2,50,2,10,"asn1_enc_init@137-147@lib/libcrypto/asn1/tasn_utl.c","lib/libcrypto/asn1/tasn_utl.c","asn1_enc_init",137,147
11,2,57,2,11,"asn1_enc_free@150-161@lib/libcrypto/asn1/tasn_utl.c","lib/libcrypto/asn1/tasn_utl.c","asn1_enc_free",150,161
16,3,95,4,18,"asn1_enc_save@164-182@lib/libcrypto/asn1/tasn_utl.c","lib/libcrypto/asn1/tasn_utl.c","asn1_enc_save",164,182
15,5,88,4,15,"asn1_enc_restore@185-200@lib/libcrypto/asn1/tasn_utl.c","lib/libcrypto/asn1/tasn_utl.c","asn1_enc_restore",185,200
8,2,43,2,12,"asn1_get_field_ptr@204-216@lib/libcrypto/asn1/tasn_utl.c","lib/libcrypto/asn1/tasn_utl.c","asn1_get_field_ptr",204,216
31,9,195,3,57,"asn1_do_adb@223-280@lib/libcrypto/asn1/tasn_utl.c","lib/libcrypto/asn1/tasn_utl.c","asn1_do_adb",223,280
5,1,38,3,4,"d2i_X509_ALGOR@107-111@lib/libcrypto/asn1/x_algor.c","lib/libcrypto/asn1/x_algor.c","d2i_X509_ALGOR",107,111
4,1,28,2,3,"i2d_X509_ALGOR@114-117@lib/libcrypto/asn1/x_algor.c","lib/libcrypto/asn1/x_algor.c","i2d_X509_ALGOR",114,117
4,1,17,1,3,"X509_ALGOR_new@120-123@lib/libcrypto/asn1/x_algor.c","lib/libcrypto/asn1/x_algor.c","X509_ALGOR_new",120,123
4,1,20,1,3,"X509_ALGOR_free@126-129@lib/libcrypto/asn1/x_algor.c","lib/libcrypto/asn1/x_algor.c","X509_ALGOR_free",126,129
5,1,38,3,4,"d2i_X509_ALGORS@132-136@lib/libcrypto/asn1/x_algor.c","lib/libcrypto/asn1/x_algor.c","d2i_X509_ALGORS",132,136
4,1,28,2,3,"i2d_X509_ALGORS@139-142@lib/libcrypto/asn1/x_algor.c","lib/libcrypto/asn1/x_algor.c","i2d_X509_ALGORS",139,142
4,1,17,1,3,"X509_ALGOR_dup@145-148@lib/libcrypto/asn1/x_algor.c","lib/libcrypto/asn1/x_algor.c","X509_ALGOR_dup",145,148
26,10,140,4,25,"X509_ALGOR_set0@151-176@lib/libcrypto/asn1/x_algor.c","lib/libcrypto/asn1/x_algor.c","X509_ALGOR_set0",151,176
15,5,79,4,14,"X509_ALGOR_get0@179-193@lib/libcrypto/asn1/x_algor.c","lib/libcrypto/asn1/x_algor.c","X509_ALGOR_get0",179,193
9,2,50,2,10,"X509_ALGOR_set_md@198-208@lib/libcrypto/asn1/x_algor.c","lib/libcrypto/asn1/x_algor.c","X509_ALGOR_set_md",198,208
11,4,70,2,10,"X509_ALGOR_cmp@212-222@lib/libcrypto/asn1/x_algor.c","lib/libcrypto/asn1/x_algor.c","X509_ALGOR_cmp",212,222
5,1,38,3,4,"d2i_X509_ATTRIBUTE@142-146@lib/libcrypto/asn1/x_attrib.c","lib/libcrypto/asn1/x_attrib.c","d2i_X509_ATTRIBUTE",142,146
4,1,28,2,3,"i2d_X509_ATTRIBUTE@149-152@lib/libcrypto/asn1/x_attrib.c","lib/libcrypto/asn1/x_attrib.c","i2d_X509_ATTRIBUTE",149,152
4,1,17,1,3,"X509_ATTRIBUTE_new@155-158@lib/libcrypto/asn1/x_attrib.c","lib/libcrypto/asn1/x_attrib.c","X509_ATTRIBUTE_new",155,158
4,1,20,1,3,"X509_ATTRIBUTE_free@161-164@lib/libcrypto/asn1/x_attrib.c","lib/libcrypto/asn1/x_attrib.c","X509_ATTRIBUTE_free",161,164
4,1,17,1,3,"X509_ATTRIBUTE_dup@167-170@lib/libcrypto/asn1/x_attrib.c","lib/libcrypto/asn1/x_attrib.c","X509_ATTRIBUTE_dup",167,170
23,7,152,3,25,"X509_ATTRIBUTE_create@173-198@lib/libcrypto/asn1/x_attrib.c","lib/libcrypto/asn1/x_attrib.c","X509_ATTRIBUTE_create",173,198
8,2,36,2,7,"bn_new@110-117@lib/libcrypto/asn1/x_bignum.c","lib/libcrypto/asn1/x_bignum.c","bn_new",110,117
7,2,37,2,6,"bn_free@120-126@lib/libcrypto/asn1/x_bignum.c","lib/libcrypto/asn1/x_bignum.c","bn_free",120,126
19,5,107,4,20,"bn_i2c@129-149@lib/libcrypto/asn1/x_bignum.c","lib/libcrypto/asn1/x_bignum.c","bn_i2c",129,149
15,4,92,6,15,"bn_c2i@152-167@lib/libcrypto/asn1/x_bignum.c","lib/libcrypto/asn1/x_bignum.c","bn_c2i",152,167
12,4,70,4,15,"crl_inf_cb@118-133@lib/libcrypto/asn1/x_crl.c","lib/libcrypto/asn1/x_crl.c","crl_inf_cb",118,133
54,14,308,1,63,"crl_set_issuers@198-261@lib/libcrypto/asn1/x_crl.c","lib/libcrypto/asn1/x_crl.c","crl_set_issuers",198,261
73,20,446,4,94,"crl_cb@267-361@lib/libcrypto/asn1/x_crl.c","lib/libcrypto/asn1/x_crl.c","crl_cb",267,361
31,9,189,2,36,"setup_idp@366-402@lib/libcrypto/asn1/x_crl.c","lib/libcrypto/asn1/x_crl.c","setup_idp",366,402
5,1,38,3,4,"d2i_X509_REVOKED@441-445@lib/libcrypto/asn1/x_crl.c","lib/libcrypto/asn1/x_crl.c","d2i_X509_REVOKED",441,445
4,1,28,2,3,"i2d_X509_REVOKED@448-451@lib/libcrypto/asn1/x_crl.c","lib/libcrypto/asn1/x_crl.c","i2d_X509_REVOKED",448,451
4,1,17,1,3,"X509_REVOKED_new@454-457@lib/libcrypto/asn1/x_crl.c","lib/libcrypto/asn1/x_crl.c","X509_REVOKED_new",454,457
4,1,20,1,3,"X509_REVOKED_free@460-463@lib/libcrypto/asn1/x_crl.c","lib/libcrypto/asn1/x_crl.c","X509_REVOKED_free",460,463
5,1,38,3,4,"d2i_X509_CRL_INFO@466-470@lib/libcrypto/asn1/x_crl.c","lib/libcrypto/asn1/x_crl.c","d2i_X509_CRL_INFO",466,470
4,1,28,2,3,"i2d_X509_CRL_INFO@473-476@lib/libcrypto/asn1/x_crl.c","lib/libcrypto/asn1/x_crl.c","i2d_X509_CRL_INFO",473,476
4,1,17,1,3,"X509_CRL_INFO_new@479-482@lib/libcrypto/asn1/x_crl.c","lib/libcrypto/asn1/x_crl.c","X509_CRL_INFO_new",479,482
4,1,20,1,3,"X509_CRL_INFO_free@485-488@lib/libcrypto/asn1/x_crl.c","lib/libcrypto/asn1/x_crl.c","X509_CRL_INFO_free",485,488
5,1,38,3,4,"d2i_X509_CRL@491-495@lib/libcrypto/asn1/x_crl.c","lib/libcrypto/asn1/x_crl.c","d2i_X509_CRL",491,495
4,1,28,2,3,"i2d_X509_CRL@498-501@lib/libcrypto/asn1/x_crl.c","lib/libcrypto/asn1/x_crl.c","i2d_X509_CRL",498,501
4,1,17,1,3,"X509_CRL_new@504-507@lib/libcrypto/asn1/x_crl.c","lib/libcrypto/asn1/x_crl.c","X509_CRL_new",504,507
4,1,20,1,3,"X509_CRL_free@510-513@lib/libcrypto/asn1/x_crl.c","lib/libcrypto/asn1/x_crl.c","X509_CRL_free",510,513
4,1,17,1,3,"X509_CRL_dup@516-519@lib/libcrypto/asn1/x_crl.c","lib/libcrypto/asn1/x_crl.c","X509_CRL_dup",516,519
6,1,46,2,5,"X509_REVOKED_cmp@522-527@lib/libcrypto/asn1/x_crl.c","lib/libcrypto/asn1/x_crl.c","X509_REVOKED_cmp",522,527
13,4,76,2,13,"X509_CRL_add0_revoked@530-543@lib/libcrypto/asn1/x_crl.c","lib/libcrypto/asn1/x_crl.c","X509_CRL_add0_revoked",530,543
6,2,35,2,5,"X509_CRL_verify@546-551@lib/libcrypto/asn1/x_crl.c","lib/libcrypto/asn1/x_crl.c","X509_CRL_verify",546,551
7,2,43,3,6,"X509_CRL_get0_by_serial@554-560@lib/libcrypto/asn1/x_crl.c","lib/libcrypto/asn1/x_crl.c","X509_CRL_get0_by_serial",554,560
7,2,49,3,6,"X509_CRL_get0_by_cert@563-569@lib/libcrypto/asn1/x_crl.c","lib/libcrypto/asn1/x_crl.c","X509_CRL_get0_by_cert",563,569
5,1,35,2,4,"def_crl_verify@572-576@lib/libcrypto/asn1/x_crl.c","lib/libcrypto/asn1/x_crl.c","def_crl_verify",572,576
21,8,130,3,24,"crl_revoked_issuer_match@579-603@lib/libcrypto/asn1/x_crl.c","lib/libcrypto/asn1/x_crl.c","crl_revoked_issuer_match",579,603
28,8,176,4,32,"def_crl_lookup@606-638@lib/libcrypto/asn1/x_crl.c","lib/libcrypto/asn1/x_crl.c","def_crl_lookup",606,638
7,2,25,1,6,"X509_CRL_set_default_method@641-647@lib/libcrypto/asn1/x_crl.c","lib/libcrypto/asn1/x_crl.c","X509_CRL_set_default_method",641,647
17,2,119,4,17,"X509_CRL_METHOD_new@650-667@lib/libcrypto/asn1/x_crl.c","lib/libcrypto/asn1/x_crl.c","X509_CRL_METHOD_new",650,667
6,2,26,1,5,"X509_CRL_METHOD_free@670-675@lib/libcrypto/asn1/x_crl.c","lib/libcrypto/asn1/x_crl.c","X509_CRL_METHOD_free",670,675
4,1,18,2,3,"X509_CRL_set_meth_data@678-681@lib/libcrypto/asn1/x_crl.c","lib/libcrypto/asn1/x_crl.c","X509_CRL_set_meth_data",678,681
4,1,13,1,3,"X509_CRL_get_meth_data@684-687@lib/libcrypto/asn1/x_crl.c","lib/libcrypto/asn1/x_crl.c","X509_CRL_get_meth_data",684,687
5,1,38,3,4,"d2i_X509_EXTENSION@112-116@lib/libcrypto/asn1/x_exten.c","lib/libcrypto/asn1/x_exten.c","d2i_X509_EXTENSION",112,116
4,1,28,2,3,"i2d_X509_EXTENSION@119-122@lib/libcrypto/asn1/x_exten.c","lib/libcrypto/asn1/x_exten.c","i2d_X509_EXTENSION",119,122
4,1,17,1,3,"X509_EXTENSION_new@125-128@lib/libcrypto/asn1/x_exten.c","lib/libcrypto/asn1/x_exten.c","X509_EXTENSION_new",125,128
4,1,20,1,3,"X509_EXTENSION_free@131-134@lib/libcrypto/asn1/x_exten.c","lib/libcrypto/asn1/x_exten.c","X509_EXTENSION_free",131,134
5,1,38,3,4,"d2i_X509_EXTENSIONS@137-141@lib/libcrypto/asn1/x_exten.c","lib/libcrypto/asn1/x_exten.c","d2i_X509_EXTENSIONS",137,141
4,1,28,2,3,"i2d_X509_EXTENSIONS@144-147@lib/libcrypto/asn1/x_exten.c","lib/libcrypto/asn1/x_exten.c","i2d_X509_EXTENSIONS",144,147
4,1,17,1,3,"X509_EXTENSION_dup@150-153@lib/libcrypto/asn1/x_exten.c","lib/libcrypto/asn1/x_exten.c","X509_EXTENSION_dup",150,153
17,2,89,1,19,"X509_INFO_new@67-86@lib/libcrypto/asn1/x_info.c","lib/libcrypto/asn1/x_info.c","X509_INFO_new",67,86
16,5,91,1,18,"X509_INFO_free@89-107@lib/libcrypto/asn1/x_info.c","lib/libcrypto/asn1/x_info.c","X509_INFO_free",89,107
5,1,27,2,4,"long_new@109-113@lib/libcrypto/asn1/x_long.c","lib/libcrypto/asn1/x_long.c","long_new",109,113
4,1,24,2,3,"long_free@116-119@lib/libcrypto/asn1/x_long.c","lib/libcrypto/asn1/x_long.c","long_free",116,119
32,9,204,4,43,"long_i2c@122-165@lib/libcrypto/asn1/x_long.c","lib/libcrypto/asn1/x_long.c","long_i2c",122,165
35,8,197,6,35,"long_c2i@168-203@lib/libcrypto/asn1/x_long.c","lib/libcrypto/asn1/x_long.c","long_c2i",168,203
5,1,40,5,4,"long_print@206-210@lib/libcrypto/asn1/x_long.c","lib/libcrypto/asn1/x_long.c","long_print",206,210
5,1,38,3,4,"d2i_X509_NAME_ENTRY@114-118@lib/libcrypto/asn1/x_name.c","lib/libcrypto/asn1/x_name.c","d2i_X509_NAME_ENTRY",114,118
4,1,28,2,3,"i2d_X509_NAME_ENTRY@121-124@lib/libcrypto/asn1/x_name.c","lib/libcrypto/asn1/x_name.c","i2d_X509_NAME_ENTRY",121,124
4,1,17,1,3,"X509_NAME_ENTRY_new@127-130@lib/libcrypto/asn1/x_name.c","lib/libcrypto/asn1/x_name.c","X509_NAME_ENTRY_new",127,130
4,1,20,1,3,"X509_NAME_ENTRY_free@133-136@lib/libcrypto/asn1/x_name.c","lib/libcrypto/asn1/x_name.c","X509_NAME_ENTRY_free",133,136
4,1,17,1,3,"X509_NAME_ENTRY_dup@139-142@lib/libcrypto/asn1/x_name.c","lib/libcrypto/asn1/x_name.c","X509_NAME_ENTRY_dup",139,142
5,1,38,3,4,"d2i_X509_NAME@211-215@lib/libcrypto/asn1/x_name.c","lib/libcrypto/asn1/x_name.c","d2i_X509_NAME",211,215
4,1,28,2,3,"i2d_X509_NAME@218-221@lib/libcrypto/asn1/x_name.c","lib/libcrypto/asn1/x_name.c","i2d_X509_NAME",218,221
4,1,17,1,3,"X509_NAME_new@224-227@lib/libcrypto/asn1/x_name.c","lib/libcrypto/asn1/x_name.c","X509_NAME_new",224,227
4,1,20,1,3,"X509_NAME_free@230-233@lib/libcrypto/asn1/x_name.c","lib/libcrypto/asn1/x_name.c","X509_NAME_free",230,233
4,1,17,1,3,"X509_NAME_dup@236-239@lib/libcrypto/asn1/x_name.c","lib/libcrypto/asn1/x_name.c","X509_NAME_dup",236,239
24,6,135,2,25,"x509_name_ex_new@242-267@lib/libcrypto/asn1/x_name.c","lib/libcrypto/asn1/x_name.c","x509_name_ex_new",242,267
12,3,70,2,13,"x509_name_ex_free@270-283@lib/libcrypto/asn1/x_name.c","lib/libcrypto/asn1/x_name.c","x509_name_ex_free",270,283
51,10,363,8,58,"x509_name_ex_d2i@286-344@lib/libcrypto/asn1/x_name.c","lib/libcrypto/asn1/x_name.c","x509_name_ex_d2i",286,344
20,5,116,5,20,"x509_name_ex_i2d@347-367@lib/libcrypto/asn1/x_name.c","lib/libcrypto/asn1/x_name.c","x509_name_ex_i2d",347,367
4,1,16,1,3,"local_sk_X509_NAME_ENTRY_free@370-373@lib/libcrypto/asn1/x_name.c","lib/libcrypto/asn1/x_name.c","local_sk_X509_NAME_ENTRY_free",370,373
4,1,18,1,3,"local_sk_X509_NAME_ENTRY_pop_free@376-379@lib/libcrypto/asn1/x_name.c","lib/libcrypto/asn1/x_name.c","local_sk_X509_NAME_ENTRY_pop_free",376,379
46,9,275,1,47,"x509_name_encode@382-429@lib/libcrypto/asn1/x_name.c","lib/libcrypto/asn1/x_name.c","x509_name_encode",382,429
8,2,53,5,7,"x509_name_ex_print@432-439@lib/libcrypto/asn1/x_name.c","lib/libcrypto/asn1/x_name.c","x509_name_ex_print",432,439
62,17,351,1,66,"x509_name_canon@455-521@lib/libcrypto/asn1/x_name.c","lib/libcrypto/asn1/x_name.c","x509_name_canon",455,521
47,15,286,2,73,"asn1_string_canon@532-605@lib/libcrypto/asn1/x_name.c","lib/libcrypto/asn1/x_name.c","asn1_string_canon",532,605
16,3,109,2,16,"i2d_name_canon@608-624@lib/libcrypto/asn1/x_name.c","lib/libcrypto/asn1/x_name.c","i2d_name_canon",608,624
14,5,72,2,15,"X509_NAME_set@627-642@lib/libcrypto/asn1/x_name.c","lib/libcrypto/asn1/x_name.c","X509_NAME_set",627,642
5,1,38,3,4,"d2i_NETSCAPE_X509@91-95@lib/libcrypto/asn1/x_nx509.c","lib/libcrypto/asn1/x_nx509.c","d2i_NETSCAPE_X509",91,95
4,1,28,2,3,"i2d_NETSCAPE_X509@98-101@lib/libcrypto/asn1/x_nx509.c","lib/libcrypto/asn1/x_nx509.c","i2d_NETSCAPE_X509",98,101
4,1,17,1,3,"NETSCAPE_X509_new@104-107@lib/libcrypto/asn1/x_nx509.c","lib/libcrypto/asn1/x_nx509.c","NETSCAPE_X509_new",104,107
4,1,20,1,3,"NETSCAPE_X509_free@110-113@lib/libcrypto/asn1/x_nx509.c","lib/libcrypto/asn1/x_nx509.c","NETSCAPE_X509_free",110,113
31,5,171,1,32,"X509_PKEY_new@68-100@lib/libcrypto/asn1/x_pkey.c","lib/libcrypto/asn1/x_pkey.c","X509_PKEY_new",68,100
16,6,99,1,18,"X509_PKEY_free@103-121@lib/libcrypto/asn1/x_pkey.c","lib/libcrypto/asn1/x_pkey.c","X509_PKEY_free",103,121
8,2,49,4,7,"pubkey_cb@78-85@lib/libcrypto/asn1/x_pubkey.c","lib/libcrypto/asn1/x_pubkey.c","pubkey_cb",78,85
5,1,38,3,4,"d2i_X509_PUBKEY@115-119@lib/libcrypto/asn1/x_pubkey.c","lib/libcrypto/asn1/x_pubkey.c","d2i_X509_PUBKEY",115,119
4,1,28,2,3,"i2d_X509_PUBKEY@122-125@lib/libcrypto/asn1/x_pubkey.c","lib/libcrypto/asn1/x_pubkey.c","i2d_X509_PUBKEY",122,125
4,1,17,1,3,"X509_PUBKEY_new@128-131@lib/libcrypto/asn1/x_pubkey.c","lib/libcrypto/asn1/x_pubkey.c","X509_PUBKEY_new",128,131
4,1,20,1,3,"X509_PUBKEY_free@134-137@lib/libcrypto/asn1/x_pubkey.c","lib/libcrypto/asn1/x_pubkey.c","X509_PUBKEY_free",134,137
30,8,145,2,35,"X509_PUBKEY_set@140-175@lib/libcrypto/asn1/x_pubkey.c","lib/libcrypto/asn1/x_pubkey.c","X509_PUBKEY_set",140,175
43,9,227,1,52,"X509_PUBKEY_get@178-230@lib/libcrypto/asn1/x_pubkey.c","lib/libcrypto/asn1/x_pubkey.c","X509_PUBKEY_get",178,230
17,4,84,3,16,"d2i_PUBKEY@237-253@lib/libcrypto/asn1/x_pubkey.c","lib/libcrypto/asn1/x_pubkey.c","d2i_PUBKEY",237,253
12,3,61,2,11,"i2d_PUBKEY@256-267@lib/libcrypto/asn1/x_pubkey.c","lib/libcrypto/asn1/x_pubkey.c","i2d_PUBKEY",256,267
20,4,101,3,19,"d2i_RSA_PUBKEY@274-293@lib/libcrypto/asn1/x_pubkey.c","lib/libcrypto/asn1/x_pubkey.c","d2i_RSA_PUBKEY",274,293
16,3,73,2,15,"i2d_RSA_PUBKEY@296-311@lib/libcrypto/asn1/x_pubkey.c","lib/libcrypto/asn1/x_pubkey.c","i2d_RSA_PUBKEY",296,311
20,4,101,3,19,"d2i_DSA_PUBKEY@316-335@lib/libcrypto/asn1/x_pubkey.c","lib/libcrypto/asn1/x_pubkey.c","d2i_DSA_PUBKEY",316,335
16,3,73,2,15,"i2d_DSA_PUBKEY@338-353@lib/libcrypto/asn1/x_pubkey.c","lib/libcrypto/asn1/x_pubkey.c","i2d_DSA_PUBKEY",338,353
20,4,107,3,19,"d2i_EC_PUBKEY@358-377@lib/libcrypto/asn1/x_pubkey.c","lib/libcrypto/asn1/x_pubkey.c","d2i_EC_PUBKEY",358,377
15,3,80,2,14,"i2d_EC_PUBKEY@380-394@lib/libcrypto/asn1/x_pubkey.c","lib/libcrypto/asn1/x_pubkey.c","i2d_EC_PUBKEY",380,394
14,3,100,6,14,"X509_PUBKEY_set0_param@398-412@lib/libcrypto/asn1/x_pubkey.c","lib/libcrypto/asn1/x_pubkey.c","X509_PUBKEY_set0_param",398,412
13,4,77,5,12,"X509_PUBKEY_get0_param@415-427@lib/libcrypto/asn1/x_pubkey.c","lib/libcrypto/asn1/x_pubkey.c","X509_PUBKEY_get0_param",415,427
10,3,60,4,10,"rinf_cb@83-93@lib/libcrypto/asn1/x_req.c","lib/libcrypto/asn1/x_req.c","rinf_cb",83,93
5,1,38,3,4,"d2i_X509_REQ_INFO@139-143@lib/libcrypto/asn1/x_req.c","lib/libcrypto/asn1/x_req.c","d2i_X509_REQ_INFO",139,143
4,1,28,2,3,"i2d_X509_REQ_INFO@146-149@lib/libcrypto/asn1/x_req.c","lib/libcrypto/asn1/x_req.c","i2d_X509_REQ_INFO",146,149
4,1,17,1,3,"X509_REQ_INFO_new@152-155@lib/libcrypto/asn1/x_req.c","lib/libcrypto/asn1/x_req.c","X509_REQ_INFO_new",152,155
4,1,20,1,3,"X509_REQ_INFO_free@158-161@lib/libcrypto/asn1/x_req.c","lib/libcrypto/asn1/x_req.c","X509_REQ_INFO_free",158,161
5,1,38,3,4,"d2i_X509_REQ@199-203@lib/libcrypto/asn1/x_req.c","lib/libcrypto/asn1/x_req.c","d2i_X509_REQ",199,203
4,1,28,2,3,"i2d_X509_REQ@206-209@lib/libcrypto/asn1/x_req.c","lib/libcrypto/asn1/x_req.c","i2d_X509_REQ",206,209
4,1,17,1,3,"X509_REQ_new@212-215@lib/libcrypto/asn1/x_req.c","lib/libcrypto/asn1/x_req.c","X509_REQ_new",212,215
4,1,20,1,3,"X509_REQ_free@218-221@lib/libcrypto/asn1/x_req.c","lib/libcrypto/asn1/x_req.c","X509_REQ_free",218,221
4,1,17,1,3,"X509_REQ_dup@224-227@lib/libcrypto/asn1/x_req.c","lib/libcrypto/asn1/x_req.c","X509_REQ_dup",224,227
5,1,38,3,4,"d2i_X509_SIG@88-92@lib/libcrypto/asn1/x_sig.c","lib/libcrypto/asn1/x_sig.c","d2i_X509_SIG",88,92
4,1,28,2,3,"i2d_X509_SIG@95-98@lib/libcrypto/asn1/x_sig.c","lib/libcrypto/asn1/x_sig.c","i2d_X509_SIG",95,98
4,1,17,1,3,"X509_SIG_new@101-104@lib/libcrypto/asn1/x_sig.c","lib/libcrypto/asn1/x_sig.c","X509_SIG_new",101,104
4,1,20,1,3,"X509_SIG_free@107-110@lib/libcrypto/asn1/x_sig.c","lib/libcrypto/asn1/x_sig.c","X509_SIG_free",107,110
5,1,38,3,4,"d2i_NETSCAPE_SPKAC@92-96@lib/libcrypto/asn1/x_spki.c","lib/libcrypto/asn1/x_spki.c","d2i_NETSCAPE_SPKAC",92,96
4,1,28,2,3,"i2d_NETSCAPE_SPKAC@99-102@lib/libcrypto/asn1/x_spki.c","lib/libcrypto/asn1/x_spki.c","i2d_NETSCAPE_SPKAC",99,102
4,1,17,1,3,"NETSCAPE_SPKAC_new@105-108@lib/libcrypto/asn1/x_spki.c","lib/libcrypto/asn1/x_spki.c","NETSCAPE_SPKAC_new",105,108
4,1,20,1,3,"NETSCAPE_SPKAC_free@111-114@lib/libcrypto/asn1/x_spki.c","lib/libcrypto/asn1/x_spki.c","NETSCAPE_SPKAC_free",111,114
5,1,38,3,4,"d2i_NETSCAPE_SPKI@152-156@lib/libcrypto/asn1/x_spki.c","lib/libcrypto/asn1/x_spki.c","d2i_NETSCAPE_SPKI",152,156
4,1,28,2,3,"i2d_NETSCAPE_SPKI@159-162@lib/libcrypto/asn1/x_spki.c","lib/libcrypto/asn1/x_spki.c","i2d_NETSCAPE_SPKI",159,162
4,1,17,1,3,"NETSCAPE_SPKI_new@165-168@lib/libcrypto/asn1/x_spki.c","lib/libcrypto/asn1/x_spki.c","NETSCAPE_SPKI_new",165,168
4,1,20,1,3,"NETSCAPE_SPKI_free@171-174@lib/libcrypto/asn1/x_spki.c","lib/libcrypto/asn1/x_spki.c","NETSCAPE_SPKI_free",171,174
5,1,38,3,4,"d2i_X509_VAL@88-92@lib/libcrypto/asn1/x_val.c","lib/libcrypto/asn1/x_val.c","d2i_X509_VAL",88,92
4,1,28,2,3,"i2d_X509_VAL@95-98@lib/libcrypto/asn1/x_val.c","lib/libcrypto/asn1/x_val.c","i2d_X509_VAL",95,98
4,1,17,1,3,"X509_VAL_new@101-104@lib/libcrypto/asn1/x_val.c","lib/libcrypto/asn1/x_val.c","X509_VAL_new",101,104
4,1,20,1,3,"X509_VAL_free@107-110@lib/libcrypto/asn1/x_val.c","lib/libcrypto/asn1/x_val.c","X509_VAL_free",107,110
5,1,38,3,4,"d2i_X509_CINF@145-149@lib/libcrypto/asn1/x_x509.c","lib/libcrypto/asn1/x_x509.c","d2i_X509_CINF",145,149
4,1,28,2,3,"i2d_X509_CINF@152-155@lib/libcrypto/asn1/x_x509.c","lib/libcrypto/asn1/x_x509.c","i2d_X509_CINF",152,155
4,1,17,1,3,"X509_CINF_new@158-161@lib/libcrypto/asn1/x_x509.c","lib/libcrypto/asn1/x_x509.c","X509_CINF_new",158,161
4,1,20,1,3,"X509_CINF_free@164-167@lib/libcrypto/asn1/x_x509.c","lib/libcrypto/asn1/x_x509.c","X509_CINF_free",164,167
34,4,214,4,38,"x509_cb@173-211@lib/libcrypto/asn1/x_x509.c","lib/libcrypto/asn1/x_x509.c","x509_cb",173,211
5,1,38,3,4,"d2i_X509@250-254@lib/libcrypto/asn1/x_x509.c","lib/libcrypto/asn1/x_x509.c","d2i_X509",250,254
4,1,28,2,3,"i2d_X509@257-260@lib/libcrypto/asn1/x_x509.c","lib/libcrypto/asn1/x_x509.c","i2d_X509",257,260
4,1,17,1,3,"X509_new@263-266@lib/libcrypto/asn1/x_x509.c","lib/libcrypto/asn1/x_x509.c","X509_new",263,266
4,1,20,1,3,"X509_free@269-272@lib/libcrypto/asn1/x_x509.c","lib/libcrypto/asn1/x_x509.c","X509_free",269,272
4,1,17,1,3,"X509_dup@275-278@lib/libcrypto/asn1/x_x509.c","lib/libcrypto/asn1/x_x509.c","X509_dup",275,278
6,1,39,5,5,"X509_get_ex_new_index@281-286@lib/libcrypto/asn1/x_x509.c","lib/libcrypto/asn1/x_x509.c","X509_get_ex_new_index",281,286
4,1,30,3,3,"X509_set_ex_data@289-292@lib/libcrypto/asn1/x_x509.c","lib/libcrypto/asn1/x_x509.c","X509_set_ex_data",289,292
4,1,24,2,3,"X509_get_ex_data@295-298@lib/libcrypto/asn1/x_x509.c","lib/libcrypto/asn1/x_x509.c","X509_get_ex_data",295,298
22,5,116,3,26,"d2i_X509_AUX@309-335@lib/libcrypto/asn1/x_x509.c","lib/libcrypto/asn1/x_x509.c","d2i_X509_AUX",309,335
8,2,43,2,8,"i2d_X509_AUX@338-346@lib/libcrypto/asn1/x_x509.c","lib/libcrypto/asn1/x_x509.c","i2d_X509_AUX",338,346
5,1,38,3,4,"d2i_X509_CERT_AUX@122-126@lib/libcrypto/asn1/x_x509a.c","lib/libcrypto/asn1/x_x509a.c","d2i_X509_CERT_AUX",122,126
4,1,28,2,3,"i2d_X509_CERT_AUX@129-132@lib/libcrypto/asn1/x_x509a.c","lib/libcrypto/asn1/x_x509a.c","i2d_X509_CERT_AUX",129,132
4,1,17,1,3,"X509_CERT_AUX_new@135-138@lib/libcrypto/asn1/x_x509a.c","lib/libcrypto/asn1/x_x509a.c","X509_CERT_AUX_new",135,138
4,1,20,1,3,"X509_CERT_AUX_free@141-144@lib/libcrypto/asn1/x_x509a.c","lib/libcrypto/asn1/x_x509a.c","X509_CERT_AUX_free",141,144
8,3,42,1,7,"aux_get@147-154@lib/libcrypto/asn1/x_x509a.c","lib/libcrypto/asn1/x_x509a.c","aux_get",147,154
16,7,115,3,15,"X509_alias_set1@157-172@lib/libcrypto/asn1/x_x509a.c","lib/libcrypto/asn1/x_x509a.c","X509_alias_set1",157,172
16,7,115,3,15,"X509_keyid_set1@175-190@lib/libcrypto/asn1/x_x509a.c","lib/libcrypto/asn1/x_x509a.c","X509_keyid_set1",175,190
8,4,53,2,7,"X509_alias_get0@193-200@lib/libcrypto/asn1/x_x509a.c","lib/libcrypto/asn1/x_x509a.c","X509_alias_get0",193,200
8,4,53,2,7,"X509_keyid_get0@203-210@lib/libcrypto/asn1/x_x509a.c","lib/libcrypto/asn1/x_x509a.c","X509_keyid_get0",203,210
18,5,104,2,19,"X509_add1_trust_object@213-232@lib/libcrypto/asn1/x_x509a.c","lib/libcrypto/asn1/x_x509a.c","X509_add1_trust_object",213,232
18,5,104,2,19,"X509_add1_reject_object@235-254@lib/libcrypto/asn1/x_x509a.c","lib/libcrypto/asn1/x_x509a.c","X509_add1_reject_object",235,254
7,3,41,1,6,"X509_trust_clear@257-263@lib/libcrypto/asn1/x_x509a.c","lib/libcrypto/asn1/x_x509a.c","X509_trust_clear",257,263
7,3,41,1,6,"X509_reject_clear@266-272@lib/libcrypto/asn1/x_x509a.c","lib/libcrypto/asn1/x_x509a.c","X509_reject_clear",266,272
5,1,38,3,4,"d2i_X509_CERT_PAIR@303-307@lib/libcrypto/asn1/x_x509a.c","lib/libcrypto/asn1/x_x509a.c","d2i_X509_CERT_PAIR",303,307
4,1,28,2,3,"i2d_X509_CERT_PAIR@310-313@lib/libcrypto/asn1/x_x509a.c","lib/libcrypto/asn1/x_x509a.c","i2d_X509_CERT_PAIR",310,313
4,1,17,1,3,"X509_CERT_PAIR_new@316-319@lib/libcrypto/asn1/x_x509a.c","lib/libcrypto/asn1/x_x509a.c","X509_CERT_PAIR_new",316,319
4,1,20,1,3,"X509_CERT_PAIR_free@322-325@lib/libcrypto/asn1/x_x509a.c","lib/libcrypto/asn1/x_x509a.c","X509_CERT_PAIR_free",322,325
80,6,495,6,80,"BF_cbc_encrypt@62-142@lib/libcrypto/bf/bf_cbc.c","lib/libcrypto/bf/bf_cbc.c","BF_cbc_encrypt",62,142
53,6,393,7,53,"BF_cfb64_encrypt@67-120@lib/libcrypto/bf/bf_cfb64.c","lib/libcrypto/bf/bf_cfb64.c","BF_cfb64_encrypt",67,120
6,3,21,1,9,"BF_options@68-77@lib/libcrypto/bf/bf_ecb.c","lib/libcrypto/bf/bf_ecb.c","BF_options",68,77
14,2,120,4,14,"BF_ecb_encrypt@79-93@lib/libcrypto/bf/bf_ecb.c","lib/libcrypto/bf/bf_ecb.c","BF_ecb_encrypt",79,93
61,3,658,2,73,"BF_encrypt@72-145@lib/libcrypto/bf/bf_enc.c","lib/libcrypto/bf/bf_enc.c","BF_encrypt",72,145
61,3,658,2,73,"BF_decrypt@149-222@lib/libcrypto/bf/bf_enc.c","lib/libcrypto/bf/bf_enc.c","BF_decrypt",149,222
80,6,495,6,80,"BF_cbc_encrypt@224-304@lib/libcrypto/bf/bf_enc.c","lib/libcrypto/bf/bf_enc.c","BF_cbc_encrypt",224,304
43,4,294,6,43,"BF_ofb64_encrypt@66-109@lib/libcrypto/bf/bf_ofb64.c","lib/libcrypto/bf/bf_ofb64.c","BF_ofb64_encrypt",66,109
41,9,326,3,50,"BF_set_key@66-116@lib/libcrypto/bf/bf_skey.c","lib/libcrypto/bf/bf_skey.c","BF_set_key",66,116
5,1,49,4,4,"BIO_dump_cb@73-77@lib/libcrypto/bio/b_dump.c","lib/libcrypto/bio/b_dump.c","BIO_dump_cb",73,77
56,19,511,5,66,"BIO_dump_indent_cb@80-146@lib/libcrypto/bio/b_dump.c","lib/libcrypto/bio/b_dump.c","BIO_dump_indent_cb",80,146
4,1,28,3,3,"write_fp@149-152@lib/libcrypto/bio/b_dump.c","lib/libcrypto/bio/b_dump.c","write_fp",149,152
4,1,28,3,3,"BIO_dump_fp@155-158@lib/libcrypto/bio/b_dump.c","lib/libcrypto/bio/b_dump.c","BIO_dump_fp",155,158
4,1,33,4,3,"BIO_dump_indent_fp@161-164@lib/libcrypto/bio/b_dump.c","lib/libcrypto/bio/b_dump.c","BIO_dump_indent_fp",161,164
4,1,35,3,3,"write_bio@167-170@lib/libcrypto/bio/b_dump.c","lib/libcrypto/bio/b_dump.c","write_bio",167,170
4,1,28,3,3,"BIO_dump@173-176@lib/libcrypto/bio/b_dump.c","lib/libcrypto/bio/b_dump.c","BIO_dump",173,176
4,1,33,4,3,"BIO_dump_indent@179-182@lib/libcrypto/bio/b_dump.c","lib/libcrypto/bio/b_dump.c","BIO_dump_indent",179,182
4,1,11,1,3,"BIO_sock_init@69-72@lib/libcrypto/bio/b_posix.c","lib/libcrypto/bio/b_posix.c","BIO_sock_init",69,72
3,1,6,1,2,"BIO_sock_cleanup@75-77@lib/libcrypto/bio/b_posix.c","lib/libcrypto/bio/b_posix.c","BIO_sock_cleanup",75,77
9,5,82,2,8,"BIO_socket_nbio@80-88@lib/libcrypto/bio/b_posix.c","lib/libcrypto/bio/b_posix.c","BIO_socket_nbio",80,88
9,1,49,3,9,"BIO_printf@8-17@lib/libcrypto/bio/b_print.c","lib/libcrypto/bio/b_print.c","BIO_printf",8,17
4,1,26,3,3,"_BIO_write@21-24@lib/libcrypto/bio/b_print.c","lib/libcrypto/bio/b_print.c","_BIO_write",21,24
14,2,78,3,14,"BIO_vprintf@27-41@lib/libcrypto/bio/b_print.c","lib/libcrypto/bio/b_print.c","BIO_vprintf",27,41
14,2,74,3,14,"BIO_vprintf@46-60@lib/libcrypto/bio/b_print.c","lib/libcrypto/bio/b_print.c","BIO_vprintf",46,60
11,3,71,4,12,"BIO_snprintf@85-97@lib/libcrypto/bio/b_print.c","lib/libcrypto/bio/b_print.c","BIO_snprintf",85,97
8,3,57,4,9,"BIO_vsnprintf@100-109@lib/libcrypto/bio/b_print.c","lib/libcrypto/bio/b_print.c","BIO_vsnprintf",100,109
24,3,154,2,25,"BIO_get_host_ip@38-63@lib/libcrypto/bio/b_sock.c","lib/libcrypto/bio/b_sock.c","BIO_get_host_ip",38,63
22,3,135,2,23,"BIO_get_port@66-89@lib/libcrypto/bio/b_sock.c","lib/libcrypto/bio/b_sock.c","BIO_get_port",66,89
9,2,49,1,9,"BIO_sock_error@92-101@lib/libcrypto/bio/b_sock.c","lib/libcrypto/bio/b_sock.c","BIO_sock_error",92,101
4,1,15,1,3,"BIO_gethostbyname@104-107@lib/libcrypto/bio/b_sock.c","lib/libcrypto/bio/b_sock.c","BIO_gethostbyname",104,107
8,2,44,3,8,"BIO_socket_ioctl@110-118@lib/libcrypto/bio/b_sock.c","lib/libcrypto/bio/b_sock.c","BIO_socket_ioctl",110,118
68,15,431,2,72,"BIO_get_accept_socket@121-193@lib/libcrypto/bio/b_sock.c","lib/libcrypto/bio/b_sock.c","BIO_get_accept_socket",121,193
33,8,209,2,38,"BIO_accept@196-234@lib/libcrypto/bio/b_sock.c","lib/libcrypto/bio/b_sock.c","BIO_accept",196,234
4,1,32,2,3,"BIO_set_tcp_ndelay@237-240@lib/libcrypto/bio/b_sock.c","lib/libcrypto/bio/b_sock.c","BIO_set_tcp_ndelay",237,240
4,1,12,1,3,"BIO_f_buffer@90-93@lib/libcrypto/bio/bf_buff.c","lib/libcrypto/bio/bf_buff.c","BIO_f_buffer",90,93
28,4,161,1,29,"buffer_new@96-125@lib/libcrypto/bio/bf_buff.c","lib/libcrypto/bio/bf_buff.c","buffer_new",96,125
14,2,77,1,14,"buffer_free@128-142@lib/libcrypto/bio/bf_buff.c","lib/libcrypto/bio/bf_buff.c","buffer_free",128,142
54,18,328,3,68,"buffer_read@145-213@lib/libcrypto/bio/bf_buff.c","lib/libcrypto/bio/bf_buff.c","buffer_read",145,213
60,20,398,3,73,"buffer_write@216-289@lib/libcrypto/bio/bf_buff.c","lib/libcrypto/bio/bf_buff.c","buffer_write",216,289
155,40,899,4,158,"buffer_ctrl@292-450@lib/libcrypto/bio/bf_buff.c","lib/libcrypto/bio/bf_buff.c","buffer_ctrl",292,450
12,2,61,3,12,"buffer_callback_ctrl@453-465@lib/libcrypto/bio/bf_buff.c","lib/libcrypto/bio/bf_buff.c","buffer_callback_ctrl",453,465
45,12,261,3,46,"buffer_gets@468-514@lib/libcrypto/bio/bf_buff.c","lib/libcrypto/bio/bf_buff.c","buffer_gets",468,514
4,1,28,2,3,"buffer_puts@517-520@lib/libcrypto/bio/bf_buff.c","lib/libcrypto/bio/bf_buff.c","buffer_puts",517,520
4,1,12,1,3,"BIO_f_linebuffer@93-96@lib/libcrypto/bio/bf_lbuf.c","lib/libcrypto/bio/bf_lbuf.c","BIO_f_linebuffer",93,96
18,3,101,1,19,"linebuffer_new@105-124@lib/libcrypto/bio/bf_lbuf.c","lib/libcrypto/bio/bf_lbuf.c","linebuffer_new",105,124
13,2,70,1,13,"linebuffer_free@127-140@lib/libcrypto/bio/bf_lbuf.c","lib/libcrypto/bio/bf_lbuf.c","linebuffer_free",127,140
12,3,72,3,12,"linebuffer_read@143-155@lib/libcrypto/bio/bf_lbuf.c","lib/libcrypto/bio/bf_lbuf.c","linebuffer_read",143,155
75,28,522,3,89,"linebuffer_write@158-247@lib/libcrypto/bio/bf_lbuf.c","lib/libcrypto/bio/bf_lbuf.c","linebuffer_write",158,247
95,25,557,4,98,"linebuffer_ctrl@250-348@lib/libcrypto/bio/bf_lbuf.c","lib/libcrypto/bio/bf_lbuf.c","linebuffer_ctrl",250,348
12,2,61,3,12,"linebuffer_callback_ctrl@351-363@lib/libcrypto/bio/bf_lbuf.c","lib/libcrypto/bio/bf_lbuf.c","linebuffer_callback_ctrl",351,363
6,2,42,3,5,"linebuffer_gets@366-371@lib/libcrypto/bio/bf_lbuf.c","lib/libcrypto/bio/bf_lbuf.c","linebuffer_gets",366,371
4,1,28,2,3,"linebuffer_puts@374-377@lib/libcrypto/bio/bf_lbuf.c","lib/libcrypto/bio/bf_lbuf.c","linebuffer_puts",374,377
4,1,12,1,3,"BIO_f_nbio_test@97-100@lib/libcrypto/bio/bf_nbio.c","lib/libcrypto/bio/bf_nbio.c","BIO_f_nbio_test",97,100
12,2,73,1,12,"nbiof_new@103-115@lib/libcrypto/bio/bf_nbio.c","lib/libcrypto/bio/bf_nbio.c","nbiof_new",103,115
10,2,49,1,9,"nbiof_free@118-127@lib/libcrypto/bio/bf_nbio.c","lib/libcrypto/bio/bf_nbio.c","nbiof_free",118,127
24,6,132,3,28,"nbiof_read@130-158@lib/libcrypto/bio/bf_nbio.c","lib/libcrypto/bio/bf_nbio.c","nbiof_read",130,158
33,8,188,3,37,"nbiof_write@161-198@lib/libcrypto/bio/bf_nbio.c","lib/libcrypto/bio/bf_nbio.c","nbiof_write",161,198
20,4,103,4,20,"nbiof_ctrl@201-221@lib/libcrypto/bio/bf_nbio.c","lib/libcrypto/bio/bf_nbio.c","nbiof_ctrl",201,221
12,2,61,3,12,"nbiof_callback_ctrl@224-236@lib/libcrypto/bio/bf_nbio.c","lib/libcrypto/bio/bf_nbio.c","nbiof_callback_ctrl",224,236
6,2,42,3,5,"nbiof_gets@239-244@lib/libcrypto/bio/bf_nbio.c","lib/libcrypto/bio/bf_nbio.c","nbiof_gets",239,244
6,2,38,2,5,"nbiof_puts@247-252@lib/libcrypto/bio/bf_nbio.c","lib/libcrypto/bio/bf_nbio.c","nbiof_puts",247,252
4,1,12,1,3,"BIO_f_null@90-93@lib/libcrypto/bio/bf_null.c","lib/libcrypto/bio/bf_null.c","BIO_f_null",90,93
7,1,31,1,6,"nullf_new@96-102@lib/libcrypto/bio/bf_null.c","lib/libcrypto/bio/bf_null.c","nullf_new",96,102
6,2,24,1,8,"nullf_free@105-113@lib/libcrypto/bio/bf_null.c","lib/libcrypto/bio/bf_null.c","nullf_free",105,113
12,3,72,3,12,"nullf_read@116-128@lib/libcrypto/bio/bf_null.c","lib/libcrypto/bio/bf_null.c","nullf_read",116,128
12,4,81,3,12,"nullf_write@131-143@lib/libcrypto/bio/bf_null.c","lib/libcrypto/bio/bf_null.c","nullf_write",131,143
19,4,101,4,19,"nullf_ctrl@146-165@lib/libcrypto/bio/bf_null.c","lib/libcrypto/bio/bf_null.c","nullf_ctrl",146,165
12,2,61,3,12,"nullf_callback_ctrl@168-180@lib/libcrypto/bio/bf_null.c","lib/libcrypto/bio/bf_null.c","nullf_callback_ctrl",168,180
6,2,42,3,5,"nullf_gets@183-188@lib/libcrypto/bio/bf_null.c","lib/libcrypto/bio/bf_null.c","nullf_gets",183,188
6,2,38,2,5,"nullf_puts@191-196@lib/libcrypto/bio/bf_null.c","lib/libcrypto/bio/bf_null.c","nullf_puts",191,196
76,16,470,6,78,"BIO_debug_callback@67-145@lib/libcrypto/bio/bio_cb.c","lib/libcrypto/bio/bio_cb.c","BIO_debug_callback",67,145
7,2,36,1,8,"ERR_load_BIO_strings@116-124@lib/libcrypto/bio/bio_err.c","lib/libcrypto/bio/bio_err.c","ERR_load_BIO_strings",116,124
14,3,68,1,14,"BIO_new@68-82@lib/libcrypto/bio/bio_lib.c","lib/libcrypto/bio/bio_lib.c","BIO_new",68,82
25,3,150,2,24,"BIO_set@85-109@lib/libcrypto/bio/bio_lib.c","lib/libcrypto/bio/bio_lib.c","BIO_set",85,109
17,6,138,1,20,"BIO_free@112-132@lib/libcrypto/bio/bio_lib.c","lib/libcrypto/bio/bio_lib.c","BIO_free",112,132
4,1,13,1,3,"BIO_vfree@135-138@lib/libcrypto/bio/bio_lib.c","lib/libcrypto/bio/bio_lib.c","BIO_vfree",135,138
4,1,17,2,3,"BIO_clear_flags@141-144@lib/libcrypto/bio/bio_lib.c","lib/libcrypto/bio/bio_lib.c","BIO_clear_flags",141,144
4,1,21,2,3,"BIO_test_flags@147-150@lib/libcrypto/bio/bio_lib.c","lib/libcrypto/bio/bio_lib.c","BIO_test_flags",147,150
4,1,17,2,3,"BIO_set_flags@153-156@lib/libcrypto/bio/bio_lib.c","lib/libcrypto/bio/bio_lib.c","BIO_set_flags",153,156
5,1,24,6,4,"long( * BIO_get_callback(constBIO*b))@159-163@lib/libcrypto/bio/bio_lib.c","lib/libcrypto/bio/bio_lib.c","long( * BIO_get_callback(constBIO*b))",159,163
5,1,37,2,4,"BIO_set_callback@166-170@lib/libcrypto/bio/bio_lib.c","lib/libcrypto/bio/bio_lib.c","BIO_set_callback",166,170
4,1,18,2,3,"BIO_set_callback_arg@173-176@lib/libcrypto/bio/bio_lib.c","lib/libcrypto/bio/bio_lib.c","BIO_set_callback_arg",173,176
4,1,14,1,3,"BIO_get_callback_arg@179-182@lib/libcrypto/bio/bio_lib.c","lib/libcrypto/bio/bio_lib.c","BIO_get_callback_arg",179,182
4,1,16,1,3,"BIO_method_name@185-188@lib/libcrypto/bio/bio_lib.c","lib/libcrypto/bio/bio_lib.c","BIO_method_name",185,188
4,1,16,1,3,"BIO_method_type@191-194@lib/libcrypto/bio/bio_lib.c","lib/libcrypto/bio/bio_lib.c","BIO_method_type",191,194
24,8,211,3,29,"BIO_read@197-226@lib/libcrypto/bio/bio_lib.c","lib/libcrypto/bio/bio_lib.c","BIO_read",197,226
26,8,217,3,32,"BIO_write@229-261@lib/libcrypto/bio/bio_lib.c","lib/libcrypto/bio/bio_lib.c","BIO_write",229,261
23,8,207,2,29,"BIO_puts@264-293@lib/libcrypto/bio/bio_lib.c","lib/libcrypto/bio/bio_lib.c","BIO_puts",264,293
21,7,195,3,26,"BIO_gets@296-322@lib/libcrypto/bio/bio_lib.c","lib/libcrypto/bio/bio_lib.c","BIO_gets",296,322
11,5,56,3,10,"BIO_indent@325-335@lib/libcrypto/bio/bio_lib.c","lib/libcrypto/bio/bio_lib.c","BIO_indent",325,335
6,1,43,4,6,"BIO_int_ctrl@338-344@lib/libcrypto/bio/bio_lib.c","lib/libcrypto/bio/bio_lib.c","BIO_int_ctrl",338,344
8,2,51,3,8,"BIO_ptr_ctrl@347-355@lib/libcrypto/bio/bio_lib.c","lib/libcrypto/bio/bio_lib.c","BIO_ptr_ctrl",347,355
19,6,176,4,24,"BIO_ctrl@358-382@lib/libcrypto/bio/bio_lib.c","lib/libcrypto/bio/bio_lib.c","BIO_ctrl",358,382
20,6,200,3,25,"BIO_callback_ctrl@385-410@lib/libcrypto/bio/bio_lib.c","lib/libcrypto/bio/bio_lib.c","BIO_callback_ctrl",385,410
4,1,20,1,3,"BIO_ctrl_pending@416-419@lib/libcrypto/bio/bio_lib.c","lib/libcrypto/bio/bio_lib.c","BIO_ctrl_pending",416,419
4,1,20,1,3,"BIO_ctrl_wpending@422-425@lib/libcrypto/bio/bio_lib.c","lib/libcrypto/bio/bio_lib.c","BIO_ctrl_wpending",422,425
14,4,79,2,15,"BIO_push@430-445@lib/libcrypto/bio/bio_lib.c","lib/libcrypto/bio/bio_lib.c","BIO_push",430,445
15,4,93,1,18,"BIO_pop@449-467@lib/libcrypto/bio/bio_lib.c","lib/libcrypto/bio/bio_lib.c","BIO_pop",449,467
16,5,78,2,16,"BIO_get_retry_BIO@470-486@lib/libcrypto/bio/bio_lib.c","lib/libcrypto/bio/bio_lib.c","BIO_get_retry_BIO",470,486
4,1,15,1,3,"BIO_get_retry_reason@489-492@lib/libcrypto/bio/bio_lib.c","lib/libcrypto/bio/bio_lib.c","BIO_get_retry_reason",489,492
19,7,99,2,19,"BIO_find_type@495-514@lib/libcrypto/bio/bio_lib.c","lib/libcrypto/bio/bio_lib.c","BIO_find_type",495,514
6,2,21,1,5,"BIO_next@517-522@lib/libcrypto/bio/bio_lib.c","lib/libcrypto/bio/bio_lib.c","BIO_next",517,522
13,3,52,1,14,"BIO_free_all@525-539@lib/libcrypto/bio/bio_lib.c","lib/libcrypto/bio/bio_lib.c","BIO_free_all",525,539
32,6,201,1,39,"BIO_dup_chain@542-581@lib/libcrypto/bio/bio_lib.c","lib/libcrypto/bio/bio_lib.c","BIO_dup_chain",542,581
5,1,30,1,4,"BIO_copy_next_retry@584-588@lib/libcrypto/bio/bio_lib.c","lib/libcrypto/bio/bio_lib.c","BIO_copy_next_retry",584,588
6,1,39,5,5,"BIO_get_ex_new_index@591-596@lib/libcrypto/bio/bio_lib.c","lib/libcrypto/bio/bio_lib.c","BIO_get_ex_new_index",591,596
4,1,32,3,3,"BIO_set_ex_data@599-602@lib/libcrypto/bio/bio_lib.c","lib/libcrypto/bio/bio_lib.c","BIO_set_ex_data",599,602
4,1,26,2,3,"BIO_get_ex_data@605-608@lib/libcrypto/bio/bio_lib.c","lib/libcrypto/bio/bio_lib.c","BIO_get_ex_data",605,608
6,2,20,1,5,"BIO_number_read@611-616@lib/libcrypto/bio/bio_lib.c","lib/libcrypto/bio/bio_lib.c","BIO_number_read",611,616
6,2,20,1,5,"BIO_number_written@619-624@lib/libcrypto/bio/bio_lib.c","lib/libcrypto/bio/bio_lib.c","BIO_number_written",619,624
4,1,12,1,3,"BIO_s_accept@115-118@lib/libcrypto/bio/bss_acpt.c","lib/libcrypto/bio/bss_acpt.c","BIO_s_accept",115,118
13,2,75,1,13,"acpt_new@121-134@lib/libcrypto/bio/bss_acpt.c","lib/libcrypto/bio/bss_acpt.c","acpt_new",121,134
9,2,51,1,9,"BIO_ACCEPT_new@137-146@lib/libcrypto/bio/bss_acpt.c","lib/libcrypto/bio/bss_acpt.c","BIO_ACCEPT_new",137,146
9,2,42,1,9,"BIO_ACCEPT_free@149-158@lib/libcrypto/bio/bss_acpt.c","lib/libcrypto/bio/bss_acpt.c","BIO_ACCEPT_free",149,158
11,2,63,1,11,"acpt_close_socket@161-172@lib/libcrypto/bio/bss_acpt.c","lib/libcrypto/bio/bss_acpt.c","acpt_close_socket",161,172
15,3,74,1,16,"acpt_free@175-191@lib/libcrypto/bio/bss_acpt.c","lib/libcrypto/bio/bss_acpt.c","acpt_free",175,191
76,20,421,2,92,"acpt_state@194-286@lib/libcrypto/bio/bss_acpt.c","lib/libcrypto/bio/bss_acpt.c","acpt_state",194,286
15,3,92,3,17,"acpt_read@289-306@lib/libcrypto/bio/bss_acpt.c","lib/libcrypto/bio/bss_acpt.c","acpt_read",289,306
15,3,91,3,17,"acpt_write@309-326@lib/libcrypto/bio/bss_acpt.c","lib/libcrypto/bio/bss_acpt.c","acpt_write",309,326
87,24,431,4,97,"acpt_ctrl@329-426@lib/libcrypto/bio/bss_acpt.c","lib/libcrypto/bio/bss_acpt.c","acpt_ctrl",329,426
7,1,41,2,7,"acpt_puts@429-436@lib/libcrypto/bio/bss_acpt.c","lib/libcrypto/bio/bss_acpt.c","acpt_puts",429,436
13,3,59,1,13,"BIO_new_accept@439-452@lib/libcrypto/bio/bss_acpt.c","lib/libcrypto/bio/bss_acpt.c","BIO_new_accept",439,452
4,1,10,1,3,"BIO_s_bio@109-112@lib/libcrypto/bio/bss_bio.c","lib/libcrypto/bio/bss_bio.c","BIO_s_bio",109,112
12,2,60,1,14,"bio_new@134-148@lib/libcrypto/bio/bss_bio.c","lib/libcrypto/bio/bss_bio.c","bio_new",134,148
13,3,61,1,16,"bio_free@151-167@lib/libcrypto/bio/bss_bio.c","lib/libcrypto/bio/bss_bio.c","bio_free",151,167
58,12,339,3,77,"bio_read@172-249@lib/libcrypto/bio/bss_bio.c","lib/libcrypto/bio/bss_bio.c","bio_read",172,249
26,5,169,2,35,"bio_nread0@260-295@lib/libcrypto/bio/bss_bio.c","lib/libcrypto/bio/bss_bio.c","bio_nread0",260,295
25,6,145,3,29,"bio_nread@298-327@lib/libcrypto/bio/bss_bio.c","lib/libcrypto/bio/bss_bio.c","bio_nread",298,327
46,10,286,3,69,"bio_write@331-400@lib/libcrypto/bio/bss_bio.c","lib/libcrypto/bio/bss_bio.c","bio_write",331,400
33,7,205,2,45,"bio_nwrite0@409-454@lib/libcrypto/bio/bss_bio.c","lib/libcrypto/bio/bss_bio.c","bio_nwrite0",409,454
19,4,104,3,21,"bio_nwrite@457-478@lib/libcrypto/bio/bss_bio.c","lib/libcrypto/bio/bss_bio.c","bio_nwrite",457,478
126,32,596,4,179,"bio_ctrl@482-661@lib/libcrypto/bio/bss_bio.c","lib/libcrypto/bio/bss_bio.c","bio_ctrl",482,661
4,1,26,2,3,"bio_puts@664-667@lib/libcrypto/bio/bss_bio.c","lib/libcrypto/bio/bss_bio.c","bio_puts",664,667
39,7,223,2,46,"bio_make_pair@671-717@lib/libcrypto/bio/bss_bio.c","lib/libcrypto/bio/bss_bio.c","bio_make_pair",671,717
22,3,132,1,26,"bio_destroy_pair@720-746@lib/libcrypto/bio/bss_bio.c","lib/libcrypto/bio/bss_bio.c","bio_destroy_pair",720,746
40,11,193,4,44,"BIO_new_bio_pair@751-795@lib/libcrypto/bio/bss_bio.c","lib/libcrypto/bio/bss_bio.c","BIO_new_bio_pair",751,795
4,1,20,1,3,"BIO_ctrl_get_write_guarantee@798-801@lib/libcrypto/bio/bss_bio.c","lib/libcrypto/bio/bss_bio.c","BIO_ctrl_get_write_guarantee",798,801
4,1,20,1,3,"BIO_ctrl_get_read_request@804-807@lib/libcrypto/bio/bss_bio.c","lib/libcrypto/bio/bss_bio.c","BIO_ctrl_get_read_request",804,807
4,1,24,1,3,"BIO_ctrl_reset_read_request@810-813@lib/libcrypto/bio/bss_bio.c","lib/libcrypto/bio/bss_bio.c","BIO_ctrl_reset_read_request",810,813
13,3,62,2,14,"BIO_nread0@820-834@lib/libcrypto/bio/bss_bio.c","lib/libcrypto/bio/bss_bio.c","BIO_nread0",820,834
12,3,67,3,13,"BIO_nread@837-850@lib/libcrypto/bio/bss_bio.c","lib/libcrypto/bio/bss_bio.c","BIO_nread",837,850
13,3,62,2,14,"BIO_nwrite0@853-867@lib/libcrypto/bio/bss_bio.c","lib/libcrypto/bio/bss_bio.c","BIO_nwrite0",853,867
12,3,64,3,13,"BIO_nwrite@870-883@lib/libcrypto/bio/bss_bio.c","lib/libcrypto/bio/bss_bio.c","BIO_nwrite",870,883
146,35,890,2,166,"conn_state@122-288@lib/libcrypto/bio/bss_conn.c","lib/libcrypto/bio/bss_conn.c","conn_state",122,288
18,2,129,1,18,"BIO_CONNECT_new@291-309@lib/libcrypto/bio/bss_conn.c","lib/libcrypto/bio/bss_conn.c","BIO_CONNECT_new",291,309
8,2,35,1,8,"BIO_CONNECT_free@312-320@lib/libcrypto/bio/bss_conn.c","lib/libcrypto/bio/bss_conn.c","BIO_CONNECT_free",312,320
4,1,12,1,3,"BIO_s_connect@323-326@lib/libcrypto/bio/bss_conn.c","lib/libcrypto/bio/bss_conn.c","BIO_s_connect",323,326
10,2,56,1,9,"conn_new@329-338@lib/libcrypto/bio/bss_conn.c","lib/libcrypto/bio/bss_conn.c","conn_new",329,338
11,3,64,1,12,"conn_close_socket@341-353@lib/libcrypto/bio/bss_conn.c","lib/libcrypto/bio/bss_conn.c","conn_close_socket",341,353
15,3,74,1,16,"conn_free@356-372@lib/libcrypto/bio/bss_conn.c","lib/libcrypto/bio/bss_conn.c","conn_free",356,372
21,6,119,3,22,"conn_read@375-397@lib/libcrypto/bio/bss_conn.c","lib/libcrypto/bio/bss_conn.c","conn_read",375,397
19,5,110,3,20,"conn_write@400-420@lib/libcrypto/bio/bss_conn.c","lib/libcrypto/bio/bss_conn.c","conn_write",400,420
121,35,698,4,129,"conn_ctrl@423-552@lib/libcrypto/bio/bss_conn.c","lib/libcrypto/bio/bss_conn.c","conn_ctrl",423,552
17,2,82,3,18,"conn_callback_ctrl@555-573@lib/libcrypto/bio/bss_conn.c","lib/libcrypto/bio/bss_conn.c","conn_callback_ctrl",555,573
7,1,41,2,7,"conn_puts@576-583@lib/libcrypto/bio/bss_conn.c","lib/libcrypto/bio/bss_conn.c","conn_puts",576,583
13,3,59,1,13,"BIO_new_connect@586-599@lib/libcrypto/bio/bss_conn.c","lib/libcrypto/bio/bss_conn.c","BIO_new_connect",586,599
4,1,12,1,3,"BIO_s_datagram@116-119@lib/libcrypto/bio/bss_dgram.c","lib/libcrypto/bio/bss_dgram.c","BIO_s_datagram",116,119
9,2,48,2,9,"BIO_new_dgram@122-131@lib/libcrypto/bio/bss_dgram.c","lib/libcrypto/bio/bss_dgram.c","BIO_new_dgram",122,131
12,2,64,1,13,"dgram_new@134-147@lib/libcrypto/bio/bss_dgram.c","lib/libcrypto/bio/bss_dgram.c","dgram_new",134,147
11,3,54,1,13,"dgram_free@150-163@lib/libcrypto/bio/bss_dgram.c","lib/libcrypto/bio/bss_dgram.c","dgram_free",150,163
14,4,68,1,13,"dgram_clear@166-179@lib/libcrypto/bio/bss_dgram.c","lib/libcrypto/bio/bss_dgram.c","dgram_clear",166,179
34,13,261,1,48,"dgram_adjust_rcv_timeout@182-230@lib/libcrypto/bio/bss_dgram.c","lib/libcrypto/bio/bss_dgram.c","dgram_adjust_rcv_timeout",182,230
10,5,75,1,13,"dgram_reset_rcv_timeout@233-246@lib/libcrypto/bio/bss_dgram.c","lib/libcrypto/bio/bss_dgram.c","dgram_reset_rcv_timeout",233,246
31,6,197,3,36,"dgram_read@249-285@lib/libcrypto/bio/bss_dgram.c","lib/libcrypto/bio/bss_dgram.c","dgram_read",249,285
24,6,176,3,31,"dgram_write@288-319@lib/libcrypto/bio/bss_dgram.c","lib/libcrypto/bio/bss_dgram.c","dgram_write",288,319
265,73,1419,4,296,"dgram_ctrl@322-618@lib/libcrypto/bio/bss_dgram.c","lib/libcrypto/bio/bss_dgram.c","dgram_ctrl",322,618
7,1,41,2,7,"dgram_puts@621-628@lib/libcrypto/bio/bss_dgram.c","lib/libcrypto/bio/bss_dgram.c","dgram_puts",621,628
9,3,44,1,9,"BIO_dgram_should_retry@632-641@lib/libcrypto/bio/bss_dgram.c","lib/libcrypto/bio/bss_dgram.c","BIO_dgram_should_retry",632,641
13,5,39,1,12,"BIO_dgram_non_fatal_error@644-656@lib/libcrypto/bio/bss_dgram.c","lib/libcrypto/bio/bss_dgram.c","BIO_dgram_non_fatal_error",644,656
4,1,12,1,3,"BIO_s_fd@90-93@lib/libcrypto/bio/bss_fd.c","lib/libcrypto/bio/bss_fd.c","BIO_s_fd",90,93
9,2,48,2,8,"BIO_new_fd@96-104@lib/libcrypto/bio/bss_fd.c","lib/libcrypto/bio/bss_fd.c","BIO_new_fd",96,104
8,1,38,1,7,"fd_new@107-114@lib/libcrypto/bio/bss_fd.c","lib/libcrypto/bio/bss_fd.c","fd_new",107,114
13,4,59,1,12,"fd_free@117-129@lib/libcrypto/bio/bss_fd.c","lib/libcrypto/bio/bss_fd.c","fd_free",117,129
14,4,75,3,14,"fd_read@132-146@lib/libcrypto/bio/bss_fd.c","lib/libcrypto/bio/bss_fd.c","fd_read",132,146
12,3,66,3,11,"fd_write@149-160@lib/libcrypto/bio/bss_fd.c","lib/libcrypto/bio/bss_fd.c","fd_write",149,160
49,15,231,4,49,"fd_ctrl@163-212@lib/libcrypto/bio/bss_fd.c","lib/libcrypto/bio/bss_fd.c","fd_ctrl",163,212
7,1,41,2,7,"fd_puts@215-222@lib/libcrypto/bio/bss_fd.c","lib/libcrypto/bio/bss_fd.c","fd_puts",215,222
12,5,97,3,14,"fd_gets@225-239@lib/libcrypto/bio/bss_fd.c","lib/libcrypto/bio/bss_fd.c","fd_gets",225,239
9,3,44,1,9,"BIO_fd_should_retry@242-251@lib/libcrypto/bio/bss_fd.c","lib/libcrypto/bio/bss_fd.c","BIO_fd_should_retry",242,251
14,6,42,1,13,"BIO_fd_non_fatal_error@254-267@lib/libcrypto/bio/bss_fd.c","lib/libcrypto/bio/bss_fd.c","BIO_fd_non_fatal_error",254,267
21,4,118,2,23,"BIO_new_file@114-137@lib/libcrypto/bio/bss_file.c","lib/libcrypto/bio/bss_file.c","BIO_new_file",114,137
8,2,49,2,9,"BIO_new_fp@140-149@lib/libcrypto/bio/bss_file.c","lib/libcrypto/bio/bss_file.c","BIO_new_fp",140,149
4,1,12,1,3,"BIO_s_file@152-155@lib/libcrypto/bio/bss_file.c","lib/libcrypto/bio/bss_file.c","BIO_s_file",152,155
8,1,37,1,7,"file_new@158-165@lib/libcrypto/bio/bss_file.c","lib/libcrypto/bio/bss_file.c","file_new",158,165
14,5,75,1,13,"file_free@168-181@lib/libcrypto/bio/bss_file.c","lib/libcrypto/bio/bss_file.c","file_free",168,181
13,5,90,3,13,"file_read@184-197@lib/libcrypto/bio/bss_file.c","lib/libcrypto/bio/bss_file.c","file_read",184,197
7,3,55,3,7,"file_write@200-207@lib/libcrypto/bio/bss_file.c","lib/libcrypto/bio/bss_file.c","file_write",200,207
81,25,429,4,83,"file_ctrl@210-293@lib/libcrypto/bio/bss_file.c","lib/libcrypto/bio/bss_file.c","file_ctrl",210,293
11,3,71,3,11,"file_gets@296-307@lib/libcrypto/bio/bss_file.c","lib/libcrypto/bio/bss_file.c","file_gets",296,307
7,1,41,2,7,"file_puts@310-317@lib/libcrypto/bio/bss_file.c","lib/libcrypto/bio/bss_file.c","file_puts",310,317
4,1,12,1,3,"BIO_s_log@95-98@lib/libcrypto/bio/bss_log.c","lib/libcrypto/bio/bss_log.c","BIO_s_log",95,98
8,1,40,1,7,"slg_new@101-108@lib/libcrypto/bio/bss_log.c","lib/libcrypto/bio/bss_log.c","slg_new",101,108
7,2,29,1,6,"slg_free@111-117@lib/libcrypto/bio/bss_log.c","lib/libcrypto/bio/bss_log.c","slg_free",111,117
46,3,319,3,48,"slg_write@120-168@lib/libcrypto/bio/bss_log.c","lib/libcrypto/bio/bss_log.c","slg_write",120,168
12,2,52,4,11,"slg_ctrl@171-182@lib/libcrypto/bio/bss_log.c","lib/libcrypto/bio/bss_log.c","slg_ctrl",171,182
7,1,41,2,7,"slg_puts@185-192@lib/libcrypto/bio/bss_log.c","lib/libcrypto/bio/bss_log.c","slg_puts",185,192
4,1,26,3,3,"xopenlog@196-199@lib/libcrypto/bio/bss_log.c","lib/libcrypto/bio/bss_log.c","xopenlog",196,199
4,1,25,3,3,"xsyslog@202-205@lib/libcrypto/bio/bss_log.c","lib/libcrypto/bio/bss_log.c","xsyslog",202,205
4,1,12,1,3,"xcloselog@208-211@lib/libcrypto/bio/bss_log.c","lib/libcrypto/bio/bss_log.c","xcloselog",208,211
4,1,12,1,3,"BIO_s_mem@91-94@lib/libcrypto/bio/bss_mem.c","lib/libcrypto/bio/bss_mem.c","BIO_s_mem",91,94
20,4,115,2,21,"BIO_new_mem_buf@97-118@lib/libcrypto/bio/bss_mem.c","lib/libcrypto/bio/bss_mem.c","BIO_new_mem_buf",97,118
11,2,63,1,11,"mem_new@121-132@lib/libcrypto/bio/bss_mem.c","lib/libcrypto/bio/bss_mem.c","mem_new",121,132
16,6,89,1,15,"mem_free@135-150@lib/libcrypto/bio/bss_mem.c","lib/libcrypto/bio/bss_mem.c","mem_free",135,150
22,8,176,3,22,"mem_read@153-175@lib/libcrypto/bio/bss_mem.c","lib/libcrypto/bio/bss_mem.c","mem_read",153,175
23,4,132,3,25,"mem_write@178-203@lib/libcrypto/bio/bss_mem.c","lib/libcrypto/bio/bss_mem.c","mem_write",178,203
65,19,328,4,68,"mem_ctrl@206-274@lib/libcrypto/bio/bss_mem.c","lib/libcrypto/bio/bss_mem.c","mem_ctrl",206,274
27,6,155,3,33,"mem_gets@277-310@lib/libcrypto/bio/bss_mem.c","lib/libcrypto/bio/bss_mem.c","mem_gets",277,310
7,1,41,2,8,"mem_puts@313-321@lib/libcrypto/bio/bss_mem.c","lib/libcrypto/bio/bss_mem.c","mem_puts",313,321
4,1,12,1,3,"BIO_s_null@86-89@lib/libcrypto/bio/bss_null.c","lib/libcrypto/bio/bss_null.c","BIO_s_null",86,89
7,1,33,1,6,"null_new@92-98@lib/libcrypto/bio/bss_null.c","lib/libcrypto/bio/bss_null.c","null_new",92,98
6,2,24,1,5,"null_free@101-106@lib/libcrypto/bio/bss_null.c","lib/libcrypto/bio/bss_null.c","null_free",101,106
4,1,20,3,3,"null_read@109-112@lib/libcrypto/bio/bss_null.c","lib/libcrypto/bio/bss_null.c","null_read",109,112
4,1,21,3,3,"null_write@115-118@lib/libcrypto/bio/bss_null.c","lib/libcrypto/bio/bss_null.c","null_write",115,118
23,12,81,4,23,"null_ctrl@121-144@lib/libcrypto/bio/bss_null.c","lib/libcrypto/bio/bss_null.c","null_ctrl",121,144
4,1,20,3,3,"null_gets@147-150@lib/libcrypto/bio/bss_null.c","lib/libcrypto/bio/bss_null.c","null_gets",147,150
6,2,32,2,5,"null_puts@153-158@lib/libcrypto/bio/bss_null.c","lib/libcrypto/bio/bss_null.c","null_puts",153,158
4,1,12,1,3,"BIO_s_socket@88-91@lib/libcrypto/bio/bss_sock.c","lib/libcrypto/bio/bss_sock.c","BIO_s_socket",88,91
9,2,48,2,9,"BIO_new_socket@94-103@lib/libcrypto/bio/bss_sock.c","lib/libcrypto/bio/bss_sock.c","BIO_new_socket",94,103
8,1,37,1,7,"sock_new@106-113@lib/libcrypto/bio/bss_sock.c","lib/libcrypto/bio/bss_sock.c","sock_new",106,113
14,4,68,1,13,"sock_free@116-129@lib/libcrypto/bio/bss_sock.c","lib/libcrypto/bio/bss_sock.c","sock_free",116,129
14,4,75,3,14,"sock_read@132-146@lib/libcrypto/bio/bss_sock.c","lib/libcrypto/bio/bss_sock.c","sock_read",132,146
12,3,66,3,12,"sock_write@149-161@lib/libcrypto/bio/bss_sock.c","lib/libcrypto/bio/bss_sock.c","sock_write",149,161
36,9,167,4,36,"sock_ctrl@164-200@lib/libcrypto/bio/bss_sock.c","lib/libcrypto/bio/bss_sock.c","sock_ctrl",164,200
7,1,41,2,7,"sock_puts@203-210@lib/libcrypto/bio/bss_sock.c","lib/libcrypto/bio/bss_sock.c","sock_puts",203,210
9,3,44,1,9,"BIO_sock_should_retry@213-222@lib/libcrypto/bio/bss_sock.c","lib/libcrypto/bio/bss_sock.c","BIO_sock_should_retry",213,222
14,6,42,1,13,"BIO_sock_non_fatal_error@225-238@lib/libcrypto/bio/bss_sock.c","lib/libcrypto/bio/bss_sock.c","BIO_sock_non_fatal_error",225,238
20,6,208,4,22,"bn_mul_add_words@103-125@lib/libcrypto/bn/asm/x86_64-gcc.c","lib/libcrypto/bn/asm/x86_64-gcc.c","bn_mul_add_words",103,125
20,6,205,4,21,"bn_mul_words@127-148@lib/libcrypto/bn/asm/x86_64-gcc.c","lib/libcrypto/bn/asm/x86_64-gcc.c","bn_mul_words",127,148
18,6,194,3,18,"bn_sqr_words@150-168@lib/libcrypto/bn/asm/x86_64-gcc.c","lib/libcrypto/bn/asm/x86_64-gcc.c","bn_sqr_words",150,168
8,1,53,3,9,"bn_div_words@170-179@lib/libcrypto/bn/asm/x86_64-gcc.c","lib/libcrypto/bn/asm/x86_64-gcc.c","bn_div_words",170,179
18,2,88,4,20,"bn_add_words@181-201@lib/libcrypto/bn/asm/x86_64-gcc.c","lib/libcrypto/bn/asm/x86_64-gcc.c","bn_add_words",181,201
18,2,88,4,20,"bn_sub_words@203-223@lib/libcrypto/bn/asm/x86_64-gcc.c","lib/libcrypto/bn/asm/x86_64-gcc.c","bn_sub_words",203,223
101,1,1419,3,101,"bn_mul_comba8@306-407@lib/libcrypto/bn/asm/x86_64-gcc.c","lib/libcrypto/bn/asm/x86_64-gcc.c","bn_mul_comba8",306,407
37,1,419,3,37,"bn_mul_comba4@409-446@lib/libcrypto/bn/asm/x86_64-gcc.c","lib/libcrypto/bn/asm/x86_64-gcc.c","bn_mul_comba4",409,446
73,1,724,2,73,"bn_sqr_comba8@448-521@lib/libcrypto/bn/asm/x86_64-gcc.c","lib/libcrypto/bn/asm/x86_64-gcc.c","bn_sqr_comba8",448,521
31,1,254,2,31,"bn_sqr_comba4@523-554@lib/libcrypto/bn/asm/x86_64-gcc.c","lib/libcrypto/bn/asm/x86_64-gcc.c","bn_sqr_comba4",523,554
28,6,162,3,39,"BN_add@67-106@lib/libcrypto/bn/bn_add.c","lib/libcrypto/bn/bn_add.c","BN_add",67,106
48,10,271,3,56,"BN_uadd@110-166@lib/libcrypto/bn/bn_add.c","lib/libcrypto/bn/bn_add.c","BN_uadd",110,166
74,17,432,3,87,"BN_usub@170-257@lib/libcrypto/bn/bn_add.c","lib/libcrypto/bn/bn_add.c","BN_usub",170,257
43,11,245,3,53,"BN_sub@260-313@lib/libcrypto/bn/bn_add.c","lib/libcrypto/bn/bn_add.c","BN_sub",260,313
23,4,167,4,27,"bn_mul_add_words@74-101@lib/libcrypto/bn/bn_asm.c","lib/libcrypto/bn/bn_asm.c","bn_mul_add_words",74,101
23,4,167,4,26,"bn_mul_words@104-130@lib/libcrypto/bn/bn_asm.c","lib/libcrypto/bn/bn_asm.c","bn_mul_words",104,130
21,4,157,3,23,"bn_sqr_words@133-156@lib/libcrypto/bn/bn_asm.c","lib/libcrypto/bn/bn_asm.c","bn_sqr_words",133,156
26,4,199,4,30,"bn_mul_add_words@161-191@lib/libcrypto/bn/bn_asm.c","lib/libcrypto/bn/bn_asm.c","bn_mul_add_words",161,191
26,4,199,4,30,"bn_mul_words@194-224@lib/libcrypto/bn/bn_asm.c","lib/libcrypto/bn/bn_asm.c","bn_mul_words",194,224
21,4,157,3,23,"bn_sqr_words@227-250@lib/libcrypto/bn/bn_asm.c","lib/libcrypto/bn/bn_asm.c","bn_sqr_words",227,250
4,1,42,3,3,"bn_div_words@257-260@lib/libcrypto/bn/bn_asm.c","lib/libcrypto/bn/bn_asm.c","bn_div_words",257,260
56,13,360,3,63,"bn_div_words@267-330@lib/libcrypto/bn/bn_asm.c","lib/libcrypto/bn/bn_asm.c","bn_div_words",267,330
35,4,257,4,38,"bn_add_words@335-373@lib/libcrypto/bn/bn_asm.c","lib/libcrypto/bn/bn_asm.c","bn_add_words",335,373
51,4,368,4,54,"bn_add_words@376-430@lib/libcrypto/bn/bn_asm.c","lib/libcrypto/bn/bn_asm.c","bn_add_words",376,430
46,9,314,4,49,"bn_sub_words@434-483@lib/libcrypto/bn/bn_asm.c","lib/libcrypto/bn/bn_asm.c","bn_sub_words",434,483
101,1,1419,3,101,"bn_mul_comba8@641-742@lib/libcrypto/bn/bn_asm.c","lib/libcrypto/bn/bn_asm.c","bn_mul_comba8",641,742
37,1,419,3,37,"bn_mul_comba4@745-782@lib/libcrypto/bn/bn_asm.c","lib/libcrypto/bn/bn_asm.c","bn_mul_comba4",745,782
73,1,724,2,73,"bn_sqr_comba8@785-858@lib/libcrypto/bn/bn_asm.c","lib/libcrypto/bn/bn_asm.c","bn_sqr_comba8",785,858
31,1,254,2,31,"bn_sqr_comba4@861-892@lib/libcrypto/bn/bn_asm.c","lib/libcrypto/bn/bn_asm.c","bn_sqr_comba4",861,892
63,21,613,6,84,"bn_mul_mont@910-994@lib/libcrypto/bn/bn_asm.c","lib/libcrypto/bn/bn_asm.c","bn_mul_mont",910,994
3,1,34,6,2,"bn_mul_mont@1001-1003@lib/libcrypto/bn/bn_asm.c","lib/libcrypto/bn/bn_asm.c","bn_mul_mont",1001,1003
5,1,30,2,4,"bn_sqr_comba4@1012-1016@lib/libcrypto/bn/bn_asm.c","lib/libcrypto/bn/bn_asm.c","bn_sqr_comba4",1012,1016
5,1,30,2,4,"bn_sqr_comba8@1020-1024@lib/libcrypto/bn/bn_asm.c","lib/libcrypto/bn/bn_asm.c","bn_sqr_comba8",1020,1024
7,1,116,3,6,"bn_mul_comba4@1027-1033@lib/libcrypto/bn/bn_asm.c","lib/libcrypto/bn/bn_asm.c","bn_mul_comba4",1027,1033
11,1,216,3,10,"bn_mul_comba8@1036-1046@lib/libcrypto/bn/bn_asm.c","lib/libcrypto/bn/bn_asm.c","bn_mul_comba8",1036,1046
31,10,315,6,34,"bn_mul_mont@1051-1085@lib/libcrypto/bn/bn_asm.c","lib/libcrypto/bn/bn_asm.c","bn_mul_mont",1051,1085
5,1,34,6,4,"bn_mul_mont@1088-1092@lib/libcrypto/bn/bn_asm.c","lib/libcrypto/bn/bn_asm.c","bn_mul_mont",1088,1092
28,9,187,3,36,"BN_BLINDING_new@140-176@lib/libcrypto/bn/bn_blind.c","lib/libcrypto/bn/bn_blind.c","BN_BLINDING_new",140,176
10,2,49,1,10,"BN_BLINDING_free@179-189@lib/libcrypto/bn/bn_blind.c","lib/libcrypto/bn/bn_blind.c","BN_BLINDING_free",179,189
25,12,200,2,30,"BN_BLINDING_update@192-222@lib/libcrypto/bn/bn_blind.c","lib/libcrypto/bn/bn_blind.c","BN_BLINDING_update",192,222
4,1,28,3,3,"BN_BLINDING_convert@225-228@lib/libcrypto/bn/bn_blind.c","lib/libcrypto/bn/bn_blind.c","BN_BLINDING_convert",225,228
20,8,142,4,26,"BN_BLINDING_convert_ex@231-257@lib/libcrypto/bn/bn_blind.c","lib/libcrypto/bn/bn_blind.c","BN_BLINDING_convert_ex",231,257
4,1,28,3,3,"BN_BLINDING_invert@260-263@lib/libcrypto/bn/bn_blind.c","lib/libcrypto/bn/bn_blind.c","BN_BLINDING_invert",260,263
16,3,104,4,18,"BN_BLINDING_invert_ex@266-284@lib/libcrypto/bn/bn_blind.c","lib/libcrypto/bn/bn_blind.c","BN_BLINDING_invert_ex",266,284
4,1,14,1,3,"BN_BLINDING_get_thread_id@288-291@lib/libcrypto/bn/bn_blind.c","lib/libcrypto/bn/bn_blind.c","BN_BLINDING_get_thread_id",288,291
4,1,18,2,3,"BN_BLINDING_set_thread_id@294-297@lib/libcrypto/bn/bn_blind.c","lib/libcrypto/bn/bn_blind.c","BN_BLINDING_set_thread_id",294,297
4,1,14,1,3,"BN_BLINDING_thread_id@301-304@lib/libcrypto/bn/bn_blind.c","lib/libcrypto/bn/bn_blind.c","BN_BLINDING_thread_id",301,304
4,1,14,1,3,"BN_BLINDING_get_flags@307-310@lib/libcrypto/bn/bn_blind.c","lib/libcrypto/bn/bn_blind.c","BN_BLINDING_get_flags",307,310
4,1,18,2,3,"BN_BLINDING_set_flags@313-316@lib/libcrypto/bn/bn_blind.c","lib/libcrypto/bn/bn_blind.c","BN_BLINDING_set_flags",313,316
58,20,409,6,68,"BN_BLINDING_create_param@319-387@lib/libcrypto/bn/bn_blind.c","lib/libcrypto/bn/bn_blind.c","BN_BLINDING_create_param",319,387
14,1,224,1,13,"get_rfc2409_prime_768@15-28@lib/libcrypto/bn/bn_const.c","lib/libcrypto/bn/bn_const.c","get_rfc2409_prime_768",15,28
17,1,288,1,16,"get_rfc2409_prime_1024@39-55@lib/libcrypto/bn/bn_const.c","lib/libcrypto/bn/bn_const.c","get_rfc2409_prime_1024",39,55
22,1,416,1,21,"get_rfc3526_prime_1536@66-87@lib/libcrypto/bn/bn_const.c","lib/libcrypto/bn/bn_const.c","get_rfc3526_prime_1536",66,87
28,1,544,1,27,"get_rfc3526_prime_2048@97-124@lib/libcrypto/bn/bn_const.c","lib/libcrypto/bn/bn_const.c","get_rfc3526_prime_2048",97,124
38,1,800,1,37,"get_rfc3526_prime_3072@134-171@lib/libcrypto/bn/bn_const.c","lib/libcrypto/bn/bn_const.c","get_rfc3526_prime_3072",134,171
49,1,1056,1,48,"get_rfc3526_prime_4096@181-229@lib/libcrypto/bn/bn_const.c","lib/libcrypto/bn/bn_const.c","get_rfc3526_prime_4096",181,229
70,1,1568,1,69,"get_rfc3526_prime_6144@239-308@lib/libcrypto/bn/bn_const.c","lib/libcrypto/bn/bn_const.c","get_rfc3526_prime_6144",239,308
92,1,2080,1,91,"get_rfc3526_prime_8192@318-409@lib/libcrypto/bn/bn_const.c","lib/libcrypto/bn/bn_const.c","get_rfc3526_prime_8192",318,409
24,5,161,1,24,"ctxdbg@160-184@lib/libcrypto/bn/bn_ctx.c","lib/libcrypto/bn/bn_ctx.c","ctxdbg",160,184
8,1,42,1,11,"BN_CTX_init@209-220@lib/libcrypto/bn/bn_ctx.c","lib/libcrypto/bn/bn_ctx.c","BN_CTX_init",209,220
14,2,70,1,15,"BN_CTX_new@224-239@lib/libcrypto/bn/bn_ctx.c","lib/libcrypto/bn/bn_ctx.c","BN_CTX_new",224,239
22,5,122,1,23,"BN_CTX_free@242-265@lib/libcrypto/bn/bn_ctx.c","lib/libcrypto/bn/bn_ctx.c","BN_CTX_free",242,265
11,4,63,1,13,"BN_CTX_start@268-281@lib/libcrypto/bn/bn_ctx.c","lib/libcrypto/bn/bn_ctx.c","BN_CTX_start",268,281
14,3,80,1,16,"BN_CTX_end@284-300@lib/libcrypto/bn/bn_ctx.c","lib/libcrypto/bn/bn_ctx.c","BN_CTX_end",284,300
16,4,84,1,20,"BN_CTX_get@303-323@lib/libcrypto/bn/bn_ctx.c","lib/libcrypto/bn/bn_ctx.c","BN_CTX_get",303,323
5,1,24,1,4,"BN_STACK_init@330-334@lib/libcrypto/bn/bn_ctx.c","lib/libcrypto/bn/bn_ctx.c","BN_STACK_init",330,334
5,2,21,1,4,"BN_STACK_finish@337-341@lib/libcrypto/bn/bn_ctx.c","lib/libcrypto/bn/bn_ctx.c","BN_STACK_finish",337,341
4,1,14,1,3,"BN_STACK_reset@345-348@lib/libcrypto/bn/bn_ctx.c","lib/libcrypto/bn/bn_ctx.c","BN_STACK_reset",345,348
21,6,139,2,21,"BN_STACK_push@352-373@lib/libcrypto/bn/bn_ctx.c","lib/libcrypto/bn/bn_ctx.c","BN_STACK_push",352,373
4,1,21,1,3,"BN_STACK_pop@376-379@lib/libcrypto/bn/bn_ctx.c","lib/libcrypto/bn/bn_ctx.c","BN_STACK_pop",376,379
5,1,32,1,4,"BN_POOL_init@386-390@lib/libcrypto/bn/bn_ctx.c","lib/libcrypto/bn/bn_ctx.c","BN_POOL_init",386,390
15,4,80,1,14,"BN_POOL_finish@393-407@lib/libcrypto/bn/bn_ctx.c","lib/libcrypto/bn/bn_ctx.c","BN_POOL_finish",393,407
16,4,79,1,15,"BN_POOL_reset@411-426@lib/libcrypto/bn/bn_ctx.c","lib/libcrypto/bn/bn_ctx.c","BN_POOL_reset",411,426
30,7,199,1,32,"BN_POOL_get@430-462@lib/libcrypto/bn/bn_ctx.c","lib/libcrypto/bn/bn_ctx.c","BN_POOL_get",430,462
13,3,77,2,13,"BN_POOL_release@465-478@lib/libcrypto/bn/bn_ctx.c","lib/libcrypto/bn/bn_ctx.c","BN_POOL_release",465,478
20,8,153,7,24,"BN_generate_prime@68-92@lib/libcrypto/bn/bn_depr.c","lib/libcrypto/bn/bn_depr.c","BN_generate_prime",68,92
7,1,60,5,7,"BN_is_prime@95-102@lib/libcrypto/bn/bn_depr.c","lib/libcrypto/bn/bn_depr.c","BN_is_prime",95,102
9,1,65,6,9,"BN_is_prime_fasttest@105-114@lib/libcrypto/bn/bn_depr.c","lib/libcrypto/bn/bn_depr.c","BN_is_prime_fasttest",105,114
173,49,1234,6,259,"BN_div_internal@120-379@lib/libcrypto/bn/bn_div.c","lib/libcrypto/bn/bn_div.c","BN_div_internal",120,379
7,2,69,5,7,"BN_div@382-389@lib/libcrypto/bn/bn_div.c","lib/libcrypto/bn/bn_div.c","BN_div",382,389
5,1,42,5,4,"BN_div_nonct@392-396@lib/libcrypto/bn/bn_div.c","lib/libcrypto/bn/bn_div.c","BN_div_nonct",392,396
5,1,42,5,4,"BN_div_ct@399-403@lib/libcrypto/bn/bn_div.c","lib/libcrypto/bn/bn_div.c","BN_div_ct",399,403
7,2,36,1,8,"ERR_load_BN_strings@104-112@lib/libcrypto/bn/bn_err.c","lib/libcrypto/bn/bn_err.c","ERR_load_BN_strings",104,112
42,16,265,4,48,"BN_exp@125-173@lib/libcrypto/bn/bn_exp.c","lib/libcrypto/bn/bn_exp.c","BN_exp",125,173
19,5,148,6,51,"BN_mod_exp_internal@176-227@lib/libcrypto/bn/bn_exp.c","lib/libcrypto/bn/bn_exp.c","BN_mod_exp_internal",176,227
6,1,52,5,5,"BN_mod_exp@230-235@lib/libcrypto/bn/bn_exp.c","lib/libcrypto/bn/bn_exp.c","BN_mod_exp",230,235
5,1,43,5,4,"BN_mod_exp_ct@238-242@lib/libcrypto/bn/bn_exp.c","lib/libcrypto/bn/bn_exp.c","BN_mod_exp_ct",238,242
5,1,43,5,4,"BN_mod_exp_nonct@246-250@lib/libcrypto/bn/bn_exp.c","lib/libcrypto/bn/bn_exp.c","BN_mod_exp_nonct",246,250
105,31,671,5,131,"BN_mod_exp_recp@254-385@lib/libcrypto/bn/bn_exp.c","lib/libcrypto/bn/bn_exp.c","BN_mod_exp_recp",254,385
121,38,794,7,149,"BN_mod_exp_mont_internal@388-537@lib/libcrypto/bn/bn_exp.c","lib/libcrypto/bn/bn_exp.c","BN_mod_exp_mont_internal",388,537
6,1,58,6,5,"BN_mod_exp_mont@540-545@lib/libcrypto/bn/bn_exp.c","lib/libcrypto/bn/bn_exp.c","BN_mod_exp_mont",540,545
5,1,49,6,4,"BN_mod_exp_mont_ct@548-552@lib/libcrypto/bn/bn_exp.c","lib/libcrypto/bn/bn_exp.c","BN_mod_exp_mont_ct",548,552
5,1,49,6,4,"BN_mod_exp_mont_nonct@555-559@lib/libcrypto/bn/bn_exp.c","lib/libcrypto/bn/bn_exp.c","BN_mod_exp_mont_nonct",555,559
13,3,98,5,15,"MOD_EXP_CTIME_COPY_TO_PREBUF@567-582@lib/libcrypto/bn/bn_exp.c","lib/libcrypto/bn/bn_exp.c","MOD_EXP_CTIME_COPY_TO_PREBUF",567,582
42,7,391,5,50,"MOD_EXP_CTIME_COPY_FROM_PREBUF@585-635@lib/libcrypto/bn/bn_exp.c","lib/libcrypto/bn/bn_exp.c","MOD_EXP_CTIME_COPY_FROM_PREBUF",585,635
184,53,1702,6,257,"BN_mod_exp_mont_consttime@648-905@lib/libcrypto/bn/bn_exp.c","lib/libcrypto/bn/bn_exp.c","BN_mod_exp_mont_consttime",648,905
114,34,624,6,148,"BN_mod_exp_mont_word@908-1056@lib/libcrypto/bn/bn_exp.c","lib/libcrypto/bn/bn_exp.c","BN_mod_exp_mont_word",908,1056
91,27,587,5,115,"BN_mod_exp_simple@1061-1176@lib/libcrypto/bn/bn_exp.c","lib/libcrypto/bn/bn_exp.c","BN_mod_exp_simple",1061,1176
156,55,1108,8,187,"BN_mod_exp2_mont@121-308@lib/libcrypto/bn/bn_exp2.c","lib/libcrypto/bn/bn_exp2.c","BN_mod_exp2_mont",121,308
33,8,202,4,38,"BN_gcd@121-159@lib/libcrypto/bn/bn_gcd.c","lib/libcrypto/bn/bn_gcd.c","BN_gcd",121,159
6,2,43,4,5,"BN_gcd_ct@162-167@lib/libcrypto/bn/bn_gcd.c","lib/libcrypto/bn/bn_gcd.c","BN_gcd_ct",162,167
4,1,34,4,3,"BN_gcd_nonct@170-173@lib/libcrypto/bn/bn_gcd.c","lib/libcrypto/bn/bn_gcd.c","BN_gcd_nonct",170,173
60,16,273,2,67,"euclid@177-244@lib/libcrypto/bn/bn_gcd.c","lib/libcrypto/bn/bn_gcd.c","euclid",177,244
177,73,1144,5,289,"BN_mod_inverse_internal@252-541@lib/libcrypto/bn/bn_gcd.c","lib/libcrypto/bn/bn_gcd.c","BN_mod_inverse_internal",252,541
6,2,63,4,5,"BN_mod_inverse@544-549@lib/libcrypto/bn/bn_gcd.c","lib/libcrypto/bn/bn_gcd.c","BN_mod_inverse",544,549
4,1,36,4,3,"BN_mod_inverse_nonct@552-555@lib/libcrypto/bn/bn_gcd.c","lib/libcrypto/bn/bn_gcd.c","BN_mod_inverse_nonct",552,555
4,1,36,4,3,"BN_mod_inverse_ct@558-561@lib/libcrypto/bn/bn_gcd.c","lib/libcrypto/bn/bn_gcd.c","BN_mod_inverse_ct",558,561
87,28,564,4,156,"BN_mod_inverse_no_branch@567-723@lib/libcrypto/bn/bn_gcd.c","lib/libcrypto/bn/bn_gcd.c","BN_mod_inverse_no_branch",567,723
70,21,470,4,132,"BN_gcd_no_branch@730-862@lib/libcrypto/bn/bn_gcd.c","lib/libcrypto/bn/bn_gcd.c","BN_gcd_no_branch",730,862
143,6,1141,4,157,"bn_GF2m_mul_1x1@136-293@lib/libcrypto/bn/bn_gf2m.c","lib/libcrypto/bn/bn_gf2m.c","bn_GF2m_mul_1x1",136,293
10,1,115,5,12,"bn_GF2m_mul_2x2@301-313@lib/libcrypto/bn/bn_gf2m.c","lib/libcrypto/bn/bn_gf2m.c","bn_GF2m_mul_2x2",301,313
25,5,168,3,30,"BN_GF2m_add@323-353@lib/libcrypto/bn/bn_gf2m.c","lib/libcrypto/bn/bn_gf2m.c","BN_GF2m_add",323,353
67,15,484,3,90,"BN_GF2m_mod_arr@365-455@lib/libcrypto/bn/bn_gf2m.c","lib/libcrypto/bn/bn_gf2m.c","BN_GF2m_mod_arr",365,455
15,3,115,3,15,"BN_GF2m_mod@464-479@lib/libcrypto/bn/bn_gf2m.c","lib/libcrypto/bn/bn_gf2m.c","BN_GF2m_mod",464,479
39,11,344,5,46,"BN_GF2m_mod_mul_arr@486-532@lib/libcrypto/bn/bn_gf2m.c","lib/libcrypto/bn/bn_gf2m.c","BN_GF2m_mod_mul_arr",486,532
22,4,147,5,23,"BN_GF2m_mod_mul@542-565@lib/libcrypto/bn/bn_gf2m.c","lib/libcrypto/bn/bn_gf2m.c","BN_GF2m_mod_mul",542,565
24,5,185,4,27,"BN_GF2m_mod_sqr_arr@570-597@lib/libcrypto/bn/bn_gf2m.c","lib/libcrypto/bn/bn_gf2m.c","BN_GF2m_mod_sqr_arr",570,597
20,4,135,4,21,"BN_GF2m_mod_sqr@606-627@lib/libcrypto/bn/bn_gf2m.c","lib/libcrypto/bn/bn_gf2m.c","BN_GF2m_mod_sqr",606,627
143,41,957,4,167,"BN_GF2m_mod_inv@636-803@lib/libcrypto/bn/bn_gf2m.c","lib/libcrypto/bn/bn_gf2m.c","BN_GF2m_mod_inv",636,803
16,3,99,4,18,"BN_GF2m_mod_inv_arr@812-830@lib/libcrypto/bn/bn_gf2m.c","lib/libcrypto/bn/bn_gf2m.c","BN_GF2m_mod_inv_arr",812,830
21,4,129,5,24,"BN_GF2m_mod_div@838-862@lib/libcrypto/bn/bn_gf2m.c","lib/libcrypto/bn/bn_gf2m.c","BN_GF2m_mod_div",838,862
73,31,478,5,81,"BN_GF2m_mod_div@871-952@lib/libcrypto/bn/bn_gf2m.c","lib/libcrypto/bn/bn_gf2m.c","BN_GF2m_mod_div",871,952
18,3,111,5,21,"BN_GF2m_mod_div_arr@963-984@lib/libcrypto/bn/bn_gf2m.c","lib/libcrypto/bn/bn_gf2m.c","BN_GF2m_mod_div_arr",963,984
33,10,228,5,39,"BN_GF2m_mod_exp_arr@992-1031@lib/libcrypto/bn/bn_gf2m.c","lib/libcrypto/bn/bn_gf2m.c","BN_GF2m_mod_exp_arr",992,1031
22,4,147,5,23,"BN_GF2m_mod_exp@1041-1064@lib/libcrypto/bn/bn_gf2m.c","lib/libcrypto/bn/bn_gf2m.c","BN_GF2m_mod_exp",1041,1064
20,4,124,4,25,"BN_GF2m_mod_sqrt_arr@1071-1096@lib/libcrypto/bn/bn_gf2m.c","lib/libcrypto/bn/bn_gf2m.c","BN_GF2m_mod_sqrt_arr",1071,1096
20,4,135,4,20,"BN_GF2m_mod_sqrt@1106-1126@lib/libcrypto/bn/bn_gf2m.c","lib/libcrypto/bn/bn_gf2m.c","BN_GF2m_mod_sqrt",1106,1126
88,32,589,4,100,"BN_GF2m_mod_solve_quad_arr@1132-1232@lib/libcrypto/bn/bn_gf2m.c","lib/libcrypto/bn/bn_gf2m.c","BN_GF2m_mod_solve_quad_arr",1132,1232
20,4,135,4,21,"BN_GF2m_mod_solve_quad@1241-1262@lib/libcrypto/bn/bn_gf2m.c","lib/libcrypto/bn/bn_gf2m.c","BN_GF2m_mod_solve_quad",1241,1262
25,8,151,3,29,"BN_GF2m_poly2arr@1271-1300@lib/libcrypto/bn/bn_gf2m.c","lib/libcrypto/bn/bn_gf2m.c","BN_GF2m_poly2arr",1271,1300
12,3,71,2,13,"BN_GF2m_arr2poly@1306-1319@lib/libcrypto/bn/bn_gf2m.c","lib/libcrypto/bn/bn_gf2m.c","BN_GF2m_arr2poly",1306,1319
75,23,458,3,122,"BN_kronecker@63-185@lib/libcrypto/bn/bn_kron.c","lib/libcrypto/bn/bn_kron.c","BN_kronecker",63,185
27,9,208,4,26,"BN_set_params@96-122@lib/libcrypto/bn/bn_lib.c","lib/libcrypto/bn/bn_lib.c","BN_set_params",96,122
13,5,60,1,12,"BN_get_params@125-137@lib/libcrypto/bn/bn_lib.c","lib/libcrypto/bn/bn_lib.c","BN_get_params",125,137
8,1,41,1,8,"BN_value_one@141-149@lib/libcrypto/bn/bn_lib.c","lib/libcrypto/bn/bn_lib.c","BN_value_one",141,149
47,9,735,1,49,"BN_num_bits_word@152-201@lib/libcrypto/bn/bn_lib.c","lib/libcrypto/bn/bn_lib.c","BN_num_bits_word",152,201
8,2,52,1,9,"BN_num_bits@204-213@lib/libcrypto/bn/bn_lib.c","lib/libcrypto/bn/bn_lib.c","BN_num_bits",204,213
13,5,91,1,13,"BN_clear_free@216-229@lib/libcrypto/bn/bn_lib.c","lib/libcrypto/bn/bn_lib.c","BN_clear_free",216,229
4,1,13,1,3,"BN_free@232-235@lib/libcrypto/bn/bn_lib.c","lib/libcrypto/bn/bn_lib.c","BN_free",232,235
5,1,25,1,4,"BN_init@238-242@lib/libcrypto/bn/bn_lib.c","lib/libcrypto/bn/bn_lib.c","BN_init",238,242
15,2,78,1,15,"BN_new@245-260@lib/libcrypto/bn/bn_lib.c","lib/libcrypto/bn/bn_lib.c","BN_new",245,260
45,10,311,2,61,"bn_expand_internal@265-326@lib/libcrypto/bn/bn_lib.c","lib/libcrypto/bn/bn_lib.c","bn_expand_internal",265,326
23,4,116,2,35,"bn_dup_expand@341-376@lib/libcrypto/bn/bn_lib.c","lib/libcrypto/bn/bn_lib.c","bn_dup_expand",341,376
32,8,259,2,37,"bn_expand2@386-423@lib/libcrypto/bn/bn_lib.c","lib/libcrypto/bn/bn_lib.c","bn_expand2",386,423
16,4,70,1,17,"BN_dup@426-443@lib/libcrypto/bn/bn_lib.c","lib/libcrypto/bn/bn_lib.c","BN_dup",426,443
37,8,264,2,43,"BN_copy@446-489@lib/libcrypto/bn/bn_lib.c","lib/libcrypto/bn/bn_lib.c","BN_copy",446,489
28,1,172,2,33,"BN_swap@492-525@lib/libcrypto/bn/bn_lib.c","lib/libcrypto/bn/bn_lib.c","BN_swap",492,525
8,2,56,1,7,"BN_clear@528-535@lib/libcrypto/bn/bn_lib.c","lib/libcrypto/bn/bn_lib.c","BN_clear",528,535
8,3,40,1,8,"BN_get_word@538-546@lib/libcrypto/bn/bn_lib.c","lib/libcrypto/bn/bn_lib.c","BN_get_word",538,546
8,3,67,2,9,"bn_expand@549-558@lib/libcrypto/bn/bn_lib.c","lib/libcrypto/bn/bn_lib.c","bn_expand",549,558
11,3,77,2,10,"BN_set_word@561-571@lib/libcrypto/bn/bn_lib.c","lib/libcrypto/bn/bn_lib.c","BN_set_word",561,571
36,7,218,3,38,"BN_bin2bn@574-612@lib/libcrypto/bn/bn_lib.c","lib/libcrypto/bn/bn_lib.c","BN_bin2bn",574,612
12,2,86,2,12,"BN_bn2bin@616-628@lib/libcrypto/bn/bn_lib.c","lib/libcrypto/bn/bn_lib.c","BN_bn2bin",616,628
19,5,129,2,20,"BN_ucmp@631-651@lib/libcrypto/bn/bn_lib.c","lib/libcrypto/bn/bn_lib.c","BN_ucmp",631,651
42,13,238,2,45,"BN_cmp@654-699@lib/libcrypto/bn/bn_lib.c","lib/libcrypto/bn/bn_lib.c","BN_cmp",654,699
18,5,130,2,20,"BN_set_bit@702-722@lib/libcrypto/bn/bn_lib.c","lib/libcrypto/bn/bn_lib.c","BN_set_bit",702,722
14,3,86,2,16,"BN_clear_bit@725-741@lib/libcrypto/bn/bn_lib.c","lib/libcrypto/bn/bn_lib.c","BN_clear_bit",725,741
12,3,81,2,12,"BN_is_bit_set@744-756@lib/libcrypto/bn/bn_lib.c","lib/libcrypto/bn/bn_lib.c","BN_is_bit_set",744,756
19,4,100,2,20,"BN_mask_bits@759-779@lib/libcrypto/bn/bn_lib.c","lib/libcrypto/bn/bn_lib.c","BN_mask_bits",759,779
7,3,34,2,6,"BN_set_negative@782-788@lib/libcrypto/bn/bn_lib.c","lib/libcrypto/bn/bn_lib.c","BN_set_negative",782,788
16,6,119,3,16,"bn_cmp_words@791-807@lib/libcrypto/bn/bn_lib.c","lib/libcrypto/bn/bn_lib.c","bn_cmp_words",791,807
18,7,116,4,19,"bn_cmp_part_words@817-836@lib/libcrypto/bn/bn_lib.c","lib/libcrypto/bn/bn_lib.c","bn_cmp_part_words",817,836
30,12,224,4,44,"BN_consttime_swap@846-890@lib/libcrypto/bn/bn_lib.c","lib/libcrypto/bn/bn_lib.c","BN_consttime_swap",846,890
11,4,78,4,14,"BN_nnmod@119-133@lib/libcrypto/bn/bn_mod.c","lib/libcrypto/bn/bn_mod.c","BN_nnmod",119,133
7,2,54,5,6,"BN_mod_add@136-142@lib/libcrypto/bn/bn_mod.c","lib/libcrypto/bn/bn_mod.c","BN_mod_add",136,142
8,3,62,4,7,"BN_mod_add_quick@147-154@lib/libcrypto/bn/bn_mod.c","lib/libcrypto/bn/bn_mod.c","BN_mod_add_quick",147,154
7,2,54,5,6,"BN_mod_sub@157-163@lib/libcrypto/bn/bn_mod.c","lib/libcrypto/bn/bn_mod.c","BN_mod_sub",157,163
8,3,57,4,7,"BN_mod_sub_quick@168-175@lib/libcrypto/bn/bn_mod.c","lib/libcrypto/bn/bn_mod.c","BN_mod_sub_quick",168,175
26,6,153,5,28,"BN_mod_mul@179-207@lib/libcrypto/bn/bn_mod.c","lib/libcrypto/bn/bn_mod.c","BN_mod_mul",179,207
6,2,49,4,6,"BN_mod_sqr@210-216@lib/libcrypto/bn/bn_mod.c","lib/libcrypto/bn/bn_mod.c","BN_mod_sqr",210,216
7,2,52,4,6,"BN_mod_lshift1@219-225@lib/libcrypto/bn/bn_mod.c","lib/libcrypto/bn/bn_mod.c","BN_mod_lshift1",219,225
9,3,60,3,8,"BN_mod_lshift1_quick@230-238@lib/libcrypto/bn/bn_mod.c","lib/libcrypto/bn/bn_mod.c","BN_mod_lshift1_quick",230,238
17,5,113,5,20,"BN_mod_lshift@241-261@lib/libcrypto/bn/bn_mod.c","lib/libcrypto/bn/bn_mod.c","BN_mod_lshift",241,261
32,11,172,4,42,"BN_mod_lshift_quick@266-308@lib/libcrypto/bn/bn_mod.c","lib/libcrypto/bn/bn_mod.c","BN_mod_lshift_quick",266,308
37,14,261,5,45,"BN_mod_mul_montgomery@131-176@lib/libcrypto/bn/bn_mont.c","lib/libcrypto/bn/bn_mont.c","BN_mod_mul_montgomery",131,176
67,12,610,3,92,"BN_from_montgomery_word@180-272@lib/libcrypto/bn/bn_mont.c","lib/libcrypto/bn/bn_mont.c","BN_from_montgomery_word",180,272
36,13,275,4,45,"BN_from_montgomery@276-321@lib/libcrypto/bn/bn_mont.c","lib/libcrypto/bn/bn_mont.c","BN_from_montgomery",276,321
9,2,47,1,10,"BN_MONT_CTX_new@324-334@lib/libcrypto/bn/bn_mont.c","lib/libcrypto/bn/bn_mont.c","BN_MONT_CTX_new",324,334
9,1,66,1,8,"BN_MONT_CTX_init@337-345@lib/libcrypto/bn/bn_mont.c","lib/libcrypto/bn/bn_mont.c","BN_MONT_CTX_init",337,345
10,3,59,1,10,"BN_MONT_CTX_free@348-358@lib/libcrypto/bn/bn_mont.c","lib/libcrypto/bn/bn_mont.c","BN_MONT_CTX_free",348,358
97,33,779,3,127,"BN_MONT_CTX_set@361-488@lib/libcrypto/bn/bn_mont.c","lib/libcrypto/bn/bn_mont.c","BN_MONT_CTX_set",361,488
15,5,133,2,15,"BN_MONT_CTX_copy@491-506@lib/libcrypto/bn/bn_mont.c","lib/libcrypto/bn/bn_mont.c","BN_MONT_CTX_copy",491,506
25,6,118,4,29,"BN_MONT_CTX_set_locked@509-538@lib/libcrypto/bn/bn_mont.c","lib/libcrypto/bn/bn_mont.c","BN_MONT_CTX_set_locked",509,538
25,5,207,2,26,"BN_bn2mpi@66-92@lib/libcrypto/bn/bn_mpi.c","lib/libcrypto/bn/bn_mpi.c","BN_bn2mpi",66,92
35,9,234,3,37,"BN_mpi2bn@95-132@lib/libcrypto/bn/bn_mpi.c","lib/libcrypto/bn/bn_mpi.c","BN_mpi2bn",95,132
124,39,687,5,144,"bn_sub_part_words@84-228@lib/libcrypto/bn/bn_mul.c","lib/libcrypto/bn/bn_mul.c","bn_sub_part_words",84,228
160,47,890,5,185,"bn_add_part_words@232-417@lib/libcrypto/bn/bn_mul.c","lib/libcrypto/bn/bn_mul.c","bn_add_part_words",232,417
106,33,1041,7,142,"bn_mul_recursive@435-577@lib/libcrypto/bn/bn_mul.c","lib/libcrypto/bn/bn_mul.c","bn_mul_recursive",435,577
122,29,1230,7,155,"bn_mul_part_recursive@583-738@lib/libcrypto/bn/bn_mul.c","lib/libcrypto/bn/bn_mul.c","bn_mul_part_recursive",583,738
17,3,323,5,20,"bn_mul_low_recursive@744-764@lib/libcrypto/bn/bn_mul.c","lib/libcrypto/bn/bn_mul.c","bn_mul_low_recursive",744,764
130,28,1335,6,164,"bn_mul_high@772-936@lib/libcrypto/bn/bn_mul.c","lib/libcrypto/bn/bn_mul.c","bn_mul_high",772,936
130,49,917,4,158,"BN_mul@940-1098@lib/libcrypto/bn/bn_mul.c","lib/libcrypto/bn/bn_mul.c","BN_mul",940,1098
38,9,285,5,44,"bn_mul_normal@1101-1145@lib/libcrypto/bn/bn_mul.c","lib/libcrypto/bn/bn_mul.c","bn_mul_normal",1101,1145
21,7,175,4,23,"bn_mul_low_normal@1148-1171@lib/libcrypto/bn/bn_mul.c","lib/libcrypto/bn/bn_mul.c","bn_mul_low_normal",1148,1171
4,1,10,1,3,"BN_get0_nist_prime_192@329-332@lib/libcrypto/bn/bn_nist.c","lib/libcrypto/bn/bn_nist.c","BN_get0_nist_prime_192",329,332
4,1,10,1,3,"BN_get0_nist_prime_224@335-338@lib/libcrypto/bn/bn_nist.c","lib/libcrypto/bn/bn_nist.c","BN_get0_nist_prime_224",335,338
4,1,10,1,3,"BN_get0_nist_prime_256@341-344@lib/libcrypto/bn/bn_nist.c","lib/libcrypto/bn/bn_nist.c","BN_get0_nist_prime_256",341,344
4,1,10,1,3,"BN_get0_nist_prime_384@347-350@lib/libcrypto/bn/bn_nist.c","lib/libcrypto/bn/bn_nist.c","BN_get0_nist_prime_384",347,350
4,1,10,1,3,"BN_get0_nist_prime_521@353-356@lib/libcrypto/bn/bn_nist.c","lib/libcrypto/bn/bn_nist.c","BN_get0_nist_prime_521",353,356
9,4,69,4,11,"nist_cp_bn_0@359-370@lib/libcrypto/bn/bn_nist.c","lib/libcrypto/bn/bn_nist.c","nist_cp_bn_0",359,370
6,2,42,3,6,"nist_cp_bn@372-378@lib/libcrypto/bn/bn_nist.c","lib/libcrypto/bn/bn_nist.c","nist_cp_bn",372,378
98,10,824,4,122,"BN_nist_mod_192@424-546@lib/libcrypto/bn/bn_nist.c","lib/libcrypto/bn/bn_nist.c","BN_nist_mod_192",424,546
124,15,1109,4,164,"BN_nist_mod_224@563-727@lib/libcrypto/bn/bn_nist.c","lib/libcrypto/bn/bn_nist.c","BN_nist_mod_224",563,727
177,13,1615,4,208,"BN_nist_mod_256@742-950@lib/libcrypto/bn/bn_nist.c","lib/libcrypto/bn/bn_nist.c","BN_nist_mod_256",742,950
205,13,1890,4,241,"BN_nist_mod_384@969-1210@lib/libcrypto/bn/bn_nist.c","lib/libcrypto/bn/bn_nist.c","BN_nist_mod_384",969,1210
47,9,405,4,56,"BN_nist_mod_521@1217-1273@lib/libcrypto/bn/bn_nist.c","lib/libcrypto/bn/bn_nist.c","BN_nist_mod_521",1217,1273
17,5,87,3,20,"BN_GENCB_call@139-159@lib/libcrypto/bn/bn_prime.c","lib/libcrypto/bn/bn_prime.c","BN_GENCB_call",139,159
67,23,398,6,88,"BN_generate_prime_ex@162-250@lib/libcrypto/bn/bn_prime.c","lib/libcrypto/bn/bn_prime.c","BN_generate_prime_ex",162,250
4,1,34,4,3,"BN_is_prime_ex@253-256@lib/libcrypto/bn/bn_prime.c","lib/libcrypto/bn/bn_prime.c","BN_is_prime_ex",253,256
89,31,556,5,107,"BN_is_prime_fasttest_ex@259-366@lib/libcrypto/bn/bn_prime.c","lib/libcrypto/bn/bn_prime.c","BN_is_prime_fasttest_ex",259,366
20,8,139,7,23,"witness@369-392@lib/libcrypto/bn/bn_prime.c","lib/libcrypto/bn/bn_prime.c","witness",369,392
30,8,197,2,33,"probable_prime@395-428@lib/libcrypto/bn/bn_prime.c","lib/libcrypto/bn/bn_prime.c","probable_prime",395,428
38,12,238,5,47,"probable_prime_dh@431-478@lib/libcrypto/bn/bn_prime.c","lib/libcrypto/bn/bn_prime.c","probable_prime_dh",431,478
54,21,374,5,65,"probable_prime_dh_safe@481-546@lib/libcrypto/bn/bn_prime.c","lib/libcrypto/bn/bn_prime.c","probable_prime_dh_safe",481,546
29,8,206,1,31,"BN_bn2hex@75-106@lib/libcrypto/bn/bn_print.c","lib/libcrypto/bn/bn_print.c","BN_bn2hex",75,106
63,16,376,1,77,"BN_bn2dec@110-187@lib/libcrypto/bn/bn_print.c","lib/libcrypto/bn/bn_print.c","BN_bn2dec",110,187
63,22,415,2,74,"BN_hex2bn@190-264@lib/libcrypto/bn/bn_print.c","lib/libcrypto/bn/bn_print.c","BN_hex2bn",190,264
53,15,306,2,63,"BN_dec2bn@267-330@lib/libcrypto/bn/bn_print.c","lib/libcrypto/bn/bn_print.c","BN_dec2bn",267,330
16,8,107,2,16,"BN_asc2bn@333-349@lib/libcrypto/bn/bn_print.c","lib/libcrypto/bn/bn_print.c","BN_asc2bn",333,349
11,2,68,2,11,"BN_print_fp@353-364@lib/libcrypto/bn/bn_print.c","lib/libcrypto/bn/bn_print.c","BN_print_fp",353,364
22,10,186,2,24,"BN_print@367-391@lib/libcrypto/bn/bn_print.c","lib/libcrypto/bn/bn_print.c","BN_print",367,391
13,3,94,1,16,"BN_options@395-411@lib/libcrypto/bn/bn_print.c","lib/libcrypto/bn/bn_print.c","BN_options",395,411
57,16,353,5,70,"bnrand@122-192@lib/libcrypto/bn/bn_rand.c","lib/libcrypto/bn/bn_rand.c","bnrand",122,192
4,1,31,4,3,"BN_rand@195-198@lib/libcrypto/bn/bn_rand.c","lib/libcrypto/bn/bn_rand.c","BN_rand",195,198
4,1,31,4,3,"BN_pseudo_rand@201-204@lib/libcrypto/bn/bn_rand.c","lib/libcrypto/bn/bn_rand.c","BN_pseudo_rand",201,204
4,1,31,4,3,"BN_bntest_rand@208-211@lib/libcrypto/bn/bn_rand.c","lib/libcrypto/bn/bn_rand.c","BN_bntest_rand",208,211
41,17,275,3,57,"bn_rand_range@217-274@lib/libcrypto/bn/bn_rand.c","lib/libcrypto/bn/bn_rand.c","bn_rand_range",217,274
4,1,23,2,3,"BN_rand_range@277-280@lib/libcrypto/bn/bn_rand.c","lib/libcrypto/bn/bn_rand.c","BN_rand_range",277,280
4,1,23,2,3,"BN_pseudo_rand_range@283-286@lib/libcrypto/bn/bn_rand.c","lib/libcrypto/bn/bn_rand.c","BN_pseudo_rand_range",283,286
7,1,40,1,6,"BN_RECP_CTX_init@66-72@lib/libcrypto/bn/bn_recp.c","lib/libcrypto/bn/bn_recp.c","BN_RECP_CTX_init",66,72
9,2,47,1,10,"BN_RECP_CTX_new@75-85@lib/libcrypto/bn/bn_recp.c","lib/libcrypto/bn/bn_recp.c","BN_RECP_CTX_new",75,85
9,3,49,1,9,"BN_RECP_CTX_free@88-97@lib/libcrypto/bn/bn_recp.c","lib/libcrypto/bn/bn_recp.c","BN_RECP_CTX_free",88,97
9,2,65,3,8,"BN_RECP_CTX_set@100-108@lib/libcrypto/bn/bn_recp.c","lib/libcrypto/bn/bn_recp.c","BN_RECP_CTX_set",100,108
26,6,153,5,28,"BN_mod_mul_reciprocal@111-139@lib/libcrypto/bn/bn_recp.c","lib/libcrypto/bn/bn_recp.c","BN_mod_mul_reciprocal",111,139
67,23,481,5,92,"BN_div_recp@142-234@lib/libcrypto/bn/bn_recp.c","lib/libcrypto/bn/bn_recp.c","BN_div_recp",142,234
17,4,104,4,21,"BN_reciprocal@242-263@lib/libcrypto/bn/bn_recp.c","lib/libcrypto/bn/bn_recp.c","BN_reciprocal",242,263
30,7,202,2,31,"BN_lshift1@65-96@lib/libcrypto/bn/bn_shift.c","lib/libcrypto/bn/bn_shift.c","BN_lshift1",65,96
32,8,219,2,33,"BN_rshift1@99-132@lib/libcrypto/bn/bn_shift.c","lib/libcrypto/bn/bn_shift.c","BN_rshift1",99,132
31,5,256,3,34,"BN_lshift@135-169@lib/libcrypto/bn/bn_shift.c","lib/libcrypto/bn/bn_shift.c","BN_lshift",135,169
43,10,319,3,46,"BN_rshift@172-218@lib/libcrypto/bn/bn_shift.c","lib/libcrypto/bn/bn_shift.c","BN_rshift",172,218
66,17,483,3,86,"BN_sqr@67-153@lib/libcrypto/bn/bn_sqr.c","lib/libcrypto/bn/bn_sqr.c","BN_sqr",67,153
26,3,185,4,33,"bn_sqr_normal@157-190@lib/libcrypto/bn/bn_sqr.c","lib/libcrypto/bn/bn_sqr.c","bn_sqr_normal",157,190
52,11,463,4,81,"bn_sqr_recursive@204-285@lib/libcrypto/bn/bn_sqr.c","lib/libcrypto/bn/bn_sqr.c","bn_sqr_recursive",204,285
217,86,1365,4,347,"BN_mod_sqrt@63-410@lib/libcrypto/bn/bn_sqrt.c","lib/libcrypto/bn/bn_sqrt.c","BN_mod_sqrt",63,410
27,5,215,2,39,"BN_mod_word@64-103@lib/libcrypto/bn/bn_word.c","lib/libcrypto/bn/bn_word.c","BN_mod_word",64,103
27,7,202,2,33,"BN_div_word@106-139@lib/libcrypto/bn/bn_word.c","lib/libcrypto/bn/bn_word.c","BN_div_word",106,139
30,11,205,2,34,"BN_add_word@142-176@lib/libcrypto/bn/bn_word.c","lib/libcrypto/bn/bn_word.c","BN_add_word",142,176
40,11,254,2,45,"BN_sub_word@179-224@lib/libcrypto/bn/bn_word.c","lib/libcrypto/bn/bn_word.c","BN_sub_word",179,224
20,5,112,2,20,"BN_mul_word@227-247@lib/libcrypto/bn/bn_word.c","lib/libcrypto/bn/bn_word.c","BN_mul_word",227,247
18,7,119,4,19,"bn_x931_derive_pi@72-91@lib/libcrypto/bn/bn_x931p.c","lib/libcrypto/bn/bn_x931p.c","bn_x931_derive_pi",72,91
66,28,483,9,97,"BN_X931_derive_prime_ex@99-196@lib/libcrypto/bn/bn_x931p.c","lib/libcrypto/bn/bn_x931p.c","BN_X931_derive_prime_ex",99,196
26,9,167,4,39,"BN_X931_generate_Xpq@203-242@lib/libcrypto/bn/bn_x931p.c","lib/libcrypto/bn/bn_x931p.c","BN_X931_generate_Xpq",203,242
24,8,175,9,28,"BN_X931_generate_prime_ex@253-281@lib/libcrypto/bn/bn_x931p.c","lib/libcrypto/bn/bn_x931p.c","BN_X931_generate_prime_ex",253,281
7,2,36,1,8,"ERR_load_BUF_strings@86-94@lib/libcrypto/buffer/buf_err.c","lib/libcrypto/buffer/buf_err.c","ERR_load_BUF_strings",86,94
9,3,44,1,9,"BUF_strdup@32-41@lib/libcrypto/buffer/buf_str.c","lib/libcrypto/buffer/buf_str.c","BUF_strdup",32,41
9,3,49,2,9,"BUF_strndup@44-53@lib/libcrypto/buffer/buf_str.c","lib/libcrypto/buffer/buf_str.c","BUF_strndup",44,53
11,3,60,2,11,"BUF_memdup@56-67@lib/libcrypto/buffer/buf_str.c","lib/libcrypto/buffer/buf_str.c","BUF_memdup",56,67
4,1,26,3,3,"BUF_strlcpy@70-73@lib/libcrypto/buffer/buf_str.c","lib/libcrypto/buffer/buf_str.c","BUF_strlcpy",70,73
4,1,26,3,3,"BUF_strlcat@76-79@lib/libcrypto/buffer/buf_str.c","lib/libcrypto/buffer/buf_str.c","BUF_strlcat",76,79
9,2,45,1,10,"BUF_MEM_new@74-84@lib/libcrypto/buffer/buffer.c","lib/libcrypto/buffer/buffer.c","BUF_MEM_new",74,84
7,2,32,1,7,"BUF_MEM_free@87-94@lib/libcrypto/buffer/buffer.c","lib/libcrypto/buffer/buffer.c","BUF_MEM_free",87,94
4,1,19,2,3,"BUF_MEM_grow@97-100@lib/libcrypto/buffer/buffer.c","lib/libcrypto/buffer/buffer.c","BUF_MEM_grow",97,100
24,5,152,2,27,"BUF_MEM_grow_clean@103-130@lib/libcrypto/buffer/buffer.c","lib/libcrypto/buffer/buffer.c","BUF_MEM_grow_clean",103,130
18,4,108,3,18,"BUF_reverse@133-151@lib/libcrypto/buffer/buffer.c","lib/libcrypto/buffer/buffer.c","BUF_reverse",133,151
93,4,1628,3,115,"Camellia_Ekeygen@347-462@lib/libcrypto/camellia/camellia.c","lib/libcrypto/camellia/camellia.c","Camellia_Ekeygen",347,462
32,3,325,4,41,"Camellia_EncryptBlock_Rounds@465-506@lib/libcrypto/camellia/camellia.c","lib/libcrypto/camellia/camellia.c","Camellia_EncryptBlock_Rounds",465,506
6,2,39,4,5,"Camellia_EncryptBlock@509-514@lib/libcrypto/camellia/camellia.c","lib/libcrypto/camellia/camellia.c","Camellia_EncryptBlock",509,514
32,3,327,4,41,"Camellia_DecryptBlock_Rounds@517-558@lib/libcrypto/camellia/camellia.c","lib/libcrypto/camellia/camellia.c","Camellia_DecryptBlock_Rounds",517,558
6,2,39,4,5,"Camellia_DecryptBlock@561-566@lib/libcrypto/camellia/camellia.c","lib/libcrypto/camellia/camellia.c","Camellia_DecryptBlock",561,566
10,2,73,6,9,"Camellia_cbc_encrypt@56-65@lib/libcrypto/camellia/cmll_cbc.c","lib/libcrypto/camellia/cmll_cbc.c","Camellia_cbc_encrypt",56,65
7,1,58,7,6,"Camellia_cfb128_encrypt@119-125@lib/libcrypto/camellia/cmll_cfb.c","lib/libcrypto/camellia/cmll_cfb.c","Camellia_cfb128_encrypt",119,125
7,1,58,7,6,"Camellia_cfb1_encrypt@129-135@lib/libcrypto/camellia/cmll_cfb.c","lib/libcrypto/camellia/cmll_cfb.c","Camellia_cfb1_encrypt",129,135
7,1,58,7,6,"Camellia_cfb8_encrypt@138-144@lib/libcrypto/camellia/cmll_cfb.c","lib/libcrypto/camellia/cmll_cfb.c","Camellia_cfb8_encrypt",138,144
8,1,64,7,7,"Camellia_ctr128_encrypt@56-63@lib/libcrypto/camellia/cmll_ctr.c","lib/libcrypto/camellia/cmll_ctr.c","Camellia_ctr128_encrypt",56,63
8,2,49,4,7,"Camellia_ecb_encrypt@56-63@lib/libcrypto/camellia/cmll_ecb.c","lib/libcrypto/camellia/cmll_ecb.c","Camellia_ecb_encrypt",56,63
10,6,70,3,9,"Camellia_set_key@58-67@lib/libcrypto/camellia/cmll_misc.c","lib/libcrypto/camellia/cmll_misc.c","Camellia_set_key",58,67
5,1,37,3,4,"Camellia_encrypt@70-74@lib/libcrypto/camellia/cmll_misc.c","lib/libcrypto/camellia/cmll_misc.c","Camellia_encrypt",70,74
5,1,37,3,4,"Camellia_decrypt@77-81@lib/libcrypto/camellia/cmll_misc.c","lib/libcrypto/camellia/cmll_misc.c","Camellia_decrypt",77,81
6,1,52,6,5,"Camellia_ofb128_encrypt@117-122@lib/libcrypto/camellia/cmll_ofb.c","lib/libcrypto/camellia/cmll_ofb.c","Camellia_ofb128_encrypt",117,122
54,6,368,7,54,"CAST_cfb64_encrypt@67-121@lib/libcrypto/cast/c_cfb64.c","lib/libcrypto/cast/c_cfb64.c","CAST_cfb64_encrypt",67,121
14,2,120,4,14,"CAST_ecb_encrypt@63-77@lib/libcrypto/cast/c_ecb.c","lib/libcrypto/cast/c_ecb.c","CAST_ecb_encrypt",63,77
29,2,350,2,31,"CAST_encrypt@63-94@lib/libcrypto/cast/c_enc.c","lib/libcrypto/cast/c_enc.c","CAST_encrypt",63,94
29,2,350,2,31,"CAST_decrypt@96-127@lib/libcrypto/cast/c_enc.c","lib/libcrypto/cast/c_enc.c","CAST_decrypt",96,127
80,6,495,6,80,"CAST_cbc_encrypt@130-210@lib/libcrypto/cast/c_enc.c","lib/libcrypto/cast/c_enc.c","CAST_cbc_encrypt",130,210
44,4,284,6,44,"CAST_ofb64_encrypt@66-110@lib/libcrypto/cast/c_ofb64.c","lib/libcrypto/cast/c_ofb64.c","CAST_ofb64_encrypt",66,110
80,8,2033,3,90,"CAST_set_key@75-165@lib/libcrypto/cast/c_skey.c","lib/libcrypto/cast/c_skey.c","CAST_set_key",75,165
22,2,212,3,22,"chacha_keysetup@88-110@lib/libcrypto/chacha/chacha-merged.c","lib/libcrypto/chacha/chacha-merged.c","chacha_keysetup",88,110
7,3,86,3,6,"chacha_ivsetup@113-119@lib/libcrypto/chacha/chacha-merged.c","lib/libcrypto/chacha/chacha-merged.c","chacha_ivsetup",113,119
146,11,1260,4,157,"chacha_encrypt_bytes@122-279@lib/libcrypto/chacha/chacha-merged.c","lib/libcrypto/chacha/chacha-merged.c","chacha_encrypt_bytes",122,279
5,1,36,3,4,"ChaCha_set_key@25-29@lib/libcrypto/chacha/chacha.c","lib/libcrypto/chacha/chacha.c","ChaCha_set_key",25,29
6,1,39,3,5,"ChaCha_set_iv@32-37@lib/libcrypto/chacha/chacha.c","lib/libcrypto/chacha/chacha.c","ChaCha_set_iv",32,37
14,4,129,4,16,"ChaCha@40-56@lib/libcrypto/chacha/chacha.c","lib/libcrypto/chacha/chacha.c","ChaCha",40,56
12,2,113,6,18,"CRYPTO_chacha_20@59-77@lib/libcrypto/chacha/chacha.c","lib/libcrypto/chacha/chacha.c","CRYPTO_chacha_20",59,77
4,1,12,1,3,"cmac_size@67-70@lib/libcrypto/cmac/cm_ameth.c","lib/libcrypto/cmac/cm_ameth.c","cmac_size",67,70
5,1,27,1,5,"cmac_key_free@73-78@lib/libcrypto/cmac/cm_ameth.c","lib/libcrypto/cmac/cm_ameth.c","cmac_key_free",73,78
8,2,35,1,7,"pkey_cmac_init@67-74@lib/libcrypto/cmac/cm_pmeth.c","lib/libcrypto/cmac/cm_pmeth.c","pkey_cmac_init",67,74
8,3,43,2,7,"pkey_cmac_copy@77-84@lib/libcrypto/cmac/cm_pmeth.c","lib/libcrypto/cmac/cm_pmeth.c","pkey_cmac_copy",77,84
4,1,15,1,3,"pkey_cmac_cleanup@87-90@lib/libcrypto/cmac/cm_pmeth.c","lib/libcrypto/cmac/cm_pmeth.c","pkey_cmac_cleanup",87,90
13,3,68,2,14,"pkey_cmac_keygen@93-107@lib/libcrypto/cmac/cm_pmeth.c","lib/libcrypto/cmac/cm_pmeth.c","pkey_cmac_keygen",93,107
6,2,38,3,5,"int_update@110-115@lib/libcrypto/cmac/cm_pmeth.c","lib/libcrypto/cmac/cm_pmeth.c","int_update",110,115
6,1,28,2,5,"cmac_signctx_init@118-123@lib/libcrypto/cmac/cm_pmeth.c","lib/libcrypto/cmac/cm_pmeth.c","cmac_signctx_init",118,123
5,1,33,4,4,"cmac_signctx@126-130@lib/libcrypto/cmac/cm_pmeth.c","lib/libcrypto/cmac/cm_pmeth.c","cmac_signctx",126,130
26,11,156,4,29,"pkey_cmac_ctrl@133-162@lib/libcrypto/cmac/cm_pmeth.c","lib/libcrypto/cmac/cm_pmeth.c","pkey_cmac_ctrl",133,162
29,7,178,3,31,"pkey_cmac_ctrl_str@165-196@lib/libcrypto/cmac/cm_pmeth.c","lib/libcrypto/cmac/cm_pmeth.c","pkey_cmac_ctrl_str",165,196
11,6,96,3,13,"make_kn@78-91@lib/libcrypto/cmac/cmac.c","lib/libcrypto/cmac/cmac.c","make_kn",78,91
10,2,46,1,10,"CMAC_CTX_new@94-104@lib/libcrypto/cmac/cmac.c","lib/libcrypto/cmac/cmac.c","CMAC_CTX_new",94,104
9,1,59,1,8,"CMAC_CTX_cleanup@107-115@lib/libcrypto/cmac/cmac.c","lib/libcrypto/cmac/cmac.c","CMAC_CTX_cleanup",107,115
4,1,14,1,3,"CMAC_CTX_get0_cipher_ctx@118-121@lib/libcrypto/cmac/cmac.c","lib/libcrypto/cmac/cmac.c","CMAC_CTX_get0_cipher_ctx",118,121
7,2,26,1,7,"CMAC_CTX_free@124-131@lib/libcrypto/cmac/cmac.c","lib/libcrypto/cmac/cmac.c","CMAC_CTX_free",124,131
15,3,120,2,15,"CMAC_CTX_copy@134-149@lib/libcrypto/cmac/cmac.c","lib/libcrypto/cmac/cmac.c","CMAC_CTX_copy",134,149
36,15,304,5,43,"CMAC_Init@152-195@lib/libcrypto/cmac/cmac.c","lib/libcrypto/cmac/cmac.c","CMAC_Init",152,195
33,9,209,3,39,"CMAC_Update@198-237@lib/libcrypto/cmac/cmac.c","lib/libcrypto/cmac/cmac.c","CMAC_Update",198,237
26,8,211,3,27,"CMAC_Final@240-267@lib/libcrypto/cmac/cmac.c","lib/libcrypto/cmac/cmac.c","CMAC_Final",240,267
6,2,39,1,11,"CMAC_resume@270-281@lib/libcrypto/cmac/cmac.c","lib/libcrypto/cmac/cmac.c","CMAC_resume",270,281
4,1,12,1,3,"COMP_rle@21-24@lib/libcrypto/comp/c_rle.c","lib/libcrypto/comp/c_rle.c","COMP_rle",21,24
10,3,72,5,11,"rle_compress_block@27-38@lib/libcrypto/comp/c_rle.c","lib/libcrypto/comp/c_rle.c","rle_compress_block",27,38
13,3,81,5,14,"rle_expand_block@41-55@lib/libcrypto/comp/c_rle.c","lib/libcrypto/comp/c_rle.c","rle_expand_block",41,55
4,1,24,3,3,"zlib_zalloc@30-33@lib/libcrypto/comp/c_zlib.c","lib/libcrypto/comp/c_zlib.c","zlib_zalloc",30,33
4,1,17,2,3,"zlib_zfree@36-39@lib/libcrypto/comp/c_zlib.c","lib/libcrypto/comp/c_zlib.c","zlib_zfree",36,39
34,4,237,1,38,"zlib_stateful_init@58-96@lib/libcrypto/comp/c_zlib.c","lib/libcrypto/comp/c_zlib.c","zlib_stateful_init",58,96
10,1,61,1,10,"zlib_stateful_finish@99-109@lib/libcrypto/comp/c_zlib.c","lib/libcrypto/comp/c_zlib.c","zlib_stateful_finish",99,109
22,6,163,5,27,"zlib_stateful_compress_block@112-139@lib/libcrypto/comp/c_zlib.c","lib/libcrypto/comp/c_zlib.c","zlib_stateful_compress_block",112,139
22,6,162,5,28,"zlib_stateful_expand_block@142-170@lib/libcrypto/comp/c_zlib.c","lib/libcrypto/comp/c_zlib.c","zlib_stateful_expand_block",142,170
19,5,80,1,27,"COMP_zlib@175-202@lib/libcrypto/comp/c_zlib.c","lib/libcrypto/comp/c_zlib.c","COMP_zlib",175,202
3,1,6,1,2,"COMP_zlib_cleanup@205-207@lib/libcrypto/comp/c_zlib.c","lib/libcrypto/comp/c_zlib.c","COMP_zlib_cleanup",205,207
4,1,10,1,3,"BIO_f_zlib@247-250@lib/libcrypto/comp/c_zlib.c","lib/libcrypto/comp/c_zlib.c","BIO_f_zlib",247,250
31,2,194,1,31,"bio_zlib_new@254-285@lib/libcrypto/comp/c_zlib.c","lib/libcrypto/comp/c_zlib.c","bio_zlib_new",254,285
20,4,102,1,22,"bio_zlib_free@288-310@lib/libcrypto/comp/c_zlib.c","lib/libcrypto/comp/c_zlib.c","bio_zlib_free",288,310
46,14,287,3,55,"bio_zlib_read@313-368@lib/libcrypto/comp/c_zlib.c","lib/libcrypto/comp/c_zlib.c","bio_zlib_read",313,368
53,13,328,3,64,"bio_zlib_write@371-435@lib/libcrypto/comp/c_zlib.c","lib/libcrypto/comp/c_zlib.c","bio_zlib_write",371,435
38,10,227,1,46,"bio_zlib_flush@438-484@lib/libcrypto/comp/c_zlib.c","lib/libcrypto/comp/c_zlib.c","bio_zlib_flush",438,484
55,11,282,4,63,"bio_zlib_ctrl@487-550@lib/libcrypto/comp/c_zlib.c","lib/libcrypto/comp/c_zlib.c","bio_zlib_ctrl",487,550
6,2,37,3,5,"bio_zlib_callback_ctrl@554-559@lib/libcrypto/comp/c_zlib.c","lib/libcrypto/comp/c_zlib.c","bio_zlib_callback_ctrl",554,559
7,2,36,1,8,"ERR_load_COMP_strings@84-92@lib/libcrypto/comp/comp_err.c","lib/libcrypto/comp/comp_err.c","ERR_load_COMP_strings",84,92
13,4,81,1,13,"COMP_CTX_new@9-22@lib/libcrypto/comp/comp_lib.c","lib/libcrypto/comp/comp_lib.c","COMP_CTX_new",9,22
8,3,40,1,9,"COMP_CTX_free@25-34@lib/libcrypto/comp/comp_lib.c","lib/libcrypto/comp/comp_lib.c","COMP_CTX_free",25,34
14,3,89,5,14,"COMP_compress_block@37-51@lib/libcrypto/comp/comp_lib.c","lib/libcrypto/comp/comp_lib.c","COMP_compress_block",37,51
14,3,89,5,14,"COMP_expand_block@54-68@lib/libcrypto/comp/comp_lib.c","lib/libcrypto/comp/comp_lib.c","COMP_expand_block",54,68
10,3,71,2,10,"_CONF_get_section@81-91@lib/libcrypto/conf/conf_api.c","lib/libcrypto/conf/conf_api.c","_CONF_get_section",81,91
9,2,53,2,9,"_CONF_get_section_values@95-104@lib/libcrypto/conf/conf_api.c","lib/libcrypto/conf/conf_api.c","_CONF_get_section_values",95,104
18,3,116,3,20,"_CONF_add_string@107-127@lib/libcrypto/conf/conf_api.c","lib/libcrypto/conf/conf_api.c","_CONF_add_string",107,127
23,6,150,3,23,"_CONF_get_string@130-153@lib/libcrypto/conf/conf_api.c","lib/libcrypto/conf/conf_api.c","_CONF_get_string",130,153
4,1,29,1,3,"conf_value_hash@156-159@lib/libcrypto/conf/conf_api.c","lib/libcrypto/conf/conf_api.c","conf_value_hash",156,159
16,7,121,2,16,"conf_value_cmp@164-180@lib/libcrypto/conf/conf_api.c","lib/libcrypto/conf/conf_api.c","conf_value_cmp",164,180
11,4,48,1,10,"_CONF_new_data@185-195@lib/libcrypto/conf/conf_api.c","lib/libcrypto/conf/conf_api.c","_CONF_new_data",185,195
11,3,71,1,17,"_CONF_free_data@198-215@lib/libcrypto/conf/conf_api.c","lib/libcrypto/conf/conf_api.c","_CONF_free_data",198,215
5,2,33,2,4,"value_free_hash_doall_arg@218-222@lib/libcrypto/conf/conf_api.c","lib/libcrypto/conf/conf_api.c","value_free_hash_doall_arg",218,222
19,4,116,1,20,"value_free_stack_doall@225-245@lib/libcrypto/conf/conf_api.c","lib/libcrypto/conf/conf_api.c","value_free_stack_doall",225,245
27,6,182,2,30,"_CONF_new_section@249-279@lib/libcrypto/conf/conf_api.c","lib/libcrypto/conf/conf_api.c","_CONF_new_section",249,279
4,1,10,1,3,"NCONF_default@119-122@lib/libcrypto/conf/conf_def.c","lib/libcrypto/conf/conf_def.c","NCONF_default",119,122
4,1,10,1,3,"NCONF_WIN32@125-128@lib/libcrypto/conf/conf_def.c","lib/libcrypto/conf/conf_def.c","NCONF_WIN32",125,128
11,3,58,1,11,"def_create@131-142@lib/libcrypto/conf/conf_def.c","lib/libcrypto/conf/conf_def.c","def_create",131,142
9,2,39,1,10,"def_init_default@145-155@lib/libcrypto/conf/conf_def.c","lib/libcrypto/conf/conf_def.c","def_init_default",145,155
9,2,43,1,10,"def_init_WIN32@158-168@lib/libcrypto/conf/conf_def.c","lib/libcrypto/conf/conf_def.c","def_init_WIN32",158,168
8,2,28,1,7,"def_destroy@171-178@lib/libcrypto/conf/conf_def.c","lib/libcrypto/conf/conf_def.c","def_destroy",171,178
7,2,25,1,6,"def_destroy_data@181-187@lib/libcrypto/conf/conf_def.c","lib/libcrypto/conf/conf_def.c","def_destroy_data",181,187
16,3,87,3,18,"def_load@190-208@lib/libcrypto/conf/conf_def.c","lib/libcrypto/conf/conf_def.c","def_load",190,208
180,47,1067,3,202,"def_load_bio@211-413@lib/libcrypto/conf/conf_def.c","lib/libcrypto/conf/conf_def.c","def_load_bio",211,413
35,10,167,2,35,"clear_comments@416-451@lib/libcrypto/conf/conf_def.c","lib/libcrypto/conf/conf_def.c","clear_comments",416,451
121,37,751,4,143,"str_copy@454-597@lib/libcrypto/conf/conf_def.c","lib/libcrypto/conf/conf_def.c","str_copy",454,597
6,3,41,2,5,"eat_ws@600-605@lib/libcrypto/conf/conf_def.c","lib/libcrypto/conf/conf_def.c","eat_ws",600,605
12,4,61,2,11,"eat_alpha_numeric@608-619@lib/libcrypto/conf/conf_def.c","lib/libcrypto/conf/conf_def.c","eat_alpha_numeric",608,619
16,6,91,2,16,"scan_quote@622-638@lib/libcrypto/conf/conf_def.c","lib/libcrypto/conf/conf_def.c","scan_quote",622,638
18,5,84,2,18,"scan_dquote@642-660@lib/libcrypto/conf/conf_def.c","lib/libcrypto/conf/conf_def.c","scan_dquote",642,660
7,2,49,2,6,"dump_value_doall_arg@663-669@lib/libcrypto/conf/conf_def.c","lib/libcrypto/conf/conf_def.c","dump_value_doall_arg",663,669
6,1,31,2,5,"def_dump@674-679@lib/libcrypto/conf/conf_def.c","lib/libcrypto/conf/conf_def.c","def_dump",674,679
4,1,20,2,3,"def_is_number@682-685@lib/libcrypto/conf/conf_def.c","lib/libcrypto/conf/conf_def.c","def_is_number",682,685
4,1,17,2,3,"def_to_int@688-691@lib/libcrypto/conf/conf_def.c","lib/libcrypto/conf/conf_def.c","def_to_int",688,691
7,2,36,1,8,"ERR_load_CONF_strings@102-110@lib/libcrypto/conf/conf_err.c","lib/libcrypto/conf/conf_err.c","ERR_load_CONF_strings",102,110
7,2,40,2,6,"CONF_set_nconf@71-77@lib/libcrypto/conf/conf_lib.c","lib/libcrypto/conf/conf_lib.c","CONF_set_nconf",71,77
5,1,15,1,4,"CONF_set_default_method@83-87@lib/libcrypto/conf/conf_lib.c","lib/libcrypto/conf/conf_lib.c","CONF_set_default_method",83,87
14,2,77,3,16,"CONF_load@89-105@lib/libcrypto/conf/conf_lib.c","lib/libcrypto/conf/conf_lib.c","CONF_load",89,105
13,2,73,3,13,"CONF_load_fp@107-120@lib/libcrypto/conf/conf_lib.c","lib/libcrypto/conf/conf_lib.c","CONF_load_fp",107,120
11,2,57,3,12,"CONF_load_bio@122-134@lib/libcrypto/conf/conf_lib.c","lib/libcrypto/conf/conf_lib.c","CONF_load_bio",122,134
11,2,50,2,10,"CONF_get_section@136-146@lib/libcrypto/conf/conf_lib.c","lib/libcrypto/conf/conf_lib.c","CONF_get_section",136,146
11,2,64,3,10,"CONF_get_string@149-159@lib/libcrypto/conf/conf_lib.c","lib/libcrypto/conf/conf_lib.c","CONF_get_string",149,159
17,3,95,3,19,"CONF_get_number@162-181@lib/libcrypto/conf/conf_lib.c","lib/libcrypto/conf/conf_lib.c","CONF_get_number",162,181
6,1,28,1,6,"CONF_free@184-190@lib/libcrypto/conf/conf_lib.c","lib/libcrypto/conf/conf_lib.c","CONF_free",184,190
12,2,63,2,12,"CONF_dump_fp@193-205@lib/libcrypto/conf/conf_lib.c","lib/libcrypto/conf/conf_lib.c","CONF_dump_fp",193,205
6,1,35,2,6,"CONF_dump_bio@208-214@lib/libcrypto/conf/conf_lib.c","lib/libcrypto/conf/conf_lib.c","CONF_dump_bio",208,214
12,3,54,1,14,"NCONF_new@223-237@lib/libcrypto/conf/conf_lib.c","lib/libcrypto/conf/conf_lib.c","NCONF_new",223,237
6,2,25,1,5,"NCONF_free@240-245@lib/libcrypto/conf/conf_lib.c","lib/libcrypto/conf/conf_lib.c","NCONF_free",240,245
6,2,25,1,5,"NCONF_free_data@248-253@lib/libcrypto/conf/conf_lib.c","lib/libcrypto/conf/conf_lib.c","NCONF_free_data",248,253
8,2,47,3,8,"NCONF_load@256-264@lib/libcrypto/conf/conf_lib.c","lib/libcrypto/conf/conf_lib.c","NCONF_load",256,264
12,2,66,3,12,"NCONF_load_fp@267-279@lib/libcrypto/conf/conf_lib.c","lib/libcrypto/conf/conf_lib.c","NCONF_load_fp",267,279
8,2,46,3,8,"NCONF_load_bio@282-290@lib/libcrypto/conf/conf_lib.c","lib/libcrypto/conf/conf_lib.c","NCONF_load_bio",282,290
12,3,54,2,13,"NCONF_get_section@293-306@lib/libcrypto/conf/conf_lib.c","lib/libcrypto/conf/conf_lib.c","NCONF_get_section",293,306
14,4,76,3,17,"NCONF_get_string@309-326@lib/libcrypto/conf/conf_lib.c","lib/libcrypto/conf/conf_lib.c","NCONF_get_string",309,326
17,4,113,4,21,"NCONF_get_number_e@329-350@lib/libcrypto/conf/conf_lib.c","lib/libcrypto/conf/conf_lib.c","NCONF_get_number_e",329,350
12,2,61,2,11,"NCONF_dump_fp@353-364@lib/libcrypto/conf/conf_lib.c","lib/libcrypto/conf/conf_lib.c","NCONF_dump_fp",353,364
8,2,41,2,8,"NCONF_dump_bio@367-375@lib/libcrypto/conf/conf_lib.c","lib/libcrypto/conf/conf_lib.c","NCONF_dump_bio",367,375
5,1,14,1,7,"OPENSSL_load_builtin_modules@75-82@lib/libcrypto/conf/conf_mall.c","lib/libcrypto/conf/conf_mall.c","OPENSSL_load_builtin_modules",75,82
28,11,186,3,36,"CONF_modules_load@124-160@lib/libcrypto/conf/conf_mod.c","lib/libcrypto/conf/conf_mod.c","CONF_modules_load",124,160
31,8,160,3,35,"CONF_modules_load_file@163-198@lib/libcrypto/conf/conf_mod.c","lib/libcrypto/conf/conf_mod.c","CONF_modules_load_file",163,198
25,7,145,4,31,"module_run@201-232@lib/libcrypto/conf/conf_mod.c","lib/libcrypto/conf/conf_mod.c","module_run",201,232
35,6,195,4,40,"module_load_dso@236-276@lib/libcrypto/conf/conf_mod.c","lib/libcrypto/conf/conf_mod.c","module_load_dso",236,276
24,6,132,4,27,"module_add@280-307@lib/libcrypto/conf/conf_mod.c","lib/libcrypto/conf/conf_mod.c","module_add",280,307
17,4,95,1,20,"module_find@315-335@lib/libcrypto/conf/conf_mod.c","lib/libcrypto/conf/conf_mod.c","module_find",315,335
44,14,245,4,58,"module_init@339-397@lib/libcrypto/conf/conf_mod.c","lib/libcrypto/conf/conf_mod.c","module_init",339,397
17,6,104,1,21,"CONF_modules_unload@405-426@lib/libcrypto/conf/conf_mod.c","lib/libcrypto/conf/conf_mod.c","CONF_modules_unload",405,426
7,2,33,1,6,"module_free@430-436@lib/libcrypto/conf/conf_mod.c","lib/libcrypto/conf/conf_mod.c","module_free",430,436
10,2,42,1,10,"CONF_modules_finish@441-451@lib/libcrypto/conf/conf_mod.c","lib/libcrypto/conf/conf_mod.c","CONF_modules_finish",441,451
9,2,51,1,8,"module_finish@456-464@lib/libcrypto/conf/conf_mod.c","lib/libcrypto/conf/conf_mod.c","module_finish",456,464
8,2,37,3,7,"CONF_module_add@469-476@lib/libcrypto/conf/conf_mod.c","lib/libcrypto/conf/conf_mod.c","CONF_module_add",469,476
5,1,15,1,4,"CONF_modules_free@479-483@lib/libcrypto/conf/conf_mod.c","lib/libcrypto/conf/conf_mod.c","CONF_modules_free",479,483
4,1,14,1,3,"CONF_imodule_get_name@488-491@lib/libcrypto/conf/conf_mod.c","lib/libcrypto/conf/conf_mod.c","CONF_imodule_get_name",488,491
4,1,14,1,3,"CONF_imodule_get_value@494-497@lib/libcrypto/conf/conf_mod.c","lib/libcrypto/conf/conf_mod.c","CONF_imodule_get_value",494,497
4,1,14,1,3,"CONF_imodule_get_usr_data@500-503@lib/libcrypto/conf/conf_mod.c","lib/libcrypto/conf/conf_mod.c","CONF_imodule_get_usr_data",500,503
4,1,18,2,3,"CONF_imodule_set_usr_data@506-509@lib/libcrypto/conf/conf_mod.c","lib/libcrypto/conf/conf_mod.c","CONF_imodule_set_usr_data",506,509
4,1,14,1,3,"CONF_imodule_get_module@512-515@lib/libcrypto/conf/conf_mod.c","lib/libcrypto/conf/conf_mod.c","CONF_imodule_get_module",512,515
4,1,14,1,3,"CONF_imodule_get_flags@518-521@lib/libcrypto/conf/conf_mod.c","lib/libcrypto/conf/conf_mod.c","CONF_imodule_get_flags",518,521
4,1,18,2,3,"CONF_imodule_set_flags@524-527@lib/libcrypto/conf/conf_mod.c","lib/libcrypto/conf/conf_mod.c","CONF_imodule_set_flags",524,527
4,1,13,1,3,"CONF_module_get_usr_data@530-533@lib/libcrypto/conf/conf_mod.c","lib/libcrypto/conf/conf_mod.c","CONF_module_get_usr_data",530,533
4,1,18,2,3,"CONF_module_set_usr_data@536-539@lib/libcrypto/conf/conf_mod.c","lib/libcrypto/conf/conf_mod.c","CONF_module_set_usr_data",536,539
8,2,37,1,8,"CONF_get1_default_config_file@544-552@lib/libcrypto/conf/conf_mod.c","lib/libcrypto/conf/conf_mod.c","CONF_get1_default_config_file",544,552
36,13,218,5,37,"CONF_parse_list@561-598@lib/libcrypto/conf/conf_mod.c","lib/libcrypto/conf/conf_mod.c","CONF_parse_list",561,598
20,4,93,1,26,"OPENSSL_config@81-107@lib/libcrypto/conf/conf_sap.c","lib/libcrypto/conf/conf_sap.c","OPENSSL_config",81,107
4,1,10,1,3,"OPENSSL_no_config@110-113@lib/libcrypto/conf/conf_sap.c","lib/libcrypto/conf/conf_sap.c","OPENSSL_no_config",110,113
5,1,33,3,4,"x25519_scalar_mult@29-33@lib/libcrypto/curve25519/curve25519-generic.c","lib/libcrypto/curve25519/curve25519-generic.c","x25519_scalar_mult",29,33
7,1,55,1,6,"load_3@42-48@lib/libcrypto/curve25519/curve25519.c","lib/libcrypto/curve25519/curve25519.c","load_3",42,48
8,1,70,1,7,"load_4@50-57@lib/libcrypto/curve25519/curve25519.c","lib/libcrypto/curve25519/curve25519.c","load_4",50,57
42,1,482,2,45,"fe_frombytes@59-104@lib/libcrypto/curve25519/curve25519.c","lib/libcrypto/curve25519/curve25519.c","fe_frombytes",59,104
67,1,769,2,78,"fe_tobytes@128-206@lib/libcrypto/curve25519/curve25519.c","lib/libcrypto/curve25519/curve25519.c","fe_tobytes",128,206
3,1,25,2,2,"fe_copy@209-211@lib/libcrypto/curve25519/curve25519.c","lib/libcrypto/curve25519/curve25519.c","fe_copy",209,211
1,1,21,1,0,"fe_0@214-214@lib/libcrypto/curve25519/curve25519.c","lib/libcrypto/curve25519/curve25519.c","fe_0",214,214
4,1,28,1,3,"fe_1@217-220@lib/libcrypto/curve25519/curve25519.c","lib/libcrypto/curve25519/curve25519.c","fe_1",217,220
6,2,48,3,5,"fe_add@231-236@lib/libcrypto/curve25519/curve25519.c","lib/libcrypto/curve25519/curve25519.c","fe_add",231,236
6,2,48,3,5,"fe_sub@247-252@lib/libcrypto/curve25519/curve25519.c","lib/libcrypto/curve25519/curve25519.c","fe_sub",247,252
178,1,1895,3,214,"fe_mul@281-495@lib/libcrypto/curve25519/curve25519.c","lib/libcrypto/curve25519/curve25519.c","fe_mul",281,495
122,1,1264,2,129,"fe_sq@507-636@lib/libcrypto/curve25519/curve25519.c","lib/libcrypto/curve25519/curve25519.c","fe_sq",507,636
62,12,444,2,62,"fe_invert@638-700@lib/libcrypto/curve25519/curve25519.c","lib/libcrypto/curve25519/curve25519.c","fe_invert",638,700
6,2,40,2,5,"fe_neg@709-714@lib/libcrypto/curve25519/curve25519.c","lib/libcrypto/curve25519/curve25519.c","fe_neg",709,714
9,2,62,3,8,"fe_cmov@720-728@lib/libcrypto/curve25519/curve25519.c","lib/libcrypto/curve25519/curve25519.c","fe_cmov",720,728
6,1,48,1,6,"fe_isnonzero@735-741@lib/libcrypto/curve25519/curve25519.c","lib/libcrypto/curve25519/curve25519.c","fe_isnonzero",735,741
5,1,29,1,4,"fe_isnegative@748-752@lib/libcrypto/curve25519/curve25519.c","lib/libcrypto/curve25519/curve25519.c","fe_isnegative",748,752
132,1,1304,2,140,"fe_sq2@764-904@lib/libcrypto/curve25519/curve25519.c","lib/libcrypto/curve25519/curve25519.c","fe_sq2",764,904
61,12,441,2,61,"fe_pow22523@906-967@lib/libcrypto/curve25519/curve25519.c","lib/libcrypto/curve25519/curve25519.c","fe_pow22523",906,967
10,1,73,2,10,"x25519_ge_tobytes@969-979@lib/libcrypto/curve25519/curve25519.c","lib/libcrypto/curve25519/curve25519.c","x25519_ge_tobytes",969,979
10,1,73,2,10,"ge_p3_tobytes@982-992@lib/libcrypto/curve25519/curve25519.c","lib/libcrypto/curve25519/curve25519.c","ge_p3_tobytes",982,992
36,4,293,2,41,"x25519_ge_frombytes_vartime@1001-1042@lib/libcrypto/curve25519/curve25519.c","lib/libcrypto/curve25519/curve25519.c","x25519_ge_frombytes_vartime",1001,1042
5,1,29,1,4,"ge_p2_0@1044-1048@lib/libcrypto/curve25519/curve25519.c","lib/libcrypto/curve25519/curve25519.c","ge_p2_0",1044,1048
6,1,36,1,5,"ge_p3_0@1050-1055@lib/libcrypto/curve25519/curve25519.c","lib/libcrypto/curve25519/curve25519.c","ge_p3_0",1050,1055
6,1,36,1,5,"ge_cached_0@1057-1062@lib/libcrypto/curve25519/curve25519.c","lib/libcrypto/curve25519/curve25519.c","ge_cached_0",1057,1062
5,1,29,1,4,"ge_precomp_0@1064-1068@lib/libcrypto/curve25519/curve25519.c","lib/libcrypto/curve25519/curve25519.c","ge_precomp_0",1064,1068
5,1,46,2,4,"ge_p3_to_p2@1071-1075@lib/libcrypto/curve25519/curve25519.c","lib/libcrypto/curve25519/curve25519.c","ge_p3_to_p2",1071,1075
6,1,67,2,5,"x25519_ge_p3_to_cached@1081-1086@lib/libcrypto/curve25519/curve25519.c","lib/libcrypto/curve25519/curve25519.c","x25519_ge_p3_to_cached",1081,1086
5,1,58,2,4,"x25519_ge_p1p1_to_p2@1089-1093@lib/libcrypto/curve25519/curve25519.c","lib/libcrypto/curve25519/curve25519.c","x25519_ge_p1p1_to_p2",1089,1093
6,1,73,2,5,"x25519_ge_p1p1_to_p3@1096-1101@lib/libcrypto/curve25519/curve25519.c","lib/libcrypto/curve25519/curve25519.c","x25519_ge_p1p1_to_p3",1096,1101
5,1,32,2,4,"ge_p1p1_to_cached@1104-1108@lib/libcrypto/curve25519/curve25519.c","lib/libcrypto/curve25519/curve25519.c","ge_p1p1_to_cached",1104,1108
12,1,131,2,12,"ge_p2_dbl@1111-1123@lib/libcrypto/curve25519/curve25519.c","lib/libcrypto/curve25519/curve25519.c","ge_p2_dbl",1111,1123
5,1,32,2,4,"ge_p3_dbl@1126-1130@lib/libcrypto/curve25519/curve25519.c","lib/libcrypto/curve25519/curve25519.c","ge_p3_dbl",1126,1130
13,1,165,3,13,"ge_madd@1133-1146@lib/libcrypto/curve25519/curve25519.c","lib/libcrypto/curve25519/curve25519.c","ge_madd",1133,1146
13,1,165,3,13,"ge_msub@1150-1163@lib/libcrypto/curve25519/curve25519.c","lib/libcrypto/curve25519/curve25519.c","ge_msub",1150,1163
14,1,180,3,14,"x25519_ge_add@1167-1181@lib/libcrypto/curve25519/curve25519.c","lib/libcrypto/curve25519/curve25519.c","x25519_ge_add",1167,1181
14,1,180,3,14,"x25519_ge_sub@1184-1198@lib/libcrypto/curve25519/curve25519.c","lib/libcrypto/curve25519/curve25519.c","x25519_ge_sub",1184,1198
9,1,46,2,8,"equal@1200-1208@lib/libcrypto/curve25519/curve25519.c","lib/libcrypto/curve25519/curve25519.c","equal",1200,1208
5,1,55,3,4,"cmov@1210-1214@lib/libcrypto/curve25519/curve25519.c","lib/libcrypto/curve25519/curve25519.c","cmov",1210,1214
37,5,324,3,50,"x25519_ge_scalarmult_small_precomp@1216-1266@lib/libcrypto/curve25519/curve25519.c","lib/libcrypto/curve25519/curve25519.c","x25519_ge_scalarmult_small_precomp",1216,1266
3,1,24,2,2,"x25519_ge_scalarmult_base@1361-1363@lib/libcrypto/curve25519/curve25519.c","lib/libcrypto/curve25519/curve25519.c","x25519_ge_scalarmult_base",1361,1363
5,1,21,1,4,"negative@3483-3487@lib/libcrypto/curve25519/curve25519.c","lib/libcrypto/curve25519/curve25519.c","negative",3483,3487
18,1,264,3,18,"table_select@3489-3507@lib/libcrypto/curve25519/curve25519.c","lib/libcrypto/curve25519/curve25519.c","table_select",3489,3507
39,5,325,2,46,"x25519_ge_scalarmult_base@3515-3561@lib/libcrypto/curve25519/curve25519.c","lib/libcrypto/curve25519/curve25519.c","x25519_ge_scalarmult_base",3515,3561
6,1,67,3,5,"cmov_cached@3565-3570@lib/libcrypto/curve25519/curve25519.c","lib/libcrypto/curve25519/curve25519.c","cmov_cached",3565,3570
44,6,361,3,50,"x25519_ge_scalarmult@3574-3624@lib/libcrypto/curve25519/curve25519.c","lib/libcrypto/curve25519/curve25519.c","x25519_ge_scalarmult",3574,3624
31,11,253,2,32,"slide@3627-3659@lib/libcrypto/curve25519/curve25519.c","lib/libcrypto/curve25519/curve25519.c","slide",3627,3659
60,9,581,4,67,"ge_double_scalarmult_vartime@3733-3800@lib/libcrypto/curve25519/curve25519.c","lib/libcrypto/curve25519/curve25519.c","ge_double_scalarmult_vartime",3733,3800
311,1,2453,1,331,"x25519_sc_reduce@3814-4145@lib/libcrypto/curve25519/curve25519.c","lib/libcrypto/curve25519/curve25519.c","x25519_sc_reduce",3814,4145
457,1,4010,4,480,"sc_muladd@4157-4637@lib/libcrypto/curve25519/curve25519.c","lib/libcrypto/curve25519/curve25519.c","sc_muladd",4157,4637
14,1,104,2,17,"ED25519_keypair@4641-4658@lib/libcrypto/curve25519/curve25519.c","lib/libcrypto/curve25519/curve25519.c","ED25519_keypair",4641,4658
27,1,201,4,32,"ED25519_sign@4660-4692@lib/libcrypto/curve25519/curve25519.c","lib/libcrypto/curve25519/curve25519.c","ED25519_sign",4660,4692
29,3,229,4,35,"ED25519_verify@4694-4729@lib/libcrypto/curve25519/curve25519.c","lib/libcrypto/curve25519/curve25519.c","ED25519_verify",4694,4729
10,2,69,3,9,"fe_cswap@4736-4745@lib/libcrypto/curve25519/curve25519.c","lib/libcrypto/curve25519/curve25519.c","fe_cswap",4736,4745
52,1,534,2,54,"fe_mul121666@4755-4809@lib/libcrypto/curve25519/curve25519.c","lib/libcrypto/curve25519/curve25519.c","fe_mul121666",4755,4809
46,2,367,3,48,"x25519_scalar_mult_generic@4812-4860@lib/libcrypto/curve25519/curve25519.c","lib/libcrypto/curve25519/curve25519.c","x25519_scalar_mult_generic",4812,4860
17,1,120,2,21,"x25519_public_from_private_generic@4864-4885@lib/libcrypto/curve25519/curve25519.c","lib/libcrypto/curve25519/curve25519.c","x25519_public_from_private_generic",4864,4885
6,1,38,2,6,"x25519_public_from_private@4889-4895@lib/libcrypto/curve25519/curve25519.c","lib/libcrypto/curve25519/curve25519.c","x25519_public_from_private",4889,4895
9,1,51,2,23,"X25519_keypair@4898-4921@lib/libcrypto/curve25519/curve25519.c","lib/libcrypto/curve25519/curve25519.c","X25519_keypair",4898,4921
8,1,57,3,10,"X25519@4924-4934@lib/libcrypto/curve25519/curve25519.c","lib/libcrypto/curve25519/curve25519.c","X25519",4924,4934
38,4,275,5,45,"DES_cbc_cksum@61-106@lib/libcrypto/des/cbc_cksm.c","lib/libcrypto/des/cbc_cksm.c","DES_cbc_cksum",61,106
63,6,405,9,67,"DES_ede3_cfb64_encrypt@66-133@lib/libcrypto/des/cfb64ede.c","lib/libcrypto/des/cfb64ede.c","DES_ede3_cfb64_encrypt",66,133
96,15,685,9,104,"DES_ede3_cfb_encrypt@139-243@lib/libcrypto/des/cfb64ede.c","lib/libcrypto/des/cfb64ede.c","DES_ede3_cfb_encrypt",139,243
54,6,393,7,54,"DES_cfb64_encrypt@66-120@lib/libcrypto/des/cfb64enc.c","lib/libcrypto/des/cfb64enc.c","DES_cfb64_encrypt",66,120
99,19,770,7,118,"DES_cfb_encrypt@70-188@lib/libcrypto/des/cfb_enc.c","lib/libcrypto/des/cfb_enc.c","DES_cfb_encrypt",70,188
67,7,522,3,92,"DES_encrypt1@64-156@lib/libcrypto/des/des_enc.c","lib/libcrypto/des/des_enc.c","DES_encrypt1",64,156
63,7,500,3,85,"DES_encrypt2@158-243@lib/libcrypto/des/des_enc.c","lib/libcrypto/des/des_enc.c","DES_encrypt2",158,243
18,1,134,4,18,"DES_encrypt3@247-265@lib/libcrypto/des/des_enc.c","lib/libcrypto/des/des_enc.c","DES_encrypt3",247,265
18,1,134,4,18,"DES_decrypt3@267-285@lib/libcrypto/des/des_enc.c","lib/libcrypto/des/des_enc.c","DES_decrypt3",267,285
97,6,611,8,110,"DES_ede3_cbc_encrypt@292-402@lib/libcrypto/des/des_enc.c","lib/libcrypto/des/des_enc.c","DES_ede3_cbc_encrypt",292,402
4,1,29,2,3,"ROTATE@137-140@lib/libcrypto/des/des_locl.h","lib/libcrypto/des/des_locl.h","ROTATE",137,140
22,2,150,6,22,"DES_ecb3_encrypt@61-83@lib/libcrypto/des/ecb3_enc.c","lib/libcrypto/des/ecb3_enc.c","DES_ecb3_encrypt",61,83
24,8,115,1,38,"DES_options@63-101@lib/libcrypto/des/ecb_enc.c","lib/libcrypto/des/ecb_enc.c","DES_options",63,101
14,1,136,4,14,"DES_ecb_encrypt@104-118@lib/libcrypto/des/ecb_enc.c","lib/libcrypto/des/ecb_enc.c","DES_ecb_encrypt",104,118
110,6,706,9,122,"DES_ede3_cbcm_encrypt@76-198@lib/libcrypto/des/ede_cbcm_enc.c","lib/libcrypto/des/ede_cbcm_enc.c","DES_ede3_cbcm_encrypt",76,198
101,28,596,5,140,"DES_enc_read@88-228@lib/libcrypto/des/enc_read.c","lib/libcrypto/des/enc_read.c","DES_enc_read",88,228
70,17,422,5,91,"DES_enc_write@82-173@lib/libcrypto/des/enc_writ.c","lib/libcrypto/des/enc_writ.c","DES_enc_write",82,173
5,1,33,2,5,"DES_crypt@54-59@lib/libcrypto/des/fcrypt.c","lib/libcrypto/des/fcrypt.c","DES_crypt",54,59
48,10,359,3,62,"DES_fcrypt@62-124@lib/libcrypto/des/fcrypt.c","lib/libcrypto/des/fcrypt.c","DES_fcrypt",62,124
51,4,390,4,62,"fcrypt_body@81-143@lib/libcrypto/des/fcrypt_b.c","lib/libcrypto/des/fcrypt_b.c","fcrypt_body",81,143
70,6,546,6,78,"DES_ncbc_encrypt@70-148@lib/libcrypto/des/ncbc_enc.c","lib/libcrypto/des/ncbc_enc.c","DES_ncbc_encrypt",70,148
46,4,282,8,49,"DES_ede3_ofb64_encrypt@65-114@lib/libcrypto/des/ofb64ede.c","lib/libcrypto/des/ofb64ede.c","DES_ede3_ofb64_encrypt",65,114
44,4,283,6,44,"DES_ofb64_encrypt@65-109@lib/libcrypto/des/ofb64enc.c","lib/libcrypto/des/ofb64enc.c","DES_ofb64_encrypt",65,109
65,9,490,6,67,"DES_ofb_encrypt@67-134@lib/libcrypto/des/ofb_enc.c","lib/libcrypto/des/ofb_enc.c","DES_ofb_encrypt",67,134
61,6,380,6,62,"DES_pcbc_encrypt@61-123@lib/libcrypto/des/pcbc_enc.c","lib/libcrypto/des/pcbc_enc.c","DES_pcbc_encrypt",61,123
42,7,354,5,48,"DES_quad_cksum@76-124@lib/libcrypto/des/qud_cksm.c","lib/libcrypto/des/qud_cksm.c","DES_quad_cksum",76,124
8,2,39,1,7,"DES_random_key@61-68@lib/libcrypto/des/rand_key.c","lib/libcrypto/des/rand_key.c","DES_random_key",61,68
6,2,44,1,6,"DES_set_odd_parity@89-95@lib/libcrypto/des/set_key.c","lib/libcrypto/des/set_key.c","DES_set_odd_parity",89,95
10,3,58,1,10,"DES_check_key_parity@97-107@lib/libcrypto/des/set_key.c","lib/libcrypto/des/set_key.c","DES_check_key_parity",97,107
8,3,50,1,8,"DES_is_weak_key@140-148@lib/libcrypto/des/set_key.c","lib/libcrypto/des/set_key.c","DES_is_weak_key",140,148
12,2,39,2,11,"DES_set_key@307-318@lib/libcrypto/des/set_key.c","lib/libcrypto/des/set_key.c","DES_set_key",307,318
9,3,49,2,8,"DES_set_key_checked@324-332@lib/libcrypto/des/set_key.c","lib/libcrypto/des/set_key.c","DES_set_key_checked",324,332
43,3,605,2,54,"DES_set_key_unchecked@334-388@lib/libcrypto/des/set_key.c","lib/libcrypto/des/set_key.c","DES_set_key_unchecked",334,388
4,1,22,2,3,"DES_key_sched@390-393@lib/libcrypto/des/set_key.c","lib/libcrypto/des/set_key.c","DES_key_sched",390,393
31,7,288,2,38,"DES_string_to_key@62-100@lib/libcrypto/des/str2key.c","lib/libcrypto/des/str2key.c","DES_string_to_key",62,100
63,15,521,3,72,"DES_string_to_2keys@102-174@lib/libcrypto/des/str2key.c","lib/libcrypto/des/str2key.c","DES_string_to_2keys",102,174
81,6,646,8,84,"DES_xcbc_encrypt@63-147@lib/libcrypto/des/xcbc_enc.c","lib/libcrypto/des/xcbc_enc.c","DES_xcbc_encrypt",63,147
4,1,17,1,3,"int_dh_free@70-73@lib/libcrypto/dh/dh_ameth.c","lib/libcrypto/dh/dh_ameth.c","int_dh_free",70,73
41,7,234,2,49,"dh_pub_decode@76-125@lib/libcrypto/dh/dh_ameth.c","lib/libcrypto/dh/dh_ameth.c","dh_pub_decode",76,125
37,6,198,2,46,"dh_pub_encode@128-174@lib/libcrypto/dh/dh_ameth.c","lib/libcrypto/dh/dh_ameth.c","dh_pub_encode",128,174
37,7,222,2,47,"dh_priv_decode@183-230@lib/libcrypto/dh/dh_ameth.c","lib/libcrypto/dh/dh_ameth.c","dh_priv_decode",183,230
35,5,196,2,45,"dh_priv_encode@233-278@lib/libcrypto/dh/dh_ameth.c","lib/libcrypto/dh/dh_ameth.c","dh_priv_encode",233,278
8,3,45,2,8,"update_buflen@281-289@lib/libcrypto/dh/dh_ameth.c","lib/libcrypto/dh/dh_ameth.c","update_buflen",281,289
10,2,57,3,10,"dh_param_decode@292-302@lib/libcrypto/dh/dh_ameth.c","lib/libcrypto/dh/dh_ameth.c","dh_param_decode",292,302
4,1,26,2,3,"dh_param_encode@305-308@lib/libcrypto/dh/dh_ameth.c","lib/libcrypto/dh/dh_ameth.c","dh_param_encode",305,308
60,15,376,5,70,"do_dh_print@311-381@lib/libcrypto/dh/dh_ameth.c","lib/libcrypto/dh/dh_ameth.c","do_dh_print",311,381
4,1,19,1,3,"int_dh_size@384-387@lib/libcrypto/dh/dh_ameth.c","lib/libcrypto/dh/dh_ameth.c","int_dh_size",384,387
4,1,21,1,3,"dh_bits@390-393@lib/libcrypto/dh/dh_ameth.c","lib/libcrypto/dh/dh_ameth.c","dh_bits",390,393
8,3,61,2,7,"dh_cmp_parameters@396-403@lib/libcrypto/dh/dh_ameth.c","lib/libcrypto/dh/dh_ameth.c","dh_cmp_parameters",396,403
13,3,106,2,15,"dh_copy_parameters@406-421@lib/libcrypto/dh/dh_ameth.c","lib/libcrypto/dh/dh_ameth.c","dh_copy_parameters",406,421
6,3,35,1,5,"dh_missing_parameters@424-429@lib/libcrypto/dh/dh_ameth.c","lib/libcrypto/dh/dh_ameth.c","dh_missing_parameters",424,429
9,3,58,2,8,"dh_pub_cmp@432-440@lib/libcrypto/dh/dh_ameth.c","lib/libcrypto/dh/dh_ameth.c","dh_pub_cmp",432,440
4,1,38,4,3,"dh_param_print@443-446@lib/libcrypto/dh/dh_ameth.c","lib/libcrypto/dh/dh_ameth.c","dh_param_print",443,446
4,1,38,4,3,"dh_public_print@449-452@lib/libcrypto/dh/dh_ameth.c","lib/libcrypto/dh/dh_ameth.c","dh_public_print",449,452
4,1,38,4,3,"dh_private_print@455-458@lib/libcrypto/dh/dh_ameth.c","lib/libcrypto/dh/dh_ameth.c","dh_private_print",455,458
4,1,27,2,3,"DHparams_print@461-464@lib/libcrypto/dh/dh_ameth.c","lib/libcrypto/dh/dh_ameth.c","DHparams_print",461,464
14,4,80,4,13,"dh_cb@68-81@lib/libcrypto/dh/dh_asn1.c","lib/libcrypto/dh/dh_asn1.c","dh_cb",68,81
5,1,38,3,4,"d2i_DHparams@127-131@lib/libcrypto/dh/dh_asn1.c","lib/libcrypto/dh/dh_asn1.c","d2i_DHparams",127,131
4,1,29,2,3,"i2d_DHparams@134-137@lib/libcrypto/dh/dh_asn1.c","lib/libcrypto/dh/dh_asn1.c","i2d_DHparams",134,137
4,1,23,2,3,"d2i_DHparams_bio@140-143@lib/libcrypto/dh/dh_asn1.c","lib/libcrypto/dh/dh_asn1.c","d2i_DHparams_bio",140,143
4,1,23,2,3,"i2d_DHparams_bio@146-149@lib/libcrypto/dh/dh_asn1.c","lib/libcrypto/dh/dh_asn1.c","i2d_DHparams_bio",146,149
4,1,23,2,3,"d2i_DHparams_fp@152-155@lib/libcrypto/dh/dh_asn1.c","lib/libcrypto/dh/dh_asn1.c","d2i_DHparams_fp",152,155
4,1,23,2,3,"i2d_DHparams_fp@158-161@lib/libcrypto/dh/dh_asn1.c","lib/libcrypto/dh/dh_asn1.c","i2d_DHparams_fp",158,161
4,1,17,1,3,"DHparams_dup@164-167@lib/libcrypto/dh/dh_asn1.c","lib/libcrypto/dh/dh_asn1.c","DHparams_dup",164,167
41,13,252,2,43,"DH_check@75-118@lib/libcrypto/dh/dh_check.c","lib/libcrypto/dh/dh_check.c","DH_check",75,118
17,4,107,3,18,"DH_check_pub_key@121-139@lib/libcrypto/dh/dh_check.c","lib/libcrypto/dh/dh_check.c","DH_check_pub_key",121,139
13,3,87,4,15,"DH_generate_parameters@67-82@lib/libcrypto/dh/dh_depr.c","lib/libcrypto/dh/dh_depr.c","DH_generate_parameters",67,82
8,2,36,1,10,"ERR_load_DH_strings@98-108@lib/libcrypto/dh/dh_err.c","lib/libcrypto/dh/dh_err.c","ERR_load_DH_strings",98,108
6,2,54,4,5,"DH_generate_parameters_ex@74-79@lib/libcrypto/dh/dh_gen.c","lib/libcrypto/dh/dh_gen.c","DH_generate_parameters_ex",74,79
58,20,363,4,71,"dh_builtin_genparams@108-179@lib/libcrypto/dh/dh_gen.c","lib/libcrypto/dh/dh_gen.c","dh_builtin_genparams",108,179
4,1,18,1,3,"DH_generate_key@75-78@lib/libcrypto/dh/dh_key.c","lib/libcrypto/dh/dh_key.c","DH_generate_key",75,78
4,1,32,3,3,"DH_compute_key@81-84@lib/libcrypto/dh/dh_key.c","lib/libcrypto/dh/dh_key.c","DH_compute_key",81,84
4,1,10,1,3,"DH_OpenSSL@96-99@lib/libcrypto/dh/dh_key.c","lib/libcrypto/dh/dh_key.c","DH_OpenSSL",96,99
64,21,371,1,74,"generate_key@102-176@lib/libcrypto/dh/dh_key.c","lib/libcrypto/dh/dh_key.c","generate_key",102,176
45,11,258,3,53,"compute_key@179-232@lib/libcrypto/dh/dh_key.c","lib/libcrypto/dh/dh_key.c","compute_key",179,232
5,1,52,7,4,"dh_bn_mod_exp@235-239@lib/libcrypto/dh/dh_key.c","lib/libcrypto/dh/dh_key.c","dh_bn_mod_exp",235,239
5,1,17,1,4,"dh_init@242-246@lib/libcrypto/dh/dh_key.c","lib/libcrypto/dh/dh_key.c","dh_init",242,246
5,1,18,1,4,"dh_finish@249-253@lib/libcrypto/dh/dh_key.c","lib/libcrypto/dh/dh_key.c","dh_finish",249,253
4,1,13,1,3,"DH_set_default_method@74-77@lib/libcrypto/dh/dh_lib.c","lib/libcrypto/dh/dh_lib.c","DH_set_default_method",74,77
6,2,20,1,5,"DH_get_default_method@80-85@lib/libcrypto/dh/dh_lib.c","lib/libcrypto/dh/dh_lib.c","DH_get_default_method",80,85
15,4,80,2,21,"DH_set_method@88-109@lib/libcrypto/dh/dh_lib.c","lib/libcrypto/dh/dh_lib.c","DH_set_method",88,109
4,1,12,1,3,"DH_new@112-115@lib/libcrypto/dh/dh_lib.c","lib/libcrypto/dh/dh_lib.c","DH_new",112,115
52,9,305,1,58,"DH_new_method@118-176@lib/libcrypto/dh/dh_lib.c","lib/libcrypto/dh/dh_lib.c","DH_new_method",118,176
23,5,145,1,28,"DH_free@179-207@lib/libcrypto/dh/dh_lib.c","lib/libcrypto/dh/dh_lib.c","DH_free",179,207
5,2,32,1,5,"DH_up_ref@210-215@lib/libcrypto/dh/dh_lib.c","lib/libcrypto/dh/dh_lib.c","DH_up_ref",210,215
6,1,39,5,5,"DH_get_ex_new_index@218-223@lib/libcrypto/dh/dh_lib.c","lib/libcrypto/dh/dh_lib.c","DH_get_ex_new_index",218,223
4,1,28,3,3,"DH_set_ex_data@226-229@lib/libcrypto/dh/dh_lib.c","lib/libcrypto/dh/dh_lib.c","DH_set_ex_data",226,229
4,1,22,2,3,"DH_get_ex_data@232-235@lib/libcrypto/dh/dh_lib.c","lib/libcrypto/dh/dh_lib.c","DH_get_ex_data",232,235
4,1,17,1,3,"DH_size@238-241@lib/libcrypto/dh/dh_lib.c","lib/libcrypto/dh/dh_lib.c","DH_size",238,241
14,2,71,1,16,"pkey_dh_init@85-101@lib/libcrypto/dh/dh_pmeth.c","lib/libcrypto/dh/dh_pmeth.c","pkey_dh_init",85,101
12,2,69,2,12,"pkey_dh_copy@104-116@lib/libcrypto/dh/dh_pmeth.c","lib/libcrypto/dh/dh_pmeth.c","pkey_dh_copy",104,116
5,1,21,1,5,"pkey_dh_cleanup@119-124@lib/libcrypto/dh/dh_pmeth.c","lib/libcrypto/dh/dh_pmeth.c","pkey_dh_cleanup",119,124
18,5,78,4,22,"pkey_dh_ctrl@127-149@lib/libcrypto/dh/dh_pmeth.c","lib/libcrypto/dh/dh_pmeth.c","pkey_dh_ctrl",127,149
32,17,213,3,33,"pkey_dh_ctrl_str@152-185@lib/libcrypto/dh/dh_pmeth.c","lib/libcrypto/dh/dh_pmeth.c","pkey_dh_ctrl_str",152,185
22,4,111,2,22,"pkey_dh_paramgen@188-210@lib/libcrypto/dh/dh_pmeth.c","lib/libcrypto/dh/dh_pmeth.c","pkey_dh_paramgen",188,210
15,4,82,2,16,"pkey_dh_keygen@213-229@lib/libcrypto/dh/dh_pmeth.c","lib/libcrypto/dh/dh_pmeth.c","pkey_dh_keygen",213,229
14,4,84,3,14,"pkey_dh_derive@232-246@lib/libcrypto/dh/dh_pmeth.c","lib/libcrypto/dh/dh_pmeth.c","pkey_dh_derive",232,246
13,2,71,2,13,"DHparams_print_fp@66-79@lib/libcrypto/dh/dh_prn.c","lib/libcrypto/dh/dh_prn.c","DHparams_print_fp",66,79
47,10,271,2,54,"dsa_pub_decode@73-127@lib/libcrypto/dsa/dsa_ameth.c","lib/libcrypto/dsa/dsa_ameth.c","dsa_pub_decode",73,127
39,9,210,2,46,"dsa_pub_encode@130-176@lib/libcrypto/dsa/dsa_ameth.c","lib/libcrypto/dsa/dsa_ameth.c","dsa_pub_encode",130,176
55,11,329,2,64,"dsa_priv_decode@182-246@lib/libcrypto/dsa/dsa_ameth.c","lib/libcrypto/dsa/dsa_ameth.c","dsa_priv_decode",182,246
35,5,196,2,43,"dsa_priv_encode@249-292@lib/libcrypto/dsa/dsa_ameth.c","lib/libcrypto/dsa/dsa_ameth.c","dsa_priv_encode",249,292
4,1,19,1,3,"int_dsa_size@295-298@lib/libcrypto/dsa/dsa_ameth.c","lib/libcrypto/dsa/dsa_ameth.c","int_dsa_size",295,298
4,1,21,1,3,"dsa_bits@301-304@lib/libcrypto/dsa/dsa_ameth.c","lib/libcrypto/dsa/dsa_ameth.c","dsa_bits",301,304
8,4,47,1,8,"dsa_missing_parameters@307-315@lib/libcrypto/dsa/dsa_ameth.c","lib/libcrypto/dsa/dsa_ameth.c","dsa_missing_parameters",307,315
17,4,149,2,19,"dsa_copy_parameters@318-337@lib/libcrypto/dsa/dsa_ameth.c","lib/libcrypto/dsa/dsa_ameth.c","dsa_copy_parameters",318,337
9,4,80,2,8,"dsa_cmp_parameters@340-348@lib/libcrypto/dsa/dsa_ameth.c","lib/libcrypto/dsa/dsa_ameth.c","dsa_cmp_parameters",340,348
7,2,44,2,6,"dsa_pub_cmp@351-357@lib/libcrypto/dsa/dsa_ameth.c","lib/libcrypto/dsa/dsa_ameth.c","dsa_pub_cmp",351,357
4,1,17,1,3,"int_dsa_free@360-363@lib/libcrypto/dsa/dsa_ameth.c","lib/libcrypto/dsa/dsa_ameth.c","int_dsa_free",360,363
8,3,45,2,8,"update_buflen@366-374@lib/libcrypto/dsa/dsa_ameth.c","lib/libcrypto/dsa/dsa_ameth.c","update_buflen",366,374
53,14,343,4,59,"do_dsa_print@377-436@lib/libcrypto/dsa/dsa_ameth.c","lib/libcrypto/dsa/dsa_ameth.c","do_dsa_print",377,436
10,2,57,3,10,"dsa_param_decode@439-449@lib/libcrypto/dsa/dsa_ameth.c","lib/libcrypto/dsa/dsa_ameth.c","dsa_param_decode",439,449
4,1,26,2,3,"dsa_param_encode@452-455@lib/libcrypto/dsa/dsa_ameth.c","lib/libcrypto/dsa/dsa_ameth.c","dsa_param_encode",452,455
4,1,36,4,3,"dsa_param_print@458-461@lib/libcrypto/dsa/dsa_ameth.c","lib/libcrypto/dsa/dsa_ameth.c","dsa_param_print",458,461
4,1,36,4,3,"dsa_pub_print@464-467@lib/libcrypto/dsa/dsa_ameth.c","lib/libcrypto/dsa/dsa_ameth.c","dsa_pub_print",464,467
4,1,36,4,3,"dsa_priv_print@470-473@lib/libcrypto/dsa/dsa_ameth.c","lib/libcrypto/dsa/dsa_ameth.c","dsa_priv_print",470,473
39,11,256,3,56,"old_dsa_priv_decode@476-532@lib/libcrypto/dsa/dsa_ameth.c","lib/libcrypto/dsa/dsa_ameth.c","old_dsa_priv_decode",476,532
4,1,26,2,3,"old_dsa_priv_encode@535-538@lib/libcrypto/dsa/dsa_ameth.c","lib/libcrypto/dsa/dsa_ameth.c","old_dsa_priv_encode",535,538
38,8,235,5,41,"dsa_sig_print@541-582@lib/libcrypto/dsa/dsa_ameth.c","lib/libcrypto/dsa/dsa_ameth.c","dsa_sig_print",541,582
27,8,153,4,29,"dsa_pkey_ctrl@585-614@lib/libcrypto/dsa/dsa_ameth.c","lib/libcrypto/dsa/dsa_ameth.c","dsa_pkey_ctrl",585,614
16,3,84,4,16,"sig_cb@69-85@lib/libcrypto/dsa/dsa_asn1.c","lib/libcrypto/dsa/dsa_asn1.c","sig_cb",69,85
5,1,38,3,4,"d2i_DSA_SIG@124-128@lib/libcrypto/dsa/dsa_asn1.c","lib/libcrypto/dsa/dsa_asn1.c","d2i_DSA_SIG",124,128
4,1,29,2,3,"i2d_DSA_SIG@131-134@lib/libcrypto/dsa/dsa_asn1.c","lib/libcrypto/dsa/dsa_asn1.c","i2d_DSA_SIG",131,134
14,4,80,4,13,"dsa_cb@138-151@lib/libcrypto/dsa/dsa_asn1.c","lib/libcrypto/dsa/dsa_asn1.c","dsa_cb",138,151
5,1,38,3,4,"d2i_DSAPrivateKey@218-222@lib/libcrypto/dsa/dsa_asn1.c","lib/libcrypto/dsa/dsa_asn1.c","d2i_DSAPrivateKey",218,222
4,1,29,2,3,"i2d_DSAPrivateKey@225-228@lib/libcrypto/dsa/dsa_asn1.c","lib/libcrypto/dsa/dsa_asn1.c","i2d_DSAPrivateKey",225,228
5,1,38,3,4,"d2i_DSAparams@274-278@lib/libcrypto/dsa/dsa_asn1.c","lib/libcrypto/dsa/dsa_asn1.c","d2i_DSAparams",274,278
4,1,29,2,3,"i2d_DSAparams@281-284@lib/libcrypto/dsa/dsa_asn1.c","lib/libcrypto/dsa/dsa_asn1.c","i2d_DSAparams",281,284
4,1,23,2,3,"d2i_DSAparams_bio@287-290@lib/libcrypto/dsa/dsa_asn1.c","lib/libcrypto/dsa/dsa_asn1.c","d2i_DSAparams_bio",287,290
4,1,23,2,3,"i2d_DSAparams_bio@293-296@lib/libcrypto/dsa/dsa_asn1.c","lib/libcrypto/dsa/dsa_asn1.c","i2d_DSAparams_bio",293,296
4,1,23,2,3,"d2i_DSAparams_fp@299-302@lib/libcrypto/dsa/dsa_asn1.c","lib/libcrypto/dsa/dsa_asn1.c","d2i_DSAparams_fp",299,302
4,1,23,2,3,"i2d_DSAparams_fp@305-308@lib/libcrypto/dsa/dsa_asn1.c","lib/libcrypto/dsa/dsa_asn1.c","i2d_DSAparams_fp",305,308
5,1,38,3,4,"d2i_DSAPublicKey@395-399@lib/libcrypto/dsa/dsa_asn1.c","lib/libcrypto/dsa/dsa_asn1.c","d2i_DSAPublicKey",395,399
4,1,29,2,3,"i2d_DSAPublicKey@402-405@lib/libcrypto/dsa/dsa_asn1.c","lib/libcrypto/dsa/dsa_asn1.c","i2d_DSAPublicKey",402,405
4,1,17,1,3,"DSAparams_dup@408-411@lib/libcrypto/dsa/dsa_asn1.c","lib/libcrypto/dsa/dsa_asn1.c","DSAparams_dup",408,411
13,2,80,6,13,"DSA_sign@414-427@lib/libcrypto/dsa/dsa_asn1.c","lib/libcrypto/dsa/dsa_asn1.c","DSA_sign",414,427
22,5,151,6,23,"DSA_verify@437-460@lib/libcrypto/dsa/dsa_asn1.c","lib/libcrypto/dsa/dsa_asn1.c","DSA_verify",437,460
15,3,105,7,17,"DSA_generate_parameters@73-90@lib/libcrypto/dsa/dsa_depr.c","lib/libcrypto/dsa/dsa_depr.c","DSA_generate_parameters",73,90
8,2,36,1,10,"ERR_load_DSA_strings@98-108@lib/libcrypto/dsa/dsa_err.c","lib/libcrypto/dsa/dsa_err.c","ERR_load_DSA_strings",98,108
20,3,129,7,21,"DSA_generate_parameters_ex@75-96@lib/libcrypto/dsa/dsa_gen.c","lib/libcrypto/dsa/dsa_gen.c","DSA_generate_parameters_ex",75,96
195,74,1353,10,258,"dsa_builtin_paramgen@99-357@lib/libcrypto/dsa/dsa_gen.c","lib/libcrypto/dsa/dsa_gen.c","dsa_builtin_paramgen",99,357
6,2,32,1,5,"DSA_generate_key@73-78@lib/libcrypto/dsa/dsa_key.c","lib/libcrypto/dsa/dsa_key.c","DSA_generate_key",73,78
38,13,234,1,46,"dsa_builtin_keygen@81-127@lib/libcrypto/dsa/dsa_key.c","lib/libcrypto/dsa/dsa_key.c","dsa_builtin_keygen",81,127
4,1,13,1,3,"DSA_set_default_method@80-83@lib/libcrypto/dsa/dsa_lib.c","lib/libcrypto/dsa/dsa_lib.c","DSA_set_default_method",80,83
6,2,20,1,5,"DSA_get_default_method@86-91@lib/libcrypto/dsa/dsa_lib.c","lib/libcrypto/dsa/dsa_lib.c","DSA_get_default_method",86,91
4,1,12,1,3,"DSA_new@94-97@lib/libcrypto/dsa/dsa_lib.c","lib/libcrypto/dsa/dsa_lib.c","DSA_new",94,97
15,4,80,2,20,"DSA_set_method@100-120@lib/libcrypto/dsa/dsa_lib.c","lib/libcrypto/dsa/dsa_lib.c","DSA_set_method",100,120
50,9,293,1,59,"DSA_new_method@123-182@lib/libcrypto/dsa/dsa_lib.c","lib/libcrypto/dsa/dsa_lib.c","DSA_new_method",123,182
22,5,138,1,28,"DSA_free@185-213@lib/libcrypto/dsa/dsa_lib.c","lib/libcrypto/dsa/dsa_lib.c","DSA_free",185,213
5,2,32,1,4,"DSA_up_ref@216-220@lib/libcrypto/dsa/dsa_lib.c","lib/libcrypto/dsa/dsa_lib.c","DSA_up_ref",216,220
15,1,92,1,20,"DSA_size@223-243@lib/libcrypto/dsa/dsa_lib.c","lib/libcrypto/dsa/dsa_lib.c","DSA_size",223,243
6,1,39,5,5,"DSA_get_ex_new_index@246-251@lib/libcrypto/dsa/dsa_lib.c","lib/libcrypto/dsa/dsa_lib.c","DSA_get_ex_new_index",246,251
4,1,28,3,3,"DSA_set_ex_data@254-257@lib/libcrypto/dsa/dsa_lib.c","lib/libcrypto/dsa/dsa_lib.c","DSA_set_ex_data",254,257
4,1,22,2,3,"DSA_get_ex_data@260-263@lib/libcrypto/dsa/dsa_lib.c","lib/libcrypto/dsa/dsa_lib.c","DSA_get_ex_data",260,263
30,13,205,1,37,"DSA_dup_DH@267-304@lib/libcrypto/dsa/dsa_lib.c","lib/libcrypto/dsa/dsa_lib.c","DSA_dup_DH",267,304
4,1,10,1,3,"DSA_OpenSSL@89-92@lib/libcrypto/dsa/dsa_ossl.c","lib/libcrypto/dsa/dsa_ossl.c","DSA_OpenSSL",89,92
69,21,432,3,86,"dsa_do_sign@95-181@lib/libcrypto/dsa/dsa_ossl.c","lib/libcrypto/dsa/dsa_ossl.c","dsa_do_sign",95,181
61,21,431,4,85,"dsa_sign_setup@184-269@lib/libcrypto/dsa/dsa_ossl.c","lib/libcrypto/dsa/dsa_ossl.c","dsa_sign_setup",184,269
71,27,549,4,100,"dsa_do_verify@272-372@lib/libcrypto/dsa/dsa_ossl.c","lib/libcrypto/dsa/dsa_ossl.c","dsa_do_verify",272,372
5,1,17,1,4,"dsa_init@375-379@lib/libcrypto/dsa/dsa_ossl.c","lib/libcrypto/dsa/dsa_ossl.c","dsa_init",375,379
5,1,18,1,4,"dsa_finish@382-386@lib/libcrypto/dsa/dsa_ossl.c","lib/libcrypto/dsa/dsa_ossl.c","dsa_finish",382,386
15,2,77,1,17,"pkey_dsa_init@86-103@lib/libcrypto/dsa/dsa_pmeth.c","lib/libcrypto/dsa/dsa_pmeth.c","pkey_dsa_init",86,103
13,2,77,2,13,"pkey_dsa_copy@106-119@lib/libcrypto/dsa/dsa_pmeth.c","lib/libcrypto/dsa/dsa_pmeth.c","pkey_dsa_copy",106,119
5,1,21,1,5,"pkey_dsa_cleanup@122-127@lib/libcrypto/dsa/dsa_pmeth.c","lib/libcrypto/dsa/dsa_pmeth.c","pkey_dsa_cleanup",122,127
17,3,110,5,19,"pkey_dsa_sign@130-149@lib/libcrypto/dsa/dsa_pmeth.c","lib/libcrypto/dsa/dsa_pmeth.c","pkey_dsa_sign",130,149
13,2,91,5,15,"pkey_dsa_verify@152-167@lib/libcrypto/dsa/dsa_pmeth.c","lib/libcrypto/dsa/dsa_pmeth.c","pkey_dsa_verify",152,167
53,24,222,4,58,"pkey_dsa_ctrl@170-228@lib/libcrypto/dsa/dsa_pmeth.c","lib/libcrypto/dsa/dsa_pmeth.c","pkey_dsa_ctrl",170,228
39,18,260,3,41,"pkey_dsa_ctrl_str@231-272@lib/libcrypto/dsa/dsa_pmeth.c","lib/libcrypto/dsa/dsa_pmeth.c","pkey_dsa_ctrl_str",231,272
22,4,125,2,22,"pkey_dsa_paramgen@275-297@lib/libcrypto/dsa/dsa_pmeth.c","lib/libcrypto/dsa/dsa_pmeth.c","pkey_dsa_paramgen",275,297
15,4,82,2,16,"pkey_dsa_keygen@300-316@lib/libcrypto/dsa/dsa_pmeth.c","lib/libcrypto/dsa/dsa_pmeth.c","pkey_dsa_keygen",300,316
13,2,76,3,13,"DSA_print_fp@66-79@lib/libcrypto/dsa/dsa_prn.c","lib/libcrypto/dsa/dsa_prn.c","DSA_print_fp",66,79
13,2,71,2,13,"DSAparams_print_fp@82-95@lib/libcrypto/dsa/dsa_prn.c","lib/libcrypto/dsa/dsa_prn.c","DSAparams_print_fp",82,95
11,3,70,3,11,"DSA_print@98-109@lib/libcrypto/dsa/dsa_prn.c","lib/libcrypto/dsa/dsa_prn.c","DSA_print",98,109
11,3,67,2,11,"DSAparams_print@112-123@lib/libcrypto/dsa/dsa_prn.c","lib/libcrypto/dsa/dsa_prn.c","DSAparams_print",112,123
4,1,31,3,3,"DSA_do_sign@65-68@lib/libcrypto/dsa/dsa_sign.c","lib/libcrypto/dsa/dsa_sign.c","DSA_do_sign",65,68
4,1,36,4,3,"DSA_sign_setup@71-74@lib/libcrypto/dsa/dsa_sign.c","lib/libcrypto/dsa/dsa_sign.c","DSA_sign_setup",71,74
10,2,43,1,10,"DSA_SIG_new@77-87@lib/libcrypto/dsa/dsa_sign.c","lib/libcrypto/dsa/dsa_sign.c","DSA_SIG_new",77,87
8,2,33,1,7,"DSA_SIG_free@90-97@lib/libcrypto/dsa/dsa_sign.c","lib/libcrypto/dsa/dsa_sign.c","DSA_SIG_free",90,97
4,1,37,4,3,"DSA_do_verify@64-67@lib/libcrypto/dsa/dsa_vrf.c","lib/libcrypto/dsa/dsa_vrf.c","DSA_do_verify",64,67
4,1,9,1,3,"DSO_METHOD_dlfcn@67-70@lib/libcrypto/dso/dso_dlfcn.c","lib/libcrypto/dso/dso_dlfcn.c","DSO_METHOD_dlfcn",67,70
4,1,12,1,3,"DSO_METHOD_dlfcn@104-107@lib/libcrypto/dso/dso_dlfcn.c","lib/libcrypto/dso/dso_dlfcn.c","DSO_METHOD_dlfcn",104,107
30,6,154,1,35,"dlfcn_load@114-149@lib/libcrypto/dso/dso_dlfcn.c","lib/libcrypto/dso/dso_dlfcn.c","dlfcn_load",114,149
18,4,92,1,20,"dlfcn_unload@152-172@lib/libcrypto/dso/dso_dlfcn.c","lib/libcrypto/dso/dso_dlfcn.c","dlfcn_unload",152,172
24,6,148,2,24,"dlfcn_bind_var@175-199@lib/libcrypto/dso/dso_dlfcn.c","lib/libcrypto/dso/dso_dlfcn.c","dlfcn_bind_var",175,199
28,6,161,2,28,"dlfcn_bind_func@202-230@lib/libcrypto/dso/dso_dlfcn.c","lib/libcrypto/dso/dso_dlfcn.c","dlfcn_bind_func",202,230
40,13,237,3,50,"dlfcn_merger@233-283@lib/libcrypto/dso/dso_dlfcn.c","lib/libcrypto/dso/dso_dlfcn.c","dlfcn_merger",233,283
18,5,110,2,21,"dlfcn_name_converter@289-310@lib/libcrypto/dso/dso_dlfcn.c","lib/libcrypto/dso/dso_dlfcn.c","dlfcn_name_converter",289,310
24,5,145,3,26,"dlfcn_pathbyaddr@313-339@lib/libcrypto/dso/dso_dlfcn.c","lib/libcrypto/dso/dso_dlfcn.c","dlfcn_pathbyaddr",313,339
9,2,48,1,10,"dlfcn_globallookup@342-352@lib/libcrypto/dso/dso_dlfcn.c","lib/libcrypto/dso/dso_dlfcn.c","dlfcn_globallookup",342,352
7,2,36,1,8,"ERR_load_DSO_strings@103-111@lib/libcrypto/dso/dso_err.c","lib/libcrypto/dso/dso_err.c","ERR_load_DSO_strings",103,111
4,1,14,1,3,"DSO_new@69-72@lib/libcrypto/dso/dso_lib.c","lib/libcrypto/dso/dso_lib.c","DSO_new",69,72
4,1,12,1,3,"DSO_set_default_method@75-78@lib/libcrypto/dso/dso_lib.c","lib/libcrypto/dso/dso_lib.c","DSO_set_default_method",75,78
4,1,11,1,3,"DSO_get_default_method@81-84@lib/libcrypto/dso/dso_lib.c","lib/libcrypto/dso/dso_lib.c","DSO_get_default_method",81,84
4,1,15,1,3,"DSO_get_method@87-90@lib/libcrypto/dso/dso_lib.c","lib/libcrypto/dso/dso_lib.c","DSO_get_method",87,90
7,1,33,2,7,"DSO_set_method@93-100@lib/libcrypto/dso/dso_lib.c","lib/libcrypto/dso/dso_lib.c","DSO_set_method",93,100
27,7,150,1,31,"DSO_new_method@103-134@lib/libcrypto/dso/dso_lib.c","lib/libcrypto/dso/dso_lib.c","DSO_new_method",103,134
24,7,154,1,28,"DSO_free@137-165@lib/libcrypto/dso/dso_lib.c","lib/libcrypto/dso/dso_lib.c","DSO_free",137,165
4,2,23,1,3,"DSO_flags@168-171@lib/libcrypto/dso/dso_lib.c","lib/libcrypto/dso/dso_lib.c","DSO_flags",168,171
9,2,43,1,9,"DSO_up_ref@175-184@lib/libcrypto/dso/dso_lib.c","lib/libcrypto/dso/dso_lib.c","DSO_up_ref",175,184
45,11,223,4,51,"DSO_load@187-238@lib/libcrypto/dso/dso_lib.c","lib/libcrypto/dso/dso_lib.c","DSO_load",187,238
17,5,103,2,18,"DSO_bind_var@241-259@lib/libcrypto/dso/dso_lib.c","lib/libcrypto/dso/dso_lib.c","DSO_bind_var",241,259
17,5,102,2,18,"DSO_bind_func@262-280@lib/libcrypto/dso/dso_lib.c","lib/libcrypto/dso/dso_lib.c","DSO_bind_func",262,280
24,7,140,4,26,"DSO_ctrl@291-317@lib/libcrypto/dso/dso_lib.c","lib/libcrypto/dso/dso_lib.c","DSO_ctrl",291,317
12,3,55,3,11,"DSO_set_name_converter@320-331@lib/libcrypto/dso/dso_lib.c","lib/libcrypto/dso/dso_lib.c","DSO_set_name_converter",320,331
8,2,33,1,7,"DSO_get_filename@334-341@lib/libcrypto/dso/dso_lib.c","lib/libcrypto/dso/dso_lib.c","DSO_get_filename",334,341
20,5,104,2,21,"DSO_set_filename@344-365@lib/libcrypto/dso/dso_lib.c","lib/libcrypto/dso/dso_lib.c","DSO_set_filename",344,365
16,6,112,3,16,"DSO_merge@368-384@lib/libcrypto/dso/dso_lib.c","lib/libcrypto/dso/dso_lib.c","DSO_merge",368,384
28,9,162,2,28,"DSO_convert_filename@387-415@lib/libcrypto/dso/dso_lib.c","lib/libcrypto/dso/dso_lib.c","DSO_convert_filename",387,415
8,2,33,1,7,"DSO_get_loaded_filename@418-425@lib/libcrypto/dso/dso_lib.c","lib/libcrypto/dso/dso_lib.c","DSO_get_loaded_filename",418,425
11,3,67,3,10,"DSO_pathbyaddr@428-438@lib/libcrypto/dso/dso_lib.c","lib/libcrypto/dso/dso_lib.c","DSO_pathbyaddr",428,438
11,3,56,1,10,"DSO_global_lookup@441-451@lib/libcrypto/dso/dso_lib.c","lib/libcrypto/dso/dso_lib.c","DSO_global_lookup",441,451
4,1,12,1,3,"DSO_METHOD_null@71-74@lib/libcrypto/dso/dso_null.c","lib/libcrypto/dso/dso_null.c","DSO_METHOD_null",71,74
6,3,27,1,9,"DSO_METHOD_openssl@66-75@lib/libcrypto/dso/dso_openssl.c","lib/libcrypto/dso/dso_openssl.c","DSO_METHOD_openssl",66,75
26,9,213,4,30,"gf2m_Mdouble@87-117@lib/libcrypto/ec/ec2_mult.c","lib/libcrypto/ec/ec2_mult.c","gf2m_Mdouble",87,117
31,11,255,7,35,"gf2m_Madd@126-161@lib/libcrypto/ec/ec2_mult.c","lib/libcrypto/ec/ec2_mult.c","gf2m_Madd",126,161
67,27,558,8,76,"gf2m_Mxy@173-249@lib/libcrypto/ec/ec2_mult.c","lib/libcrypto/ec/ec2_mult.c","gf2m_Mxy",173,249
84,28,642,5,100,"ec_GF2m_montgomery_point_multiply@262-362@lib/libcrypto/ec/ec2_mult.c","lib/libcrypto/ec/ec2_mult.c","ec_GF2m_montgomery_point_multiply",262,362
51,22,393,7,62,"ec_GF2m_simple_mul@370-432@lib/libcrypto/ec/ec2_mult.c","lib/libcrypto/ec/ec2_mult.c","ec_GF2m_simple_mul",370,432
4,1,20,2,3,"ec_GF2m_precompute_mult@439-442@lib/libcrypto/ec/ec2_mult.c","lib/libcrypto/ec/ec2_mult.c","ec_GF2m_precompute_mult",439,442
4,1,15,1,3,"ec_GF2m_have_precompute_mult@445-448@lib/libcrypto/ec/ec2_mult.c","lib/libcrypto/ec/ec2_mult.c","ec_GF2m_have_precompute_mult",445,448
62,23,451,5,70,"ec_GF2m_simple_set_compressed_coordinates@94-164@lib/libcrypto/ec/ec2_oct.c","lib/libcrypto/ec/ec2_oct.c","ec_GF2m_simple_set_compressed_coordinates",94,164
100,30,556,6,108,"ec_GF2m_simple_point2oct@172-280@lib/libcrypto/ec/ec2_oct.c","lib/libcrypto/ec/ec2_oct.c","ec_GF2m_simple_point2oct",172,280
89,29,535,5,94,"ec_GF2m_simple_oct2point@287-381@lib/libcrypto/ec/ec2_oct.c","lib/libcrypto/ec/ec2_oct.c","ec_GF2m_simple_oct2point",287,381
40,1,173,1,46,"EC_GF2m_simple_method@79-125@lib/libcrypto/ec/ec2_smpl.c","lib/libcrypto/ec/ec2_smpl.c","EC_GF2m_simple_method",79,125
7,1,35,1,6,"ec_GF2m_simple_group_init@132-138@lib/libcrypto/ec/ec2_smpl.c","lib/libcrypto/ec/ec2_smpl.c","ec_GF2m_simple_group_init",132,138
6,1,32,1,5,"ec_GF2m_simple_group_finish@145-150@lib/libcrypto/ec/ec2_smpl.c","lib/libcrypto/ec/ec2_smpl.c","ec_GF2m_simple_group_finish",145,150
12,1,87,1,11,"ec_GF2m_simple_group_clear_finish@157-168@lib/libcrypto/ec/ec2_smpl.c","lib/libcrypto/ec/ec2_smpl.c","ec_GF2m_simple_group_clear_finish",157,168
25,8,290,2,25,"ec_GF2m_simple_group_copy@175-200@lib/libcrypto/ec/ec2_smpl.c","lib/libcrypto/ec/ec2_smpl.c","ec_GF2m_simple_group_copy",175,200
27,10,271,5,32,"ec_GF2m_simple_group_set_curve@205-237@lib/libcrypto/ec/ec2_smpl.c","lib/libcrypto/ec/ec2_smpl.c","ec_GF2m_simple_group_set_curve",205,237
20,7,111,5,21,"ec_GF2m_simple_group_get_curve@244-265@lib/libcrypto/ec/ec2_smpl.c","lib/libcrypto/ec/ec2_smpl.c","ec_GF2m_simple_group_get_curve",244,265
4,1,20,1,3,"ec_GF2m_simple_group_get_degree@270-273@lib/libcrypto/ec/ec2_smpl.c","lib/libcrypto/ec/ec2_smpl.c","ec_GF2m_simple_group_get_degree",270,273
26,7,136,2,34,"ec_GF2m_simple_group_check_discriminant@280-314@lib/libcrypto/ec/ec2_smpl.c","lib/libcrypto/ec/ec2_smpl.c","ec_GF2m_simple_group_check_discriminant",280,314
7,1,35,1,6,"ec_GF2m_simple_point_init@319-325@lib/libcrypto/ec/ec2_smpl.c","lib/libcrypto/ec/ec2_smpl.c","ec_GF2m_simple_point_init",319,325
6,1,32,1,5,"ec_GF2m_simple_point_finish@330-335@lib/libcrypto/ec/ec2_smpl.c","lib/libcrypto/ec/ec2_smpl.c","ec_GF2m_simple_point_finish",330,335
7,1,38,1,6,"ec_GF2m_simple_point_clear_finish@340-346@lib/libcrypto/ec/ec2_smpl.c","lib/libcrypto/ec/ec2_smpl.c","ec_GF2m_simple_point_clear_finish",340,346
11,4,81,2,11,"ec_GF2m_simple_point_copy@351-362@lib/libcrypto/ec/ec2_smpl.c","lib/libcrypto/ec/ec2_smpl.c","ec_GF2m_simple_point_copy",351,362
6,1,30,2,5,"ec_GF2m_simple_point_set_to_infinity@369-374@lib/libcrypto/ec/ec2_smpl.c","lib/libcrypto/ec/ec2_smpl.c","ec_GF2m_simple_point_set_to_infinity",369,374
22,6,147,5,22,"ec_GF2m_simple_point_set_affine_coordinates@381-403@lib/libcrypto/ec/ec2_smpl.c","lib/libcrypto/ec/ec2_smpl.c","ec_GF2m_simple_point_set_affine_coordinates",381,403
26,7,147,5,27,"ec_GF2m_simple_point_get_affine_coordinates@410-437@lib/libcrypto/ec/ec2_smpl.c","lib/libcrypto/ec/ec2_smpl.c","ec_GF2m_simple_point_get_affine_coordinates",410,437
105,44,773,5,113,"ec_GF2m_simple_add@443-556@lib/libcrypto/ec/ec2_smpl.c","lib/libcrypto/ec/ec2_smpl.c","ec_GF2m_simple_add",443,556
5,1,36,4,4,"ec_GF2m_simple_dbl@563-567@lib/libcrypto/ec/ec2_smpl.c","lib/libcrypto/ec/ec2_smpl.c","ec_GF2m_simple_dbl",563,567
8,4,73,3,9,"ec_GF2m_simple_invert@570-579@lib/libcrypto/ec/ec2_smpl.c","lib/libcrypto/ec/ec2_smpl.c","ec_GF2m_simple_invert",570,579
4,1,23,2,3,"ec_GF2m_simple_is_at_infinity@584-587@lib/libcrypto/ec/ec2_smpl.c","lib/libcrypto/ec/ec2_smpl.c","ec_GF2m_simple_is_at_infinity",584,587
44,15,349,3,54,"ec_GF2m_simple_is_on_curve@595-649@lib/libcrypto/ec/ec2_smpl.c","lib/libcrypto/ec/ec2_smpl.c","ec_GF2m_simple_is_on_curve",595,649
39,19,320,4,42,"ec_GF2m_simple_cmp@659-701@lib/libcrypto/ec/ec2_smpl.c","lib/libcrypto/ec/ec2_smpl.c","ec_GF2m_simple_cmp",659,701
32,12,203,3,36,"ec_GF2m_simple_make_affine@706-742@lib/libcrypto/ec/ec2_smpl.c","lib/libcrypto/ec/ec2_smpl.c","ec_GF2m_simple_make_affine",706,742
10,3,65,4,11,"ec_GF2m_simple_points_make_affine@747-758@lib/libcrypto/ec/ec2_smpl.c","lib/libcrypto/ec/ec2_smpl.c","ec_GF2m_simple_points_make_affine",747,758
5,1,43,5,4,"ec_GF2m_simple_field_mul@763-767@lib/libcrypto/ec/ec2_smpl.c","lib/libcrypto/ec/ec2_smpl.c","ec_GF2m_simple_field_mul",763,767
5,1,36,4,4,"ec_GF2m_simple_field_sqr@772-776@lib/libcrypto/ec/ec2_smpl.c","lib/libcrypto/ec/ec2_smpl.c","ec_GF2m_simple_field_sqr",772,776
5,1,44,5,4,"ec_GF2m_simple_field_div@781-785@lib/libcrypto/ec/ec2_smpl.c","lib/libcrypto/ec/ec2_smpl.c","ec_GF2m_simple_field_div",781,785
28,6,155,3,29,"eckey_param2type@72-101@lib/libcrypto/ec/ec_ameth.c","lib/libcrypto/ec/ec_ameth.c","eckey_param2type",72,101
32,7,175,2,32,"eckey_pub_encode@104-136@lib/libcrypto/ec/ec_ameth.c","lib/libcrypto/ec/ec_ameth.c","eckey_pub_encode",104,136
37,8,195,2,45,"eckey_type2param@139-184@lib/libcrypto/ec/ec_ameth.c","lib/libcrypto/ec/ec_ameth.c","eckey_type2param",139,184
26,5,146,2,30,"eckey_pub_decode@187-217@lib/libcrypto/ec/ec_ameth.c","lib/libcrypto/ec/ec_ameth.c","eckey_pub_decode",187,217
12,3,92,2,12,"eckey_pub_cmp@220-232@lib/libcrypto/ec/ec_ameth.c","lib/libcrypto/ec/ec_ameth.c","eckey_pub_cmp",220,232
54,10,300,2,64,"eckey_priv_decode@235-299@lib/libcrypto/ec/ec_ameth.c","lib/libcrypto/ec/ec_ameth.c","eckey_priv_decode",235,299
40,6,225,2,50,"eckey_priv_encode@302-352@lib/libcrypto/ec/ec_ameth.c","lib/libcrypto/ec/ec_ameth.c","eckey_priv_encode",302,352
4,1,19,1,3,"int_ec_size@355-358@lib/libcrypto/ec/ec_ameth.c","lib/libcrypto/ec/ec_ameth.c","int_ec_size",355,358
19,3,91,1,19,"ec_bits@361-380@lib/libcrypto/ec/ec_ameth.c","lib/libcrypto/ec/ec_ameth.c","ec_bits",361,380
6,2,28,1,5,"ec_missing_parameters@383-388@lib/libcrypto/ec/ec_ameth.c","lib/libcrypto/ec/ec_ameth.c","ec_missing_parameters",383,388
4,1,32,2,3,"ec_copy_parameters@391-394@lib/libcrypto/ec/ec_ameth.c","lib/libcrypto/ec/ec_ameth.c","ec_copy_parameters",391,394
8,2,58,2,7,"ec_cmp_parameters@397-404@lib/libcrypto/ec/ec_ameth.c","lib/libcrypto/ec/ec_ameth.c","ec_cmp_parameters",397,404
4,1,17,1,3,"int_ec_free@407-410@lib/libcrypto/ec/ec_ameth.c","lib/libcrypto/ec/ec_ameth.c","int_ec_free",407,410
76,23,462,4,79,"do_EC_KEY_print@413-492@lib/libcrypto/ec/ec_ameth.c","lib/libcrypto/ec/ec_ameth.c","do_EC_KEY_print",413,492
11,2,57,3,10,"eckey_param_decode@495-505@lib/libcrypto/ec/ec_ameth.c","lib/libcrypto/ec/ec_ameth.c","eckey_param_decode",495,505
4,1,26,2,3,"eckey_param_encode@508-511@lib/libcrypto/ec/ec_ameth.c","lib/libcrypto/ec/ec_ameth.c","eckey_param_encode",508,511
5,1,36,4,4,"eckey_param_print@514-518@lib/libcrypto/ec/ec_ameth.c","lib/libcrypto/ec/ec_ameth.c","eckey_param_print",514,518
5,1,36,4,4,"eckey_pub_print@521-525@lib/libcrypto/ec/ec_ameth.c","lib/libcrypto/ec/ec_ameth.c","eckey_pub_print",521,525
5,1,36,4,4,"eckey_priv_print@529-533@lib/libcrypto/ec/ec_ameth.c","lib/libcrypto/ec/ec_ameth.c","eckey_priv_print",529,533
11,2,57,3,10,"old_ec_priv_decode@536-546@lib/libcrypto/ec/ec_ameth.c","lib/libcrypto/ec/ec_ameth.c","old_ec_priv_decode",536,546
4,1,26,2,3,"old_ec_priv_encode@549-552@lib/libcrypto/ec/ec_ameth.c","lib/libcrypto/ec/ec_ameth.c","old_ec_priv_encode",549,552
25,8,153,4,28,"ec_pkey_ctrl@555-583@lib/libcrypto/ec/ec_ameth.c","lib/libcrypto/ec/ec_ameth.c","ec_pkey_ctrl",555,583
15,5,66,1,19,"EC_GROUP_get_basis_type@69-88@lib/libcrypto/ec/ec_asn1.c","lib/libcrypto/ec/ec_asn1.c","EC_GROUP_get_basis_type",69,88
14,7,98,2,15,"EC_GROUP_get_trinomial_basis@91-106@lib/libcrypto/ec/ec_asn1.c","lib/libcrypto/ec/ec_asn1.c","EC_GROUP_get_trinomial_basis",91,106
19,11,158,4,20,"EC_GROUP_get_pentanomial_basis@108-128@lib/libcrypto/ec/ec_asn1.c","lib/libcrypto/ec/ec_asn1.c","EC_GROUP_get_pentanomial_basis",108,128
4,1,17,1,3,"X9_62_PENTANOMIAL_new@239-242@lib/libcrypto/ec/ec_asn1.c","lib/libcrypto/ec/ec_asn1.c","X9_62_PENTANOMIAL_new",239,242
4,1,20,1,3,"X9_62_PENTANOMIAL_free@245-248@lib/libcrypto/ec/ec_asn1.c","lib/libcrypto/ec/ec_asn1.c","X9_62_PENTANOMIAL_free",245,248
4,1,17,1,3,"X9_62_CHARACTERISTIC_TWO_new@341-344@lib/libcrypto/ec/ec_asn1.c","lib/libcrypto/ec/ec_asn1.c","X9_62_CHARACTERISTIC_TWO_new",341,344
4,1,20,1,3,"X9_62_CHARACTERISTIC_TWO_free@347-350@lib/libcrypto/ec/ec_asn1.c","lib/libcrypto/ec/ec_asn1.c","X9_62_CHARACTERISTIC_TWO_free",347,350
4,1,17,1,3,"ECPARAMETERS_new@513-516@lib/libcrypto/ec/ec_asn1.c","lib/libcrypto/ec/ec_asn1.c","ECPARAMETERS_new",513,516
4,1,20,1,3,"ECPARAMETERS_free@519-522@lib/libcrypto/ec/ec_asn1.c","lib/libcrypto/ec/ec_asn1.c","ECPARAMETERS_free",519,522
5,1,38,3,4,"d2i_ECPKPARAMETERS@564-568@lib/libcrypto/ec/ec_asn1.c","lib/libcrypto/ec/ec_asn1.c","d2i_ECPKPARAMETERS",564,568
4,1,29,2,3,"i2d_ECPKPARAMETERS@571-574@lib/libcrypto/ec/ec_asn1.c","lib/libcrypto/ec/ec_asn1.c","i2d_ECPKPARAMETERS",571,574
4,1,17,1,3,"ECPKPARAMETERS_new@577-580@lib/libcrypto/ec/ec_asn1.c","lib/libcrypto/ec/ec_asn1.c","ECPKPARAMETERS_new",577,580
4,1,20,1,3,"ECPKPARAMETERS_free@583-586@lib/libcrypto/ec/ec_asn1.c","lib/libcrypto/ec/ec_asn1.c","ECPKPARAMETERS_free",583,586
5,1,38,3,4,"d2i_EC_PRIVATEKEY@635-639@lib/libcrypto/ec/ec_asn1.c","lib/libcrypto/ec/ec_asn1.c","d2i_EC_PRIVATEKEY",635,639
4,1,29,2,3,"i2d_EC_PRIVATEKEY@642-645@lib/libcrypto/ec/ec_asn1.c","lib/libcrypto/ec/ec_asn1.c","i2d_EC_PRIVATEKEY",642,645
4,1,17,1,3,"EC_PRIVATEKEY_new@648-651@lib/libcrypto/ec/ec_asn1.c","lib/libcrypto/ec/ec_asn1.c","EC_PRIVATEKEY_new",648,651
4,1,20,1,3,"EC_PRIVATEKEY_free@654-657@lib/libcrypto/ec/ec_asn1.c","lib/libcrypto/ec/ec_asn1.c","EC_PRIVATEKEY_free",654,657
91,22,546,2,113,"ec_asn1_group2fieldid@682-795@lib/libcrypto/ec/ec_asn1.c","lib/libcrypto/ec/ec_asn1.c","ec_asn1_group2fieldid",682,795
89,23,535,2,103,"ec_asn1_group2curve@798-901@lib/libcrypto/ec/ec_asn1.c","lib/libcrypto/ec/ec_asn1.c","ec_asn1_group2curve",798,901
81,19,471,2,91,"ec_asn1_group2parameters@904-995@lib/libcrypto/ec/ec_asn1.c","lib/libcrypto/ec/ec_asn1.c","ec_asn1_group2parameters",904,995
35,12,210,2,43,"ec_asn1_group2pkparameters@998-1041@lib/libcrypto/ec/ec_asn1.c","lib/libcrypto/ec/ec_asn1.c","ec_asn1_group2pkparameters",998,1041
179,56,1144,1,208,"ec_asn1_parameters2group@1044-1252@lib/libcrypto/ec/ec_asn1.c","lib/libcrypto/ec/ec_asn1.c","ec_asn1_parameters2group",1044,1252
30,7,159,1,32,"ec_asn1_pkparameters2group@1255-1287@lib/libcrypto/ec/ec_asn1.c","lib/libcrypto/ec/ec_asn1.c","ec_asn1_pkparameters2group",1255,1287
20,4,110,3,22,"d2i_ECPKParameters@1292-1314@lib/libcrypto/ec/ec_asn1.c","lib/libcrypto/ec/ec_asn1.c","d2i_ECPKParameters",1292,1314
16,3,86,2,15,"i2d_ECPKParameters@1317-1332@lib/libcrypto/ec/ec_asn1.c","lib/libcrypto/ec/ec_asn1.c","i2d_ECPKParameters",1317,1332
75,19,429,3,85,"d2i_ECPrivateKey@1337-1422@lib/libcrypto/ec/ec_asn1.c","lib/libcrypto/ec/ec_asn1.c","d2i_ECPrivateKey",1337,1422
77,20,468,2,79,"i2d_ECPrivateKey@1425-1504@lib/libcrypto/ec/ec_asn1.c","lib/libcrypto/ec/ec_asn1.c","i2d_ECPrivateKey",1425,1504
8,2,39,2,7,"i2d_ECParameters@1507-1514@lib/libcrypto/ec/ec_asn1.c","lib/libcrypto/ec/ec_asn1.c","i2d_ECParameters",1507,1514
24,10,138,3,26,"d2i_ECParameters@1517-1543@lib/libcrypto/ec/ec_asn1.c","lib/libcrypto/ec/ec_asn1.c","d2i_ECParameters",1517,1543
21,6,149,3,26,"o2i_ECPublicKey@1546-1572@lib/libcrypto/ec/ec_asn1.c","lib/libcrypto/ec/ec_asn1.c","o2i_ECPublicKey",1546,1572
32,9,177,2,35,"i2o_ECPublicKey@1575-1610@lib/libcrypto/ec/ec_asn1.c","lib/libcrypto/ec/ec_asn1.c","i2o_ECPublicKey",1575,1610
50,13,270,2,55,"EC_GROUP_check@60-115@lib/libcrypto/ec/ec_check.c","lib/libcrypto/ec/ec_check.c","EC_GROUP_check",60,115
89,21,603,1,94,"ec_group_new_from_data@3158-3252@lib/libcrypto/ec/ec_curve.c","lib/libcrypto/ec/ec_curve.c","ec_group_new_from_data",3158,3252
18,5,89,1,20,"EC_GROUP_new_by_curve_name@3255-3275@lib/libcrypto/ec/ec_curve.c","lib/libcrypto/ec/ec_curve.c","EC_GROUP_new_by_curve_name",3255,3275
12,5,85,2,15,"EC_get_builtin_curves@3278-3293@lib/libcrypto/ec/ec_curve.c","lib/libcrypto/ec/ec_curve.c","EC_get_builtin_curves",3278,3293
9,3,59,1,9,"EC_curve_nid2nist@3323-3332@lib/libcrypto/ec/ec_curve.c","lib/libcrypto/ec/ec_curve.c","EC_curve_nid2nist",3323,3332
9,3,65,1,9,"EC_curve_nist2nid@3335-3344@lib/libcrypto/ec/ec_curve.c","lib/libcrypto/ec/ec_curve.c","EC_curve_nist2nid",3335,3344
32,9,190,4,67,"EC_GROUP_new_curve_GFp@78-145@lib/libcrypto/ec/ec_cvt.c","lib/libcrypto/ec/ec_cvt.c","EC_GROUP_new_curve_GFp",78,145
15,3,83,4,17,"EC_GROUP_new_curve_GF2m@149-166@lib/libcrypto/ec/ec_cvt.c","lib/libcrypto/ec/ec_cvt.c","EC_GROUP_new_curve_GF2m",149,166
7,2,36,1,9,"ERR_load_EC_strings@134-143@lib/libcrypto/ec/ec_err.c","lib/libcrypto/ec/ec_err.c","ERR_load_EC_strings",134,143
19,2,97,1,19,"EC_KEY_new@72-91@lib/libcrypto/ec/ec_key.c","lib/libcrypto/ec/ec_key.c","EC_KEY_new",72,91
12,3,54,1,11,"EC_KEY_new_by_curve_name@94-105@lib/libcrypto/ec/ec_key.c","lib/libcrypto/ec/ec_key.c","EC_KEY_new_by_curve_name",94,105
14,3,81,1,18,"EC_KEY_free@108-126@lib/libcrypto/ec/ec_key.c","lib/libcrypto/ec/ec_key.c","EC_KEY_free",108,126
48,17,326,2,58,"EC_KEY_copy@129-187@lib/libcrypto/ec/ec_key.c","lib/libcrypto/ec/ec_key.c","EC_KEY_copy",129,187
11,3,50,1,10,"EC_KEY_dup@190-200@lib/libcrypto/ec/ec_key.c","lib/libcrypto/ec/ec_key.c","EC_KEY_dup",190,200
5,2,36,1,4,"EC_KEY_up_ref@203-207@lib/libcrypto/ec/ec_key.c","lib/libcrypto/ec/ec_key.c","EC_KEY_up_ref",203,207
46,17,282,1,54,"EC_KEY_generate_key@210-264@lib/libcrypto/ec/ec_key.c","lib/libcrypto/ec/ec_key.c","EC_KEY_generate_key",210,264
57,15,337,1,64,"EC_KEY_check_key@267-331@lib/libcrypto/ec/ec_key.c","lib/libcrypto/ec/ec_key.c","EC_KEY_check_key",267,331
53,19,320,3,69,"EC_KEY_set_public_key_affine_coordinates@334-403@lib/libcrypto/ec/ec_key.c","lib/libcrypto/ec/ec_key.c","EC_KEY_set_public_key_affine_coordinates",334,403
4,1,14,1,3,"EC_KEY_get0_group@406-409@lib/libcrypto/ec/ec_key.c","lib/libcrypto/ec/ec_key.c","EC_KEY_get0_group",406,409
6,2,42,2,5,"EC_KEY_set_group@412-417@lib/libcrypto/ec/ec_key.c","lib/libcrypto/ec/ec_key.c","EC_KEY_set_group",412,417
4,1,14,1,3,"EC_KEY_get0_private_key@420-423@lib/libcrypto/ec/ec_key.c","lib/libcrypto/ec/ec_key.c","EC_KEY_get0_private_key",420,423
6,2,42,2,5,"EC_KEY_set_private_key@426-431@lib/libcrypto/ec/ec_key.c","lib/libcrypto/ec/ec_key.c","EC_KEY_set_private_key",426,431
4,1,14,1,3,"EC_KEY_get0_public_key@434-437@lib/libcrypto/ec/ec_key.c","lib/libcrypto/ec/ec_key.c","EC_KEY_get0_public_key",434,437
6,2,46,2,5,"EC_KEY_set_public_key@440-445@lib/libcrypto/ec/ec_key.c","lib/libcrypto/ec/ec_key.c","EC_KEY_set_public_key",440,445
4,1,14,1,3,"EC_KEY_get_enc_flags@448-451@lib/libcrypto/ec/ec_key.c","lib/libcrypto/ec/ec_key.c","EC_KEY_get_enc_flags",448,451
4,1,18,2,3,"EC_KEY_set_enc_flags@454-457@lib/libcrypto/ec/ec_key.c","lib/libcrypto/ec/ec_key.c","EC_KEY_set_enc_flags",454,457
4,1,14,1,3,"EC_KEY_get_conv_form@460-463@lib/libcrypto/ec/ec_key.c","lib/libcrypto/ec/ec_key.c","EC_KEY_get_conv_form",460,463
6,2,34,2,5,"EC_KEY_set_conv_form@466-471@lib/libcrypto/ec/ec_key.c","lib/libcrypto/ec/ec_key.c","EC_KEY_set_conv_form",466,471
11,1,71,4,12,"EC_KEY_get_key_method_data@474-486@lib/libcrypto/ec/ec_key.c","lib/libcrypto/ec/ec_key.c","EC_KEY_get_key_method_data",474,486
13,2,97,5,14,"EC_KEY_insert_key_method_data@489-503@lib/libcrypto/ec/ec_key.c","lib/libcrypto/ec/ec_key.c","EC_KEY_insert_key_method_data",489,503
5,2,28,2,4,"EC_KEY_set_asn1_flag@506-510@lib/libcrypto/ec/ec_key.c","lib/libcrypto/ec/ec_key.c","EC_KEY_set_asn1_flag",506,510
6,2,33,2,5,"EC_KEY_precompute_mult@513-518@lib/libcrypto/ec/ec_key.c","lib/libcrypto/ec/ec_key.c","EC_KEY_precompute_mult",513,518
4,1,14,1,3,"EC_KEY_get_flags@521-524@lib/libcrypto/ec/ec_key.c","lib/libcrypto/ec/ec_key.c","EC_KEY_get_flags",521,524
4,1,17,2,3,"EC_KEY_set_flags@527-530@lib/libcrypto/ec/ec_key.c","lib/libcrypto/ec/ec_key.c","EC_KEY_set_flags",527,530
4,1,17,2,3,"EC_KEY_clear_flags@533-536@lib/libcrypto/ec/ec_key.c","lib/libcrypto/ec/ec_key.c","EC_KEY_clear_flags",533,536
32,5,159,1,37,"EC_GROUP_new@76-113@lib/libcrypto/ec/ec_lib.c","lib/libcrypto/ec/ec_lib.c","EC_GROUP_new",76,113
13,3,77,1,17,"EC_GROUP_free@117-134@lib/libcrypto/ec/ec_lib.c","lib/libcrypto/ec/ec_lib.c","EC_GROUP_free",117,134
15,4,105,1,18,"EC_GROUP_clear_free@138-156@lib/libcrypto/ec/ec_lib.c","lib/libcrypto/ec/ec_lib.c","EC_GROUP_clear_free",138,156
55,15,373,2,65,"EC_GROUP_copy@160-225@lib/libcrypto/ec/ec_lib.c","lib/libcrypto/ec/ec_lib.c","EC_GROUP_copy",160,225
10,3,62,1,10,"EC_GROUP_dup@229-239@lib/libcrypto/ec/ec_lib.c","lib/libcrypto/ec/ec_lib.c","EC_GROUP_dup",229,239
4,1,14,1,3,"EC_GROUP_method_of@243-246@lib/libcrypto/ec/ec_lib.c","lib/libcrypto/ec/ec_lib.c","EC_GROUP_method_of",243,246
4,1,14,1,3,"EC_METHOD_get_field_type@250-253@lib/libcrypto/ec/ec_lib.c","lib/libcrypto/ec/ec_lib.c","EC_METHOD_get_field_type",250,253
26,9,153,4,28,"EC_GROUP_set_generator@257-285@lib/libcrypto/ec/ec_lib.c","lib/libcrypto/ec/ec_lib.c","EC_GROUP_set_generator",257,285
4,1,14,1,3,"EC_GROUP_get0_generator@289-292@lib/libcrypto/ec/ec_lib.c","lib/libcrypto/ec/ec_lib.c","EC_GROUP_get0_generator",289,292
6,2,40,3,6,"EC_GROUP_get_order@296-302@lib/libcrypto/ec/ec_lib.c","lib/libcrypto/ec/ec_lib.c","EC_GROUP_get_order",296,302
6,2,43,3,6,"EC_GROUP_get_cofactor@306-312@lib/libcrypto/ec/ec_lib.c","lib/libcrypto/ec/ec_lib.c","EC_GROUP_get_cofactor",306,312
4,1,17,2,3,"EC_GROUP_set_curve_name@316-319@lib/libcrypto/ec/ec_lib.c","lib/libcrypto/ec/ec_lib.c","EC_GROUP_set_curve_name",316,319
4,1,14,1,3,"EC_GROUP_get_curve_name@323-326@lib/libcrypto/ec/ec_lib.c","lib/libcrypto/ec/ec_lib.c","EC_GROUP_get_curve_name",323,326
4,1,17,2,3,"EC_GROUP_set_asn1_flag@330-333@lib/libcrypto/ec/ec_lib.c","lib/libcrypto/ec/ec_lib.c","EC_GROUP_set_asn1_flag",330,333
4,1,14,1,3,"EC_GROUP_get_asn1_flag@337-340@lib/libcrypto/ec/ec_lib.c","lib/libcrypto/ec/ec_lib.c","EC_GROUP_get_asn1_flag",337,340
5,1,17,2,4,"EC_GROUP_set_point_conversion_form@344-348@lib/libcrypto/ec/ec_lib.c","lib/libcrypto/ec/ec_lib.c","EC_GROUP_set_point_conversion_form",344,348
4,1,14,1,3,"EC_GROUP_get_point_conversion_form@352-355@lib/libcrypto/ec/ec_lib.c","lib/libcrypto/ec/ec_lib.c","EC_GROUP_get_point_conversion_form",352,355
15,5,93,3,16,"EC_GROUP_set_seed@359-375@lib/libcrypto/ec/ec_lib.c","lib/libcrypto/ec/ec_lib.c","EC_GROUP_set_seed",359,375
4,1,14,1,3,"EC_GROUP_get0_seed@379-382@lib/libcrypto/ec/ec_lib.c","lib/libcrypto/ec/ec_lib.c","EC_GROUP_get0_seed",379,382
4,1,14,1,3,"EC_GROUP_get_seed_len@386-389@lib/libcrypto/ec/ec_lib.c","lib/libcrypto/ec/ec_lib.c","EC_GROUP_get_seed_len",386,389
9,2,65,5,8,"EC_GROUP_set_curve_GFp@393-401@lib/libcrypto/ec/ec_lib.c","lib/libcrypto/ec/ec_lib.c","EC_GROUP_set_curve_GFp",393,401
9,2,63,5,8,"EC_GROUP_get_curve_GFp@405-413@lib/libcrypto/ec/ec_lib.c","lib/libcrypto/ec/ec_lib.c","EC_GROUP_get_curve_GFp",405,413
9,2,65,5,8,"EC_GROUP_set_curve_GF2m@417-425@lib/libcrypto/ec/ec_lib.c","lib/libcrypto/ec/ec_lib.c","EC_GROUP_set_curve_GF2m",417,425
9,2,63,5,8,"EC_GROUP_get_curve_GF2m@429-437@lib/libcrypto/ec/ec_lib.c","lib/libcrypto/ec/ec_lib.c","EC_GROUP_get_curve_GF2m",429,437
8,2,39,1,7,"EC_GROUP_get_degree@441-448@lib/libcrypto/ec/ec_lib.c","lib/libcrypto/ec/ec_lib.c","EC_GROUP_get_degree",441,448
8,2,45,2,7,"EC_GROUP_check_discriminant@452-459@lib/libcrypto/ec/ec_lib.c","lib/libcrypto/ec/ec_lib.c","EC_GROUP_check_discriminant",452,459
55,30,422,3,71,"EC_GROUP_cmp@463-534@lib/libcrypto/ec/ec_lib.c","lib/libcrypto/ec/ec_lib.c","EC_GROUP_cmp",463,534
28,8,171,5,35,"EC_EX_DATA_set_data@539-574@lib/libcrypto/ec/ec_lib.c","lib/libcrypto/ec/ec_lib.c","EC_EX_DATA_set_data",539,574
12,5,91,4,13,"EC_EX_DATA_get_data@578-591@lib/libcrypto/ec/ec_lib.c","lib/libcrypto/ec/ec_lib.c","EC_EX_DATA_get_data",578,591
20,6,146,4,23,"EC_EX_DATA_free_data@595-618@lib/libcrypto/ec/ec_lib.c","lib/libcrypto/ec/ec_lib.c","EC_EX_DATA_free_data",595,618
20,6,146,4,23,"EC_EX_DATA_clear_free_data@622-645@lib/libcrypto/ec/ec_lib.c","lib/libcrypto/ec/ec_lib.c","EC_EX_DATA_clear_free_data",622,645
14,3,62,1,17,"EC_EX_DATA_free_all_data@649-666@lib/libcrypto/ec/ec_lib.c","lib/libcrypto/ec/ec_lib.c","EC_EX_DATA_free_all_data",649,666
14,3,62,1,17,"EC_EX_DATA_clear_free_all_data@670-687@lib/libcrypto/ec/ec_lib.c","lib/libcrypto/ec/ec_lib.c","EC_EX_DATA_clear_free_all_data",670,687
23,5,107,1,24,"EC_POINT_new@693-717@lib/libcrypto/ec/ec_lib.c","lib/libcrypto/ec/ec_lib.c","EC_POINT_new",693,717
8,3,39,1,8,"EC_POINT_free@721-729@lib/libcrypto/ec/ec_lib.c","lib/libcrypto/ec/ec_lib.c","EC_POINT_free",721,729
10,4,63,1,10,"EC_POINT_clear_free@733-743@lib/libcrypto/ec/ec_lib.c","lib/libcrypto/ec/ec_lib.c","EC_POINT_clear_free",733,743
14,4,74,2,13,"EC_POINT_copy@747-760@lib/libcrypto/ec/ec_lib.c","lib/libcrypto/ec/ec_lib.c","EC_POINT_copy",747,760
16,4,76,2,17,"EC_POINT_dup@764-781@lib/libcrypto/ec/ec_lib.c","lib/libcrypto/ec/ec_lib.c","EC_POINT_dup",764,781
4,1,14,1,3,"EC_POINT_method_of@785-788@lib/libcrypto/ec/ec_lib.c","lib/libcrypto/ec/ec_lib.c","EC_POINT_method_of",785,788
12,3,65,2,11,"EC_POINT_set_to_infinity@792-803@lib/libcrypto/ec/ec_lib.c","lib/libcrypto/ec/ec_lib.c","EC_POINT_set_to_infinity",792,803
13,3,92,6,12,"EC_POINT_set_Jprojective_coordinates_GFp@807-819@lib/libcrypto/ec/ec_lib.c","lib/libcrypto/ec/ec_lib.c","EC_POINT_set_Jprojective_coordinates_GFp",807,819
13,3,90,6,12,"EC_POINT_get_Jprojective_coordinates_GFp@823-835@lib/libcrypto/ec/ec_lib.c","lib/libcrypto/ec/ec_lib.c","EC_POINT_get_Jprojective_coordinates_GFp",823,835
13,3,85,5,12,"EC_POINT_set_affine_coordinates_GFp@839-851@lib/libcrypto/ec/ec_lib.c","lib/libcrypto/ec/ec_lib.c","EC_POINT_set_affine_coordinates_GFp",839,851
13,3,85,5,12,"EC_POINT_set_affine_coordinates_GF2m@855-867@lib/libcrypto/ec/ec_lib.c","lib/libcrypto/ec/ec_lib.c","EC_POINT_set_affine_coordinates_GF2m",855,867
13,3,84,5,12,"EC_POINT_get_affine_coordinates_GFp@871-883@lib/libcrypto/ec/ec_lib.c","lib/libcrypto/ec/ec_lib.c","EC_POINT_get_affine_coordinates_GFp",871,883
13,3,84,5,12,"EC_POINT_get_affine_coordinates_GF2m@887-899@lib/libcrypto/ec/ec_lib.c","lib/libcrypto/ec/ec_lib.c","EC_POINT_get_affine_coordinates_GF2m",887,899
13,5,107,5,12,"EC_POINT_add@903-915@lib/libcrypto/ec/ec_lib.c","lib/libcrypto/ec/ec_lib.c","EC_POINT_add",903,915
12,4,90,4,11,"EC_POINT_dbl@919-930@lib/libcrypto/ec/ec_lib.c","lib/libcrypto/ec/ec_lib.c","EC_POINT_dbl",919,930
12,3,71,3,11,"EC_POINT_invert@934-945@lib/libcrypto/ec/ec_lib.c","lib/libcrypto/ec/ec_lib.c","EC_POINT_invert",934,945
12,3,66,2,11,"EC_POINT_is_at_infinity@949-960@lib/libcrypto/ec/ec_lib.c","lib/libcrypto/ec/ec_lib.c","EC_POINT_is_at_infinity",949,960
12,3,72,3,11,"EC_POINT_is_on_curve@964-975@lib/libcrypto/ec/ec_lib.c","lib/libcrypto/ec/ec_lib.c","EC_POINT_is_on_curve",964,975
13,4,93,4,12,"EC_POINT_cmp@979-991@lib/libcrypto/ec/ec_lib.c","lib/libcrypto/ec/ec_lib.c","EC_POINT_cmp",979,991
12,3,71,3,11,"EC_POINT_make_affine@995-1006@lib/libcrypto/ec/ec_lib.c","lib/libcrypto/ec/ec_lib.c","EC_POINT_make_affine",995,1006
16,4,99,4,16,"EC_POINTs_make_affine@1010-1026@lib/libcrypto/ec/ec_lib.c","lib/libcrypto/ec/ec_lib.c","EC_POINTs_make_affine",1010,1026
7,2,89,7,8,"EC_POINTs_mul@1036-1044@lib/libcrypto/ec/ec_lib.c","lib/libcrypto/ec/ec_lib.c","EC_POINTs_mul",1036,1044
11,2,88,6,14,"EC_POINT_mul@1047-1061@lib/libcrypto/ec/ec_lib.c","lib/libcrypto/ec/ec_lib.c","EC_POINT_mul",1047,1061
9,3,56,2,10,"EC_GROUP_precompute_mult@1064-1074@lib/libcrypto/ec/ec_lib.c","lib/libcrypto/ec/ec_lib.c","EC_GROUP_precompute_mult",1064,1074
9,3,49,1,11,"EC_GROUP_have_precompute_mult@1077-1088@lib/libcrypto/ec/ec_lib.c","lib/libcrypto/ec/ec_lib.c","EC_GROUP_have_precompute_mult",1077,1088
11,3,74,1,13,"ECParameters_dup@1091-1104@lib/libcrypto/ec/ec_lib.c","lib/libcrypto/ec/ec_lib.c","ECParameters_dup",1091,1104
19,3,93,1,20,"ec_pre_comp_new@101-121@lib/libcrypto/ec/ec_mult.c","lib/libcrypto/ec/ec_mult.c","ec_pre_comp_new",101,121
6,1,29,1,9,"ec_pre_comp_dup@124-133@lib/libcrypto/ec/ec_mult.c","lib/libcrypto/ec/ec_mult.c","ec_pre_comp_dup",124,133
17,5,93,1,20,"ec_pre_comp_free@136-156@lib/libcrypto/ec/ec_mult.c","lib/libcrypto/ec/ec_mult.c","ec_pre_comp_free",136,156
19,5,108,1,22,"ec_pre_comp_clear_free@159-181@lib/libcrypto/ec/ec_mult.c","lib/libcrypto/ec/ec_mult.c","ec_pre_comp_clear_free",159,181
84,25,454,3,117,"compute_wNAF@195-312@lib/libcrypto/ec/ec_mult.c","lib/libcrypto/ec/ec_mult.c","compute_wNAF",195,312
266,75,1769,7,367,"ec_wNAF_mul@335-702@lib/libcrypto/ec/ec_mult.c","lib/libcrypto/ec/ec_mult.c","ec_wNAF_mul",335,702
114,30,727,2,150,"ec_wNAF_precompute_mult@725-875@lib/libcrypto/ec/ec_mult.c","lib/libcrypto/ec/ec_mult.c","ec_wNAF_precompute_mult",725,875
7,2,33,1,6,"ec_wNAF_have_precompute_mult@879-885@lib/libcrypto/ec/ec_mult.c","lib/libcrypto/ec/ec_mult.c","ec_wNAF_have_precompute_mult",879,885
26,7,155,5,28,"EC_POINT_set_compressed_coordinates_GFp@74-102@lib/libcrypto/ec/ec_oct.c","lib/libcrypto/ec/ec_oct.c","EC_POINT_set_compressed_coordinates_GFp",74,102
22,6,145,5,21,"EC_POINT_set_compressed_coordinates_GF2m@106-127@lib/libcrypto/ec/ec_oct.c","lib/libcrypto/ec/ec_oct.c","EC_POINT_set_compressed_coordinates_GF2m",106,127
27,7,165,6,29,"EC_POINT_point2oct@131-160@lib/libcrypto/ec/ec_oct.c","lib/libcrypto/ec/ec_oct.c","EC_POINT_point2oct",131,160
26,7,156,5,28,"EC_POINT_oct2point@164-192@lib/libcrypto/ec/ec_oct.c","lib/libcrypto/ec/ec_oct.c","EC_POINT_oct2point",164,192
11,2,51,1,12,"pkey_ec_init@81-93@lib/libcrypto/ec/ec_pmeth.c","lib/libcrypto/ec/ec_pmeth.c","pkey_ec_init",81,93
15,4,82,2,14,"pkey_ec_copy@96-110@lib/libcrypto/ec/ec_pmeth.c","lib/libcrypto/ec/ec_pmeth.c","pkey_ec_copy",96,110
8,2,34,1,7,"pkey_ec_cleanup@113-120@lib/libcrypto/ec/ec_pmeth.c","lib/libcrypto/ec/ec_pmeth.c","pkey_ec_cleanup",113,120
24,5,155,5,27,"pkey_ec_sign@123-150@lib/libcrypto/ec/ec_pmeth.c","lib/libcrypto/ec/ec_pmeth.c","pkey_ec_sign",123,150
14,2,91,5,16,"pkey_ec_verify@153-169@lib/libcrypto/ec/ec_pmeth.c","lib/libcrypto/ec/ec_pmeth.c","pkey_ec_verify",153,169
23,5,150,3,29,"pkey_ec_derive@172-201@lib/libcrypto/ec/ec_pmeth.c","lib/libcrypto/ec/ec_pmeth.c","pkey_ec_derive",172,201
35,14,195,4,39,"pkey_ec_ctrl@204-243@lib/libcrypto/ec/ec_pmeth.c","lib/libcrypto/ec/ec_pmeth.c","pkey_ec_ctrl",204,243
18,5,94,3,17,"pkey_ec_ctrl_str@246-263@lib/libcrypto/ec/ec_pmeth.c","lib/libcrypto/ec/ec_pmeth.c","pkey_ec_ctrl_str",246,263
19,4,94,2,18,"pkey_ec_paramgen@266-284@lib/libcrypto/ec/ec_pmeth.c","lib/libcrypto/ec/ec_pmeth.c","pkey_ec_paramgen",266,284
15,4,82,2,15,"pkey_ec_keygen@287-302@lib/libcrypto/ec/ec_pmeth.c","lib/libcrypto/ec/ec_pmeth.c","pkey_ec_keygen",287,302
19,4,124,5,23,"EC_POINT_point2bn@60-83@lib/libcrypto/ec/ec_print.c","lib/libcrypto/ec/ec_print.c","EC_POINT_point2bn",60,83
31,8,169,4,33,"EC_POINT_bn2point@86-119@lib/libcrypto/ec/ec_print.c","lib/libcrypto/ec/ec_print.c","EC_POINT_bn2point",86,119
32,7,223,4,36,"EC_POINT_point2hex@125-161@lib/libcrypto/ec/ec_print.c","lib/libcrypto/ec/ec_print.c","EC_POINT_point2hex",125,161
11,2,69,4,14,"EC_POINT_hex2point@164-178@lib/libcrypto/ec/ec_print.c","lib/libcrypto/ec/ec_print.c","EC_POINT_hex2point",164,178
13,2,80,3,13,"ECPKParameters_print_fp@75-88@lib/libcrypto/ec/eck_prn.c","lib/libcrypto/ec/eck_prn.c","ECPKParameters_print_fp",75,88
13,2,80,3,13,"EC_KEY_print_fp@91-104@lib/libcrypto/ec/eck_prn.c","lib/libcrypto/ec/eck_prn.c","EC_KEY_print_fp",91,104
13,2,75,2,13,"ECParameters_print_fp@107-120@lib/libcrypto/ec/eck_prn.c","lib/libcrypto/ec/eck_prn.c","ECParameters_print_fp",107,120
11,3,70,3,10,"EC_KEY_print@123-133@lib/libcrypto/ec/eck_prn.c","lib/libcrypto/ec/eck_prn.c","EC_KEY_print",123,133
11,3,67,2,10,"ECParameters_print@136-146@lib/libcrypto/ec/eck_prn.c","lib/libcrypto/ec/eck_prn.c","ECParameters_print",136,146
160,60,1097,3,183,"ECPKParameters_print@153-336@lib/libcrypto/ec/eck_prn.c","lib/libcrypto/ec/eck_prn.c","ECPKParameters_print",153,336
30,12,223,5,32,"print_bin@339-371@lib/libcrypto/ec/eck_prn.c","lib/libcrypto/ec/eck_prn.c","print_bin",339,371
43,1,177,1,43,"EC_GFp_mont_method@70-113@lib/libcrypto/ec/ecp_mont.c","lib/libcrypto/ec/ecp_mont.c","EC_GFp_mont_method",70,113
8,1,33,1,8,"ec_GFp_mont_group_init@117-125@lib/libcrypto/ec/ecp_mont.c","lib/libcrypto/ec/ecp_mont.c","ec_GFp_mont_group_init",117,125
8,1,39,1,7,"ec_GFp_mont_group_finish@129-136@lib/libcrypto/ec/ecp_mont.c","lib/libcrypto/ec/ecp_mont.c","ec_GFp_mont_group_finish",129,136
8,1,39,1,7,"ec_GFp_mont_group_clear_finish@140-147@lib/libcrypto/ec/ecp_mont.c","lib/libcrypto/ec/ecp_mont.c","ec_GFp_mont_group_clear_finish",140,147
28,8,161,2,30,"ec_GFp_mont_group_copy@151-181@lib/libcrypto/ec/ecp_mont.c","lib/libcrypto/ec/ecp_mont.c","ec_GFp_mont_group_copy",151,181
45,8,260,5,48,"ec_GFp_mont_group_set_curve@185-233@lib/libcrypto/ec/ecp_mont.c","lib/libcrypto/ec/ecp_mont.c","ec_GFp_mont_group_set_curve",185,233
9,2,61,5,8,"ec_GFp_mont_field_mul@237-245@lib/libcrypto/ec/ecp_mont.c","lib/libcrypto/ec/ecp_mont.c","ec_GFp_mont_field_mul",237,245
9,2,56,4,8,"ec_GFp_mont_field_sqr@249-257@lib/libcrypto/ec/ecp_mont.c","lib/libcrypto/ec/ecp_mont.c","ec_GFp_mont_field_sqr",249,257
9,2,58,4,8,"ec_GFp_mont_field_encode@261-269@lib/libcrypto/ec/ecp_mont.c","lib/libcrypto/ec/ecp_mont.c","ec_GFp_mont_field_encode",261,269
9,2,54,4,8,"ec_GFp_mont_field_decode@273-281@lib/libcrypto/ec/ecp_mont.c","lib/libcrypto/ec/ecp_mont.c","ec_GFp_mont_field_decode",273,281
10,3,53,3,9,"ec_GFp_mont_field_set_to_one@285-294@lib/libcrypto/ec/ecp_mont.c","lib/libcrypto/ec/ecp_mont.c","ec_GFp_mont_field_set_to_one",285,294
40,1,162,1,40,"EC_GFp_nist_method@71-111@lib/libcrypto/ec/ecp_nist.c","lib/libcrypto/ec/ecp_nist.c","EC_GFp_nist_method",71,111
5,1,29,2,5,"ec_GFp_nist_group_copy@114-119@lib/libcrypto/ec/ecp_nist.c","lib/libcrypto/ec/ecp_nist.c","ec_GFp_nist_group_copy",114,119
32,9,226,5,36,"ec_GFp_nist_group_set_curve@122-158@lib/libcrypto/ec/ecp_nist.c","lib/libcrypto/ec/ecp_nist.c","ec_GFp_nist_group_set_curve",122,158
21,9,137,5,23,"ec_GFp_nist_field_mul@162-185@lib/libcrypto/ec/ecp_nist.c","lib/libcrypto/ec/ecp_nist.c","ec_GFp_nist_field_mul",162,185
21,8,127,4,23,"ec_GFp_nist_field_sqr@189-212@lib/libcrypto/ec/ecp_nist.c","lib/libcrypto/ec/ecp_nist.c","ec_GFp_nist_field_sqr",189,212
43,1,177,1,43,"EC_GFp_nistp224_method@234-277@lib/libcrypto/ec/ecp_nistp224.c","lib/libcrypto/ec/ecp_nistp224.c","EC_GFp_nistp224_method",234,277
7,1,102,2,6,"bin28_to_felem@281-287@lib/libcrypto/ec/ecp_nistp224.c","lib/libcrypto/ec/ecp_nistp224.c","bin28_to_felem",281,287
10,2,106,2,9,"felem_to_bin28@290-299@lib/libcrypto/ec/ecp_nistp224.c","lib/libcrypto/ec/ecp_nistp224.c","felem_to_bin28",290,299
6,2,46,3,5,"flip_endian@303-308@lib/libcrypto/ec/ecp_nistp224.c","lib/libcrypto/ec/ecp_nistp224.c","flip_endian",303,308
20,3,100,2,21,"BN_to_felem@312-333@lib/libcrypto/ec/ecp_nistp224.c","lib/libcrypto/ec/ecp_nistp224.c","BN_to_felem",312,333
7,1,45,2,6,"felem_to_BN@337-343@lib/libcrypto/ec/ecp_nistp224.c","lib/libcrypto/ec/ecp_nistp224.c","felem_to_BN",337,343
7,1,35,1,6,"felem_one@356-362@lib/libcrypto/ec/ecp_nistp224.c","lib/libcrypto/ec/ecp_nistp224.c","felem_one",356,362
7,1,51,2,6,"felem_assign@365-371@lib/libcrypto/ec/ecp_nistp224.c","lib/libcrypto/ec/ecp_nistp224.c","felem_assign",365,371
7,1,51,2,6,"felem_sum@375-381@lib/libcrypto/ec/ecp_nistp224.c","lib/libcrypto/ec/ecp_nistp224.c","felem_sum",375,381
11,1,158,2,12,"felem_neg@386-398@lib/libcrypto/ec/ecp_nistp224.c","lib/libcrypto/ec/ecp_nistp224.c","felem_neg",386,398
15,1,178,2,17,"felem_diff@403-420@lib/libcrypto/ec/ecp_nistp224.c","lib/libcrypto/ec/ecp_nistp224.c","felem_diff",403,420
22,1,215,2,24,"widefelem_diff@425-449@lib/libcrypto/ec/ecp_nistp224.c","lib/libcrypto/ec/ecp_nistp224.c","widefelem_diff",425,449
17,1,178,2,19,"felem_diff_128_64@454-473@lib/libcrypto/ec/ecp_nistp224.c","lib/libcrypto/ec/ecp_nistp224.c","felem_diff_128_64",454,473
7,1,39,2,6,"felem_scalar@478-484@lib/libcrypto/ec/ecp_nistp224.c","lib/libcrypto/ec/ecp_nistp224.c","felem_scalar",478,484
10,1,60,2,9,"widefelem_scalar@489-498@lib/libcrypto/ec/ecp_nistp224.c","lib/libcrypto/ec/ecp_nistp224.c","widefelem_scalar",489,498
15,1,212,2,14,"felem_square@502-516@lib/libcrypto/ec/ecp_nistp224.c","lib/libcrypto/ec/ecp_nistp224.c","felem_square",502,516
13,1,290,3,12,"felem_mul@520-532@lib/libcrypto/ec/ecp_nistp224.c","lib/libcrypto/ec/ecp_nistp224.c","felem_mul",520,532
38,1,457,2,61,"felem_reduce@538-599@lib/libcrypto/ec/ecp_nistp224.c","lib/libcrypto/ec/ecp_nistp224.c","felem_reduce",538,599
6,1,28,2,5,"felem_square_reduce@602-607@lib/libcrypto/ec/ecp_nistp224.c","lib/libcrypto/ec/ecp_nistp224.c","felem_square_reduce",602,607
6,1,34,3,5,"felem_mul_reduce@610-615@lib/libcrypto/ec/ecp_nistp224.c","lib/libcrypto/ec/ecp_nistp224.c","felem_mul_reduce",610,615
32,1,328,2,50,"felem_contract@620-670@lib/libcrypto/ec/ecp_nistp224.c","lib/libcrypto/ec/ecp_nistp224.c","felem_contract",620,670
13,1,182,1,13,"felem_is_zero@677-690@lib/libcrypto/ec/ecp_nistp224.c","lib/libcrypto/ec/ecp_nistp224.c","felem_is_zero",677,690
4,1,26,1,3,"felem_is_zero_int@693-696@lib/libcrypto/ec/ecp_nistp224.c","lib/libcrypto/ec/ecp_nistp224.c","felem_is_zero_int",693,696
78,8,559,2,78,"felem_inv@701-779@lib/libcrypto/ec/ecp_nistp224.c","lib/libcrypto/ec/ecp_nistp224.c","felem_inv",701,779
9,2,64,3,9,"copy_conditional@785-794@lib/libcrypto/ec/ecp_nistp224.c","lib/libcrypto/ec/ecp_nistp224.c","copy_conditional",785,794
37,1,266,6,68,"point_double@813-881@lib/libcrypto/ec/ecp_nistp224.c","lib/libcrypto/ec/ecp_nistp224.c","point_double",813,881
74,7,551,10,155,"point_add@900-1055@lib/libcrypto/ec/ecp_nistp224.c","lib/libcrypto/ec/ecp_nistp224.c","point_add",900,1055
17,3,153,4,17,"select_point@1060-1077@lib/libcrypto/ec/ecp_nistp224.c","lib/libcrypto/ec/ecp_nistp224.c","select_point",1060,1077
6,2,40,2,5,"get_bit@1081-1086@lib/libcrypto/ec/ecp_nistp224.c","lib/libcrypto/ec/ecp_nistp224.c","get_bit",1081,1086
65,11,729,9,88,"batch_mul@1094-1182@lib/libcrypto/ec/ecp_nistp224.c","lib/libcrypto/ec/ecp_nistp224.c","batch_mul",1094,1182
12,2,60,0,11,"nistp224_pre_comp_new@1189-1200@lib/libcrypto/ec/ecp_nistp224.c","lib/libcrypto/ec/ecp_nistp224.c","nistp224_pre_comp_new",1189,1200
6,1,29,1,8,"nistp224_pre_comp_dup@1203-1211@lib/libcrypto/ec/ecp_nistp224.c","lib/libcrypto/ec/ecp_nistp224.c","nistp224_pre_comp_dup",1203,1211
11,3,52,1,13,"nistp224_pre_comp_free@1214-1227@lib/libcrypto/ec/ecp_nistp224.c","lib/libcrypto/ec/ecp_nistp224.c","nistp224_pre_comp_free",1214,1227
11,3,56,1,13,"nistp224_pre_comp_clear_free@1230-1243@lib/libcrypto/ec/ecp_nistp224.c","lib/libcrypto/ec/ecp_nistp224.c","nistp224_pre_comp_clear_free",1230,1243
7,1,27,1,6,"ec_GFp_nistp224_group_init@1250-1256@lib/libcrypto/ec/ecp_nistp224.c","lib/libcrypto/ec/ecp_nistp224.c","ec_GFp_nistp224_group_init",1250,1256
29,9,240,5,29,"ec_GFp_nistp224_group_set_curve@1259-1288@lib/libcrypto/ec/ecp_nistp224.c","lib/libcrypto/ec/ecp_nistp224.c","ec_GFp_nistp224_group_set_curve",1259,1288
37,9,249,5,37,"ec_GFp_nistp224_point_get_affine_coordinates@1293-1330@lib/libcrypto/ec/ecp_nistp224.c","lib/libcrypto/ec/ecp_nistp224.c","ec_GFp_nistp224_point_get_affine_coordinates",1293,1330
15,1,143,3,18,"make_points_affine@1333-1351@lib/libcrypto/ec/ecp_nistp224.c","lib/libcrypto/ec/ecp_nistp224.c","make_points_affine",1333,1351
154,43,1312,7,192,"ec_GFp_nistp224_points_mul@1356-1548@lib/libcrypto/ec/ecp_nistp224.c","lib/libcrypto/ec/ecp_nistp224.c","ec_GFp_nistp224_points_mul",1356,1548
106,20,1500,2,124,"ec_GFp_nistp224_precompute_mult@1551-1675@lib/libcrypto/ec/ecp_nistp224.c","lib/libcrypto/ec/ecp_nistp224.c","ec_GFp_nistp224_precompute_mult",1551,1675
9,2,33,1,8,"ec_GFp_nistp224_have_precompute_mult@1678-1686@lib/libcrypto/ec/ecp_nistp224.c","lib/libcrypto/ec/ecp_nistp224.c","ec_GFp_nistp224_have_precompute_mult",1678,1686
7,1,86,2,6,"bin32_to_felem@119-125@lib/libcrypto/ec/ecp_nistp256.c","lib/libcrypto/ec/ecp_nistp256.c","bin32_to_felem",119,125
7,1,86,2,6,"smallfelem_to_bin32@130-136@lib/libcrypto/ec/ecp_nistp256.c","lib/libcrypto/ec/ecp_nistp256.c","smallfelem_to_bin32",130,136
6,2,46,3,5,"flip_endian@140-145@lib/libcrypto/ec/ecp_nistp256.c","lib/libcrypto/ec/ecp_nistp256.c","flip_endian",140,145
20,3,100,2,21,"BN_to_felem@149-170@lib/libcrypto/ec/ecp_nistp256.c","lib/libcrypto/ec/ecp_nistp256.c","BN_to_felem",149,170
7,1,45,2,6,"smallfelem_to_BN@174-180@lib/libcrypto/ec/ecp_nistp256.c","lib/libcrypto/ec/ecp_nistp256.c","smallfelem_to_BN",174,180
7,1,35,1,6,"smallfelem_one@187-193@lib/libcrypto/ec/ecp_nistp256.c","lib/libcrypto/ec/ecp_nistp256.c","smallfelem_one",187,193
7,1,51,2,6,"smallfelem_assign@196-202@lib/libcrypto/ec/ecp_nistp256.c","lib/libcrypto/ec/ecp_nistp256.c","smallfelem_assign",196,202
7,1,51,2,6,"felem_assign@205-211@lib/libcrypto/ec/ecp_nistp256.c","lib/libcrypto/ec/ecp_nistp256.c","felem_assign",205,211
7,1,51,2,6,"felem_sum@215-221@lib/libcrypto/ec/ecp_nistp256.c","lib/libcrypto/ec/ecp_nistp256.c","felem_sum",215,221
7,1,51,2,6,"felem_small_sum@225-231@lib/libcrypto/ec/ecp_nistp256.c","lib/libcrypto/ec/ecp_nistp256.c","felem_small_sum",225,231
7,1,39,2,6,"felem_scalar@235-241@lib/libcrypto/ec/ecp_nistp256.c","lib/libcrypto/ec/ecp_nistp256.c","felem_scalar",235,241
11,1,67,2,10,"longfelem_scalar@245-255@lib/libcrypto/ec/ecp_nistp256.c","lib/libcrypto/ec/ecp_nistp256.c","longfelem_scalar",245,255
7,1,71,2,7,"smallfelem_neg@269-276@lib/libcrypto/ec/ecp_nistp256.c","lib/libcrypto/ec/ecp_nistp256.c","smallfelem_neg",269,276
11,1,91,2,12,"felem_diff@285-297@lib/libcrypto/ec/ecp_nistp256.c","lib/libcrypto/ec/ecp_nistp256.c","felem_diff",285,297
11,1,91,2,12,"felem_diff_zero107@314-326@lib/libcrypto/ec/ecp_nistp256.c","lib/libcrypto/ec/ecp_nistp256.c","felem_diff_zero107",314,326
24,1,316,2,27,"longfelem_diff@335-362@lib/libcrypto/ec/ecp_nistp256.c","lib/libcrypto/ec/ecp_nistp256.c","longfelem_diff",335,362
46,1,469,2,87,"felem_shrink@381-468@lib/libcrypto/ec/ecp_nistp256.c","lib/libcrypto/ec/ecp_nistp256.c","felem_shrink",381,468
7,1,51,2,6,"smallfelem_expand@472-478@lib/libcrypto/ec/ecp_nistp256.c","lib/libcrypto/ec/ecp_nistp256.c","smallfelem_expand",472,478
61,1,481,2,70,"smallfelem_square@487-557@lib/libcrypto/ec/ecp_nistp256.c","lib/libcrypto/ec/ecp_nistp256.c","smallfelem_square",487,557
6,1,31,2,5,"felem_square@566-571@lib/libcrypto/ec/ecp_nistp256.c","lib/libcrypto/ec/ecp_nistp256.c","felem_square",566,571
85,1,695,3,106,"smallfelem_mul@581-687@lib/libcrypto/ec/ecp_nistp256.c","lib/libcrypto/ec/ecp_nistp256.c","smallfelem_mul",581,687
7,1,43,3,6,"felem_mul@697-703@lib/libcrypto/ec/ecp_nistp256.c","lib/libcrypto/ec/ecp_nistp256.c","felem_mul",697,703
6,1,34,3,5,"felem_small_mul@713-718@lib/libcrypto/ec/ecp_nistp256.c","lib/libcrypto/ec/ecp_nistp256.c","felem_small_mul",713,718
22,1,239,2,32,"felem_reduce_@740-772@lib/libcrypto/ec/ecp_nistp256.c","lib/libcrypto/ec/ecp_nistp256.c","felem_reduce_",740,772
8,1,78,2,20,"felem_reduce@783-803@lib/libcrypto/ec/ecp_nistp256.c","lib/libcrypto/ec/ecp_nistp256.c","felem_reduce",783,803
8,1,78,2,19,"felem_reduce_zero105@812-831@lib/libcrypto/ec/ecp_nistp256.c","lib/libcrypto/ec/ecp_nistp256.c","felem_reduce_zero105",812,831
7,1,45,3,6,"subtract_u64@836-842@lib/libcrypto/ec/ecp_nistp256.c","lib/libcrypto/ec/ecp_nistp256.c","subtract_u64",836,842
33,2,324,2,61,"felem_contract@849-910@lib/libcrypto/ec/ecp_nistp256.c","lib/libcrypto/ec/ecp_nistp256.c","felem_contract",849,910
8,1,38,2,8,"smallfelem_square_contract@913-921@lib/libcrypto/ec/ecp_nistp256.c","lib/libcrypto/ec/ecp_nistp256.c","smallfelem_square_contract",913,921
8,1,44,3,8,"smallfelem_mul_contract@924-932@lib/libcrypto/ec/ecp_nistp256.c","lib/libcrypto/ec/ecp_nistp256.c","smallfelem_mul_contract",924,932
30,1,224,1,33,"smallfelem_is_zero@940-973@lib/libcrypto/ec/ecp_nistp256.c","lib/libcrypto/ec/ecp_nistp256.c","smallfelem_is_zero",940,973
4,1,26,1,3,"smallfelem_is_zero_int@976-979@lib/libcrypto/ec/ecp_nistp256.c","lib/libcrypto/ec/ecp_nistp256.c","smallfelem_is_zero_int",976,979
89,8,642,2,92,"felem_inv@989-1081@lib/libcrypto/ec/ecp_nistp256.c","lib/libcrypto/ec/ecp_nistp256.c","felem_inv",989,1081
7,1,35,2,7,"smallfelem_inv_contract@1084-1091@lib/libcrypto/ec/ecp_nistp256.c","lib/libcrypto/ec/ecp_nistp256.c","smallfelem_inv_contract",1084,1091
40,1,285,6,75,"point_double@1108-1183@lib/libcrypto/ec/ecp_nistp256.c","lib/libcrypto/ec/ecp_nistp256.c","point_double",1108,1183
14,1,96,6,14,"point_double_small@1188-1202@lib/libcrypto/ec/ecp_nistp256.c","lib/libcrypto/ec/ecp_nistp256.c","point_double_small",1188,1202
8,2,57,3,7,"copy_conditional@1206-1213@lib/libcrypto/ec/ecp_nistp256.c","lib/libcrypto/ec/ecp_nistp256.c","copy_conditional",1206,1213
8,2,66,3,7,"copy_small_conditional@1217-1224@lib/libcrypto/ec/ecp_nistp256.c","lib/libcrypto/ec/ecp_nistp256.c","copy_small_conditional",1217,1224
86,6,650,10,155,"point_add@1237-1392@lib/libcrypto/ec/ecp_nistp256.c","lib/libcrypto/ec/ecp_nistp256.c","point_add",1237,1392
14,1,110,9,13,"point_add_small@1397-1410@lib/libcrypto/ec/ecp_nistp256.c","lib/libcrypto/ec/ecp_nistp256.c","point_add_small",1397,1410
17,3,158,4,17,"select_point@1549-1566@lib/libcrypto/ec/ecp_nistp256.c","lib/libcrypto/ec/ecp_nistp256.c","select_point",1549,1566
6,3,48,2,5,"get_bit@1570-1575@lib/libcrypto/ec/ecp_nistp256.c","lib/libcrypto/ec/ecp_nistp256.c","get_bit",1570,1575
70,11,794,9,96,"batch_mul@1583-1679@lib/libcrypto/ec/ecp_nistp256.c","lib/libcrypto/ec/ecp_nistp256.c","batch_mul",1583,1679
43,1,177,1,43,"EC_GFp_nistp256_method@1688-1731@lib/libcrypto/ec/ecp_nistp256.c","lib/libcrypto/ec/ecp_nistp256.c","EC_GFp_nistp256_method",1688,1731
12,2,60,0,11,"nistp256_pre_comp_new@1738-1749@lib/libcrypto/ec/ecp_nistp256.c","lib/libcrypto/ec/ecp_nistp256.c","nistp256_pre_comp_new",1738,1749
6,1,29,1,8,"nistp256_pre_comp_dup@1752-1760@lib/libcrypto/ec/ecp_nistp256.c","lib/libcrypto/ec/ecp_nistp256.c","nistp256_pre_comp_dup",1752,1760
11,3,52,1,13,"nistp256_pre_comp_free@1763-1776@lib/libcrypto/ec/ecp_nistp256.c","lib/libcrypto/ec/ecp_nistp256.c","nistp256_pre_comp_free",1763,1776
11,3,56,1,13,"nistp256_pre_comp_clear_free@1779-1792@lib/libcrypto/ec/ecp_nistp256.c","lib/libcrypto/ec/ecp_nistp256.c","nistp256_pre_comp_clear_free",1779,1792
7,1,27,1,6,"ec_GFp_nistp256_group_init@1799-1805@lib/libcrypto/ec/ecp_nistp256.c","lib/libcrypto/ec/ecp_nistp256.c","ec_GFp_nistp256_group_init",1799,1805
29,9,240,5,29,"ec_GFp_nistp256_group_set_curve@1808-1837@lib/libcrypto/ec/ecp_nistp256.c","lib/libcrypto/ec/ecp_nistp256.c","ec_GFp_nistp256_group_set_curve",1808,1837
38,9,250,5,38,"ec_GFp_nistp256_point_get_affine_coordinates@1842-1880@lib/libcrypto/ec/ecp_nistp256.c","lib/libcrypto/ec/ecp_nistp256.c","ec_GFp_nistp256_point_get_affine_coordinates",1842,1880
15,1,143,3,18,"make_points_affine@1883-1901@lib/libcrypto/ec/ecp_nistp256.c","lib/libcrypto/ec/ecp_nistp256.c","make_points_affine",1883,1901
154,43,1309,7,195,"ec_GFp_nistp256_points_mul@1906-2101@lib/libcrypto/ec/ecp_nistp256.c","lib/libcrypto/ec/ecp_nistp256.c","ec_GFp_nistp256_points_mul",1906,2101
100,20,1518,2,118,"ec_GFp_nistp256_precompute_mult@2104-2222@lib/libcrypto/ec/ecp_nistp256.c","lib/libcrypto/ec/ecp_nistp256.c","ec_GFp_nistp256_precompute_mult",2104,2222
9,2,33,1,8,"ec_GFp_nistp256_have_precompute_mult@2225-2233@lib/libcrypto/ec/ecp_nistp256.c","lib/libcrypto/ec/ecp_nistp256.c","ec_GFp_nistp256_have_precompute_mult",2225,2233
12,1,230,2,11,"bin66_to_felem@134-145@lib/libcrypto/ec/ecp_nistp521.c","lib/libcrypto/ec/ecp_nistp521.c","bin66_to_felem",134,145
13,1,221,2,12,"felem_to_bin66@150-162@lib/libcrypto/ec/ecp_nistp521.c","lib/libcrypto/ec/ecp_nistp521.c","felem_to_bin66",150,162
6,2,46,3,5,"flip_endian@166-171@lib/libcrypto/ec/ecp_nistp521.c","lib/libcrypto/ec/ecp_nistp521.c","flip_endian",166,171
20,3,100,2,21,"BN_to_felem@175-196@lib/libcrypto/ec/ecp_nistp521.c","lib/libcrypto/ec/ecp_nistp521.c","BN_to_felem",175,196
7,1,45,2,6,"felem_to_BN@200-206@lib/libcrypto/ec/ecp_nistp521.c","lib/libcrypto/ec/ecp_nistp521.c","felem_to_BN",200,206
12,1,70,1,11,"felem_one@213-224@lib/libcrypto/ec/ecp_nistp521.c","lib/libcrypto/ec/ecp_nistp521.c","felem_one",213,224
12,1,101,2,11,"felem_assign@227-238@lib/libcrypto/ec/ecp_nistp521.c","lib/libcrypto/ec/ecp_nistp521.c","felem_assign",227,238
12,1,101,2,11,"felem_sum64@242-253@lib/libcrypto/ec/ecp_nistp521.c","lib/libcrypto/ec/ecp_nistp521.c","felem_sum64",242,253
12,1,122,3,11,"felem_scalar@257-268@lib/libcrypto/ec/ecp_nistp521.c","lib/libcrypto/ec/ecp_nistp521.c","felem_scalar",257,268
12,1,73,2,11,"felem_scalar64@272-283@lib/libcrypto/ec/ecp_nistp521.c","lib/libcrypto/ec/ecp_nistp521.c","felem_scalar64",272,283
12,1,73,2,11,"felem_scalar128@287-298@lib/libcrypto/ec/ecp_nistp521.c","lib/libcrypto/ec/ecp_nistp521.c","felem_scalar128",287,298
14,1,177,2,15,"felem_neg@307-322@lib/libcrypto/ec/ecp_nistp521.c","lib/libcrypto/ec/ecp_nistp521.c","felem_neg",307,322
14,1,177,2,15,"felem_diff64@331-346@lib/libcrypto/ec/ecp_nistp521.c","lib/libcrypto/ec/ecp_nistp521.c","felem_diff64",331,346
14,1,177,2,15,"felem_diff_128_64@355-370@lib/libcrypto/ec/ecp_nistp521.c","lib/libcrypto/ec/ecp_nistp521.c","felem_diff_128_64",355,370
14,1,195,2,15,"felem_diff128@379-394@lib/libcrypto/ec/ecp_nistp521.c","lib/libcrypto/ec/ecp_nistp521.c","felem_diff128",379,394
51,1,794,2,84,"felem_square@403-487@lib/libcrypto/ec/ecp_nistp521.c","lib/libcrypto/ec/ecp_nistp521.c","felem_square",403,487
86,1,1327,3,104,"felem_mul@497-601@lib/libcrypto/ec/ecp_nistp521.c","lib/libcrypto/ec/ecp_nistp521.c","felem_mul",497,601
46,1,813,2,69,"felem_reduce@612-681@lib/libcrypto/ec/ecp_nistp521.c","lib/libcrypto/ec/ecp_nistp521.c","felem_reduce",612,681
6,1,28,2,5,"felem_square_reduce@684-689@lib/libcrypto/ec/ecp_nistp521.c","lib/libcrypto/ec/ecp_nistp521.c","felem_square_reduce",684,689
6,1,34,3,5,"felem_mul_reduce@692-697@lib/libcrypto/ec/ecp_nistp521.c","lib/libcrypto/ec/ecp_nistp521.c","felem_mul_reduce",692,697
89,8,640,2,98,"felem_inv@707-805@lib/libcrypto/ec/ecp_nistp521.c","lib/libcrypto/ec/ecp_nistp521.c","felem_inv",707,805
49,1,415,1,66,"felem_is_zero@821-887@lib/libcrypto/ec/ecp_nistp521.c","lib/libcrypto/ec/ecp_nistp521.c","felem_is_zero",821,887
4,1,26,1,3,"felem_is_zero_int@890-893@lib/libcrypto/ec/ecp_nistp521.c","lib/libcrypto/ec/ecp_nistp521.c","felem_is_zero_int",890,893
101,1,1009,2,128,"felem_contract@900-1028@lib/libcrypto/ec/ecp_nistp521.c","lib/libcrypto/ec/ecp_nistp521.c","felem_contract",900,1028
37,1,266,6,88,"point_double@1045-1133@lib/libcrypto/ec/ecp_nistp521.c","lib/libcrypto/ec/ecp_nistp521.c","point_double",1045,1133
8,2,57,3,7,"copy_conditional@1137-1144@lib/libcrypto/ec/ecp_nistp521.c","lib/libcrypto/ec/ecp_nistp521.c","copy_conditional",1137,1144
78,6,592,10,148,"point_add@1157-1305@lib/libcrypto/ec/ecp_nistp521.c","lib/libcrypto/ec/ecp_nistp521.c","point_add",1157,1305
18,3,153,4,18,"select_point@1454-1472@lib/libcrypto/ec/ecp_nistp521.c","lib/libcrypto/ec/ecp_nistp521.c","select_point",1454,1472
6,2,40,2,5,"get_bit@1476-1481@lib/libcrypto/ec/ecp_nistp521.c","lib/libcrypto/ec/ecp_nistp521.c","get_bit",1476,1481
58,12,619,9,79,"batch_mul@1489-1568@lib/libcrypto/ec/ecp_nistp521.c","lib/libcrypto/ec/ecp_nistp521.c","batch_mul",1489,1568
43,1,177,1,43,"EC_GFp_nistp521_method@1578-1621@lib/libcrypto/ec/ecp_nistp521.c","lib/libcrypto/ec/ecp_nistp521.c","EC_GFp_nistp521_method",1578,1621
12,2,61,0,11,"nistp521_pre_comp_new@1629-1640@lib/libcrypto/ec/ecp_nistp521.c","lib/libcrypto/ec/ecp_nistp521.c","nistp521_pre_comp_new",1629,1640
6,1,29,1,8,"nistp521_pre_comp_dup@1643-1651@lib/libcrypto/ec/ecp_nistp521.c","lib/libcrypto/ec/ecp_nistp521.c","nistp521_pre_comp_dup",1643,1651
11,3,52,1,13,"nistp521_pre_comp_free@1654-1667@lib/libcrypto/ec/ecp_nistp521.c","lib/libcrypto/ec/ecp_nistp521.c","nistp521_pre_comp_free",1654,1667
11,3,58,1,13,"nistp521_pre_comp_clear_free@1670-1683@lib/libcrypto/ec/ecp_nistp521.c","lib/libcrypto/ec/ecp_nistp521.c","nistp521_pre_comp_clear_free",1670,1683
7,1,27,1,6,"ec_GFp_nistp521_group_init@1690-1696@lib/libcrypto/ec/ecp_nistp521.c","lib/libcrypto/ec/ecp_nistp521.c","ec_GFp_nistp521_group_init",1690,1696
29,9,240,5,29,"ec_GFp_nistp521_group_set_curve@1699-1728@lib/libcrypto/ec/ecp_nistp521.c","lib/libcrypto/ec/ecp_nistp521.c","ec_GFp_nistp521_group_set_curve",1699,1728
37,9,249,5,37,"ec_GFp_nistp521_point_get_affine_coordinates@1733-1770@lib/libcrypto/ec/ecp_nistp521.c","lib/libcrypto/ec/ecp_nistp521.c","ec_GFp_nistp521_point_get_affine_coordinates",1733,1770
15,1,143,3,18,"make_points_affine@1773-1791@lib/libcrypto/ec/ecp_nistp521.c","lib/libcrypto/ec/ecp_nistp521.c","make_points_affine",1773,1791
153,43,1318,7,194,"ec_GFp_nistp521_points_mul@1796-1990@lib/libcrypto/ec/ecp_nistp521.c","lib/libcrypto/ec/ecp_nistp521.c","ec_GFp_nistp521_points_mul",1796,1990
92,17,1111,2,104,"ec_GFp_nistp521_precompute_mult@1993-2097@lib/libcrypto/ec/ecp_nistp521.c","lib/libcrypto/ec/ecp_nistp521.c","ec_GFp_nistp521_precompute_mult",1993,2097
9,2,33,1,8,"ec_GFp_nistp521_have_precompute_mult@2100-2108@lib/libcrypto/ec/ecp_nistp521.c","lib/libcrypto/ec/ecp_nistp521.c","ec_GFp_nistp521_have_precompute_mult",2100,2108
43,9,467,11,73,"ec_GFp_nistp_points_make_affine_internal@47-120@lib/libcrypto/ec/ecp_nistputil.c","lib/libcrypto/ec/ecp_nistputil.c","ec_GFp_nistp_points_make_affine_internal",47,120
10,1,91,3,12,"ec_GFp_nistp_recode_scalar_bits@196-208@lib/libcrypto/ec/ecp_nistputil.c","lib/libcrypto/ec/ecp_nistputil.c","ec_GFp_nistp_recode_scalar_bits",196,208
9,1,83,1,11,"_booth_recode_w5@209-220@lib/libcrypto/ec/ecp_nistz256.c","lib/libcrypto/ec/ecp_nistz256.c","_booth_recode_w5",209,220
9,1,83,1,11,"_booth_recode_w7@223-234@lib/libcrypto/ec/ecp_nistz256.c","lib/libcrypto/ec/ecp_nistz256.c","_booth_recode_w7",223,234
16,2,223,3,16,"copy_conditional@237-253@lib/libcrypto/ec/ecp_nistz256.c","lib/libcrypto/ec/ecp_nistz256.c","copy_conditional",237,253
8,1,33,1,7,"is_zero@256-263@lib/libcrypto/ec/ecp_nistz256.c","lib/libcrypto/ec/ecp_nistz256.c","is_zero",256,263
15,2,131,2,16,"is_equal@266-282@lib/libcrypto/ec/ecp_nistz256.c","lib/libcrypto/ec/ecp_nistz256.c","is_equal",266,282
18,3,140,1,23,"is_one@285-308@lib/libcrypto/ec/ecp_nistz256.c","lib/libcrypto/ec/ecp_nistz256.c","is_one",285,308
11,2,65,2,10,"ecp_nistz256_set_words@311-321@lib/libcrypto/ec/ecp_nistz256.c","lib/libcrypto/ec/ecp_nistz256.c","ecp_nistz256_set_words",311,321
56,8,454,2,73,"ecp_nistz256_mod_inverse@331-404@lib/libcrypto/ec/ecp_nistz256.c","lib/libcrypto/ec/ecp_nistz256.c","ecp_nistz256_mod_inverse",331,404
8,2,61,2,8,"ecp_nistz256_bignum_to_field_elem@411-419@lib/libcrypto/ec/ecp_nistz256.c","lib/libcrypto/ec/ecp_nistz256.c","ecp_nistz256_bignum_to_field_elem",411,419
112,20,1288,6,150,"ecp_nistz256_windowed_mul@423-573@lib/libcrypto/ec/ecp_nistz256.c","lib/libcrypto/ec/ecp_nistz256.c","ecp_nistz256_windowed_mul",423,573
8,5,56,1,7,"ecp_nistz256_is_affine_G@591-598@lib/libcrypto/ec/ecp_nistz256.c","lib/libcrypto/ec/ecp_nistz256.c","ecp_nistz256_is_affine_G",591,598
88,24,528,2,124,"ecp_nistz256_mult_precompute@601-725@lib/libcrypto/ec/ecp_nistz256.c","lib/libcrypto/ec/ecp_nistz256.c","ecp_nistz256_mult_precompute",601,725
19,1,147,4,22,"ecp_nistz256_set_from_affine@728-750@lib/libcrypto/ec/ecp_nistz256.c","lib/libcrypto/ec/ecp_nistz256.c","ecp_nistz256_set_from_affine",728,750
180,39,1501,7,241,"ecp_nistz256_points_mul@754-995@lib/libcrypto/ec/ecp_nistz256.c","lib/libcrypto/ec/ecp_nistz256.c","ecp_nistz256_points_mul",754,995
37,9,242,5,50,"ecp_nistz256_get_affine@998-1048@lib/libcrypto/ec/ecp_nistz256.c","lib/libcrypto/ec/ecp_nistz256.c","ecp_nistz256_get_affine",998,1048
16,3,79,1,18,"ecp_nistz256_pre_comp_new@1051-1069@lib/libcrypto/ec/ecp_nistz256.c","lib/libcrypto/ec/ecp_nistz256.c","ecp_nistz256_pre_comp_new",1051,1069
6,1,29,1,8,"ecp_nistz256_pre_comp_dup@1072-1080@lib/libcrypto/ec/ecp_nistz256.c","lib/libcrypto/ec/ecp_nistz256.c","ecp_nistz256_pre_comp_dup",1072,1080
12,3,60,1,14,"ecp_nistz256_pre_comp_free@1083-1097@lib/libcrypto/ec/ecp_nistz256.c","lib/libcrypto/ec/ecp_nistz256.c","ecp_nistz256_pre_comp_free",1083,1097
14,4,81,1,24,"ecp_nistz256_pre_comp_clear_free@1100-1124@lib/libcrypto/ec/ecp_nistz256.c","lib/libcrypto/ec/ecp_nistz256.c","ecp_nistz256_pre_comp_clear_free",1100,1124
11,3,51,1,13,"ecp_nistz256_window_have_precompute_mult@1127-1140@lib/libcrypto/ec/ecp_nistz256.c","lib/libcrypto/ec/ecp_nistz256.c","ecp_nistz256_window_have_precompute_mult",1127,1140
46,1,192,1,46,"EC_GFp_nistz256_method@1143-1189@lib/libcrypto/ec/ecp_nistz256.c","lib/libcrypto/ec/ecp_nistz256.c","EC_GFp_nistz256_method",1143,1189
100,36,735,5,127,"ec_GFp_simple_set_compressed_coordinates@70-197@lib/libcrypto/ec/ecp_oct.c","lib/libcrypto/ec/ecp_oct.c","ec_GFp_simple_set_compressed_coordinates",70,197
92,28,509,6,101,"ec_GFp_simple_point2oct@201-302@lib/libcrypto/ec/ecp_oct.c","lib/libcrypto/ec/ecp_oct.c","ec_GFp_simple_point2oct",201,302
84,27,490,5,89,"ec_GFp_simple_oct2point@306-395@lib/libcrypto/ec/ecp_oct.c","lib/libcrypto/ec/ecp_oct.c","ec_GFp_simple_oct2point",306,395
40,1,162,1,40,"EC_GFp_simple_method@71-111@lib/libcrypto/ec/ecp_smpl.c","lib/libcrypto/ec/ecp_smpl.c","EC_GFp_simple_method",71,111
8,1,41,1,7,"ec_GFp_simple_group_init@129-136@lib/libcrypto/ec/ecp_smpl.c","lib/libcrypto/ec/ecp_smpl.c","ec_GFp_simple_group_init",129,136
6,1,32,1,5,"ec_GFp_simple_group_finish@140-145@lib/libcrypto/ec/ecp_smpl.c","lib/libcrypto/ec/ecp_smpl.c","ec_GFp_simple_group_finish",140,145
6,1,32,1,5,"ec_GFp_simple_group_clear_finish@149-154@lib/libcrypto/ec/ecp_smpl.c","lib/libcrypto/ec/ecp_smpl.c","ec_GFp_simple_group_clear_finish",149,154
11,4,81,2,12,"ec_GFp_simple_group_copy@158-170@lib/libcrypto/ec/ecp_smpl.c","lib/libcrypto/ec/ecp_smpl.c","ec_GFp_simple_group_copy",158,170
42,15,312,5,53,"ec_GFp_simple_group_set_curve@174-227@lib/libcrypto/ec/ecp_smpl.c","lib/libcrypto/ec/ecp_smpl.c","ec_GFp_simple_group_set_curve",174,227
39,16,236,5,40,"ec_GFp_simple_group_get_curve@231-271@lib/libcrypto/ec/ecp_smpl.c","lib/libcrypto/ec/ecp_smpl.c","ec_GFp_simple_group_get_curve",231,271
4,1,18,1,3,"ec_GFp_simple_group_get_degree@275-278@lib/libcrypto/ec/ecp_smpl.c","lib/libcrypto/ec/ecp_smpl.c","ec_GFp_simple_group_get_degree",275,278
61,24,425,2,72,"ec_GFp_simple_group_check_discriminant@282-354@lib/libcrypto/ec/ecp_smpl.c","lib/libcrypto/ec/ecp_smpl.c","ec_GFp_simple_group_check_discriminant",282,354
8,1,41,1,8,"ec_GFp_simple_point_init@358-366@lib/libcrypto/ec/ecp_smpl.c","lib/libcrypto/ec/ecp_smpl.c","ec_GFp_simple_point_init",358,366
6,1,32,1,5,"ec_GFp_simple_point_finish@370-375@lib/libcrypto/ec/ecp_smpl.c","lib/libcrypto/ec/ecp_smpl.c","ec_GFp_simple_point_finish",370,375
7,1,38,1,6,"ec_GFp_simple_point_clear_finish@379-385@lib/libcrypto/ec/ecp_smpl.c","lib/libcrypto/ec/ecp_smpl.c","ec_GFp_simple_point_clear_finish",379,385
11,4,81,2,11,"ec_GFp_simple_point_copy@389-400@lib/libcrypto/ec/ecp_smpl.c","lib/libcrypto/ec/ecp_smpl.c","ec_GFp_simple_point_copy",389,400
6,1,30,2,5,"ec_GFp_simple_point_set_to_infinity@404-409@lib/libcrypto/ec/ecp_smpl.c","lib/libcrypto/ec/ecp_smpl.c","ec_GFp_simple_point_set_to_infinity",404,409
47,18,346,6,49,"ec_GFp_simple_set_Jprojective_coordinates_GFp@413-462@lib/libcrypto/ec/ecp_smpl.c","lib/libcrypto/ec/ecp_smpl.c","ec_GFp_simple_set_Jprojective_coordinates_GFp",413,462
42,16,263,6,44,"ec_GFp_simple_get_Jprojective_coordinates_GFp@466-510@lib/libcrypto/ec/ecp_smpl.c","lib/libcrypto/ec/ecp_smpl.c","ec_GFp_simple_get_Jprojective_coordinates_GFp",466,510
9,3,65,5,9,"ec_GFp_simple_point_set_affine_coordinates@514-523@lib/libcrypto/ec/ecp_smpl.c","lib/libcrypto/ec/ecp_smpl.c","ec_GFp_simple_point_set_affine_coordinates",514,523
86,31,585,5,104,"ec_GFp_simple_point_get_affine_coordinates@527-631@lib/libcrypto/ec/ecp_smpl.c","lib/libcrypto/ec/ecp_smpl.c","ec_GFp_simple_point_get_affine_coordinates",527,631
138,56,1104,5,185,"ec_GFp_simple_add@634-819@lib/libcrypto/ec/ecp_smpl.c","lib/libcrypto/ec/ecp_smpl.c","ec_GFp_simple_add",634,819
106,42,880,4,138,"ec_GFp_simple_dbl@823-961@lib/libcrypto/ec/ecp_smpl.c","lib/libcrypto/ec/ecp_smpl.c","ec_GFp_simple_dbl",823,961
6,3,58,3,7,"ec_GFp_simple_invert@965-972@lib/libcrypto/ec/ecp_smpl.c","lib/libcrypto/ec/ecp_smpl.c","ec_GFp_simple_invert",965,972
4,1,23,2,3,"ec_GFp_simple_is_at_infinity@976-979@lib/libcrypto/ec/ecp_smpl.c","lib/libcrypto/ec/ecp_smpl.c","ec_GFp_simple_is_at_infinity",976,979
73,27,606,3,99,"ec_GFp_simple_is_on_curve@983-1082@lib/libcrypto/ec/ecp_smpl.c","lib/libcrypto/ec/ecp_smpl.c","ec_GFp_simple_is_on_curve",983,1082
76,28,612,4,98,"ec_GFp_simple_cmp@1086-1184@lib/libcrypto/ec/ecp_smpl.c","lib/libcrypto/ec/ecp_smpl.c","ec_GFp_simple_cmp",1086,1184
31,10,189,3,34,"ec_GFp_simple_make_affine@1188-1222@lib/libcrypto/ec/ecp_smpl.c","lib/libcrypto/ec/ecp_smpl.c","ec_GFp_simple_make_affine",1188,1222
114,44,979,4,171,"ec_GFp_simple_points_make_affine@1226-1397@lib/libcrypto/ec/ecp_smpl.c","lib/libcrypto/ec/ecp_smpl.c","ec_GFp_simple_points_make_affine",1226,1397
4,1,44,5,3,"ec_GFp_simple_field_mul@1401-1404@lib/libcrypto/ec/ecp_smpl.c","lib/libcrypto/ec/ecp_smpl.c","ec_GFp_simple_field_mul",1401,1404
4,1,37,4,3,"ec_GFp_simple_field_sqr@1408-1411@lib/libcrypto/ec/ecp_smpl.c","lib/libcrypto/ec/ecp_smpl.c","ec_GFp_simple_field_sqr",1408,1411
7,2,36,1,8,"ERR_load_ECDH_strings@91-99@lib/libcrypto/ecdh/ech_err.c","lib/libcrypto/ecdh/ech_err.c","ERR_load_ECDH_strings",91,99
93,20,543,5,107,"ecdh_compute_key@94-201@lib/libcrypto/ecdh/ech_key.c","lib/libcrypto/ecdh/ech_key.c","ecdh_compute_key",94,201
4,1,10,1,3,"ECDH_OpenSSL@209-212@lib/libcrypto/ecdh/ech_key.c","lib/libcrypto/ecdh/ech_key.c","ECDH_OpenSSL",209,212
9,2,80,5,8,"ECDH_compute_key@215-223@lib/libcrypto/ecdh/ech_key.c","lib/libcrypto/ecdh/ech_key.c","ECDH_compute_key",215,223
4,1,13,1,3,"ECDH_set_default_method@87-90@lib/libcrypto/ecdh/ech_lib.c","lib/libcrypto/ecdh/ech_lib.c","ECDH_set_default_method",87,90
7,2,22,1,6,"ECDH_get_default_method@93-99@lib/libcrypto/ecdh/ech_lib.c","lib/libcrypto/ecdh/ech_lib.c","ECDH_get_default_method",93,99
13,3,63,2,17,"ECDH_set_method@102-119@lib/libcrypto/ecdh/ech_lib.c","lib/libcrypto/ecdh/ech_lib.c","ECDH_set_method",102,119
26,5,150,1,31,"ECDH_DATA_new_method@122-153@lib/libcrypto/ecdh/ech_lib.c","lib/libcrypto/ecdh/ech_lib.c","ECDH_DATA_new_method",122,153
4,1,16,1,3,"ecdh_data_new@156-159@lib/libcrypto/ecdh/ech_lib.c","lib/libcrypto/ecdh/ech_lib.c","ecdh_data_new",156,159
7,2,36,1,9,"ecdh_data_dup@162-171@lib/libcrypto/ecdh/ech_lib.c","lib/libcrypto/ecdh/ech_lib.c","ecdh_data_dup",162,171
8,2,53,1,12,"ecdh_data_free@174-186@lib/libcrypto/ecdh/ech_lib.c","lib/libcrypto/ecdh/ech_lib.c","ecdh_data_free",174,186
19,4,106,1,22,"ecdh_check@189-211@lib/libcrypto/ecdh/ech_lib.c","lib/libcrypto/ecdh/ech_lib.c","ecdh_check",189,211
6,1,39,5,5,"ECDH_get_ex_new_index@214-219@lib/libcrypto/ecdh/ech_lib.c","lib/libcrypto/ecdh/ech_lib.c","ECDH_get_ex_new_index",214,219
8,2,50,3,7,"ECDH_set_ex_data@222-229@lib/libcrypto/ecdh/ech_lib.c","lib/libcrypto/ecdh/ech_lib.c","ECDH_set_ex_data",222,229
8,2,44,2,7,"ECDH_get_ex_data@232-239@lib/libcrypto/ecdh/ech_lib.c","lib/libcrypto/ecdh/ech_lib.c","ECDH_get_ex_data",232,239
4,1,26,1,3,"ECDH_size@242-245@lib/libcrypto/ecdh/ech_lib.c","lib/libcrypto/ecdh/ech_lib.c","ECDH_size",242,245
5,1,38,3,4,"d2i_ECDSA_SIG@93-97@lib/libcrypto/ecdsa/ecs_asn1.c","lib/libcrypto/ecdsa/ecs_asn1.c","d2i_ECDSA_SIG",93,97
4,1,29,2,3,"i2d_ECDSA_SIG@100-103@lib/libcrypto/ecdsa/ecs_asn1.c","lib/libcrypto/ecdsa/ecs_asn1.c","i2d_ECDSA_SIG",100,103
4,1,17,1,3,"ECDSA_SIG_new@106-109@lib/libcrypto/ecdsa/ecs_asn1.c","lib/libcrypto/ecdsa/ecs_asn1.c","ECDSA_SIG_new",106,109
4,1,20,1,3,"ECDSA_SIG_free@112-115@lib/libcrypto/ecdsa/ecs_asn1.c","lib/libcrypto/ecdsa/ecs_asn1.c","ECDSA_SIG_free",112,115
7,2,36,1,8,"ERR_load_ECDSA_strings@94-102@lib/libcrypto/ecdsa/ecs_err.c","lib/libcrypto/ecdsa/ecs_err.c","ERR_load_ECDSA_strings",94,102
4,1,13,1,3,"ECDSA_set_default_method@74-77@lib/libcrypto/ecdsa/ecs_lib.c","lib/libcrypto/ecdsa/ecs_lib.c","ECDSA_set_default_method",74,77
7,2,22,1,6,"ECDSA_get_default_method@80-86@lib/libcrypto/ecdsa/ecs_lib.c","lib/libcrypto/ecdsa/ecs_lib.c","ECDSA_get_default_method",80,86
13,3,63,2,18,"ECDSA_set_method@89-107@lib/libcrypto/ecdsa/ecs_lib.c","lib/libcrypto/ecdsa/ecs_lib.c","ECDSA_set_method",89,107
26,5,150,1,31,"ECDSA_DATA_new_method@110-141@lib/libcrypto/ecdsa/ecs_lib.c","lib/libcrypto/ecdsa/ecs_lib.c","ECDSA_DATA_new_method",110,141
4,1,16,1,3,"ecdsa_data_new@144-147@lib/libcrypto/ecdsa/ecs_lib.c","lib/libcrypto/ecdsa/ecs_lib.c","ecdsa_data_new",144,147
7,2,32,1,9,"ecdsa_data_dup@150-159@lib/libcrypto/ecdsa/ecs_lib.c","lib/libcrypto/ecdsa/ecs_lib.c","ecdsa_data_dup",150,159
8,2,53,1,11,"ecdsa_data_free@162-173@lib/libcrypto/ecdsa/ecs_lib.c","lib/libcrypto/ecdsa/ecs_lib.c","ecdsa_data_free",162,173
19,4,106,1,22,"ecdsa_check@176-198@lib/libcrypto/ecdsa/ecs_lib.c","lib/libcrypto/ecdsa/ecs_lib.c","ecdsa_check",176,198
29,5,170,1,32,"ECDSA_size@201-233@lib/libcrypto/ecdsa/ecs_lib.c","lib/libcrypto/ecdsa/ecs_lib.c","ECDSA_size",201,233
6,1,39,5,5,"ECDSA_get_ex_new_index@236-241@lib/libcrypto/ecdsa/ecs_lib.c","lib/libcrypto/ecdsa/ecs_lib.c","ECDSA_get_ex_new_index",236,241
8,2,50,3,7,"ECDSA_set_ex_data@244-251@lib/libcrypto/ecdsa/ecs_lib.c","lib/libcrypto/ecdsa/ecs_lib.c","ECDSA_set_ex_data",244,251
8,2,44,2,7,"ECDSA_get_ex_data@254-261@lib/libcrypto/ecdsa/ecs_lib.c","lib/libcrypto/ecdsa/ecs_lib.c","ECDSA_get_ex_data",254,261
4,1,10,1,3,"ECDSA_OpenSSL@83-86@lib/libcrypto/ecdsa/ecs_ossl.c","lib/libcrypto/ecdsa/ecs_ossl.c","ECDSA_OpenSSL",83,86
93,25,528,4,111,"ecdsa_sign_setup@89-200@lib/libcrypto/ecdsa/ecs_ossl.c","lib/libcrypto/ecdsa/ecs_ossl.c","ecdsa_sign_setup",89,200
91,26,558,5,105,"ecdsa_do_sign@204-309@lib/libcrypto/ecdsa/ecs_ossl.c","lib/libcrypto/ecdsa/ecs_ossl.c","ecdsa_do_sign",204,309
98,27,616,4,115,"ecdsa_do_verify@312-427@lib/libcrypto/ecdsa/ecs_ossl.c","lib/libcrypto/ecdsa/ecs_ossl.c","ecdsa_do_verify",312,427
4,1,31,3,3,"ECDSA_do_sign@64-67@lib/libcrypto/ecdsa/ecs_sign.c","lib/libcrypto/ecdsa/ecs_sign.c","ECDSA_do_sign",64,67
8,2,63,5,8,"ECDSA_do_sign_ex@70-78@lib/libcrypto/ecdsa/ecs_sign.c","lib/libcrypto/ecdsa/ecs_sign.c","ECDSA_do_sign_ex",70,78
5,1,50,6,4,"ECDSA_sign@81-85@lib/libcrypto/ecdsa/ecs_sign.c","lib/libcrypto/ecdsa/ecs_sign.c","ECDSA_sign",81,85
13,2,94,8,13,"ECDSA_sign_ex@88-101@lib/libcrypto/ecdsa/ecs_sign.c","lib/libcrypto/ecdsa/ecs_sign.c","ECDSA_sign_ex",88,101
7,2,54,4,7,"ECDSA_sign_setup@104-111@lib/libcrypto/ecdsa/ecs_sign.c","lib/libcrypto/ecdsa/ecs_sign.c","ECDSA_sign_setup",104,111
8,2,56,4,8,"ECDSA_do_verify@73-81@lib/libcrypto/ecdsa/ecs_vrf.c","lib/libcrypto/ecdsa/ecs_vrf.c","ECDSA_do_verify",73,81
22,5,155,6,24,"ECDSA_verify@89-113@lib/libcrypto/ecdsa/ecs_vrf.c","lib/libcrypto/ecdsa/ecs_vrf.c","ECDSA_verify",89,113
10,3,40,1,12,"ENGINE_load_aesni@100-112@lib/libcrypto/engine/eng_aesni.c","lib/libcrypto/engine/eng_aesni.c","ENGINE_load_aesni",100,112
90,24,618,7,97,"aesni_cfb128_encrypt@152-249@lib/libcrypto/engine/eng_aesni.c","lib/libcrypto/engine/eng_aesni.c","aesni_cfb128_encrypt",152,249
42,12,294,6,47,"aesni_ofb128_encrypt@256-303@lib/libcrypto/engine/eng_aesni.c","lib/libcrypto/engine/eng_aesni.c","aesni_ofb128_encrypt",256,303
11,7,71,1,15,"aesni_bind_helper@308-323@lib/libcrypto/engine/eng_aesni.c","lib/libcrypto/engine/eng_aesni.c","aesni_bind_helper",308,323
12,3,45,1,14,"ENGINE_aesni@327-341@lib/libcrypto/engine/eng_aesni.c","lib/libcrypto/engine/eng_aesni.c","ENGINE_aesni",327,341
4,1,11,1,3,"aesni_init@345-348@lib/libcrypto/engine/eng_aesni.c","lib/libcrypto/engine/eng_aesni.c","aesni_init",345,348
17,5,115,4,19,"aesni_init_key@400-419@lib/libcrypto/engine/eng_aesni.c","lib/libcrypto/engine/eng_aesni.c","aesni_init_key",400,419
7,1,51,4,7,"aesni_cipher_ecb@422-429@lib/libcrypto/engine/eng_aesni.c","lib/libcrypto/engine/eng_aesni.c","aesni_cipher_ecb",422,429
7,1,55,4,7,"aesni_cipher_cbc@432-439@lib/libcrypto/engine/eng_aesni.c","lib/libcrypto/engine/eng_aesni.c","aesni_cipher_cbc",432,439
8,1,60,4,8,"aesni_cipher_cfb@442-450@lib/libcrypto/engine/eng_aesni.c","lib/libcrypto/engine/eng_aesni.c","aesni_cipher_cfb",442,450
7,1,56,4,7,"aesni_cipher_ofb@453-460@lib/libcrypto/engine/eng_aesni.c","lib/libcrypto/engine/eng_aesni.c","aesni_cipher_ofb",453,460
49,14,187,4,55,"aesni_ciphers@504-559@lib/libcrypto/engine/eng_aesni.c","lib/libcrypto/engine/eng_aesni.c","aesni_ciphers",504,559
6,1,18,1,13,"ENGINE_load_builtin_engines@65-78@lib/libcrypto/engine/eng_all.c","lib/libcrypto/engine/eng_all.c","ENGINE_load_builtin_engines",65,78
8,2,33,1,8,"skip_dot@71-79@lib/libcrypto/engine/eng_cnf.c","lib/libcrypto/engine/eng_cnf.c","skip_dot",71,79
12,5,56,1,11,"int_engine_init@84-95@lib/libcrypto/engine/eng_cnf.c","lib/libcrypto/engine/eng_cnf.c","int_engine_init",84,95
87,31,506,3,107,"int_engine_configure@99-206@lib/libcrypto/engine/eng_cnf.c","lib/libcrypto/engine/eng_cnf.c","int_engine_configure",99,206
19,5,120,2,25,"int_engine_module_init@210-235@lib/libcrypto/engine/eng_cnf.c","lib/libcrypto/engine/eng_cnf.c","int_engine_module_init",210,235
8,2,37,1,8,"int_engine_module_finish@238-246@lib/libcrypto/engine/eng_cnf.c","lib/libcrypto/engine/eng_cnf.c","int_engine_module_finish",238,246
5,1,15,1,4,"ENGINE_add_conf_module@249-253@lib/libcrypto/engine/eng_cnf.c","lib/libcrypto/engine/eng_cnf.c","ENGINE_add_conf_module",249,253
6,3,33,1,5,"int_ctrl_cmd_is_null@71-76@lib/libcrypto/engine/eng_ctrl.c","lib/libcrypto/engine/eng_ctrl.c","int_ctrl_cmd_is_null",71,76
12,4,62,2,12,"int_ctrl_cmd_by_name@79-91@lib/libcrypto/engine/eng_ctrl.c","lib/libcrypto/engine/eng_ctrl.c","int_ctrl_cmd_by_name",79,91
11,4,57,2,13,"int_ctrl_cmd_by_num@94-107@lib/libcrypto/engine/eng_ctrl.c","lib/libcrypto/engine/eng_ctrl.c","int_ctrl_cmd_by_num",94,107
71,25,497,5,80,"int_ctrl_helper@110-190@lib/libcrypto/engine/eng_ctrl.c","lib/libcrypto/engine/eng_ctrl.c","int_ctrl_helper",110,190
41,18,219,5,47,"ENGINE_ctrl@193-240@lib/libcrypto/engine/eng_ctrl.c","lib/libcrypto/engine/eng_ctrl.c","ENGINE_ctrl",193,240
14,5,74,2,14,"ENGINE_cmd_is_executable@243-257@lib/libcrypto/engine/eng_ctrl.c","lib/libcrypto/engine/eng_ctrl.c","ENGINE_cmd_is_executable",243,257
22,7,140,6,32,"ENGINE_ctrl_cmd@260-292@lib/libcrypto/engine/eng_ctrl.c","lib/libcrypto/engine/eng_ctrl.c","ENGINE_ctrl_cmd",260,292
60,18,347,4,84,"ENGINE_ctrl_cmd_string@295-379@lib/libcrypto/engine/eng_ctrl.c","lib/libcrypto/engine/eng_ctrl.c","ENGINE_ctrl_cmd_string",295,379
3,1,6,1,2,"ENGINE_load_dynamic@62-64@lib/libcrypto/engine/eng_dyn.c","lib/libcrypto/engine/eng_dyn.c","ENGINE_load_dynamic",62,64
7,2,36,1,8,"ERR_load_ENGINE_strings@127-135@lib/libcrypto/engine/eng_err.c","lib/libcrypto/engine/eng_err.c","ERR_load_ENGINE_strings",127,135
26,21,185,2,35,"ENGINE_set_default@70-105@lib/libcrypto/engine/eng_fat.c","lib/libcrypto/engine/eng_fat.c","ENGINE_set_default",70,105
32,13,247,3,32,"int_def_cb@110-142@lib/libcrypto/engine/eng_fat.c","lib/libcrypto/engine/eng_fat.c","int_def_cb",110,142
10,2,61,2,10,"ENGINE_set_default_string@145-155@lib/libcrypto/engine/eng_fat.c","lib/libcrypto/engine/eng_fat.c","ENGINE_set_default_string",145,155
13,1,56,1,22,"ENGINE_register_complete@158-180@lib/libcrypto/engine/eng_fat.c","lib/libcrypto/engine/eng_fat.c","ENGINE_register_complete",158,180
8,3,46,1,8,"ENGINE_register_all_complete@183-191@lib/libcrypto/engine/eng_fat.c","lib/libcrypto/engine/eng_fat.c","ENGINE_register_all_complete",183,191
13,4,71,1,17,"engine_unlocked_init@63-80@lib/libcrypto/engine/eng_init.c","lib/libcrypto/engine/eng_init.c","engine_unlocked_init",63,80
20,7,105,2,28,"engine_unlocked_finish@85-113@lib/libcrypto/engine/eng_init.c","lib/libcrypto/engine/eng_init.c","engine_unlocked_finish",85,113
12,2,47,1,12,"ENGINE_init@117-129@lib/libcrypto/engine/eng_init.c","lib/libcrypto/engine/eng_init.c","ENGINE_init",117,129
16,3,66,1,16,"ENGINE_finish@133-149@lib/libcrypto/engine/eng_init.c","lib/libcrypto/engine/eng_init.c","ENGINE_finish",133,149
14,2,77,1,14,"ENGINE_new@69-83@lib/libcrypto/engine/eng_lib.c","lib/libcrypto/engine/eng_lib.c","ENGINE_new",69,83
20,1,110,1,19,"engine_set_all_null@89-108@lib/libcrypto/engine/eng_lib.c","lib/libcrypto/engine/eng_lib.c","engine_set_all_null",89,108
22,5,118,2,26,"engine_free_util@111-137@lib/libcrypto/engine/eng_lib.c","lib/libcrypto/engine/eng_lib.c","engine_free_util",111,137
4,1,16,1,3,"ENGINE_free@140-143@lib/libcrypto/engine/eng_lib.c","lib/libcrypto/engine/eng_lib.c","ENGINE_free",140,143
9,4,37,1,8,"int_cleanup_check@153-161@lib/libcrypto/engine/eng_lib.c","lib/libcrypto/engine/eng_lib.c","int_cleanup_check",153,161
8,2,37,1,8,"int_cleanup_item@164-172@lib/libcrypto/engine/eng_lib.c","lib/libcrypto/engine/eng_lib.c","int_cleanup_item",164,172
9,3,42,1,9,"engine_cleanup_add_first@175-184@lib/libcrypto/engine/eng_lib.c","lib/libcrypto/engine/eng_lib.c","engine_cleanup_add_first",175,184
9,3,40,1,9,"engine_cleanup_add_last@187-196@lib/libcrypto/engine/eng_lib.c","lib/libcrypto/engine/eng_lib.c","engine_cleanup_add_last",187,196
5,1,24,1,4,"engine_cleanup_cb_free@199-203@lib/libcrypto/engine/eng_lib.c","lib/libcrypto/engine/eng_lib.c","engine_cleanup_cb_free",199,203
9,2,31,1,10,"ENGINE_cleanup@206-216@lib/libcrypto/engine/eng_lib.c","lib/libcrypto/engine/eng_lib.c","ENGINE_cleanup",206,216
6,1,39,5,5,"ENGINE_get_ex_new_index@221-226@lib/libcrypto/engine/eng_lib.c","lib/libcrypto/engine/eng_lib.c","ENGINE_get_ex_new_index",221,226
4,1,30,3,3,"ENGINE_set_ex_data@229-232@lib/libcrypto/engine/eng_lib.c","lib/libcrypto/engine/eng_lib.c","ENGINE_set_ex_data",229,232
4,1,25,2,3,"ENGINE_get_ex_data@235-238@lib/libcrypto/engine/eng_lib.c","lib/libcrypto/engine/eng_lib.c","ENGINE_get_ex_data",235,238
9,2,38,2,8,"ENGINE_set_id@244-252@lib/libcrypto/engine/eng_lib.c","lib/libcrypto/engine/eng_lib.c","ENGINE_set_id",244,252
9,2,38,2,8,"ENGINE_set_name@255-263@lib/libcrypto/engine/eng_lib.c","lib/libcrypto/engine/eng_lib.c","ENGINE_set_name",255,263
5,1,20,2,4,"ENGINE_set_destroy_function@266-270@lib/libcrypto/engine/eng_lib.c","lib/libcrypto/engine/eng_lib.c","ENGINE_set_destroy_function",266,270
5,1,20,2,4,"ENGINE_set_init_function@273-277@lib/libcrypto/engine/eng_lib.c","lib/libcrypto/engine/eng_lib.c","ENGINE_set_init_function",273,277
5,1,20,2,4,"ENGINE_set_finish_function@280-284@lib/libcrypto/engine/eng_lib.c","lib/libcrypto/engine/eng_lib.c","ENGINE_set_finish_function",280,284
5,1,20,2,4,"ENGINE_set_ctrl_function@287-291@lib/libcrypto/engine/eng_lib.c","lib/libcrypto/engine/eng_lib.c","ENGINE_set_ctrl_function",287,291
5,1,20,2,4,"ENGINE_set_flags@294-298@lib/libcrypto/engine/eng_lib.c","lib/libcrypto/engine/eng_lib.c","ENGINE_set_flags",294,298
5,1,22,2,4,"ENGINE_set_cmd_defns@301-305@lib/libcrypto/engine/eng_lib.c","lib/libcrypto/engine/eng_lib.c","ENGINE_set_cmd_defns",301,305
4,1,14,1,3,"ENGINE_get_id@308-311@lib/libcrypto/engine/eng_lib.c","lib/libcrypto/engine/eng_lib.c","ENGINE_get_id",308,311
4,1,14,1,3,"ENGINE_get_name@314-317@lib/libcrypto/engine/eng_lib.c","lib/libcrypto/engine/eng_lib.c","ENGINE_get_name",314,317
4,1,14,1,3,"ENGINE_get_destroy_function@320-323@lib/libcrypto/engine/eng_lib.c","lib/libcrypto/engine/eng_lib.c","ENGINE_get_destroy_function",320,323
4,1,14,1,3,"ENGINE_get_init_function@326-329@lib/libcrypto/engine/eng_lib.c","lib/libcrypto/engine/eng_lib.c","ENGINE_get_init_function",326,329
4,1,14,1,3,"ENGINE_get_finish_function@332-335@lib/libcrypto/engine/eng_lib.c","lib/libcrypto/engine/eng_lib.c","ENGINE_get_finish_function",332,335
4,1,14,1,3,"ENGINE_get_ctrl_function@338-341@lib/libcrypto/engine/eng_lib.c","lib/libcrypto/engine/eng_lib.c","ENGINE_get_ctrl_function",338,341
4,1,14,1,3,"ENGINE_get_flags@344-347@lib/libcrypto/engine/eng_lib.c","lib/libcrypto/engine/eng_lib.c","ENGINE_get_flags",344,347
4,1,14,1,3,"ENGINE_get_cmd_defns@350-353@lib/libcrypto/engine/eng_lib.c","lib/libcrypto/engine/eng_lib.c","ENGINE_get_cmd_defns",350,353
4,1,10,1,3,"ENGINE_get_static_state@361-364@lib/libcrypto/engine/eng_lib.c","lib/libcrypto/engine/eng_lib.c","ENGINE_get_static_state",361,364
6,3,27,1,6,"engine_list_cleanup@91-97@lib/libcrypto/engine/eng_list.c","lib/libcrypto/engine/eng_list.c","engine_list_cleanup",91,97
40,9,189,1,47,"engine_list_add@102-149@lib/libcrypto/engine/eng_list.c","lib/libcrypto/engine/eng_list.c","engine_list_add",102,149
25,9,130,1,28,"engine_list_remove@152-180@lib/libcrypto/engine/eng_list.c","lib/libcrypto/engine/eng_list.c","engine_list_remove",152,180
12,2,46,1,12,"ENGINE_get_first@184-196@lib/libcrypto/engine/eng_list.c","lib/libcrypto/engine/eng_list.c","ENGINE_get_first",184,196
12,2,46,1,12,"ENGINE_get_last@199-211@lib/libcrypto/engine/eng_list.c","lib/libcrypto/engine/eng_list.c","ENGINE_get_last",199,211
17,3,73,1,19,"ENGINE_get_next@215-234@lib/libcrypto/engine/eng_list.c","lib/libcrypto/engine/eng_list.c","ENGINE_get_next",215,234
17,3,73,1,19,"ENGINE_get_prev@237-256@lib/libcrypto/engine/eng_list.c","lib/libcrypto/engine/eng_list.c","ENGINE_get_prev",237,256
18,5,86,1,18,"ENGINE_add@260-278@lib/libcrypto/engine/eng_list.c","lib/libcrypto/engine/eng_list.c","ENGINE_add",260,278
15,3,61,1,15,"ENGINE_remove@282-297@lib/libcrypto/engine/eng_list.c","lib/libcrypto/engine/eng_list.c","ENGINE_remove",282,297
23,1,173,2,32,"engine_cpy@300-332@lib/libcrypto/engine/eng_list.c","lib/libcrypto/engine/eng_list.c","engine_cpy",300,332
32,8,152,1,36,"ENGINE_by_id@335-371@lib/libcrypto/engine/eng_list.c","lib/libcrypto/engine/eng_list.c","ENGINE_by_id",335,371
9,2,39,1,8,"ENGINE_up_ref@374-382@lib/libcrypto/engine/eng_list.c","lib/libcrypto/engine/eng_list.c","ENGINE_up_ref",374,382
17,15,116,1,36,"bind_helper@137-173@lib/libcrypto/engine/eng_openssl.c","lib/libcrypto/engine/eng_openssl.c","bind_helper",137,173
11,3,43,1,11,"engine_openssl@176-187@lib/libcrypto/engine/eng_openssl.c","lib/libcrypto/engine/eng_openssl.c","engine_openssl",176,187
9,2,38,1,11,"ENGINE_load_openssl@190-201@lib/libcrypto/engine/eng_openssl.c","lib/libcrypto/engine/eng_openssl.c","ENGINE_load_openssl",190,201
8,4,45,2,7,"bind_fn@207-214@lib/libcrypto/engine/eng_openssl.c","lib/libcrypto/engine/eng_openssl.c","bind_fn",207,214
9,2,77,4,10,"test_rc4_init_key@242-252@lib/libcrypto/engine/eng_openssl.c","lib/libcrypto/engine/eng_openssl.c","test_rc4_init_key",242,252
7,2,49,4,8,"test_rc4_cipher@255-263@lib/libcrypto/engine/eng_openssl.c","lib/libcrypto/engine/eng_openssl.c","test_rc4_cipher",255,263
18,5,85,4,21,"openssl_ciphers@294-315@lib/libcrypto/engine/eng_openssl.c","lib/libcrypto/engine/eng_openssl.c","openssl_ciphers",294,315
5,2,23,1,6,"test_sha1_init@325-331@lib/libcrypto/engine/eng_openssl.c","lib/libcrypto/engine/eng_openssl.c","test_sha1_init",325,331
5,2,35,3,6,"test_sha1_update@334-340@lib/libcrypto/engine/eng_openssl.c","lib/libcrypto/engine/eng_openssl.c","test_sha1_update",334,340
5,2,30,2,6,"test_sha1_final@343-349@lib/libcrypto/engine/eng_openssl.c","lib/libcrypto/engine/eng_openssl.c","test_sha1_final",343,349
16,4,72,4,19,"openssl_digests@367-386@lib/libcrypto/engine/eng_openssl.c","lib/libcrypto/engine/eng_openssl.c","openssl_digests",367,386
14,2,76,4,14,"openssl_load_privkey@391-405@lib/libcrypto/engine/eng_openssl.c","lib/libcrypto/engine/eng_openssl.c","openssl_load_privkey",391,405
9,3,35,1,11,"ENGINE_load_padlock@114-125@lib/libcrypto/engine/eng_padlock.c","lib/libcrypto/engine/eng_padlock.c","ENGINE_load_padlock",114,125
17,10,102,1,30,"padlock_bind_helper@166-196@lib/libcrypto/engine/eng_padlock.c","lib/libcrypto/engine/eng_padlock.c","padlock_bind_helper",166,196
12,3,45,1,14,"ENGINE_padlock@202-216@lib/libcrypto/engine/eng_padlock.c","lib/libcrypto/engine/eng_padlock.c","ENGINE_padlock",202,216
4,2,15,1,3,"padlock_init@222-225@lib/libcrypto/engine/eng_padlock.c","lib/libcrypto/engine/eng_padlock.c","padlock_init",222,225
10,4,49,2,11,"padlock_bind_fn@232-243@lib/libcrypto/engine/eng_padlock.c","lib/libcrypto/engine/eng_padlock.c","padlock_bind_fn",232,243
19,1,46,1,22,"padlock_insn_cpuid_available@313-335@lib/libcrypto/engine/eng_padlock.c","lib/libcrypto/engine/eng_padlock.c","padlock_insn_cpuid_available",313,335
30,4,179,1,40,"padlock_available@340-380@lib/libcrypto/engine/eng_padlock.c","lib/libcrypto/engine/eng_padlock.c","padlock_available",340,380
9,2,59,1,9,"padlock_bswapl@385-394@lib/libcrypto/engine/eng_padlock.c","lib/libcrypto/engine/eng_padlock.c","padlock_bswapl",385,394
4,1,12,1,3,"padlock_reload_key@401-404@lib/libcrypto/engine/eng_padlock.c","lib/libcrypto/engine/eng_padlock.c","padlock_reload_key",401,404
15,1,40,1,14,"padlock_verify_context@417-431@lib/libcrypto/engine/eng_padlock.c","lib/libcrypto/engine/eng_padlock.c","padlock_verify_context",417,431
9,1,49,2,10,"padlock_xstore@464-474@lib/libcrypto/engine/eng_padlock.c","lib/libcrypto/engine/eng_padlock.c","padlock_xstore",464,474
9,2,57,3,10,"padlock_memcpy@488-498@lib/libcrypto/engine/eng_padlock.c","lib/libcrypto/engine/eng_padlock.c","padlock_memcpy",488,498
49,14,187,4,53,"padlock_ciphers@599-652@lib/libcrypto/engine/eng_padlock.c","lib/libcrypto/engine/eng_padlock.c","padlock_ciphers",599,652
37,9,252,4,62,"padlock_aes_init_key@656-718@lib/libcrypto/engine/eng_padlock.c","lib/libcrypto/engine/eng_padlock.c","padlock_aes_init_key",656,718
36,5,221,4,43,"padlock_aes_cipher_omnivorous@727-770@lib/libcrypto/engine/eng_padlock.c","lib/libcrypto/engine/eng_padlock.c","padlock_aes_cipher_omnivorous",727,770
207,52,1233,4,269,"padlock_aes_cipher@782-1051@lib/libcrypto/engine/eng_padlock.c","lib/libcrypto/engine/eng_padlock.c","padlock_aes_cipher",782,1051
32,11,201,2,35,"padlock_rand_bytes@1065-1100@lib/libcrypto/engine/eng_padlock.c","lib/libcrypto/engine/eng_padlock.c","padlock_rand_bytes",1065,1100
4,1,9,1,3,"padlock_rand_status@1104-1107@lib/libcrypto/engine/eng_padlock.c","lib/libcrypto/engine/eng_padlock.c","padlock_rand_status",1104,1107
3,1,21,3,2,"bind_engine@1120-1122@lib/libcrypto/engine/eng_padlock.c","lib/libcrypto/engine/eng_padlock.c","bind_engine",1120,1122
5,1,20,2,4,"ENGINE_set_load_privkey_function@63-67@lib/libcrypto/engine/eng_pkey.c","lib/libcrypto/engine/eng_pkey.c","ENGINE_set_load_privkey_function",63,67
5,1,20,2,4,"ENGINE_set_load_pubkey_function@70-74@lib/libcrypto/engine/eng_pkey.c","lib/libcrypto/engine/eng_pkey.c","ENGINE_set_load_pubkey_function",70,74
6,1,20,2,5,"ENGINE_set_load_ssl_client_cert_function@77-82@lib/libcrypto/engine/eng_pkey.c","lib/libcrypto/engine/eng_pkey.c","ENGINE_set_load_ssl_client_cert_function",77,82
4,1,14,1,3,"ENGINE_get_load_privkey_function@85-88@lib/libcrypto/engine/eng_pkey.c","lib/libcrypto/engine/eng_pkey.c","ENGINE_get_load_privkey_function",85,88
4,1,14,1,3,"ENGINE_get_load_pubkey_function@91-94@lib/libcrypto/engine/eng_pkey.c","lib/libcrypto/engine/eng_pkey.c","ENGINE_get_load_pubkey_function",91,94
4,1,14,1,3,"ENGINE_get_ssl_client_cert_function@97-100@lib/libcrypto/engine/eng_pkey.c","lib/libcrypto/engine/eng_pkey.c","ENGINE_get_ssl_client_cert_function",97,100
26,5,124,4,26,"ENGINE_load_private_key@105-131@lib/libcrypto/engine/eng_pkey.c","lib/libcrypto/engine/eng_pkey.c","ENGINE_load_private_key",105,131
26,5,124,4,26,"ENGINE_load_public_key@134-160@lib/libcrypto/engine/eng_pkey.c","lib/libcrypto/engine/eng_pkey.c","ENGINE_load_public_key",134,160
22,4,130,8,21,"ENGINE_load_ssl_client_cert@163-184@lib/libcrypto/engine/eng_pkey.c","lib/libcrypto/engine/eng_pkey.c","ENGINE_load_ssl_client_cert",163,184
4,1,9,1,3,"ENGINE_get_table_flags@91-94@lib/libcrypto/engine/eng_table.c","lib/libcrypto/engine/eng_table.c","ENGINE_get_table_flags",91,94
4,1,12,1,3,"ENGINE_set_table_flags@97-100@lib/libcrypto/engine/eng_table.c","lib/libcrypto/engine/eng_table.c","ENGINE_set_table_flags",97,100
4,1,14,1,3,"engine_pile_hash@104-107@lib/libcrypto/engine/eng_table.c","lib/libcrypto/engine/eng_table.c","engine_pile_hash",104,107
4,1,23,2,3,"engine_pile_cmp@110-113@lib/libcrypto/engine/eng_table.c","lib/libcrypto/engine/eng_table.c","engine_pile_cmp",110,113
12,4,60,2,12,"int_table_check@118-130@lib/libcrypto/engine/eng_table.c","lib/libcrypto/engine/eng_table.c","int_table_check",118,130
50,12,297,6,54,"engine_table_register@135-189@lib/libcrypto/engine/eng_table.c","lib/libcrypto/engine/eng_table.c","engine_table_register",135,189
12,3,75,2,13,"int_unregister_cb_doall_arg@192-205@lib/libcrypto/engine/eng_table.c","lib/libcrypto/engine/eng_table.c","int_unregister_cb_doall_arg",192,205
8,2,50,2,7,"engine_table_unregister@209-216@lib/libcrypto/engine/eng_table.c","lib/libcrypto/engine/eng_table.c","engine_table_unregister",209,216
7,2,35,1,6,"int_cleanup_cb_doall@219-225@lib/libcrypto/engine/eng_table.c","lib/libcrypto/engine/eng_table.c","int_cleanup_cb_doall",219,225
11,2,56,1,10,"engine_table_cleanup@229-239@lib/libcrypto/engine/eng_table.c","lib/libcrypto/engine/eng_table.c","engine_table_cleanup",229,239
65,22,393,4,87,"engine_table_select_tmp@247-334@lib/libcrypto/engine/eng_table.c","lib/libcrypto/engine/eng_table.c","engine_table_select_tmp",247,334
4,1,33,2,3,"int_cb_doall_arg@339-342@lib/libcrypto/engine/eng_table.c","lib/libcrypto/engine/eng_table.c","int_cb_doall_arg",339,342
8,1,48,3,8,"engine_table_doall@346-354@lib/libcrypto/engine/eng_table.c","lib/libcrypto/engine/eng_table.c","engine_table_doall",346,354
4,1,16,1,3,"ENGINE_unregister_pkey_asn1_meths@73-76@lib/libcrypto/engine/tb_asnmth.c","lib/libcrypto/engine/tb_asnmth.c","ENGINE_unregister_pkey_asn1_meths",73,76
4,1,12,1,3,"engine_unregister_all_pkey_asn1_meths@79-82@lib/libcrypto/engine/tb_asnmth.c","lib/libcrypto/engine/tb_asnmth.c","engine_unregister_all_pkey_asn1_meths",79,82
12,3,64,1,11,"ENGINE_register_pkey_asn1_meths@85-96@lib/libcrypto/engine/tb_asnmth.c","lib/libcrypto/engine/tb_asnmth.c","ENGINE_register_pkey_asn1_meths",85,96
6,2,32,1,6,"ENGINE_register_all_pkey_asn1_meths@99-105@lib/libcrypto/engine/tb_asnmth.c","lib/libcrypto/engine/tb_asnmth.c","ENGINE_register_all_pkey_asn1_meths",99,105
12,3,64,1,11,"ENGINE_set_default_pkey_asn1_meths@108-119@lib/libcrypto/engine/tb_asnmth.c","lib/libcrypto/engine/tb_asnmth.c","ENGINE_set_default_pkey_asn1_meths",108,119
4,1,16,1,3,"ENGINE_get_pkey_asn1_meth_engine@125-128@lib/libcrypto/engine/tb_asnmth.c","lib/libcrypto/engine/tb_asnmth.c","ENGINE_get_pkey_asn1_meth_engine",125,128
10,3,54,2,10,"ENGINE_get_pkey_asn1_meth@132-142@lib/libcrypto/engine/tb_asnmth.c","lib/libcrypto/engine/tb_asnmth.c","ENGINE_get_pkey_asn1_meth",132,142
4,1,14,1,3,"ENGINE_get_pkey_asn1_meths@146-149@lib/libcrypto/engine/tb_asnmth.c","lib/libcrypto/engine/tb_asnmth.c","ENGINE_get_pkey_asn1_meths",146,149
5,1,20,2,4,"ENGINE_set_pkey_asn1_meths@153-157@lib/libcrypto/engine/tb_asnmth.c","lib/libcrypto/engine/tb_asnmth.c","ENGINE_set_pkey_asn1_meths",153,157
15,4,88,1,15,"engine_pkey_asn1_meths_free@164-179@lib/libcrypto/engine/tb_asnmth.c","lib/libcrypto/engine/tb_asnmth.c","engine_pkey_asn1_meths_free",164,179
18,6,136,3,18,"ENGINE_get_pkey_asn1_meth_str@188-206@lib/libcrypto/engine/tb_asnmth.c","lib/libcrypto/engine/tb_asnmth.c","ENGINE_get_pkey_asn1_meth_str",188,206
18,5,136,4,18,"look_str_cb@216-234@lib/libcrypto/engine/tb_asnmth.c","lib/libcrypto/engine/tb_asnmth.c","look_str_cb",216,234
17,2,100,3,18,"ENGINE_pkey_asn1_find_str@237-255@lib/libcrypto/engine/tb_asnmth.c","lib/libcrypto/engine/tb_asnmth.c","ENGINE_pkey_asn1_find_str",237,255
4,1,16,1,3,"ENGINE_unregister_ciphers@68-71@lib/libcrypto/engine/tb_cipher.c","lib/libcrypto/engine/tb_cipher.c","ENGINE_unregister_ciphers",68,71
4,1,12,1,3,"engine_unregister_all_ciphers@74-77@lib/libcrypto/engine/tb_cipher.c","lib/libcrypto/engine/tb_cipher.c","engine_unregister_all_ciphers",74,77
12,3,64,1,11,"ENGINE_register_ciphers@80-91@lib/libcrypto/engine/tb_cipher.c","lib/libcrypto/engine/tb_cipher.c","ENGINE_register_ciphers",80,91
6,2,32,1,6,"ENGINE_register_all_ciphers@94-100@lib/libcrypto/engine/tb_cipher.c","lib/libcrypto/engine/tb_cipher.c","ENGINE_register_all_ciphers",94,100
12,3,64,1,11,"ENGINE_set_default_ciphers@103-114@lib/libcrypto/engine/tb_cipher.c","lib/libcrypto/engine/tb_cipher.c","ENGINE_set_default_ciphers",103,114
4,1,16,1,3,"ENGINE_get_cipher_engine@120-123@lib/libcrypto/engine/tb_cipher.c","lib/libcrypto/engine/tb_cipher.c","ENGINE_get_cipher_engine",120,123
10,3,55,2,10,"ENGINE_get_cipher@127-137@lib/libcrypto/engine/tb_cipher.c","lib/libcrypto/engine/tb_cipher.c","ENGINE_get_cipher",127,137
4,1,14,1,3,"ENGINE_get_ciphers@141-144@lib/libcrypto/engine/tb_cipher.c","lib/libcrypto/engine/tb_cipher.c","ENGINE_get_ciphers",141,144
5,1,20,2,4,"ENGINE_set_ciphers@148-152@lib/libcrypto/engine/tb_cipher.c","lib/libcrypto/engine/tb_cipher.c","ENGINE_set_ciphers",148,152
4,1,16,1,3,"ENGINE_unregister_DH@67-70@lib/libcrypto/engine/tb_dh.c","lib/libcrypto/engine/tb_dh.c","ENGINE_unregister_DH",67,70
4,1,12,1,3,"engine_unregister_all_DH@73-76@lib/libcrypto/engine/tb_dh.c","lib/libcrypto/engine/tb_dh.c","engine_unregister_all_DH",73,76
7,2,35,1,6,"ENGINE_register_DH@79-85@lib/libcrypto/engine/tb_dh.c","lib/libcrypto/engine/tb_dh.c","ENGINE_register_DH",79,85
6,2,32,1,6,"ENGINE_register_all_DH@88-94@lib/libcrypto/engine/tb_dh.c","lib/libcrypto/engine/tb_dh.c","ENGINE_register_all_DH",88,94
7,2,35,1,6,"ENGINE_set_default_DH@97-103@lib/libcrypto/engine/tb_dh.c","lib/libcrypto/engine/tb_dh.c","ENGINE_set_default_DH",97,103
4,1,15,1,3,"ENGINE_get_default_DH@109-112@lib/libcrypto/engine/tb_dh.c","lib/libcrypto/engine/tb_dh.c","ENGINE_get_default_DH",109,112
4,1,14,1,3,"ENGINE_get_DH@116-119@lib/libcrypto/engine/tb_dh.c","lib/libcrypto/engine/tb_dh.c","ENGINE_get_DH",116,119
5,1,22,2,4,"ENGINE_set_DH@123-127@lib/libcrypto/engine/tb_dh.c","lib/libcrypto/engine/tb_dh.c","ENGINE_set_DH",123,127
4,1,16,1,3,"ENGINE_unregister_digests@68-71@lib/libcrypto/engine/tb_digest.c","lib/libcrypto/engine/tb_digest.c","ENGINE_unregister_digests",68,71
4,1,12,1,3,"engine_unregister_all_digests@74-77@lib/libcrypto/engine/tb_digest.c","lib/libcrypto/engine/tb_digest.c","engine_unregister_all_digests",74,77
12,3,64,1,11,"ENGINE_register_digests@80-91@lib/libcrypto/engine/tb_digest.c","lib/libcrypto/engine/tb_digest.c","ENGINE_register_digests",80,91
6,2,32,1,6,"ENGINE_register_all_digests@94-100@lib/libcrypto/engine/tb_digest.c","lib/libcrypto/engine/tb_digest.c","ENGINE_register_all_digests",94,100
12,3,64,1,11,"ENGINE_set_default_digests@103-114@lib/libcrypto/engine/tb_digest.c","lib/libcrypto/engine/tb_digest.c","ENGINE_set_default_digests",103,114
4,1,16,1,3,"ENGINE_get_digest_engine@120-123@lib/libcrypto/engine/tb_digest.c","lib/libcrypto/engine/tb_digest.c","ENGINE_get_digest_engine",120,123
10,3,55,2,10,"ENGINE_get_digest@127-137@lib/libcrypto/engine/tb_digest.c","lib/libcrypto/engine/tb_digest.c","ENGINE_get_digest",127,137
4,1,14,1,3,"ENGINE_get_digests@141-144@lib/libcrypto/engine/tb_digest.c","lib/libcrypto/engine/tb_digest.c","ENGINE_get_digests",141,144
5,1,20,2,4,"ENGINE_set_digests@148-152@lib/libcrypto/engine/tb_digest.c","lib/libcrypto/engine/tb_digest.c","ENGINE_set_digests",148,152
4,1,16,1,3,"ENGINE_unregister_DSA@67-70@lib/libcrypto/engine/tb_dsa.c","lib/libcrypto/engine/tb_dsa.c","ENGINE_unregister_DSA",67,70
4,1,12,1,3,"engine_unregister_all_DSA@73-76@lib/libcrypto/engine/tb_dsa.c","lib/libcrypto/engine/tb_dsa.c","engine_unregister_all_DSA",73,76
7,2,35,1,6,"ENGINE_register_DSA@79-85@lib/libcrypto/engine/tb_dsa.c","lib/libcrypto/engine/tb_dsa.c","ENGINE_register_DSA",79,85
6,2,32,1,6,"ENGINE_register_all_DSA@88-94@lib/libcrypto/engine/tb_dsa.c","lib/libcrypto/engine/tb_dsa.c","ENGINE_register_all_DSA",88,94
7,2,35,1,6,"ENGINE_set_default_DSA@97-103@lib/libcrypto/engine/tb_dsa.c","lib/libcrypto/engine/tb_dsa.c","ENGINE_set_default_DSA",97,103
4,1,15,1,3,"ENGINE_get_default_DSA@109-112@lib/libcrypto/engine/tb_dsa.c","lib/libcrypto/engine/tb_dsa.c","ENGINE_get_default_DSA",109,112
4,1,14,1,3,"ENGINE_get_DSA@116-119@lib/libcrypto/engine/tb_dsa.c","lib/libcrypto/engine/tb_dsa.c","ENGINE_get_DSA",116,119
5,1,22,2,4,"ENGINE_set_DSA@123-127@lib/libcrypto/engine/tb_dsa.c","lib/libcrypto/engine/tb_dsa.c","ENGINE_set_DSA",123,127
4,1,16,1,3,"ENGINE_unregister_ECDH@81-84@lib/libcrypto/engine/tb_ecdh.c","lib/libcrypto/engine/tb_ecdh.c","ENGINE_unregister_ECDH",81,84
4,1,12,1,3,"engine_unregister_all_ECDH@87-90@lib/libcrypto/engine/tb_ecdh.c","lib/libcrypto/engine/tb_ecdh.c","engine_unregister_all_ECDH",87,90
7,2,35,1,6,"ENGINE_register_ECDH@93-99@lib/libcrypto/engine/tb_ecdh.c","lib/libcrypto/engine/tb_ecdh.c","ENGINE_register_ECDH",93,99
6,2,32,1,6,"ENGINE_register_all_ECDH@102-108@lib/libcrypto/engine/tb_ecdh.c","lib/libcrypto/engine/tb_ecdh.c","ENGINE_register_all_ECDH",102,108
7,2,35,1,6,"ENGINE_set_default_ECDH@111-117@lib/libcrypto/engine/tb_ecdh.c","lib/libcrypto/engine/tb_ecdh.c","ENGINE_set_default_ECDH",111,117
4,1,15,1,3,"ENGINE_get_default_ECDH@123-126@lib/libcrypto/engine/tb_ecdh.c","lib/libcrypto/engine/tb_ecdh.c","ENGINE_get_default_ECDH",123,126
4,1,14,1,3,"ENGINE_get_ECDH@130-133@lib/libcrypto/engine/tb_ecdh.c","lib/libcrypto/engine/tb_ecdh.c","ENGINE_get_ECDH",130,133
5,1,22,2,4,"ENGINE_set_ECDH@137-141@lib/libcrypto/engine/tb_ecdh.c","lib/libcrypto/engine/tb_ecdh.c","ENGINE_set_ECDH",137,141
4,1,16,1,3,"ENGINE_unregister_ECDSA@67-70@lib/libcrypto/engine/tb_ecdsa.c","lib/libcrypto/engine/tb_ecdsa.c","ENGINE_unregister_ECDSA",67,70
4,1,12,1,3,"engine_unregister_all_ECDSA@73-76@lib/libcrypto/engine/tb_ecdsa.c","lib/libcrypto/engine/tb_ecdsa.c","engine_unregister_all_ECDSA",73,76
7,2,35,1,6,"ENGINE_register_ECDSA@79-85@lib/libcrypto/engine/tb_ecdsa.c","lib/libcrypto/engine/tb_ecdsa.c","ENGINE_register_ECDSA",79,85
6,2,32,1,6,"ENGINE_register_all_ECDSA@88-94@lib/libcrypto/engine/tb_ecdsa.c","lib/libcrypto/engine/tb_ecdsa.c","ENGINE_register_all_ECDSA",88,94
7,2,35,1,6,"ENGINE_set_default_ECDSA@97-103@lib/libcrypto/engine/tb_ecdsa.c","lib/libcrypto/engine/tb_ecdsa.c","ENGINE_set_default_ECDSA",97,103
4,1,15,1,3,"ENGINE_get_default_ECDSA@109-112@lib/libcrypto/engine/tb_ecdsa.c","lib/libcrypto/engine/tb_ecdsa.c","ENGINE_get_default_ECDSA",109,112
4,1,14,1,3,"ENGINE_get_ECDSA@116-119@lib/libcrypto/engine/tb_ecdsa.c","lib/libcrypto/engine/tb_ecdsa.c","ENGINE_get_ECDSA",116,119
5,1,22,2,4,"ENGINE_set_ECDSA@123-127@lib/libcrypto/engine/tb_ecdsa.c","lib/libcrypto/engine/tb_ecdsa.c","ENGINE_set_ECDSA",123,127
4,1,16,1,3,"ENGINE_unregister_pkey_meths@69-72@lib/libcrypto/engine/tb_pkmeth.c","lib/libcrypto/engine/tb_pkmeth.c","ENGINE_unregister_pkey_meths",69,72
4,1,12,1,3,"engine_unregister_all_pkey_meths@75-78@lib/libcrypto/engine/tb_pkmeth.c","lib/libcrypto/engine/tb_pkmeth.c","engine_unregister_all_pkey_meths",75,78
12,3,64,1,11,"ENGINE_register_pkey_meths@81-92@lib/libcrypto/engine/tb_pkmeth.c","lib/libcrypto/engine/tb_pkmeth.c","ENGINE_register_pkey_meths",81,92
6,2,32,1,6,"ENGINE_register_all_pkey_meths@95-101@lib/libcrypto/engine/tb_pkmeth.c","lib/libcrypto/engine/tb_pkmeth.c","ENGINE_register_all_pkey_meths",95,101
12,3,64,1,11,"ENGINE_set_default_pkey_meths@104-115@lib/libcrypto/engine/tb_pkmeth.c","lib/libcrypto/engine/tb_pkmeth.c","ENGINE_set_default_pkey_meths",104,115
4,1,16,1,3,"ENGINE_get_pkey_meth_engine@121-124@lib/libcrypto/engine/tb_pkmeth.c","lib/libcrypto/engine/tb_pkmeth.c","ENGINE_get_pkey_meth_engine",121,124
10,3,54,2,10,"ENGINE_get_pkey_meth@128-138@lib/libcrypto/engine/tb_pkmeth.c","lib/libcrypto/engine/tb_pkmeth.c","ENGINE_get_pkey_meth",128,138
4,1,14,1,3,"ENGINE_get_pkey_meths@142-145@lib/libcrypto/engine/tb_pkmeth.c","lib/libcrypto/engine/tb_pkmeth.c","ENGINE_get_pkey_meths",142,145
5,1,20,2,4,"ENGINE_set_pkey_meths@149-153@lib/libcrypto/engine/tb_pkmeth.c","lib/libcrypto/engine/tb_pkmeth.c","ENGINE_set_pkey_meths",149,153
15,4,88,1,15,"engine_pkey_meths_free@160-175@lib/libcrypto/engine/tb_pkmeth.c","lib/libcrypto/engine/tb_pkmeth.c","engine_pkey_meths_free",160,175
4,1,16,1,3,"ENGINE_unregister_RAND@67-70@lib/libcrypto/engine/tb_rand.c","lib/libcrypto/engine/tb_rand.c","ENGINE_unregister_RAND",67,70
4,1,12,1,3,"engine_unregister_all_RAND@73-76@lib/libcrypto/engine/tb_rand.c","lib/libcrypto/engine/tb_rand.c","engine_unregister_all_RAND",73,76
7,2,35,1,6,"ENGINE_register_RAND@79-85@lib/libcrypto/engine/tb_rand.c","lib/libcrypto/engine/tb_rand.c","ENGINE_register_RAND",79,85
6,2,32,1,6,"ENGINE_register_all_RAND@88-94@lib/libcrypto/engine/tb_rand.c","lib/libcrypto/engine/tb_rand.c","ENGINE_register_all_RAND",88,94
7,2,35,1,6,"ENGINE_set_default_RAND@97-103@lib/libcrypto/engine/tb_rand.c","lib/libcrypto/engine/tb_rand.c","ENGINE_set_default_RAND",97,103
4,1,15,1,3,"ENGINE_get_default_RAND@109-112@lib/libcrypto/engine/tb_rand.c","lib/libcrypto/engine/tb_rand.c","ENGINE_get_default_RAND",109,112
4,1,14,1,3,"ENGINE_get_RAND@116-119@lib/libcrypto/engine/tb_rand.c","lib/libcrypto/engine/tb_rand.c","ENGINE_get_RAND",116,119
5,1,22,2,4,"ENGINE_set_RAND@123-127@lib/libcrypto/engine/tb_rand.c","lib/libcrypto/engine/tb_rand.c","ENGINE_set_RAND",123,127
4,1,16,1,3,"ENGINE_unregister_RSA@67-70@lib/libcrypto/engine/tb_rsa.c","lib/libcrypto/engine/tb_rsa.c","ENGINE_unregister_RSA",67,70
4,1,12,1,3,"engine_unregister_all_RSA@73-76@lib/libcrypto/engine/tb_rsa.c","lib/libcrypto/engine/tb_rsa.c","engine_unregister_all_RSA",73,76
7,2,35,1,6,"ENGINE_register_RSA@79-85@lib/libcrypto/engine/tb_rsa.c","lib/libcrypto/engine/tb_rsa.c","ENGINE_register_RSA",79,85
6,2,32,1,6,"ENGINE_register_all_RSA@88-94@lib/libcrypto/engine/tb_rsa.c","lib/libcrypto/engine/tb_rsa.c","ENGINE_register_all_RSA",88,94
7,2,35,1,6,"ENGINE_set_default_RSA@97-103@lib/libcrypto/engine/tb_rsa.c","lib/libcrypto/engine/tb_rsa.c","ENGINE_set_default_RSA",97,103
4,1,15,1,3,"ENGINE_get_default_RSA@109-112@lib/libcrypto/engine/tb_rsa.c","lib/libcrypto/engine/tb_rsa.c","ENGINE_get_default_RSA",109,112
4,1,14,1,3,"ENGINE_get_RSA@116-119@lib/libcrypto/engine/tb_rsa.c","lib/libcrypto/engine/tb_rsa.c","ENGINE_get_RSA",116,119
5,1,22,2,4,"ENGINE_set_RSA@123-127@lib/libcrypto/engine/tb_rsa.c","lib/libcrypto/engine/tb_rsa.c","ENGINE_set_RSA",123,127
4,1,16,1,3,"ENGINE_unregister_STORE@67-70@lib/libcrypto/engine/tb_store.c","lib/libcrypto/engine/tb_store.c","ENGINE_unregister_STORE",67,70
4,1,12,1,3,"engine_unregister_all_STORE@73-76@lib/libcrypto/engine/tb_store.c","lib/libcrypto/engine/tb_store.c","engine_unregister_all_STORE",73,76
7,2,35,1,6,"ENGINE_register_STORE@79-85@lib/libcrypto/engine/tb_store.c","lib/libcrypto/engine/tb_store.c","ENGINE_register_STORE",79,85
6,2,32,1,6,"ENGINE_register_all_STORE@88-94@lib/libcrypto/engine/tb_store.c","lib/libcrypto/engine/tb_store.c","ENGINE_register_all_STORE",88,94
4,1,14,1,3,"ENGINE_get_STORE@98-101@lib/libcrypto/engine/tb_store.c","lib/libcrypto/engine/tb_store.c","ENGINE_get_STORE",98,101
5,1,22,2,4,"ENGINE_set_STORE@105-109@lib/libcrypto/engine/tb_store.c","lib/libcrypto/engine/tb_store.c","ENGINE_set_STORE",105,109
9,3,32,1,9,"err_fns_check@288-297@lib/libcrypto/err/err.c","lib/libcrypto/err/err.c","err_fns_check",288,297
5,1,13,1,4,"ERR_get_implementation@302-306@lib/libcrypto/err/err.c","lib/libcrypto/err/err.c","ERR_get_implementation",302,306
11,2,42,1,13,"ERR_set_implementation@309-322@lib/libcrypto/err/err.c","lib/libcrypto/err/err.c","ERR_set_implementation",309,322
7,1,46,1,7,"err_string_data_hash@333-340@lib/libcrypto/err/err.c","lib/libcrypto/err/err.c","err_string_data_hash",333,340
4,1,27,2,3,"err_string_data_cmp@344-347@lib/libcrypto/err/err.c","lib/libcrypto/err/err.c","err_string_data_cmp",344,347
14,4,61,1,15,"int_err_get@351-366@lib/libcrypto/err/err.c","lib/libcrypto/err/err.c","int_err_get",351,366
9,2,31,1,8,"int_err_del@369-377@lib/libcrypto/err/err.c","lib/libcrypto/err/err.c","int_err_del",369,377
13,2,64,1,15,"int_err_get_item@380-395@lib/libcrypto/err/err.c","lib/libcrypto/err/err.c","int_err_get_item",380,395
13,2,63,1,15,"int_err_set_item@398-413@lib/libcrypto/err/err.c","lib/libcrypto/err/err.c","int_err_set_item",398,413
13,2,63,1,15,"int_err_del_item@416-431@lib/libcrypto/err/err.c","lib/libcrypto/err/err.c","int_err_del_item",416,431
4,1,20,1,3,"err_state_hash@434-437@lib/libcrypto/err/err.c","lib/libcrypto/err/err.c","err_state_hash",434,437
4,1,27,2,3,"err_state_cmp@441-444@lib/libcrypto/err/err.c","lib/libcrypto/err/err.c","err_state_cmp",441,444
16,4,66,1,16,"int_thread_get@448-464@lib/libcrypto/err/err.c","lib/libcrypto/err/err.c","int_thread_get",448,464
10,4,53,1,12,"int_thread_release@467-479@lib/libcrypto/err/err.c","lib/libcrypto/err/err.c","int_thread_release",467,479
14,2,73,1,16,"int_thread_get_item@482-498@lib/libcrypto/err/err.c","lib/libcrypto/err/err.c","int_thread_get_item",482,498
14,2,72,1,16,"int_thread_set_item@501-517@lib/libcrypto/err/err.c","lib/libcrypto/err/err.c","int_thread_set_item",501,517
20,6,104,1,23,"int_thread_del_item@520-543@lib/libcrypto/err/err.c","lib/libcrypto/err/err.c","int_thread_del_item",520,543
8,1,27,1,9,"int_err_get_next_lib@546-555@lib/libcrypto/err/err.c","lib/libcrypto/err/err.c","int_err_get_next_lib",546,555
34,7,194,1,43,"build_SYS_str_reasons@573-616@lib/libcrypto/err/err.c","lib/libcrypto/err/err.c","build_SYS_str_reasons",573,616
10,3,46,1,11,"ERR_STATE_free@639-650@lib/libcrypto/err/err.c","lib/libcrypto/err/err.c","ERR_STATE_free",639,650
9,1,42,1,10,"ERR_load_ERR_strings@653-663@lib/libcrypto/err/err.c","lib/libcrypto/err/err.c","ERR_load_ERR_strings",653,663
9,3,47,2,8,"err_load_strings@666-674@lib/libcrypto/err/err.c","lib/libcrypto/err/err.c","err_load_strings",666,674
5,1,22,2,4,"ERR_load_strings@677-681@lib/libcrypto/err/err.c","lib/libcrypto/err/err.c","ERR_load_strings",677,681
9,3,47,2,8,"ERR_unload_strings@684-692@lib/libcrypto/err/err.c","lib/libcrypto/err/err.c","ERR_unload_strings",684,692
5,1,17,1,4,"ERR_free_strings@695-699@lib/libcrypto/err/err.c","lib/libcrypto/err/err.c","ERR_free_strings",695,699
15,2,138,5,16,"ERR_put_error@704-720@lib/libcrypto/err/err.c","lib/libcrypto/err/err.c","ERR_put_error",704,720
10,2,51,1,11,"ERR_clear_error@723-734@lib/libcrypto/err/err.c","lib/libcrypto/err/err.c","ERR_clear_error",723,734
4,1,24,1,3,"ERR_get_error@738-741@lib/libcrypto/err/err.c","lib/libcrypto/err/err.c","ERR_get_error",738,741
4,1,31,2,3,"ERR_get_error_line@744-747@lib/libcrypto/err/err.c","lib/libcrypto/err/err.c","ERR_get_error_line",744,747
5,1,40,4,4,"ERR_get_error_line_data@750-754@lib/libcrypto/err/err.c","lib/libcrypto/err/err.c","ERR_get_error_line_data",750,754
4,1,24,1,3,"ERR_peek_error@758-761@lib/libcrypto/err/err.c","lib/libcrypto/err/err.c","ERR_peek_error",758,761
4,1,31,2,3,"ERR_peek_error_line@764-767@lib/libcrypto/err/err.c","lib/libcrypto/err/err.c","ERR_peek_error_line",764,767
5,1,40,4,4,"ERR_peek_error_line_data@770-774@lib/libcrypto/err/err.c","lib/libcrypto/err/err.c","ERR_peek_error_line_data",770,774
4,1,24,1,3,"ERR_peek_last_error@777-780@lib/libcrypto/err/err.c","lib/libcrypto/err/err.c","ERR_peek_last_error",777,780
4,1,31,2,3,"ERR_peek_last_error_line@783-786@lib/libcrypto/err/err.c","lib/libcrypto/err/err.c","ERR_peek_last_error_line",783,786
5,1,40,4,4,"ERR_peek_last_error_line_data@789-793@lib/libcrypto/err/err.c","lib/libcrypto/err/err.c","ERR_peek_last_error_line_data",789,793
57,20,319,6,63,"get_error_values@796-859@lib/libcrypto/err/err.c","lib/libcrypto/err/err.c","get_error_values",796,859
43,10,306,3,52,"ERR_error_string_n@862-914@lib/libcrypto/err/err.c","lib/libcrypto/err/err.c","ERR_error_string_n",862,914
8,2,41,2,9,"ERR_error_string@920-929@lib/libcrypto/err/err.c","lib/libcrypto/err/err.c","ERR_error_string",920,929
5,1,19,1,4,"ERR_get_string_table@931-935@lib/libcrypto/err/err.c","lib/libcrypto/err/err.c","ERR_get_string_table",931,935
5,1,19,1,4,"ERR_get_err_state_table@937-941@lib/libcrypto/err/err.c","lib/libcrypto/err/err.c","ERR_get_err_state_table",937,941
5,1,23,1,4,"ERR_release_err_state_table@944-948@lib/libcrypto/err/err.c","lib/libcrypto/err/err.c","ERR_release_err_state_table",944,948
10,2,68,1,10,"ERR_lib_error_string@951-961@lib/libcrypto/err/err.c","lib/libcrypto/err/err.c","ERR_lib_error_string",951,961
11,2,77,1,11,"ERR_func_error_string@964-975@lib/libcrypto/err/err.c","lib/libcrypto/err/err.c","ERR_func_error_string",964,975
15,3,110,1,15,"ERR_reason_error_string@978-993@lib/libcrypto/err/err.c","lib/libcrypto/err/err.c","ERR_reason_error_string",978,993
10,2,48,1,12,"ERR_remove_thread_state@996-1008@lib/libcrypto/err/err.c","lib/libcrypto/err/err.c","ERR_remove_thread_state",996,1008
4,1,13,1,3,"ERR_remove_state@1012-1015@lib/libcrypto/err/err.c","lib/libcrypto/err/err.c","ERR_remove_state",1012,1015
31,6,192,1,36,"ERR_get_state@1019-1055@lib/libcrypto/err/err.c","lib/libcrypto/err/err.c","ERR_get_state",1019,1055
5,1,18,1,4,"ERR_get_next_error_library@1058-1062@lib/libcrypto/err/err.c","lib/libcrypto/err/err.c","ERR_get_next_error_library",1058,1062
12,2,67,2,14,"ERR_set_error_data@1065-1079@lib/libcrypto/err/err.c","lib/libcrypto/err/err.c","ERR_set_error_data",1065,1079
12,2,70,2,12,"ERR_asprintf_error_data@1082-1094@lib/libcrypto/err/err.c","lib/libcrypto/err/err.c","ERR_asprintf_error_data",1082,1094
17,4,107,2,17,"ERR_add_error_vdata@1097-1114@lib/libcrypto/err/err.c","lib/libcrypto/err/err.c","ERR_add_error_vdata",1097,1114
7,1,31,2,6,"ERR_add_error_data@1117-1123@lib/libcrypto/err/err.c","lib/libcrypto/err/err.c","ERR_add_error_data",1117,1123
9,2,43,1,10,"ERR_set_mark@1126-1136@lib/libcrypto/err/err.c","lib/libcrypto/err/err.c","ERR_set_mark",1126,1136
16,5,102,1,18,"ERR_pop_to_mark@1139-1157@lib/libcrypto/err/err.c","lib/libcrypto/err/err.c","ERR_pop_to_mark",1139,1157
30,1,114,1,48,"ERR_load_crypto_strings@107-155@lib/libcrypto/err/err_all.c","lib/libcrypto/err/err_all.c","ERR_load_crypto_strings",107,155
20,4,163,2,20,"ERR_print_errors_cb@68-88@lib/libcrypto/err/err_prn.c","lib/libcrypto/err/err_prn.c","ERR_print_errors_cb",68,88
7,1,50,3,8,"print_fp@91-99@lib/libcrypto/err/err_prn.c","lib/libcrypto/err/err_prn.c","print_fp",91,99
4,1,15,1,3,"ERR_print_errors_fp@102-105@lib/libcrypto/err/err_prn.c","lib/libcrypto/err/err_prn.c","ERR_print_errors_fp",102,105
4,1,30,3,3,"print_bio@108-111@lib/libcrypto/err/err_prn.c","lib/libcrypto/err/err_prn.c","print_bio",108,111
4,1,15,1,3,"ERR_print_errors@114-117@lib/libcrypto/err/err_prn.c","lib/libcrypto/err/err_prn.c","ERR_print_errors",114,117
4,1,12,1,3,"BIO_f_base64@107-110@lib/libcrypto/evp/bio_b64.c","lib/libcrypto/evp/bio_b64.c","BIO_f_base64",107,110
19,2,108,1,21,"b64_new@113-134@lib/libcrypto/evp/bio_b64.c","lib/libcrypto/evp/bio_b64.c","b64_new",113,134
10,2,49,1,9,"b64_free@137-146@lib/libcrypto/evp/bio_b64.c","lib/libcrypto/evp/bio_b64.c","b64_free",137,146
157,42,1060,3,199,"b64_read@149-348@lib/libcrypto/evp/bio_b64.c","lib/libcrypto/evp/bio_b64.c","b64_read",149,348
100,16,745,3,110,"b64_write@351-461@lib/libcrypto/evp/bio_b64.c","lib/libcrypto/evp/bio_b64.c","b64_write",351,461
76,23,483,4,82,"b64_ctrl@464-546@lib/libcrypto/evp/bio_b64.c","lib/libcrypto/evp/bio_b64.c","b64_ctrl",464,546
12,2,61,3,12,"b64_callback_ctrl@549-561@lib/libcrypto/evp/bio_b64.c","lib/libcrypto/evp/bio_b64.c","b64_callback_ctrl",549,561
4,1,26,2,3,"b64_puts@564-567@lib/libcrypto/evp/bio_b64.c","lib/libcrypto/evp/bio_b64.c","b64_puts",564,567
4,1,12,1,3,"BIO_f_cipher@102-105@lib/libcrypto/evp/bio_enc.c","lib/libcrypto/evp/bio_enc.c","BIO_f_cipher",102,105
17,2,98,1,19,"enc_new@108-127@lib/libcrypto/evp/bio_enc.c","lib/libcrypto/evp/bio_enc.c","enc_new",108,127
13,2,78,1,13,"enc_free@130-143@lib/libcrypto/evp/bio_enc.c","lib/libcrypto/evp/bio_enc.c","enc_free",130,143
63,16,422,3,83,"enc_read@146-229@lib/libcrypto/evp/bio_enc.c","lib/libcrypto/evp/bio_enc.c","enc_read",146,229
44,10,304,3,49,"enc_write@232-281@lib/libcrypto/evp/bio_enc.c","lib/libcrypto/evp/bio_enc.c","enc_write",232,281
79,18,496,4,86,"enc_ctrl@284-370@lib/libcrypto/evp/bio_enc.c","lib/libcrypto/evp/bio_enc.c","enc_ctrl",284,370
12,2,61,3,12,"enc_callback_ctrl@373-385@lib/libcrypto/evp/bio_enc.c","lib/libcrypto/evp/bio_enc.c","enc_callback_ctrl",373,385
15,5,144,5,18,"BIO_set_cipher@408-426@lib/libcrypto/evp/bio_enc.c","lib/libcrypto/evp/bio_enc.c","BIO_set_cipher",408,426
4,1,12,1,3,"BIO_f_md@90-93@lib/libcrypto/evp/bio_md.c","lib/libcrypto/evp/bio_md.c","BIO_f_md",90,93
11,2,56,1,12,"md_new@96-108@lib/libcrypto/evp/bio_md.c","lib/libcrypto/evp/bio_md.c","md_new",96,108
10,2,49,1,9,"md_free@111-120@lib/libcrypto/evp/bio_md.c","lib/libcrypto/evp/bio_md.c","md_free",111,120
21,7,134,3,23,"md_read@123-146@lib/libcrypto/evp/bio_md.c","lib/libcrypto/evp/bio_md.c","md_read",123,146
24,9,152,3,25,"md_write@149-174@lib/libcrypto/evp/bio_md.c","lib/libcrypto/evp/bio_md.c","md_write",149,174
59,14,299,4,61,"md_ctrl@177-238@lib/libcrypto/evp/bio_md.c","lib/libcrypto/evp/bio_md.c","md_ctrl",177,238
12,2,61,3,12,"md_callback_ctrl@241-253@lib/libcrypto/evp/bio_md.c","lib/libcrypto/evp/bio_md.c","md_callback_ctrl",241,253
11,3,75,3,12,"md_gets@256-268@lib/libcrypto/evp/bio_md.c","lib/libcrypto/evp/bio_md.c","md_gets",256,268
120,2,825,1,156,"OpenSSL_add_all_ciphers@70-226@lib/libcrypto/evp/c_all.c","lib/libcrypto/evp/c_all.c","OpenSSL_add_all_ciphers",70,226
29,3,188,1,55,"OpenSSL_add_all_digests@229-284@lib/libcrypto/evp/c_all.c","lib/libcrypto/evp/c_all.c","OpenSSL_add_all_digests",229,284
6,1,18,1,5,"OPENSSL_add_all_algorithms_noconf@287-292@lib/libcrypto/evp/c_all.c","lib/libcrypto/evp/c_all.c","OPENSSL_add_all_algorithms_noconf",287,292
5,1,15,1,4,"OPENSSL_add_all_algorithms_conf@295-299@lib/libcrypto/evp/c_all.c","lib/libcrypto/evp/c_all.c","OPENSSL_add_all_algorithms_conf",295,299
4,1,19,1,3,"EVP_MD_CTX_init@126-129@lib/libcrypto/evp/digest.c","lib/libcrypto/evp/digest.c","EVP_MD_CTX_init",126,129
4,1,17,1,3,"EVP_MD_CTX_create@132-135@lib/libcrypto/evp/digest.c","lib/libcrypto/evp/digest.c","EVP_MD_CTX_create",132,135
5,1,28,2,4,"EVP_DigestInit@138-142@lib/libcrypto/evp/digest.c","lib/libcrypto/evp/digest.c","EVP_DigestInit",138,142
61,25,384,3,79,"EVP_DigestInit_ex@145-224@lib/libcrypto/evp/digest.c","lib/libcrypto/evp/digest.c","EVP_DigestInit_ex",145,224
4,1,28,3,3,"EVP_DigestUpdate@227-230@lib/libcrypto/evp/digest.c","lib/libcrypto/evp/digest.c","EVP_DigestUpdate",227,230
7,1,40,3,7,"EVP_DigestFinal@234-241@lib/libcrypto/evp/digest.c","lib/libcrypto/evp/digest.c","EVP_DigestFinal",234,241
17,4,116,3,17,"EVP_DigestFinal_ex@245-262@lib/libcrypto/evp/digest.c","lib/libcrypto/evp/digest.c","EVP_DigestFinal_ex",245,262
5,1,26,2,4,"EVP_MD_CTX_copy@265-269@lib/libcrypto/evp/digest.c","lib/libcrypto/evp/digest.c","EVP_MD_CTX_copy",265,269
42,13,255,2,51,"EVP_MD_CTX_copy_ex@272-323@lib/libcrypto/evp/digest.c","lib/libcrypto/evp/digest.c","EVP_MD_CTX_copy_ex",272,323
13,3,92,6,14,"EVP_Digest@326-340@lib/libcrypto/evp/digest.c","lib/libcrypto/evp/digest.c","EVP_Digest",326,340
7,2,24,1,6,"EVP_MD_CTX_destroy@343-349@lib/libcrypto/evp/digest.c","lib/libcrypto/evp/digest.c","EVP_MD_CTX_destroy",343,349
14,9,108,1,21,"EVP_MD_CTX_cleanup@353-374@lib/libcrypto/evp/digest.c","lib/libcrypto/evp/digest.c","EVP_MD_CTX_cleanup",353,374
18,4,94,4,20,"EVP_MD_CTX_ctrl@377-397@lib/libcrypto/evp/digest.c","lib/libcrypto/evp/digest.c","EVP_MD_CTX_ctrl",377,397
30,8,202,4,32,"aesni_init_key@201-233@lib/libcrypto/evp/e_aes.c","lib/libcrypto/evp/e_aes.c","aesni_init_key",201,233
7,1,46,4,7,"aesni_cbc_cipher@236-243@lib/libcrypto/evp/e_aes.c","lib/libcrypto/evp/e_aes.c","aesni_cbc_cipher",236,243
9,2,60,4,11,"aesni_ecb_cipher@246-257@lib/libcrypto/evp/e_aes.c","lib/libcrypto/evp/e_aes.c","aesni_ecb_cipher",246,257
28,8,191,4,32,"aesni_gcm_init_key@280-312@lib/libcrypto/evp/e_aes.c","lib/libcrypto/evp/e_aes.c","aesni_gcm_init_key",280,312
29,6,198,4,35,"aesni_xts_init_key@319-354@lib/libcrypto/evp/e_aes.c","lib/libcrypto/evp/e_aes.c","aesni_xts_init_key",319,354
20,6,142,4,20,"aesni_ccm_init_key@361-381@lib/libcrypto/evp/e_aes.c","lib/libcrypto/evp/e_aes.c","aesni_ccm_init_key",361,381
56,21,394,4,68,"aes_init_key@503-571@lib/libcrypto/evp/e_aes.c","lib/libcrypto/evp/e_aes.c","aes_init_key",503,571
15,3,126,4,16,"aes_cbc_cipher@574-590@lib/libcrypto/evp/e_aes.c","lib/libcrypto/evp/e_aes.c","aes_cbc_cipher",574,590
12,3,97,4,14,"aes_ecb_cipher@593-607@lib/libcrypto/evp/e_aes.c","lib/libcrypto/evp/e_aes.c","aes_ecb_cipher",593,607
8,1,64,4,8,"aes_ofb_cipher@610-618@lib/libcrypto/evp/e_aes.c","lib/libcrypto/evp/e_aes.c","aes_ofb_cipher",610,618
8,1,68,4,8,"aes_cfb_cipher@621-629@lib/libcrypto/evp/e_aes.c","lib/libcrypto/evp/e_aes.c","aes_cfb_cipher",621,629
8,1,68,4,8,"aes_cfb8_cipher@632-640@lib/libcrypto/evp/e_aes.c","lib/libcrypto/evp/e_aes.c","aes_cfb8_cipher",632,640
19,4,163,4,21,"aes_cfb1_cipher@643-664@lib/libcrypto/evp/e_aes.c","lib/libcrypto/evp/e_aes.c","aes_cfb1_cipher",643,664
14,2,123,4,14,"aes_ctr_cipher@666-680@lib/libcrypto/evp/e_aes.c","lib/libcrypto/evp/e_aes.c","aes_ctr_cipher",666,680
8,2,46,1,8,"aes_gcm_cleanup@687-695@lib/libcrypto/evp/e_aes.c","lib/libcrypto/evp/e_aes.c","aes_gcm_cleanup",687,695
13,3,52,1,13,"ctr64_inc@699-712@lib/libcrypto/evp/e_aes.c","lib/libcrypto/evp/e_aes.c","ctr64_inc",699,712
110,42,746,4,136,"aes_gcm_ctrl@715-851@lib/libcrypto/evp/e_aes.c","lib/libcrypto/evp/e_aes.c","aes_gcm_ctrl",715,851
19,6,127,4,26,"aes_gcm_set_key@854-880@lib/libcrypto/evp/e_aes.c","lib/libcrypto/evp/e_aes.c","aes_gcm_set_key",854,880
26,8,171,4,31,"aes_gcm_init_key@883-914@lib/libcrypto/evp/e_aes.c","lib/libcrypto/evp/e_aes.c","aes_gcm_init_key",883,914
50,14,317,4,67,"aes_gcm_tls_cipher@923-990@lib/libcrypto/evp/e_aes.c","lib/libcrypto/evp/e_aes.c","aes_gcm_tls_cipher",923,990
52,17,315,4,59,"aes_gcm_cipher@993-1052@lib/libcrypto/evp/e_aes.c","lib/libcrypto/evp/e_aes.c","aes_gcm_cipher",993,1052
27,7,153,4,33,"aes_xts_ctrl@1067-1100@lib/libcrypto/evp/e_aes.c","lib/libcrypto/evp/e_aes.c","aes_xts_ctrl",1067,1100
48,15,344,4,64,"aes_xts_init_key@1103-1167@lib/libcrypto/evp/e_aes.c","lib/libcrypto/evp/e_aes.c","aes_xts_init_key",1103,1167
16,8,131,4,17,"aes_xts_cipher@1170-1187@lib/libcrypto/evp/e_aes.c","lib/libcrypto/evp/e_aes.c","aes_xts_cipher",1170,1187
54,22,309,4,61,"aes_ccm_ctrl@1199-1260@lib/libcrypto/evp/e_aes.c","lib/libcrypto/evp/e_aes.c","aes_ccm_ctrl",1199,1260
27,8,200,4,29,"aes_ccm_init_key@1263-1292@lib/libcrypto/evp/e_aes.c","lib/libcrypto/evp/e_aes.c","aes_ccm_init_key",1263,1292
53,21,363,4,59,"aes_ccm_cipher@1295-1354@lib/libcrypto/evp/e_aes.c","lib/libcrypto/evp/e_aes.c","aes_ccm_cipher",1295,1354
32,8,189,4,40,"aead_aes_gcm_init@1378-1418@lib/libcrypto/evp/e_aes.c","lib/libcrypto/evp/e_aes.c","aead_aes_gcm_init",1378,1418
5,1,28,1,5,"aead_aes_gcm_cleanup@1421-1426@lib/libcrypto/evp/e_aes.c","lib/libcrypto/evp/e_aes.c","aead_aes_gcm_cleanup",1421,1426
29,7,218,10,34,"aead_aes_gcm_seal@1429-1463@lib/libcrypto/evp/e_aes.c","lib/libcrypto/evp/e_aes.c","aead_aes_gcm_seal",1429,1463
40,8,275,10,48,"aead_aes_gcm_open@1466-1514@lib/libcrypto/evp/e_aes.c","lib/libcrypto/evp/e_aes.c","aead_aes_gcm_open",1466,1514
4,1,10,1,3,"EVP_aead_aes_128_gcm@1541-1544@lib/libcrypto/evp/e_aes.c","lib/libcrypto/evp/e_aes.c","EVP_aead_aes_128_gcm",1541,1544
4,1,10,1,3,"EVP_aead_aes_256_gcm@1547-1550@lib/libcrypto/evp/e_aes.c","lib/libcrypto/evp/e_aes.c","EVP_aead_aes_256_gcm",1547,1550
15,3,115,4,18,"aesni_cbc_hmac_sha1_init_key@102-120@lib/libcrypto/evp/e_aes_cbc_hmac_sha1.c","lib/libcrypto/evp/e_aes_cbc_hmac_sha1.c","aesni_cbc_hmac_sha1_init_key",102,120
25,6,151,3,29,"sha1_update@131-160@lib/libcrypto/evp/e_aes_cbc_hmac_sha1.c","lib/libcrypto/evp/e_aes_cbc_hmac_sha1.c","sha1_update",131,160
233,30,2304,4,300,"aesni_cbc_hmac_sha1_cipher@168-468@lib/libcrypto/evp/e_aes_cbc_hmac_sha1.c","lib/libcrypto/evp/e_aes_cbc_hmac_sha1.c","aesni_cbc_hmac_sha1_cipher",168,468
55,9,409,4,64,"aesni_cbc_hmac_sha1_ctrl@471-535@lib/libcrypto/evp/e_aes_cbc_hmac_sha1.c","lib/libcrypto/evp/e_aes_cbc_hmac_sha1.c","aesni_cbc_hmac_sha1_ctrl",471,535
5,2,20,1,4,"EVP_aes_128_cbc_hmac_sha1@572-576@lib/libcrypto/evp/e_aes_cbc_hmac_sha1.c","lib/libcrypto/evp/e_aes_cbc_hmac_sha1.c","EVP_aes_128_cbc_hmac_sha1",572,576
5,2,20,1,4,"EVP_aes_256_cbc_hmac_sha1@579-583@lib/libcrypto/evp/e_aes_cbc_hmac_sha1.c","lib/libcrypto/evp/e_aes_cbc_hmac_sha1.c","EVP_aes_256_cbc_hmac_sha1",579,583
4,1,9,1,3,"EVP_aes_128_cbc_hmac_sha1@586-589@lib/libcrypto/evp/e_aes_cbc_hmac_sha1.c","lib/libcrypto/evp/e_aes_cbc_hmac_sha1.c","EVP_aes_128_cbc_hmac_sha1",586,589
4,1,9,1,3,"EVP_aes_256_cbc_hmac_sha1@592-595@lib/libcrypto/evp/e_aes_cbc_hmac_sha1.c","lib/libcrypto/evp/e_aes_cbc_hmac_sha1.c","EVP_aes_256_cbc_hmac_sha1",592,595
6,1,43,4,5,"bf_init_key@85-90@lib/libcrypto/evp/e_bf.c","lib/libcrypto/evp/e_bf.c","bf_init_key",85,90
11,2,61,4,13,"camellia_init_key@109-122@lib/libcrypto/evp/e_camellia.c","lib/libcrypto/evp/e_camellia.c","camellia_init_key",109,122
6,1,43,4,5,"cast_init_key@86-91@lib/libcrypto/evp/e_cast.c","lib/libcrypto/evp/e_cast.c","cast_init_key",86,91
4,1,12,1,3,"EVP_chacha20@45-48@lib/libcrypto/evp/e_chacha.c","lib/libcrypto/evp/e_chacha.c","EVP_chacha20",45,48
9,2,67,4,8,"chacha_init@51-59@lib/libcrypto/evp/e_chacha.c","lib/libcrypto/evp/e_chacha.c","chacha_init",51,59
6,1,42,4,5,"chacha_cipher@62-67@lib/libcrypto/evp/e_chacha.c","lib/libcrypto/evp/e_chacha.c","chacha_cipher",62,67
20,5,115,4,26,"aead_chacha20_poly1305_init@46-72@lib/libcrypto/evp/e_chacha20poly1305.c","lib/libcrypto/evp/e_chacha20poly1305.c","aead_chacha20_poly1305_init",46,72
5,1,28,1,5,"aead_chacha20_poly1305_cleanup@75-80@lib/libcrypto/evp/e_chacha20poly1305.c","lib/libcrypto/evp/e_chacha20poly1305.c","aead_chacha20_poly1305_cleanup",75,80
14,3,89,3,15,"poly1305_update_with_length@83-98@lib/libcrypto/evp/e_chacha20poly1305.c","lib/libcrypto/evp/e_chacha20poly1305.c","poly1305_update_with_length",83,98
10,2,63,3,13,"poly1305_update_with_pad16@101-114@lib/libcrypto/evp/e_chacha20poly1305.c","lib/libcrypto/evp/e_chacha20poly1305.c","poly1305_update_with_pad16",101,114
46,5,362,10,60,"aead_chacha20_poly1305_seal@117-177@lib/libcrypto/evp/e_chacha20poly1305.c","lib/libcrypto/evp/e_chacha20poly1305.c","aead_chacha20_poly1305_seal",117,177
50,6,371,10,67,"aead_chacha20_poly1305_open@180-247@lib/libcrypto/evp/e_chacha20poly1305.c","lib/libcrypto/evp/e_chacha20poly1305.c","aead_chacha20_poly1305_open",180,247
4,1,9,0,3,"EVP_aead_chacha20_poly1305@263-266@lib/libcrypto/evp/e_chacha20poly1305.c","lib/libcrypto/evp/e_chacha20poly1305.c","EVP_aead_chacha20_poly1305",263,266
8,1,59,4,7,"des_ecb_cipher@78-85@lib/libcrypto/evp/e_des.c","lib/libcrypto/evp/e_des.c","des_ecb_cipher",78,85
15,3,107,4,14,"des_ofb_cipher@88-102@lib/libcrypto/evp/e_des.c","lib/libcrypto/evp/e_des.c","des_ofb_cipher",88,102
15,3,105,4,14,"des_cbc_cipher@105-119@lib/libcrypto/evp/e_des.c","lib/libcrypto/evp/e_des.c","des_cbc_cipher",105,119
15,3,115,4,14,"des_cfb64_cipher@122-136@lib/libcrypto/evp/e_des.c","lib/libcrypto/evp/e_des.c","des_cfb64_cipher",122,136
24,7,216,4,26,"des_cfb1_cipher@141-167@lib/libcrypto/evp/e_des.c","lib/libcrypto/evp/e_des.c","des_cfb1_cipher",141,167
15,3,109,4,14,"des_cfb8_cipher@170-184@lib/libcrypto/evp/e_des.c","lib/libcrypto/evp/e_des.c","des_cfb8_cipher",170,184
7,1,44,4,7,"des_init_key@203-210@lib/libcrypto/evp/e_des.c","lib/libcrypto/evp/e_des.c","des_init_key",203,210
11,3,52,4,11,"des_ctrl@213-224@lib/libcrypto/evp/e_des.c","lib/libcrypto/evp/e_des.c","des_ctrl",213,224
8,1,79,4,7,"des_ede_ecb_cipher@91-98@lib/libcrypto/evp/e_des3.c","lib/libcrypto/evp/e_des3.c","des_ede_ecb_cipher",91,98
17,3,147,4,17,"des_ede_ofb_cipher@101-118@lib/libcrypto/evp/e_des3.c","lib/libcrypto/evp/e_des3.c","des_ede_ofb_cipher",101,118
17,3,145,4,16,"des_ede_cbc_cipher@121-137@lib/libcrypto/evp/e_des3.c","lib/libcrypto/evp/e_des3.c","des_ede_cbc_cipher",121,137
17,3,155,4,16,"des_ede_cfb64_cipher@140-156@lib/libcrypto/evp/e_des3.c","lib/libcrypto/evp/e_des3.c","des_ede_cfb64_cipher",140,156
15,3,186,4,16,"des_ede3_cfb1_cipher@161-177@lib/libcrypto/evp/e_des3.c","lib/libcrypto/evp/e_des3.c","des_ede3_cfb1_cipher",161,177
17,3,149,4,16,"des_ede3_cfb8_cipher@180-196@lib/libcrypto/evp/e_des3.c","lib/libcrypto/evp/e_des3.c","des_ede3_cfb8_cipher",180,196
10,1,98,4,10,"des_ede_init_key@228-238@lib/libcrypto/evp/e_des3.c","lib/libcrypto/evp/e_des3.c","des_ede_init_key",228,238
9,1,87,4,10,"des_ede3_init_key@241-251@lib/libcrypto/evp/e_des3.c","lib/libcrypto/evp/e_des3.c","des_ede3_init_key",241,251
16,7,94,4,17,"des3_ctrl@254-271@lib/libcrypto/evp/e_des3.c","lib/libcrypto/evp/e_des3.c","des3_ctrl",254,271
4,1,10,1,3,"EVP_des_ede@274-277@lib/libcrypto/evp/e_des3.c","lib/libcrypto/evp/e_des3.c","EVP_des_ede",274,277
4,1,10,1,3,"EVP_des_ede3@280-283@lib/libcrypto/evp/e_des3.c","lib/libcrypto/evp/e_des3.c","EVP_des_ede3",280,283
20,5,105,4,21,"gost2814789_ctl@67-88@lib/libcrypto/evp/e_gost2814789.c","lib/libcrypto/evp/e_gost2814789.c","gost2814789_ctl",67,88
6,1,48,4,6,"gost2814789_init_key@91-97@lib/libcrypto/evp/e_gost2814789.c","lib/libcrypto/evp/e_gost2814789.c","gost2814789_init_key",91,97
44,6,252,2,47,"gost2814789_set_asn1_params@100-147@lib/libcrypto/evp/e_gost2814789.c","lib/libcrypto/evp/e_gost2814789.c","gost2814789_set_asn1_params",100,147
28,4,198,2,35,"gost2814789_get_asn1_params@150-185@lib/libcrypto/evp/e_gost2814789.c","lib/libcrypto/evp/e_gost2814789.c","gost2814789_get_asn1_params",150,185
16,3,113,4,17,"gost2814789_cnt_cipher@191-208@lib/libcrypto/evp/e_gost2814789.c","lib/libcrypto/evp/e_gost2814789.c","gost2814789_cnt_cipher",191,208
7,1,43,4,6,"idea_ecb_cipher@80-86@lib/libcrypto/evp/e_idea.c","lib/libcrypto/evp/e_idea.c","idea_ecb_cipher",80,86
20,5,112,4,20,"idea_init_key@103-123@lib/libcrypto/evp/e_idea.c","lib/libcrypto/evp/e_idea.c","idea_init_key",103,123
4,1,12,1,3,"EVP_enc_null@85-88@lib/libcrypto/evp/e_null.c","lib/libcrypto/evp/e_null.c","EVP_enc_null",85,88
5,1,26,4,5,"null_init_key@91-96@lib/libcrypto/evp/e_null.c","lib/libcrypto/evp/e_null.c","null_init_key",91,96
7,2,49,4,6,"null_cipher@99-105@lib/libcrypto/evp/e_null.c","lib/libcrypto/evp/e_null.c","null_cipher",99,105
4,1,11,1,3,"EVP_bf_cfb@75-78@lib/libcrypto/evp/e_old.c","lib/libcrypto/evp/e_old.c","EVP_bf_cfb",75,78
4,1,11,1,3,"EVP_des_cfb@85-88@lib/libcrypto/evp/e_old.c","lib/libcrypto/evp/e_old.c","EVP_des_cfb",85,88
4,1,11,1,3,"EVP_des_ede3_cfb@92-95@lib/libcrypto/evp/e_old.c","lib/libcrypto/evp/e_old.c","EVP_des_ede3_cfb",92,95
4,1,11,1,3,"EVP_des_ede_cfb@99-102@lib/libcrypto/evp/e_old.c","lib/libcrypto/evp/e_old.c","EVP_des_ede_cfb",99,102
4,1,11,1,3,"EVP_idea_cfb@109-112@lib/libcrypto/evp/e_old.c","lib/libcrypto/evp/e_old.c","EVP_idea_cfb",109,112
4,1,11,1,3,"EVP_rc2_cfb@119-122@lib/libcrypto/evp/e_old.c","lib/libcrypto/evp/e_old.c","EVP_rc2_cfb",119,122
4,1,11,1,3,"EVP_cast5_cfb@129-132@lib/libcrypto/evp/e_old.c","lib/libcrypto/evp/e_old.c","EVP_cast5_cfb",129,132
4,1,11,1,3,"EVP_aes_128_cfb@139-142@lib/libcrypto/evp/e_old.c","lib/libcrypto/evp/e_old.c","EVP_aes_128_cfb",139,142
4,1,11,1,3,"EVP_aes_192_cfb@146-149@lib/libcrypto/evp/e_old.c","lib/libcrypto/evp/e_old.c","EVP_aes_192_cfb",146,149
4,1,11,1,3,"EVP_aes_256_cfb@153-156@lib/libcrypto/evp/e_old.c","lib/libcrypto/evp/e_old.c","EVP_aes_256_cfb",153,156
4,1,12,1,3,"EVP_rc2_64_cbc@128-131@lib/libcrypto/evp/e_rc2.c","lib/libcrypto/evp/e_rc2.c","EVP_rc2_64_cbc",128,131
4,1,12,1,3,"EVP_rc2_40_cbc@134-137@lib/libcrypto/evp/e_rc2.c","lib/libcrypto/evp/e_rc2.c","EVP_rc2_40_cbc",134,137
7,1,51,4,6,"rc2_init_key@140-146@lib/libcrypto/evp/e_rc2.c","lib/libcrypto/evp/e_rc2.c","rc2_init_key",140,146
13,4,64,1,13,"rc2_meth_to_magic@149-162@lib/libcrypto/evp/e_rc2.c","lib/libcrypto/evp/e_rc2.c","rc2_meth_to_magic",149,162
13,4,49,1,12,"rc2_magic_to_meth@165-177@lib/libcrypto/evp/e_rc2.c","lib/libcrypto/evp/e_rc2.c","rc2_magic_to_meth",165,177
27,7,173,2,27,"rc2_get_asn1_type_and_iv@180-207@lib/libcrypto/evp/e_rc2.c","lib/libcrypto/evp/e_rc2.c","rc2_get_asn1_type_and_iv",180,207
11,2,64,2,11,"rc2_set_asn1_type_and_iv@210-221@lib/libcrypto/evp/e_rc2.c","lib/libcrypto/evp/e_rc2.c","rc2_set_asn1_type_and_iv",210,221
22,7,111,4,27,"rc2_ctrl@224-251@lib/libcrypto/evp/e_rc2.c","lib/libcrypto/evp/e_rc2.c","rc2_ctrl",224,251
4,1,12,1,3,"EVP_rc4@114-117@lib/libcrypto/evp/e_rc4.c","lib/libcrypto/evp/e_rc4.c","EVP_rc4",114,117
4,1,12,1,3,"EVP_rc4_40@120-123@lib/libcrypto/evp/e_rc4.c","lib/libcrypto/evp/e_rc4.c","EVP_rc4_40",120,123
6,1,44,4,5,"rc4_init_key@126-131@lib/libcrypto/evp/e_rc4.c","lib/libcrypto/evp/e_rc4.c","rc4_init_key",126,131
6,1,42,4,5,"rc4_cipher@134-139@lib/libcrypto/evp/e_rc4.c","lib/libcrypto/evp/e_rc4.c","rc4_cipher",134,139
11,1,80,4,14,"rc4_hmac_md5_init_key@80-94@lib/libcrypto/evp/e_rc4_hmac_md5.c","lib/libcrypto/evp/e_rc4_hmac_md5.c","rc4_hmac_md5_init_key",80,94
89,20,719,4,113,"rc4_hmac_md5_cipher@111-224@lib/libcrypto/evp/e_rc4_hmac_md5.c","lib/libcrypto/evp/e_rc4_hmac_md5.c","rc4_hmac_md5_cipher",111,224
46,8,326,4,53,"rc4_hmac_md5_ctrl@227-280@lib/libcrypto/evp/e_rc4_hmac_md5.c","lib/libcrypto/evp/e_rc4_hmac_md5.c","rc4_hmac_md5_ctrl",227,280
4,1,12,1,3,"EVP_rc4_hmac_md5@301-304@lib/libcrypto/evp/e_rc4_hmac_md5.c","lib/libcrypto/evp/e_rc4_hmac_md5.c","EVP_rc4_hmac_md5",301,304
4,1,12,1,3,"EVP_desx_cbc@101-104@lib/libcrypto/evp/e_xcbc_d.c","lib/libcrypto/evp/e_xcbc_d.c","EVP_desx_cbc",101,104
9,1,93,4,10,"desx_cbc_init_key@107-117@lib/libcrypto/evp/e_xcbc_d.c","lib/libcrypto/evp/e_xcbc_d.c","desx_cbc_init_key",107,117
17,3,157,4,16,"desx_cbc_cipher@120-136@lib/libcrypto/evp/e_xcbc_d.c","lib/libcrypto/evp/e_xcbc_d.c","desx_cbc_cipher",120,136
6,1,26,1,5,"EVP_EncodeInit@116-121@lib/libcrypto/evp/encode.c","lib/libcrypto/evp/encode.c","EVP_EncodeInit",116,121
44,8,309,5,45,"EVP_EncodeUpdate@124-169@lib/libcrypto/evp/encode.c","lib/libcrypto/evp/encode.c","EVP_EncodeUpdate",124,169
11,2,74,3,11,"EVP_EncodeFinal@172-183@lib/libcrypto/evp/encode.c","lib/libcrypto/evp/encode.c","EVP_EncodeFinal",172,183
27,5,262,3,29,"EVP_EncodeBlock@186-215@lib/libcrypto/evp/encode.c","lib/libcrypto/evp/encode.c","EVP_EncodeBlock",186,215
7,1,32,1,6,"EVP_DecodeInit@218-224@lib/libcrypto/evp/encode.c","lib/libcrypto/evp/encode.c","EVP_DecodeInit",218,224
98,35,580,5,135,"EVP_DecodeUpdate@231-366@lib/libcrypto/evp/encode.c","lib/libcrypto/evp/encode.c","EVP_DecodeUpdate",231,366
31,11,311,3,37,"EVP_DecodeBlock@369-406@lib/libcrypto/evp/encode.c","lib/libcrypto/evp/encode.c","EVP_DecodeBlock",369,406
14,3,84,3,14,"EVP_DecodeFinal@409-423@lib/libcrypto/evp/encode.c","lib/libcrypto/evp/encode.c","EVP_DecodeFinal",409,423
4,1,14,1,3,"EVP_AEAD_key_length@27-30@lib/libcrypto/evp/evp_aead.c","lib/libcrypto/evp/evp_aead.c","EVP_AEAD_key_length",27,30
4,1,14,1,3,"EVP_AEAD_nonce_length@33-36@lib/libcrypto/evp/evp_aead.c","lib/libcrypto/evp/evp_aead.c","EVP_AEAD_nonce_length",33,36
4,1,14,1,3,"EVP_AEAD_max_overhead@39-42@lib/libcrypto/evp/evp_aead.c","lib/libcrypto/evp/evp_aead.c","EVP_AEAD_max_overhead",39,42
4,1,14,1,3,"EVP_AEAD_max_tag_len@45-48@lib/libcrypto/evp/evp_aead.c","lib/libcrypto/evp/evp_aead.c","EVP_AEAD_max_tag_len",45,48
10,2,67,6,9,"EVP_AEAD_CTX_init@51-60@lib/libcrypto/evp/evp_aead.c","lib/libcrypto/evp/evp_aead.c","EVP_AEAD_CTX_init",51,60
7,2,33,1,6,"EVP_AEAD_CTX_cleanup@63-69@lib/libcrypto/evp/evp_aead.c","lib/libcrypto/evp/evp_aead.c","EVP_AEAD_CTX_cleanup",63,69
8,3,42,3,7,"check_alias@80-87@lib/libcrypto/evp/evp_aead.c","lib/libcrypto/evp/evp_aead.c","check_alias",80,87
23,4,150,10,29,"EVP_AEAD_CTX_seal@90-119@lib/libcrypto/evp/evp_aead.c","lib/libcrypto/evp/evp_aead.c","EVP_AEAD_CTX_seal",90,119
18,3,123,10,22,"EVP_AEAD_CTX_open@122-144@lib/libcrypto/evp/evp_aead.c","lib/libcrypto/evp/evp_aead.c","EVP_AEAD_CTX_open",122,144
4,1,20,1,3,"EVP_CIPHER_CTX_init@79-82@lib/libcrypto/evp/evp_enc.c","lib/libcrypto/evp/evp_enc.c","EVP_CIPHER_CTX_init",79,82
4,1,17,1,3,"EVP_CIPHER_CTX_new@85-88@lib/libcrypto/evp/evp_enc.c","lib/libcrypto/evp/evp_enc.c","EVP_CIPHER_CTX_new",85,88
7,2,53,5,6,"EVP_CipherInit@91-97@lib/libcrypto/evp/evp_enc.c","lib/libcrypto/evp/evp_enc.c","EVP_CipherInit",91,97
107,35,591,6,139,"EVP_CipherInit_ex@100-239@lib/libcrypto/evp/evp_enc.c","lib/libcrypto/evp/evp_enc.c","EVP_CipherInit_ex",100,239
8,2,61,5,7,"EVP_CipherUpdate@242-249@lib/libcrypto/evp/evp_enc.c","lib/libcrypto/evp/evp_enc.c","EVP_CipherUpdate",242,249
7,2,44,3,6,"EVP_CipherFinal_ex@252-258@lib/libcrypto/evp/evp_enc.c","lib/libcrypto/evp/evp_enc.c","EVP_CipherFinal_ex",252,258
9,2,52,3,8,"EVP_CipherFinal@264-272@lib/libcrypto/evp/evp_enc.c","lib/libcrypto/evp/evp_enc.c","EVP_CipherFinal",264,272
5,1,39,4,4,"EVP_EncryptInit@275-279@lib/libcrypto/evp/evp_enc.c","lib/libcrypto/evp/evp_enc.c","EVP_EncryptInit",275,279
5,1,45,5,4,"EVP_EncryptInit_ex@282-286@lib/libcrypto/evp/evp_enc.c","lib/libcrypto/evp/evp_enc.c","EVP_EncryptInit_ex",282,286
5,1,39,4,4,"EVP_DecryptInit@289-293@lib/libcrypto/evp/evp_enc.c","lib/libcrypto/evp/evp_enc.c","EVP_DecryptInit",289,293
5,1,45,5,4,"EVP_DecryptInit_ex@296-300@lib/libcrypto/evp/evp_enc.c","lib/libcrypto/evp/evp_enc.c","EVP_DecryptInit_ex",296,300
62,14,386,5,65,"EVP_EncryptUpdate@303-368@lib/libcrypto/evp/evp_enc.c","lib/libcrypto/evp/evp_enc.c","EVP_EncryptUpdate",303,368
6,1,34,3,6,"EVP_EncryptFinal@374-380@lib/libcrypto/evp/evp_enc.c","lib/libcrypto/evp/evp_enc.c","EVP_EncryptFinal",374,380
38,9,209,3,43,"EVP_EncryptFinal_ex@383-426@lib/libcrypto/evp/evp_enc.c","lib/libcrypto/evp/evp_enc.c","EVP_EncryptFinal_ex",383,426
43,11,260,5,54,"EVP_DecryptUpdate@429-483@lib/libcrypto/evp/evp_enc.c","lib/libcrypto/evp/evp_enc.c","EVP_DecryptUpdate",429,483
6,1,34,3,6,"EVP_DecryptFinal@489-495@lib/libcrypto/evp/evp_enc.c","lib/libcrypto/evp/evp_enc.c","EVP_DecryptFinal",489,495
50,14,292,3,51,"EVP_DecryptFinal_ex@498-549@lib/libcrypto/evp/evp_enc.c","lib/libcrypto/evp/evp_enc.c","EVP_DecryptFinal_ex",498,549
7,2,24,1,6,"EVP_CIPHER_CTX_free@552-558@lib/libcrypto/evp/evp_enc.c","lib/libcrypto/evp/evp_enc.c","EVP_CIPHER_CTX_free",552,558
14,6,91,1,18,"EVP_CIPHER_CTX_cleanup@561-579@lib/libcrypto/evp/evp_enc.c","lib/libcrypto/evp/evp_enc.c","EVP_CIPHER_CTX_cleanup",561,579
14,5,81,2,13,"EVP_CIPHER_CTX_set_key_length@582-595@lib/libcrypto/evp/evp_enc.c","lib/libcrypto/evp/evp_enc.c","EVP_CIPHER_CTX_set_key_length",582,595
8,2,31,2,7,"EVP_CIPHER_CTX_set_padding@598-605@lib/libcrypto/evp/evp_enc.c","lib/libcrypto/evp/evp_enc.c","EVP_CIPHER_CTX_set_padding",598,605
18,4,94,4,20,"EVP_CIPHER_CTX_ctrl@608-628@lib/libcrypto/evp/evp_enc.c","lib/libcrypto/evp/evp_enc.c","EVP_CIPHER_CTX_ctrl",608,628
7,2,47,2,6,"EVP_CIPHER_CTX_rand_key@631-637@lib/libcrypto/evp/evp_enc.c","lib/libcrypto/evp/evp_enc.c","EVP_CIPHER_CTX_rand_key",631,637
25,9,173,2,30,"EVP_CIPHER_CTX_copy@640-670@lib/libcrypto/evp/evp_enc.c","lib/libcrypto/evp/evp_enc.c","EVP_CIPHER_CTX_copy",640,670
7,2,36,1,8,"ERR_load_EVP_strings@158-166@lib/libcrypto/evp/evp_err.c","lib/libcrypto/evp/evp_err.c","ERR_load_EVP_strings",158,166
8,2,37,1,7,"EVP_set_pw_prompt@72-79@lib/libcrypto/evp/evp_key.c","lib/libcrypto/evp/evp_key.c","EVP_set_pw_prompt",72,79
7,2,26,1,6,"EVP_get_pw_prompt@82-88@lib/libcrypto/evp/evp_key.c","lib/libcrypto/evp/evp_key.c","EVP_get_pw_prompt",82,88
4,1,33,4,3,"EVP_read_pw_string@91-94@lib/libcrypto/evp/evp_key.c","lib/libcrypto/evp/evp_key.c","EVP_read_pw_string",91,94
24,9,168,5,24,"EVP_read_pw_string_min@97-121@lib/libcrypto/evp/evp_key.c","lib/libcrypto/evp/evp_key.c","EVP_read_pw_string_min",97,121
77,29,487,8,82,"EVP_BytesToKey@124-206@lib/libcrypto/evp/evp_key.c","lib/libcrypto/evp/evp_key.c","EVP_BytesToKey",124,206
11,3,69,2,11,"EVP_CIPHER_param_to_asn1@67-78@lib/libcrypto/evp/evp_lib.c","lib/libcrypto/evp/evp_lib.c","EVP_CIPHER_param_to_asn1",67,78
11,3,69,2,11,"EVP_CIPHER_asn1_to_param@81-92@lib/libcrypto/evp/evp_lib.c","lib/libcrypto/evp/evp_lib.c","EVP_CIPHER_asn1_to_param",81,92
18,5,110,2,18,"EVP_CIPHER_get_asn1_iv@95-113@lib/libcrypto/evp/evp_lib.c","lib/libcrypto/evp/evp_lib.c","EVP_CIPHER_get_asn1_iv",95,113
14,3,75,2,14,"EVP_CIPHER_set_asn1_iv@116-130@lib/libcrypto/evp/evp_lib.c","lib/libcrypto/evp/evp_lib.c","EVP_CIPHER_set_asn1_iv",116,130
41,23,141,1,49,"EVP_CIPHER_type@134-183@lib/libcrypto/evp/evp_lib.c","lib/libcrypto/evp/evp_lib.c","EVP_CIPHER_type",134,183
4,1,14,1,3,"EVP_CIPHER_block_size@186-189@lib/libcrypto/evp/evp_lib.c","lib/libcrypto/evp/evp_lib.c","EVP_CIPHER_block_size",186,189
4,1,16,1,3,"EVP_CIPHER_CTX_block_size@192-195@lib/libcrypto/evp/evp_lib.c","lib/libcrypto/evp/evp_lib.c","EVP_CIPHER_CTX_block_size",192,195
5,1,39,4,4,"EVP_Cipher@198-202@lib/libcrypto/evp/evp_lib.c","lib/libcrypto/evp/evp_lib.c","EVP_Cipher",198,202
4,1,14,1,3,"EVP_CIPHER_CTX_cipher@205-208@lib/libcrypto/evp/evp_lib.c","lib/libcrypto/evp/evp_lib.c","EVP_CIPHER_CTX_cipher",205,208
4,1,14,1,3,"EVP_CIPHER_flags@211-214@lib/libcrypto/evp/evp_lib.c","lib/libcrypto/evp/evp_lib.c","EVP_CIPHER_flags",211,214
4,1,16,1,3,"EVP_CIPHER_CTX_flags@217-220@lib/libcrypto/evp/evp_lib.c","lib/libcrypto/evp/evp_lib.c","EVP_CIPHER_CTX_flags",217,220
4,1,14,1,3,"EVP_CIPHER_CTX_get_app_data@223-226@lib/libcrypto/evp/evp_lib.c","lib/libcrypto/evp/evp_lib.c","EVP_CIPHER_CTX_get_app_data",223,226
4,1,18,2,3,"EVP_CIPHER_CTX_set_app_data@229-232@lib/libcrypto/evp/evp_lib.c","lib/libcrypto/evp/evp_lib.c","EVP_CIPHER_CTX_set_app_data",229,232
4,1,14,1,3,"EVP_CIPHER_iv_length@235-238@lib/libcrypto/evp/evp_lib.c","lib/libcrypto/evp/evp_lib.c","EVP_CIPHER_iv_length",235,238
4,1,16,1,3,"EVP_CIPHER_CTX_iv_length@241-244@lib/libcrypto/evp/evp_lib.c","lib/libcrypto/evp/evp_lib.c","EVP_CIPHER_CTX_iv_length",241,244
4,1,14,1,3,"EVP_CIPHER_key_length@247-250@lib/libcrypto/evp/evp_lib.c","lib/libcrypto/evp/evp_lib.c","EVP_CIPHER_key_length",247,250
4,1,14,1,3,"EVP_CIPHER_CTX_key_length@253-256@lib/libcrypto/evp/evp_lib.c","lib/libcrypto/evp/evp_lib.c","EVP_CIPHER_CTX_key_length",253,256
4,1,14,1,3,"EVP_CIPHER_nid@259-262@lib/libcrypto/evp/evp_lib.c","lib/libcrypto/evp/evp_lib.c","EVP_CIPHER_nid",259,262
4,1,16,1,3,"EVP_CIPHER_CTX_nid@265-268@lib/libcrypto/evp/evp_lib.c","lib/libcrypto/evp/evp_lib.c","EVP_CIPHER_CTX_nid",265,268
4,1,14,1,3,"EVP_MD_block_size@271-274@lib/libcrypto/evp/evp_lib.c","lib/libcrypto/evp/evp_lib.c","EVP_MD_block_size",271,274
4,1,14,1,3,"EVP_MD_type@277-280@lib/libcrypto/evp/evp_lib.c","lib/libcrypto/evp/evp_lib.c","EVP_MD_type",277,280
4,1,14,1,3,"EVP_MD_pkey_type@283-286@lib/libcrypto/evp/evp_lib.c","lib/libcrypto/evp/evp_lib.c","EVP_MD_pkey_type",283,286
8,2,30,1,7,"EVP_MD_size@289-296@lib/libcrypto/evp/evp_lib.c","lib/libcrypto/evp/evp_lib.c","EVP_MD_size",289,296
4,1,14,1,3,"EVP_MD_flags@299-302@lib/libcrypto/evp/evp_lib.c","lib/libcrypto/evp/evp_lib.c","EVP_MD_flags",299,302
6,2,22,1,5,"EVP_MD_CTX_md@305-310@lib/libcrypto/evp/evp_lib.c","lib/libcrypto/evp/evp_lib.c","EVP_MD_CTX_md",305,310
4,1,17,2,3,"EVP_MD_CTX_set_flags@313-316@lib/libcrypto/evp/evp_lib.c","lib/libcrypto/evp/evp_lib.c","EVP_MD_CTX_set_flags",313,316
4,1,17,2,3,"EVP_MD_CTX_clear_flags@319-322@lib/libcrypto/evp/evp_lib.c","lib/libcrypto/evp/evp_lib.c","EVP_MD_CTX_clear_flags",319,322
4,1,21,2,3,"EVP_MD_CTX_test_flags@325-328@lib/libcrypto/evp/evp_lib.c","lib/libcrypto/evp/evp_lib.c","EVP_MD_CTX_test_flags",325,328
4,1,17,2,3,"EVP_CIPHER_CTX_set_flags@331-334@lib/libcrypto/evp/evp_lib.c","lib/libcrypto/evp/evp_lib.c","EVP_CIPHER_CTX_set_flags",331,334
4,1,17,2,3,"EVP_CIPHER_CTX_clear_flags@337-340@lib/libcrypto/evp/evp_lib.c","lib/libcrypto/evp/evp_lib.c","EVP_CIPHER_CTX_clear_flags",337,340
4,1,21,2,3,"EVP_CIPHER_CTX_test_flags@343-346@lib/libcrypto/evp/evp_lib.c","lib/libcrypto/evp/evp_lib.c","EVP_CIPHER_CTX_test_flags",343,346
46,10,246,6,50,"EVP_PBE_CipherInit@120-170@lib/libcrypto/evp/evp_pbe.c","lib/libcrypto/evp/evp_pbe.c","EVP_PBE_CipherInit",120,170
8,2,42,2,8,"pbe2_cmp@177-185@lib/libcrypto/evp/evp_pbe.c","lib/libcrypto/evp/evp_pbe.c","pbe2_cmp",177,185
6,1,36,2,5,"pbe2_cmp_BSEARCH_CMP_FN@189-194@lib/libcrypto/evp/evp_pbe.c","lib/libcrypto/evp/evp_pbe.c","pbe2_cmp_BSEARCH_CMP_FN",189,194
5,1,37,3,4,"OBJ_bsearch_pbe2@197-201@lib/libcrypto/evp/evp_pbe.c","lib/libcrypto/evp/evp_pbe.c","OBJ_bsearch_pbe2",197,201
8,2,58,2,8,"pbe_cmp@204-212@lib/libcrypto/evp/evp_pbe.c","lib/libcrypto/evp/evp_pbe.c","pbe_cmp",204,212
28,5,140,5,29,"EVP_PBE_alg_add_type@217-246@lib/libcrypto/evp/evp_pbe.c","lib/libcrypto/evp/evp_pbe.c","EVP_PBE_alg_add_type",217,246
15,3,74,4,16,"EVP_PBE_alg_add@249-265@lib/libcrypto/evp/evp_pbe.c","lib/libcrypto/evp/evp_pbe.c","EVP_PBE_alg_add",249,265
28,9,159,5,29,"EVP_PBE_find@268-297@lib/libcrypto/evp/evp_pbe.c","lib/libcrypto/evp/evp_pbe.c","EVP_PBE_find",268,297
4,1,13,1,3,"free_evp_pbe_ctl@300-303@lib/libcrypto/evp/evp_pbe.c","lib/libcrypto/evp/evp_pbe.c","free_evp_pbe_ctl",300,303
5,1,17,1,4,"EVP_PBE_cleanup@306-310@lib/libcrypto/evp/evp_pbe.c","lib/libcrypto/evp/evp_pbe.c","EVP_PBE_cleanup",306,310
31,6,162,1,36,"EVP_PKCS82PKEY@70-106@lib/libcrypto/evp/evp_pkey.c","lib/libcrypto/evp/evp_pkey.c","EVP_PKCS82PKEY",70,106
4,1,16,1,3,"EVP_PKEY2PKCS8@109-112@lib/libcrypto/evp/evp_pkey.c","lib/libcrypto/evp/evp_pkey.c","EVP_PKEY2PKCS8",109,112
27,5,119,2,29,"EVP_PKEY2PKCS8_broken@117-146@lib/libcrypto/evp/evp_pkey.c","lib/libcrypto/evp/evp_pkey.c","EVP_PKEY2PKCS8_broken",117,146
17,3,63,2,18,"PKCS8_set_broken@149-167@lib/libcrypto/evp/evp_pkey.c","lib/libcrypto/evp/evp_pkey.c","PKCS8_set_broken",149,167
4,1,17,1,3,"EVP_PKEY_get_attr_count@172-175@lib/libcrypto/evp/evp_pkey.c","lib/libcrypto/evp/evp_pkey.c","EVP_PKEY_get_attr_count",172,175
4,1,27,3,3,"EVP_PKEY_get_attr_by_NID@178-181@lib/libcrypto/evp/evp_pkey.c","lib/libcrypto/evp/evp_pkey.c","EVP_PKEY_get_attr_by_NID",178,181
4,1,28,3,3,"EVP_PKEY_get_attr_by_OBJ@184-187@lib/libcrypto/evp/evp_pkey.c","lib/libcrypto/evp/evp_pkey.c","EVP_PKEY_get_attr_by_OBJ",184,187
4,1,22,2,3,"EVP_PKEY_get_attr@190-193@lib/libcrypto/evp/evp_pkey.c","lib/libcrypto/evp/evp_pkey.c","EVP_PKEY_get_attr",190,193
4,1,21,2,3,"EVP_PKEY_delete_attr@196-199@lib/libcrypto/evp/evp_pkey.c","lib/libcrypto/evp/evp_pkey.c","EVP_PKEY_delete_attr",196,199
6,2,30,2,5,"EVP_PKEY_add1_attr@202-207@lib/libcrypto/evp/evp_pkey.c","lib/libcrypto/evp/evp_pkey.c","EVP_PKEY_add1_attr",202,207
7,2,49,5,6,"EVP_PKEY_add1_attr_by_OBJ@210-216@lib/libcrypto/evp/evp_pkey.c","lib/libcrypto/evp/evp_pkey.c","EVP_PKEY_add1_attr_by_OBJ",210,216
7,2,47,5,6,"EVP_PKEY_add1_attr_by_NID@219-225@lib/libcrypto/evp/evp_pkey.c","lib/libcrypto/evp/evp_pkey.c","EVP_PKEY_add1_attr_by_NID",219,225
8,2,49,5,7,"EVP_PKEY_add1_attr_by_txt@228-235@lib/libcrypto/evp/evp_pkey.c","lib/libcrypto/evp/evp_pkey.c","EVP_PKEY_add1_attr_by_txt",228,235
4,1,16,1,3,"init@74-77@lib/libcrypto/evp/m_dss.c","lib/libcrypto/evp/m_dss.c","init",74,77
4,1,28,3,3,"update@80-83@lib/libcrypto/evp/m_dss.c","lib/libcrypto/evp/m_dss.c","update",80,83
4,1,23,2,3,"final@86-89@lib/libcrypto/evp/m_dss.c","lib/libcrypto/evp/m_dss.c","final",86,89
4,1,12,1,3,"EVP_dss@113-116@lib/libcrypto/evp/m_dss.c","lib/libcrypto/evp/m_dss.c","EVP_dss",113,116
4,1,16,1,3,"init@74-77@lib/libcrypto/evp/m_dss1.c","lib/libcrypto/evp/m_dss1.c","init",74,77
4,1,28,3,3,"update@80-83@lib/libcrypto/evp/m_dss1.c","lib/libcrypto/evp/m_dss1.c","update",80,83
4,1,23,2,3,"final@86-89@lib/libcrypto/evp/m_dss1.c","lib/libcrypto/evp/m_dss1.c","final",86,89
4,1,12,1,3,"EVP_dss1@113-116@lib/libcrypto/evp/m_dss1.c","lib/libcrypto/evp/m_dss1.c","EVP_dss1",113,116
4,1,16,1,3,"init@123-126@lib/libcrypto/evp/m_ecdsa.c","lib/libcrypto/evp/m_ecdsa.c","init",123,126
4,1,28,3,3,"update@129-132@lib/libcrypto/evp/m_ecdsa.c","lib/libcrypto/evp/m_ecdsa.c","update",129,132
4,1,23,2,3,"final@135-138@lib/libcrypto/evp/m_ecdsa.c","lib/libcrypto/evp/m_ecdsa.c","final",135,138
4,1,12,1,3,"EVP_ecdsa@162-165@lib/libcrypto/evp/m_ecdsa.c","lib/libcrypto/evp/m_ecdsa.c","EVP_ecdsa",162,165
5,1,18,1,4,"gost2814789_init@60-64@lib/libcrypto/evp/m_gost2814789.c","lib/libcrypto/evp/m_gost2814789.c","gost2814789_init",60,64
4,1,28,3,3,"gost2814789_update@67-70@lib/libcrypto/evp/m_gost2814789.c","lib/libcrypto/evp/m_gost2814789.c","gost2814789_update",67,70
4,1,23,2,3,"gost2814789_final@73-76@lib/libcrypto/evp/m_gost2814789.c","lib/libcrypto/evp/m_gost2814789.c","gost2814789_final",73,76
11,3,66,4,11,"gost2814789_md_ctrl@79-90@lib/libcrypto/evp/m_gost2814789.c","lib/libcrypto/evp/m_gost2814789.c","gost2814789_md_ctrl",79,90
4,1,12,1,3,"EVP_gost2814789imit@106-109@lib/libcrypto/evp/m_gost2814789.c","lib/libcrypto/evp/m_gost2814789.c","EVP_gost2814789imit",106,109
5,1,18,1,4,"gostr341194_init@62-66@lib/libcrypto/evp/m_gostr341194.c","lib/libcrypto/evp/m_gostr341194.c","gostr341194_init",62,66
4,1,28,3,3,"gostr341194_update@69-72@lib/libcrypto/evp/m_gostr341194.c","lib/libcrypto/evp/m_gostr341194.c","gostr341194_update",69,72
4,1,23,2,3,"gostr341194_final@75-78@lib/libcrypto/evp/m_gostr341194.c","lib/libcrypto/evp/m_gostr341194.c","gostr341194_final",75,78
4,1,12,1,3,"EVP_gostr341194@93-96@lib/libcrypto/evp/m_gostr341194.c","lib/libcrypto/evp/m_gostr341194.c","EVP_gostr341194",93,96
4,1,16,1,3,"init@75-78@lib/libcrypto/evp/m_md4.c","lib/libcrypto/evp/m_md4.c","init",75,78
4,1,28,3,3,"update@81-84@lib/libcrypto/evp/m_md4.c","lib/libcrypto/evp/m_md4.c","update",81,84
4,1,23,2,3,"final@87-90@lib/libcrypto/evp/m_md4.c","lib/libcrypto/evp/m_md4.c","final",87,90
4,1,12,1,3,"EVP_md4@114-117@lib/libcrypto/evp/m_md4.c","lib/libcrypto/evp/m_md4.c","EVP_md4",114,117
4,1,16,1,3,"init@75-78@lib/libcrypto/evp/m_md5.c","lib/libcrypto/evp/m_md5.c","init",75,78
4,1,28,3,3,"update@81-84@lib/libcrypto/evp/m_md5.c","lib/libcrypto/evp/m_md5.c","update",81,84
4,1,23,2,3,"final@87-90@lib/libcrypto/evp/m_md5.c","lib/libcrypto/evp/m_md5.c","final",87,90
4,1,12,1,3,"EVP_md5@114-117@lib/libcrypto/evp/m_md5.c","lib/libcrypto/evp/m_md5.c","EVP_md5",114,117
9,3,48,1,10,"md5_sha1_init@29-39@lib/libcrypto/evp/m_md5_sha1.c","lib/libcrypto/evp/m_md5_sha1.c","md5_sha1_init",29,39
9,3,64,3,10,"md5_sha1_update@42-52@lib/libcrypto/evp/m_md5_sha1.c","lib/libcrypto/evp/m_md5_sha1.c","md5_sha1_update",42,52
9,3,59,2,10,"md5_sha1_final@55-65@lib/libcrypto/evp/m_md5_sha1.c","lib/libcrypto/evp/m_md5_sha1.c","md5_sha1_final",55,65
4,1,10,1,3,"EVP_md5_sha1@80-83@lib/libcrypto/evp/m_md5_sha1.c","lib/libcrypto/evp/m_md5_sha1.c","EVP_md5_sha1",80,83
4,1,11,1,3,"init@66-69@lib/libcrypto/evp/m_null.c","lib/libcrypto/evp/m_null.c","init",66,69
4,1,19,3,3,"update@72-75@lib/libcrypto/evp/m_null.c","lib/libcrypto/evp/m_null.c","update",72,75
4,1,16,2,3,"final@78-81@lib/libcrypto/evp/m_null.c","lib/libcrypto/evp/m_null.c","final",78,81
4,1,12,1,3,"EVP_md_null@103-106@lib/libcrypto/evp/m_null.c","lib/libcrypto/evp/m_null.c","EVP_md_null",103,106
4,1,16,1,3,"init@75-78@lib/libcrypto/evp/m_ripemd.c","lib/libcrypto/evp/m_ripemd.c","init",75,78
4,1,28,3,3,"update@81-84@lib/libcrypto/evp/m_ripemd.c","lib/libcrypto/evp/m_ripemd.c","update",81,84
4,1,23,2,3,"final@87-90@lib/libcrypto/evp/m_ripemd.c","lib/libcrypto/evp/m_ripemd.c","final",87,90
4,1,12,1,3,"EVP_ripemd160@114-117@lib/libcrypto/evp/m_ripemd.c","lib/libcrypto/evp/m_ripemd.c","EVP_ripemd160",114,117
4,1,16,1,3,"init@74-77@lib/libcrypto/evp/m_sha1.c","lib/libcrypto/evp/m_sha1.c","init",74,77
4,1,28,3,3,"update@80-83@lib/libcrypto/evp/m_sha1.c","lib/libcrypto/evp/m_sha1.c","update",80,83
4,1,23,2,3,"final@86-89@lib/libcrypto/evp/m_sha1.c","lib/libcrypto/evp/m_sha1.c","final",86,89
4,1,12,1,3,"EVP_sha1@113-116@lib/libcrypto/evp/m_sha1.c","lib/libcrypto/evp/m_sha1.c","EVP_sha1",113,116
4,1,16,1,3,"init224@121-124@lib/libcrypto/evp/m_sha1.c","lib/libcrypto/evp/m_sha1.c","init224",121,124
4,1,16,1,3,"init256@127-130@lib/libcrypto/evp/m_sha1.c","lib/libcrypto/evp/m_sha1.c","init256",127,130
4,1,28,3,3,"update256@137-140@lib/libcrypto/evp/m_sha1.c","lib/libcrypto/evp/m_sha1.c","update256",137,140
4,1,23,2,3,"final256@143-146@lib/libcrypto/evp/m_sha1.c","lib/libcrypto/evp/m_sha1.c","final256",143,146
4,1,12,1,3,"EVP_sha224@170-173@lib/libcrypto/evp/m_sha1.c","lib/libcrypto/evp/m_sha1.c","EVP_sha224",170,173
4,1,12,1,3,"EVP_sha256@197-200@lib/libcrypto/evp/m_sha1.c","lib/libcrypto/evp/m_sha1.c","EVP_sha256",197,200
4,1,16,1,3,"init384@205-208@lib/libcrypto/evp/m_sha1.c","lib/libcrypto/evp/m_sha1.c","init384",205,208
4,1,16,1,3,"init512@211-214@lib/libcrypto/evp/m_sha1.c","lib/libcrypto/evp/m_sha1.c","init512",211,214
4,1,28,3,3,"update512@217-220@lib/libcrypto/evp/m_sha1.c","lib/libcrypto/evp/m_sha1.c","update512",217,220
4,1,23,2,3,"final512@223-226@lib/libcrypto/evp/m_sha1.c","lib/libcrypto/evp/m_sha1.c","final512",223,226
4,1,12,1,3,"EVP_sha384@250-253@lib/libcrypto/evp/m_sha1.c","lib/libcrypto/evp/m_sha1.c","EVP_sha384",250,253
4,1,12,1,3,"EVP_sha512@277-280@lib/libcrypto/evp/m_sha1.c","lib/libcrypto/evp/m_sha1.c","EVP_sha512",277,280
40,16,272,6,42,"do_sigver_init@69-111@lib/libcrypto/evp/m_sigver.c","lib/libcrypto/evp/m_sigver.c","do_sigver_init",69,111
5,1,41,5,4,"EVP_DigestSignInit@114-118@lib/libcrypto/evp/m_sigver.c","lib/libcrypto/evp/m_sigver.c","EVP_DigestSignInit",114,118
5,1,41,5,4,"EVP_DigestVerifyInit@121-125@lib/libcrypto/evp/m_sigver.c","lib/libcrypto/evp/m_sigver.c","EVP_DigestVerifyInit",121,125
38,12,240,3,38,"EVP_DigestSignFinal@128-166@lib/libcrypto/evp/m_sigver.c","lib/libcrypto/evp/m_sigver.c","EVP_DigestSignFinal",128,166
24,6,152,3,24,"EVP_DigestVerifyFinal@169-193@lib/libcrypto/evp/m_sigver.c","lib/libcrypto/evp/m_sigver.c","EVP_DigestVerifyFinal",169,193
4,1,16,1,3,"streebog_init256@61-64@lib/libcrypto/evp/m_streebog.c","lib/libcrypto/evp/m_streebog.c","streebog_init256",61,64
4,1,28,3,3,"streebog_update256@67-70@lib/libcrypto/evp/m_streebog.c","lib/libcrypto/evp/m_streebog.c","streebog_update256",67,70
4,1,23,2,3,"streebog_final256@73-76@lib/libcrypto/evp/m_streebog.c","lib/libcrypto/evp/m_streebog.c","streebog_final256",73,76
4,1,16,1,3,"streebog_init512@79-82@lib/libcrypto/evp/m_streebog.c","lib/libcrypto/evp/m_streebog.c","streebog_init512",79,82
4,1,28,3,3,"streebog_update512@85-88@lib/libcrypto/evp/m_streebog.c","lib/libcrypto/evp/m_streebog.c","streebog_update512",85,88
4,1,23,2,3,"streebog_final512@91-94@lib/libcrypto/evp/m_streebog.c","lib/libcrypto/evp/m_streebog.c","streebog_final512",91,94
4,1,12,1,3,"EVP_streebog256@121-124@lib/libcrypto/evp/m_streebog.c","lib/libcrypto/evp/m_streebog.c","EVP_streebog256",121,124
4,1,12,1,3,"EVP_streebog512@127-130@lib/libcrypto/evp/m_streebog.c","lib/libcrypto/evp/m_streebog.c","EVP_streebog512",127,130
4,1,16,1,3,"init@15-18@lib/libcrypto/evp/m_wp.c","lib/libcrypto/evp/m_wp.c","init",15,18
4,1,28,3,3,"update@21-24@lib/libcrypto/evp/m_wp.c","lib/libcrypto/evp/m_wp.c","update",21,24
4,1,23,2,3,"final@27-30@lib/libcrypto/evp/m_wp.c","lib/libcrypto/evp/m_wp.c","final",27,30
4,1,12,1,3,"EVP_whirlpool@52-55@lib/libcrypto/evp/m_wp.c","lib/libcrypto/evp/m_wp.c","EVP_whirlpool",52,55
14,3,86,1,15,"EVP_add_cipher@66-81@lib/libcrypto/evp/names.c","lib/libcrypto/evp/names.c","EVP_add_cipher",66,81
24,6,167,1,25,"EVP_add_digest@84-109@lib/libcrypto/evp/names.c","lib/libcrypto/evp/names.c","EVP_add_digest",84,109
6,1,33,1,6,"EVP_get_cipherbyname@112-118@lib/libcrypto/evp/names.c","lib/libcrypto/evp/names.c","EVP_get_cipherbyname",112,118
6,1,33,1,6,"EVP_get_digestbyname@121-127@lib/libcrypto/evp/names.c","lib/libcrypto/evp/names.c","EVP_get_digestbyname",121,127
12,2,46,1,15,"EVP_cleanup@130-145@lib/libcrypto/evp/names.c","lib/libcrypto/evp/names.c","EVP_cleanup",130,145
8,2,70,2,8,"do_all_cipher_fn@154-162@lib/libcrypto/evp/names.c","lib/libcrypto/evp/names.c","do_all_cipher_fn",154,162
8,1,60,2,8,"EVP_CIPHER_do_all@165-173@lib/libcrypto/evp/names.c","lib/libcrypto/evp/names.c","EVP_CIPHER_do_all",165,173
9,1,60,2,9,"EVP_CIPHER_do_all_sorted@176-185@lib/libcrypto/evp/names.c","lib/libcrypto/evp/names.c","EVP_CIPHER_do_all_sorted",176,185
8,2,70,2,8,"do_all_md_fn@194-202@lib/libcrypto/evp/names.c","lib/libcrypto/evp/names.c","do_all_md_fn",194,202
8,1,60,2,8,"EVP_MD_do_all@205-213@lib/libcrypto/evp/names.c","lib/libcrypto/evp/names.c","EVP_MD_do_all",205,213
8,1,60,2,8,"EVP_MD_do_all_sorted@216-224@lib/libcrypto/evp/names.c","lib/libcrypto/evp/names.c","EVP_MD_do_all_sorted",216,224
3,1,6,1,2,"PKCS5_PBE_add@71-73@lib/libcrypto/evp/p5_crpt.c","lib/libcrypto/evp/p5_crpt.c","PKCS5_PBE_add",71,73
77,21,527,7,84,"PKCS5_PBE_keyivgen@76-160@lib/libcrypto/evp/p5_crpt.c","lib/libcrypto/evp/p5_crpt.c","PKCS5_PBE_keyivgen",76,160
65,16,470,8,69,"PKCS5_PBKDF2_HMAC@81-150@lib/libcrypto/evp/p5_crpt2.c","lib/libcrypto/evp/p5_crpt2.c","PKCS5_PBKDF2_HMAC",81,150
6,1,54,7,5,"PKCS5_PBKDF2_HMAC_SHA1@153-158@lib/libcrypto/evp/p5_crpt2.c","lib/libcrypto/evp/p5_crpt2.c","PKCS5_PBKDF2_HMAC_SHA1",153,158
40,9,263,7,53,"PKCS5_v2_PBE_keyivgen@166-219@lib/libcrypto/evp/p5_crpt2.c","lib/libcrypto/evp/p5_crpt2.c","PKCS5_v2_PBE_keyivgen",166,219
67,14,426,7,82,"PKCS5_v2_PBKDF2_keyivgen@222-304@lib/libcrypto/evp/p5_crpt2.c","lib/libcrypto/evp/p5_crpt2.c","PKCS5_v2_PBKDF2_keyivgen",222,304
13,2,72,4,19,"EVP_PKEY_decrypt_old@73-92@lib/libcrypto/evp/p_dec.c","lib/libcrypto/evp/p_dec.c","EVP_PKEY_decrypt_old",73,92
12,2,71,4,16,"EVP_PKEY_encrypt_old@73-89@lib/libcrypto/evp/p_enc.c","lib/libcrypto/evp/p_enc.c","EVP_PKEY_encrypt_old",73,89
6,4,35,1,5,"EVP_PKEY_bits@88-93@lib/libcrypto/evp/p_lib.c","lib/libcrypto/evp/p_lib.c","EVP_PKEY_bits",88,93
6,4,35,1,5,"EVP_PKEY_size@96-101@lib/libcrypto/evp/p_lib.c","lib/libcrypto/evp/p_lib.c","EVP_PKEY_size",96,101
16,5,84,2,21,"EVP_PKEY_save_parameters@104-125@lib/libcrypto/evp/p_lib.c","lib/libcrypto/evp/p_lib.c","EVP_PKEY_save_parameters",104,125
15,5,79,2,16,"EVP_PKEY_copy_parameters@128-144@lib/libcrypto/evp/p_lib.c","lib/libcrypto/evp/p_lib.c","EVP_PKEY_copy_parameters",128,144
6,3,34,1,5,"EVP_PKEY_missing_parameters@147-152@lib/libcrypto/evp/p_lib.c","lib/libcrypto/evp/p_lib.c","EVP_PKEY_missing_parameters",147,152
8,4,56,2,7,"EVP_PKEY_cmp_parameters@155-162@lib/libcrypto/evp/p_lib.c","lib/libcrypto/evp/p_lib.c","EVP_PKEY_cmp_parameters",155,162
16,6,95,2,19,"EVP_PKEY_cmp@165-184@lib/libcrypto/evp/p_lib.c","lib/libcrypto/evp/p_lib.c","EVP_PKEY_cmp",165,184
18,2,93,1,18,"EVP_PKEY_new@187-205@lib/libcrypto/evp/p_lib.c","lib/libcrypto/evp/p_lib.c","EVP_PKEY_new",187,205
32,11,178,4,40,"pkey_set_type@212-252@lib/libcrypto/evp/p_lib.c","lib/libcrypto/evp/p_lib.c","pkey_set_type",212,252
4,1,24,2,3,"EVP_PKEY_set_type@255-258@lib/libcrypto/evp/p_lib.c","lib/libcrypto/evp/p_lib.c","EVP_PKEY_set_type",255,258
4,1,28,3,3,"EVP_PKEY_set_type_str@261-264@lib/libcrypto/evp/p_lib.c","lib/libcrypto/evp/p_lib.c","EVP_PKEY_set_type_str",261,264
7,2,43,3,6,"EVP_PKEY_assign@267-273@lib/libcrypto/evp/p_lib.c","lib/libcrypto/evp/p_lib.c","EVP_PKEY_assign",267,273
4,1,15,1,3,"EVP_PKEY_get0@276-279@lib/libcrypto/evp/p_lib.c","lib/libcrypto/evp/p_lib.c","EVP_PKEY_get0",276,279
7,2,34,2,6,"EVP_PKEY_set1_RSA@283-289@lib/libcrypto/evp/p_lib.c","lib/libcrypto/evp/p_lib.c","EVP_PKEY_set1_RSA",283,289
9,2,42,1,8,"EVP_PKEY_get1_RSA@292-300@lib/libcrypto/evp/p_lib.c","lib/libcrypto/evp/p_lib.c","EVP_PKEY_get1_RSA",292,300
7,2,34,2,6,"EVP_PKEY_set1_DSA@305-311@lib/libcrypto/evp/p_lib.c","lib/libcrypto/evp/p_lib.c","EVP_PKEY_set1_DSA",305,311
9,2,42,1,8,"EVP_PKEY_get1_DSA@314-322@lib/libcrypto/evp/p_lib.c","lib/libcrypto/evp/p_lib.c","EVP_PKEY_get1_DSA",314,322
7,2,34,2,6,"EVP_PKEY_set1_EC_KEY@328-334@lib/libcrypto/evp/p_lib.c","lib/libcrypto/evp/p_lib.c","EVP_PKEY_set1_EC_KEY",328,334
9,2,42,1,8,"EVP_PKEY_get1_EC_KEY@337-345@lib/libcrypto/evp/p_lib.c","lib/libcrypto/evp/p_lib.c","EVP_PKEY_get1_EC_KEY",337,345
7,2,34,2,6,"EVP_PKEY_set1_DH@352-358@lib/libcrypto/evp/p_lib.c","lib/libcrypto/evp/p_lib.c","EVP_PKEY_set1_DH",352,358
9,2,42,1,8,"EVP_PKEY_get1_DH@361-369@lib/libcrypto/evp/p_lib.c","lib/libcrypto/evp/p_lib.c","EVP_PKEY_get1_DH",361,369
14,3,56,1,15,"EVP_PKEY_type@373-388@lib/libcrypto/evp/p_lib.c","lib/libcrypto/evp/p_lib.c","EVP_PKEY_type",373,388
4,1,14,1,3,"EVP_PKEY_id@391-394@lib/libcrypto/evp/p_lib.c","lib/libcrypto/evp/p_lib.c","EVP_PKEY_id",391,394
4,1,17,1,3,"EVP_PKEY_base_id@397-400@lib/libcrypto/evp/p_lib.c","lib/libcrypto/evp/p_lib.c","EVP_PKEY_base_id",397,400
13,4,67,1,15,"EVP_PKEY_free@403-418@lib/libcrypto/evp/p_lib.c","lib/libcrypto/evp/p_lib.c","EVP_PKEY_free",403,418
11,4,60,1,12,"EVP_PKEY_free_it@421-433@lib/libcrypto/evp/p_lib.c","lib/libcrypto/evp/p_lib.c","EVP_PKEY_free_it",421,433
7,1,49,4,6,"unsup_alg@436-442@lib/libcrypto/evp/p_lib.c","lib/libcrypto/evp/p_lib.c","unsup_alg",436,442
7,3,60,4,7,"EVP_PKEY_print_public@445-452@lib/libcrypto/evp/p_lib.c","lib/libcrypto/evp/p_lib.c","EVP_PKEY_print_public",445,452
7,3,60,4,7,"EVP_PKEY_print_private@455-462@lib/libcrypto/evp/p_lib.c","lib/libcrypto/evp/p_lib.c","EVP_PKEY_print_private",455,462
7,3,60,4,6,"EVP_PKEY_print_params@465-471@lib/libcrypto/evp/p_lib.c","lib/libcrypto/evp/p_lib.c","EVP_PKEY_print_params",465,471
7,3,46,2,6,"EVP_PKEY_get_default_digest_nid@474-480@lib/libcrypto/evp/p_lib.c","lib/libcrypto/evp/p_lib.c","EVP_PKEY_get_default_digest_nid",474,480
33,9,213,6,41,"EVP_OpenInit@73-114@lib/libcrypto/evp/p_open.c","lib/libcrypto/evp/p_open.c","EVP_OpenInit",73,114
8,2,55,3,8,"EVP_OpenFinal@117-125@lib/libcrypto/evp/p_open.c","lib/libcrypto/evp/p_open.c","EVP_OpenFinal",117,125
26,10,198,7,28,"EVP_SealInit@73-101@lib/libcrypto/evp/p_seal.c","lib/libcrypto/evp/p_seal.c","EVP_SealInit",73,101
8,2,53,3,8,"EVP_SealFinal@116-124@lib/libcrypto/evp/p_seal.c","lib/libcrypto/evp/p_seal.c","EVP_SealFinal",116,124
53,13,338,4,56,"EVP_SignFinal@67-123@lib/libcrypto/evp/p_sign.c","lib/libcrypto/evp/p_sign.c","EVP_SignFinal",67,123
48,12,309,4,51,"EVP_VerifyFinal@67-118@lib/libcrypto/evp/p_verify.c","lib/libcrypto/evp/p_verify.c","EVP_VerifyFinal",67,118
15,6,83,1,15,"EVP_PKEY_sign_init@85-100@lib/libcrypto/evp/pmeth_fn.c","lib/libcrypto/evp/pmeth_fn.c","EVP_PKEY_sign_init",85,100
14,5,101,5,13,"EVP_PKEY_sign@103-116@lib/libcrypto/evp/pmeth_fn.c","lib/libcrypto/evp/pmeth_fn.c","EVP_PKEY_sign",103,116
15,6,83,1,15,"EVP_PKEY_verify_init@119-134@lib/libcrypto/evp/pmeth_fn.c","lib/libcrypto/evp/pmeth_fn.c","EVP_PKEY_verify_init",119,134
13,5,91,5,12,"EVP_PKEY_verify@137-149@lib/libcrypto/evp/pmeth_fn.c","lib/libcrypto/evp/pmeth_fn.c","EVP_PKEY_verify",137,149
15,6,83,1,15,"EVP_PKEY_verify_recover_init@152-167@lib/libcrypto/evp/pmeth_fn.c","lib/libcrypto/evp/pmeth_fn.c","EVP_PKEY_verify_recover_init",152,167
14,5,101,5,13,"EVP_PKEY_verify_recover@170-183@lib/libcrypto/evp/pmeth_fn.c","lib/libcrypto/evp/pmeth_fn.c","EVP_PKEY_verify_recover",170,183
15,6,83,1,15,"EVP_PKEY_encrypt_init@186-201@lib/libcrypto/evp/pmeth_fn.c","lib/libcrypto/evp/pmeth_fn.c","EVP_PKEY_encrypt_init",186,201
14,5,101,5,13,"EVP_PKEY_encrypt@204-217@lib/libcrypto/evp/pmeth_fn.c","lib/libcrypto/evp/pmeth_fn.c","EVP_PKEY_encrypt",204,217
15,6,83,1,15,"EVP_PKEY_decrypt_init@220-235@lib/libcrypto/evp/pmeth_fn.c","lib/libcrypto/evp/pmeth_fn.c","EVP_PKEY_decrypt_init",220,235
14,5,101,5,13,"EVP_PKEY_decrypt@238-251@lib/libcrypto/evp/pmeth_fn.c","lib/libcrypto/evp/pmeth_fn.c","EVP_PKEY_decrypt",238,251
15,6,83,1,15,"EVP_PKEY_derive_init@254-269@lib/libcrypto/evp/pmeth_fn.c","lib/libcrypto/evp/pmeth_fn.c","EVP_PKEY_derive_init",254,269
43,17,262,2,58,"EVP_PKEY_derive_set_peer@272-330@lib/libcrypto/evp/pmeth_fn.c","lib/libcrypto/evp/pmeth_fn.c","EVP_PKEY_derive_set_peer",272,330
13,5,88,3,12,"EVP_PKEY_derive@333-345@lib/libcrypto/evp/pmeth_fn.c","lib/libcrypto/evp/pmeth_fn.c","EVP_PKEY_derive",333,345
15,6,83,1,15,"EVP_PKEY_paramgen_init@70-85@lib/libcrypto/evp/pmeth_gn.c","lib/libcrypto/evp/pmeth_gn.c","EVP_PKEY_paramgen_init",70,85
22,8,120,2,26,"EVP_PKEY_paramgen@88-114@lib/libcrypto/evp/pmeth_gn.c","lib/libcrypto/evp/pmeth_gn.c","EVP_PKEY_paramgen",88,114
15,6,83,1,15,"EVP_PKEY_keygen_init@117-132@lib/libcrypto/evp/pmeth_gn.c","lib/libcrypto/evp/pmeth_gn.c","EVP_PKEY_keygen_init",117,132
22,8,120,2,25,"EVP_PKEY_keygen@135-160@lib/libcrypto/evp/pmeth_gn.c","lib/libcrypto/evp/pmeth_gn.c","EVP_PKEY_keygen",135,160
4,1,18,2,3,"EVP_PKEY_CTX_set_cb@163-166@lib/libcrypto/evp/pmeth_gn.c","lib/libcrypto/evp/pmeth_gn.c","EVP_PKEY_CTX_set_cb",163,166
4,1,13,1,3,"EVP_PKEY_CTX_get_cb@169-172@lib/libcrypto/evp/pmeth_gn.c","lib/libcrypto/evp/pmeth_gn.c","EVP_PKEY_CTX_get_cb",169,172
7,1,48,3,6,"trans_cb@179-185@lib/libcrypto/evp/pmeth_gn.c","lib/libcrypto/evp/pmeth_gn.c","trans_cb",179,185
4,1,20,2,3,"evp_pkey_set_cb_translate@188-191@lib/libcrypto/evp/pmeth_gn.c","lib/libcrypto/evp/pmeth_gn.c","evp_pkey_set_cb_translate",188,191
8,4,46,2,7,"EVP_PKEY_CTX_get_keygen_info@194-201@lib/libcrypto/evp/pmeth_gn.c","lib/libcrypto/evp/pmeth_gn.c","EVP_PKEY_CTX_get_keygen_info",194,201
18,5,113,4,19,"EVP_PKEY_new_mac_key@204-223@lib/libcrypto/evp/pmeth_gn.c","lib/libcrypto/evp/pmeth_gn.c","EVP_PKEY_new_mac_key",204,223
4,1,35,2,3,"pmeth_cmp@111-114@lib/libcrypto/evp/pmeth_lib.c","lib/libcrypto/evp/pmeth_lib.c","pmeth_cmp",111,114
6,1,40,2,5,"pmeth_cmp_BSEARCH_CMP_FN@118-123@lib/libcrypto/evp/pmeth_lib.c","lib/libcrypto/evp/pmeth_lib.c","pmeth_cmp_BSEARCH_CMP_FN",118,123
5,1,45,3,4,"OBJ_bsearch_pmeth@126-130@lib/libcrypto/evp/pmeth_lib.c","lib/libcrypto/evp/pmeth_lib.c","OBJ_bsearch_pmeth",126,130
17,5,97,1,17,"EVP_PKEY_meth_find@133-150@lib/libcrypto/evp/pmeth_lib.c","lib/libcrypto/evp/pmeth_lib.c","EVP_PKEY_meth_find",133,150
50,15,261,3,64,"int_ctx_new@153-217@lib/libcrypto/evp/pmeth_lib.c","lib/libcrypto/evp/pmeth_lib.c","int_ctx_new",153,217
35,2,201,2,38,"EVP_PKEY_meth_new@220-258@lib/libcrypto/evp/pmeth_lib.c","lib/libcrypto/evp/pmeth_lib.c","EVP_PKEY_meth_new",220,258
7,3,39,3,6,"EVP_PKEY_meth_get0_info@261-267@lib/libcrypto/evp/pmeth_lib.c","lib/libcrypto/evp/pmeth_lib.c","EVP_PKEY_meth_get0_info",261,267
28,1,213,2,38,"EVP_PKEY_meth_copy@270-308@lib/libcrypto/evp/pmeth_lib.c","lib/libcrypto/evp/pmeth_lib.c","EVP_PKEY_meth_copy",270,308
5,3,25,1,4,"EVP_PKEY_meth_free@311-315@lib/libcrypto/evp/pmeth_lib.c","lib/libcrypto/evp/pmeth_lib.c","EVP_PKEY_meth_free",311,315
4,1,23,2,3,"EVP_PKEY_CTX_new@318-321@lib/libcrypto/evp/pmeth_lib.c","lib/libcrypto/evp/pmeth_lib.c","EVP_PKEY_CTX_new",318,321
4,1,21,2,3,"EVP_PKEY_CTX_new_id@324-327@lib/libcrypto/evp/pmeth_lib.c","lib/libcrypto/evp/pmeth_lib.c","EVP_PKEY_CTX_new_id",324,327
28,9,189,1,41,"EVP_PKEY_CTX_dup@330-371@lib/libcrypto/evp/pmeth_lib.c","lib/libcrypto/evp/pmeth_lib.c","EVP_PKEY_CTX_dup",330,371
12,4,53,1,11,"EVP_PKEY_meth_add0@374-385@lib/libcrypto/evp/pmeth_lib.c","lib/libcrypto/evp/pmeth_lib.c","EVP_PKEY_meth_add0",374,385
12,5,69,1,15,"EVP_PKEY_CTX_free@388-403@lib/libcrypto/evp/pmeth_lib.c","lib/libcrypto/evp/pmeth_lib.c","EVP_PKEY_CTX_free",388,403
23,10,158,6,29,"EVP_PKEY_CTX_ctrl@406-435@lib/libcrypto/evp/pmeth_lib.c","lib/libcrypto/evp/pmeth_lib.c","EVP_PKEY_CTX_ctrl",406,435
16,7,110,3,15,"EVP_PKEY_CTX_ctrl_str@438-453@lib/libcrypto/evp/pmeth_lib.c","lib/libcrypto/evp/pmeth_lib.c","EVP_PKEY_CTX_ctrl_str",438,453
4,1,13,1,3,"EVP_PKEY_CTX_get_operation@456-459@lib/libcrypto/evp/pmeth_lib.c","lib/libcrypto/evp/pmeth_lib.c","EVP_PKEY_CTX_get_operation",456,459
5,1,27,3,4,"EVP_PKEY_CTX_set0_keygen_info@462-466@lib/libcrypto/evp/pmeth_lib.c","lib/libcrypto/evp/pmeth_lib.c","EVP_PKEY_CTX_set0_keygen_info",462,466
4,1,18,2,3,"EVP_PKEY_CTX_set_data@469-472@lib/libcrypto/evp/pmeth_lib.c","lib/libcrypto/evp/pmeth_lib.c","EVP_PKEY_CTX_set_data",469,472
4,1,13,1,3,"EVP_PKEY_CTX_get_data@475-478@lib/libcrypto/evp/pmeth_lib.c","lib/libcrypto/evp/pmeth_lib.c","EVP_PKEY_CTX_get_data",475,478
4,1,13,1,3,"EVP_PKEY_CTX_get0_pkey@481-484@lib/libcrypto/evp/pmeth_lib.c","lib/libcrypto/evp/pmeth_lib.c","EVP_PKEY_CTX_get0_pkey",481,484
4,1,13,1,3,"EVP_PKEY_CTX_get0_peerkey@487-490@lib/libcrypto/evp/pmeth_lib.c","lib/libcrypto/evp/pmeth_lib.c","EVP_PKEY_CTX_get0_peerkey",487,490
4,1,18,2,3,"EVP_PKEY_CTX_set_app_data@493-496@lib/libcrypto/evp/pmeth_lib.c","lib/libcrypto/evp/pmeth_lib.c","EVP_PKEY_CTX_set_app_data",493,496
4,1,13,1,3,"EVP_PKEY_CTX_get_app_data@499-502@lib/libcrypto/evp/pmeth_lib.c","lib/libcrypto/evp/pmeth_lib.c","EVP_PKEY_CTX_get_app_data",499,502
5,1,25,2,4,"EVP_PKEY_meth_set_init@505-509@lib/libcrypto/evp/pmeth_lib.c","lib/libcrypto/evp/pmeth_lib.c","EVP_PKEY_meth_set_init",505,509
5,1,29,2,4,"EVP_PKEY_meth_set_copy@512-516@lib/libcrypto/evp/pmeth_lib.c","lib/libcrypto/evp/pmeth_lib.c","EVP_PKEY_meth_set_copy",512,516
5,1,25,2,4,"EVP_PKEY_meth_set_cleanup@519-523@lib/libcrypto/evp/pmeth_lib.c","lib/libcrypto/evp/pmeth_lib.c","EVP_PKEY_meth_set_cleanup",519,523
7,1,46,3,6,"EVP_PKEY_meth_set_paramgen@526-532@lib/libcrypto/evp/pmeth_lib.c","lib/libcrypto/evp/pmeth_lib.c","EVP_PKEY_meth_set_paramgen",526,532
7,1,46,3,6,"EVP_PKEY_meth_set_keygen@535-541@lib/libcrypto/evp/pmeth_lib.c","lib/libcrypto/evp/pmeth_lib.c","EVP_PKEY_meth_set_keygen",535,541
8,1,60,3,7,"EVP_PKEY_meth_set_sign@544-551@lib/libcrypto/evp/pmeth_lib.c","lib/libcrypto/evp/pmeth_lib.c","EVP_PKEY_meth_set_sign",544,551
8,1,60,3,7,"EVP_PKEY_meth_set_verify@554-561@lib/libcrypto/evp/pmeth_lib.c","lib/libcrypto/evp/pmeth_lib.c","EVP_PKEY_meth_set_verify",554,561
9,1,60,3,8,"EVP_PKEY_meth_set_verify_recover@564-572@lib/libcrypto/evp/pmeth_lib.c","lib/libcrypto/evp/pmeth_lib.c","EVP_PKEY_meth_set_verify_recover",564,572
8,1,59,3,7,"EVP_PKEY_meth_set_signctx@575-582@lib/libcrypto/evp/pmeth_lib.c","lib/libcrypto/evp/pmeth_lib.c","EVP_PKEY_meth_set_signctx",575,582
8,1,59,3,7,"EVP_PKEY_meth_set_verifyctx@585-592@lib/libcrypto/evp/pmeth_lib.c","lib/libcrypto/evp/pmeth_lib.c","EVP_PKEY_meth_set_verifyctx",585,592
8,1,60,3,7,"EVP_PKEY_meth_set_encrypt@595-602@lib/libcrypto/evp/pmeth_lib.c","lib/libcrypto/evp/pmeth_lib.c","EVP_PKEY_meth_set_encrypt",595,602
8,1,60,3,7,"EVP_PKEY_meth_set_decrypt@605-612@lib/libcrypto/evp/pmeth_lib.c","lib/libcrypto/evp/pmeth_lib.c","EVP_PKEY_meth_set_decrypt",605,612
7,1,51,3,6,"EVP_PKEY_meth_set_derive@615-621@lib/libcrypto/evp/pmeth_lib.c","lib/libcrypto/evp/pmeth_lib.c","EVP_PKEY_meth_set_derive",615,621
7,1,62,3,6,"EVP_PKEY_meth_set_ctrl@624-630@lib/libcrypto/evp/pmeth_lib.c","lib/libcrypto/evp/pmeth_lib.c","EVP_PKEY_meth_set_ctrl",624,630
5,1,67,2,4,"f@63-67@lib/libcrypto/gost/gost2814789.c","lib/libcrypto/gost/gost2814789.c","f",63,67
25,1,566,3,31,"Gost2814789_encrypt@70-101@lib/libcrypto/gost/gost2814789.c","lib/libcrypto/gost/gost2814789.c","Gost2814789_encrypt",70,101
25,1,566,3,31,"Gost2814789_decrypt@104-135@lib/libcrypto/gost/gost2814789.c","lib/libcrypto/gost/gost2814789.c","Gost2814789_decrypt",104,135
23,2,348,3,28,"Gost2814789_mac@138-166@lib/libcrypto/gost/gost2814789.c","lib/libcrypto/gost/gost2814789.c","Gost2814789_mac",138,166
12,4,71,4,12,"Gost2814789_ecb_encrypt@169-181@lib/libcrypto/gost/gost2814789.c","lib/libcrypto/gost/gost2814789.c","Gost2814789_ecb_encrypt",169,181
10,3,62,2,9,"Gost2814789_encrypt_mesh@184-193@lib/libcrypto/gost/gost2814789.c","lib/libcrypto/gost/gost2814789.c","Gost2814789_encrypt_mesh",184,193
10,3,59,3,9,"Gost2814789_mac_mesh@196-205@lib/libcrypto/gost/gost2814789.c","lib/libcrypto/gost/gost2814789.c","Gost2814789_mac_mesh",196,205
97,28,653,7,111,"Gost2814789_cfb64_encrypt@208-319@lib/libcrypto/gost/gost2814789.c","lib/libcrypto/gost/gost2814789.c","Gost2814789_cfb64_encrypt",208,319
23,5,151,3,27,"Gost2814789_cnt_next@322-349@lib/libcrypto/gost/gost2814789.c","lib/libcrypto/gost/gost2814789.c","Gost2814789_cnt_next",322,349
44,14,318,7,52,"Gost2814789_cnt_encrypt@352-404@lib/libcrypto/gost/gost2814789.c","lib/libcrypto/gost/gost2814789.c","Gost2814789_cnt_encrypt",352,404
6,1,47,2,5,"GOST2814789IMIT_Init@407-412@lib/libcrypto/gost/gost2814789.c","lib/libcrypto/gost/gost2814789.c","GOST2814789IMIT_Init",407,412
9,2,53,3,9,"GOST2814789IMIT_block_data_order@415-424@lib/libcrypto/gost/gost2814789.c","lib/libcrypto/gost/gost2814789.c","GOST2814789IMIT_block_data_order",415,424
13,5,121,2,12,"GOST2814789IMIT_Final@439-451@lib/libcrypto/gost/gost2814789.c","lib/libcrypto/gost/gost2814789.c","GOST2814789IMIT_Final",439,451
15,2,119,6,15,"GOST2814789IMIT@454-469@lib/libcrypto/gost/gost2814789.c","lib/libcrypto/gost/gost2814789.c","GOST2814789IMIT",454,469
28,4,181,4,30,"key_diversify_crypto_pro@63-93@lib/libcrypto/gost/gost89_keywrap.c","lib/libcrypto/gost/gost89_keywrap.c","key_diversify_crypto_pro",63,93
17,1,163,5,17,"gost_key_wrap_crypto_pro@96-113@lib/libcrypto/gost/gost89_keywrap.c","lib/libcrypto/gost/gost89_keywrap.c","gost_key_wrap_crypto_pro",96,113
17,2,167,4,20,"gost_key_unwrap_crypto_pro@116-136@lib/libcrypto/gost/gost89_keywrap.c","lib/libcrypto/gost/gost89_keywrap.c","gost_key_unwrap_crypto_pro",116,136
26,5,323,2,30,"Gost2814789_set_sbox@183-213@lib/libcrypto/gost/gost89_params.c","lib/libcrypto/gost/gost89_params.c","Gost2814789_set_sbox",183,213
11,3,64,3,14,"Gost2814789_set_key@216-230@lib/libcrypto/gost/gost89_params.c","lib/libcrypto/gost/gost89_params.c","Gost2814789_set_key",216,230
9,1,76,1,10,"Gost2814789_cryptopro_key_mesh@233-243@lib/libcrypto/gost/gost89_params.c","lib/libcrypto/gost/gost89_params.c","Gost2814789_cryptopro_key_mesh",233,243
4,1,17,1,3,"mackey_free_gost@60-63@lib/libcrypto/gost/gost89imit_ameth.c","lib/libcrypto/gost/gost89imit_ameth.c","mackey_free_gost",60,63
9,2,43,4,8,"mac_ctrl_gost@66-74@lib/libcrypto/gost/gost89imit_ameth.c","lib/libcrypto/gost/gost89imit_ameth.c","mac_ctrl_gost",66,74
9,2,45,1,9,"pkey_gost_mac_init@72-81@lib/libcrypto/gost/gost89imit_pmeth.c","lib/libcrypto/gost/gost89imit_pmeth.c","pkey_gost_mac_init",72,81
5,1,23,1,4,"pkey_gost_mac_cleanup@84-88@lib/libcrypto/gost/gost89imit_pmeth.c","lib/libcrypto/gost/gost89imit_pmeth.c","pkey_gost_mac_cleanup",84,88
10,2,55,2,13,"pkey_gost_mac_copy@91-104@lib/libcrypto/gost/gost89imit_pmeth.c","lib/libcrypto/gost/gost89imit_pmeth.c","pkey_gost_mac_copy",91,104
17,3,90,2,19,"pkey_gost_mac_keygen@107-126@lib/libcrypto/gost/gost89imit_pmeth.c","lib/libcrypto/gost/gost89imit_pmeth.c","pkey_gost_mac_keygen",107,126
45,10,223,4,51,"pkey_gost_mac_ctrl@129-180@lib/libcrypto/gost/gost89imit_pmeth.c","lib/libcrypto/gost/gost89imit_pmeth.c","pkey_gost_mac_ctrl",129,180
23,5,133,3,23,"pkey_gost_mac_ctrl_str@183-206@lib/libcrypto/gost/gost89imit_pmeth.c","lib/libcrypto/gost/gost89imit_pmeth.c","pkey_gost_mac_ctrl_str",183,206
4,1,15,2,3,"pkey_gost_mac_signctx_init@209-212@lib/libcrypto/gost/gost89imit_pmeth.c","lib/libcrypto/gost/gost89imit_pmeth.c","pkey_gost_mac_signctx_init",209,212
13,2,67,4,15,"pkey_gost_mac_signctx@215-230@lib/libcrypto/gost/gost89imit_pmeth.c","lib/libcrypto/gost/gost89imit_pmeth.c","pkey_gost_mac_signctx",215,230
5,1,38,3,4,"d2i_GOST_KEY_TRANSPORT@48-52@lib/libcrypto/gost/gost_asn1.c","lib/libcrypto/gost/gost_asn1.c","d2i_GOST_KEY_TRANSPORT",48,52
4,1,28,2,3,"i2d_GOST_KEY_TRANSPORT@55-58@lib/libcrypto/gost/gost_asn1.c","lib/libcrypto/gost/gost_asn1.c","i2d_GOST_KEY_TRANSPORT",55,58
4,1,17,1,3,"GOST_KEY_TRANSPORT_new@61-64@lib/libcrypto/gost/gost_asn1.c","lib/libcrypto/gost/gost_asn1.c","GOST_KEY_TRANSPORT_new",61,64
4,1,20,1,3,"GOST_KEY_TRANSPORT_free@67-70@lib/libcrypto/gost/gost_asn1.c","lib/libcrypto/gost/gost_asn1.c","GOST_KEY_TRANSPORT_free",67,70
5,1,38,3,4,"d2i_GOST_KEY_INFO@100-104@lib/libcrypto/gost/gost_asn1.c","lib/libcrypto/gost/gost_asn1.c","d2i_GOST_KEY_INFO",100,104
4,1,28,2,3,"i2d_GOST_KEY_INFO@107-110@lib/libcrypto/gost/gost_asn1.c","lib/libcrypto/gost/gost_asn1.c","i2d_GOST_KEY_INFO",107,110
4,1,17,1,3,"GOST_KEY_INFO_new@113-116@lib/libcrypto/gost/gost_asn1.c","lib/libcrypto/gost/gost_asn1.c","GOST_KEY_INFO_new",113,116
4,1,20,1,3,"GOST_KEY_INFO_free@119-122@lib/libcrypto/gost/gost_asn1.c","lib/libcrypto/gost/gost_asn1.c","GOST_KEY_INFO_free",119,122
5,1,38,3,4,"d2i_GOST_KEY_AGREEMENT_INFO@159-163@lib/libcrypto/gost/gost_asn1.c","lib/libcrypto/gost/gost_asn1.c","d2i_GOST_KEY_AGREEMENT_INFO",159,163
4,1,28,2,3,"i2d_GOST_KEY_AGREEMENT_INFO@166-169@lib/libcrypto/gost/gost_asn1.c","lib/libcrypto/gost/gost_asn1.c","i2d_GOST_KEY_AGREEMENT_INFO",166,169
4,1,17,1,3,"GOST_KEY_AGREEMENT_INFO_new@172-175@lib/libcrypto/gost/gost_asn1.c","lib/libcrypto/gost/gost_asn1.c","GOST_KEY_AGREEMENT_INFO_new",172,175
4,1,20,1,3,"GOST_KEY_AGREEMENT_INFO_free@178-181@lib/libcrypto/gost/gost_asn1.c","lib/libcrypto/gost/gost_asn1.c","GOST_KEY_AGREEMENT_INFO_free",178,181
5,1,38,3,4,"d2i_GOST_KEY_PARAMS@219-223@lib/libcrypto/gost/gost_asn1.c","lib/libcrypto/gost/gost_asn1.c","d2i_GOST_KEY_PARAMS",219,223
4,1,28,2,3,"i2d_GOST_KEY_PARAMS@226-229@lib/libcrypto/gost/gost_asn1.c","lib/libcrypto/gost/gost_asn1.c","i2d_GOST_KEY_PARAMS",226,229
4,1,17,1,3,"GOST_KEY_PARAMS_new@232-235@lib/libcrypto/gost/gost_asn1.c","lib/libcrypto/gost/gost_asn1.c","GOST_KEY_PARAMS_new",232,235
4,1,20,1,3,"GOST_KEY_PARAMS_free@238-241@lib/libcrypto/gost/gost_asn1.c","lib/libcrypto/gost/gost_asn1.c","GOST_KEY_PARAMS_free",238,241
5,1,38,3,4,"d2i_GOST_CIPHER_PARAMS@271-275@lib/libcrypto/gost/gost_asn1.c","lib/libcrypto/gost/gost_asn1.c","d2i_GOST_CIPHER_PARAMS",271,275
4,1,28,2,3,"i2d_GOST_CIPHER_PARAMS@278-281@lib/libcrypto/gost/gost_asn1.c","lib/libcrypto/gost/gost_asn1.c","i2d_GOST_CIPHER_PARAMS",278,281
4,1,17,1,3,"GOST_CIPHER_PARAMS_new@284-287@lib/libcrypto/gost/gost_asn1.c","lib/libcrypto/gost/gost_asn1.c","GOST_CIPHER_PARAMS_new",284,287
4,1,20,1,3,"GOST_CIPHER_PARAMS_free@290-293@lib/libcrypto/gost/gost_asn1.c","lib/libcrypto/gost/gost_asn1.c","GOST_CIPHER_PARAMS_free",290,293
8,2,36,1,10,"ERR_load_GOST_strings@105-115@lib/libcrypto/gost/gost_err.c","lib/libcrypto/gost/gost_err.c","ERR_load_GOST_strings",105,115
11,3,75,3,13,"GOST_le2bn@66-79@lib/libcrypto/gost/gostr341001.c","lib/libcrypto/gost/gostr341001.c","GOST_le2bn",66,79
14,4,100,3,18,"GOST_bn2le@82-100@lib/libcrypto/gost/gostr341001.c","lib/libcrypto/gost/gostr341001.c","GOST_bn2le",82,100
38,9,198,1,40,"gost2001_compute_public@103-143@lib/libcrypto/gost/gostr341001.c","lib/libcrypto/gost/gostr341001.c","gost2001_compute_public",103,143
92,29,601,2,100,"gost2001_do_sign@146-246@lib/libcrypto/gost/gostr341001.c","lib/libcrypto/gost/gostr341001.c","gost2001_do_sign",146,246
74,27,563,3,76,"gost2001_do_verify@249-325@lib/libcrypto/gost/gostr341001.c","lib/libcrypto/gost/gostr341001.c","gost2001_do_verify",249,325
38,10,260,5,39,"VKO_compute_key@329-368@lib/libcrypto/gost/gostr341001.c","lib/libcrypto/gost/gostr341001.c","VKO_compute_key",329,368
23,7,135,1,26,"gost2001_keygen@371-397@lib/libcrypto/gost/gostr341001.c","lib/libcrypto/gost/gostr341001.c","gost2001_keygen",371,397
4,1,17,1,3,"pkey_free_gost01@70-73@lib/libcrypto/gost/gostr341001_ameth.c","lib/libcrypto/gost/gostr341001_ameth.c","pkey_free_gost01",70,73
35,8,201,3,37,"decode_gost01_algor_params@80-117@lib/libcrypto/gost/gostr341001_ameth.c","lib/libcrypto/gost/gostr341001_ameth.c","decode_gost01_algor_params",80,117
27,4,155,1,29,"encode_gost01_algor_params@120-149@lib/libcrypto/gost/gostr341001_ameth.c","lib/libcrypto/gost/gostr341001_ameth.c","encode_gost01_algor_params",120,149
15,5,112,2,15,"pub_cmp_gost01@152-167@lib/libcrypto/gost/gostr341001_ameth.c","lib/libcrypto/gost/gostr341001_ameth.c","pub_cmp_gost01",152,167
6,2,28,1,5,"pkey_size_gost01@170-175@lib/libcrypto/gost/gostr341001_ameth.c","lib/libcrypto/gost/gostr341001_ameth.c","pkey_size_gost01",170,175
6,2,28,1,5,"pkey_bits_gost01@178-183@lib/libcrypto/gost/gostr341001_ameth.c","lib/libcrypto/gost/gostr341001_ameth.c","pkey_bits_gost01",178,183
41,6,271,2,47,"pub_decode_gost01@186-233@lib/libcrypto/gost/gostr341001_ameth.c","lib/libcrypto/gost/gostr341001_ameth.c","pub_decode_gost01",186,233
64,10,376,2,76,"pub_encode_gost01@236-312@lib/libcrypto/gost/gostr341001_ameth.c","lib/libcrypto/gost/gostr341001_ameth.c","pub_encode_gost01",236,312
13,3,101,4,13,"param_print_gost01@315-328@lib/libcrypto/gost/gostr341001_ameth.c","lib/libcrypto/gost/gostr341001_ameth.c","param_print_gost01",315,328
42,7,278,4,45,"pub_print_gost01@331-376@lib/libcrypto/gost/gostr341001_ameth.c","lib/libcrypto/gost/gostr341001_ameth.c","pub_print_gost01",331,376
14,3,99,4,15,"priv_print_gost01@379-394@lib/libcrypto/gost/gostr341001_ameth.c","lib/libcrypto/gost/gostr341001_ameth.c","priv_print_gost01",379,394
73,15,452,2,77,"priv_decode_gost01@397-474@lib/libcrypto/gost/gostr341001_ameth.c","lib/libcrypto/gost/gostr341001_ameth.c","priv_decode_gost01",397,474
21,3,131,2,22,"priv_encode_gost01@477-499@lib/libcrypto/gost/gostr341001_ameth.c","lib/libcrypto/gost/gostr341001_ameth.c","priv_encode_gost01",477,499
12,3,69,2,12,"param_encode_gost01@502-514@lib/libcrypto/gost/gostr341001_ameth.c","lib/libcrypto/gost/gostr341001_ameth.c","param_encode_gost01",502,514
45,8,236,3,50,"param_decode_gost01@517-567@lib/libcrypto/gost/gostr341001_ameth.c","lib/libcrypto/gost/gostr341001_ameth.c","param_decode_gost01",517,567
11,4,56,1,11,"param_missing_gost01@570-581@lib/libcrypto/gost/gostr341001_ameth.c","lib/libcrypto/gost/gostr341001_ameth.c","param_missing_gost01",570,581
30,7,172,2,31,"param_copy_gost01@584-615@lib/libcrypto/gost/gostr341001_ameth.c","lib/libcrypto/gost/gostr341001_ameth.c","param_copy_gost01",584,615
10,3,69,2,11,"param_cmp_gost01@618-629@lib/libcrypto/gost/gostr341001_ameth.c","lib/libcrypto/gost/gostr341001_ameth.c","param_cmp_gost01",618,629
34,10,208,4,38,"pkey_ctrl_gost01@632-670@lib/libcrypto/gost/gostr341001_ameth.c","lib/libcrypto/gost/gostr341001_ameth.c","pkey_ctrl_gost01",632,670
15,2,73,1,15,"GOST_KEY_new@75-90@lib/libcrypto/gost/gostr341001_key.c","lib/libcrypto/gost/gostr341001_key.c","GOST_KEY_new",75,90
13,3,73,1,16,"GOST_KEY_free@93-109@lib/libcrypto/gost/gostr341001_key.c","lib/libcrypto/gost/gostr341001_key.c","GOST_KEY_free",93,109
59,16,362,1,66,"GOST_KEY_check_key@112-178@lib/libcrypto/gost/gostr341001_key.c","lib/libcrypto/gost/gostr341001_key.c","GOST_KEY_check_key",112,178
40,15,254,3,50,"GOST_KEY_set_public_key_affine_coordinates@181-231@lib/libcrypto/gost/gostr341001_key.c","lib/libcrypto/gost/gostr341001_key.c","GOST_KEY_set_public_key_affine_coordinates",181,231
4,1,14,1,3,"GOST_KEY_get0_group@234-237@lib/libcrypto/gost/gostr341001_key.c","lib/libcrypto/gost/gostr341001_key.c","GOST_KEY_get0_group",234,237
6,2,42,2,5,"GOST_KEY_set_group@240-245@lib/libcrypto/gost/gostr341001_key.c","lib/libcrypto/gost/gostr341001_key.c","GOST_KEY_set_group",240,245
4,1,14,1,3,"GOST_KEY_get0_private_key@248-251@lib/libcrypto/gost/gostr341001_key.c","lib/libcrypto/gost/gostr341001_key.c","GOST_KEY_get0_private_key",248,251
6,2,42,2,5,"GOST_KEY_set_private_key@254-259@lib/libcrypto/gost/gostr341001_key.c","lib/libcrypto/gost/gostr341001_key.c","GOST_KEY_set_private_key",254,259
4,1,14,1,3,"GOST_KEY_get0_public_key@262-265@lib/libcrypto/gost/gostr341001_key.c","lib/libcrypto/gost/gostr341001_key.c","GOST_KEY_get0_public_key",262,265
6,2,46,2,5,"GOST_KEY_set_public_key@268-273@lib/libcrypto/gost/gostr341001_key.c","lib/libcrypto/gost/gostr341001_key.c","GOST_KEY_set_public_key",268,273
4,1,14,1,3,"GOST_KEY_get_digest@276-279@lib/libcrypto/gost/gostr341001_key.c","lib/libcrypto/gost/gostr341001_key.c","GOST_KEY_get_digest",276,279
10,4,39,2,10,"GOST_KEY_set_digest@281-291@lib/libcrypto/gost/gostr341001_key.c","lib/libcrypto/gost/gostr341001_key.c","GOST_KEY_set_digest",281,291
20,5,103,1,23,"GOST_KEY_get_size@294-317@lib/libcrypto/gost/gostr341001_key.c","lib/libcrypto/gost/gostr341001_key.c","GOST_KEY_get_size",294,317
6,2,19,1,5,"GostR3410_get_md_digest@63-68@lib/libcrypto/gost/gostr341001_params.c","lib/libcrypto/gost/gostr341001_params.c","GostR3410_get_md_digest",63,68
13,4,36,1,12,"GostR3410_get_pk_digest@71-83@lib/libcrypto/gost/gostr341001_params.c","lib/libcrypto/gost/gostr341001_params.c","GostR3410_get_pk_digest",71,83
9,3,59,1,10,"GostR3410_256_param_id@107-117@lib/libcrypto/gost/gostr341001_params.c","lib/libcrypto/gost/gostr341001_params.c","GostR3410_256_param_id",107,117
9,3,59,1,10,"GostR3410_512_param_id@120-130@lib/libcrypto/gost/gostr341001_params.c","lib/libcrypto/gost/gostr341001_params.c","GostR3410_512_param_id",120,130
12,2,72,2,12,"unpack_signature_cp@70-82@lib/libcrypto/gost/gostr341001_pmeth.c","lib/libcrypto/gost/gostr341001_pmeth.c","unpack_signature_cp",70,82
13,3,106,4,15,"pack_signature_cp@85-100@lib/libcrypto/gost/gostr341001_pmeth.c","lib/libcrypto/gost/gostr341001_pmeth.c","pack_signature_cp",85,100
12,2,72,2,12,"unpack_signature_le@103-115@lib/libcrypto/gost/gostr341001_pmeth.c","lib/libcrypto/gost/gostr341001_pmeth.c","unpack_signature_le",103,115
9,1,69,4,8,"pack_signature_le@118-126@lib/libcrypto/gost/gostr341001_pmeth.c","lib/libcrypto/gost/gostr341001_pmeth.c","pack_signature_le",118,126
15,4,99,1,16,"pkey_gost01_init@138-154@lib/libcrypto/gost/gostr341001_pmeth.c","lib/libcrypto/gost/gostr341001_pmeth.c","pkey_gost01_init",138,154
12,3,69,2,13,"pkey_gost01_copy@158-171@lib/libcrypto/gost/gostr341001_pmeth.c","lib/libcrypto/gost/gostr341001_pmeth.c","pkey_gost01_copy",158,171
6,1,30,1,6,"pkey_gost01_cleanup@175-181@lib/libcrypto/gost/gostr341001_pmeth.c","lib/libcrypto/gost/gostr341001_pmeth.c","pkey_gost01_cleanup",175,181
28,8,160,2,34,"pkey_gost01_paramgen@184-218@lib/libcrypto/gost/gostr341001_pmeth.c","lib/libcrypto/gost/gostr341001_pmeth.c","pkey_gost01_paramgen",184,218
6,2,38,2,5,"pkey_gost01_keygen@221-226@lib/libcrypto/gost/gostr341001_pmeth.c","lib/libcrypto/gost/gostr341001_pmeth.c","pkey_gost01_keygen",221,226
48,13,272,5,49,"pkey_gost01_sign@229-278@lib/libcrypto/gost/gostr341001_pmeth.c","lib/libcrypto/gost/gostr341001_pmeth.c","pkey_gost01_sign",229,278
29,6,164,5,30,"pkey_gost01_verify@281-311@lib/libcrypto/gost/gostr341001_pmeth.c","lib/libcrypto/gost/gostr341001_pmeth.c","pkey_gost01_verify",281,311
50,9,312,4,54,"gost01_VKO_key@314-368@lib/libcrypto/gost/gostr341001_pmeth.c","lib/libcrypto/gost/gostr341001_pmeth.c","gost01_VKO_key",314,368
66,12,418,5,72,"pkey_gost01_decrypt@371-443@lib/libcrypto/gost/gostr341001_pmeth.c","lib/libcrypto/gost/gostr341001_pmeth.c","pkey_gost01_decrypt",371,443
18,4,107,3,26,"pkey_gost01_derive@446-472@lib/libcrypto/gost/gostr341001_pmeth.c","lib/libcrypto/gost/gostr341001_pmeth.c","pkey_gost01_derive",446,472
89,24,533,5,94,"pkey_gost01_encrypt@475-569@lib/libcrypto/gost/gostr341001_pmeth.c","lib/libcrypto/gost/gostr341001_pmeth.c","pkey_gost01_encrypt",475,569
60,20,270,4,64,"pkey_gost01_ctrl@573-637@lib/libcrypto/gost/gostr341001_pmeth.c","lib/libcrypto/gost/gostr341001_pmeth.c","pkey_gost01_ctrl",573,637
38,14,228,3,41,"pkey_gost01_ctrl_str@640-681@lib/libcrypto/gost/gostr341001_pmeth.c","lib/libcrypto/gost/gostr341001_pmeth.c","pkey_gost01_ctrl_str",640,681
7,3,63,2,7,"swap_bytes@66-73@lib/libcrypto/gost/gostr341194.c","lib/libcrypto/gost/gostr341194.c","swap_bytes",66,73
9,2,75,2,9,"circle_xor8@77-86@lib/libcrypto/gost/gostr341194.c","lib/libcrypto/gost/gostr341194.c","circle_xor8",77,86
9,1,115,1,9,"transform_3@90-99@lib/libcrypto/gost/gostr341194.c","lib/libcrypto/gost/gostr341194.c","transform_3",90,99
12,2,83,3,12,"add_blocks@103-115@lib/libcrypto/gost/gostr341194.c","lib/libcrypto/gost/gostr341194.c","add_blocks",103,115
7,2,55,4,7,"xor_blocks@119-126@lib/libcrypto/gost/gostr341194.c","lib/libcrypto/gost/gostr341194.c","xor_blocks",119,126
55,3,527,3,67,"hash_step@133-200@lib/libcrypto/gost/gostr341194.c","lib/libcrypto/gost/gostr341194.c","hash_step",133,200
5,1,35,2,4,"GOSTR341194_Init@203-207@lib/libcrypto/gost/gostr341194.c","lib/libcrypto/gost/gostr341194.c","GOSTR341194_Init",203,207
10,2,61,3,10,"GOSTR341194_block_data_order@210-220@lib/libcrypto/gost/gostr341194.c","lib/libcrypto/gost/gostr341194.c","GOSTR341194_block_data_order",210,220
18,2,154,2,21,"GOSTR341194_Final@235-256@lib/libcrypto/gost/gostr341194.c","lib/libcrypto/gost/gostr341194.c","GOSTR341194_Final",235,256
13,3,90,4,13,"GOSTR341194@259-272@lib/libcrypto/gost/gostr341194.c","lib/libcrypto/gost/gostr341194.c","GOSTR341194",259,272
13,1,212,2,14,"multipermute@1171-1185@lib/libcrypto/gost/streebog.c","lib/libcrypto/gost/streebog.c","multipermute",1171,1185
21,1,240,3,22,"transform@1188-1210@lib/libcrypto/gost/streebog.c","lib/libcrypto/gost/streebog.c","transform",1188,1210
21,2,257,3,23,"gN@1213-1236@lib/libcrypto/gost/streebog.c","lib/libcrypto/gost/streebog.c","gN",1213,1236
23,8,215,3,27,"streebog_single_block@1240-1267@lib/libcrypto/gost/streebog.c","lib/libcrypto/gost/streebog.c","streebog_single_block",1240,1267
7,2,48,3,7,"streebog_block_data_order@1272-1279@lib/libcrypto/gost/streebog.c","lib/libcrypto/gost/streebog.c","streebog_block_data_order",1272,1279
67,10,784,2,84,"STREEBOG512_Final@1282-1366@lib/libcrypto/gost/streebog.c","lib/libcrypto/gost/streebog.c","STREEBOG512_Final",1282,1366
4,1,21,2,3,"STREEBOG256_Final@1369-1372@lib/libcrypto/gost/streebog.c","lib/libcrypto/gost/streebog.c","STREEBOG256_Final",1369,1372
32,6,206,3,37,"STREEBOG512_Update@1375-1412@lib/libcrypto/gost/streebog.c","lib/libcrypto/gost/streebog.c","STREEBOG512_Update",1375,1412
4,1,26,3,3,"STREEBOG256_Update@1415-1418@lib/libcrypto/gost/streebog.c","lib/libcrypto/gost/streebog.c","STREEBOG256_Update",1415,1418
4,1,23,2,3,"STREEBOG512_Transform@1421-1424@lib/libcrypto/gost/streebog.c","lib/libcrypto/gost/streebog.c","STREEBOG512_Transform",1421,1424
7,1,46,1,7,"STREEBOG256_Init@1427-1434@lib/libcrypto/gost/streebog.c","lib/libcrypto/gost/streebog.c","STREEBOG256_Init",1427,1434
8,1,52,1,8,"STREEBOG512_Init@1437-1445@lib/libcrypto/gost/streebog.c","lib/libcrypto/gost/streebog.c","STREEBOG512_Init",1437,1445
12,2,79,3,12,"STREEBOG256@1448-1460@lib/libcrypto/gost/streebog.c","lib/libcrypto/gost/streebog.c","STREEBOG256",1448,1460
12,2,79,3,12,"STREEBOG512@1463-1475@lib/libcrypto/gost/streebog.c","lib/libcrypto/gost/streebog.c","STREEBOG512",1463,1475
14,3,99,9,15,"HKDF@26-41@lib/libcrypto/hkdf/hkdf.c","lib/libcrypto/hkdf/hkdf.c","HKDF",26,41
13,2,77,7,17,"HKDF_extract@45-62@lib/libcrypto/hkdf/hkdf.c","lib/libcrypto/hkdf/hkdf.c","HKDF_extract",45,62
41,13,286,7,50,"HKDF_expand@66-116@lib/libcrypto/hkdf/hkdf.c","lib/libcrypto/hkdf/hkdf.c","HKDF_expand",66,116
4,1,12,1,3,"hmac_size@74-77@lib/libcrypto/hmac/hm_ameth.c","lib/libcrypto/hmac/hm_ameth.c","hmac_size",74,77
9,3,50,1,9,"hmac_key_free@80-89@lib/libcrypto/hmac/hm_ameth.c","lib/libcrypto/hmac/hm_ameth.c","hmac_key_free",80,89
10,2,45,4,9,"hmac_pkey_ctrl@92-101@lib/libcrypto/hmac/hm_ameth.c","lib/libcrypto/hmac/hm_ameth.c","hmac_pkey_ctrl",92,101
15,4,82,3,16,"old_hmac_decode@110-126@lib/libcrypto/hmac/hm_ameth.c","lib/libcrypto/hmac/hm_ameth.c","old_hmac_decode",110,126
18,5,105,2,21,"old_hmac_encode@129-150@lib/libcrypto/hmac/hm_ameth.c","lib/libcrypto/hmac/hm_ameth.c","old_hmac_encode",129,150
16,2,91,1,18,"pkey_hmac_init@78-96@lib/libcrypto/hmac/hm_pmeth.c","lib/libcrypto/hmac/hm_pmeth.c","pkey_hmac_init",78,96
18,5,116,2,18,"pkey_hmac_copy@99-117@lib/libcrypto/hmac/hm_pmeth.c","lib/libcrypto/hmac/hm_pmeth.c","pkey_hmac_copy",99,117
7,1,44,1,7,"pkey_hmac_cleanup@120-127@lib/libcrypto/hmac/hm_pmeth.c","lib/libcrypto/hmac/hm_pmeth.c","pkey_hmac_cleanup",120,127
12,3,68,2,13,"pkey_hmac_keygen@130-143@lib/libcrypto/hmac/hm_pmeth.c","lib/libcrypto/hmac/hm_pmeth.c","pkey_hmac_keygen",130,143
7,2,47,3,7,"int_update@146-153@lib/libcrypto/hmac/hm_pmeth.c","lib/libcrypto/hmac/hm_pmeth.c","int_update",146,153
8,1,50,2,8,"hmac_signctx_init@156-164@lib/libcrypto/hmac/hm_pmeth.c","lib/libcrypto/hmac/hm_pmeth.c","hmac_signctx_init",156,164
16,4,93,4,17,"hmac_signctx@167-184@lib/libcrypto/hmac/hm_pmeth.c","lib/libcrypto/hmac/hm_pmeth.c","hmac_signctx",167,184
25,9,149,4,28,"pkey_hmac_ctrl@187-215@lib/libcrypto/hmac/hm_pmeth.c","lib/libcrypto/hmac/hm_pmeth.c","pkey_hmac_ctrl",187,215
21,5,127,3,20,"pkey_hmac_ctrl_str@218-238@lib/libcrypto/hmac/hm_pmeth.c","lib/libcrypto/hmac/hm_pmeth.c","pkey_hmac_ctrl_str",218,238
61,24,457,5,66,"HMAC_Init_ex@67-133@lib/libcrypto/hmac/hmac.c","lib/libcrypto/hmac/hmac.c","HMAC_Init_ex",67,133
6,3,46,4,5,"HMAC_Init@136-141@lib/libcrypto/hmac/hmac.c","lib/libcrypto/hmac/hmac.c","HMAC_Init",136,141
6,2,41,3,6,"HMAC_Update@144-150@lib/libcrypto/hmac/hmac.c","lib/libcrypto/hmac/hmac.c","HMAC_Update",144,150
18,6,122,3,19,"HMAC_Final@153-172@lib/libcrypto/hmac/hmac.c","lib/libcrypto/hmac/hmac.c","HMAC_Final",153,172
7,1,38,1,6,"HMAC_CTX_init@175-181@lib/libcrypto/hmac/hmac.c","lib/libcrypto/hmac/hmac.c","HMAC_CTX_init",175,181
15,4,106,2,14,"HMAC_CTX_copy@184-198@lib/libcrypto/hmac/hmac.c","lib/libcrypto/hmac/hmac.c","HMAC_CTX_copy",184,198
7,1,43,1,6,"HMAC_CTX_cleanup@201-207@lib/libcrypto/hmac/hmac.c","lib/libcrypto/hmac/hmac.c","HMAC_CTX_cleanup",201,207
20,5,133,7,20,"HMAC@210-230@lib/libcrypto/hmac/hmac.c","lib/libcrypto/hmac/hmac.c","HMAC",210,230
6,1,42,2,5,"HMAC_CTX_set_flags@233-238@lib/libcrypto/hmac/hmac.c","lib/libcrypto/hmac/hmac.c","HMAC_CTX_set_flags",233,238
72,6,497,6,72,"idea_cbc_encrypt@62-134@lib/libcrypto/idea/i_cbc.c","lib/libcrypto/idea/i_cbc.c","idea_cbc_encrypt",62,134
26,1,219,2,32,"idea_encrypt@136-168@lib/libcrypto/idea/i_cbc.c","lib/libcrypto/idea/i_cbc.c","idea_encrypt",136,168
54,6,396,7,54,"idea_cfb64_encrypt@67-121@lib/libcrypto/idea/i_cfb64.c","lib/libcrypto/idea/i_cfb64.c","idea_cfb64_encrypt",67,121
7,2,29,1,6,"idea_options@63-69@lib/libcrypto/idea/i_ecb.c","lib/libcrypto/idea/i_ecb.c","idea_options",63,69
11,1,109,3,11,"idea_ecb_encrypt@71-82@lib/libcrypto/idea/i_ecb.c","lib/libcrypto/idea/i_ecb.c","idea_ecb_encrypt",71,82
44,4,296,6,44,"idea_ofb64_encrypt@66-110@lib/libcrypto/idea/i_ofb64.c","lib/libcrypto/idea/i_ofb64.c","idea_ofb64_encrypt",66,110
31,3,408,2,32,"idea_set_encrypt_key@64-96@lib/libcrypto/idea/i_skey.c","lib/libcrypto/idea/i_skey.c","idea_set_encrypt_key",64,96
25,3,238,2,27,"idea_set_decrypt_key@98-125@lib/libcrypto/idea/i_skey.c","lib/libcrypto/idea/i_skey.c","idea_set_decrypt_key",98,125
28,5,135,1,29,"inverse@128-157@lib/libcrypto/idea/i_skey.c","lib/libcrypto/idea/i_skey.c","inverse",128,157
24,2,232,2,25,"lh_stats@73-98@lib/libcrypto/lhash/lh_stats.c","lib/libcrypto/lhash/lh_stats.c","lh_stats",73,98
10,3,78,2,10,"lh_node_stats@101-111@lib/libcrypto/lhash/lh_stats.c","lib/libcrypto/lhash/lh_stats.c","lh_node_stats",101,111
24,5,185,2,24,"lh_node_usage_stats@114-138@lib/libcrypto/lhash/lh_stats.c","lib/libcrypto/lhash/lh_stats.c","lh_node_usage_stats",114,138
11,2,59,2,11,"lh_stats@143-154@lib/libcrypto/lhash/lh_stats.c","lib/libcrypto/lhash/lh_stats.c","lh_stats",143,154
11,2,59,2,11,"lh_node_stats@157-168@lib/libcrypto/lhash/lh_stats.c","lib/libcrypto/lhash/lh_stats.c","lh_node_stats",157,168
11,2,59,2,11,"lh_node_usage_stats@171-182@lib/libcrypto/lhash/lh_stats.c","lib/libcrypto/lhash/lh_stats.c","lh_node_usage_stats",171,182
25,2,233,2,26,"lh_stats_bio@186-212@lib/libcrypto/lhash/lh_stats.c","lib/libcrypto/lhash/lh_stats.c","lh_stats_bio",186,212
10,3,79,2,10,"lh_node_stats_bio@215-225@lib/libcrypto/lhash/lh_stats.c","lib/libcrypto/lhash/lh_stats.c","lh_node_stats_bio",215,225
24,5,186,2,24,"lh_node_usage_stats_bio@228-252@lib/libcrypto/lhash/lh_stats.c","lib/libcrypto/lhash/lh_stats.c","lh_node_usage_stats_bio",228,252
39,6,271,2,42,"lh_new@116-158@lib/libcrypto/lhash/lhash.c","lib/libcrypto/lhash/lhash.c","lh_new",116,158
17,4,88,1,18,"lh_free@161-179@lib/libcrypto/lhash/lhash.c","lib/libcrypto/lhash/lhash.c","lh_free",161,179
30,4,173,2,34,"lh_insert@182-216@lib/libcrypto/lhash/lhash.c","lib/libcrypto/lhash/lhash.c","lh_insert",182,216
23,4,139,2,26,"lh_delete@219-245@lib/libcrypto/lhash/lhash.c","lib/libcrypto/lhash/lhash.c","lh_delete",219,245
16,2,84,2,17,"lh_retrieve@248-265@lib/libcrypto/lhash/lhash.c","lib/libcrypto/lhash/lhash.c","lh_retrieve",248,265
19,5,106,5,26,"doall_util_fn@268-294@lib/libcrypto/lhash/lhash.c","lib/libcrypto/lhash/lhash.c","doall_util_fn",268,294
4,1,27,2,3,"lh_doall@297-300@lib/libcrypto/lhash/lhash.c","lib/libcrypto/lhash/lhash.c","lh_doall",297,300
4,1,31,3,3,"lh_doall_arg@303-306@lib/libcrypto/lhash/lhash.c","lib/libcrypto/lhash/lhash.c","lh_doall_arg",303,306
41,6,304,1,48,"expand@309-357@lib/libcrypto/lhash/lhash.c","lib/libcrypto/lhash/lhash.c","expand",309,357
29,5,202,1,32,"contract@360-392@lib/libcrypto/lhash/lhash.c","lib/libcrypto/lhash/lhash.c","contract",360,392
26,5,182,3,30,"getrn@394-424@lib/libcrypto/lhash/lhash.c","lib/libcrypto/lhash/lhash.c","getrn",394,424
19,5,125,1,20,"lh_strhash@431-451@lib/libcrypto/lhash/lhash.c","lib/libcrypto/lhash/lhash.c","lh_strhash",431,451
4,2,18,1,3,"lh_num_items@454-457@lib/libcrypto/lhash/lhash.c","lib/libcrypto/lhash/lhash.c","lh_num_items",454,457
9,1,48,1,8,"MD4_Init@72-80@lib/libcrypto/md4/md4_dgst.c","lib/libcrypto/md4/md4_dgst.c","MD4_Init",72,80
69,2,1325,3,80,"md4_block_data_order@86-166@lib/libcrypto/md4/md4_dgst.c","lib/libcrypto/md4/md4_dgst.c","md4_block_data_order",86,166
12,3,85,3,12,"MD4@64-76@lib/libcrypto/md4/md4_one.c","lib/libcrypto/md4/md4_one.c","MD4",64,76
9,1,48,1,8,"MD5_Init@72-80@lib/libcrypto/md5/md5_dgst.c","lib/libcrypto/md5/md5_dgst.c","MD5_Init",72,80
84,2,1645,3,96,"md5_block_data_order@86-182@lib/libcrypto/md5/md5_dgst.c","lib/libcrypto/md5/md5_dgst.c","md5_block_data_order",86,182
12,3,85,3,12,"MD5@64-76@lib/libcrypto/md5/md5_one.c","lib/libcrypto/md5/md5_one.c","MD5",64,76
43,13,330,6,45,"CRYPTO_cbc128_encrypt@69-114@lib/libcrypto/modes/cbc128.c","lib/libcrypto/modes/cbc128.c","CRYPTO_cbc128_encrypt",69,114
81,22,635,6,86,"CRYPTO_cbc128_decrypt@116-202@lib/libcrypto/modes/cbc128.c","lib/libcrypto/modes/cbc128.c","CRYPTO_cbc128_decrypt",116,202
9,1,103,5,8,"CRYPTO_ccm128_init@63-71@lib/libcrypto/modes/ccm128.c","lib/libcrypto/modes/ccm128.c","CRYPTO_ccm128_init",63,71
21,4,300,4,25,"CRYPTO_ccm128_setiv@76-101@lib/libcrypto/modes/ccm128.c","lib/libcrypto/modes/ccm128.c","CRYPTO_ccm128_setiv",76,101
43,8,542,3,46,"CRYPTO_ccm128_aad@104-150@lib/libcrypto/modes/ccm128.c","lib/libcrypto/modes/ccm128.c","CRYPTO_ccm128_aad",104,150
12,3,56,1,12,"ctr64_inc@156-168@lib/libcrypto/modes/ccm128.c","lib/libcrypto/modes/ccm128.c","ctr64_inc",156,168
57,12,697,4,73,"CRYPTO_ccm128_encrypt@170-243@lib/libcrypto/modes/ccm128.c","lib/libcrypto/modes/ccm128.c","CRYPTO_ccm128_encrypt",170,243
50,10,611,4,64,"CRYPTO_ccm128_decrypt@245-309@lib/libcrypto/modes/ccm128.c","lib/libcrypto/modes/ccm128.c","CRYPTO_ccm128_decrypt",245,309
11,4,76,2,11,"ctr64_add@311-322@lib/libcrypto/modes/ccm128.c","lib/libcrypto/modes/ccm128.c","ctr64_add",311,322
46,11,507,5,55,"CRYPTO_ccm128_encrypt_ccm64@324-379@lib/libcrypto/modes/ccm128.c","lib/libcrypto/modes/ccm128.c","CRYPTO_ccm128_encrypt_ccm64",324,379
43,9,449,5,51,"CRYPTO_ccm128_decrypt_ccm64@381-432@lib/libcrypto/modes/ccm128.c","lib/libcrypto/modes/ccm128.c","CRYPTO_ccm128_decrypt_ccm64",381,432
7,2,69,3,7,"CRYPTO_ccm128_tag@434-441@lib/libcrypto/modes/ccm128.c","lib/libcrypto/modes/ccm128.c","CRYPTO_ccm128_tag",434,441
92,28,688,8,103,"CRYPTO_cfb128_encrypt@66-169@lib/libcrypto/modes/cfb128.c","lib/libcrypto/modes/cfb128.c","CRYPTO_cfb128_encrypt",66,169
25,8,250,7,31,"cfbr_encrypt_block@173-204@lib/libcrypto/modes/cfb128.c","lib/libcrypto/modes/cfb128.c","cfbr_encrypt_block",173,204
15,3,173,8,15,"CRYPTO_cfb128_1_encrypt@207-222@lib/libcrypto/modes/cfb128.c","lib/libcrypto/modes/cfb128.c","CRYPTO_cfb128_1_encrypt",207,222
9,2,81,8,9,"CRYPTO_cfb128_8_encrypt@224-233@lib/libcrypto/modes/cfb128.c","lib/libcrypto/modes/cfb128.c","CRYPTO_cfb128_8_encrypt",224,233
11,3,51,1,11,"ctr128_inc@67-78@lib/libcrypto/modes/ctr128.c","lib/libcrypto/modes/ctr128.c","ctr128_inc",67,78
15,4,73,1,17,"ctr128_inc_aligned@82-99@lib/libcrypto/modes/ctr128.c","lib/libcrypto/modes/ctr128.c","ctr128_inc_aligned",82,99
50,14,361,8,59,"CRYPTO_ctr128_encrypt@115-174@lib/libcrypto/modes/ctr128.c","lib/libcrypto/modes/ctr128.c","CRYPTO_ctr128_encrypt",115,174
11,3,51,1,11,"ctr96_inc@177-188@lib/libcrypto/modes/ctr128.c","lib/libcrypto/modes/ctr128.c","ctr96_inc",177,188
44,11,316,8,61,"CRYPTO_ctr128_encrypt_ctr32@190-251@lib/libcrypto/modes/ctr128.c","lib/libcrypto/modes/ctr128.c","CRYPTO_ctr128_encrypt_ctr32",190,251
17,4,152,6,23,"CRYPTO_cts128_encrypt_block@32-55@lib/libcrypto/modes/cts128.c","lib/libcrypto/modes/cts128.c","CRYPTO_cts128_encrypt_block",32,55
17,4,142,6,24,"CRYPTO_nistcts128_encrypt_block@57-81@lib/libcrypto/modes/cts128.c","lib/libcrypto/modes/cts128.c","CRYPTO_nistcts128_encrypt_block",57,81
17,3,169,6,22,"CRYPTO_cts128_encrypt@83-105@lib/libcrypto/modes/cts128.c","lib/libcrypto/modes/cts128.c","CRYPTO_cts128_encrypt",83,105
17,3,159,6,23,"CRYPTO_nistcts128_encrypt@107-130@lib/libcrypto/modes/cts128.c","lib/libcrypto/modes/cts128.c","CRYPTO_nistcts128_encrypt",107,130
26,6,258,6,33,"CRYPTO_cts128_decrypt_block@132-165@lib/libcrypto/modes/cts128.c","lib/libcrypto/modes/cts128.c","CRYPTO_cts128_decrypt_block",132,165
31,6,292,6,39,"CRYPTO_nistcts128_decrypt_block@167-206@lib/libcrypto/modes/cts128.c","lib/libcrypto/modes/cts128.c","CRYPTO_nistcts128_decrypt_block",167,206
20,4,207,6,26,"CRYPTO_cts128_decrypt@208-234@lib/libcrypto/modes/cts128.c","lib/libcrypto/modes/cts128.c","CRYPTO_cts128_decrypt",208,234
24,4,226,6,31,"CRYPTO_nistcts128_decrypt@236-267@lib/libcrypto/modes/cts128.c","lib/libcrypto/modes/cts128.c","CRYPTO_nistcts128_decrypt",236,267
20,4,177,2,22,"gcm_init_8bit@121-143@lib/libcrypto/modes/gcm128.c","lib/libcrypto/modes/gcm128.c","gcm_init_8bit",121,143
92,6,1595,2,105,"gcm_gmult_8bit@145-250@lib/libcrypto/modes/gcm128.c","lib/libcrypto/modes/gcm128.c","gcm_gmult_8bit",145,250
54,10,744,2,69,"gcm_init_4bit@255-324@lib/libcrypto/modes/gcm128.c","lib/libcrypto/modes/gcm128.c","gcm_init_4bit",255,324
41,7,442,2,59,"gcm_gmult_4bit@333-392@lib/libcrypto/modes/gcm128.c","lib/libcrypto/modes/gcm128.c","gcm_gmult_4bit",333,392
46,14,330,7,53,"CRYPTO_ofb128_encrypt@66-119@lib/libcrypto/modes/ofb128.c","lib/libcrypto/modes/ofb128.c","CRYPTO_ofb128_encrypt",66,119
90,17,1160,6,123,"CRYPTO_xts128_encrypt@62-185@lib/libcrypto/modes/xts128.c","lib/libcrypto/modes/xts128.c","CRYPTO_xts128_encrypt",62,185
7,2,29,1,6,"OBJ_NAME_init@43-49@lib/libcrypto/objects/o_names.c","lib/libcrypto/objects/o_names.c","OBJ_NAME_init",43,49
37,9,229,3,38,"OBJ_NAME_new_index@52-90@lib/libcrypto/objects/o_names.c","lib/libcrypto/objects/o_names.c","OBJ_NAME_new_index",52,90
16,4,121,2,16,"obj_name_cmp@94-110@lib/libcrypto/objects/o_names.c","lib/libcrypto/objects/o_names.c","obj_name_cmp",94,110
14,3,87,1,14,"obj_name_hash@114-128@lib/libcrypto/objects/o_names.c","lib/libcrypto/objects/o_names.c","obj_name_hash",114,128
25,9,147,2,28,"OBJ_NAME_get@131-159@lib/libcrypto/objects/o_names.c","lib/libcrypto/objects/o_names.c","OBJ_NAME_get",131,159
32,8,191,3,43,"OBJ_NAME_add@162-205@lib/libcrypto/objects/o_names.c","lib/libcrypto/objects/o_names.c","OBJ_NAME_add",162,205
21,5,124,2,27,"OBJ_NAME_remove@208-235@lib/libcrypto/objects/o_names.c","lib/libcrypto/objects/o_names.c","OBJ_NAME_remove",208,235
5,2,35,2,4,"do_all_fn_doall_arg@244-248@lib/libcrypto/objects/o_names.c","lib/libcrypto/objects/o_names.c","do_all_fn_doall_arg",244,248
9,1,63,3,10,"OBJ_NAME_do_all@253-263@lib/libcrypto/objects/o_names.c","lib/libcrypto/objects/o_names.c","OBJ_NAME_do_all",253,263
7,2,44,2,8,"do_all_sorted_fn@272-280@lib/libcrypto/objects/o_names.c","lib/libcrypto/objects/o_names.c","do_all_sorted_fn",272,280
6,1,50,2,6,"do_all_sorted_cmp@283-289@lib/libcrypto/objects/o_names.c","lib/libcrypto/objects/o_names.c","do_all_sorted_cmp",283,289
17,3,142,3,20,"OBJ_NAME_do_all_sorted@292-312@lib/libcrypto/objects/o_names.c","lib/libcrypto/objects/o_names.c","OBJ_NAME_do_all_sorted",292,312
7,4,39,1,7,"names_lh_free_doall@317-324@lib/libcrypto/objects/o_names.c","lib/libcrypto/objects/o_names.c","names_lh_free_doall",317,324
4,1,12,1,3,"name_funcs_free@329-332@lib/libcrypto/objects/o_names.c","lib/libcrypto/objects/o_names.c","name_funcs_free",329,332
17,3,83,1,19,"OBJ_NAME_cleanup@335-354@lib/libcrypto/objects/o_names.c","lib/libcrypto/objects/o_names.c","OBJ_NAME_cleanup",335,354
4,1,38,2,3,"sn_cmp@99-102@lib/libcrypto/objects/obj_dat.c","lib/libcrypto/objects/obj_dat.c","sn_cmp",99,102
6,1,39,2,5,"sn_cmp_BSEARCH_CMP_FN@106-111@lib/libcrypto/objects/obj_dat.c","lib/libcrypto/objects/obj_dat.c","sn_cmp_BSEARCH_CMP_FN",106,111
5,1,42,3,4,"OBJ_bsearch_sn@114-118@lib/libcrypto/objects/obj_dat.c","lib/libcrypto/objects/obj_dat.c","OBJ_bsearch_sn",114,118
4,1,38,2,3,"ln_cmp@120-123@lib/libcrypto/objects/obj_dat.c","lib/libcrypto/objects/obj_dat.c","ln_cmp",120,123
6,1,39,2,5,"ln_cmp_BSEARCH_CMP_FN@127-132@lib/libcrypto/objects/obj_dat.c","lib/libcrypto/objects/obj_dat.c","ln_cmp_BSEARCH_CMP_FN",127,132
5,1,42,3,4,"OBJ_bsearch_ln@135-139@lib/libcrypto/objects/obj_dat.c","lib/libcrypto/objects/obj_dat.c","OBJ_bsearch_ln",135,139
30,6,162,1,31,"added_obj_hash@142-173@lib/libcrypto/objects/obj_dat.c","lib/libcrypto/objects/obj_dat.c","added_obj_hash",142,173
35,11,218,2,36,"added_obj_cmp@177-213@lib/libcrypto/objects/obj_dat.c","lib/libcrypto/objects/obj_dat.c","added_obj_cmp",177,213
7,2,29,1,6,"init_added@217-223@lib/libcrypto/objects/obj_dat.c","lib/libcrypto/objects/obj_dat.c","init_added",217,223
7,1,28,1,6,"cleanup1_doall@226-232@lib/libcrypto/objects/obj_dat.c","lib/libcrypto/objects/obj_dat.c","cleanup1_doall",226,232
4,1,15,1,3,"cleanup2_doall@234-237@lib/libcrypto/objects/obj_dat.c","lib/libcrypto/objects/obj_dat.c","cleanup2_doall",234,237
6,2,31,1,5,"cleanup3_doall@240-245@lib/libcrypto/objects/obj_dat.c","lib/libcrypto/objects/obj_dat.c","cleanup3_doall",240,245
5,3,19,1,4,"check_defer@259-263@lib/libcrypto/objects/obj_dat.c","lib/libcrypto/objects/obj_dat.c","check_defer",259,263
15,3,72,1,14,"OBJ_cleanup@266-280@lib/libcrypto/objects/obj_dat.c","lib/libcrypto/objects/obj_dat.c","OBJ_cleanup",266,280
7,1,23,1,7,"OBJ_new_nid@283-290@lib/libcrypto/objects/obj_dat.c","lib/libcrypto/objects/obj_dat.c","OBJ_new_nid",283,290
41,15,308,1,45,"OBJ_add_object@293-338@lib/libcrypto/objects/obj_dat.c","lib/libcrypto/objects/obj_dat.c","OBJ_add_object",293,338
25,7,148,1,25,"OBJ_nid2obj@341-366@lib/libcrypto/objects/obj_dat.c","lib/libcrypto/objects/obj_dat.c","OBJ_nid2obj",341,366
25,7,145,1,25,"OBJ_nid2sn@369-394@lib/libcrypto/objects/obj_dat.c","lib/libcrypto/objects/obj_dat.c","OBJ_nid2sn",369,394
25,7,145,1,25,"OBJ_nid2ln@397-422@lib/libcrypto/objects/obj_dat.c","lib/libcrypto/objects/obj_dat.c","OBJ_nid2ln",397,422
10,2,79,2,10,"obj_cmp@425-435@lib/libcrypto/objects/obj_dat.c","lib/libcrypto/objects/obj_dat.c","obj_cmp",425,435
6,1,39,2,5,"obj_cmp_BSEARCH_CMP_FN@439-444@lib/libcrypto/objects/obj_dat.c","lib/libcrypto/objects/obj_dat.c","obj_cmp_BSEARCH_CMP_FN",439,444
5,1,42,3,4,"OBJ_bsearch_obj@447-451@lib/libcrypto/objects/obj_dat.c","lib/libcrypto/objects/obj_dat.c","OBJ_bsearch_obj",447,451
20,6,130,1,21,"OBJ_obj2nid@454-475@lib/libcrypto/objects/obj_dat.c","lib/libcrypto/objects/obj_dat.c","OBJ_obj2nid",454,475
28,6,191,2,38,"OBJ_txt2obj@484-522@lib/libcrypto/objects/obj_dat.c","lib/libcrypto/objects/obj_dat.c","OBJ_txt2obj",484,522
107,31,582,4,117,"OBJ_obj2txt@525-642@lib/libcrypto/objects/obj_dat.c","lib/libcrypto/objects/obj_dat.c","OBJ_obj2txt",525,642
9,1,40,1,9,"OBJ_txt2nid@645-654@lib/libcrypto/objects/obj_dat.c","lib/libcrypto/objects/obj_dat.c","OBJ_txt2nid",645,654
19,4,118,1,19,"OBJ_ln2nid@657-676@lib/libcrypto/objects/obj_dat.c","lib/libcrypto/objects/obj_dat.c","OBJ_ln2nid",657,676
19,4,118,1,19,"OBJ_sn2nid@679-698@lib/libcrypto/objects/obj_dat.c","lib/libcrypto/objects/obj_dat.c","OBJ_sn2nid",679,698
5,1,51,5,4,"OBJ_bsearch_@701-705@lib/libcrypto/objects/obj_dat.c","lib/libcrypto/objects/obj_dat.c","OBJ_bsearch_",701,705
30,11,234,6,30,"OBJ_bsearch_ex_@708-738@lib/libcrypto/objects/obj_dat.c","lib/libcrypto/objects/obj_dat.c","OBJ_bsearch_ex_",708,738
45,17,291,1,46,"OBJ_create_objects@741-787@lib/libcrypto/objects/obj_dat.c","lib/libcrypto/objects/obj_dat.c","OBJ_create_objects",741,787
25,5,166,3,27,"OBJ_create@790-817@lib/libcrypto/objects/obj_dat.c","lib/libcrypto/objects/obj_dat.c","OBJ_create",790,817
7,2,36,1,8,"ERR_load_OBJ_strings@88-96@lib/libcrypto/objects/obj_err.c","lib/libcrypto/objects/obj_err.c","ERR_load_OBJ_strings",88,96
46,10,278,1,51,"OBJ_dup@68-119@lib/libcrypto/objects/obj_lib.c","lib/libcrypto/objects/obj_lib.c","OBJ_dup",68,119
8,2,56,2,8,"OBJ_cmp@122-130@lib/libcrypto/objects/obj_lib.c","lib/libcrypto/objects/obj_lib.c","OBJ_cmp",122,130
4,1,23,2,3,"sig_cmp@66-69@lib/libcrypto/objects/obj_xref.c","lib/libcrypto/objects/obj_xref.c","sig_cmp",66,69
6,1,36,2,5,"sig_cmp_BSEARCH_CMP_FN@76-81@lib/libcrypto/objects/obj_xref.c","lib/libcrypto/objects/obj_xref.c","sig_cmp_BSEARCH_CMP_FN",76,81
5,1,37,3,4,"OBJ_bsearch_sig@84-88@lib/libcrypto/objects/obj_xref.c","lib/libcrypto/objects/obj_xref.c","OBJ_bsearch_sig",84,88
4,1,33,2,3,"sig_sk_cmp@91-94@lib/libcrypto/objects/obj_xref.c","lib/libcrypto/objects/obj_xref.c","sig_sk_cmp",91,94
8,2,59,2,8,"sigx_cmp@101-109@lib/libcrypto/objects/obj_xref.c","lib/libcrypto/objects/obj_xref.c","sigx_cmp",101,109
6,1,40,2,5,"sigx_cmp_BSEARCH_CMP_FN@113-118@lib/libcrypto/objects/obj_xref.c","lib/libcrypto/objects/obj_xref.c","sigx_cmp_BSEARCH_CMP_FN",113,118
5,1,45,3,4,"OBJ_bsearch_sigx@121-125@lib/libcrypto/objects/obj_xref.c","lib/libcrypto/objects/obj_xref.c","OBJ_bsearch_sigx",121,125
22,7,125,3,25,"OBJ_find_sigid_algs@128-153@lib/libcrypto/objects/obj_xref.c","lib/libcrypto/objects/obj_xref.c","OBJ_find_sigid_algs",128,153
24,6,138,3,28,"OBJ_find_sigid_by_algs@156-184@lib/libcrypto/objects/obj_xref.c","lib/libcrypto/objects/obj_xref.c","OBJ_find_sigid_by_algs",156,184
27,8,143,3,31,"OBJ_add_sigid@187-218@lib/libcrypto/objects/obj_xref.c","lib/libcrypto/objects/obj_xref.c","OBJ_add_sigid",187,218
4,1,13,1,3,"sid_free@221-224@lib/libcrypto/objects/obj_xref.c","lib/libcrypto/objects/obj_xref.c","sid_free",221,224
11,3,38,1,10,"OBJ_sigid_free@227-237@lib/libcrypto/objects/obj_xref.c","lib/libcrypto/objects/obj_xref.c","OBJ_sigid_free",227,237
5,1,38,3,4,"d2i_OCSP_SIGNATURE@98-102@lib/libcrypto/ocsp/ocsp_asn.c","lib/libcrypto/ocsp/ocsp_asn.c","d2i_OCSP_SIGNATURE",98,102
4,1,28,2,3,"i2d_OCSP_SIGNATURE@105-108@lib/libcrypto/ocsp/ocsp_asn.c","lib/libcrypto/ocsp/ocsp_asn.c","i2d_OCSP_SIGNATURE",105,108
4,1,17,1,3,"OCSP_SIGNATURE_new@111-114@lib/libcrypto/ocsp/ocsp_asn.c","lib/libcrypto/ocsp/ocsp_asn.c","OCSP_SIGNATURE_new",111,114
4,1,20,1,3,"OCSP_SIGNATURE_free@117-120@lib/libcrypto/ocsp/ocsp_asn.c","lib/libcrypto/ocsp/ocsp_asn.c","OCSP_SIGNATURE_free",117,120
5,1,38,3,4,"d2i_OCSP_CERTID@165-169@lib/libcrypto/ocsp/ocsp_asn.c","lib/libcrypto/ocsp/ocsp_asn.c","d2i_OCSP_CERTID",165,169
4,1,28,2,3,"i2d_OCSP_CERTID@172-175@lib/libcrypto/ocsp/ocsp_asn.c","lib/libcrypto/ocsp/ocsp_asn.c","i2d_OCSP_CERTID",172,175
4,1,17,1,3,"OCSP_CERTID_new@178-181@lib/libcrypto/ocsp/ocsp_asn.c","lib/libcrypto/ocsp/ocsp_asn.c","OCSP_CERTID_new",178,181
4,1,20,1,3,"OCSP_CERTID_free@184-187@lib/libcrypto/ocsp/ocsp_asn.c","lib/libcrypto/ocsp/ocsp_asn.c","OCSP_CERTID_free",184,187
5,1,38,3,4,"d2i_OCSP_ONEREQ@218-222@lib/libcrypto/ocsp/ocsp_asn.c","lib/libcrypto/ocsp/ocsp_asn.c","d2i_OCSP_ONEREQ",218,222
4,1,28,2,3,"i2d_OCSP_ONEREQ@225-228@lib/libcrypto/ocsp/ocsp_asn.c","lib/libcrypto/ocsp/ocsp_asn.c","i2d_OCSP_ONEREQ",225,228
4,1,17,1,3,"OCSP_ONEREQ_new@231-234@lib/libcrypto/ocsp/ocsp_asn.c","lib/libcrypto/ocsp/ocsp_asn.c","OCSP_ONEREQ_new",231,234
4,1,20,1,3,"OCSP_ONEREQ_free@237-240@lib/libcrypto/ocsp/ocsp_asn.c","lib/libcrypto/ocsp/ocsp_asn.c","OCSP_ONEREQ_free",237,240
5,1,38,3,4,"d2i_OCSP_REQINFO@285-289@lib/libcrypto/ocsp/ocsp_asn.c","lib/libcrypto/ocsp/ocsp_asn.c","d2i_OCSP_REQINFO",285,289
4,1,28,2,3,"i2d_OCSP_REQINFO@292-295@lib/libcrypto/ocsp/ocsp_asn.c","lib/libcrypto/ocsp/ocsp_asn.c","i2d_OCSP_REQINFO",292,295
4,1,17,1,3,"OCSP_REQINFO_new@298-301@lib/libcrypto/ocsp/ocsp_asn.c","lib/libcrypto/ocsp/ocsp_asn.c","OCSP_REQINFO_new",298,301
4,1,20,1,3,"OCSP_REQINFO_free@304-307@lib/libcrypto/ocsp/ocsp_asn.c","lib/libcrypto/ocsp/ocsp_asn.c","OCSP_REQINFO_free",304,307
5,1,38,3,4,"d2i_OCSP_REQUEST@337-341@lib/libcrypto/ocsp/ocsp_asn.c","lib/libcrypto/ocsp/ocsp_asn.c","d2i_OCSP_REQUEST",337,341
4,1,28,2,3,"i2d_OCSP_REQUEST@344-347@lib/libcrypto/ocsp/ocsp_asn.c","lib/libcrypto/ocsp/ocsp_asn.c","i2d_OCSP_REQUEST",344,347
4,1,23,2,3,"d2i_OCSP_REQUEST_bio@350-353@lib/libcrypto/ocsp/ocsp_asn.c","lib/libcrypto/ocsp/ocsp_asn.c","d2i_OCSP_REQUEST_bio",350,353
4,1,23,2,3,"i2d_OCSP_REQUEST_bio@356-359@lib/libcrypto/ocsp/ocsp_asn.c","lib/libcrypto/ocsp/ocsp_asn.c","i2d_OCSP_REQUEST_bio",356,359
4,1,17,1,3,"OCSP_REQUEST_new@362-365@lib/libcrypto/ocsp/ocsp_asn.c","lib/libcrypto/ocsp/ocsp_asn.c","OCSP_REQUEST_new",362,365
4,1,20,1,3,"OCSP_REQUEST_free@368-371@lib/libcrypto/ocsp/ocsp_asn.c","lib/libcrypto/ocsp/ocsp_asn.c","OCSP_REQUEST_free",368,371
5,1,38,3,4,"d2i_OCSP_RESPBYTES@404-408@lib/libcrypto/ocsp/ocsp_asn.c","lib/libcrypto/ocsp/ocsp_asn.c","d2i_OCSP_RESPBYTES",404,408
4,1,28,2,3,"i2d_OCSP_RESPBYTES@411-414@lib/libcrypto/ocsp/ocsp_asn.c","lib/libcrypto/ocsp/ocsp_asn.c","i2d_OCSP_RESPBYTES",411,414
4,1,17,1,3,"OCSP_RESPBYTES_new@417-420@lib/libcrypto/ocsp/ocsp_asn.c","lib/libcrypto/ocsp/ocsp_asn.c","OCSP_RESPBYTES_new",417,420
4,1,20,1,3,"OCSP_RESPBYTES_free@423-426@lib/libcrypto/ocsp/ocsp_asn.c","lib/libcrypto/ocsp/ocsp_asn.c","OCSP_RESPBYTES_free",423,426
5,1,38,3,4,"d2i_OCSP_RESPONSE@457-461@lib/libcrypto/ocsp/ocsp_asn.c","lib/libcrypto/ocsp/ocsp_asn.c","d2i_OCSP_RESPONSE",457,461
4,1,28,2,3,"i2d_OCSP_RESPONSE@464-467@lib/libcrypto/ocsp/ocsp_asn.c","lib/libcrypto/ocsp/ocsp_asn.c","i2d_OCSP_RESPONSE",464,467
4,1,23,2,3,"d2i_OCSP_RESPONSE_bio@470-473@lib/libcrypto/ocsp/ocsp_asn.c","lib/libcrypto/ocsp/ocsp_asn.c","d2i_OCSP_RESPONSE_bio",470,473
4,1,23,2,3,"i2d_OCSP_RESPONSE_bio@476-479@lib/libcrypto/ocsp/ocsp_asn.c","lib/libcrypto/ocsp/ocsp_asn.c","i2d_OCSP_RESPONSE_bio",476,479
4,1,17,1,3,"OCSP_RESPONSE_new@482-485@lib/libcrypto/ocsp/ocsp_asn.c","lib/libcrypto/ocsp/ocsp_asn.c","OCSP_RESPONSE_new",482,485
4,1,20,1,3,"OCSP_RESPONSE_free@488-491@lib/libcrypto/ocsp/ocsp_asn.c","lib/libcrypto/ocsp/ocsp_asn.c","OCSP_RESPONSE_free",488,491
5,1,38,3,4,"d2i_OCSP_RESPID@522-526@lib/libcrypto/ocsp/ocsp_asn.c","lib/libcrypto/ocsp/ocsp_asn.c","d2i_OCSP_RESPID",522,526
4,1,28,2,3,"i2d_OCSP_RESPID@529-532@lib/libcrypto/ocsp/ocsp_asn.c","lib/libcrypto/ocsp/ocsp_asn.c","i2d_OCSP_RESPID",529,532
4,1,17,1,3,"OCSP_RESPID_new@535-538@lib/libcrypto/ocsp/ocsp_asn.c","lib/libcrypto/ocsp/ocsp_asn.c","OCSP_RESPID_new",535,538
4,1,20,1,3,"OCSP_RESPID_free@541-544@lib/libcrypto/ocsp/ocsp_asn.c","lib/libcrypto/ocsp/ocsp_asn.c","OCSP_RESPID_free",541,544
5,1,38,3,4,"d2i_OCSP_REVOKEDINFO@575-579@lib/libcrypto/ocsp/ocsp_asn.c","lib/libcrypto/ocsp/ocsp_asn.c","d2i_OCSP_REVOKEDINFO",575,579
4,1,28,2,3,"i2d_OCSP_REVOKEDINFO@582-585@lib/libcrypto/ocsp/ocsp_asn.c","lib/libcrypto/ocsp/ocsp_asn.c","i2d_OCSP_REVOKEDINFO",582,585
4,1,17,1,3,"OCSP_REVOKEDINFO_new@588-591@lib/libcrypto/ocsp/ocsp_asn.c","lib/libcrypto/ocsp/ocsp_asn.c","OCSP_REVOKEDINFO_new",588,591
4,1,20,1,3,"OCSP_REVOKEDINFO_free@594-597@lib/libcrypto/ocsp/ocsp_asn.c","lib/libcrypto/ocsp/ocsp_asn.c","OCSP_REVOKEDINFO_free",594,597
5,1,38,3,4,"d2i_OCSP_CERTSTATUS@635-639@lib/libcrypto/ocsp/ocsp_asn.c","lib/libcrypto/ocsp/ocsp_asn.c","d2i_OCSP_CERTSTATUS",635,639
4,1,28,2,3,"i2d_OCSP_CERTSTATUS@642-645@lib/libcrypto/ocsp/ocsp_asn.c","lib/libcrypto/ocsp/ocsp_asn.c","i2d_OCSP_CERTSTATUS",642,645
4,1,17,1,3,"OCSP_CERTSTATUS_new@648-651@lib/libcrypto/ocsp/ocsp_asn.c","lib/libcrypto/ocsp/ocsp_asn.c","OCSP_CERTSTATUS_new",648,651
4,1,20,1,3,"OCSP_CERTSTATUS_free@654-657@lib/libcrypto/ocsp/ocsp_asn.c","lib/libcrypto/ocsp/ocsp_asn.c","OCSP_CERTSTATUS_free",654,657
5,1,38,3,4,"d2i_OCSP_SINGLERESP@709-713@lib/libcrypto/ocsp/ocsp_asn.c","lib/libcrypto/ocsp/ocsp_asn.c","d2i_OCSP_SINGLERESP",709,713
4,1,28,2,3,"i2d_OCSP_SINGLERESP@716-719@lib/libcrypto/ocsp/ocsp_asn.c","lib/libcrypto/ocsp/ocsp_asn.c","i2d_OCSP_SINGLERESP",716,719
4,1,17,1,3,"OCSP_SINGLERESP_new@722-725@lib/libcrypto/ocsp/ocsp_asn.c","lib/libcrypto/ocsp/ocsp_asn.c","OCSP_SINGLERESP_new",722,725
4,1,20,1,3,"OCSP_SINGLERESP_free@728-731@lib/libcrypto/ocsp/ocsp_asn.c","lib/libcrypto/ocsp/ocsp_asn.c","OCSP_SINGLERESP_free",728,731
5,1,38,3,4,"d2i_OCSP_RESPDATA@783-787@lib/libcrypto/ocsp/ocsp_asn.c","lib/libcrypto/ocsp/ocsp_asn.c","d2i_OCSP_RESPDATA",783,787
4,1,28,2,3,"i2d_OCSP_RESPDATA@790-793@lib/libcrypto/ocsp/ocsp_asn.c","lib/libcrypto/ocsp/ocsp_asn.c","i2d_OCSP_RESPDATA",790,793
4,1,17,1,3,"OCSP_RESPDATA_new@796-799@lib/libcrypto/ocsp/ocsp_asn.c","lib/libcrypto/ocsp/ocsp_asn.c","OCSP_RESPDATA_new",796,799
4,1,20,1,3,"OCSP_RESPDATA_free@802-805@lib/libcrypto/ocsp/ocsp_asn.c","lib/libcrypto/ocsp/ocsp_asn.c","OCSP_RESPDATA_free",802,805
5,1,38,3,4,"d2i_OCSP_BASICRESP@850-854@lib/libcrypto/ocsp/ocsp_asn.c","lib/libcrypto/ocsp/ocsp_asn.c","d2i_OCSP_BASICRESP",850,854
4,1,28,2,3,"i2d_OCSP_BASICRESP@857-860@lib/libcrypto/ocsp/ocsp_asn.c","lib/libcrypto/ocsp/ocsp_asn.c","i2d_OCSP_BASICRESP",857,860
4,1,17,1,3,"OCSP_BASICRESP_new@863-866@lib/libcrypto/ocsp/ocsp_asn.c","lib/libcrypto/ocsp/ocsp_asn.c","OCSP_BASICRESP_new",863,866
4,1,20,1,3,"OCSP_BASICRESP_free@869-872@lib/libcrypto/ocsp/ocsp_asn.c","lib/libcrypto/ocsp/ocsp_asn.c","OCSP_BASICRESP_free",869,872
5,1,38,3,4,"d2i_OCSP_CRLID@910-914@lib/libcrypto/ocsp/ocsp_asn.c","lib/libcrypto/ocsp/ocsp_asn.c","d2i_OCSP_CRLID",910,914
4,1,28,2,3,"i2d_OCSP_CRLID@917-920@lib/libcrypto/ocsp/ocsp_asn.c","lib/libcrypto/ocsp/ocsp_asn.c","i2d_OCSP_CRLID",917,920
4,1,17,1,3,"OCSP_CRLID_new@923-926@lib/libcrypto/ocsp/ocsp_asn.c","lib/libcrypto/ocsp/ocsp_asn.c","OCSP_CRLID_new",923,926
4,1,20,1,3,"OCSP_CRLID_free@929-932@lib/libcrypto/ocsp/ocsp_asn.c","lib/libcrypto/ocsp/ocsp_asn.c","OCSP_CRLID_free",929,932
5,1,38,3,4,"d2i_OCSP_SERVICELOC@963-967@lib/libcrypto/ocsp/ocsp_asn.c","lib/libcrypto/ocsp/ocsp_asn.c","d2i_OCSP_SERVICELOC",963,967
4,1,28,2,3,"i2d_OCSP_SERVICELOC@970-973@lib/libcrypto/ocsp/ocsp_asn.c","lib/libcrypto/ocsp/ocsp_asn.c","i2d_OCSP_SERVICELOC",970,973
4,1,17,1,3,"OCSP_SERVICELOC_new@976-979@lib/libcrypto/ocsp/ocsp_asn.c","lib/libcrypto/ocsp/ocsp_asn.c","OCSP_SERVICELOC_new",976,979
4,1,20,1,3,"OCSP_SERVICELOC_free@982-985@lib/libcrypto/ocsp/ocsp_asn.c","lib/libcrypto/ocsp/ocsp_asn.c","OCSP_SERVICELOC_free",982,985
15,5,83,2,16,"OCSP_request_add0_id@82-98@lib/libcrypto/ocsp/ocsp_cl.c","lib/libcrypto/ocsp/ocsp_cl.c","OCSP_request_add0_id",82,98
16,4,90,2,16,"OCSP_request_set1_name@102-118@lib/libcrypto/ocsp/ocsp_cl.c","lib/libcrypto/ocsp/ocsp_cl.c","OCSP_request_set1_name",102,118
17,6,104,2,18,"OCSP_request_add1_cert@122-140@lib/libcrypto/ocsp/ocsp_cl.c","lib/libcrypto/ocsp/ocsp_cl.c","OCSP_request_add1_cert",122,140
33,10,203,6,37,"OCSP_request_sign@148-185@lib/libcrypto/ocsp/ocsp_cl.c","lib/libcrypto/ocsp/ocsp_cl.c","OCSP_request_sign",148,185
4,1,16,1,3,"OCSP_response_status@189-192@lib/libcrypto/ocsp/ocsp_cl.c","lib/libcrypto/ocsp/ocsp_cl.c","OCSP_response_status",189,192
14,3,65,1,15,"OCSP_response_get1_basic@198-213@lib/libcrypto/ocsp/ocsp_cl.c","lib/libcrypto/ocsp/ocsp_cl.c","OCSP_response_get1_basic",198,213
6,2,27,1,5,"OCSP_resp_count@219-224@lib/libcrypto/ocsp/ocsp_cl.c","lib/libcrypto/ocsp/ocsp_cl.c","OCSP_resp_count",219,224
6,2,31,2,5,"OCSP_resp_get0@228-233@lib/libcrypto/ocsp/ocsp_cl.c","lib/libcrypto/ocsp/ocsp_cl.c","OCSP_resp_get0",228,233
19,5,106,3,19,"OCSP_resp_find@237-256@lib/libcrypto/ocsp/ocsp_cl.c","lib/libcrypto/ocsp/ocsp_cl.c","OCSP_resp_find",237,256
28,8,135,5,29,"OCSP_single_get0_status@264-293@lib/libcrypto/ocsp/ocsp_cl.c","lib/libcrypto/ocsp/ocsp_cl.c","OCSP_single_get0_status",264,293
15,3,96,7,16,"OCSP_resp_find_status@299-315@lib/libcrypto/ocsp/ocsp_cl.c","lib/libcrypto/ocsp/ocsp_cl.c","OCSP_resp_find_status",299,315
49,12,280,4,68,"OCSP_check_validity@324-392@lib/libcrypto/ocsp/ocsp_cl.c","lib/libcrypto/ocsp/ocsp_cl.c","OCSP_check_validity",324,392
7,2,36,1,8,"ERR_load_OCSP_strings@116-124@lib/libcrypto/ocsp/ocsp_err.c","lib/libcrypto/ocsp/ocsp_err.c","ERR_load_OCSP_strings",116,124
4,1,18,1,3,"OCSP_REQUEST_get_ext_count@78-81@lib/libcrypto/ocsp/ocsp_ext.c","lib/libcrypto/ocsp/ocsp_ext.c","OCSP_REQUEST_get_ext_count",78,81
5,1,28,3,4,"OCSP_REQUEST_get_ext_by_NID@84-88@lib/libcrypto/ocsp/ocsp_ext.c","lib/libcrypto/ocsp/ocsp_ext.c","OCSP_REQUEST_get_ext_by_NID",84,88
5,1,29,3,4,"OCSP_REQUEST_get_ext_by_OBJ@91-95@lib/libcrypto/ocsp/ocsp_ext.c","lib/libcrypto/ocsp/ocsp_ext.c","OCSP_REQUEST_get_ext_by_OBJ",91,95
5,1,28,3,4,"OCSP_REQUEST_get_ext_by_critical@98-102@lib/libcrypto/ocsp/ocsp_ext.c","lib/libcrypto/ocsp/ocsp_ext.c","OCSP_REQUEST_get_ext_by_critical",98,102
4,1,23,2,3,"OCSP_REQUEST_get_ext@105-108@lib/libcrypto/ocsp/ocsp_ext.c","lib/libcrypto/ocsp/ocsp_ext.c","OCSP_REQUEST_get_ext",105,108
4,1,23,2,3,"OCSP_REQUEST_delete_ext@111-114@lib/libcrypto/ocsp/ocsp_ext.c","lib/libcrypto/ocsp/ocsp_ext.c","OCSP_REQUEST_delete_ext",111,114
4,1,35,4,3,"OCSP_REQUEST_get1_ext_d2i@117-120@lib/libcrypto/ocsp/ocsp_ext.c","lib/libcrypto/ocsp/ocsp_ext.c","OCSP_REQUEST_get1_ext_d2i",117,120
6,1,41,5,5,"OCSP_REQUEST_add1_ext_i2d@123-128@lib/libcrypto/ocsp/ocsp_ext.c","lib/libcrypto/ocsp/ocsp_ext.c","OCSP_REQUEST_add1_ext_i2d",123,128
5,1,34,3,4,"OCSP_REQUEST_add_ext@131-135@lib/libcrypto/ocsp/ocsp_ext.c","lib/libcrypto/ocsp/ocsp_ext.c","OCSP_REQUEST_add_ext",131,135
4,1,16,1,3,"OCSP_ONEREQ_get_ext_count@140-143@lib/libcrypto/ocsp/ocsp_ext.c","lib/libcrypto/ocsp/ocsp_ext.c","OCSP_ONEREQ_get_ext_count",140,143
4,1,26,3,3,"OCSP_ONEREQ_get_ext_by_NID@146-149@lib/libcrypto/ocsp/ocsp_ext.c","lib/libcrypto/ocsp/ocsp_ext.c","OCSP_ONEREQ_get_ext_by_NID",146,149
4,1,27,3,3,"OCSP_ONEREQ_get_ext_by_OBJ@152-155@lib/libcrypto/ocsp/ocsp_ext.c","lib/libcrypto/ocsp/ocsp_ext.c","OCSP_ONEREQ_get_ext_by_OBJ",152,155
5,1,26,3,4,"OCSP_ONEREQ_get_ext_by_critical@158-162@lib/libcrypto/ocsp/ocsp_ext.c","lib/libcrypto/ocsp/ocsp_ext.c","OCSP_ONEREQ_get_ext_by_critical",158,162
4,1,21,2,3,"OCSP_ONEREQ_get_ext@165-168@lib/libcrypto/ocsp/ocsp_ext.c","lib/libcrypto/ocsp/ocsp_ext.c","OCSP_ONEREQ_get_ext",165,168
4,1,21,2,3,"OCSP_ONEREQ_delete_ext@171-174@lib/libcrypto/ocsp/ocsp_ext.c","lib/libcrypto/ocsp/ocsp_ext.c","OCSP_ONEREQ_delete_ext",171,174
4,1,33,4,3,"OCSP_ONEREQ_get1_ext_d2i@177-180@lib/libcrypto/ocsp/ocsp_ext.c","lib/libcrypto/ocsp/ocsp_ext.c","OCSP_ONEREQ_get1_ext_d2i",177,180
6,1,39,5,5,"OCSP_ONEREQ_add1_ext_i2d@183-188@lib/libcrypto/ocsp/ocsp_ext.c","lib/libcrypto/ocsp/ocsp_ext.c","OCSP_ONEREQ_add1_ext_i2d",183,188
4,1,32,3,3,"OCSP_ONEREQ_add_ext@191-194@lib/libcrypto/ocsp/ocsp_ext.c","lib/libcrypto/ocsp/ocsp_ext.c","OCSP_ONEREQ_add_ext",191,194
4,1,18,1,3,"OCSP_BASICRESP_get_ext_count@199-202@lib/libcrypto/ocsp/ocsp_ext.c","lib/libcrypto/ocsp/ocsp_ext.c","OCSP_BASICRESP_get_ext_count",199,202
5,1,28,3,4,"OCSP_BASICRESP_get_ext_by_NID@205-209@lib/libcrypto/ocsp/ocsp_ext.c","lib/libcrypto/ocsp/ocsp_ext.c","OCSP_BASICRESP_get_ext_by_NID",205,209
5,1,29,3,4,"OCSP_BASICRESP_get_ext_by_OBJ@212-216@lib/libcrypto/ocsp/ocsp_ext.c","lib/libcrypto/ocsp/ocsp_ext.c","OCSP_BASICRESP_get_ext_by_OBJ",212,216
5,1,28,3,4,"OCSP_BASICRESP_get_ext_by_critical@219-223@lib/libcrypto/ocsp/ocsp_ext.c","lib/libcrypto/ocsp/ocsp_ext.c","OCSP_BASICRESP_get_ext_by_critical",219,223
4,1,23,2,3,"OCSP_BASICRESP_get_ext@226-229@lib/libcrypto/ocsp/ocsp_ext.c","lib/libcrypto/ocsp/ocsp_ext.c","OCSP_BASICRESP_get_ext",226,229
4,1,23,2,3,"OCSP_BASICRESP_delete_ext@232-235@lib/libcrypto/ocsp/ocsp_ext.c","lib/libcrypto/ocsp/ocsp_ext.c","OCSP_BASICRESP_delete_ext",232,235
5,1,35,4,4,"OCSP_BASICRESP_get1_ext_d2i@238-242@lib/libcrypto/ocsp/ocsp_ext.c","lib/libcrypto/ocsp/ocsp_ext.c","OCSP_BASICRESP_get1_ext_d2i",238,242
6,1,41,5,5,"OCSP_BASICRESP_add1_ext_i2d@245-250@lib/libcrypto/ocsp/ocsp_ext.c","lib/libcrypto/ocsp/ocsp_ext.c","OCSP_BASICRESP_add1_ext_i2d",245,250
5,1,34,3,4,"OCSP_BASICRESP_add_ext@253-257@lib/libcrypto/ocsp/ocsp_ext.c","lib/libcrypto/ocsp/ocsp_ext.c","OCSP_BASICRESP_add_ext",253,257
4,1,16,1,3,"OCSP_SINGLERESP_get_ext_count@262-265@lib/libcrypto/ocsp/ocsp_ext.c","lib/libcrypto/ocsp/ocsp_ext.c","OCSP_SINGLERESP_get_ext_count",262,265
4,1,26,3,3,"OCSP_SINGLERESP_get_ext_by_NID@268-271@lib/libcrypto/ocsp/ocsp_ext.c","lib/libcrypto/ocsp/ocsp_ext.c","OCSP_SINGLERESP_get_ext_by_NID",268,271
5,1,27,3,4,"OCSP_SINGLERESP_get_ext_by_OBJ@274-278@lib/libcrypto/ocsp/ocsp_ext.c","lib/libcrypto/ocsp/ocsp_ext.c","OCSP_SINGLERESP_get_ext_by_OBJ",274,278
4,1,26,3,3,"OCSP_SINGLERESP_get_ext_by_critical@281-284@lib/libcrypto/ocsp/ocsp_ext.c","lib/libcrypto/ocsp/ocsp_ext.c","OCSP_SINGLERESP_get_ext_by_critical",281,284
4,1,21,2,3,"OCSP_SINGLERESP_get_ext@287-290@lib/libcrypto/ocsp/ocsp_ext.c","lib/libcrypto/ocsp/ocsp_ext.c","OCSP_SINGLERESP_get_ext",287,290
4,1,21,2,3,"OCSP_SINGLERESP_delete_ext@293-296@lib/libcrypto/ocsp/ocsp_ext.c","lib/libcrypto/ocsp/ocsp_ext.c","OCSP_SINGLERESP_delete_ext",293,296
4,1,33,4,3,"OCSP_SINGLERESP_get1_ext_d2i@299-302@lib/libcrypto/ocsp/ocsp_ext.c","lib/libcrypto/ocsp/ocsp_ext.c","OCSP_SINGLERESP_get1_ext_d2i",299,302
5,1,39,5,4,"OCSP_SINGLERESP_add1_ext_i2d@305-309@lib/libcrypto/ocsp/ocsp_ext.c","lib/libcrypto/ocsp/ocsp_ext.c","OCSP_SINGLERESP_add1_ext_i2d",305,309
4,1,32,3,3,"OCSP_SINGLERESP_add_ext@312-315@lib/libcrypto/ocsp/ocsp_ext.c","lib/libcrypto/ocsp/ocsp_ext.c","OCSP_SINGLERESP_add_ext",312,315
25,5,154,3,31,"ocsp_add1_nonce@326-357@lib/libcrypto/ocsp/ocsp_ext.c","lib/libcrypto/ocsp/ocsp_ext.c","ocsp_add1_nonce",326,357
4,1,31,3,3,"OCSP_request_add1_nonce@361-364@lib/libcrypto/ocsp/ocsp_ext.c","lib/libcrypto/ocsp/ocsp_ext.c","OCSP_request_add1_nonce",361,364
5,1,31,3,4,"OCSP_basic_add1_nonce@368-372@lib/libcrypto/ocsp/ocsp_ext.c","lib/libcrypto/ocsp/ocsp_ext.c","OCSP_basic_add1_nonce",368,372
19,8,125,2,30,"OCSP_check_nonce@387-417@lib/libcrypto/ocsp/ocsp_ext.c","lib/libcrypto/ocsp/ocsp_ext.c","OCSP_check_nonce",387,417
10,2,60,2,12,"OCSP_copy_nonce@423-435@lib/libcrypto/ocsp/ocsp_ext.c","lib/libcrypto/ocsp/ocsp_ext.c","OCSP_copy_nonce",423,435
30,12,188,3,31,"OCSP_crlID_new@438-469@lib/libcrypto/ocsp/ocsp_ext.c","lib/libcrypto/ocsp/ocsp_ext.c","OCSP_crlID_new",438,469
21,6,125,1,21,"OCSP_accept_responses_new@473-494@lib/libcrypto/ocsp/ocsp_ext.c","lib/libcrypto/ocsp/ocsp_ext.c","OCSP_accept_responses_new",473,494
14,4,74,1,15,"OCSP_archive_cutoff_new@498-513@lib/libcrypto/ocsp/ocsp_ext.c","lib/libcrypto/ocsp/ocsp_ext.c","OCSP_archive_cutoff_new",498,513
42,16,266,2,43,"OCSP_url_svcloc_new@520-563@lib/libcrypto/ocsp/ocsp_ext.c","lib/libcrypto/ocsp/ocsp_ext.c","OCSP_url_svcloc_new",520,563
8,2,35,1,8,"OCSP_REQ_CTX_free@109-117@lib/libcrypto/ocsp/ocsp_ht.c","lib/libcrypto/ocsp/ocsp_ht.c","OCSP_REQ_CTX_free",109,117
11,3,74,2,10,"OCSP_REQ_CTX_set1_req@120-130@lib/libcrypto/ocsp/ocsp_ht.c","lib/libcrypto/ocsp/ocsp_ht.c","OCSP_REQ_CTX_set1_req",120,130
17,7,103,3,16,"OCSP_REQ_CTX_add1_header@133-149@lib/libcrypto/ocsp/ocsp_ht.c","lib/libcrypto/ocsp/ocsp_ht.c","OCSP_REQ_CTX_add1_header",133,149
39,9,228,4,42,"OCSP_sendreq_new@152-194@lib/libcrypto/ocsp/ocsp_ht.c","lib/libcrypto/ocsp/ocsp_ht.c","OCSP_sendreq_new",152,194
42,17,261,1,59,"parse_http_line1@201-260@lib/libcrypto/ocsp/ocsp_ht.c","lib/libcrypto/ocsp/ocsp_ht.c","parse_http_line1",201,260
128,40,747,2,176,"OCSP_sendreq_nbio@263-439@lib/libcrypto/ocsp/ocsp_ht.c","lib/libcrypto/ocsp/ocsp_ht.c","OCSP_sendreq_nbio",263,439
16,5,95,3,20,"OCSP_sendreq_bio@443-463@lib/libcrypto/ocsp/ocsp_ht.c","lib/libcrypto/ocsp/ocsp_ht.c","OCSP_sendreq_bio",443,463
17,3,93,3,19,"OCSP_cert_to_id@80-99@lib/libcrypto/ocsp/ocsp_lib.c","lib/libcrypto/ocsp/ocsp_lib.c","OCSP_cert_to_id",80,99
43,13,281,4,50,"OCSP_cert_id_new@102-152@lib/libcrypto/ocsp/ocsp_lib.c","lib/libcrypto/ocsp/ocsp_lib.c","OCSP_cert_id_new",102,152
11,3,71,2,11,"OCSP_id_issuer_cmp@155-166@lib/libcrypto/ocsp/ocsp_lib.c","lib/libcrypto/ocsp/ocsp_lib.c","OCSP_id_issuer_cmp",155,166
8,2,43,2,8,"OCSP_id_cmp@169-177@lib/libcrypto/ocsp/ocsp_lib.c","lib/libcrypto/ocsp/ocsp_lib.c","OCSP_id_cmp",169,177
44,9,276,5,49,"OCSP_parse_url@183-232@lib/libcrypto/ocsp/ocsp_lib.c","lib/libcrypto/ocsp/ocsp_lib.c","OCSP_parse_url",183,232
4,1,17,1,3,"OCSP_CERTID_dup@235-238@lib/libcrypto/ocsp/ocsp_lib.c","lib/libcrypto/ocsp/ocsp_lib.c","OCSP_CERTID_dup",235,238
15,1,126,3,14,"ocsp_certid_print@70-84@lib/libcrypto/ocsp/ocsp_prn.c","lib/libcrypto/ocsp/ocsp_prn.c","ocsp_certid_print",70,84
8,3,51,3,8,"table2string@92-100@lib/libcrypto/ocsp/ocsp_prn.c","lib/libcrypto/ocsp/ocsp_prn.c","table2string",92,100
12,1,62,1,11,"OCSP_response_status_str@103-114@lib/libcrypto/ocsp/ocsp_prn.c","lib/libcrypto/ocsp/ocsp_prn.c","OCSP_response_status_str",103,114
9,1,44,1,8,"OCSP_cert_status_str@117-125@lib/libcrypto/ocsp/ocsp_prn.c","lib/libcrypto/ocsp/ocsp_prn.c","OCSP_cert_status_str",117,125
14,1,74,1,13,"OCSP_crl_reason_str@128-141@lib/libcrypto/ocsp/ocsp_prn.c","lib/libcrypto/ocsp/ocsp_prn.c","OCSP_crl_reason_str",128,141
47,14,330,3,48,"OCSP_REQUEST_print@144-192@lib/libcrypto/ocsp/ocsp_prn.c","lib/libcrypto/ocsp/ocsp_prn.c","OCSP_REQUEST_print",144,192
111,35,751,3,117,"OCSP_RESPONSE_print@195-312@lib/libcrypto/ocsp/ocsp_prn.c","lib/libcrypto/ocsp/ocsp_prn.c","OCSP_RESPONSE_print",195,312
4,1,18,1,3,"OCSP_request_onereq_count@73-76@lib/libcrypto/ocsp/ocsp_srv.c","lib/libcrypto/ocsp/ocsp_srv.c","OCSP_request_onereq_count",73,76
4,1,23,2,3,"OCSP_request_onereq_get0@79-82@lib/libcrypto/ocsp/ocsp_srv.c","lib/libcrypto/ocsp/ocsp_srv.c","OCSP_request_onereq_get0",79,82
4,1,13,1,3,"OCSP_onereq_get0_id@85-88@lib/libcrypto/ocsp/ocsp_srv.c","lib/libcrypto/ocsp/ocsp_srv.c","OCSP_onereq_get0_id",85,88
15,6,81,5,14,"OCSP_id_get0_info@91-105@lib/libcrypto/ocsp/ocsp_srv.c","lib/libcrypto/ocsp/ocsp_srv.c","OCSP_id_get0_info",91,105
6,2,20,1,5,"OCSP_request_is_signed@108-113@lib/libcrypto/ocsp/ocsp_srv.c","lib/libcrypto/ocsp/ocsp_srv.c","OCSP_request_is_signed",108,113
21,7,121,2,22,"OCSP_response_create@117-139@lib/libcrypto/ocsp/ocsp_srv.c","lib/libcrypto/ocsp/ocsp_srv.c","OCSP_response_create",117,139
54,17,321,7,63,"OCSP_basic_add1_status@142-205@lib/libcrypto/ocsp/ocsp_srv.c","lib/libcrypto/ocsp/ocsp_srv.c","OCSP_basic_add1_status",142,205
9,3,63,2,9,"OCSP_basic_add1_cert@209-218@lib/libcrypto/ocsp/ocsp_srv.c","lib/libcrypto/ocsp/ocsp_srv.c","OCSP_basic_add1_cert",209,218
43,13,288,6,53,"OCSP_basic_sign@221-274@lib/libcrypto/ocsp/ocsp_srv.c","lib/libcrypto/ocsp/ocsp_srv.c","OCSP_basic_sign",221,274
88,24,498,4,102,"OCSP_basic_verify@78-180@lib/libcrypto/ocsp/ocsp_vfy.c","lib/libcrypto/ocsp/ocsp_vfy.c","OCSP_basic_verify",78,180
17,3,104,5,19,"ocsp_find_signer@183-202@lib/libcrypto/ocsp/ocsp_vfy.c","lib/libcrypto/ocsp/ocsp_vfy.c","ocsp_find_signer",183,202
18,5,135,2,24,"ocsp_find_signer_sk@205-229@lib/libcrypto/ocsp/ocsp_vfy.c","lib/libcrypto/ocsp/ocsp_vfy.c","ocsp_find_signer_sk",205,229
29,7,169,3,39,"ocsp_check_issuer@232-271@lib/libcrypto/ocsp/ocsp_vfy.c","lib/libcrypto/ocsp/ocsp_vfy.c","ocsp_check_issuer",232,271
20,4,115,2,26,"ocsp_check_ids@278-304@lib/libcrypto/ocsp/ocsp_vfy.c","lib/libcrypto/ocsp/ocsp_vfy.c","ocsp_check_ids",278,304
40,11,248,3,45,"ocsp_match_issuerid@307-352@lib/libcrypto/ocsp/ocsp_vfy.c","lib/libcrypto/ocsp/ocsp_vfy.c","ocsp_match_issuerid",307,352
8,3,50,2,7,"ocsp_check_delegated@355-362@lib/libcrypto/ocsp/ocsp_vfy.c","lib/libcrypto/ocsp/ocsp_vfy.c","ocsp_check_delegated",355,362
66,15,351,4,69,"OCSP_request_verify@369-438@lib/libcrypto/ocsp/ocsp_vfy.c","lib/libcrypto/ocsp/ocsp_vfy.c","OCSP_request_verify",369,438
18,4,99,6,19,"ocsp_req_find_signer@441-460@lib/libcrypto/ocsp/ocsp_vfy.c","lib/libcrypto/ocsp/ocsp_vfy.c","ocsp_req_find_signer",441,460
5,1,44,4,4,"PEM_read_X509_REQ@145-149@lib/libcrypto/pem/pem_all.c","lib/libcrypto/pem/pem_all.c","PEM_read_X509_REQ",145,149
5,1,38,2,4,"PEM_write_X509_REQ@152-156@lib/libcrypto/pem/pem_all.c","lib/libcrypto/pem/pem_all.c","PEM_write_X509_REQ",152,156
5,1,44,4,4,"PEM_read_bio_X509_REQ@159-163@lib/libcrypto/pem/pem_all.c","lib/libcrypto/pem/pem_all.c","PEM_read_bio_X509_REQ",159,163
5,1,38,2,4,"PEM_write_bio_X509_REQ@166-170@lib/libcrypto/pem/pem_all.c","lib/libcrypto/pem/pem_all.c","PEM_write_bio_X509_REQ",166,170
5,1,38,2,4,"PEM_write_X509_REQ_NEW@173-177@lib/libcrypto/pem/pem_all.c","lib/libcrypto/pem/pem_all.c","PEM_write_X509_REQ_NEW",173,177
5,1,38,2,4,"PEM_write_bio_X509_REQ_NEW@180-184@lib/libcrypto/pem/pem_all.c","lib/libcrypto/pem/pem_all.c","PEM_write_bio_X509_REQ_NEW",180,184
5,1,44,4,4,"PEM_read_X509_CRL@187-191@lib/libcrypto/pem/pem_all.c","lib/libcrypto/pem/pem_all.c","PEM_read_X509_CRL",187,191
5,1,38,2,4,"PEM_write_X509_CRL@194-198@lib/libcrypto/pem/pem_all.c","lib/libcrypto/pem/pem_all.c","PEM_write_X509_CRL",194,198
5,1,44,4,4,"PEM_read_bio_X509_CRL@201-205@lib/libcrypto/pem/pem_all.c","lib/libcrypto/pem/pem_all.c","PEM_read_bio_X509_CRL",201,205
5,1,38,2,4,"PEM_write_bio_X509_CRL@208-212@lib/libcrypto/pem/pem_all.c","lib/libcrypto/pem/pem_all.c","PEM_write_bio_X509_CRL",208,212
5,1,44,4,4,"PEM_read_PKCS7@215-219@lib/libcrypto/pem/pem_all.c","lib/libcrypto/pem/pem_all.c","PEM_read_PKCS7",215,219
5,1,38,2,4,"PEM_write_PKCS7@222-226@lib/libcrypto/pem/pem_all.c","lib/libcrypto/pem/pem_all.c","PEM_write_PKCS7",222,226
5,1,44,4,4,"PEM_read_bio_PKCS7@229-233@lib/libcrypto/pem/pem_all.c","lib/libcrypto/pem/pem_all.c","PEM_read_bio_PKCS7",229,233
5,1,38,2,4,"PEM_write_bio_PKCS7@236-240@lib/libcrypto/pem/pem_all.c","lib/libcrypto/pem/pem_all.c","PEM_write_bio_PKCS7",236,240
5,1,38,2,4,"PEM_write_NETSCAPE_CERT_SEQUENCE@243-247@lib/libcrypto/pem/pem_all.c","lib/libcrypto/pem/pem_all.c","PEM_write_NETSCAPE_CERT_SEQUENCE",243,247
5,1,44,4,4,"PEM_read_NETSCAPE_CERT_SEQUENCE@250-254@lib/libcrypto/pem/pem_all.c","lib/libcrypto/pem/pem_all.c","PEM_read_NETSCAPE_CERT_SEQUENCE",250,254
5,1,44,4,4,"PEM_read_bio_NETSCAPE_CERT_SEQUENCE@257-261@lib/libcrypto/pem/pem_all.c","lib/libcrypto/pem/pem_all.c","PEM_read_bio_NETSCAPE_CERT_SEQUENCE",257,261
5,1,38,2,4,"PEM_write_bio_NETSCAPE_CERT_SEQUENCE@264-268@lib/libcrypto/pem/pem_all.c","lib/libcrypto/pem/pem_all.c","PEM_write_bio_NETSCAPE_CERT_SEQUENCE",264,268
15,4,64,2,15,"pkey_get_rsa@281-296@lib/libcrypto/pem/pem_all.c","lib/libcrypto/pem/pem_all.c","pkey_get_rsa",281,296
6,1,45,4,6,"PEM_read_RSAPrivateKey@299-305@lib/libcrypto/pem/pem_all.c","lib/libcrypto/pem/pem_all.c","PEM_read_RSAPrivateKey",299,305
6,1,59,7,5,"PEM_write_RSAPrivateKey@308-313@lib/libcrypto/pem/pem_all.c","lib/libcrypto/pem/pem_all.c","PEM_write_RSAPrivateKey",308,313
6,1,45,4,6,"PEM_read_bio_RSAPrivateKey@316-322@lib/libcrypto/pem/pem_all.c","lib/libcrypto/pem/pem_all.c","PEM_read_bio_RSAPrivateKey",316,322
7,1,59,7,6,"PEM_write_bio_RSAPrivateKey@325-331@lib/libcrypto/pem/pem_all.c","lib/libcrypto/pem/pem_all.c","PEM_write_bio_RSAPrivateKey",325,331
5,1,44,4,4,"PEM_read_RSAPublicKey@334-338@lib/libcrypto/pem/pem_all.c","lib/libcrypto/pem/pem_all.c","PEM_read_RSAPublicKey",334,338
5,1,43,2,4,"PEM_write_RSAPublicKey@341-345@lib/libcrypto/pem/pem_all.c","lib/libcrypto/pem/pem_all.c","PEM_write_RSAPublicKey",341,345
5,1,44,4,4,"PEM_read_bio_RSAPublicKey@348-352@lib/libcrypto/pem/pem_all.c","lib/libcrypto/pem/pem_all.c","PEM_read_bio_RSAPublicKey",348,352
5,1,43,2,4,"PEM_write_bio_RSAPublicKey@355-359@lib/libcrypto/pem/pem_all.c","lib/libcrypto/pem/pem_all.c","PEM_write_bio_RSAPublicKey",355,359
5,1,44,4,4,"PEM_read_RSA_PUBKEY@362-366@lib/libcrypto/pem/pem_all.c","lib/libcrypto/pem/pem_all.c","PEM_read_RSA_PUBKEY",362,366
5,1,38,2,4,"PEM_write_RSA_PUBKEY@369-373@lib/libcrypto/pem/pem_all.c","lib/libcrypto/pem/pem_all.c","PEM_write_RSA_PUBKEY",369,373
5,1,44,4,4,"PEM_read_bio_RSA_PUBKEY@376-380@lib/libcrypto/pem/pem_all.c","lib/libcrypto/pem/pem_all.c","PEM_read_bio_RSA_PUBKEY",376,380
5,1,38,2,4,"PEM_write_bio_RSA_PUBKEY@383-387@lib/libcrypto/pem/pem_all.c","lib/libcrypto/pem/pem_all.c","PEM_write_bio_RSA_PUBKEY",383,387
15,4,64,2,15,"pkey_get_dsa@394-409@lib/libcrypto/pem/pem_all.c","lib/libcrypto/pem/pem_all.c","pkey_get_dsa",394,409
6,1,45,4,6,"PEM_read_DSAPrivateKey@412-418@lib/libcrypto/pem/pem_all.c","lib/libcrypto/pem/pem_all.c","PEM_read_DSAPrivateKey",412,418
6,1,59,7,5,"PEM_write_DSAPrivateKey@421-426@lib/libcrypto/pem/pem_all.c","lib/libcrypto/pem/pem_all.c","PEM_write_DSAPrivateKey",421,426
6,1,45,4,6,"PEM_read_bio_DSAPrivateKey@429-435@lib/libcrypto/pem/pem_all.c","lib/libcrypto/pem/pem_all.c","PEM_read_bio_DSAPrivateKey",429,435
7,1,59,7,6,"PEM_write_bio_DSAPrivateKey@438-444@lib/libcrypto/pem/pem_all.c","lib/libcrypto/pem/pem_all.c","PEM_write_bio_DSAPrivateKey",438,444
5,1,44,4,4,"PEM_read_DSA_PUBKEY@447-451@lib/libcrypto/pem/pem_all.c","lib/libcrypto/pem/pem_all.c","PEM_read_DSA_PUBKEY",447,451
5,1,38,2,4,"PEM_write_DSA_PUBKEY@454-458@lib/libcrypto/pem/pem_all.c","lib/libcrypto/pem/pem_all.c","PEM_write_DSA_PUBKEY",454,458
5,1,38,2,4,"PEM_write_bio_DSA_PUBKEY@461-465@lib/libcrypto/pem/pem_all.c","lib/libcrypto/pem/pem_all.c","PEM_write_bio_DSA_PUBKEY",461,465
5,1,44,4,4,"PEM_read_bio_DSA_PUBKEY@468-472@lib/libcrypto/pem/pem_all.c","lib/libcrypto/pem/pem_all.c","PEM_read_bio_DSA_PUBKEY",468,472
5,1,44,4,4,"PEM_read_DSAparams@475-479@lib/libcrypto/pem/pem_all.c","lib/libcrypto/pem/pem_all.c","PEM_read_DSAparams",475,479
5,1,43,2,4,"PEM_write_DSAparams@482-486@lib/libcrypto/pem/pem_all.c","lib/libcrypto/pem/pem_all.c","PEM_write_DSAparams",482,486
5,1,44,4,4,"PEM_read_bio_DSAparams@489-493@lib/libcrypto/pem/pem_all.c","lib/libcrypto/pem/pem_all.c","PEM_read_bio_DSAparams",489,493
5,1,43,2,4,"PEM_write_bio_DSAparams@496-500@lib/libcrypto/pem/pem_all.c","lib/libcrypto/pem/pem_all.c","PEM_write_bio_DSAparams",496,500
15,4,64,2,15,"pkey_get_eckey@507-522@lib/libcrypto/pem/pem_all.c","lib/libcrypto/pem/pem_all.c","pkey_get_eckey",507,522
5,1,44,4,4,"PEM_read_ECPKParameters@525-529@lib/libcrypto/pem/pem_all.c","lib/libcrypto/pem/pem_all.c","PEM_read_ECPKParameters",525,529
5,1,43,2,4,"PEM_write_ECPKParameters@532-536@lib/libcrypto/pem/pem_all.c","lib/libcrypto/pem/pem_all.c","PEM_write_ECPKParameters",532,536
5,1,44,4,4,"PEM_read_bio_ECPKParameters@539-543@lib/libcrypto/pem/pem_all.c","lib/libcrypto/pem/pem_all.c","PEM_read_bio_ECPKParameters",539,543
5,1,43,2,4,"PEM_write_bio_ECPKParameters@546-550@lib/libcrypto/pem/pem_all.c","lib/libcrypto/pem/pem_all.c","PEM_write_bio_ECPKParameters",546,550
6,1,45,4,6,"PEM_read_ECPrivateKey@553-559@lib/libcrypto/pem/pem_all.c","lib/libcrypto/pem/pem_all.c","PEM_read_ECPrivateKey",553,559
6,1,59,7,5,"PEM_write_ECPrivateKey@562-567@lib/libcrypto/pem/pem_all.c","lib/libcrypto/pem/pem_all.c","PEM_write_ECPrivateKey",562,567
6,1,45,4,5,"PEM_read_bio_ECPrivateKey@570-575@lib/libcrypto/pem/pem_all.c","lib/libcrypto/pem/pem_all.c","PEM_read_bio_ECPrivateKey",570,575
7,1,59,7,6,"PEM_write_bio_ECPrivateKey@578-584@lib/libcrypto/pem/pem_all.c","lib/libcrypto/pem/pem_all.c","PEM_write_bio_ECPrivateKey",578,584
5,1,44,4,4,"PEM_read_EC_PUBKEY@587-591@lib/libcrypto/pem/pem_all.c","lib/libcrypto/pem/pem_all.c","PEM_read_EC_PUBKEY",587,591
5,1,38,2,4,"PEM_write_EC_PUBKEY@594-598@lib/libcrypto/pem/pem_all.c","lib/libcrypto/pem/pem_all.c","PEM_write_EC_PUBKEY",594,598
5,1,44,4,4,"PEM_read_bio_EC_PUBKEY@601-605@lib/libcrypto/pem/pem_all.c","lib/libcrypto/pem/pem_all.c","PEM_read_bio_EC_PUBKEY",601,605
5,1,38,2,4,"PEM_write_bio_EC_PUBKEY@608-612@lib/libcrypto/pem/pem_all.c","lib/libcrypto/pem/pem_all.c","PEM_write_bio_EC_PUBKEY",608,612
5,1,44,4,4,"PEM_read_DHparams@619-623@lib/libcrypto/pem/pem_all.c","lib/libcrypto/pem/pem_all.c","PEM_read_DHparams",619,623
5,1,43,2,4,"PEM_write_DHparams@626-630@lib/libcrypto/pem/pem_all.c","lib/libcrypto/pem/pem_all.c","PEM_write_DHparams",626,630
5,1,44,4,4,"PEM_read_bio_DHparams@633-637@lib/libcrypto/pem/pem_all.c","lib/libcrypto/pem/pem_all.c","PEM_read_bio_DHparams",633,637
5,1,43,2,4,"PEM_write_bio_DHparams@640-644@lib/libcrypto/pem/pem_all.c","lib/libcrypto/pem/pem_all.c","PEM_write_bio_DHparams",640,644
5,1,44,4,4,"PEM_read_PUBKEY@649-653@lib/libcrypto/pem/pem_all.c","lib/libcrypto/pem/pem_all.c","PEM_read_PUBKEY",649,653
5,1,38,2,4,"PEM_write_PUBKEY@656-660@lib/libcrypto/pem/pem_all.c","lib/libcrypto/pem/pem_all.c","PEM_write_PUBKEY",656,660
5,1,44,4,4,"PEM_read_bio_PUBKEY@663-667@lib/libcrypto/pem/pem_all.c","lib/libcrypto/pem/pem_all.c","PEM_read_bio_PUBKEY",663,667
5,1,38,2,4,"PEM_write_bio_PUBKEY@670-674@lib/libcrypto/pem/pem_all.c","lib/libcrypto/pem/pem_all.c","PEM_write_bio_PUBKEY",670,674
7,2,36,1,8,"ERR_load_PEM_strings@114-122@lib/libcrypto/pem/pem_err.c","lib/libcrypto/pem/pem_err.c","ERR_load_PEM_strings",114,122
14,2,93,4,14,"PEM_X509_INFO_read@79-93@lib/libcrypto/pem/pem_info.c","lib/libcrypto/pem/pem_info.c","PEM_X509_INFO_read",79,93
187,55,1159,4,209,"PEM_X509_INFO_read_bio@96-305@lib/libcrypto/pem/pem_info.c","lib/libcrypto/pem/pem_info.c","PEM_X509_INFO_read_bio",96,305
57,13,383,7,89,"PEM_X509_INFO_write_bio@310-399@lib/libcrypto/pem/pem_info.c","lib/libcrypto/pem/pem_info.c","PEM_X509_INFO_write_bio",310,399
34,8,186,4,37,"PEM_def_callback@91-128@lib/libcrypto/pem/pem_lib.c","lib/libcrypto/pem/pem_lib.c","PEM_def_callback",91,128
15,4,80,2,16,"PEM_proc_type@131-147@lib/libcrypto/pem/pem_lib.c","lib/libcrypto/pem/pem_lib.c","PEM_proc_type",131,147
18,3,173,4,18,"PEM_dek_info@150-168@lib/libcrypto/pem/pem_lib.c","lib/libcrypto/pem/pem_lib.c","PEM_dek_info",150,168
14,2,100,6,14,"PEM_ASN1_read@171-185@lib/libcrypto/pem/pem_lib.c","lib/libcrypto/pem/pem_lib.c","PEM_ASN1_read",171,185
59,25,336,2,81,"check_pem@188-269@lib/libcrypto/pem/pem_lib.c","lib/libcrypto/pem/pem_lib.c","check_pem",188,269
38,11,230,7,42,"PEM_bytes_read_bio@272-314@lib/libcrypto/pem/pem_lib.c","lib/libcrypto/pem/pem_lib.c","PEM_bytes_read_bio",272,314
15,2,118,9,15,"PEM_ASN1_write@317-332@lib/libcrypto/pem/pem_lib.c","lib/libcrypto/pem/pem_lib.c","PEM_ASN1_write",317,332
84,18,596,9,95,"PEM_ASN1_write_bio@335-430@lib/libcrypto/pem/pem_lib.c","lib/libcrypto/pem/pem_lib.c","PEM_ASN1_write_bio",335,430
40,8,310,5,42,"PEM_do_header@433-475@lib/libcrypto/pem/pem_lib.c","lib/libcrypto/pem/pem_lib.c","PEM_do_header",433,475
55,20,355,2,58,"PEM_get_EVP_CIPHER_INFO@478-536@lib/libcrypto/pem/pem_lib.c","lib/libcrypto/pem/pem_lib.c","PEM_get_EVP_CIPHER_INFO",478,536
25,9,196,3,26,"load_iv@539-565@lib/libcrypto/pem/pem_lib.c","lib/libcrypto/pem/pem_lib.c","load_iv",539,565
13,2,92,5,13,"PEM_write@568-581@lib/libcrypto/pem/pem_lib.c","lib/libcrypto/pem/pem_lib.c","PEM_write",568,581
49,17,402,5,54,"PEM_write_bio@584-638@lib/libcrypto/pem/pem_lib.c","lib/libcrypto/pem/pem_lib.c","PEM_write_bio",584,638
13,2,93,5,13,"PEM_read@641-654@lib/libcrypto/pem/pem_lib.c","lib/libcrypto/pem/pem_lib.c","PEM_read",641,654
154,39,1039,5,169,"PEM_read_bio@657-826@lib/libcrypto/pem/pem_lib.c","lib/libcrypto/pem/pem_lib.c","PEM_read_bio",657,826
15,4,84,2,15,"pem_check_suffix@834-849@lib/libcrypto/pem/pem_lib.c","lib/libcrypto/pem/pem_lib.c","pem_check_suffix",834,849
16,3,115,6,16,"PEM_ASN1_read_bio@71-87@lib/libcrypto/pem/pem_oth.c","lib/libcrypto/pem/pem_oth.c","PEM_ASN1_read_bio",71,87
5,1,52,7,4,"PEM_write_bio_PKCS8PrivateKey_nid@82-86@lib/libcrypto/pem/pem_pk8.c","lib/libcrypto/pem/pem_pk8.c","PEM_write_bio_PKCS8PrivateKey_nid",82,86
5,1,55,7,4,"PEM_write_bio_PKCS8PrivateKey@89-93@lib/libcrypto/pem/pem_pk8.c","lib/libcrypto/pem/pem_pk8.c","PEM_write_bio_PKCS8PrivateKey",89,93
5,1,55,7,4,"i2d_PKCS8PrivateKey_bio@96-100@lib/libcrypto/pem/pem_pk8.c","lib/libcrypto/pem/pem_pk8.c","i2d_PKCS8PrivateKey_bio",96,100
5,1,52,7,4,"i2d_PKCS8PrivateKey_nid_bio@103-107@lib/libcrypto/pem/pem_pk8.c","lib/libcrypto/pem/pem_pk8.c","i2d_PKCS8PrivateKey_nid_bio",103,107
43,10,258,9,44,"do_pk8pkey@110-154@lib/libcrypto/pem/pem_pk8.c","lib/libcrypto/pem/pem_pk8.c","do_pk8pkey",110,154
33,7,178,4,33,"d2i_PKCS8PrivateKey_bio@157-190@lib/libcrypto/pem/pem_pk8.c","lib/libcrypto/pem/pem_pk8.c","d2i_PKCS8PrivateKey_bio",157,190
5,1,55,7,4,"i2d_PKCS8PrivateKey_fp@194-198@lib/libcrypto/pem/pem_pk8.c","lib/libcrypto/pem/pem_pk8.c","i2d_PKCS8PrivateKey_fp",194,198
5,1,52,7,4,"i2d_PKCS8PrivateKey_nid_fp@201-205@lib/libcrypto/pem/pem_pk8.c","lib/libcrypto/pem/pem_pk8.c","i2d_PKCS8PrivateKey_nid_fp",201,205
5,1,52,7,4,"PEM_write_PKCS8PrivateKey_nid@208-212@lib/libcrypto/pem/pem_pk8.c","lib/libcrypto/pem/pem_pk8.c","PEM_write_PKCS8PrivateKey_nid",208,212
5,1,55,7,4,"PEM_write_PKCS8PrivateKey@215-219@lib/libcrypto/pem/pem_pk8.c","lib/libcrypto/pem/pem_pk8.c","PEM_write_PKCS8PrivateKey",215,219
13,2,102,9,13,"do_pk8pkey_fp@222-235@lib/libcrypto/pem/pem_pk8.c","lib/libcrypto/pem/pem_pk8.c","do_pk8pkey_fp",222,235
12,2,73,4,12,"d2i_PKCS8PrivateKey_fp@238-250@lib/libcrypto/pem/pem_pk8.c","lib/libcrypto/pem/pem_pk8.c","d2i_PKCS8PrivateKey_fp",238,250
5,1,44,4,4,"PEM_read_PKCS8@253-257@lib/libcrypto/pem/pem_pk8.c","lib/libcrypto/pem/pem_pk8.c","PEM_read_PKCS8",253,257
5,1,38,2,4,"PEM_write_PKCS8@260-264@lib/libcrypto/pem/pem_pk8.c","lib/libcrypto/pem/pem_pk8.c","PEM_write_PKCS8",260,264
5,1,44,4,4,"PEM_read_bio_PKCS8@267-271@lib/libcrypto/pem/pem_pk8.c","lib/libcrypto/pem/pem_pk8.c","PEM_read_bio_PKCS8",267,271
5,1,38,2,4,"PEM_write_bio_PKCS8@274-278@lib/libcrypto/pem/pem_pk8.c","lib/libcrypto/pem/pem_pk8.c","PEM_write_bio_PKCS8",274,278
5,1,44,4,4,"PEM_read_PKCS8_PRIV_KEY_INFO@281-285@lib/libcrypto/pem/pem_pk8.c","lib/libcrypto/pem/pem_pk8.c","PEM_read_PKCS8_PRIV_KEY_INFO",281,285
5,1,38,2,4,"PEM_write_PKCS8_PRIV_KEY_INFO@288-292@lib/libcrypto/pem/pem_pk8.c","lib/libcrypto/pem/pem_pk8.c","PEM_write_PKCS8_PRIV_KEY_INFO",288,292
5,1,44,4,4,"PEM_read_bio_PKCS8_PRIV_KEY_INFO@295-299@lib/libcrypto/pem/pem_pk8.c","lib/libcrypto/pem/pem_pk8.c","PEM_read_bio_PKCS8_PRIV_KEY_INFO",295,299
5,1,38,2,4,"PEM_write_bio_PKCS8_PRIV_KEY_INFO@302-306@lib/libcrypto/pem/pem_pk8.c","lib/libcrypto/pem/pem_pk8.c","PEM_write_bio_PKCS8_PRIV_KEY_INFO",302,306
65,15,400,4,67,"PEM_read_bio_PrivateKey@81-148@lib/libcrypto/pem/pem_pkey.c","lib/libcrypto/pem/pem_pkey.c","PEM_read_bio_PrivateKey",81,148
12,3,121,7,13,"PEM_write_bio_PrivateKey@151-164@lib/libcrypto/pem/pem_pkey.c","lib/libcrypto/pem/pem_pkey.c","PEM_write_bio_PrivateKey",151,164
35,9,199,2,37,"PEM_read_bio_Parameters@167-204@lib/libcrypto/pem/pem_pkey.c","lib/libcrypto/pem/pem_pkey.c","PEM_read_bio_Parameters",167,204
10,3,86,2,11,"PEM_write_bio_Parameters@207-218@lib/libcrypto/pem/pem_pkey.c","lib/libcrypto/pem/pem_pkey.c","PEM_write_bio_Parameters",207,218
13,2,87,4,13,"PEM_read_PrivateKey@221-234@lib/libcrypto/pem/pem_pkey.c","lib/libcrypto/pem/pem_pkey.c","PEM_read_PrivateKey",221,234
13,2,92,7,13,"PEM_write_PrivateKey@237-250@lib/libcrypto/pem/pem_pkey.c","lib/libcrypto/pem/pem_pkey.c","PEM_write_PrivateKey",237,250
6,1,39,1,5,"PEM_ENCODE_SEAL_CTX_cleanup@74-79@lib/libcrypto/pem/pem_seal.c","lib/libcrypto/pem/pem_seal.c","PEM_ENCODE_SEAL_CTX_cleanup",74,79
44,9,325,8,55,"PEM_SealInit@82-137@lib/libcrypto/pem/pem_seal.c","lib/libcrypto/pem/pem_seal.c","PEM_SealInit",82,137
22,4,135,5,22,"PEM_SealUpdate@140-162@lib/libcrypto/pem/pem_seal.c","lib/libcrypto/pem/pem_seal.c","PEM_SealUpdate",140,162
34,6,235,6,38,"PEM_SealFinal@165-203@lib/libcrypto/pem/pem_seal.c","lib/libcrypto/pem/pem_seal.c","PEM_SealFinal",165,203
4,1,21,2,3,"PEM_SignInit@68-71@lib/libcrypto/pem/pem_sign.c","lib/libcrypto/pem/pem_sign.c","PEM_SignInit",68,71
5,1,26,3,4,"PEM_SignUpdate@74-78@lib/libcrypto/pem/pem_sign.c","lib/libcrypto/pem/pem_sign.c","PEM_SignUpdate",74,78
20,3,117,4,24,"PEM_SignFinal@81-105@lib/libcrypto/pem/pem_sign.c","lib/libcrypto/pem/pem_sign.c","PEM_SignFinal",81,105
5,1,44,4,4,"PEM_read_X509@69-73@lib/libcrypto/pem/pem_x509.c","lib/libcrypto/pem/pem_x509.c","PEM_read_X509",69,73
5,1,38,2,4,"PEM_write_X509@76-80@lib/libcrypto/pem/pem_x509.c","lib/libcrypto/pem/pem_x509.c","PEM_write_X509",76,80
5,1,44,4,4,"PEM_read_bio_X509@83-87@lib/libcrypto/pem/pem_x509.c","lib/libcrypto/pem/pem_x509.c","PEM_read_bio_X509",83,87
5,1,38,2,4,"PEM_write_bio_X509@90-94@lib/libcrypto/pem/pem_x509.c","lib/libcrypto/pem/pem_x509.c","PEM_write_bio_X509",90,94
5,1,44,4,4,"PEM_read_X509_AUX@69-73@lib/libcrypto/pem/pem_xaux.c","lib/libcrypto/pem/pem_xaux.c","PEM_read_X509_AUX",69,73
5,1,38,2,4,"PEM_write_X509_AUX@76-80@lib/libcrypto/pem/pem_xaux.c","lib/libcrypto/pem/pem_xaux.c","PEM_write_X509_AUX",76,80
5,1,44,4,4,"PEM_read_bio_X509_AUX@83-87@lib/libcrypto/pem/pem_xaux.c","lib/libcrypto/pem/pem_xaux.c","PEM_read_bio_X509_AUX",83,87
5,1,38,2,4,"PEM_write_bio_X509_AUX@90-94@lib/libcrypto/pem/pem_xaux.c","lib/libcrypto/pem/pem_xaux.c","PEM_write_bio_X509_AUX",90,94
5,1,44,4,4,"PEM_read_X509_CERT_PAIR@97-101@lib/libcrypto/pem/pem_xaux.c","lib/libcrypto/pem/pem_xaux.c","PEM_read_X509_CERT_PAIR",97,101
5,1,38,2,4,"PEM_write_X509_CERT_PAIR@104-108@lib/libcrypto/pem/pem_xaux.c","lib/libcrypto/pem/pem_xaux.c","PEM_write_X509_CERT_PAIR",104,108
5,1,44,4,4,"PEM_read_bio_X509_CERT_PAIR@111-115@lib/libcrypto/pem/pem_xaux.c","lib/libcrypto/pem/pem_xaux.c","PEM_read_bio_X509_CERT_PAIR",111,115
5,1,38,2,4,"PEM_write_bio_X509_CERT_PAIR@118-122@lib/libcrypto/pem/pem_xaux.c","lib/libcrypto/pem/pem_xaux.c","PEM_write_bio_X509_CERT_PAIR",118,122
11,1,70,1,11,"read_ledword@83-94@lib/libcrypto/pem/pvkfmt.c","lib/libcrypto/pem/pvkfmt.c","read_ledword",83,94
20,4,121,3,20,"read_lebn@101-121@lib/libcrypto/pem/pvkfmt.c","lib/libcrypto/pem/pvkfmt.c","read_lebn",101,121
57,14,268,6,63,"do_blob_header@150-213@lib/libcrypto/pem/pvkfmt.c","lib/libcrypto/pem/pvkfmt.c","do_blob_header",150,213
17,4,90,3,29,"blob_length@216-245@lib/libcrypto/pem/pvkfmt.c","lib/libcrypto/pem/pvkfmt.c","blob_length",216,245
19,4,127,3,19,"do_b2i@248-267@lib/libcrypto/pem/pvkfmt.c","lib/libcrypto/pem/pvkfmt.c","do_b2i",248,267
33,6,206,2,36,"do_b2i_bio@270-306@lib/libcrypto/pem/pvkfmt.c","lib/libcrypto/pem/pvkfmt.c","do_b2i_bio",270,306
45,12,297,4,49,"b2i_dss@309-358@lib/libcrypto/pem/pvkfmt.c","lib/libcrypto/pem/pvkfmt.c","b2i_dss",309,358
44,13,310,4,46,"b2i_rsa@361-407@lib/libcrypto/pem/pvkfmt.c","lib/libcrypto/pem/pvkfmt.c","b2i_rsa",361,407
4,1,23,2,3,"b2i_PrivateKey@410-413@lib/libcrypto/pem/pvkfmt.c","lib/libcrypto/pem/pvkfmt.c","b2i_PrivateKey",410,413
4,1,23,2,3,"b2i_PublicKey@416-419@lib/libcrypto/pem/pvkfmt.c","lib/libcrypto/pem/pvkfmt.c","b2i_PublicKey",416,419
4,1,16,1,3,"b2i_PrivateKey_bio@422-425@lib/libcrypto/pem/pvkfmt.c","lib/libcrypto/pem/pvkfmt.c","b2i_PrivateKey_bio",422,425
4,1,16,1,3,"b2i_PublicKey_bio@428-431@lib/libcrypto/pem/pvkfmt.c","lib/libcrypto/pem/pvkfmt.c","b2i_PublicKey_bio",428,431
9,1,73,2,9,"write_ledword@434-443@lib/libcrypto/pem/pvkfmt.c","lib/libcrypto/pem/pvkfmt.c","write_ledword",434,443
21,4,132,3,23,"write_lebn@446-469@lib/libcrypto/pem/pvkfmt.c","lib/libcrypto/pem/pvkfmt.c","write_lebn",446,469
46,11,287,3,46,"do_i2b@479-525@lib/libcrypto/pem/pvkfmt.c","lib/libcrypto/pem/pvkfmt.c","do_i2b",479,525
13,3,78,3,13,"do_i2b_bio@528-541@lib/libcrypto/pem/pvkfmt.c","lib/libcrypto/pem/pvkfmt.c","do_i2b_bio",528,541
21,7,121,3,23,"check_bitlen_dsa@544-567@lib/libcrypto/pem/pvkfmt.c","lib/libcrypto/pem/pvkfmt.c","check_bitlen_dsa",544,567
27,9,180,3,31,"check_bitlen_rsa@570-601@lib/libcrypto/pem/pvkfmt.c","lib/libcrypto/pem/pvkfmt.c","check_bitlen_rsa",570,601
16,2,141,3,16,"write_rsa@604-620@lib/libcrypto/pem/pvkfmt.c","lib/libcrypto/pem/pvkfmt.c","write_rsa",604,620
15,2,105,3,16,"write_dsa@623-639@lib/libcrypto/pem/pvkfmt.c","lib/libcrypto/pem/pvkfmt.c","write_dsa",623,639
4,1,22,2,3,"i2b_PrivateKey_bio@642-645@lib/libcrypto/pem/pvkfmt.c","lib/libcrypto/pem/pvkfmt.c","i2b_PrivateKey_bio",642,645
4,1,22,2,3,"i2b_PublicKey_bio@648-651@lib/libcrypto/pem/pvkfmt.c","lib/libcrypto/pem/pvkfmt.c","i2b_PublicKey_bio",648,651
39,9,199,5,42,"do_PVK_header@656-698@lib/libcrypto/pem/pvkfmt.c","lib/libcrypto/pem/pvkfmt.c","do_PVK_header",656,698
14,5,103,5,15,"derive_pvk_key@701-716@lib/libcrypto/pem/pvkfmt.c","lib/libcrypto/pem/pvkfmt.c","derive_pvk_key",701,716
74,19,482,5,78,"do_PVK_body@719-797@lib/libcrypto/pem/pvkfmt.c","lib/libcrypto/pem/pvkfmt.c","do_PVK_body",719,797
30,5,181,3,32,"b2i_PVK_bio@801-833@lib/libcrypto/pem/pvkfmt.c","lib/libcrypto/pem/pvkfmt.c","b2i_PVK_bio",801,833
74,18,454,5,76,"i2b_PVK@836-912@lib/libcrypto/pem/pvkfmt.c","lib/libcrypto/pem/pvkfmt.c","i2b_PVK",836,912
15,3,97,5,15,"i2b_PVK_bio@915-930@lib/libcrypto/pem/pvkfmt.c","lib/libcrypto/pem/pvkfmt.c","i2b_PVK_bio",915,930
23,4,135,4,23,"PKCS12_item_pack_safebag@67-90@lib/libcrypto/pkcs12/p12_add.c","lib/libcrypto/pkcs12/p12_add.c","PKCS12_item_pack_safebag",67,90
11,2,53,1,11,"PKCS12_MAKE_KEYBAG@95-106@lib/libcrypto/pkcs12/p12_add.c","lib/libcrypto/pkcs12/p12_add.c","PKCS12_MAKE_KEYBAG",95,106
21,4,133,7,27,"PKCS12_MAKE_SHKEYBAG@111-138@lib/libcrypto/pkcs12/p12_add.c","lib/libcrypto/pkcs12/p12_add.c","PKCS12_MAKE_SHKEYBAG",111,138
21,4,111,1,23,"PKCS12_pack_p7data@142-165@lib/libcrypto/pkcs12/p12_add.c","lib/libcrypto/pkcs12/p12_add.c","PKCS12_pack_p7data",142,165
8,2,39,1,7,"PKCS12_unpack_p7data@169-176@lib/libcrypto/pkcs12/p12_add.c","lib/libcrypto/pkcs12/p12_add.c","PKCS12_unpack_p7data",169,176
36,6,232,7,41,"PKCS12_pack_p7encdata@181-222@lib/libcrypto/pkcs12/p12_add.c","lib/libcrypto/pkcs12/p12_add.c","PKCS12_pack_p7encdata",181,222
8,2,60,3,7,"PKCS12_unpack_p7encdata@225-232@lib/libcrypto/pkcs12/p12_add.c","lib/libcrypto/pkcs12/p12_add.c","PKCS12_unpack_p7encdata",225,232
4,1,30,3,3,"PKCS12_decrypt_skey@235-238@lib/libcrypto/pkcs12/p12_add.c","lib/libcrypto/pkcs12/p12_add.c","PKCS12_decrypt_skey",235,238
7,2,40,2,6,"PKCS12_pack_authsafes@241-247@lib/libcrypto/pkcs12/p12_add.c","lib/libcrypto/pkcs12/p12_add.c","PKCS12_pack_authsafes",241,247
9,2,43,1,8,"PKCS12_unpack_authsafes@250-258@lib/libcrypto/pkcs12/p12_add.c","lib/libcrypto/pkcs12/p12_add.c","PKCS12_unpack_authsafes",250,258
5,1,38,3,4,"d2i_PKCS12@102-106@lib/libcrypto/pkcs12/p12_asn.c","lib/libcrypto/pkcs12/p12_asn.c","d2i_PKCS12",102,106
4,1,28,2,3,"i2d_PKCS12@109-112@lib/libcrypto/pkcs12/p12_asn.c","lib/libcrypto/pkcs12/p12_asn.c","i2d_PKCS12",109,112
4,1,17,1,3,"PKCS12_new@115-118@lib/libcrypto/pkcs12/p12_asn.c","lib/libcrypto/pkcs12/p12_asn.c","PKCS12_new",115,118
4,1,20,1,3,"PKCS12_free@121-124@lib/libcrypto/pkcs12/p12_asn.c","lib/libcrypto/pkcs12/p12_asn.c","PKCS12_free",121,124
5,1,38,3,4,"d2i_PKCS12_MAC_DATA@162-166@lib/libcrypto/pkcs12/p12_asn.c","lib/libcrypto/pkcs12/p12_asn.c","d2i_PKCS12_MAC_DATA",162,166
4,1,28,2,3,"i2d_PKCS12_MAC_DATA@169-172@lib/libcrypto/pkcs12/p12_asn.c","lib/libcrypto/pkcs12/p12_asn.c","i2d_PKCS12_MAC_DATA",169,172
4,1,17,1,3,"PKCS12_MAC_DATA_new@175-178@lib/libcrypto/pkcs12/p12_asn.c","lib/libcrypto/pkcs12/p12_asn.c","PKCS12_MAC_DATA_new",175,178
4,1,20,1,3,"PKCS12_MAC_DATA_free@181-184@lib/libcrypto/pkcs12/p12_asn.c","lib/libcrypto/pkcs12/p12_asn.c","PKCS12_MAC_DATA_free",181,184
5,1,38,3,4,"d2i_PKCS12_BAGS@269-273@lib/libcrypto/pkcs12/p12_asn.c","lib/libcrypto/pkcs12/p12_asn.c","d2i_PKCS12_BAGS",269,273
4,1,28,2,3,"i2d_PKCS12_BAGS@276-279@lib/libcrypto/pkcs12/p12_asn.c","lib/libcrypto/pkcs12/p12_asn.c","i2d_PKCS12_BAGS",276,279
4,1,17,1,3,"PKCS12_BAGS_new@282-285@lib/libcrypto/pkcs12/p12_asn.c","lib/libcrypto/pkcs12/p12_asn.c","PKCS12_BAGS_new",282,285
4,1,20,1,3,"PKCS12_BAGS_free@288-291@lib/libcrypto/pkcs12/p12_asn.c","lib/libcrypto/pkcs12/p12_asn.c","PKCS12_BAGS_free",288,291
5,1,38,3,4,"d2i_PKCS12_SAFEBAG@415-419@lib/libcrypto/pkcs12/p12_asn.c","lib/libcrypto/pkcs12/p12_asn.c","d2i_PKCS12_SAFEBAG",415,419
4,1,28,2,3,"i2d_PKCS12_SAFEBAG@422-425@lib/libcrypto/pkcs12/p12_asn.c","lib/libcrypto/pkcs12/p12_asn.c","i2d_PKCS12_SAFEBAG",422,425
4,1,17,1,3,"PKCS12_SAFEBAG_new@428-431@lib/libcrypto/pkcs12/p12_asn.c","lib/libcrypto/pkcs12/p12_asn.c","PKCS12_SAFEBAG_new",428,431
4,1,20,1,3,"PKCS12_SAFEBAG_free@434-437@lib/libcrypto/pkcs12/p12_asn.c","lib/libcrypto/pkcs12/p12_asn.c","PKCS12_SAFEBAG_free",434,437
8,2,41,3,7,"PKCS12_add_localkeyid@66-73@lib/libcrypto/pkcs12/p12_attr.c","lib/libcrypto/pkcs12/p12_attr.c","PKCS12_add_localkeyid",66,73
10,2,49,2,10,"PKCS8_add_keyusage@78-88@lib/libcrypto/pkcs12/p12_attr.c","lib/libcrypto/pkcs12/p12_attr.c","PKCS8_add_keyusage",78,88
8,2,46,3,7,"PKCS12_add_friendlyname_asc@93-100@lib/libcrypto/pkcs12/p12_attr.c","lib/libcrypto/pkcs12/p12_attr.c","PKCS12_add_friendlyname_asc",93,100
9,2,42,3,8,"PKCS12_add_friendlyname_uni@104-112@lib/libcrypto/pkcs12/p12_attr.c","lib/libcrypto/pkcs12/p12_attr.c","PKCS12_add_friendlyname_uni",104,112
8,2,46,3,7,"PKCS12_add_CSPName_asc@115-122@lib/libcrypto/pkcs12/p12_attr.c","lib/libcrypto/pkcs12/p12_attr.c","PKCS12_add_CSPName_asc",115,122
17,5,99,2,17,"PKCS12_get_attr_gen@125-142@lib/libcrypto/pkcs12/p12_attr.c","lib/libcrypto/pkcs12/p12_attr.c","PKCS12_get_attr_gen",125,142
10,3,60,1,10,"PKCS12_get_friendlyname@145-155@lib/libcrypto/pkcs12/p12_attr.c","lib/libcrypto/pkcs12/p12_attr.c","PKCS12_get_friendlyname",145,155
3,1,6,1,2,"PKCS12_PBE_add@68-70@lib/libcrypto/pkcs12/p12_crpt.c","lib/libcrypto/pkcs12/p12_crpt.c","PKCS12_PBE_add",68,70
45,9,321,7,48,"PKCS12_PBE_keyivgen@73-121@lib/libcrypto/pkcs12/p12_crpt.c","lib/libcrypto/pkcs12/p12_crpt.c","PKCS12_PBE_keyivgen",73,121
12,3,71,3,12,"copy_bag_attr@68-80@lib/libcrypto/pkcs12/p12_crt.c","lib/libcrypto/pkcs12/p12_crt.c","copy_bag_attr",68,80
79,36,532,10,100,"PKCS12_create@83-183@lib/libcrypto/pkcs12/p12_crt.c","lib/libcrypto/pkcs12/p12_crt.c","PKCS12_create",83,183
23,8,145,2,34,"PKCS12_add_cert@186-220@lib/libcrypto/pkcs12/p12_crt.c","lib/libcrypto/pkcs12/p12_crt.c","PKCS12_add_cert",186,220
31,10,175,6,37,"PKCS12_add_key@223-260@lib/libcrypto/pkcs12/p12_crt.c","lib/libcrypto/pkcs12/p12_crt.c","PKCS12_add_key",223,260
33,9,173,5,40,"PKCS12_add_safe@263-303@lib/libcrypto/pkcs12/p12_crt.c","lib/libcrypto/pkcs12/p12_crt.c","PKCS12_add_safe",263,303
21,6,95,2,23,"pkcs12_add_bag@306-329@lib/libcrypto/pkcs12/p12_crt.c","lib/libcrypto/pkcs12/p12_crt.c","pkcs12_add_bag",306,329
14,4,66,2,17,"PKCS12_add_safes@332-349@lib/libcrypto/pkcs12/p12_crt.c","lib/libcrypto/pkcs12/p12_crt.c","PKCS12_add_safes",332,349
39,7,229,8,45,"PKCS12_pbe_crypt@70-115@lib/libcrypto/pkcs12/p12_decr.c","lib/libcrypto/pkcs12/p12_decr.c","PKCS12_pbe_crypt",70,115
21,4,131,6,21,"PKCS12_item_decrypt_d2i@122-143@lib/libcrypto/pkcs12/p12_decr.c","lib/libcrypto/pkcs12/p12_decr.c","PKCS12_item_decrypt_d2i",122,143
30,5,162,6,31,"PKCS12_item_i2d_encrypt@150-181@lib/libcrypto/pkcs12/p12_decr.c","lib/libcrypto/pkcs12/p12_decr.c","PKCS12_item_i2d_encrypt",150,181
27,5,119,1,29,"PKCS12_init@67-96@lib/libcrypto/pkcs12/p12_init.c","lib/libcrypto/pkcs12/p12_init.c","PKCS12_init",67,96
21,4,134,9,21,"PKCS12_key_gen_asc@72-93@lib/libcrypto/pkcs12/p12_key.c","lib/libcrypto/pkcs12/p12_key.c","PKCS12_key_gen_asc",72,93
93,34,708,9,101,"PKCS12_key_gen_uni@96-197@lib/libcrypto/pkcs12/p12_key.c","lib/libcrypto/pkcs12/p12_key.c","PKCS12_key_gen_uni",96,197
66,27,361,5,85,"PKCS12_parse@82-167@lib/libcrypto/pkcs12/p12_kiss.c","lib/libcrypto/pkcs12/p12_kiss.c","PKCS12_parse",82,167
32,7,208,5,32,"parse_pk12@172-204@lib/libcrypto/pkcs12/p12_kiss.c","lib/libcrypto/pkcs12/p12_kiss.c","parse_pk12",172,204
11,3,78,5,11,"parse_bags@207-218@lib/libcrypto/pkcs12/p12_kiss.c","lib/libcrypto/pkcs12/p12_kiss.c","parse_bags",207,218
66,22,383,5,74,"parse_bag@221-295@lib/libcrypto/pkcs12/p12_kiss.c","lib/libcrypto/pkcs12/p12_kiss.c","parse_bag",221,295
44,10,294,5,45,"PKCS12_gen_mac@73-118@lib/libcrypto/pkcs12/p12_mutl.c","lib/libcrypto/pkcs12/p12_mutl.c","PKCS12_gen_mac",73,118
17,5,115,3,17,"PKCS12_verify_mac@122-139@lib/libcrypto/pkcs12/p12_mutl.c","lib/libcrypto/pkcs12/p12_mutl.c","PKCS12_verify_mac",122,139
22,5,141,7,22,"PKCS12_set_mac@144-166@lib/libcrypto/pkcs12/p12_mutl.c","lib/libcrypto/pkcs12/p12_mutl.c","PKCS12_set_mac",144,166
34,9,242,5,34,"PKCS12_setup_mac@170-204@lib/libcrypto/pkcs12/p12_mutl.c","lib/libcrypto/pkcs12/p12_mutl.c","PKCS12_setup_mac",170,204
16,4,79,3,22,"PKCS12_newpass@79-101@lib/libcrypto/pkcs12/p12_npas.c","lib/libcrypto/pkcs12/p12_npas.c","PKCS12_newpass",79,101
73,17,509,3,82,"newpass_p12@106-188@lib/libcrypto/pkcs12/p12_npas.c","lib/libcrypto/pkcs12/p12_npas.c","newpass_p12",106,188
10,3,63,3,10,"newpass_bags@192-202@lib/libcrypto/pkcs12/p12_npas.c","lib/libcrypto/pkcs12/p12_npas.c","newpass_bags",192,202
18,5,145,3,19,"newpass_bag@207-226@lib/libcrypto/pkcs12/p12_npas.c","lib/libcrypto/pkcs12/p12_npas.c","newpass_bag",207,226
14,2,107,4,14,"alg_get@229-243@lib/libcrypto/pkcs12/p12_npas.c","lib/libcrypto/pkcs12/p12_npas.c","alg_get",229,243
5,1,37,3,4,"PKCS8_decrypt@64-68@lib/libcrypto/pkcs12/p12_p8d.c","lib/libcrypto/pkcs12/p12_p8d.c","PKCS8_decrypt",64,68
32,5,185,8,35,"PKCS8_encrypt@65-100@lib/libcrypto/pkcs12/p12_p8e.c","lib/libcrypto/pkcs12/p12_p8e.c","PKCS8_encrypt",65,100
30,8,179,4,32,"OPENSSL_asc2uni@68-100@lib/libcrypto/pkcs12/p12_utl.c","lib/libcrypto/pkcs12/p12_utl.c","OPENSSL_asc2uni",68,100
19,6,119,2,22,"OPENSSL_uni2asc@103-125@lib/libcrypto/pkcs12/p12_utl.c","lib/libcrypto/pkcs12/p12_utl.c","OPENSSL_uni2asc",103,125
4,1,23,2,3,"i2d_PKCS12_bio@128-131@lib/libcrypto/pkcs12/p12_utl.c","lib/libcrypto/pkcs12/p12_utl.c","i2d_PKCS12_bio",128,131
4,1,23,2,3,"i2d_PKCS12_fp@134-137@lib/libcrypto/pkcs12/p12_utl.c","lib/libcrypto/pkcs12/p12_utl.c","i2d_PKCS12_fp",134,137
4,1,23,2,3,"d2i_PKCS12_bio@140-143@lib/libcrypto/pkcs12/p12_utl.c","lib/libcrypto/pkcs12/p12_utl.c","d2i_PKCS12_bio",140,143
4,1,23,2,3,"d2i_PKCS12_fp@146-149@lib/libcrypto/pkcs12/p12_utl.c","lib/libcrypto/pkcs12/p12_utl.c","d2i_PKCS12_fp",146,149
5,1,21,1,4,"PKCS12_x5092certbag@152-156@lib/libcrypto/pkcs12/p12_utl.c","lib/libcrypto/pkcs12/p12_utl.c","PKCS12_x5092certbag",152,156
5,1,21,1,4,"PKCS12_x509crl2certbag@159-163@lib/libcrypto/pkcs12/p12_utl.c","lib/libcrypto/pkcs12/p12_utl.c","PKCS12_x509crl2certbag",159,163
9,3,57,1,8,"PKCS12_certbag2x509@166-174@lib/libcrypto/pkcs12/p12_utl.c","lib/libcrypto/pkcs12/p12_utl.c","PKCS12_certbag2x509",166,174
9,3,57,1,8,"PKCS12_certbag2x509crl@177-185@lib/libcrypto/pkcs12/p12_utl.c","lib/libcrypto/pkcs12/p12_utl.c","PKCS12_certbag2x509crl",177,185
7,2,36,1,8,"ERR_load_PKCS12_strings@136-144@lib/libcrypto/pkcs12/pk12err.c","lib/libcrypto/pkcs12/pk12err.c","ERR_load_PKCS12_strings",136,144
4,1,27,2,3,"BIO_new_PKCS7@63-66@lib/libcrypto/pkcs7/bio_pk7.c","lib/libcrypto/pkcs7/bio_pk7.c","BIO_new_PKCS7",63,66
21,8,120,4,23,"pk7_cb@158-181@lib/libcrypto/pkcs7/pk7_asn1.c","lib/libcrypto/pkcs7/pk7_asn1.c","pk7_cb",158,181
5,1,38,3,4,"d2i_PKCS7@220-224@lib/libcrypto/pkcs7/pk7_asn1.c","lib/libcrypto/pkcs7/pk7_asn1.c","d2i_PKCS7",220,224
4,1,28,2,3,"i2d_PKCS7@227-230@lib/libcrypto/pkcs7/pk7_asn1.c","lib/libcrypto/pkcs7/pk7_asn1.c","i2d_PKCS7",227,230
4,1,17,1,3,"PKCS7_new@233-236@lib/libcrypto/pkcs7/pk7_asn1.c","lib/libcrypto/pkcs7/pk7_asn1.c","PKCS7_new",233,236
4,1,20,1,3,"PKCS7_free@239-242@lib/libcrypto/pkcs7/pk7_asn1.c","lib/libcrypto/pkcs7/pk7_asn1.c","PKCS7_free",239,242
4,1,28,2,3,"i2d_PKCS7_NDEF@245-248@lib/libcrypto/pkcs7/pk7_asn1.c","lib/libcrypto/pkcs7/pk7_asn1.c","i2d_PKCS7_NDEF",245,248
4,1,17,1,3,"PKCS7_dup@251-254@lib/libcrypto/pkcs7/pk7_asn1.c","lib/libcrypto/pkcs7/pk7_asn1.c","PKCS7_dup",251,254
5,1,38,3,4,"d2i_PKCS7_SIGNED@313-317@lib/libcrypto/pkcs7/pk7_asn1.c","lib/libcrypto/pkcs7/pk7_asn1.c","d2i_PKCS7_SIGNED",313,317
4,1,28,2,3,"i2d_PKCS7_SIGNED@320-323@lib/libcrypto/pkcs7/pk7_asn1.c","lib/libcrypto/pkcs7/pk7_asn1.c","i2d_PKCS7_SIGNED",320,323
4,1,17,1,3,"PKCS7_SIGNED_new@326-329@lib/libcrypto/pkcs7/pk7_asn1.c","lib/libcrypto/pkcs7/pk7_asn1.c","PKCS7_SIGNED_new",326,329
4,1,20,1,3,"PKCS7_SIGNED_free@332-335@lib/libcrypto/pkcs7/pk7_asn1.c","lib/libcrypto/pkcs7/pk7_asn1.c","PKCS7_SIGNED_free",332,335
8,2,49,4,7,"si_cb@339-346@lib/libcrypto/pkcs7/pk7_asn1.c","lib/libcrypto/pkcs7/pk7_asn1.c","si_cb",339,346
5,1,38,3,4,"d2i_PKCS7_SIGNER_INFO@425-429@lib/libcrypto/pkcs7/pk7_asn1.c","lib/libcrypto/pkcs7/pk7_asn1.c","d2i_PKCS7_SIGNER_INFO",425,429
4,1,28,2,3,"i2d_PKCS7_SIGNER_INFO@432-435@lib/libcrypto/pkcs7/pk7_asn1.c","lib/libcrypto/pkcs7/pk7_asn1.c","i2d_PKCS7_SIGNER_INFO",432,435
4,1,17,1,3,"PKCS7_SIGNER_INFO_new@438-441@lib/libcrypto/pkcs7/pk7_asn1.c","lib/libcrypto/pkcs7/pk7_asn1.c","PKCS7_SIGNER_INFO_new",438,441
4,1,20,1,3,"PKCS7_SIGNER_INFO_free@444-447@lib/libcrypto/pkcs7/pk7_asn1.c","lib/libcrypto/pkcs7/pk7_asn1.c","PKCS7_SIGNER_INFO_free",444,447
5,1,38,3,4,"d2i_PKCS7_ISSUER_AND_SERIAL@478-482@lib/libcrypto/pkcs7/pk7_asn1.c","lib/libcrypto/pkcs7/pk7_asn1.c","d2i_PKCS7_ISSUER_AND_SERIAL",478,482
4,1,28,2,3,"i2d_PKCS7_ISSUER_AND_SERIAL@485-488@lib/libcrypto/pkcs7/pk7_asn1.c","lib/libcrypto/pkcs7/pk7_asn1.c","i2d_PKCS7_ISSUER_AND_SERIAL",485,488
4,1,17,1,3,"PKCS7_ISSUER_AND_SERIAL_new@491-494@lib/libcrypto/pkcs7/pk7_asn1.c","lib/libcrypto/pkcs7/pk7_asn1.c","PKCS7_ISSUER_AND_SERIAL_new",491,494
4,1,20,1,3,"PKCS7_ISSUER_AND_SERIAL_free@497-500@lib/libcrypto/pkcs7/pk7_asn1.c","lib/libcrypto/pkcs7/pk7_asn1.c","PKCS7_ISSUER_AND_SERIAL_free",497,500
5,1,38,3,4,"d2i_PKCS7_ENVELOPE@538-542@lib/libcrypto/pkcs7/pk7_asn1.c","lib/libcrypto/pkcs7/pk7_asn1.c","d2i_PKCS7_ENVELOPE",538,542
4,1,28,2,3,"i2d_PKCS7_ENVELOPE@545-548@lib/libcrypto/pkcs7/pk7_asn1.c","lib/libcrypto/pkcs7/pk7_asn1.c","i2d_PKCS7_ENVELOPE",545,548
4,1,17,1,3,"PKCS7_ENVELOPE_new@551-554@lib/libcrypto/pkcs7/pk7_asn1.c","lib/libcrypto/pkcs7/pk7_asn1.c","PKCS7_ENVELOPE_new",551,554
4,1,20,1,3,"PKCS7_ENVELOPE_free@557-560@lib/libcrypto/pkcs7/pk7_asn1.c","lib/libcrypto/pkcs7/pk7_asn1.c","PKCS7_ENVELOPE_free",557,560
8,2,49,4,7,"ri_cb@564-571@lib/libcrypto/pkcs7/pk7_asn1.c","lib/libcrypto/pkcs7/pk7_asn1.c","ri_cb",564,571
5,1,38,3,4,"d2i_PKCS7_RECIP_INFO@624-628@lib/libcrypto/pkcs7/pk7_asn1.c","lib/libcrypto/pkcs7/pk7_asn1.c","d2i_PKCS7_RECIP_INFO",624,628
4,1,28,2,3,"i2d_PKCS7_RECIP_INFO@631-634@lib/libcrypto/pkcs7/pk7_asn1.c","lib/libcrypto/pkcs7/pk7_asn1.c","i2d_PKCS7_RECIP_INFO",631,634
4,1,17,1,3,"PKCS7_RECIP_INFO_new@637-640@lib/libcrypto/pkcs7/pk7_asn1.c","lib/libcrypto/pkcs7/pk7_asn1.c","PKCS7_RECIP_INFO_new",637,640
4,1,20,1,3,"PKCS7_RECIP_INFO_free@643-646@lib/libcrypto/pkcs7/pk7_asn1.c","lib/libcrypto/pkcs7/pk7_asn1.c","PKCS7_RECIP_INFO_free",643,646
5,1,38,3,4,"d2i_PKCS7_ENC_CONTENT@684-688@lib/libcrypto/pkcs7/pk7_asn1.c","lib/libcrypto/pkcs7/pk7_asn1.c","d2i_PKCS7_ENC_CONTENT",684,688
4,1,28,2,3,"i2d_PKCS7_ENC_CONTENT@691-694@lib/libcrypto/pkcs7/pk7_asn1.c","lib/libcrypto/pkcs7/pk7_asn1.c","i2d_PKCS7_ENC_CONTENT",691,694
4,1,17,1,3,"PKCS7_ENC_CONTENT_new@697-700@lib/libcrypto/pkcs7/pk7_asn1.c","lib/libcrypto/pkcs7/pk7_asn1.c","PKCS7_ENC_CONTENT_new",697,700
4,1,20,1,3,"PKCS7_ENC_CONTENT_free@703-706@lib/libcrypto/pkcs7/pk7_asn1.c","lib/libcrypto/pkcs7/pk7_asn1.c","PKCS7_ENC_CONTENT_free",703,706
5,1,38,3,4,"d2i_PKCS7_SIGN_ENVELOPE@772-776@lib/libcrypto/pkcs7/pk7_asn1.c","lib/libcrypto/pkcs7/pk7_asn1.c","d2i_PKCS7_SIGN_ENVELOPE",772,776
4,1,28,2,3,"i2d_PKCS7_SIGN_ENVELOPE@779-782@lib/libcrypto/pkcs7/pk7_asn1.c","lib/libcrypto/pkcs7/pk7_asn1.c","i2d_PKCS7_SIGN_ENVELOPE",779,782
4,1,17,1,3,"PKCS7_SIGN_ENVELOPE_new@785-788@lib/libcrypto/pkcs7/pk7_asn1.c","lib/libcrypto/pkcs7/pk7_asn1.c","PKCS7_SIGN_ENVELOPE_new",785,788
4,1,20,1,3,"PKCS7_SIGN_ENVELOPE_free@791-794@lib/libcrypto/pkcs7/pk7_asn1.c","lib/libcrypto/pkcs7/pk7_asn1.c","PKCS7_SIGN_ENVELOPE_free",791,794
5,1,38,3,4,"d2i_PKCS7_ENCRYPT@825-829@lib/libcrypto/pkcs7/pk7_asn1.c","lib/libcrypto/pkcs7/pk7_asn1.c","d2i_PKCS7_ENCRYPT",825,829
4,1,28,2,3,"i2d_PKCS7_ENCRYPT@832-835@lib/libcrypto/pkcs7/pk7_asn1.c","lib/libcrypto/pkcs7/pk7_asn1.c","i2d_PKCS7_ENCRYPT",832,835
4,1,17,1,3,"PKCS7_ENCRYPT_new@838-841@lib/libcrypto/pkcs7/pk7_asn1.c","lib/libcrypto/pkcs7/pk7_asn1.c","PKCS7_ENCRYPT_new",838,841
4,1,20,1,3,"PKCS7_ENCRYPT_free@844-847@lib/libcrypto/pkcs7/pk7_asn1.c","lib/libcrypto/pkcs7/pk7_asn1.c","PKCS7_ENCRYPT_free",844,847
5,1,38,3,4,"d2i_PKCS7_DIGEST@892-896@lib/libcrypto/pkcs7/pk7_asn1.c","lib/libcrypto/pkcs7/pk7_asn1.c","d2i_PKCS7_DIGEST",892,896
4,1,28,2,3,"i2d_PKCS7_DIGEST@899-902@lib/libcrypto/pkcs7/pk7_asn1.c","lib/libcrypto/pkcs7/pk7_asn1.c","i2d_PKCS7_DIGEST",899,902
4,1,17,1,3,"PKCS7_DIGEST_new@905-908@lib/libcrypto/pkcs7/pk7_asn1.c","lib/libcrypto/pkcs7/pk7_asn1.c","PKCS7_DIGEST_new",905,908
4,1,20,1,3,"PKCS7_DIGEST_free@911-914@lib/libcrypto/pkcs7/pk7_asn1.c","lib/libcrypto/pkcs7/pk7_asn1.c","PKCS7_DIGEST_free",911,914
5,1,39,4,4,"PKCS7_print_ctx@964-968@lib/libcrypto/pkcs7/pk7_asn1.c","lib/libcrypto/pkcs7/pk7_asn1.c","PKCS7_print_ctx",964,968
12,2,73,2,11,"PKCS7_add_attrib_smimecap@70-81@lib/libcrypto/pkcs7/pk7_attr.c","lib/libcrypto/pkcs7/pk7_attr.c","PKCS7_add_attrib_smimecap",70,81
12,3,80,1,12,"PKCS7_get_smimecap@84-96@lib/libcrypto/pkcs7/pk7_attr.c","lib/libcrypto/pkcs7/pk7_attr.c","PKCS7_get_smimecap",84,96
30,7,170,3,32,"PKCS7_simple_smimecap@100-132@lib/libcrypto/pkcs7/pk7_attr.c","lib/libcrypto/pkcs7/pk7_attr.c","PKCS7_simple_smimecap",100,132
9,3,48,2,8,"PKCS7_add_attrib_content_type@135-143@lib/libcrypto/pkcs7/pk7_attr.c","lib/libcrypto/pkcs7/pk7_attr.c","PKCS7_add_attrib_content_type",135,143
9,2,51,2,8,"PKCS7_add0_attrib_signing_time@146-154@lib/libcrypto/pkcs7/pk7_attr.c","lib/libcrypto/pkcs7/pk7_attr.c","PKCS7_add0_attrib_signing_time",146,154
15,4,72,3,15,"PKCS7_add1_attrib_digest@157-172@lib/libcrypto/pkcs7/pk7_attr.c","lib/libcrypto/pkcs7/pk7_attr.c","PKCS7_add1_attrib_digest",157,172
18,7,62,1,21,"PKCS7_type_is_other@73-94@lib/libcrypto/pkcs7/pk7_doit.c","lib/libcrypto/pkcs7/pk7_doit.c","PKCS7_type_is_other",73,94
9,5,61,1,8,"PKCS7_get_octet_string@97-105@lib/libcrypto/pkcs7/pk7_doit.c","lib/libcrypto/pkcs7/pk7_doit.c","PKCS7_get_octet_string",97,105
26,5,129,2,30,"PKCS7_bio_add_digest@108-138@lib/libcrypto/pkcs7/pk7_doit.c","lib/libcrypto/pkcs7/pk7_doit.c","PKCS7_bio_add_digest",108,138
38,8,223,3,48,"pkcs7_encode_rinfo@141-189@lib/libcrypto/pkcs7/pk7_doit.c","lib/libcrypto/pkcs7/pk7_doit.c","pkcs7_encode_rinfo",141,189
41,9,240,4,52,"pkcs7_decrypt_rinfo@193-245@lib/libcrypto/pkcs7/pk7_doit.c","lib/libcrypto/pkcs7/pk7_doit.c","pkcs7_decrypt_rinfo",193,245
130,37,800,2,154,"PKCS7_dataInit@248-402@lib/libcrypto/pkcs7/pk7_doit.c","lib/libcrypto/pkcs7/pk7_doit.c","PKCS7_dataInit",248,402
10,2,55,2,10,"pkcs7_cmp_ri@405-415@lib/libcrypto/pkcs7/pk7_doit.c","lib/libcrypto/pkcs7/pk7_doit.c","pkcs7_cmp_ri",405,415
172,41,1027,4,208,"PKCS7_dataDecode@419-627@lib/libcrypto/pkcs7/pk7_doit.c","lib/libcrypto/pkcs7/pk7_doit.c","PKCS7_dataDecode",419,627
19,5,94,3,18,"PKCS7_find_digest@630-648@lib/libcrypto/pkcs7/pk7_doit.c","lib/libcrypto/pkcs7/pk7_doit.c","PKCS7_find_digest",630,648
22,6,114,2,28,"do_pkcs7_signed_attrib@651-679@lib/libcrypto/pkcs7/pk7_doit.c","lib/libcrypto/pkcs7/pk7_doit.c","do_pkcs7_signed_attrib",651,679
141,36,839,2,172,"PKCS7_dataFinal@683-855@lib/libcrypto/pkcs7/pk7_doit.c","lib/libcrypto/pkcs7/pk7_doit.c","PKCS7_dataFinal",683,855
47,10,285,1,55,"PKCS7_SIGNER_INFO_sign@858-913@lib/libcrypto/pkcs7/pk7_doit.c","lib/libcrypto/pkcs7/pk7_doit.c","PKCS7_SIGNER_INFO_sign",858,913
48,9,264,5,58,"PKCS7_dataVerify@916-974@lib/libcrypto/pkcs7/pk7_doit.c","lib/libcrypto/pkcs7/pk7_doit.c","PKCS7_dataVerify",916,974
87,21,506,4,103,"PKCS7_signatureVerify@977-1080@lib/libcrypto/pkcs7/pk7_doit.c","lib/libcrypto/pkcs7/pk7_doit.c","PKCS7_signatureVerify",977,1080
19,5,114,2,19,"PKCS7_get_issuer_and_serial@1083-1102@lib/libcrypto/pkcs7/pk7_doit.c","lib/libcrypto/pkcs7/pk7_doit.c","PKCS7_get_issuer_and_serial",1083,1102
4,1,23,2,3,"PKCS7_get_signed_attribute@1105-1108@lib/libcrypto/pkcs7/pk7_doit.c","lib/libcrypto/pkcs7/pk7_doit.c","PKCS7_get_signed_attribute",1105,1108
4,1,23,2,3,"PKCS7_get_attribute@1111-1114@lib/libcrypto/pkcs7/pk7_doit.c","lib/libcrypto/pkcs7/pk7_doit.c","PKCS7_get_attribute",1111,1114
19,7,128,2,19,"get_attribute@1117-1136@lib/libcrypto/pkcs7/pk7_doit.c","lib/libcrypto/pkcs7/pk7_doit.c","get_attribute",1117,1136
9,3,50,1,9,"PKCS7_digest_from_attributes@1139-1148@lib/libcrypto/pkcs7/pk7_doit.c","lib/libcrypto/pkcs7/pk7_doit.c","PKCS7_digest_from_attributes",1139,1148
18,5,108,2,18,"PKCS7_set_signed_attributes@1151-1169@lib/libcrypto/pkcs7/pk7_doit.c","lib/libcrypto/pkcs7/pk7_doit.c","PKCS7_set_signed_attributes",1151,1169
17,5,108,2,17,"PKCS7_set_attributes@1172-1189@lib/libcrypto/pkcs7/pk7_doit.c","lib/libcrypto/pkcs7/pk7_doit.c","PKCS7_set_attributes",1172,1189
5,1,37,4,4,"PKCS7_add_signed_attribute@1192-1196@lib/libcrypto/pkcs7/pk7_doit.c","lib/libcrypto/pkcs7/pk7_doit.c","PKCS7_add_signed_attribute",1192,1196
4,1,37,4,3,"PKCS7_add_attribute@1199-1202@lib/libcrypto/pkcs7/pk7_doit.c","lib/libcrypto/pkcs7/pk7_doit.c","PKCS7_add_attribute",1199,1202
36,9,204,4,37,"add_attribute@1205-1242@lib/libcrypto/pkcs7/pk7_doit.c","lib/libcrypto/pkcs7/pk7_doit.c","add_attribute",1205,1242
38,9,207,4,41,"PKCS7_ctrl@68-109@lib/libcrypto/pkcs7/pk7_lib.c","lib/libcrypto/pkcs7/pk7_lib.c","PKCS7_ctrl",68,109
15,5,81,2,16,"PKCS7_content_new@112-128@lib/libcrypto/pkcs7/pk7_lib.c","lib/libcrypto/pkcs7/pk7_lib.c","PKCS7_content_new",112,128
27,9,140,2,27,"PKCS7_set_content@131-158@lib/libcrypto/pkcs7/pk7_lib.c","lib/libcrypto/pkcs7/pk7_lib.c","PKCS7_set_content",131,158
64,18,402,2,67,"PKCS7_set_type@161-228@lib/libcrypto/pkcs7/pk7_lib.c","lib/libcrypto/pkcs7/pk7_lib.c","PKCS7_set_type",161,228
6,1,35,3,5,"PKCS7_set0_type_other@231-236@lib/libcrypto/pkcs7/pk7_lib.c","lib/libcrypto/pkcs7/pk7_lib.c","PKCS7_set0_type_other",231,236
48,10,276,2,52,"PKCS7_add_signer@239-291@lib/libcrypto/pkcs7/pk7_lib.c","lib/libcrypto/pkcs7/pk7_lib.c","PKCS7_add_signer",239,291
29,6,154,2,30,"PKCS7_add_certificate@294-324@lib/libcrypto/pkcs7/pk7_lib.c","lib/libcrypto/pkcs7/pk7_lib.c","PKCS7_add_certificate",294,324
29,6,154,2,31,"PKCS7_add_crl@327-358@lib/libcrypto/pkcs7/pk7_lib.c","lib/libcrypto/pkcs7/pk7_lib.c","PKCS7_add_crl",327,358
31,8,195,4,41,"PKCS7_SIGNER_INFO_set@361-402@lib/libcrypto/pkcs7/pk7_lib.c","lib/libcrypto/pkcs7/pk7_lib.c","PKCS7_SIGNER_INFO_set",361,402
25,8,142,4,26,"PKCS7_add_signature@405-431@lib/libcrypto/pkcs7/pk7_lib.c","lib/libcrypto/pkcs7/pk7_lib.c","PKCS7_add_signature",405,431
14,3,94,2,14,"PKCS7_set_digest@434-448@lib/libcrypto/pkcs7/pk7_lib.c","lib/libcrypto/pkcs7/pk7_lib.c","PKCS7_set_digest",434,448
11,5,74,1,10,"PKCS7_get_signer_info@451-461@lib/libcrypto/pkcs7/pk7_lib.c","lib/libcrypto/pkcs7/pk7_lib.c","PKCS7_get_signer_info",451,461
10,4,53,4,9,"PKCS7_SIGNER_INFO_get0_algs@464-473@lib/libcrypto/pkcs7/pk7_lib.c","lib/libcrypto/pkcs7/pk7_lib.c","PKCS7_SIGNER_INFO_get0_algs",464,473
5,2,23,2,4,"PKCS7_RECIP_INFO_get0_alg@476-480@lib/libcrypto/pkcs7/pk7_lib.c","lib/libcrypto/pkcs7/pk7_lib.c","PKCS7_RECIP_INFO_get0_alg",476,480
15,5,74,2,15,"PKCS7_add_recipient@483-498@lib/libcrypto/pkcs7/pk7_lib.c","lib/libcrypto/pkcs7/pk7_lib.c","PKCS7_add_recipient",483,498
20,4,97,2,21,"PKCS7_add_recipient_info@501-522@lib/libcrypto/pkcs7/pk7_lib.c","lib/libcrypto/pkcs7/pk7_lib.c","PKCS7_add_recipient_info",501,522
36,9,208,2,43,"PKCS7_RECIP_INFO_set@525-568@lib/libcrypto/pkcs7/pk7_lib.c","lib/libcrypto/pkcs7/pk7_lib.c","PKCS7_RECIP_INFO_set",525,568
9,2,51,2,8,"PKCS7_cert_from_signer_info@571-579@lib/libcrypto/pkcs7/pk7_lib.c","lib/libcrypto/pkcs7/pk7_lib.c","PKCS7_cert_from_signer_info",571,579
24,4,111,2,27,"PKCS7_set_cipher@582-609@lib/libcrypto/pkcs7/pk7_lib.c","lib/libcrypto/pkcs7/pk7_lib.c","PKCS7_set_cipher",582,609
34,8,183,2,41,"PKCS7_stream@612-653@lib/libcrypto/pkcs7/pk7_lib.c","lib/libcrypto/pkcs7/pk7_lib.c","PKCS7_stream",612,653
5,1,38,4,4,"i2d_PKCS7_bio_stream@64-68@lib/libcrypto/pkcs7/pk7_mime.c","lib/libcrypto/pkcs7/pk7_mime.c","i2d_PKCS7_bio_stream",64,68
5,1,40,4,4,"PEM_write_bio_PKCS7_stream@71-75@lib/libcrypto/pkcs7/pk7_mime.c","lib/libcrypto/pkcs7/pk7_mime.c","PEM_write_bio_PKCS7_stream",71,75
12,2,86,4,14,"SMIME_write_PKCS7@78-92@lib/libcrypto/pkcs7/pk7_mime.c","lib/libcrypto/pkcs7/pk7_mime.c","SMIME_write_PKCS7",78,92
4,1,27,2,3,"SMIME_read_PKCS7@95-98@lib/libcrypto/pkcs7/pk7_mime.c","lib/libcrypto/pkcs7/pk7_mime.c","SMIME_read_PKCS7",95,98
33,12,205,5,41,"PKCS7_sign@70-111@lib/libcrypto/pkcs7/pk7_smime.c","lib/libcrypto/pkcs7/pk7_smime.c","PKCS7_sign",70,111
19,3,99,3,25,"PKCS7_final@114-139@lib/libcrypto/pkcs7/pk7_smime.c","lib/libcrypto/pkcs7/pk7_smime.c","PKCS7_final",114,139
6,2,37,3,5,"add_cipher_smcap@144-149@lib/libcrypto/pkcs7/pk7_smime.c","lib/libcrypto/pkcs7/pk7_smime.c","add_cipher_smcap",144,149
6,2,37,3,5,"add_digest_smcap@152-157@lib/libcrypto/pkcs7/pk7_smime.c","lib/libcrypto/pkcs7/pk7_smime.c","add_digest_smcap",152,157
56,27,378,5,61,"PKCS7_sign_add_signer@160-221@lib/libcrypto/pkcs7/pk7_smime.c","lib/libcrypto/pkcs7/pk7_smime.c","PKCS7_sign_add_signer",160,221
24,6,144,2,27,"pkcs7_copy_existing_digest@228-255@lib/libcrypto/pkcs7/pk7_smime.c","lib/libcrypto/pkcs7/pk7_smime.c","pkcs7_copy_existing_digest",228,255
127,35,736,6,165,"PKCS7_verify@258-423@lib/libcrypto/pkcs7/pk7_smime.c","lib/libcrypto/pkcs7/pk7_smime.c","PKCS7_verify",258,423
48,12,267,3,55,"PKCS7_get0_signers@426-481@lib/libcrypto/pkcs7/pk7_smime.c","lib/libcrypto/pkcs7/pk7_smime.c","PKCS7_get0_signers",426,481
33,8,179,4,38,"PKCS7_encrypt@486-524@lib/libcrypto/pkcs7/pk7_smime.c","lib/libcrypto/pkcs7/pk7_smime.c","PKCS7_encrypt",486,524
57,16,303,5,63,"PKCS7_decrypt@527-590@lib/libcrypto/pkcs7/pk7_smime.c","lib/libcrypto/pkcs7/pk7_smime.c","PKCS7_decrypt",527,590
7,2,36,1,8,"ERR_load_PKCS7_strings@179-187@lib/libcrypto/pkcs7/pkcs7err.c","lib/libcrypto/pkcs7/pkcs7err.c","ERR_load_PKCS7_strings",179,187
7,1,82,1,6,"U8TO32@36-42@lib/libcrypto/poly1305/poly1305-donna.c","lib/libcrypto/poly1305/poly1305-donna.c","U8TO32",36,42
7,1,66,2,6,"U32TO8@46-52@lib/libcrypto/poly1305/poly1305-donna.c","lib/libcrypto/poly1305/poly1305-donna.c","U32TO8",46,52
20,1,259,2,26,"poly1305_init@55-81@lib/libcrypto/poly1305/poly1305-donna.c","lib/libcrypto/poly1305/poly1305-donna.c","poly1305_init",55,81
80,3,781,3,90,"poly1305_blocks@84-174@lib/libcrypto/poly1305/poly1305-donna.c","lib/libcrypto/poly1305/poly1305-donna.c","poly1305_blocks",84,174
30,8,208,3,35,"poly1305_update@177-212@lib/libcrypto/poly1305/poly1305-donna.c","lib/libcrypto/poly1305/poly1305-donna.c","poly1305_update",177,212
91,3,787,2,106,"poly1305_finish@215-321@lib/libcrypto/poly1305/poly1305-donna.c","lib/libcrypto/poly1305/poly1305-donna.c","poly1305_finish",215,321
4,1,23,2,3,"CRYPTO_poly1305_init@22-25@lib/libcrypto/poly1305/poly1305.c","lib/libcrypto/poly1305/poly1305.c","CRYPTO_poly1305_init",22,25
5,1,26,3,4,"CRYPTO_poly1305_update@28-32@lib/libcrypto/poly1305/poly1305.c","lib/libcrypto/poly1305/poly1305.c","CRYPTO_poly1305_update",28,32
4,1,22,2,3,"CRYPTO_poly1305_finish@35-38@lib/libcrypto/poly1305/poly1305.c","lib/libcrypto/poly1305/poly1305.c","CRYPTO_poly1305_finish",35,38
7,2,36,1,8,"ERR_load_RAND_strings@91-99@lib/libcrypto/rand/rand_err.c","lib/libcrypto/rand/rand_err.c","ERR_load_RAND_strings",91,99
4,1,12,1,3,"RAND_set_rand_method@28-31@lib/libcrypto/rand/rand_lib.c","lib/libcrypto/rand/rand_lib.c","RAND_set_rand_method",28,31
4,1,9,1,3,"RAND_get_rand_method@34-37@lib/libcrypto/rand/rand_lib.c","lib/libcrypto/rand/rand_lib.c","RAND_get_rand_method",34,37
4,1,9,1,3,"RAND_SSLeay@40-43@lib/libcrypto/rand/rand_lib.c","lib/libcrypto/rand/rand_lib.c","RAND_SSLeay",40,43
4,1,11,1,3,"RAND_set_rand_engine@47-50@lib/libcrypto/rand/rand_lib.c","lib/libcrypto/rand/rand_lib.c","RAND_set_rand_engine",47,50
3,1,6,1,3,"RAND_cleanup@54-57@lib/libcrypto/rand/rand_lib.c","lib/libcrypto/rand/rand_lib.c","RAND_cleanup",54,57
3,1,12,2,3,"RAND_seed@60-63@lib/libcrypto/rand/rand_lib.c","lib/libcrypto/rand/rand_lib.c","RAND_seed",60,63
3,1,15,3,3,"RAND_add@66-69@lib/libcrypto/rand/rand_lib.c","lib/libcrypto/rand/rand_lib.c","RAND_add",66,69
4,1,9,1,3,"RAND_status@72-75@lib/libcrypto/rand/rand_lib.c","lib/libcrypto/rand/rand_lib.c","RAND_status",72,75
4,1,9,1,3,"RAND_poll@78-81@lib/libcrypto/rand/rand_lib.c","lib/libcrypto/rand/rand_lib.c","RAND_poll",78,81
6,2,28,2,5,"RAND_bytes@87-92@lib/libcrypto/rand/rand_lib.c","lib/libcrypto/rand/rand_lib.c","RAND_bytes",87,92
6,2,28,2,5,"RAND_pseudo_bytes@95-100@lib/libcrypto/rand/rand_lib.c","lib/libcrypto/rand/rand_lib.c","RAND_pseudo_bytes",95,100
7,2,26,2,7,"RAND_load_file@80-87@lib/libcrypto/rand/randfile.c","lib/libcrypto/rand/randfile.c","RAND_load_file",80,87
37,10,214,1,45,"RAND_write_file@90-135@lib/libcrypto/rand/randfile.c","lib/libcrypto/rand/randfile.c","RAND_write_file",90,135
6,2,32,2,5,"RAND_file_name@138-143@lib/libcrypto/rand/randfile.c","lib/libcrypto/rand/randfile.c","RAND_file_name",138,143
72,6,497,6,72,"RC2_cbc_encrypt@62-134@lib/libcrypto/rc2/rc2_cbc.c","lib/libcrypto/rc2/rc2_cbc.c","RC2_cbc_encrypt",62,134
38,5,419,2,43,"RC2_encrypt@136-179@lib/libcrypto/rc2/rc2_cbc.c","lib/libcrypto/rc2/rc2_cbc.c","RC2_encrypt",136,179
39,5,469,2,44,"RC2_decrypt@181-225@lib/libcrypto/rc2/rc2_cbc.c","lib/libcrypto/rc2/rc2_cbc.c","RC2_decrypt",181,225
14,2,120,4,14,"RC2_ecb_encrypt@71-85@lib/libcrypto/rc2/rc2_ecb.c","lib/libcrypto/rc2/rc2_ecb.c","RC2_ecb_encrypt",71,85
34,8,300,4,44,"RC2_set_key@94-138@lib/libcrypto/rc2/rc2_skey.c","lib/libcrypto/rc2/rc2_skey.c","RC2_set_key",94,138
54,6,396,7,54,"RC2_cfb64_encrypt@67-121@lib/libcrypto/rc2/rc2cfb64.c","lib/libcrypto/rc2/rc2cfb64.c","RC2_cfb64_encrypt",67,121
44,4,296,6,44,"RC2_ofb64_encrypt@66-110@lib/libcrypto/rc2/rc2ofb64.c","lib/libcrypto/rc2/rc2ofb64.c","RC2_ofb64_encrypt",66,110
91,21,648,4,181,"RC4@72-253@lib/libcrypto/rc4/rc4_enc.c","lib/libcrypto/rc4/rc4_enc.c","RC4",72,253
11,4,46,1,13,"RC4_options@64-77@lib/libcrypto/rc4/rc4_skey.c","lib/libcrypto/rc4/rc4_skey.c","RC4_options",64,77
19,3,135,3,27,"RC4_set_key@88-115@lib/libcrypto/rc4/rc4_skey.c","lib/libcrypto/rc4/rc4_skey.c","RC4_set_key",88,115
10,1,54,1,9,"RIPEMD160_Init@71-80@lib/libcrypto/ripemd/rmd_dgst.c","lib/libcrypto/ripemd/rmd_dgst.c","RIPEMD160_Init",71,80
182,2,3443,3,203,"ripemd160_block_data_order@86-289@lib/libcrypto/ripemd/rmd_dgst.c","lib/libcrypto/ripemd/rmd_dgst.c","ripemd160_block_data_order",86,289
13,3,85,3,13,"RIPEMD160@64-77@lib/libcrypto/ripemd/rmd_one.c","lib/libcrypto/ripemd/rmd_one.c","RIPEMD160",64,77
13,3,77,2,14,"rsa_pub_encode@73-87@lib/libcrypto/rsa/rsa_ameth.c","lib/libcrypto/rsa/rsa_ameth.c","rsa_pub_encode",73,87
14,3,85,2,14,"rsa_pub_decode@90-104@lib/libcrypto/rsa/rsa_ameth.c","lib/libcrypto/rsa/rsa_ameth.c","rsa_pub_decode",90,104
7,3,64,2,6,"rsa_pub_cmp@107-113@lib/libcrypto/rsa/rsa_ameth.c","lib/libcrypto/rsa/rsa_ameth.c","rsa_pub_cmp",107,113
10,2,57,3,10,"old_rsa_priv_decode@116-126@lib/libcrypto/rsa/rsa_ameth.c","lib/libcrypto/rsa/rsa_ameth.c","old_rsa_priv_decode",116,126
4,1,26,2,3,"old_rsa_priv_encode@129-132@lib/libcrypto/rsa/rsa_ameth.c","lib/libcrypto/rsa/rsa_ameth.c","old_rsa_priv_encode",129,132
16,3,89,2,19,"rsa_priv_encode@135-154@lib/libcrypto/rsa/rsa_ameth.c","lib/libcrypto/rsa/rsa_ameth.c","rsa_priv_encode",135,154
8,2,53,2,8,"rsa_priv_decode@157-165@lib/libcrypto/rsa/rsa_ameth.c","lib/libcrypto/rsa/rsa_ameth.c","rsa_priv_decode",157,165
4,1,19,1,3,"int_rsa_size@168-171@lib/libcrypto/rsa/rsa_ameth.c","lib/libcrypto/rsa/rsa_ameth.c","int_rsa_size",168,171
4,1,21,1,3,"rsa_bits@174-177@lib/libcrypto/rsa/rsa_ameth.c","lib/libcrypto/rsa/rsa_ameth.c","rsa_bits",174,177
4,1,17,1,3,"int_rsa_free@180-183@lib/libcrypto/rsa/rsa_ameth.c","lib/libcrypto/rsa/rsa_ameth.c","int_rsa_free",180,183
8,3,45,2,8,"update_buflen@186-194@lib/libcrypto/rsa/rsa_ameth.c","lib/libcrypto/rsa/rsa_ameth.c","update_buflen",186,194
60,18,443,4,65,"do_rsa_print@197-262@lib/libcrypto/rsa/rsa_ameth.c","lib/libcrypto/rsa/rsa_ameth.c","do_rsa_print",197,262
4,1,36,4,3,"rsa_pub_print@265-268@lib/libcrypto/rsa/rsa_ameth.c","lib/libcrypto/rsa/rsa_ameth.c","rsa_pub_print",265,268
4,1,36,4,3,"rsa_priv_print@271-274@lib/libcrypto/rsa/rsa_ameth.c","lib/libcrypto/rsa/rsa_ameth.c","rsa_priv_print",271,274
24,8,170,2,29,"rsa_pss_decode@277-306@lib/libcrypto/rsa/rsa_ameth.c","lib/libcrypto/rsa/rsa_ameth.c","rsa_pss_decode",277,306
63,29,433,4,71,"rsa_pss_param_print@309-380@lib/libcrypto/rsa/rsa_ameth.c","lib/libcrypto/rsa/rsa_ameth.c","rsa_pss_param_print",309,380
21,8,133,5,20,"rsa_sig_print@383-403@lib/libcrypto/rsa/rsa_ameth.c","lib/libcrypto/rsa/rsa_ameth.c","rsa_sig_print",383,403
23,7,114,4,28,"rsa_pkey_ctrl@406-434@lib/libcrypto/rsa/rsa_ameth.c","lib/libcrypto/rsa/rsa_ameth.c","rsa_pkey_ctrl",406,434
69,18,378,6,92,"rsa_item_verify@441-533@lib/libcrypto/rsa/rsa_ameth.c","lib/libcrypto/rsa/rsa_ameth.c","rsa_item_verify",441,533
80,23,494,6,83,"rsa_item_sign@536-619@lib/libcrypto/rsa/rsa_ameth.c","lib/libcrypto/rsa/rsa_ameth.c","rsa_item_sign",536,619
14,4,80,4,13,"rsa_cb@68-81@lib/libcrypto/rsa/rsa_asn1.c","lib/libcrypto/rsa/rsa_asn1.c","rsa_cb",68,81
5,1,38,3,4,"d2i_RSA_PSS_PARAMS@246-250@lib/libcrypto/rsa/rsa_asn1.c","lib/libcrypto/rsa/rsa_asn1.c","d2i_RSA_PSS_PARAMS",246,250
4,1,28,2,3,"i2d_RSA_PSS_PARAMS@253-256@lib/libcrypto/rsa/rsa_asn1.c","lib/libcrypto/rsa/rsa_asn1.c","i2d_RSA_PSS_PARAMS",253,256
4,1,17,1,3,"RSA_PSS_PARAMS_new@259-262@lib/libcrypto/rsa/rsa_asn1.c","lib/libcrypto/rsa/rsa_asn1.c","RSA_PSS_PARAMS_new",259,262
4,1,20,1,3,"RSA_PSS_PARAMS_free@265-268@lib/libcrypto/rsa/rsa_asn1.c","lib/libcrypto/rsa/rsa_asn1.c","RSA_PSS_PARAMS_free",265,268
5,1,38,3,4,"d2i_RSAPrivateKey@272-276@lib/libcrypto/rsa/rsa_asn1.c","lib/libcrypto/rsa/rsa_asn1.c","d2i_RSAPrivateKey",272,276
4,1,29,2,3,"i2d_RSAPrivateKey@279-282@lib/libcrypto/rsa/rsa_asn1.c","lib/libcrypto/rsa/rsa_asn1.c","i2d_RSAPrivateKey",279,282
5,1,38,3,4,"d2i_RSAPublicKey@286-290@lib/libcrypto/rsa/rsa_asn1.c","lib/libcrypto/rsa/rsa_asn1.c","d2i_RSAPublicKey",286,290
4,1,29,2,3,"i2d_RSAPublicKey@293-296@lib/libcrypto/rsa/rsa_asn1.c","lib/libcrypto/rsa/rsa_asn1.c","i2d_RSAPublicKey",293,296
4,1,17,1,3,"RSAPublicKey_dup@299-302@lib/libcrypto/rsa/rsa_asn1.c","lib/libcrypto/rsa/rsa_asn1.c","RSAPublicKey_dup",299,302
4,1,17,1,3,"RSAPrivateKey_dup@305-308@lib/libcrypto/rsa/rsa_asn1.c","lib/libcrypto/rsa/rsa_asn1.c","RSAPrivateKey_dup",305,308
126,36,767,1,154,"RSA_check_key@58-212@lib/libcrypto/rsa/rsa_chk.c","lib/libcrypto/rsa/rsa_chk.c","RSA_check_key",58,212
4,1,17,1,3,"RSA_size@76-79@lib/libcrypto/rsa/rsa_crpt.c","lib/libcrypto/rsa/rsa_crpt.c","RSA_size",76,79
5,1,43,5,4,"RSA_public_encrypt@82-86@lib/libcrypto/rsa/rsa_crpt.c","lib/libcrypto/rsa/rsa_crpt.c","RSA_public_encrypt",82,86
5,1,43,5,4,"RSA_private_encrypt@89-93@lib/libcrypto/rsa/rsa_crpt.c","lib/libcrypto/rsa/rsa_crpt.c","RSA_private_encrypt",89,93
5,1,43,5,4,"RSA_private_decrypt@96-100@lib/libcrypto/rsa/rsa_crpt.c","lib/libcrypto/rsa/rsa_crpt.c","RSA_private_decrypt",96,100
5,1,43,5,4,"RSA_public_decrypt@103-107@lib/libcrypto/rsa/rsa_crpt.c","lib/libcrypto/rsa/rsa_crpt.c","RSA_public_decrypt",103,107
4,2,22,1,3,"RSA_flags@110-113@lib/libcrypto/rsa/rsa_crpt.c","lib/libcrypto/rsa/rsa_crpt.c","RSA_flags",110,113
6,1,27,1,5,"RSA_blinding_off@116-121@lib/libcrypto/rsa/rsa_crpt.c","lib/libcrypto/rsa/rsa_crpt.c","RSA_blinding_off",116,121
13,3,69,2,15,"RSA_blinding_on@124-139@lib/libcrypto/rsa/rsa_crpt.c","lib/libcrypto/rsa/rsa_crpt.c","RSA_blinding_on",124,139
24,10,182,4,27,"rsa_get_public_exp@142-169@lib/libcrypto/rsa/rsa_crpt.c","lib/libcrypto/rsa/rsa_crpt.c","rsa_get_public_exp",142,169
37,8,214,2,43,"RSA_setup_blinding@172-215@lib/libcrypto/rsa/rsa_crpt.c","lib/libcrypto/rsa/rsa_crpt.c","RSA_setup_blinding",172,215
24,7,160,4,30,"RSA_generate_key@70-100@lib/libcrypto/rsa/rsa_depr.c","lib/libcrypto/rsa/rsa_depr.c","RSA_generate_key",70,100
4,1,10,1,3,"RSA_PKCS1_SSLeay@148-151@lib/libcrypto/rsa/rsa_eay.c","lib/libcrypto/rsa/rsa_eay.c","RSA_PKCS1_SSLeay",148,151
74,20,481,5,92,"RSA_eay_public_encrypt@154-246@lib/libcrypto/rsa/rsa_eay.c","lib/libcrypto/rsa/rsa_eay.c","RSA_eay_public_encrypt",154,246
39,9,202,3,54,"rsa_get_blinding@249-303@lib/libcrypto/rsa/rsa_eay.c","lib/libcrypto/rsa/rsa_eay.c","rsa_get_blinding",249,303
12,2,70,4,19,"rsa_blinding_convert@306-325@lib/libcrypto/rsa/rsa_eay.c","lib/libcrypto/rsa/rsa_eay.c","rsa_blinding_convert",306,325
4,1,32,4,11,"rsa_blinding_invert@328-339@lib/libcrypto/rsa/rsa_eay.c","lib/libcrypto/rsa/rsa_eay.c","rsa_blinding_invert",328,339
100,32,663,5,123,"RSA_eay_private_encrypt@343-466@lib/libcrypto/rsa/rsa_eay.c","lib/libcrypto/rsa/rsa_eay.c","RSA_eay_private_encrypt",343,466
94,30,608,5,120,"RSA_eay_private_decrypt@469-589@lib/libcrypto/rsa/rsa_eay.c","lib/libcrypto/rsa/rsa_eay.c","RSA_eay_private_decrypt",469,589
79,23,498,5,96,"RSA_eay_public_decrypt@593-689@lib/libcrypto/rsa/rsa_eay.c","lib/libcrypto/rsa/rsa_eay.c","RSA_eay_public_decrypt",593,689
93,31,709,4,146,"RSA_eay_mod_exp@692-838@lib/libcrypto/rsa/rsa_eay.c","lib/libcrypto/rsa/rsa_eay.c","RSA_eay_mod_exp",692,838
5,1,19,1,4,"RSA_eay_init@841-845@lib/libcrypto/rsa/rsa_eay.c","lib/libcrypto/rsa/rsa_eay.c","RSA_eay_init",841,845
7,1,32,1,7,"RSA_eay_finish@848-855@lib/libcrypto/rsa/rsa_eay.c","lib/libcrypto/rsa/rsa_eay.c","RSA_eay_finish",848,855
7,2,36,1,8,"ERR_load_RSA_strings@145-153@lib/libcrypto/rsa/rsa_err.c","lib/libcrypto/rsa/rsa_err.c","ERR_load_RSA_strings",145,153
6,2,55,4,5,"RSA_generate_key_ex@84-89@lib/libcrypto/rsa/rsa_gen.c","lib/libcrypto/rsa/rsa_gen.c","RSA_generate_key_ex",84,89
111,42,915,4,138,"rsa_builtin_keygen@92-230@lib/libcrypto/rsa/rsa_gen.c","lib/libcrypto/rsa/rsa_gen.c","rsa_builtin_keygen",92,230
5,1,18,1,5,"RSA_new@76-81@lib/libcrypto/rsa/rsa_lib.c","lib/libcrypto/rsa/rsa_lib.c","RSA_new",76,81
4,1,13,1,3,"RSA_set_default_method@84-87@lib/libcrypto/rsa/rsa_lib.c","lib/libcrypto/rsa/rsa_lib.c","RSA_set_default_method",84,87
6,2,21,1,6,"RSA_get_default_method@90-96@lib/libcrypto/rsa/rsa_lib.c","lib/libcrypto/rsa/rsa_lib.c","RSA_get_default_method",90,96
4,1,14,1,3,"RSA_get_method@99-102@lib/libcrypto/rsa/rsa_lib.c","lib/libcrypto/rsa/rsa_lib.c","RSA_get_method",99,102
15,4,80,2,21,"RSA_set_method@105-126@lib/libcrypto/rsa/rsa_lib.c","lib/libcrypto/rsa/rsa_lib.c","RSA_set_method",105,126
59,11,343,1,68,"RSA_new_method@129-197@lib/libcrypto/rsa/rsa_lib.c","lib/libcrypto/rsa/rsa_lib.c","RSA_new_method",129,197
25,5,159,1,31,"RSA_free@200-231@lib/libcrypto/rsa/rsa_lib.c","lib/libcrypto/rsa/rsa_lib.c","RSA_free",200,231
5,2,32,1,4,"RSA_up_ref@234-238@lib/libcrypto/rsa/rsa_lib.c","lib/libcrypto/rsa/rsa_lib.c","RSA_up_ref",234,238
6,1,39,5,5,"RSA_get_ex_new_index@241-246@lib/libcrypto/rsa/rsa_lib.c","lib/libcrypto/rsa/rsa_lib.c","RSA_get_ex_new_index",241,246
4,1,28,3,3,"RSA_set_ex_data@249-252@lib/libcrypto/rsa/rsa_lib.c","lib/libcrypto/rsa/rsa_lib.c","RSA_set_ex_data",249,252
4,1,23,2,3,"RSA_get_ex_data@255-258@lib/libcrypto/rsa/rsa_lib.c","lib/libcrypto/rsa/rsa_lib.c","RSA_get_ex_data",255,258
14,3,65,4,15,"RSA_padding_add_none@67-82@lib/libcrypto/rsa/rsa_none.c","lib/libcrypto/rsa/rsa_none.c","RSA_padding_add_none",67,82
11,2,68,5,11,"RSA_padding_check_none@85-96@lib/libcrypto/rsa/rsa_none.c","lib/libcrypto/rsa/rsa_none.c","RSA_padding_check_none",85,96
42,9,322,6,49,"RSA_padding_add_PKCS1_OAEP@39-88@lib/libcrypto/rsa/rsa_oaep.c","lib/libcrypto/rsa/rsa_oaep.c","RSA_padding_add_PKCS1_OAEP",39,88
63,16,418,7,93,"RSA_padding_check_PKCS1_OAEP@91-184@lib/libcrypto/rsa/rsa_oaep.c","lib/libcrypto/rsa/rsa_oaep.c","RSA_padding_check_PKCS1_OAEP",91,184
38,9,292,5,38,"PKCS1_MGF1@187-225@lib/libcrypto/rsa/rsa_oaep.c","lib/libcrypto/rsa/rsa_oaep.c","PKCS1_MGF1",187,225
4,1,37,4,3,"MGF1@228-231@lib/libcrypto/rsa/rsa_oaep.c","lib/libcrypto/rsa/rsa_oaep.c","MGF1",228,231
19,2,115,4,24,"RSA_padding_add_PKCS1_type_1@68-92@lib/libcrypto/rsa/rsa_pk1.c","lib/libcrypto/rsa/rsa_pk1.c","RSA_padding_add_PKCS1_type_1",68,92
40,9,195,5,46,"RSA_padding_check_PKCS1_type_1@95-141@lib/libcrypto/rsa/rsa_pk1.c","lib/libcrypto/rsa/rsa_pk1.c","RSA_padding_check_PKCS1_type_1",95,141
23,4,141,4,30,"RSA_padding_add_PKCS1_type_2@144-174@lib/libcrypto/rsa/rsa_pk1.c","lib/libcrypto/rsa/rsa_pk1.c","RSA_padding_add_PKCS1_type_2",144,174
31,8,167,5,36,"RSA_padding_check_PKCS1_type_2@177-213@lib/libcrypto/rsa/rsa_pk1.c","lib/libcrypto/rsa/rsa_pk1.c","RSA_padding_check_PKCS1_type_2",177,213
18,2,96,1,21,"pkey_rsa_init@97-118@lib/libcrypto/rsa/rsa_pmeth.c","lib/libcrypto/rsa/rsa_pmeth.c","pkey_rsa_init",97,118
17,4,98,2,17,"pkey_rsa_copy@121-138@lib/libcrypto/rsa/rsa_pmeth.c","lib/libcrypto/rsa/rsa_pmeth.c","pkey_rsa_copy",121,138
9,3,48,2,8,"setup_tbuf@141-149@lib/libcrypto/rsa/rsa_pmeth.c","lib/libcrypto/rsa/rsa_pmeth.c","setup_tbuf",141,149
9,2,41,1,9,"pkey_rsa_cleanup@152-161@lib/libcrypto/rsa/rsa_pmeth.c","lib/libcrypto/rsa/rsa_pmeth.c","pkey_rsa_cleanup",152,161
44,11,325,5,46,"pkey_rsa_sign@164-210@lib/libcrypto/rsa/rsa_pmeth.c","lib/libcrypto/rsa/rsa_pmeth.c","pkey_rsa_sign",164,210
42,11,275,5,43,"pkey_rsa_verifyrecover@213-256@lib/libcrypto/rsa/rsa_pmeth.c","lib/libcrypto/rsa/rsa_pmeth.c","pkey_rsa_verifyrecover",213,256
41,13,281,5,44,"pkey_rsa_verify@259-303@lib/libcrypto/rsa/rsa_pmeth.c","lib/libcrypto/rsa/rsa_pmeth.c","pkey_rsa_verify",259,303
12,2,77,5,12,"pkey_rsa_encrypt@306-318@lib/libcrypto/rsa/rsa_pmeth.c","lib/libcrypto/rsa/rsa_pmeth.c","pkey_rsa_encrypt",306,318
12,2,77,5,12,"pkey_rsa_decrypt@321-333@lib/libcrypto/rsa/rsa_pmeth.c","lib/libcrypto/rsa/rsa_pmeth.c","pkey_rsa_decrypt",321,333
17,5,73,2,19,"check_padding_md@336-355@lib/libcrypto/rsa/rsa_pmeth.c","lib/libcrypto/rsa/rsa_pmeth.c","check_padding_md",336,355
87,33,426,4,95,"pkey_rsa_ctrl@358-453@lib/libcrypto/rsa/rsa_pmeth.c","lib/libcrypto/rsa/rsa_pmeth.c","pkey_rsa_ctrl",358,453
68,28,412,3,75,"pkey_rsa_ctrl_str@456-531@lib/libcrypto/rsa/rsa_pmeth.c","lib/libcrypto/rsa/rsa_pmeth.c","pkey_rsa_ctrl_str",456,531
26,7,150,2,26,"pkey_rsa_keygen@534-560@lib/libcrypto/rsa/rsa_pmeth.c","lib/libcrypto/rsa/rsa_pmeth.c","pkey_rsa_keygen",534,560
13,2,76,3,13,"RSA_print_fp@66-79@lib/libcrypto/rsa/rsa_prn.c","lib/libcrypto/rsa/rsa_prn.c","RSA_print_fp",66,79
11,3,70,3,11,"RSA_print@82-93@lib/libcrypto/rsa/rsa_prn.c","lib/libcrypto/rsa/rsa_prn.c","RSA_print",82,93
5,1,44,5,4,"RSA_verify_PKCS1_PSS@72-76@lib/libcrypto/rsa/rsa_pss.c","lib/libcrypto/rsa/rsa_pss.c","RSA_verify_PKCS1_PSS",72,76
86,26,542,6,98,"RSA_verify_PKCS1_PSS_mgf1@79-177@lib/libcrypto/rsa/rsa_pss.c","lib/libcrypto/rsa/rsa_pss.c","RSA_verify_PKCS1_PSS_mgf1",79,177
5,1,43,5,4,"RSA_padding_add_PKCS1_PSS@180-184@lib/libcrypto/rsa/rsa_pss.c","lib/libcrypto/rsa/rsa_pss.c","RSA_padding_add_PKCS1_PSS",180,184
71,21,455,6,94,"RSA_padding_add_PKCS1_PSS_mgf1@187-281@lib/libcrypto/rsa/rsa_pss.c","lib/libcrypto/rsa/rsa_pss.c","RSA_padding_add_PKCS1_PSS_mgf1",187,281
30,4,196,6,32,"RSA_sign_ASN1_OCTET_STRING@69-101@lib/libcrypto/rsa/rsa_saos.c","lib/libcrypto/rsa/rsa_saos.c","RSA_sign_ASN1_OCTET_STRING",69,101
33,7,213,6,37,"RSA_verify_ASN1_OCTET_STRING@104-141@lib/libcrypto/rsa/rsa_saos.c","lib/libcrypto/rsa/rsa_saos.c","RSA_verify_ASN1_OCTET_STRING",104,141
62,12,392,6,67,"RSA_sign@74-141@lib/libcrypto/rsa/rsa_sign.c","lib/libcrypto/rsa/rsa_sign.c","RSA_sign",74,141
77,22,477,8,92,"int_rsa_verify@144-236@lib/libcrypto/rsa/rsa_sign.c","lib/libcrypto/rsa/rsa_sign.c","int_rsa_verify",144,236
8,3,87,6,8,"RSA_verify@239-247@lib/libcrypto/rsa/rsa_sign.c","lib/libcrypto/rsa/rsa_sign.c","RSA_verify",239,247
26,4,136,4,34,"RSA_padding_add_X931@68-102@lib/libcrypto/rsa/rsa_x931.c","lib/libcrypto/rsa/rsa_x931.c","RSA_padding_add_X931",68,102
34,11,196,5,40,"RSA_padding_check_X931@105-145@lib/libcrypto/rsa/rsa_x931.c","lib/libcrypto/rsa/rsa_x931.c","RSA_padding_check_X931",105,145
14,5,41,1,14,"RSA_X931_hash_id@150-164@lib/libcrypto/rsa/rsa_x931.c","lib/libcrypto/rsa/rsa_x931.c","RSA_X931_hash_id",150,164
12,3,85,3,12,"SHA1@68-80@lib/libcrypto/sha/sha1_one.c","lib/libcrypto/sha/sha1_one.c","SHA1",68,80
10,1,102,1,9,"SHA224_Init@21-30@lib/libcrypto/sha/sha256.c","lib/libcrypto/sha/sha256.c","SHA224_Init",21,30
10,1,102,1,9,"SHA256_Init@32-41@lib/libcrypto/sha/sha256.c","lib/libcrypto/sha/sha256.c","SHA256_Init",32,41
11,2,79,3,11,"SHA224@43-54@lib/libcrypto/sha/sha256.c","lib/libcrypto/sha/sha256.c","SHA224",43,54
11,2,79,3,11,"SHA256@56-67@lib/libcrypto/sha/sha256.c","lib/libcrypto/sha/sha256.c","SHA256",56,67
2,1,26,3,1,"SHA224_Update@69-70@lib/libcrypto/sha/sha256.c","lib/libcrypto/sha/sha256.c","SHA224_Update",69,70
2,1,21,2,1,"SHA224_Final@71-72@lib/libcrypto/sha/sha256.c","lib/libcrypto/sha/sha256.c","SHA224_Final",71,72
31,4,469,3,37,"sha256_block_data_order@153-190@lib/libcrypto/sha/sha256.c","lib/libcrypto/sha/sha256.c","sha256_block_data_order",153,190
66,6,1592,3,74,"sha256_block_data_order@205-279@lib/libcrypto/sha/sha256.c","lib/libcrypto/sha/sha256.c","sha256_block_data_order",205,279
14,1,131,1,14,"SHA384_Init@60-74@lib/libcrypto/sha/sha512.c","lib/libcrypto/sha/sha512.c","SHA384_Init",60,74
14,1,131,1,14,"SHA512_Init@76-90@lib/libcrypto/sha/sha512.c","lib/libcrypto/sha/sha512.c","SHA512_Init",76,90
64,8,900,2,76,"SHA512_Final@97-173@lib/libcrypto/sha/sha512.c","lib/libcrypto/sha/sha512.c","SHA512_Final",97,173
2,1,21,2,1,"SHA384_Final@175-176@lib/libcrypto/sha/sha512.c","lib/libcrypto/sha/sha512.c","SHA384_Final",175,176
41,10,367,3,49,"SHA512_Update@178-227@lib/libcrypto/sha/sha512.c","lib/libcrypto/sha/sha512.c","SHA512_Update",178,227
2,1,26,3,1,"SHA384_Update@229-230@lib/libcrypto/sha/sha512.c","lib/libcrypto/sha/sha512.c","SHA384_Update",229,230
7,2,72,2,8,"SHA512_Transform@232-240@lib/libcrypto/sha/sha512.c","lib/libcrypto/sha/sha512.c","SHA512_Transform",232,240
11,2,79,3,11,"SHA384@242-253@lib/libcrypto/sha/sha512.c","lib/libcrypto/sha/sha512.c","SHA384",242,253
11,2,79,3,11,"SHA512@255-266@lib/libcrypto/sha/sha512.c","lib/libcrypto/sha/sha512.c","SHA512",255,266
41,4,502,3,47,"sha512_block_data_order@360-407@lib/libcrypto/sha/sha512.c","lib/libcrypto/sha/sha512.c","sha512_block_data_order",360,407
33,5,480,3,42,"sha512_block_data_order@411-453@lib/libcrypto/sha/sha512.c","lib/libcrypto/sha/sha512.c","sha512_block_data_order",411,453
65,4,1730,3,73,"sha512_block_data_order@468-541@lib/libcrypto/sha/sha512.c","lib/libcrypto/sha/sha512.c","sha512_block_data_order",468,541
10,1,54,1,9,"SHA1_Init@106-115@lib/libcrypto/sha/sha_locl.h","lib/libcrypto/sha/sha_locl.h","SHA1_Init",106,115
134,6,3807,3,150,"HASH_BLOCK_DATA_ORDER@190-340@lib/libcrypto/sha/sha_locl.h","lib/libcrypto/sha/sha_locl.h","HASH_BLOCK_DATA_ORDER",190,340
36,8,451,3,41,"HASH_BLOCK_DATA_ORDER@375-416@lib/libcrypto/sha/sha_locl.h","lib/libcrypto/sha/sha_locl.h","HASH_BLOCK_DATA_ORDER",375,416
9,2,53,2,10,"int( * sk_set_cmp_func(_STACK*sk,int(*c)(constvoid*,constvoid*)))@71-81@lib/libcrypto/stack/stack.c","lib/libcrypto/stack/stack.c","int( * sk_set_cmp_func(_STACK*sk,int(*c)(constvoid*,constvoid*)))",71,81
21,4,142,1,23,"sk_dup@84-107@lib/libcrypto/stack/stack.c","lib/libcrypto/stack/stack.c","sk_dup",84,107
4,1,27,1,3,"sk_new_null@110-113@lib/libcrypto/stack/stack.c","lib/libcrypto/stack/stack.c","sk_new_null",110,113
19,4,134,1,20,"sk_new@116-136@lib/libcrypto/stack/stack.c","lib/libcrypto/stack/stack.c","sk_new",116,136
23,6,185,3,23,"sk_insert@139-162@lib/libcrypto/stack/stack.c","lib/libcrypto/stack/stack.c","sk_insert",139,162
8,3,56,2,8,"sk_delete_ptr@165-173@lib/libcrypto/stack/stack.c","lib/libcrypto/stack/stack.c","sk_delete_ptr",165,173
13,5,109,2,14,"sk_delete@176-190@lib/libcrypto/stack/stack.c","lib/libcrypto/stack/stack.c","sk_delete",176,190
21,7,155,3,22,"internal_find@193-215@lib/libcrypto/stack/stack.c","lib/libcrypto/stack/stack.c","internal_find",193,215
4,1,22,2,3,"sk_find@218-221@lib/libcrypto/stack/stack.c","lib/libcrypto/stack/stack.c","sk_find",218,221
4,1,22,2,3,"sk_find_ex@224-227@lib/libcrypto/stack/stack.c","lib/libcrypto/stack/stack.c","sk_find_ex",224,227
4,1,26,2,3,"sk_push@230-233@lib/libcrypto/stack/stack.c","lib/libcrypto/stack/stack.c","sk_push",230,233
4,1,24,2,3,"sk_unshift@236-239@lib/libcrypto/stack/stack.c","lib/libcrypto/stack/stack.c","sk_unshift",236,239
8,3,42,1,7,"sk_shift@242-249@lib/libcrypto/stack/stack.c","lib/libcrypto/stack/stack.c","sk_shift",242,249
8,3,46,1,7,"sk_pop@252-259@lib/libcrypto/stack/stack.c","lib/libcrypto/stack/stack.c","sk_pop",252,259
9,3,52,1,8,"sk_zero@262-270@lib/libcrypto/stack/stack.c","lib/libcrypto/stack/stack.c","sk_zero",262,270
10,4,70,2,10,"sk_pop_free@273-283@lib/libcrypto/stack/stack.c","lib/libcrypto/stack/stack.c","sk_pop_free",273,283
7,2,28,1,6,"sk_free@286-292@lib/libcrypto/stack/stack.c","lib/libcrypto/stack/stack.c","sk_free",286,292
6,2,24,1,5,"sk_num@295-300@lib/libcrypto/stack/stack.c","lib/libcrypto/stack/stack.c","sk_num",295,300
6,4,42,2,5,"sk_value@303-308@lib/libcrypto/stack/stack.c","lib/libcrypto/stack/stack.c","sk_value",303,308
6,4,49,3,5,"sk_set@311-316@lib/libcrypto/stack/stack.c","lib/libcrypto/stack/stack.c","sk_set",311,316
9,3,82,1,14,"sk_sort@319-333@lib/libcrypto/stack/stack.c","lib/libcrypto/stack/stack.c","sk_sort",319,333
6,2,22,1,5,"sk_is_sorted@336-341@lib/libcrypto/stack/stack.c","lib/libcrypto/stack/stack.c","sk_is_sorted",336,341
5,1,38,3,4,"d2i_TS_MSG_IMPRINT@93-97@lib/libcrypto/ts/ts_asn1.c","lib/libcrypto/ts/ts_asn1.c","d2i_TS_MSG_IMPRINT",93,97
4,1,29,2,3,"i2d_TS_MSG_IMPRINT@100-103@lib/libcrypto/ts/ts_asn1.c","lib/libcrypto/ts/ts_asn1.c","i2d_TS_MSG_IMPRINT",100,103
4,1,17,1,3,"TS_MSG_IMPRINT_new@106-109@lib/libcrypto/ts/ts_asn1.c","lib/libcrypto/ts/ts_asn1.c","TS_MSG_IMPRINT_new",106,109
4,1,20,1,3,"TS_MSG_IMPRINT_free@112-115@lib/libcrypto/ts/ts_asn1.c","lib/libcrypto/ts/ts_asn1.c","TS_MSG_IMPRINT_free",112,115
4,1,17,1,3,"TS_MSG_IMPRINT_dup@118-121@lib/libcrypto/ts/ts_asn1.c","lib/libcrypto/ts/ts_asn1.c","TS_MSG_IMPRINT_dup",118,121
4,1,23,2,3,"d2i_TS_MSG_IMPRINT_bio@125-128@lib/libcrypto/ts/ts_asn1.c","lib/libcrypto/ts/ts_asn1.c","d2i_TS_MSG_IMPRINT_bio",125,128
4,1,23,2,3,"i2d_TS_MSG_IMPRINT_bio@131-134@lib/libcrypto/ts/ts_asn1.c","lib/libcrypto/ts/ts_asn1.c","i2d_TS_MSG_IMPRINT_bio",131,134
4,1,23,2,3,"d2i_TS_MSG_IMPRINT_fp@138-141@lib/libcrypto/ts/ts_asn1.c","lib/libcrypto/ts/ts_asn1.c","d2i_TS_MSG_IMPRINT_fp",138,141
4,1,23,2,3,"i2d_TS_MSG_IMPRINT_fp@144-147@lib/libcrypto/ts/ts_asn1.c","lib/libcrypto/ts/ts_asn1.c","i2d_TS_MSG_IMPRINT_fp",144,147
5,1,38,3,4,"d2i_TS_REQ@206-210@lib/libcrypto/ts/ts_asn1.c","lib/libcrypto/ts/ts_asn1.c","d2i_TS_REQ",206,210
4,1,29,2,3,"i2d_TS_REQ@213-216@lib/libcrypto/ts/ts_asn1.c","lib/libcrypto/ts/ts_asn1.c","i2d_TS_REQ",213,216
4,1,17,1,3,"TS_REQ_new@219-222@lib/libcrypto/ts/ts_asn1.c","lib/libcrypto/ts/ts_asn1.c","TS_REQ_new",219,222
4,1,20,1,3,"TS_REQ_free@225-228@lib/libcrypto/ts/ts_asn1.c","lib/libcrypto/ts/ts_asn1.c","TS_REQ_free",225,228
4,1,17,1,3,"TS_REQ_dup@231-234@lib/libcrypto/ts/ts_asn1.c","lib/libcrypto/ts/ts_asn1.c","TS_REQ_dup",231,234
4,1,23,2,3,"d2i_TS_REQ_bio@238-241@lib/libcrypto/ts/ts_asn1.c","lib/libcrypto/ts/ts_asn1.c","d2i_TS_REQ_bio",238,241
4,1,23,2,3,"i2d_TS_REQ_bio@244-247@lib/libcrypto/ts/ts_asn1.c","lib/libcrypto/ts/ts_asn1.c","i2d_TS_REQ_bio",244,247
4,1,23,2,3,"d2i_TS_REQ_fp@251-254@lib/libcrypto/ts/ts_asn1.c","lib/libcrypto/ts/ts_asn1.c","d2i_TS_REQ_fp",251,254
4,1,23,2,3,"i2d_TS_REQ_fp@257-260@lib/libcrypto/ts/ts_asn1.c","lib/libcrypto/ts/ts_asn1.c","i2d_TS_REQ_fp",257,260
5,1,38,3,4,"d2i_TS_ACCURACY@298-302@lib/libcrypto/ts/ts_asn1.c","lib/libcrypto/ts/ts_asn1.c","d2i_TS_ACCURACY",298,302
4,1,29,2,3,"i2d_TS_ACCURACY@305-308@lib/libcrypto/ts/ts_asn1.c","lib/libcrypto/ts/ts_asn1.c","i2d_TS_ACCURACY",305,308
4,1,17,1,3,"TS_ACCURACY_new@311-314@lib/libcrypto/ts/ts_asn1.c","lib/libcrypto/ts/ts_asn1.c","TS_ACCURACY_new",311,314
4,1,20,1,3,"TS_ACCURACY_free@317-320@lib/libcrypto/ts/ts_asn1.c","lib/libcrypto/ts/ts_asn1.c","TS_ACCURACY_free",317,320
4,1,17,1,3,"TS_ACCURACY_dup@323-326@lib/libcrypto/ts/ts_asn1.c","lib/libcrypto/ts/ts_asn1.c","TS_ACCURACY_dup",323,326
5,1,38,3,4,"d2i_TS_TST_INFO@413-417@lib/libcrypto/ts/ts_asn1.c","lib/libcrypto/ts/ts_asn1.c","d2i_TS_TST_INFO",413,417
4,1,29,2,3,"i2d_TS_TST_INFO@420-423@lib/libcrypto/ts/ts_asn1.c","lib/libcrypto/ts/ts_asn1.c","i2d_TS_TST_INFO",420,423
4,1,17,1,3,"TS_TST_INFO_new@426-429@lib/libcrypto/ts/ts_asn1.c","lib/libcrypto/ts/ts_asn1.c","TS_TST_INFO_new",426,429
4,1,20,1,3,"TS_TST_INFO_free@432-435@lib/libcrypto/ts/ts_asn1.c","lib/libcrypto/ts/ts_asn1.c","TS_TST_INFO_free",432,435
4,1,17,1,3,"TS_TST_INFO_dup@438-441@lib/libcrypto/ts/ts_asn1.c","lib/libcrypto/ts/ts_asn1.c","TS_TST_INFO_dup",438,441
4,1,23,2,3,"d2i_TS_TST_INFO_bio@445-448@lib/libcrypto/ts/ts_asn1.c","lib/libcrypto/ts/ts_asn1.c","d2i_TS_TST_INFO_bio",445,448
4,1,23,2,3,"i2d_TS_TST_INFO_bio@451-454@lib/libcrypto/ts/ts_asn1.c","lib/libcrypto/ts/ts_asn1.c","i2d_TS_TST_INFO_bio",451,454
4,1,23,2,3,"d2i_TS_TST_INFO_fp@458-461@lib/libcrypto/ts/ts_asn1.c","lib/libcrypto/ts/ts_asn1.c","d2i_TS_TST_INFO_fp",458,461
4,1,23,2,3,"i2d_TS_TST_INFO_fp@464-467@lib/libcrypto/ts/ts_asn1.c","lib/libcrypto/ts/ts_asn1.c","i2d_TS_TST_INFO_fp",464,467
5,1,38,3,4,"d2i_TS_STATUS_INFO@505-509@lib/libcrypto/ts/ts_asn1.c","lib/libcrypto/ts/ts_asn1.c","d2i_TS_STATUS_INFO",505,509
4,1,29,2,3,"i2d_TS_STATUS_INFO@512-515@lib/libcrypto/ts/ts_asn1.c","lib/libcrypto/ts/ts_asn1.c","i2d_TS_STATUS_INFO",512,515
4,1,17,1,3,"TS_STATUS_INFO_new@518-521@lib/libcrypto/ts/ts_asn1.c","lib/libcrypto/ts/ts_asn1.c","TS_STATUS_INFO_new",518,521
4,1,20,1,3,"TS_STATUS_INFO_free@524-527@lib/libcrypto/ts/ts_asn1.c","lib/libcrypto/ts/ts_asn1.c","TS_STATUS_INFO_free",524,527
4,1,17,1,3,"TS_STATUS_INFO_dup@530-533@lib/libcrypto/ts/ts_asn1.c","lib/libcrypto/ts/ts_asn1.c","TS_STATUS_INFO_dup",530,533
22,8,117,1,24,"ts_resp_set_tst_info@536-560@lib/libcrypto/ts/ts_asn1.c","lib/libcrypto/ts/ts_asn1.c","ts_resp_set_tst_info",536,560
14,6,93,4,14,"ts_resp_cb@563-577@lib/libcrypto/ts/ts_asn1.c","lib/libcrypto/ts/ts_asn1.c","ts_resp_cb",563,577
5,1,38,3,4,"d2i_TS_RESP@616-620@lib/libcrypto/ts/ts_asn1.c","lib/libcrypto/ts/ts_asn1.c","d2i_TS_RESP",616,620
4,1,29,2,3,"i2d_TS_RESP@623-626@lib/libcrypto/ts/ts_asn1.c","lib/libcrypto/ts/ts_asn1.c","i2d_TS_RESP",623,626
4,1,17,1,3,"TS_RESP_new@629-632@lib/libcrypto/ts/ts_asn1.c","lib/libcrypto/ts/ts_asn1.c","TS_RESP_new",629,632
4,1,20,1,3,"TS_RESP_free@635-638@lib/libcrypto/ts/ts_asn1.c","lib/libcrypto/ts/ts_asn1.c","TS_RESP_free",635,638
4,1,17,1,3,"TS_RESP_dup@641-644@lib/libcrypto/ts/ts_asn1.c","lib/libcrypto/ts/ts_asn1.c","TS_RESP_dup",641,644
4,1,23,2,3,"d2i_TS_RESP_bio@648-651@lib/libcrypto/ts/ts_asn1.c","lib/libcrypto/ts/ts_asn1.c","d2i_TS_RESP_bio",648,651
4,1,23,2,3,"i2d_TS_RESP_bio@654-657@lib/libcrypto/ts/ts_asn1.c","lib/libcrypto/ts/ts_asn1.c","i2d_TS_RESP_bio",654,657
4,1,23,2,3,"d2i_TS_RESP_fp@661-664@lib/libcrypto/ts/ts_asn1.c","lib/libcrypto/ts/ts_asn1.c","d2i_TS_RESP_fp",661,664
4,1,23,2,3,"i2d_TS_RESP_fp@667-670@lib/libcrypto/ts/ts_asn1.c","lib/libcrypto/ts/ts_asn1.c","i2d_TS_RESP_fp",667,670
5,1,38,3,4,"d2i_ESS_ISSUER_SERIAL@701-705@lib/libcrypto/ts/ts_asn1.c","lib/libcrypto/ts/ts_asn1.c","d2i_ESS_ISSUER_SERIAL",701,705
4,1,29,2,3,"i2d_ESS_ISSUER_SERIAL@708-711@lib/libcrypto/ts/ts_asn1.c","lib/libcrypto/ts/ts_asn1.c","i2d_ESS_ISSUER_SERIAL",708,711
4,1,17,1,3,"ESS_ISSUER_SERIAL_new@714-717@lib/libcrypto/ts/ts_asn1.c","lib/libcrypto/ts/ts_asn1.c","ESS_ISSUER_SERIAL_new",714,717
4,1,20,1,3,"ESS_ISSUER_SERIAL_free@720-723@lib/libcrypto/ts/ts_asn1.c","lib/libcrypto/ts/ts_asn1.c","ESS_ISSUER_SERIAL_free",720,723
4,1,17,1,3,"ESS_ISSUER_SERIAL_dup@726-729@lib/libcrypto/ts/ts_asn1.c","lib/libcrypto/ts/ts_asn1.c","ESS_ISSUER_SERIAL_dup",726,729
5,1,38,3,4,"d2i_ESS_CERT_ID@760-764@lib/libcrypto/ts/ts_asn1.c","lib/libcrypto/ts/ts_asn1.c","d2i_ESS_CERT_ID",760,764
4,1,29,2,3,"i2d_ESS_CERT_ID@767-770@lib/libcrypto/ts/ts_asn1.c","lib/libcrypto/ts/ts_asn1.c","i2d_ESS_CERT_ID",767,770
4,1,17,1,3,"ESS_CERT_ID_new@773-776@lib/libcrypto/ts/ts_asn1.c","lib/libcrypto/ts/ts_asn1.c","ESS_CERT_ID_new",773,776
4,1,20,1,3,"ESS_CERT_ID_free@779-782@lib/libcrypto/ts/ts_asn1.c","lib/libcrypto/ts/ts_asn1.c","ESS_CERT_ID_free",779,782
4,1,17,1,3,"ESS_CERT_ID_dup@785-788@lib/libcrypto/ts/ts_asn1.c","lib/libcrypto/ts/ts_asn1.c","ESS_CERT_ID_dup",785,788
5,1,38,3,4,"d2i_ESS_SIGNING_CERT@819-823@lib/libcrypto/ts/ts_asn1.c","lib/libcrypto/ts/ts_asn1.c","d2i_ESS_SIGNING_CERT",819,823
4,1,29,2,3,"i2d_ESS_SIGNING_CERT@826-829@lib/libcrypto/ts/ts_asn1.c","lib/libcrypto/ts/ts_asn1.c","i2d_ESS_SIGNING_CERT",826,829
4,1,17,1,3,"ESS_SIGNING_CERT_new@832-835@lib/libcrypto/ts/ts_asn1.c","lib/libcrypto/ts/ts_asn1.c","ESS_SIGNING_CERT_new",832,835
4,1,20,1,3,"ESS_SIGNING_CERT_free@838-841@lib/libcrypto/ts/ts_asn1.c","lib/libcrypto/ts/ts_asn1.c","ESS_SIGNING_CERT_free",838,841
4,1,17,1,3,"ESS_SIGNING_CERT_dup@844-847@lib/libcrypto/ts/ts_asn1.c","lib/libcrypto/ts/ts_asn1.c","ESS_SIGNING_CERT_dup",844,847
30,5,153,1,39,"PKCS7_to_TS_TST_INFO@851-890@lib/libcrypto/ts/ts_asn1.c","lib/libcrypto/ts/ts_asn1.c","PKCS7_to_TS_TST_INFO",851,890
13,3,77,1,14,"TS_CONF_load_cert@98-112@lib/libcrypto/ts/ts_conf.c","lib/libcrypto/ts/ts_conf.c","TS_CONF_load_cert",98,112
29,7,184,1,31,"TS_CONF_load_certs@115-146@lib/libcrypto/ts/ts_conf.c","lib/libcrypto/ts/ts_conf.c","TS_CONF_load_certs",115,146
13,3,85,2,14,"TS_CONF_load_key@149-163@lib/libcrypto/ts/ts_conf.c","lib/libcrypto/ts/ts_conf.c","TS_CONF_load_key",149,163
4,1,25,2,3,"TS_CONF_lookup_fail@168-171@lib/libcrypto/ts/ts_conf.c","lib/libcrypto/ts/ts_conf.c","TS_CONF_lookup_fail",168,171
4,1,25,2,3,"TS_CONF_invalid@174-177@lib/libcrypto/ts/ts_conf.c","lib/libcrypto/ts/ts_conf.c","TS_CONF_invalid",174,177
9,3,46,2,8,"TS_CONF_get_tsa_section@180-188@lib/libcrypto/ts/ts_conf.c","lib/libcrypto/ts/ts_conf.c","TS_CONF_get_tsa_section",180,188
14,2,73,4,16,"TS_CONF_set_serial@191-207@lib/libcrypto/ts/ts_conf.c","lib/libcrypto/ts/ts_conf.c","TS_CONF_set_serial",191,207
13,4,70,3,15,"TS_CONF_set_crypto_device@212-227@lib/libcrypto/ts/ts_conf.c","lib/libcrypto/ts/ts_conf.c","TS_CONF_set_crypto_device",212,227
20,6,99,1,24,"TS_CONF_set_default_engine@230-254@lib/libcrypto/ts/ts_conf.c","lib/libcrypto/ts/ts_conf.c","TS_CONF_set_default_engine",230,254
20,5,108,4,22,"TS_CONF_set_signer_cert@259-281@lib/libcrypto/ts/ts_conf.c","lib/libcrypto/ts/ts_conf.c","TS_CONF_set_signer_cert",259,281
19,5,106,4,21,"TS_CONF_set_certs@284-305@lib/libcrypto/ts/ts_conf.c","lib/libcrypto/ts/ts_conf.c","TS_CONF_set_certs",284,305
20,5,115,5,22,"TS_CONF_set_signer_key@308-330@lib/libcrypto/ts/ts_conf.c","lib/libcrypto/ts/ts_conf.c","TS_CONF_set_signer_key",308,330
22,5,119,4,24,"TS_CONF_set_def_policy@333-357@lib/libcrypto/ts/ts_conf.c","lib/libcrypto/ts/ts_conf.c","TS_CONF_set_def_policy",333,357
27,6,183,3,30,"TS_CONF_set_policies@360-390@lib/libcrypto/ts/ts_conf.c","lib/libcrypto/ts/ts_conf.c","TS_CONF_set_policies",360,390
34,8,213,3,36,"TS_CONF_set_digests@393-429@lib/libcrypto/ts/ts_conf.c","lib/libcrypto/ts/ts_conf.c","TS_CONF_set_digests",393,429
34,10,253,3,36,"TS_CONF_set_accuracy@432-468@lib/libcrypto/ts/ts_conf.c","lib/libcrypto/ts/ts_conf.c","TS_CONF_set_accuracy",432,468
18,5,89,3,22,"TS_CONF_set_clock_precision_digits@471-493@lib/libcrypto/ts/ts_conf.c","lib/libcrypto/ts/ts_conf.c","TS_CONF_set_clock_precision_digits",471,493
14,4,90,5,16,"TS_CONF_add_flag@496-512@lib/libcrypto/ts/ts_conf.c","lib/libcrypto/ts/ts_conf.c","TS_CONF_add_flag",496,512
4,1,31,3,3,"TS_CONF_set_ordering@515-518@lib/libcrypto/ts/ts_conf.c","lib/libcrypto/ts/ts_conf.c","TS_CONF_set_ordering",515,518
4,1,31,3,3,"TS_CONF_set_tsa_name@521-524@lib/libcrypto/ts/ts_conf.c","lib/libcrypto/ts/ts_conf.c","TS_CONF_set_tsa_name",521,524
5,1,31,3,4,"TS_CONF_set_ess_cert_id_chain@527-531@lib/libcrypto/ts/ts_conf.c","lib/libcrypto/ts/ts_conf.c","TS_CONF_set_ess_cert_id_chain",527,531
7,2,36,1,8,"ERR_load_TS_strings@121-129@lib/libcrypto/ts/ts_err.c","lib/libcrypto/ts/ts_err.c","ERR_load_TS_strings",121,129
15,3,98,2,16,"TS_ASN1_INTEGER_print_bio@72-88@lib/libcrypto/ts/ts_lib.c","lib/libcrypto/ts/ts_lib.c","TS_ASN1_INTEGER_print_bio",72,88
10,2,75,2,10,"TS_OBJ_print_bio@91-101@lib/libcrypto/ts/ts_lib.c","lib/libcrypto/ts/ts_lib.c","TS_OBJ_print_bio",91,101
21,4,149,2,22,"TS_ext_print_bio@104-126@lib/libcrypto/ts/ts_lib.c","lib/libcrypto/ts/ts_lib.c","TS_ext_print_bio",104,126
6,2,44,2,6,"TS_X509_ALGOR_print_bio@129-135@lib/libcrypto/ts/ts_lib.c","lib/libcrypto/ts/ts_lib.c","TS_X509_ALGOR_print_bio",129,135
10,1,65,2,12,"TS_MSG_IMPRINT_print_bio@138-150@lib/libcrypto/ts/ts_lib.c","lib/libcrypto/ts/ts_lib.c","TS_MSG_IMPRINT_print_bio",138,150
28,5,167,2,35,"TS_REQ_print_bio@69-104@lib/libcrypto/ts/ts_req_print.c","lib/libcrypto/ts/ts_req_print.c","TS_REQ_print_bio",69,104
4,1,21,2,3,"TS_REQ_set_version@67-70@lib/libcrypto/ts/ts_req_utils.c","lib/libcrypto/ts/ts_req_utils.c","TS_REQ_set_version",67,70
4,1,17,1,3,"TS_REQ_get_version@73-76@lib/libcrypto/ts/ts_req_utils.c","lib/libcrypto/ts/ts_req_utils.c","TS_REQ_get_version",73,76
14,3,66,2,14,"TS_REQ_set_msg_imprint@79-93@lib/libcrypto/ts/ts_req_utils.c","lib/libcrypto/ts/ts_req_utils.c","TS_REQ_set_msg_imprint",79,93
4,1,13,1,3,"TS_REQ_get_msg_imprint@96-99@lib/libcrypto/ts/ts_req_utils.c","lib/libcrypto/ts/ts_req_utils.c","TS_REQ_get_msg_imprint",96,99
14,3,66,2,14,"TS_MSG_IMPRINT_set_algo@102-116@lib/libcrypto/ts/ts_req_utils.c","lib/libcrypto/ts/ts_req_utils.c","TS_MSG_IMPRINT_set_algo",102,116
4,1,13,1,3,"TS_MSG_IMPRINT_get_algo@119-122@lib/libcrypto/ts/ts_req_utils.c","lib/libcrypto/ts/ts_req_utils.c","TS_MSG_IMPRINT_get_algo",119,122
4,1,28,3,3,"TS_MSG_IMPRINT_set_msg@125-128@lib/libcrypto/ts/ts_req_utils.c","lib/libcrypto/ts/ts_req_utils.c","TS_MSG_IMPRINT_set_msg",125,128
4,1,13,1,3,"TS_MSG_IMPRINT_get_msg@131-134@lib/libcrypto/ts/ts_req_utils.c","lib/libcrypto/ts/ts_req_utils.c","TS_MSG_IMPRINT_get_msg",131,134
14,3,66,2,14,"TS_REQ_set_policy_id@137-151@lib/libcrypto/ts/ts_req_utils.c","lib/libcrypto/ts/ts_req_utils.c","TS_REQ_set_policy_id",137,151
4,1,13,1,3,"TS_REQ_get_policy_id@154-157@lib/libcrypto/ts/ts_req_utils.c","lib/libcrypto/ts/ts_req_utils.c","TS_REQ_get_policy_id",154,157
14,3,67,2,14,"TS_REQ_set_nonce@160-174@lib/libcrypto/ts/ts_req_utils.c","lib/libcrypto/ts/ts_req_utils.c","TS_REQ_set_nonce",160,174
4,1,14,1,3,"TS_REQ_get_nonce@177-180@lib/libcrypto/ts/ts_req_utils.c","lib/libcrypto/ts/ts_req_utils.c","TS_REQ_get_nonce",177,180
5,2,24,2,4,"TS_REQ_set_cert_req@183-187@lib/libcrypto/ts/ts_req_utils.c","lib/libcrypto/ts/ts_req_utils.c","TS_REQ_set_cert_req",183,187
4,2,18,1,3,"TS_REQ_get_cert_req@190-193@lib/libcrypto/ts/ts_req_utils.c","lib/libcrypto/ts/ts_req_utils.c","TS_REQ_get_cert_req",190,193
4,1,13,1,3,"TS_REQ_get_exts@195-198@lib/libcrypto/ts/ts_req_utils.c","lib/libcrypto/ts/ts_req_utils.c","TS_REQ_get_exts",195,198
7,2,30,1,6,"TS_REQ_ext_free@201-207@lib/libcrypto/ts/ts_req_utils.c","lib/libcrypto/ts/ts_req_utils.c","TS_REQ_ext_free",201,207
4,1,16,1,3,"TS_REQ_get_ext_count@210-213@lib/libcrypto/ts/ts_req_utils.c","lib/libcrypto/ts/ts_req_utils.c","TS_REQ_get_ext_count",210,213
4,1,26,3,3,"TS_REQ_get_ext_by_NID@216-219@lib/libcrypto/ts/ts_req_utils.c","lib/libcrypto/ts/ts_req_utils.c","TS_REQ_get_ext_by_NID",216,219
4,1,27,3,3,"TS_REQ_get_ext_by_OBJ@222-225@lib/libcrypto/ts/ts_req_utils.c","lib/libcrypto/ts/ts_req_utils.c","TS_REQ_get_ext_by_OBJ",222,225
4,1,26,3,3,"TS_REQ_get_ext_by_critical@228-231@lib/libcrypto/ts/ts_req_utils.c","lib/libcrypto/ts/ts_req_utils.c","TS_REQ_get_ext_by_critical",228,231
4,1,21,2,3,"TS_REQ_get_ext@234-237@lib/libcrypto/ts/ts_req_utils.c","lib/libcrypto/ts/ts_req_utils.c","TS_REQ_get_ext",234,237
4,1,21,2,3,"TS_REQ_delete_ext@240-243@lib/libcrypto/ts/ts_req_utils.c","lib/libcrypto/ts/ts_req_utils.c","TS_REQ_delete_ext",240,243
4,1,30,3,3,"TS_REQ_add_ext@246-249@lib/libcrypto/ts/ts_req_utils.c","lib/libcrypto/ts/ts_req_utils.c","TS_REQ_add_ext",246,249
4,1,33,4,3,"TS_REQ_get_ext_d2i@252-255@lib/libcrypto/ts/ts_req_utils.c","lib/libcrypto/ts/ts_req_utils.c","TS_REQ_get_ext_d2i",252,255
13,2,74,2,15,"TS_RESP_print_bio@80-95@lib/libcrypto/ts/ts_rsp_print.c","lib/libcrypto/ts/ts_rsp_print.c","TS_RESP_print_bio",80,95
73,8,298,2,79,"TS_STATUS_INFO_print_bio@98-177@lib/libcrypto/ts/ts_rsp_print.c","lib/libcrypto/ts/ts_rsp_print.c","TS_STATUS_INFO_print_bio",98,177
12,4,77,3,13,"TS_status_map_print@180-193@lib/libcrypto/ts/ts_rsp_print.c","lib/libcrypto/ts/ts_rsp_print.c","TS_status_map_print",180,193
58,8,368,2,79,"TS_TST_INFO_print_bio@196-275@lib/libcrypto/ts/ts_rsp_print.c","lib/libcrypto/ts/ts_rsp_print.c","TS_TST_INFO_print_bio",196,275
22,4,130,2,23,"TS_ACCURACY_print_bio@278-301@lib/libcrypto/ts/ts_rsp_print.c","lib/libcrypto/ts/ts_rsp_print.c","TS_ACCURACY_print_bio",278,301
14,3,64,2,15,"def_serial_cb@95-110@lib/libcrypto/ts/ts_rsp_sign.c","lib/libcrypto/ts/ts_rsp_sign.c","def_serial_cb",95,110
14,2,80,4,16,"def_time_cb@114-130@lib/libcrypto/ts/ts_rsp_sign.c","lib/libcrypto/ts/ts_rsp_sign.c","def_time_cb",114,130
7,1,36,3,7,"def_extension_cb@133-140@lib/libcrypto/ts/ts_rsp_sign.c","lib/libcrypto/ts/ts_rsp_sign.c","def_extension_cb",133,140
12,2,58,1,15,"TS_RESP_CTX_new@145-160@lib/libcrypto/ts/ts_rsp_sign.c","lib/libcrypto/ts/ts_rsp_sign.c","TS_RESP_CTX_new",145,160
15,2,87,1,15,"TS_RESP_CTX_free@163-178@lib/libcrypto/ts/ts_rsp_sign.c","lib/libcrypto/ts/ts_rsp_sign.c","TS_RESP_CTX_free",163,178
11,2,66,2,10,"TS_RESP_CTX_set_signer_cert@181-191@lib/libcrypto/ts/ts_rsp_sign.c","lib/libcrypto/ts/ts_rsp_sign.c","TS_RESP_CTX_set_signer_cert",181,191
7,1,43,2,7,"TS_RESP_CTX_set_signer_key@194-201@lib/libcrypto/ts/ts_rsp_sign.c","lib/libcrypto/ts/ts_rsp_sign.c","TS_RESP_CTX_set_signer_key",194,201
11,3,55,2,11,"TS_RESP_CTX_set_def_policy@204-215@lib/libcrypto/ts/ts_rsp_sign.c","lib/libcrypto/ts/ts_rsp_sign.c","TS_RESP_CTX_set_def_policy",204,215
19,5,122,2,20,"TS_RESP_CTX_set_certs@218-238@lib/libcrypto/ts/ts_rsp_sign.c","lib/libcrypto/ts/ts_rsp_sign.c","TS_RESP_CTX_set_certs",218,238
15,4,87,2,18,"TS_RESP_CTX_add_policy@241-259@lib/libcrypto/ts/ts_rsp_sign.c","lib/libcrypto/ts/ts_rsp_sign.c","TS_RESP_CTX_add_policy",241,259
11,3,66,2,14,"TS_RESP_CTX_add_md@262-276@lib/libcrypto/ts/ts_rsp_sign.c","lib/libcrypto/ts/ts_rsp_sign.c","TS_RESP_CTX_add_md",262,276
18,7,130,4,19,"TS_RESP_CTX_set_accuracy@287-306@lib/libcrypto/ts/ts_rsp_sign.c","lib/libcrypto/ts/ts_rsp_sign.c","TS_RESP_CTX_set_accuracy",287,306
4,1,17,2,3,"TS_RESP_CTX_add_flags@309-312@lib/libcrypto/ts/ts_rsp_sign.c","lib/libcrypto/ts/ts_rsp_sign.c","TS_RESP_CTX_add_flags",309,312
5,1,27,3,4,"TS_RESP_CTX_set_serial_cb@315-319@lib/libcrypto/ts/ts_rsp_sign.c","lib/libcrypto/ts/ts_rsp_sign.c","TS_RESP_CTX_set_serial_cb",315,319
5,1,27,3,4,"TS_RESP_CTX_set_extension_cb@322-326@lib/libcrypto/ts/ts_rsp_sign.c","lib/libcrypto/ts/ts_rsp_sign.c","TS_RESP_CTX_set_extension_cb",322,326
29,10,179,3,30,"TS_RESP_CTX_set_status_info@329-359@lib/libcrypto/ts/ts_rsp_sign.c","lib/libcrypto/ts/ts_rsp_sign.c","TS_RESP_CTX_set_status_info",329,359
9,2,59,3,10,"TS_RESP_CTX_set_status_info_cond@362-372@lib/libcrypto/ts/ts_rsp_sign.c","lib/libcrypto/ts/ts_rsp_sign.c","TS_RESP_CTX_set_status_info_cond",362,372
12,3,73,2,13,"TS_RESP_CTX_add_failure_info@375-388@lib/libcrypto/ts/ts_rsp_sign.c","lib/libcrypto/ts/ts_rsp_sign.c","TS_RESP_CTX_add_failure_info",375,388
4,1,13,1,3,"TS_RESP_CTX_get_request@391-394@lib/libcrypto/ts/ts_rsp_sign.c","lib/libcrypto/ts/ts_rsp_sign.c","TS_RESP_CTX_get_request",391,394
4,1,13,1,3,"TS_RESP_CTX_get_tst_info@397-400@lib/libcrypto/ts/ts_rsp_sign.c","lib/libcrypto/ts/ts_rsp_sign.c","TS_RESP_CTX_get_tst_info",397,400
7,2,29,2,6,"TS_RESP_CTX_set_clock_precision_digits@403-409@lib/libcrypto/ts/ts_rsp_sign.c","lib/libcrypto/ts/ts_rsp_sign.c","TS_RESP_CTX_set_clock_precision_digits",403,409
47,12,250,2,66,"TS_RESP_create_response@413-479@lib/libcrypto/ts/ts_rsp_sign.c","lib/libcrypto/ts/ts_rsp_sign.c","TS_RESP_create_response",413,479
6,1,26,1,5,"TS_RESP_CTX_init@483-488@lib/libcrypto/ts/ts_rsp_sign.c","lib/libcrypto/ts/ts_rsp_sign.c","TS_RESP_CTX_init",483,488
9,1,47,1,8,"TS_RESP_CTX_cleanup@492-500@lib/libcrypto/ts/ts_rsp_sign.c","lib/libcrypto/ts/ts_rsp_sign.c","TS_RESP_CTX_cleanup",492,500
47,9,249,1,54,"TS_RESP_check_request@504-558@lib/libcrypto/ts/ts_rsp_sign.c","lib/libcrypto/ts/ts_rsp_sign.c","TS_RESP_check_request",504,558
25,8,149,1,29,"TS_RESP_get_policy@562-591@lib/libcrypto/ts/ts_rsp_sign.c","lib/libcrypto/ts/ts_rsp_sign.c","TS_RESP_get_policy",562,591
71,30,478,2,83,"TS_RESP_create_tst_info@595-678@lib/libcrypto/ts/ts_rsp_sign.c","lib/libcrypto/ts/ts_rsp_sign.c","TS_RESP_create_tst_info",595,678
11,3,80,1,19,"TS_RESP_process_extensions@682-701@lib/libcrypto/ts/ts_rsp_sign.c","lib/libcrypto/ts/ts_rsp_sign.c","TS_RESP_process_extensions",682,701
77,18,451,1,105,"TS_RESP_sign@705-810@lib/libcrypto/ts/ts_rsp_sign.c","lib/libcrypto/ts/ts_rsp_sign.c","TS_RESP_sign",705,810
24,8,164,2,30,"ESS_SIGNING_CERT_new_init@813-843@lib/libcrypto/ts/ts_rsp_sign.c","lib/libcrypto/ts/ts_rsp_sign.c","ESS_SIGNING_CERT_new_init",813,843
34,9,217,2,43,"ESS_CERT_ID_new_init@846-889@lib/libcrypto/ts/ts_rsp_sign.c","lib/libcrypto/ts/ts_rsp_sign.c","ESS_CERT_ID_new_init",846,889
21,5,123,1,26,"TS_TST_INFO_content_new@892-918@lib/libcrypto/ts/ts_rsp_sign.c","lib/libcrypto/ts/ts_rsp_sign.c","TS_TST_INFO_content_new",892,918
25,4,141,2,27,"ESS_add_signing_cert@921-948@lib/libcrypto/ts/ts_rsp_sign.c","lib/libcrypto/ts/ts_rsp_sign.c","ESS_add_signing_cert",921,948
40,11,266,4,68,"TS_RESP_set_genTime_with_precision@952-1020@lib/libcrypto/ts/ts_rsp_sign.c","lib/libcrypto/ts/ts_rsp_sign.c","TS_RESP_set_genTime_with_precision",952,1020
14,3,66,2,15,"TS_RESP_set_status_info@69-84@lib/libcrypto/ts/ts_rsp_utils.c","lib/libcrypto/ts/ts_rsp_utils.c","TS_RESP_set_status_info",69,84
4,1,13,1,3,"TS_RESP_get_status_info@87-90@lib/libcrypto/ts/ts_rsp_utils.c","lib/libcrypto/ts/ts_rsp_utils.c","TS_RESP_get_status_info",87,90
7,1,42,3,7,"TS_RESP_set_tst_info@94-101@lib/libcrypto/ts/ts_rsp_utils.c","lib/libcrypto/ts/ts_rsp_utils.c","TS_RESP_set_tst_info",94,101
4,1,13,1,3,"TS_RESP_get_token@104-107@lib/libcrypto/ts/ts_rsp_utils.c","lib/libcrypto/ts/ts_rsp_utils.c","TS_RESP_get_token",104,107
4,1,13,1,3,"TS_RESP_get_tst_info@110-113@lib/libcrypto/ts/ts_rsp_utils.c","lib/libcrypto/ts/ts_rsp_utils.c","TS_RESP_get_tst_info",110,113
4,1,21,2,3,"TS_TST_INFO_set_version@116-119@lib/libcrypto/ts/ts_rsp_utils.c","lib/libcrypto/ts/ts_rsp_utils.c","TS_TST_INFO_set_version",116,119
4,1,17,1,3,"TS_TST_INFO_get_version@122-125@lib/libcrypto/ts/ts_rsp_utils.c","lib/libcrypto/ts/ts_rsp_utils.c","TS_TST_INFO_get_version",122,125
14,3,66,2,14,"TS_TST_INFO_set_policy_id@128-142@lib/libcrypto/ts/ts_rsp_utils.c","lib/libcrypto/ts/ts_rsp_utils.c","TS_TST_INFO_set_policy_id",128,142
4,1,13,1,3,"TS_TST_INFO_get_policy_id@145-148@lib/libcrypto/ts/ts_rsp_utils.c","lib/libcrypto/ts/ts_rsp_utils.c","TS_TST_INFO_get_policy_id",145,148
14,3,66,2,14,"TS_TST_INFO_set_msg_imprint@151-165@lib/libcrypto/ts/ts_rsp_utils.c","lib/libcrypto/ts/ts_rsp_utils.c","TS_TST_INFO_set_msg_imprint",151,165
4,1,13,1,3,"TS_TST_INFO_get_msg_imprint@168-171@lib/libcrypto/ts/ts_rsp_utils.c","lib/libcrypto/ts/ts_rsp_utils.c","TS_TST_INFO_get_msg_imprint",168,171
14,3,67,2,14,"TS_TST_INFO_set_serial@174-188@lib/libcrypto/ts/ts_rsp_utils.c","lib/libcrypto/ts/ts_rsp_utils.c","TS_TST_INFO_set_serial",174,188
4,1,14,1,3,"TS_TST_INFO_get_serial@191-194@lib/libcrypto/ts/ts_rsp_utils.c","lib/libcrypto/ts/ts_rsp_utils.c","TS_TST_INFO_get_serial",191,194
14,3,67,2,14,"TS_TST_INFO_set_time@197-211@lib/libcrypto/ts/ts_rsp_utils.c","lib/libcrypto/ts/ts_rsp_utils.c","TS_TST_INFO_set_time",197,211
4,1,14,1,3,"TS_TST_INFO_get_time@214-217@lib/libcrypto/ts/ts_rsp_utils.c","lib/libcrypto/ts/ts_rsp_utils.c","TS_TST_INFO_get_time",214,217
14,3,66,2,14,"TS_TST_INFO_set_accuracy@220-234@lib/libcrypto/ts/ts_rsp_utils.c","lib/libcrypto/ts/ts_rsp_utils.c","TS_TST_INFO_set_accuracy",220,234
4,1,13,1,3,"TS_TST_INFO_get_accuracy@237-240@lib/libcrypto/ts/ts_rsp_utils.c","lib/libcrypto/ts/ts_rsp_utils.c","TS_TST_INFO_get_accuracy",237,240
14,3,67,2,14,"TS_ACCURACY_set_seconds@243-257@lib/libcrypto/ts/ts_rsp_utils.c","lib/libcrypto/ts/ts_rsp_utils.c","TS_ACCURACY_set_seconds",243,257
4,1,14,1,3,"TS_ACCURACY_get_seconds@260-263@lib/libcrypto/ts/ts_rsp_utils.c","lib/libcrypto/ts/ts_rsp_utils.c","TS_ACCURACY_get_seconds",260,263
16,4,77,2,16,"TS_ACCURACY_set_millis@266-282@lib/libcrypto/ts/ts_rsp_utils.c","lib/libcrypto/ts/ts_rsp_utils.c","TS_ACCURACY_set_millis",266,282
4,1,14,1,3,"TS_ACCURACY_get_millis@285-288@lib/libcrypto/ts/ts_rsp_utils.c","lib/libcrypto/ts/ts_rsp_utils.c","TS_ACCURACY_get_millis",285,288
16,4,77,2,16,"TS_ACCURACY_set_micros@291-307@lib/libcrypto/ts/ts_rsp_utils.c","lib/libcrypto/ts/ts_rsp_utils.c","TS_ACCURACY_set_micros",291,307
4,1,14,1,3,"TS_ACCURACY_get_micros@310-313@lib/libcrypto/ts/ts_rsp_utils.c","lib/libcrypto/ts/ts_rsp_utils.c","TS_ACCURACY_get_micros",310,313
5,2,24,2,4,"TS_TST_INFO_set_ordering@316-320@lib/libcrypto/ts/ts_rsp_utils.c","lib/libcrypto/ts/ts_rsp_utils.c","TS_TST_INFO_set_ordering",316,320
4,2,18,1,3,"TS_TST_INFO_get_ordering@323-326@lib/libcrypto/ts/ts_rsp_utils.c","lib/libcrypto/ts/ts_rsp_utils.c","TS_TST_INFO_get_ordering",323,326
14,3,67,2,14,"TS_TST_INFO_set_nonce@329-343@lib/libcrypto/ts/ts_rsp_utils.c","lib/libcrypto/ts/ts_rsp_utils.c","TS_TST_INFO_set_nonce",329,343
4,1,14,1,3,"TS_TST_INFO_get_nonce@346-349@lib/libcrypto/ts/ts_rsp_utils.c","lib/libcrypto/ts/ts_rsp_utils.c","TS_TST_INFO_get_nonce",346,349
14,3,66,2,14,"TS_TST_INFO_set_tsa@352-366@lib/libcrypto/ts/ts_rsp_utils.c","lib/libcrypto/ts/ts_rsp_utils.c","TS_TST_INFO_set_tsa",352,366
4,1,13,1,3,"TS_TST_INFO_get_tsa@369-372@lib/libcrypto/ts/ts_rsp_utils.c","lib/libcrypto/ts/ts_rsp_utils.c","TS_TST_INFO_get_tsa",369,372
4,1,13,1,3,"TS_TST_INFO_get_exts@374-377@lib/libcrypto/ts/ts_rsp_utils.c","lib/libcrypto/ts/ts_rsp_utils.c","TS_TST_INFO_get_exts",374,377
7,2,30,1,6,"TS_TST_INFO_ext_free@380-386@lib/libcrypto/ts/ts_rsp_utils.c","lib/libcrypto/ts/ts_rsp_utils.c","TS_TST_INFO_ext_free",380,386
4,1,16,1,3,"TS_TST_INFO_get_ext_count@389-392@lib/libcrypto/ts/ts_rsp_utils.c","lib/libcrypto/ts/ts_rsp_utils.c","TS_TST_INFO_get_ext_count",389,392
4,1,26,3,3,"TS_TST_INFO_get_ext_by_NID@395-398@lib/libcrypto/ts/ts_rsp_utils.c","lib/libcrypto/ts/ts_rsp_utils.c","TS_TST_INFO_get_ext_by_NID",395,398
4,1,27,3,3,"TS_TST_INFO_get_ext_by_OBJ@401-404@lib/libcrypto/ts/ts_rsp_utils.c","lib/libcrypto/ts/ts_rsp_utils.c","TS_TST_INFO_get_ext_by_OBJ",401,404
4,1,26,3,3,"TS_TST_INFO_get_ext_by_critical@407-410@lib/libcrypto/ts/ts_rsp_utils.c","lib/libcrypto/ts/ts_rsp_utils.c","TS_TST_INFO_get_ext_by_critical",407,410
4,1,21,2,3,"TS_TST_INFO_get_ext@413-416@lib/libcrypto/ts/ts_rsp_utils.c","lib/libcrypto/ts/ts_rsp_utils.c","TS_TST_INFO_get_ext",413,416
4,1,21,2,3,"TS_TST_INFO_delete_ext@419-422@lib/libcrypto/ts/ts_rsp_utils.c","lib/libcrypto/ts/ts_rsp_utils.c","TS_TST_INFO_delete_ext",419,422
4,1,30,3,3,"TS_TST_INFO_add_ext@425-428@lib/libcrypto/ts/ts_rsp_utils.c","lib/libcrypto/ts/ts_rsp_utils.c","TS_TST_INFO_add_ext",425,428
4,1,33,4,3,"TS_TST_INFO_get_ext_d2i@431-434@lib/libcrypto/ts/ts_rsp_utils.c","lib/libcrypto/ts/ts_rsp_utils.c","TS_TST_INFO_get_ext_d2i",431,434
56,13,343,4,82,"TS_RESP_verify_signature@144-226@lib/libcrypto/ts/ts_rsp_verify.c","lib/libcrypto/ts/ts_rsp_verify.c","TS_RESP_verify_signature",144,226
29,4,153,4,34,"TS_verify_cert@233-267@lib/libcrypto/ts/ts_rsp_verify.c","lib/libcrypto/ts/ts_rsp_verify.c","TS_verify_cert",233,267
27,7,160,2,33,"TS_check_signing_certs@270-303@lib/libcrypto/ts/ts_rsp_verify.c","lib/libcrypto/ts/ts_rsp_verify.c","TS_check_signing_certs",270,303
13,3,73,1,13,"ESS_get_signing_cert@306-319@lib/libcrypto/ts/ts_rsp_verify.c","lib/libcrypto/ts/ts_rsp_verify.c","ESS_get_signing_cert",306,319
18,8,137,2,26,"TS_find_cert@323-349@lib/libcrypto/ts/ts_rsp_verify.c","lib/libcrypto/ts/ts_rsp_verify.c","TS_find_cert",323,349
13,7,93,2,18,"TS_issuer_serial_cmp@352-370@lib/libcrypto/ts/ts_rsp_verify.c","lib/libcrypto/ts/ts_rsp_verify.c","TS_issuer_serial_cmp",352,370
13,3,70,2,18,"TS_RESP_verify_response@379-397@lib/libcrypto/ts/ts_rsp_verify.c","lib/libcrypto/ts/ts_rsp_verify.c","TS_RESP_verify_response",379,397
10,2,51,2,10,"TS_RESP_verify_token@404-414@lib/libcrypto/ts/ts_rsp_verify.c","lib/libcrypto/ts/ts_rsp_verify.c","TS_RESP_verify_token",404,414
49,19,318,3,66,"int_TS_RESP_verify_token@429-495@lib/libcrypto/ts/ts_rsp_verify.c","lib/libcrypto/ts/ts_rsp_verify.c","int_TS_RESP_verify_token",429,495
43,12,243,1,53,"TS_check_status_info@498-551@lib/libcrypto/ts/ts_rsp_verify.c","lib/libcrypto/ts/ts_rsp_verify.c","TS_check_status_info",498,551
23,5,159,1,26,"TS_get_status_text@554-580@lib/libcrypto/ts/ts_rsp_verify.c","lib/libcrypto/ts/ts_rsp_verify.c","TS_get_status_text",554,580
9,2,45,2,10,"TS_check_policy@583-593@lib/libcrypto/ts/ts_rsp_verify.c","lib/libcrypto/ts/ts_rsp_verify.c","TS_check_policy",583,593
41,9,258,5,50,"TS_compute_imprint@596-646@lib/libcrypto/ts/ts_rsp_verify.c","lib/libcrypto/ts/ts_rsp_verify.c","TS_compute_imprint",596,646
22,9,145,4,29,"TS_check_imprints@649-678@lib/libcrypto/ts/ts_rsp_verify.c","lib/libcrypto/ts/ts_rsp_verify.c","TS_check_imprints",649,678
13,3,62,2,17,"TS_check_nonces@681-698@lib/libcrypto/ts/ts_rsp_verify.c","lib/libcrypto/ts/ts_rsp_verify.c","TS_check_nonces",681,698
22,6,138,2,29,"TS_check_signer_name@703-732@lib/libcrypto/ts/ts_rsp_verify.c","lib/libcrypto/ts/ts_rsp_verify.c","TS_check_signer_name",703,732
10,4,77,2,9,"TS_find_name@736-745@lib/libcrypto/ts/ts_rsp_verify.c","lib/libcrypto/ts/ts_rsp_verify.c","TS_find_name",736,745
7,2,33,1,8,"TS_VERIFY_CTX_new@66-74@lib/libcrypto/ts/ts_verify_ctx.c","lib/libcrypto/ts/ts_verify_ctx.c","TS_VERIFY_CTX_new",66,74
4,1,20,1,3,"TS_VERIFY_CTX_init@77-80@lib/libcrypto/ts/ts_verify_ctx.c","lib/libcrypto/ts/ts_verify_ctx.c","TS_VERIFY_CTX_init",77,80
7,2,25,1,7,"TS_VERIFY_CTX_free@83-90@lib/libcrypto/ts/ts_verify_ctx.c","lib/libcrypto/ts/ts_verify_ctx.c","TS_VERIFY_CTX_free",83,90
14,2,78,1,20,"TS_VERIFY_CTX_cleanup@93-113@lib/libcrypto/ts/ts_verify_ctx.c","lib/libcrypto/ts/ts_verify_ctx.c","TS_VERIFY_CTX_cleanup",93,113
40,10,258,2,50,"TS_REQ_to_TS_VERIFY_CTX@116-166@lib/libcrypto/ts/ts_verify_ctx.c","lib/libcrypto/ts/ts_verify_ctx.c","TS_REQ_to_TS_VERIFY_CTX",116,166
112,28,722,2,116,"TXT_DB_read@70-186@lib/libcrypto/txt_db/txt_db.c","lib/libcrypto/txt_db/txt_db.c","TXT_DB_read",70,186
17,3,95,3,17,"TXT_DB_get_by_index@189-206@lib/libcrypto/txt_db/txt_db.c","lib/libcrypto/txt_db/txt_db.c","TXT_DB_get_by_index",189,206
33,8,249,5,34,"TXT_DB_create_index@209-243@lib/libcrypto/txt_db/txt_db.c","lib/libcrypto/txt_db/txt_db.c","TXT_DB_create_index",209,243
44,13,313,2,47,"TXT_DB_write@246-293@lib/libcrypto/txt_db/txt_db.c","lib/libcrypto/txt_db/txt_db.c","TXT_DB_write",246,293
32,11,230,2,35,"TXT_DB_insert@296-331@lib/libcrypto/txt_db/txt_db.c","lib/libcrypto/txt_db/txt_db.c","TXT_DB_insert",296,331
35,13,260,1,38,"TXT_DB_free@334-372@lib/libcrypto/txt_db/txt_db.c","lib/libcrypto/txt_db/txt_db.c","TXT_DB_free",334,372
7,2,36,1,8,"ERR_load_UI_strings@93-101@lib/libcrypto/ui/ui_err.c","lib/libcrypto/ui/ui_err.c","ERR_load_UI_strings",93,101
4,1,14,1,3,"UI_new@72-75@lib/libcrypto/ui/ui_lib.c","lib/libcrypto/ui/ui_lib.c","UI_new",72,75
18,3,93,1,19,"UI_new_method@78-97@lib/libcrypto/ui/ui_lib.c","lib/libcrypto/ui/ui_lib.c","UI_new_method",78,97
16,3,96,1,15,"free_string@100-115@lib/libcrypto/ui/ui_lib.c","lib/libcrypto/ui/ui_lib.c","free_string",100,115
8,2,42,1,7,"UI_free@118-125@lib/libcrypto/ui/ui_lib.c","lib/libcrypto/ui/ui_lib.c","UI_free",118,125
10,3,43,1,9,"allocate_string_stack@128-137@lib/libcrypto/ui/ui_lib.c","lib/libcrypto/ui/ui_lib.c","allocate_string_stack",128,137
18,8,128,6,18,"general_allocate_prompt@140-158@lib/libcrypto/ui/ui_lib.c","lib/libcrypto/ui/ui_lib.c","general_allocate_prompt",140,158
20,4,139,9,21,"general_allocate_string@161-182@lib/libcrypto/ui/ui_lib.c","lib/libcrypto/ui/ui_lib.c","general_allocate_string",161,182
33,8,211,9,39,"general_allocate_boolean@185-224@lib/libcrypto/ui/ui_lib.c","lib/libcrypto/ui/ui_lib.c","general_allocate_boolean",185,224
6,1,48,6,5,"UI_add_input_string@229-234@lib/libcrypto/ui/ui_lib.c","lib/libcrypto/ui/ui_lib.c","UI_add_input_string",229,234
14,3,83,6,14,"UI_dup_input_string@238-252@lib/libcrypto/ui/ui_lib.c","lib/libcrypto/ui/ui_lib.c","UI_dup_input_string",238,252
6,1,53,7,5,"UI_add_verify_string@255-260@lib/libcrypto/ui/ui_lib.c","lib/libcrypto/ui/ui_lib.c","UI_add_verify_string",255,260
14,3,89,7,14,"UI_dup_verify_string@263-277@lib/libcrypto/ui/ui_lib.c","lib/libcrypto/ui/ui_lib.c","UI_dup_verify_string",263,277
6,1,57,7,5,"UI_add_input_boolean@280-285@lib/libcrypto/ui/ui_lib.c","lib/libcrypto/ui/ui_lib.c","UI_add_input_boolean",280,285
45,9,223,7,46,"UI_dup_input_boolean@288-334@lib/libcrypto/ui/ui_lib.c","lib/libcrypto/ui/ui_lib.c","UI_dup_input_boolean",288,334
5,1,35,2,4,"UI_add_info_string@337-341@lib/libcrypto/ui/ui_lib.c","lib/libcrypto/ui/ui_lib.c","UI_add_info_string",337,341
13,3,71,2,13,"UI_dup_info_string@344-357@lib/libcrypto/ui/ui_lib.c","lib/libcrypto/ui/ui_lib.c","UI_dup_info_string",344,357
5,1,35,2,4,"UI_add_error_string@360-364@lib/libcrypto/ui/ui_lib.c","lib/libcrypto/ui/ui_lib.c","UI_add_error_string",360,364
13,3,71,2,13,"UI_dup_error_string@367-380@lib/libcrypto/ui/ui_lib.c","lib/libcrypto/ui/ui_lib.c","UI_dup_error_string",367,380
18,6,109,3,21,"UI_construct_prompt@383-404@lib/libcrypto/ui/ui_lib.c","lib/libcrypto/ui/ui_lib.c","UI_construct_prompt",383,404
6,1,29,2,6,"UI_add_user_data@407-413@lib/libcrypto/ui/ui_lib.c","lib/libcrypto/ui/ui_lib.c","UI_add_user_data",407,413
4,1,13,1,3,"UI_get0_user_data@416-419@lib/libcrypto/ui/ui_lib.c","lib/libcrypto/ui/ui_lib.c","UI_get0_user_data",416,419
12,3,61,2,11,"UI_get0_result@422-433@lib/libcrypto/ui/ui_lib.c","lib/libcrypto/ui/ui_lib.c","UI_get0_result",422,433
11,3,72,3,12,"print_error@436-448@lib/libcrypto/ui/ui_lib.c","lib/libcrypto/ui/ui_lib.c","print_error",436,448
51,16,297,1,56,"UI_process@451-507@lib/libcrypto/ui/ui_lib.c","lib/libcrypto/ui/ui_lib.c","UI_process",451,507
24,5,115,5,23,"UI_ctrl@510-533@lib/libcrypto/ui/ui_lib.c","lib/libcrypto/ui/ui_lib.c","UI_ctrl",510,533
6,1,39,5,5,"UI_get_ex_new_index@536-541@lib/libcrypto/ui/ui_lib.c","lib/libcrypto/ui/ui_lib.c","UI_get_ex_new_index",536,541
4,1,30,3,3,"UI_set_ex_data@544-547@lib/libcrypto/ui/ui_lib.c","lib/libcrypto/ui/ui_lib.c","UI_set_ex_data",544,547
4,1,24,2,3,"UI_get_ex_data@550-553@lib/libcrypto/ui/ui_lib.c","lib/libcrypto/ui/ui_lib.c","UI_get_ex_data",550,553
4,1,13,1,3,"UI_set_default_method@556-559@lib/libcrypto/ui/ui_lib.c","lib/libcrypto/ui/ui_lib.c","UI_set_default_method",556,559
7,2,23,1,6,"UI_get_default_method@562-568@lib/libcrypto/ui/ui_lib.c","lib/libcrypto/ui/ui_lib.c","UI_get_default_method",562,568
4,1,13,1,3,"UI_get_method@571-574@lib/libcrypto/ui/ui_lib.c","lib/libcrypto/ui/ui_lib.c","UI_get_method",571,574
5,1,24,2,4,"UI_set_method@577-581@lib/libcrypto/ui/ui_lib.c","lib/libcrypto/ui/ui_lib.c","UI_set_method",577,581
7,3,40,1,8,"UI_create_method@585-593@lib/libcrypto/ui/ui_lib.c","lib/libcrypto/ui/ui_lib.c","UI_create_method",585,593
6,1,26,1,5,"UI_destroy_method@599-604@lib/libcrypto/ui/ui_lib.c","lib/libcrypto/ui/ui_lib.c","UI_destroy_method",599,604
8,2,39,2,7,"UI_method_set_opener@607-614@lib/libcrypto/ui/ui_lib.c","lib/libcrypto/ui/ui_lib.c","UI_method_set_opener",607,614
8,2,43,2,7,"UI_method_set_writer@617-624@lib/libcrypto/ui/ui_lib.c","lib/libcrypto/ui/ui_lib.c","UI_method_set_writer",617,624
8,2,39,2,7,"UI_method_set_flusher@627-634@lib/libcrypto/ui/ui_lib.c","lib/libcrypto/ui/ui_lib.c","UI_method_set_flusher",627,634
8,2,43,2,7,"UI_method_set_reader@637-644@lib/libcrypto/ui/ui_lib.c","lib/libcrypto/ui/ui_lib.c","UI_method_set_reader",637,644
8,2,39,2,7,"UI_method_set_closer@647-654@lib/libcrypto/ui/ui_lib.c","lib/libcrypto/ui/ui_lib.c","UI_method_set_closer",647,654
10,2,50,2,9,"UI_method_set_prompt_constructor@657-666@lib/libcrypto/ui/ui_lib.c","lib/libcrypto/ui/ui_lib.c","UI_method_set_prompt_constructor",657,666
7,2,19,1,6,"int( * UI_method_get_opener(UI_METHOD*method))@669-675@lib/libcrypto/ui/ui_lib.c","lib/libcrypto/ui/ui_lib.c","int( * UI_method_get_opener(UI_METHOD*method))",669,675
7,2,22,2,6,"int( * UI_method_get_writer(UI_METHOD*method))@678-684@lib/libcrypto/ui/ui_lib.c","lib/libcrypto/ui/ui_lib.c","int( * UI_method_get_writer(UI_METHOD*method))",678,684
7,2,19,1,6,"int( * UI_method_get_flusher(UI_METHOD*method))@687-693@lib/libcrypto/ui/ui_lib.c","lib/libcrypto/ui/ui_lib.c","int( * UI_method_get_flusher(UI_METHOD*method))",687,693
7,2,22,2,6,"int( * UI_method_get_reader(UI_METHOD*method))@696-702@lib/libcrypto/ui/ui_lib.c","lib/libcrypto/ui/ui_lib.c","int( * UI_method_get_reader(UI_METHOD*method))",696,702
7,2,19,1,6,"int( * UI_method_get_closer(UI_METHOD*method))@705-711@lib/libcrypto/ui/ui_lib.c","lib/libcrypto/ui/ui_lib.c","int( * UI_method_get_closer(UI_METHOD*method))",705,711
6,2,21,1,5,"UI_get_string_type@724-729@lib/libcrypto/ui/ui_lib.c","lib/libcrypto/ui/ui_lib.c","UI_get_string_type",724,729
6,2,21,1,5,"UI_get_input_flags@732-737@lib/libcrypto/ui/ui_lib.c","lib/libcrypto/ui/ui_lib.c","UI_get_input_flags",732,737
6,2,21,1,5,"UI_get0_output_string@740-745@lib/libcrypto/ui/ui_lib.c","lib/libcrypto/ui/ui_lib.c","UI_get0_output_string",740,745
12,4,44,1,11,"UI_get0_action_string@748-759@lib/libcrypto/ui/ui_lib.c","lib/libcrypto/ui/ui_lib.c","UI_get0_action_string",748,759
12,4,40,1,11,"UI_get0_result_string@762-773@lib/libcrypto/ui/ui_lib.c","lib/libcrypto/ui/ui_lib.c","UI_get0_result_string",762,773
11,3,41,1,10,"UI_get0_test_string@776-786@lib/libcrypto/ui/ui_lib.c","lib/libcrypto/ui/ui_lib.c","UI_get0_test_string",776,786
12,4,46,1,11,"UI_get_result_minsize@789-800@lib/libcrypto/ui/ui_lib.c","lib/libcrypto/ui/ui_lib.c","UI_get_result_minsize",789,800
12,4,46,1,11,"UI_get_result_maxsize@803-814@lib/libcrypto/ui/ui_lib.c","lib/libcrypto/ui/ui_lib.c","UI_get_result_maxsize",803,814
60,12,327,3,62,"UI_set_result@817-879@lib/libcrypto/ui/ui_lib.c","lib/libcrypto/ui/ui_lib.c","UI_set_result",817,879
4,1,10,1,3,"UI_OpenSSL@166-169@lib/libcrypto/ui/ui_openssl.c","lib/libcrypto/ui/ui_openssl.c","UI_OpenSSL",166,169
13,3,51,2,12,"write_string@174-186@lib/libcrypto/ui/ui_openssl.c","lib/libcrypto/ui/ui_openssl.c","write_string",174,186
34,6,196,2,34,"read_string@189-223@lib/libcrypto/ui/ui_openssl.c","lib/libcrypto/ui/ui_openssl.c","read_string",189,223
9,3,49,1,10,"read_till_nl@228-238@lib/libcrypto/ui/ui_openssl.c","lib/libcrypto/ui/ui_openssl.c","read_till_nl",228,238
42,16,245,4,48,"read_string_inner@243-291@lib/libcrypto/ui/ui_openssl.c","lib/libcrypto/ui/ui_openssl.c","read_string_inner",243,291
19,6,101,1,27,"open_console@296-323@lib/libcrypto/ui/ui_openssl.c","lib/libcrypto/ui/ui_openssl.c","open_console",296,323
8,3,48,1,8,"noecho_console@326-334@lib/libcrypto/ui/ui_openssl.c","lib/libcrypto/ui/ui_openssl.c","noecho_console",326,334
6,3,36,1,5,"echo_console@337-342@lib/libcrypto/ui/ui_openssl.c","lib/libcrypto/ui/ui_openssl.c","echo_console",337,342
9,3,38,1,9,"close_console@345-354@lib/libcrypto/ui/ui_openssl.c","lib/libcrypto/ui/ui_openssl.c","close_console",345,354
17,5,90,1,19,"pushsig@359-378@lib/libcrypto/ui/ui_openssl.c","lib/libcrypto/ui/ui_openssl.c","pushsig",359,378
11,4,53,1,10,"popsig@381-391@lib/libcrypto/ui/ui_openssl.c","lib/libcrypto/ui/ui_openssl.c","popsig",381,391
4,1,11,1,3,"recsig@394-397@lib/libcrypto/ui/ui_openssl.c","lib/libcrypto/ui/ui_openssl.c","recsig",394,397
9,2,63,4,9,"UI_UTIL_read_pw_string@63-72@lib/libcrypto/ui/ui_util.c","lib/libcrypto/ui/ui_util.c","UI_UTIL_read_pw_string",63,72
20,7,135,5,21,"UI_UTIL_read_pw@75-96@lib/libcrypto/ui/ui_util.c","lib/libcrypto/ui/ui_util.c","UI_UTIL_read_pw",75,96
4,1,31,4,3,"_ossl_old_des_read_pw_string@102-105@lib/libcrypto/ui/ui_util.c","lib/libcrypto/ui/ui_util.c","_ossl_old_des_read_pw_string",102,105
4,1,37,5,3,"_ossl_old_des_read_pw@108-111@lib/libcrypto/ui/ui_util.c","lib/libcrypto/ui/ui_util.c","_ossl_old_des_read_pw",108,111
152,17,3519,3,188,"whirlpool_block@441-629@lib/libcrypto/whrlpool/wp_block.c","lib/libcrypto/whrlpool/wp_block.c","whirlpool_block",441,629
5,1,26,1,4,"WHIRLPOOL_Init@59-63@lib/libcrypto/whrlpool/wp_dgst.c","lib/libcrypto/whrlpool/wp_dgst.c","WHIRLPOOL_Init",59,63
14,3,93,3,19,"WHIRLPOOL_Update@65-84@lib/libcrypto/whrlpool/wp_dgst.c","lib/libcrypto/whrlpool/wp_dgst.c","WHIRLPOOL_Update",65,84
107,19,622,3,129,"WHIRLPOOL_BitUpdate@86-215@lib/libcrypto/whrlpool/wp_dgst.c","lib/libcrypto/whrlpool/wp_dgst.c","WHIRLPOOL_BitUpdate",86,215
32,8,293,2,37,"WHIRLPOOL_Final@217-254@lib/libcrypto/whrlpool/wp_dgst.c","lib/libcrypto/whrlpool/wp_dgst.c","WHIRLPOOL_Final",217,254
10,2,67,3,10,"WHIRLPOOL@256-266@lib/libcrypto/whrlpool/wp_dgst.c","lib/libcrypto/whrlpool/wp_dgst.c","WHIRLPOOL",256,266
4,1,12,1,3,"X509_LOOKUP_hash_dir@116-119@lib/libcrypto/x509/by_dir.c","lib/libcrypto/x509/by_dir.c","X509_LOOKUP_hash_dir",116,119
20,4,106,5,21,"dir_ctrl@122-143@lib/libcrypto/x509/by_dir.c","lib/libcrypto/x509/by_dir.c","dir_ctrl",122,143
13,3,80,1,13,"new_dir@146-159@lib/libcrypto/x509/by_dir.c","lib/libcrypto/x509/by_dir.c","new_dir",146,159
4,1,13,1,3,"by_dir_hash_free@162-165@lib/libcrypto/x509/by_dir.c","lib/libcrypto/x509/by_dir.c","by_dir_hash_free",162,165
9,3,60,2,8,"by_dir_hash_cmp@168-176@lib/libcrypto/x509/by_dir.c","lib/libcrypto/x509/by_dir.c","by_dir_hash_cmp",168,176
7,2,35,1,6,"by_dir_entry_free@179-185@lib/libcrypto/x509/by_dir.c","lib/libcrypto/x509/by_dir.c","by_dir_entry_free",179,185
10,3,59,1,10,"free_dir@188-198@lib/libcrypto/x509/by_dir.c","lib/libcrypto/x509/by_dir.c","free_dir",188,198
56,17,341,3,57,"add_cert_dir@201-258@lib/libcrypto/x509/by_dir.c","lib/libcrypto/x509/by_dir.c","add_cert_dir",201,258
137,26,814,4,161,"get_cert_by_subject@261-422@lib/libcrypto/x509/by_dir.c","lib/libcrypto/x509/by_dir.c","get_cert_by_subject",261,422
4,1,12,1,3,"X509_LOOKUP_file@87-90@lib/libcrypto/x509/by_file.c","lib/libcrypto/x509/by_file.c","X509_LOOKUP_file",87,90
25,5,124,5,25,"by_file_ctrl@93-118@lib/libcrypto/x509/by_file.c","lib/libcrypto/x509/by_file.c","by_file_ctrl",93,118
53,13,283,3,55,"X509_load_cert_file@121-176@lib/libcrypto/x509/by_file.c","lib/libcrypto/x509/by_file.c","X509_load_cert_file",121,176
54,14,289,3,56,"X509_load_crl_file@179-235@lib/libcrypto/x509/by_file.c","lib/libcrypto/x509/by_file.c","X509_load_crl_file",179,235
33,7,192,3,32,"X509_load_cert_crl_file@238-270@lib/libcrypto/x509/by_file.c","lib/libcrypto/x509/by_file.c","X509_load_cert_crl_file",238,270
4,1,12,1,3,"X509_LOOKUP_mem@87-90@lib/libcrypto/x509/by_mem.c","lib/libcrypto/x509/by_mem.c","X509_LOOKUP_mem",87,90
40,13,268,5,45,"by_mem_ctrl@93-138@lib/libcrypto/x509/by_mem.c","lib/libcrypto/x509/by_mem.c","by_mem_ctrl",93,138
4,1,18,1,3,"X509at_get_attr_count@70-73@lib/libcrypto/x509/x509_att.c","lib/libcrypto/x509/x509_att.c","X509at_get_attr_count",70,73
8,2,53,3,8,"X509at_get_attr_by_NID@76-84@lib/libcrypto/x509/x509_att.c","lib/libcrypto/x509/x509_att.c","X509at_get_attr_by_NID",76,84
18,5,103,3,18,"X509at_get_attr_by_OBJ@87-105@lib/libcrypto/x509/x509_att.c","lib/libcrypto/x509/x509_att.c","X509at_get_attr_by_OBJ",87,105
7,4,44,2,6,"X509at_get_attr@108-114@lib/libcrypto/x509/x509_att.c","lib/libcrypto/x509/x509_att.c","X509at_get_attr",108,114
8,4,54,2,8,"X509at_delete_attr@117-125@lib/libcrypto/x509/x509_att.c","lib/libcrypto/x509/x509_att.c","X509at_delete_attr",117,125
29,10,165,2,32,"X509at_add1_attr@128-160@lib/libcrypto/x509/x509_att.c","lib/libcrypto/x509/x509_att.c","X509at_add1_attr",128,160
12,2,79,5,12,"X509at_add1_attr_by_OBJ@163-175@lib/libcrypto/x509/x509_att.c","lib/libcrypto/x509/x509_att.c","X509at_add1_attr_by_OBJ",163,175
12,2,77,5,12,"X509at_add1_attr_by_NID@178-190@lib/libcrypto/x509/x509_att.c","lib/libcrypto/x509/x509_att.c","X509at_add1_attr_by_NID",178,190
12,2,79,5,12,"X509at_add1_attr_by_txt@193-205@lib/libcrypto/x509/x509_att.c","lib/libcrypto/x509/x509_att.c","X509at_add1_attr_by_txt",193,205
15,6,115,4,15,"X509at_get0_data_by_OBJ@208-223@lib/libcrypto/x509/x509_att.c","lib/libcrypto/x509/x509_att.c","X509at_get0_data_by_OBJ",208,223
15,3,86,5,15,"X509_ATTRIBUTE_create_by_NID@226-241@lib/libcrypto/x509/x509_att.c","lib/libcrypto/x509/x509_att.c","X509_ATTRIBUTE_create_by_NID",226,241
23,10,157,5,26,"X509_ATTRIBUTE_create_by_OBJ@244-270@lib/libcrypto/x509/x509_att.c","lib/libcrypto/x509/x509_att.c","X509_ATTRIBUTE_create_by_OBJ",244,270
15,2,90,5,15,"X509_ATTRIBUTE_create_by_txt@273-288@lib/libcrypto/x509/x509_att.c","lib/libcrypto/x509/x509_att.c","X509_ATTRIBUTE_create_by_txt",273,288
8,3,55,2,7,"X509_ATTRIBUTE_set1_object@291-298@lib/libcrypto/x509/x509_att.c","lib/libcrypto/x509/x509_att.c","X509_ATTRIBUTE_set1_object",291,298
46,14,274,4,52,"X509_ATTRIBUTE_set1_data@301-353@lib/libcrypto/x509/x509_att.c","lib/libcrypto/x509/x509_att.c","X509_ATTRIBUTE_set1_data",301,353
8,3,39,1,7,"X509_ATTRIBUTE_count@356-363@lib/libcrypto/x509/x509_att.c","lib/libcrypto/x509/x509_att.c","X509_ATTRIBUTE_count",356,363
6,2,26,1,5,"X509_ATTRIBUTE_get0_object@366-371@lib/libcrypto/x509/x509_att.c","lib/libcrypto/x509/x509_att.c","X509_ATTRIBUTE_get0_object",366,371
12,3,65,4,12,"X509_ATTRIBUTE_get0_data@374-386@lib/libcrypto/x509/x509_att.c","lib/libcrypto/x509/x509_att.c","X509_ATTRIBUTE_get0_data",374,386
11,4,61,2,10,"X509_ATTRIBUTE_get0_type@389-399@lib/libcrypto/x509/x509_att.c","lib/libcrypto/x509/x509_att.c","X509_ATTRIBUTE_get0_type",389,399
11,2,72,2,11,"X509_issuer_and_serial_cmp@72-83@lib/libcrypto/x509/x509_cmp.c","lib/libcrypto/x509/x509_cmp.c","X509_issuer_and_serial_cmp",72,83
30,6,245,1,31,"X509_issuer_and_serial_hash@87-118@lib/libcrypto/x509/x509_cmp.c","lib/libcrypto/x509/x509_cmp.c","X509_issuer_and_serial_hash",87,118
4,1,32,2,3,"X509_issuer_name_cmp@122-125@lib/libcrypto/x509/x509_cmp.c","lib/libcrypto/x509/x509_cmp.c","X509_issuer_name_cmp",122,125
4,1,32,2,3,"X509_subject_name_cmp@128-131@lib/libcrypto/x509/x509_cmp.c","lib/libcrypto/x509/x509_cmp.c","X509_subject_name_cmp",128,131
4,1,32,2,3,"X509_CRL_cmp@134-137@lib/libcrypto/x509/x509_cmp.c","lib/libcrypto/x509/x509_cmp.c","X509_CRL_cmp",134,137
4,1,28,2,3,"X509_CRL_match@141-144@lib/libcrypto/x509/x509_cmp.c","lib/libcrypto/x509/x509_cmp.c","X509_CRL_match",141,144
4,1,17,1,3,"X509_get_issuer_name@148-151@lib/libcrypto/x509/x509_cmp.c","lib/libcrypto/x509/x509_cmp.c","X509_get_issuer_name",148,151
4,1,20,1,3,"X509_issuer_name_hash@154-157@lib/libcrypto/x509/x509_cmp.c","lib/libcrypto/x509/x509_cmp.c","X509_issuer_name_hash",154,157
4,1,20,1,3,"X509_issuer_name_hash_old@161-164@lib/libcrypto/x509/x509_cmp.c","lib/libcrypto/x509/x509_cmp.c","X509_issuer_name_hash_old",161,164
4,1,17,1,3,"X509_get_subject_name@168-171@lib/libcrypto/x509/x509_cmp.c","lib/libcrypto/x509/x509_cmp.c","X509_get_subject_name",168,171
4,1,17,1,3,"X509_get_serialNumber@174-177@lib/libcrypto/x509/x509_cmp.c","lib/libcrypto/x509/x509_cmp.c","X509_get_serialNumber",174,177
4,1,20,1,3,"X509_subject_name_hash@180-183@lib/libcrypto/x509/x509_cmp.c","lib/libcrypto/x509/x509_cmp.c","X509_subject_name_hash",180,183
4,1,20,1,3,"X509_subject_name_hash_old@187-190@lib/libcrypto/x509/x509_cmp.c","lib/libcrypto/x509/x509_cmp.c","X509_subject_name_hash_old",187,190
6,1,56,2,7,"X509_cmp@204-211@lib/libcrypto/x509/x509_cmp.c","lib/libcrypto/x509/x509_cmp.c","X509_cmp",204,211
18,8,122,2,19,"X509_NAME_cmp@215-234@lib/libcrypto/x509/x509_cmp.c","lib/libcrypto/x509/x509_cmp.c","X509_NAME_cmp",215,234
13,2,119,1,15,"X509_NAME_hash@237-252@lib/libcrypto/x509/x509_cmp.c","lib/libcrypto/x509/x509_cmp.c","X509_NAME_hash",237,252
18,4,149,1,20,"X509_NAME_hash_old@260-280@lib/libcrypto/x509/x509_cmp.c","lib/libcrypto/x509/x509_cmp.c","X509_NAME_hash_old",260,280
18,4,109,3,20,"X509_find_by_issuer_and_serial@285-305@lib/libcrypto/x509/x509_cmp.c","lib/libcrypto/x509/x509_cmp.c","X509_find_by_issuer_and_serial",285,305
11,3,73,2,11,"X509_find_by_subject@308-319@lib/libcrypto/x509/x509_cmp.c","lib/libcrypto/x509/x509_cmp.c","X509_find_by_subject",308,319
6,3,41,1,5,"X509_get_pubkey@322-327@lib/libcrypto/x509/x509_cmp.c","lib/libcrypto/x509/x509_cmp.c","X509_get_pubkey",322,327
6,2,26,1,5,"X509_get0_pubkey_bitstr@330-335@lib/libcrypto/x509/x509_cmp.c","lib/libcrypto/x509/x509_cmp.c","X509_get0_pubkey_bitstr",330,335
26,7,103,2,28,"X509_check_private_key@338-366@lib/libcrypto/x509/x509_cmp.c","lib/libcrypto/x509/x509_cmp.c","X509_check_private_key",338,366
14,3,83,1,18,"X509_STORE_set_default_paths@67-85@lib/libcrypto/x509/x509_d2.c","lib/libcrypto/x509/x509_d2.c","X509_STORE_set_default_paths",67,85
21,9,142,3,21,"X509_STORE_load_locations@88-109@lib/libcrypto/x509/x509_d2.c","lib/libcrypto/x509/x509_d2.c","X509_STORE_load_locations",88,109
13,3,81,3,16,"X509_STORE_load_mem@112-128@lib/libcrypto/x509/x509_d2.c","lib/libcrypto/x509/x509_d2.c","X509_STORE_load_mem",112,128
4,1,11,1,3,"X509_get_default_private_dir@65-68@lib/libcrypto/x509/x509_def.c","lib/libcrypto/x509/x509_def.c","X509_get_default_private_dir",65,68
4,1,11,1,3,"X509_get_default_cert_area@71-74@lib/libcrypto/x509/x509_def.c","lib/libcrypto/x509/x509_def.c","X509_get_default_cert_area",71,74
4,1,11,1,3,"X509_get_default_cert_dir@77-80@lib/libcrypto/x509/x509_def.c","lib/libcrypto/x509/x509_def.c","X509_get_default_cert_dir",77,80
4,1,11,1,3,"X509_get_default_cert_file@83-86@lib/libcrypto/x509/x509_def.c","lib/libcrypto/x509/x509_def.c","X509_get_default_cert_file",83,86
4,1,11,1,3,"X509_get_default_cert_dir_env@89-92@lib/libcrypto/x509/x509_def.c","lib/libcrypto/x509/x509_def.c","X509_get_default_cert_dir_env",89,92
4,1,11,1,3,"X509_get_default_cert_file_env@95-98@lib/libcrypto/x509/x509_def.c","lib/libcrypto/x509/x509_def.c","X509_get_default_cert_file_env",95,98
7,2,36,1,8,"ERR_load_X509_strings@112-120@lib/libcrypto/x509/x509_err.c","lib/libcrypto/x509/x509_err.c","ERR_load_X509_strings",112,120
4,1,20,1,3,"X509_CRL_get_ext_count@69-72@lib/libcrypto/x509/x509_ext.c","lib/libcrypto/x509/x509_ext.c","X509_CRL_get_ext_count",69,72
4,1,30,3,3,"X509_CRL_get_ext_by_NID@75-78@lib/libcrypto/x509/x509_ext.c","lib/libcrypto/x509/x509_ext.c","X509_CRL_get_ext_by_NID",75,78
4,1,31,3,3,"X509_CRL_get_ext_by_OBJ@81-84@lib/libcrypto/x509/x509_ext.c","lib/libcrypto/x509/x509_ext.c","X509_CRL_get_ext_by_OBJ",81,84
4,1,30,3,3,"X509_CRL_get_ext_by_critical@87-90@lib/libcrypto/x509/x509_ext.c","lib/libcrypto/x509/x509_ext.c","X509_CRL_get_ext_by_critical",87,90
4,1,25,2,3,"X509_CRL_get_ext@93-96@lib/libcrypto/x509/x509_ext.c","lib/libcrypto/x509/x509_ext.c","X509_CRL_get_ext",93,96
4,1,25,2,3,"X509_CRL_delete_ext@99-102@lib/libcrypto/x509/x509_ext.c","lib/libcrypto/x509/x509_ext.c","X509_CRL_delete_ext",99,102
4,1,35,4,3,"X509_CRL_get_ext_d2i@105-108@lib/libcrypto/x509/x509_ext.c","lib/libcrypto/x509/x509_ext.c","X509_CRL_get_ext_d2i",105,108
5,1,41,5,4,"X509_CRL_add1_ext_i2d@111-115@lib/libcrypto/x509/x509_ext.c","lib/libcrypto/x509/x509_ext.c","X509_CRL_add1_ext_i2d",111,115
4,1,36,3,3,"X509_CRL_add_ext@118-121@lib/libcrypto/x509/x509_ext.c","lib/libcrypto/x509/x509_ext.c","X509_CRL_add_ext",118,121
4,1,20,1,3,"X509_get_ext_count@124-127@lib/libcrypto/x509/x509_ext.c","lib/libcrypto/x509/x509_ext.c","X509_get_ext_count",124,127
4,1,30,3,3,"X509_get_ext_by_NID@130-133@lib/libcrypto/x509/x509_ext.c","lib/libcrypto/x509/x509_ext.c","X509_get_ext_by_NID",130,133
4,1,31,3,3,"X509_get_ext_by_OBJ@136-139@lib/libcrypto/x509/x509_ext.c","lib/libcrypto/x509/x509_ext.c","X509_get_ext_by_OBJ",136,139
5,1,30,3,4,"X509_get_ext_by_critical@142-146@lib/libcrypto/x509/x509_ext.c","lib/libcrypto/x509/x509_ext.c","X509_get_ext_by_critical",142,146
4,1,25,2,3,"X509_get_ext@149-152@lib/libcrypto/x509/x509_ext.c","lib/libcrypto/x509/x509_ext.c","X509_get_ext",149,152
4,1,25,2,3,"X509_delete_ext@155-158@lib/libcrypto/x509/x509_ext.c","lib/libcrypto/x509/x509_ext.c","X509_delete_ext",155,158
4,1,36,3,3,"X509_add_ext@161-164@lib/libcrypto/x509/x509_ext.c","lib/libcrypto/x509/x509_ext.c","X509_add_ext",161,164
4,1,35,4,3,"X509_get_ext_d2i@167-170@lib/libcrypto/x509/x509_ext.c","lib/libcrypto/x509/x509_ext.c","X509_get_ext_d2i",167,170
5,1,41,5,4,"X509_add1_ext_i2d@173-177@lib/libcrypto/x509/x509_ext.c","lib/libcrypto/x509/x509_ext.c","X509_add1_ext_i2d",173,177
4,1,18,1,3,"X509_REVOKED_get_ext_count@180-183@lib/libcrypto/x509/x509_ext.c","lib/libcrypto/x509/x509_ext.c","X509_REVOKED_get_ext_count",180,183
4,1,28,3,3,"X509_REVOKED_get_ext_by_NID@186-189@lib/libcrypto/x509/x509_ext.c","lib/libcrypto/x509/x509_ext.c","X509_REVOKED_get_ext_by_NID",186,189
4,1,29,3,3,"X509_REVOKED_get_ext_by_OBJ@192-195@lib/libcrypto/x509/x509_ext.c","lib/libcrypto/x509/x509_ext.c","X509_REVOKED_get_ext_by_OBJ",192,195
4,1,28,3,3,"X509_REVOKED_get_ext_by_critical@198-201@lib/libcrypto/x509/x509_ext.c","lib/libcrypto/x509/x509_ext.c","X509_REVOKED_get_ext_by_critical",198,201
4,1,23,2,3,"X509_REVOKED_get_ext@204-207@lib/libcrypto/x509/x509_ext.c","lib/libcrypto/x509/x509_ext.c","X509_REVOKED_get_ext",204,207
4,1,23,2,3,"X509_REVOKED_delete_ext@210-213@lib/libcrypto/x509/x509_ext.c","lib/libcrypto/x509/x509_ext.c","X509_REVOKED_delete_ext",210,213
4,1,34,3,3,"X509_REVOKED_add_ext@216-219@lib/libcrypto/x509/x509_ext.c","lib/libcrypto/x509/x509_ext.c","X509_REVOKED_add_ext",216,219
4,1,33,4,3,"X509_REVOKED_get_ext_d2i@222-225@lib/libcrypto/x509/x509_ext.c","lib/libcrypto/x509/x509_ext.c","X509_REVOKED_get_ext_d2i",222,225
5,1,39,5,4,"X509_REVOKED_add1_ext_i2d@228-232@lib/libcrypto/x509/x509_ext.c","lib/libcrypto/x509/x509_ext.c","X509_REVOKED_add1_ext_i2d",228,232
17,4,92,1,18,"X509_LOOKUP_new@71-89@lib/libcrypto/x509/x509_lu.c","lib/libcrypto/x509/x509_lu.c","X509_LOOKUP_new",71,89
8,4,53,1,7,"X509_LOOKUP_free@92-99@lib/libcrypto/x509/x509_lu.c","lib/libcrypto/x509/x509_lu.c","X509_LOOKUP_free",92,99
9,3,43,1,8,"X509_LOOKUP_init@102-110@lib/libcrypto/x509/x509_lu.c","lib/libcrypto/x509/x509_lu.c","X509_LOOKUP_init",102,110
9,3,43,1,8,"X509_LOOKUP_shutdown@113-121@lib/libcrypto/x509/x509_lu.c","lib/libcrypto/x509/x509_lu.c","X509_LOOKUP_shutdown",113,121
10,3,67,5,9,"X509_LOOKUP_ctrl@124-133@lib/libcrypto/x509/x509_lu.c","lib/libcrypto/x509/x509_lu.c","X509_LOOKUP_ctrl",124,133
9,4,67,4,8,"X509_LOOKUP_by_subject@136-144@lib/libcrypto/x509/x509_lu.c","lib/libcrypto/x509/x509_lu.c","X509_LOOKUP_by_subject",136,144
8,3,64,5,7,"X509_LOOKUP_by_issuer_serial@147-154@lib/libcrypto/x509/x509_lu.c","lib/libcrypto/x509/x509_lu.c","X509_LOOKUP_by_issuer_serial",147,154
7,3,64,5,6,"X509_LOOKUP_by_fingerprint@157-163@lib/libcrypto/x509/x509_lu.c","lib/libcrypto/x509/x509_lu.c","X509_LOOKUP_by_fingerprint",157,163
7,3,63,5,6,"X509_LOOKUP_by_alias@166-172@lib/libcrypto/x509/x509_lu.c","lib/libcrypto/x509/x509_lu.c","X509_LOOKUP_by_alias",166,172
18,4,121,2,19,"x509_object_cmp@175-194@lib/libcrypto/x509/x509_lu.c","lib/libcrypto/x509/x509_lu.c","x509_object_cmp",175,194
32,4,193,1,37,"X509_STORE_new@197-234@lib/libcrypto/x509/x509_lu.c","lib/libcrypto/x509/x509_lu.c","X509_STORE_new",197,234
5,1,18,1,4,"X509_OBJECT_free@237-241@lib/libcrypto/x509/x509_lu.c","lib/libcrypto/x509/x509_lu.c","X509_OBJECT_free",237,241
22,4,134,1,25,"X509_STORE_free@244-269@lib/libcrypto/x509/x509_lu.c","lib/libcrypto/x509/x509_lu.c","X509_STORE_free",244,269
25,5,122,2,26,"X509_STORE_add_lookup@272-298@lib/libcrypto/x509/x509_lu.c","lib/libcrypto/x509/x509_lu.c","X509_STORE_add_lookup",272,298
32,7,198,4,39,"X509_STORE_get_by_subject@301-340@lib/libcrypto/x509/x509_lu.c","lib/libcrypto/x509/x509_lu.c","X509_STORE_get_by_subject",301,340
33,7,169,2,40,"X509_STORE_add_cert@343-383@lib/libcrypto/x509/x509_lu.c","lib/libcrypto/x509/x509_lu.c","X509_STORE_add_cert",343,383
33,7,169,2,40,"X509_STORE_add_crl@386-426@lib/libcrypto/x509/x509_lu.c","lib/libcrypto/x509/x509_lu.c","X509_STORE_add_crl",386,426
11,3,60,1,10,"X509_OBJECT_dec_ref_count@429-439@lib/libcrypto/x509/x509_lu.c","lib/libcrypto/x509/x509_lu.c","X509_OBJECT_dec_ref_count",429,439
11,3,58,1,10,"X509_OBJECT_up_ref_count@442-452@lib/libcrypto/x509/x509_lu.c","lib/libcrypto/x509/x509_lu.c","X509_OBJECT_up_ref_count",442,452
11,3,44,1,10,"X509_OBJECT_free_contents@455-465@lib/libcrypto/x509/x509_lu.c","lib/libcrypto/x509/x509_lu.c","X509_OBJECT_free_contents",455,465
39,7,204,4,41,"x509_object_idx_cnt@468-509@lib/libcrypto/x509/x509_lu.c","lib/libcrypto/x509/x509_lu.c","x509_object_idx_cnt",468,509
4,1,30,3,3,"X509_OBJECT_idx_by_subject@512-515@lib/libcrypto/x509/x509_lu.c","lib/libcrypto/x509/x509_lu.c","X509_OBJECT_idx_by_subject",512,515
9,2,50,3,9,"X509_OBJECT_retrieve_by_subject@518-527@lib/libcrypto/x509/x509_lu.c","lib/libcrypto/x509/x509_lu.c","X509_OBJECT_retrieve_by_subject",518,527
42,7,254,2,46,"X509_STORE_get1_certs@530-576@lib/libcrypto/x509/x509_lu.c","lib/libcrypto/x509/x509_lu.c","X509_STORE_get1_certs",530,576
38,6,245,2,43,"X509_STORE_get1_crls@579-622@lib/libcrypto/x509/x509_lu.c","lib/libcrypto/x509/x509_lu.c","X509_STORE_get1_crls",579,622
25,10,190,2,25,"X509_OBJECT_retrieve_match@625-650@lib/libcrypto/x509/x509_lu.c","lib/libcrypto/x509/x509_lu.c","X509_OBJECT_retrieve_match",625,650
50,13,338,3,62,"X509_STORE_CTX_get1_issuer@665-727@lib/libcrypto/x509/x509_lu.c","lib/libcrypto/x509/x509_lu.c","X509_STORE_CTX_get1_issuer",665,727
4,1,22,2,3,"X509_STORE_set_flags@730-733@lib/libcrypto/x509/x509_lu.c","lib/libcrypto/x509/x509_lu.c","X509_STORE_set_flags",730,733
5,1,23,2,4,"X509_STORE_set_depth@736-740@lib/libcrypto/x509/x509_lu.c","lib/libcrypto/x509/x509_lu.c","X509_STORE_set_depth",736,740
4,1,21,2,3,"X509_STORE_set_purpose@743-746@lib/libcrypto/x509/x509_lu.c","lib/libcrypto/x509/x509_lu.c","X509_STORE_set_purpose",743,746
4,1,21,2,3,"X509_STORE_set_trust@749-752@lib/libcrypto/x509/x509_lu.c","lib/libcrypto/x509/x509_lu.c","X509_STORE_set_trust",749,752
4,1,22,2,3,"X509_STORE_set1_param@755-758@lib/libcrypto/x509/x509_lu.c","lib/libcrypto/x509/x509_lu.c","X509_STORE_set1_param",755,758
5,1,26,2,4,"X509_STORE_set_verify_cb@761-765@lib/libcrypto/x509/x509_lu.c","lib/libcrypto/x509/x509_lu.c","X509_STORE_set_verify_cb",761,765
104,28,786,3,110,"X509_NAME_oneline@69-179@lib/libcrypto/x509/x509_obj.c","lib/libcrypto/x509/x509_obj.c","X509_NAME_oneline",69,179
36,11,241,3,45,"X509_REQ_to_X509@70-115@lib/libcrypto/x509/x509_r2x.c","lib/libcrypto/x509/x509_r2x.c","X509_REQ_to_X509",70,115
33,9,187,3,40,"X509_to_X509_REQ@74-114@lib/libcrypto/x509/x509_req.c","lib/libcrypto/x509/x509_req.c","X509_to_X509_REQ",74,114
6,3,41,1,5,"X509_REQ_get_pubkey@117-122@lib/libcrypto/x509/x509_req.c","lib/libcrypto/x509/x509_req.c","X509_REQ_get_pubkey",117,122
29,7,124,2,35,"X509_REQ_check_private_key@125-160@lib/libcrypto/x509/x509_req.c","lib/libcrypto/x509/x509_req.c","X509_REQ_check_private_key",125,160
11,4,50,1,11,"X509_REQ_extension_nid@172-183@lib/libcrypto/x509/x509_req.c","lib/libcrypto/x509/x509_req.c","X509_REQ_extension_nid",172,183
4,1,9,1,3,"X509_REQ_get_extension_nids@186-189@lib/libcrypto/x509/x509_req.c","lib/libcrypto/x509/x509_req.c","X509_REQ_get_extension_nids",186,189
4,1,12,1,3,"X509_REQ_set_extension_nids@192-195@lib/libcrypto/x509/x509_req.c","lib/libcrypto/x509/x509_req.c","X509_REQ_set_extension_nids",192,195
25,10,195,1,25,"X509_REQ_get_extensions@198-223@lib/libcrypto/x509/x509_req.c","lib/libcrypto/x509/x509_req.c","X509_REQ_get_extensions",198,223
32,9,224,3,35,"X509_REQ_add_extensions_nid@230-265@lib/libcrypto/x509/x509_req.c","lib/libcrypto/x509/x509_req.c","X509_REQ_add_extensions_nid",230,265
4,1,25,2,3,"X509_REQ_add_extensions@269-272@lib/libcrypto/x509/x509_req.c","lib/libcrypto/x509/x509_req.c","X509_REQ_add_extensions",269,272
4,1,19,1,3,"X509_REQ_get_attr_count@277-280@lib/libcrypto/x509/x509_req.c","lib/libcrypto/x509/x509_req.c","X509_REQ_get_attr_count",277,280
4,1,29,3,3,"X509_REQ_get_attr_by_NID@283-286@lib/libcrypto/x509/x509_req.c","lib/libcrypto/x509/x509_req.c","X509_REQ_get_attr_by_NID",283,286
4,1,30,3,3,"X509_REQ_get_attr_by_OBJ@289-292@lib/libcrypto/x509/x509_req.c","lib/libcrypto/x509/x509_req.c","X509_REQ_get_attr_by_OBJ",289,292
4,1,24,2,3,"X509_REQ_get_attr@295-298@lib/libcrypto/x509/x509_req.c","lib/libcrypto/x509/x509_req.c","X509_REQ_get_attr",295,298
4,1,23,2,3,"X509_REQ_delete_attr@301-304@lib/libcrypto/x509/x509_req.c","lib/libcrypto/x509/x509_req.c","X509_REQ_delete_attr",301,304
6,2,32,2,5,"X509_REQ_add1_attr@307-312@lib/libcrypto/x509/x509_req.c","lib/libcrypto/x509/x509_req.c","X509_REQ_add1_attr",307,312
8,2,51,5,7,"X509_REQ_add1_attr_by_OBJ@315-322@lib/libcrypto/x509/x509_req.c","lib/libcrypto/x509/x509_req.c","X509_REQ_add1_attr_by_OBJ",315,322
8,2,49,5,7,"X509_REQ_add1_attr_by_NID@325-332@lib/libcrypto/x509/x509_req.c","lib/libcrypto/x509/x509_req.c","X509_REQ_add1_attr_by_NID",325,332
8,2,51,5,7,"X509_REQ_add1_attr_by_txt@335-342@lib/libcrypto/x509/x509_req.c","lib/libcrypto/x509/x509_req.c","X509_REQ_add1_attr_by_txt",335,342
10,4,69,2,9,"X509_set_version@67-76@lib/libcrypto/x509/x509_set.c","lib/libcrypto/x509/x509_set.c","X509_set_version",67,76
15,4,82,2,15,"X509_set_serialNumber@79-94@lib/libcrypto/x509/x509_set.c","lib/libcrypto/x509/x509_set.c","X509_set_serialNumber",79,94
6,3,48,2,5,"X509_set_issuer_name@97-102@lib/libcrypto/x509/x509_set.c","lib/libcrypto/x509/x509_set.c","X509_set_issuer_name",97,102
6,3,48,2,5,"X509_set_subject_name@105-110@lib/libcrypto/x509/x509_set.c","lib/libcrypto/x509/x509_set.c","X509_set_subject_name",105,110
15,5,101,2,15,"X509_set_notBefore@113-128@lib/libcrypto/x509/x509_set.c","lib/libcrypto/x509/x509_set.c","X509_set_notBefore",113,128
15,5,101,2,15,"X509_set_notAfter@131-146@lib/libcrypto/x509/x509_set.c","lib/libcrypto/x509/x509_set.c","X509_set_notAfter",131,146
6,3,50,2,5,"X509_set_pubkey@149-154@lib/libcrypto/x509/x509_set.c","lib/libcrypto/x509/x509_set.c","X509_set_pubkey",149,154
4,1,33,2,3,"tr_cmp@96-99@lib/libcrypto/x509/x509_trs.c","lib/libcrypto/x509/x509_trs.c","tr_cmp",96,99
7,1,35,3,7,"int( * X509_TRUST_set_default(int(*trust)(int,X509*,int)))@102-109@lib/libcrypto/x509/x509_trs.c","lib/libcrypto/x509/x509_trs.c","int( * X509_TRUST_set_default(int(*trust)(int,X509*,int)))",102,109
19,5,115,3,28,"X509_check_trust@112-140@lib/libcrypto/x509/x509_trs.c","lib/libcrypto/x509/x509_trs.c","X509_check_trust",112,140
6,2,22,1,5,"X509_TRUST_get_count@143-148@lib/libcrypto/x509/x509_trs.c","lib/libcrypto/x509/x509_trs.c","X509_TRUST_get_count",143,148
8,3,40,1,7,"X509_TRUST_get0@151-158@lib/libcrypto/x509/x509_trs.c","lib/libcrypto/x509/x509_trs.c","X509_TRUST_get0",151,158
14,5,73,1,14,"X509_TRUST_get_by_id@161-175@lib/libcrypto/x509/x509_trs.c","lib/libcrypto/x509/x509_trs.c","X509_TRUST_get_by_id",161,175
9,2,39,2,8,"X509_TRUST_set@178-186@lib/libcrypto/x509/x509_trs.c","lib/libcrypto/x509/x509_trs.c","X509_TRUST_set",178,186
48,10,274,6,62,"X509_TRUST_add@189-251@lib/libcrypto/x509/x509_trs.c","lib/libcrypto/x509/x509_trs.c","X509_TRUST_add",189,251
10,4,45,1,9,"trtable_free@254-263@lib/libcrypto/x509/x509_trs.c","lib/libcrypto/x509/x509_trs.c","trtable_free",254,263
8,2,41,1,8,"X509_TRUST_cleanup@266-274@lib/libcrypto/x509/x509_trs.c","lib/libcrypto/x509/x509_trs.c","X509_TRUST_cleanup",266,274
4,1,13,1,3,"X509_TRUST_get_flags@277-280@lib/libcrypto/x509/x509_trs.c","lib/libcrypto/x509/x509_trs.c","X509_TRUST_get_flags",277,280
4,1,13,1,3,"X509_TRUST_get0_name@283-286@lib/libcrypto/x509/x509_trs.c","lib/libcrypto/x509/x509_trs.c","X509_TRUST_get0_name",283,286
4,1,13,1,3,"X509_TRUST_get_trust@289-292@lib/libcrypto/x509/x509_trs.c","lib/libcrypto/x509/x509_trs.c","X509_TRUST_get_trust",289,292
6,4,57,3,8,"trust_1oidany@295-303@lib/libcrypto/x509/x509_trs.c","lib/libcrypto/x509/x509_trs.c","trust_1oidany",295,303
6,2,36,3,5,"trust_1oid@306-311@lib/libcrypto/x509/x509_trs.c","lib/libcrypto/x509/x509_trs.c","trust_1oid",306,311
8,2,40,3,7,"trust_compat@314-321@lib/libcrypto/x509/x509_trs.c","lib/libcrypto/x509/x509_trs.c","trust_compat",314,321
24,8,144,3,24,"obj_trust@324-348@lib/libcrypto/x509/x509_trs.c","lib/libcrypto/x509/x509_trs.c","obj_trust",324,348
117,55,477,1,118,"X509_verify_cert_error_string@71-189@lib/libcrypto/x509/x509_txt.c","lib/libcrypto/x509/x509_txt.c","X509_verify_cert_error_string",71,189
6,2,31,1,5,"X509v3_get_ext_count@70-75@lib/libcrypto/x509/x509_v3.c","lib/libcrypto/x509/x509_v3.c","X509v3_get_ext_count",70,75
8,2,53,3,8,"X509v3_get_ext_by_NID@78-86@lib/libcrypto/x509/x509_v3.c","lib/libcrypto/x509/x509_v3.c","X509v3_get_ext_by_NID",78,86
18,5,103,3,18,"X509v3_get_ext_by_OBJ@89-107@lib/libcrypto/x509/x509_v3.c","lib/libcrypto/x509/x509_v3.c","X509v3_get_ext_by_OBJ",89,107
19,8,116,3,19,"X509v3_get_ext_by_critical@110-129@lib/libcrypto/x509/x509_v3.c","lib/libcrypto/x509/x509_v3.c","X509v3_get_ext_by_critical",110,129
7,4,44,2,6,"X509v3_get_ext@132-138@lib/libcrypto/x509/x509_v3.c","lib/libcrypto/x509/x509_v3.c","X509v3_get_ext",132,138
8,4,54,2,8,"X509v3_delete_ext@141-149@lib/libcrypto/x509/x509_v3.c","lib/libcrypto/x509/x509_v3.c","X509v3_delete_ext",141,149
35,13,205,3,39,"X509v3_add_ext@152-191@lib/libcrypto/x509/x509_v3.c","lib/libcrypto/x509/x509_v3.c","X509v3_add_ext",152,191
15,3,80,4,15,"X509_EXTENSION_create_by_NID@194-209@lib/libcrypto/x509/x509_v3.c","lib/libcrypto/x509/x509_v3.c","X509_EXTENSION_create_by_NID",194,209
25,11,161,4,28,"X509_EXTENSION_create_by_OBJ@212-240@lib/libcrypto/x509/x509_v3.c","lib/libcrypto/x509/x509_v3.c","X509_EXTENSION_create_by_OBJ",212,240
8,3,54,2,7,"X509_EXTENSION_set_object@243-250@lib/libcrypto/x509/x509_v3.c","lib/libcrypto/x509/x509_v3.c","X509_EXTENSION_set_object",243,250
7,3,40,2,6,"X509_EXTENSION_set_critical@253-259@lib/libcrypto/x509/x509_v3.c","lib/libcrypto/x509/x509_v3.c","X509_EXTENSION_set_critical",253,259
10,3,58,2,10,"X509_EXTENSION_set_data@262-272@lib/libcrypto/x509/x509_v3.c","lib/libcrypto/x509/x509_v3.c","X509_EXTENSION_set_data",262,272
6,2,26,1,5,"X509_EXTENSION_get_object@275-280@lib/libcrypto/x509/x509_v3.c","lib/libcrypto/x509/x509_v3.c","X509_EXTENSION_get_object",275,280
6,2,26,1,5,"X509_EXTENSION_get_data@283-288@lib/libcrypto/x509/x509_v3.c","lib/libcrypto/x509/x509_v3.c","X509_EXTENSION_get_data",283,288
8,3,33,1,7,"X509_EXTENSION_get_critical@291-298@lib/libcrypto/x509/x509_v3.c","lib/libcrypto/x509/x509_v3.c","X509_EXTENSION_get_critical",291,298
4,1,14,2,3,"null_callback@149-152@lib/libcrypto/x509/x509_vfy.c","lib/libcrypto/x509/x509_vfy.c","null_callback",149,152
4,1,22,2,3,"x509_subject_cmp@156-159@lib/libcrypto/x509/x509_vfy.c","lib/libcrypto/x509/x509_vfy.c","x509_subject_cmp",156,159
8,2,33,1,7,"cert_self_signed@164-171@lib/libcrypto/x509/x509_vfy.c","lib/libcrypto/x509/x509_vfy.c","cert_self_signed",164,171
7,1,41,2,6,"check_id_error@174-180@lib/libcrypto/x509/x509_vfy.c","lib/libcrypto/x509/x509_vfy.c","check_id_error",174,180
15,3,101,2,16,"check_hosts@183-199@lib/libcrypto/x509/x509_vfy.c","lib/libcrypto/x509/x509_vfy.c","check_hosts",183,199
20,10,145,1,20,"check_id@202-222@lib/libcrypto/x509/x509_vfy.c","lib/libcrypto/x509/x509_vfy.c","check_id",202,222
212,55,1229,1,325,"X509_verify_cert@225-550@lib/libcrypto/x509/x509_vfy.c","lib/libcrypto/x509/x509_vfy.c","X509_verify_cert",225,550
14,4,94,3,14,"find_issuer@556-570@lib/libcrypto/x509/x509_vfy.c","lib/libcrypto/x509/x509_vfy.c","find_issuer",556,570
13,3,81,3,15,"check_issued@575-590@lib/libcrypto/x509/x509_vfy.c","lib/libcrypto/x509/x509_vfy.c","check_issued",575,590
9,2,59,3,8,"get_issuer_sk@595-603@lib/libcrypto/x509/x509_vfy.c","lib/libcrypto/x509/x509_vfy.c","get_issuer_sk",595,603
117,36,678,1,140,"check_chain_extensions@610-750@lib/libcrypto/x509/x509_vfy.c","lib/libcrypto/x509/x509_vfy.c","check_chain_extensions",610,750
24,8,162,1,31,"check_name_constraints@753-784@lib/libcrypto/x509/x509_vfy.c","lib/libcrypto/x509/x509_vfy.c","check_name_constraints",753,784
20,5,119,2,25,"lookup_cert_match@788-813@lib/libcrypto/x509/x509_vfy.c","lib/libcrypto/x509/x509_vfy.c","lookup_cert_match",788,813
36,8,232,1,52,"check_trust@815-867@lib/libcrypto/x509/x509_vfy.c","lib/libcrypto/x509/x509_vfy.c","check_trust",815,867
20,6,107,1,21,"check_revocation@870-891@lib/libcrypto/x509/x509_vfy.c","lib/libcrypto/x509/x509_vfy.c","check_revocation",870,891
58,11,334,1,70,"check_cert@894-964@lib/libcrypto/x509/x509_vfy.c","lib/libcrypto/x509/x509_vfy.c","check_cert",894,964
47,19,273,3,56,"check_crl_time@969-1025@lib/libcrypto/x509/x509_vfy.c","lib/libcrypto/x509/x509_vfy.c","check_crl_time",969,1025
38,7,247,7,42,"get_crl_sk@1028-1070@lib/libcrypto/x509/x509_vfy.c","lib/libcrypto/x509/x509_vfy.c","get_crl_sk",1028,1070
26,10,170,3,33,"crl_extension_match@1077-1110@lib/libcrypto/x509/x509_vfy.c","lib/libcrypto/x509/x509_vfy.c","crl_extension_match",1077,1110
19,8,119,2,24,"check_delta_base@1115-1139@lib/libcrypto/x509/x509_vfy.c","lib/libcrypto/x509/x509_vfy.c","check_delta_base",1115,1139
21,6,148,5,21,"get_delta_sk@1146-1167@lib/libcrypto/x509/x509_vfy.c","lib/libcrypto/x509/x509_vfy.c","get_delta_sk",1146,1167
37,14,249,5,58,"get_crl_score@1177-1235@lib/libcrypto/x509/x509_vfy.c","lib/libcrypto/x509/x509_vfy.c","get_crl_score",1177,1235
40,11,270,4,50,"crl_akid_check@1238-1288@lib/libcrypto/x509/x509_vfy.c","lib/libcrypto/x509/x509_vfy.c","crl_akid_check",1238,1288
22,4,131,2,32,"check_crl_path@1298-1330@lib/libcrypto/x509/x509_vfy.c","lib/libcrypto/x509/x509_vfy.c","check_crl_path",1298,1330
10,2,73,3,10,"check_crl_chain@1341-1351@lib/libcrypto/x509/x509_vfy.c","lib/libcrypto/x509/x509_vfy.c","check_crl_chain",1341,1351
47,17,306,2,56,"idp_check_dp@1361-1417@lib/libcrypto/x509/x509_vfy.c","lib/libcrypto/x509/x509_vfy.c","idp_check_dp",1361,1417
15,5,106,3,16,"crldp_check_crlissuer@1420-1436@lib/libcrypto/x509/x509_vfy.c","lib/libcrypto/x509/x509_vfy.c","crldp_check_crlissuer",1420,1436
28,12,182,4,28,"crl_crldp_check@1441-1469@lib/libcrypto/x509/x509_vfy.c","lib/libcrypto/x509/x509_vfy.c","crl_crldp_check",1441,1469
30,5,196,4,40,"get_crl_delta@1476-1516@lib/libcrypto/x509/x509_vfy.c","lib/libcrypto/x509/x509_vfy.c","get_crl_delta",1476,1516
76,23,454,2,98,"check_crl@1520-1618@lib/libcrypto/x509/x509_vfy.c","lib/libcrypto/x509/x509_vfy.c","check_crl",1520,1618
21,7,124,3,30,"cert_crl@1622-1652@lib/libcrypto/x509/x509_vfy.c","lib/libcrypto/x509/x509_vfy.c","cert_crl",1622,1652
38,10,230,1,44,"check_policy@1655-1699@lib/libcrypto/x509/x509_vfy.c","lib/libcrypto/x509/x509_vfy.c","check_policy",1655,1699
8,3,67,4,7,"verify_cb_cert@1713-1720@lib/libcrypto/x509/x509_vfy.c","lib/libcrypto/x509/x509_vfy.c","verify_cb_cert",1713,1720
30,15,199,3,32,"x509_check_cert_time@1731-1763@lib/libcrypto/x509/x509_vfy.c","lib/libcrypto/x509/x509_vfy.c","x509_check_cert_time",1731,1763
51,15,304,1,73,"internal_verify@1766-1839@lib/libcrypto/x509/x509_vfy.c","lib/libcrypto/x509/x509_vfy.c","internal_verify",1766,1839
4,1,17,1,3,"X509_cmp_current_time@1842-1845@lib/libcrypto/x509/x509_vfy.c","lib/libcrypto/x509/x509_vfy.c","X509_cmp_current_time",1842,1845
32,12,208,3,46,"X509_cmp_time_internal@1861-1907@lib/libcrypto/x509/x509_vfy.c","lib/libcrypto/x509/x509_vfy.c","X509_cmp_time_internal",1861,1907
4,1,23,2,3,"X509_cmp_time@1910-1913@lib/libcrypto/x509/x509_vfy.c","lib/libcrypto/x509/x509_vfy.c","X509_cmp_time",1910,1913
4,1,21,2,3,"X509_gmtime_adj@1917-1920@lib/libcrypto/x509/x509_vfy.c","lib/libcrypto/x509/x509_vfy.c","X509_gmtime_adj",1917,1920
4,1,27,3,3,"X509_time_adj@1923-1926@lib/libcrypto/x509/x509_vfy.c","lib/libcrypto/x509/x509_vfy.c","X509_time_adj",1923,1926
9,2,52,4,9,"X509_time_adj_ex@1929-1938@lib/libcrypto/x509/x509_vfy.c","lib/libcrypto/x509/x509_vfy.c","X509_time_adj_ex",1929,1938
33,9,192,2,37,"X509_get_pubkey_parameters@1941-1978@lib/libcrypto/x509/x509_vfy.c","lib/libcrypto/x509/x509_vfy.c","X509_get_pubkey_parameters",1941,1978
6,1,39,5,7,"X509_STORE_CTX_get_ex_new_index@1981-1988@lib/libcrypto/x509/x509_vfy.c","lib/libcrypto/x509/x509_vfy.c","X509_STORE_CTX_get_ex_new_index",1981,1988
4,1,28,3,3,"X509_STORE_CTX_set_ex_data@1991-1994@lib/libcrypto/x509/x509_vfy.c","lib/libcrypto/x509/x509_vfy.c","X509_STORE_CTX_set_ex_data",1991,1994
4,1,22,2,3,"X509_STORE_CTX_get_ex_data@1997-2000@lib/libcrypto/x509/x509_vfy.c","lib/libcrypto/x509/x509_vfy.c","X509_STORE_CTX_get_ex_data",1997,2000
4,1,13,1,3,"X509_STORE_CTX_get_error@2003-2006@lib/libcrypto/x509/x509_vfy.c","lib/libcrypto/x509/x509_vfy.c","X509_STORE_CTX_get_error",2003,2006
4,1,17,2,3,"X509_STORE_CTX_set_error@2009-2012@lib/libcrypto/x509/x509_vfy.c","lib/libcrypto/x509/x509_vfy.c","X509_STORE_CTX_set_error",2009,2012
4,1,13,1,3,"X509_STORE_CTX_get_error_depth@2015-2018@lib/libcrypto/x509/x509_vfy.c","lib/libcrypto/x509/x509_vfy.c","X509_STORE_CTX_get_error_depth",2015,2018
4,1,13,1,3,"X509_STORE_CTX_get_current_cert@2021-2024@lib/libcrypto/x509/x509_vfy.c","lib/libcrypto/x509/x509_vfy.c","X509_STORE_CTX_get_current_cert",2021,2024
4,1,13,1,3,"X509_STORE_CTX_get_chain@2026-2029@lib/libcrypto/x509/x509_vfy.c","lib/libcrypto/x509/x509_vfy.c","X509_STORE_CTX_get_chain",2026,2029
13,4,86,1,13,"X509_STORE_CTX_get1_chain@2031-2044@lib/libcrypto/x509/x509_vfy.c","lib/libcrypto/x509/x509_vfy.c","X509_STORE_CTX_get1_chain",2031,2044
4,1,13,1,3,"X509_STORE_CTX_get0_current_issuer@2047-2050@lib/libcrypto/x509/x509_vfy.c","lib/libcrypto/x509/x509_vfy.c","X509_STORE_CTX_get0_current_issuer",2047,2050
4,1,13,1,3,"X509_STORE_CTX_get0_current_crl@2053-2056@lib/libcrypto/x509/x509_vfy.c","lib/libcrypto/x509/x509_vfy.c","X509_STORE_CTX_get0_current_crl",2053,2056
4,1,13,1,3,"X509_STORE_CTX_get0_parent_ctx@2059-2062@lib/libcrypto/x509/x509_vfy.c","lib/libcrypto/x509/x509_vfy.c","X509_STORE_CTX_get0_parent_ctx",2059,2062
4,1,18,2,3,"X509_STORE_CTX_set_cert@2065-2068@lib/libcrypto/x509/x509_vfy.c","lib/libcrypto/x509/x509_vfy.c","X509_STORE_CTX_set_cert",2065,2068
4,1,21,2,3,"X509_STORE_CTX_set_chain@2071-2074@lib/libcrypto/x509/x509_vfy.c","lib/libcrypto/x509/x509_vfy.c","X509_STORE_CTX_set_chain",2071,2074
4,1,21,2,3,"X509_STORE_CTX_set0_crls@2077-2080@lib/libcrypto/x509/x509_vfy.c","lib/libcrypto/x509/x509_vfy.c","X509_STORE_CTX_set0_crls",2077,2080
4,1,23,2,3,"X509_STORE_CTX_set_purpose@2083-2086@lib/libcrypto/x509/x509_vfy.c","lib/libcrypto/x509/x509_vfy.c","X509_STORE_CTX_set_purpose",2083,2086
4,1,23,2,3,"X509_STORE_CTX_set_trust@2089-2092@lib/libcrypto/x509/x509_vfy.c","lib/libcrypto/x509/x509_vfy.c","X509_STORE_CTX_set_trust",2089,2092
38,13,193,4,42,"X509_STORE_CTX_purpose_inherit@2105-2147@lib/libcrypto/x509/x509_vfy.c","lib/libcrypto/x509/x509_vfy.c","X509_STORE_CTX_purpose_inherit",2105,2147
10,2,40,1,10,"X509_STORE_CTX_new@2150-2160@lib/libcrypto/x509/x509_vfy.c","lib/libcrypto/x509/x509_vfy.c","X509_STORE_CTX_new",2150,2160
7,2,26,1,7,"X509_STORE_CTX_free@2163-2170@lib/libcrypto/x509/x509_vfy.c","lib/libcrypto/x509/x509_vfy.c","X509_STORE_CTX_free",2163,2170
77,28,442,4,118,"X509_STORE_CTX_init@2173-2291@lib/libcrypto/x509/x509_vfy.c","lib/libcrypto/x509/x509_vfy.c","X509_STORE_CTX_init",2173,2291
5,1,27,2,4,"X509_STORE_CTX_trusted_stack@2298-2302@lib/libcrypto/x509/x509_vfy.c","lib/libcrypto/x509/x509_vfy.c","X509_STORE_CTX_trusted_stack",2298,2302
21,6,129,1,20,"X509_STORE_CTX_cleanup@2305-2325@lib/libcrypto/x509/x509_vfy.c","lib/libcrypto/x509/x509_vfy.c","X509_STORE_CTX_cleanup",2305,2325
4,1,20,2,3,"X509_STORE_CTX_set_depth@2328-2331@lib/libcrypto/x509/x509_vfy.c","lib/libcrypto/x509/x509_vfy.c","X509_STORE_CTX_set_depth",2328,2331
4,1,21,2,3,"X509_STORE_CTX_set_flags@2334-2337@lib/libcrypto/x509/x509_vfy.c","lib/libcrypto/x509/x509_vfy.c","X509_STORE_CTX_set_flags",2334,2337
4,1,24,3,3,"X509_STORE_CTX_set_time@2340-2343@lib/libcrypto/x509/x509_vfy.c","lib/libcrypto/x509/x509_vfy.c","X509_STORE_CTX_set_time",2340,2343
5,1,26,2,4,"X509_STORE_CTX_set_verify_cb@2346-2350@lib/libcrypto/x509/x509_vfy.c","lib/libcrypto/x509/x509_vfy.c","X509_STORE_CTX_set_verify_cb",2346,2350
4,1,13,1,3,"X509_STORE_CTX_get0_policy_tree@2353-2356@lib/libcrypto/x509/x509_vfy.c","lib/libcrypto/x509/x509_vfy.c","X509_STORE_CTX_get0_policy_tree",2353,2356
4,1,13,1,3,"X509_STORE_CTX_get_explicit_policy@2359-2362@lib/libcrypto/x509/x509_vfy.c","lib/libcrypto/x509/x509_vfy.c","X509_STORE_CTX_get_explicit_policy",2359,2362
8,2,43,2,7,"X509_STORE_CTX_set_default@2365-2372@lib/libcrypto/x509/x509_vfy.c","lib/libcrypto/x509/x509_vfy.c","X509_STORE_CTX_set_default",2365,2372
4,1,13,1,3,"X509_STORE_CTX_get0_param@2375-2378@lib/libcrypto/x509/x509_vfy.c","lib/libcrypto/x509/x509_vfy.c","X509_STORE_CTX_get0_param",2375,2378
6,2,31,2,5,"X509_STORE_CTX_set0_param@2381-2386@lib/libcrypto/x509/x509_vfy.c","lib/libcrypto/x509/x509_vfy.c","X509_STORE_CTX_set0_param",2381,2386
4,1,13,1,3,"str_free@82-85@lib/libcrypto/x509/x509_vpm.c","lib/libcrypto/x509/x509_vpm.c","str_free",82,85
25,7,178,3,27,"sk_deep_copy@98-125@lib/libcrypto/x509/x509_vpm.c","lib/libcrypto/x509/x509_vpm.c","sk_deep_copy",98,125
30,11,176,4,38,"int_x509_param_set_hosts@128-166@lib/libcrypto/x509/x509_vpm.c","lib/libcrypto/x509/x509_vpm.c","int_x509_param_set_hosts",128,166
29,4,157,1,29,"x509_verify_param_zero@169-198@lib/libcrypto/x509/x509_vpm.c","lib/libcrypto/x509/x509_vpm.c","x509_verify_param_zero",169,198
16,3,77,1,15,"X509_VERIFY_PARAM_new@201-216@lib/libcrypto/x509/x509_vpm.c","lib/libcrypto/x509/x509_vpm.c","X509_VERIFY_PARAM_new",201,216
8,2,33,1,7,"X509_VERIFY_PARAM_free@219-226@lib/libcrypto/x509/x509_vpm.c","lib/libcrypto/x509/x509_vpm.c","X509_VERIFY_PARAM_free",219,226
59,19,347,2,76,"X509_VERIFY_PARAM_inherit@277-353@lib/libcrypto/x509/x509_vpm.c","lib/libcrypto/x509/x509_vpm.c","X509_VERIFY_PARAM_inherit",277,353
9,1,48,2,9,"X509_VERIFY_PARAM_set1@356-365@lib/libcrypto/x509/x509_vpm.c","lib/libcrypto/x509/x509_vpm.c","X509_VERIFY_PARAM_set1",356,365
25,7,128,4,24,"int_x509_param_set1@368-392@lib/libcrypto/x509/x509_vpm.c","lib/libcrypto/x509/x509_vpm.c","int_x509_param_set1",368,392
11,3,56,2,10,"X509_VERIFY_PARAM_set1_name@395-405@lib/libcrypto/x509/x509_vpm.c","lib/libcrypto/x509/x509_vpm.c","X509_VERIFY_PARAM_set1_name",395,405
7,2,33,2,6,"X509_VERIFY_PARAM_set_flags@408-414@lib/libcrypto/x509/x509_vpm.c","lib/libcrypto/x509/x509_vpm.c","X509_VERIFY_PARAM_set_flags",408,414
5,1,21,2,4,"X509_VERIFY_PARAM_clear_flags@417-421@lib/libcrypto/x509/x509_vpm.c","lib/libcrypto/x509/x509_vpm.c","X509_VERIFY_PARAM_clear_flags",417,421
4,1,13,1,3,"X509_VERIFY_PARAM_get_flags@424-427@lib/libcrypto/x509/x509_vpm.c","lib/libcrypto/x509/x509_vpm.c","X509_VERIFY_PARAM_get_flags",424,427
4,1,22,2,3,"X509_VERIFY_PARAM_set_purpose@430-433@lib/libcrypto/x509/x509_vpm.c","lib/libcrypto/x509/x509_vpm.c","X509_VERIFY_PARAM_set_purpose",430,433
4,1,22,2,3,"X509_VERIFY_PARAM_set_trust@436-439@lib/libcrypto/x509/x509_vpm.c","lib/libcrypto/x509/x509_vpm.c","X509_VERIFY_PARAM_set_trust",436,439
4,1,17,2,3,"X509_VERIFY_PARAM_set_depth@442-445@lib/libcrypto/x509/x509_vpm.c","lib/libcrypto/x509/x509_vpm.c","X509_VERIFY_PARAM_set_depth",442,445
5,1,23,2,4,"X509_VERIFY_PARAM_set_time@448-452@lib/libcrypto/x509/x509_vpm.c","lib/libcrypto/x509/x509_vpm.c","X509_VERIFY_PARAM_set_time",448,452
11,4,57,2,10,"X509_VERIFY_PARAM_add0_policy@455-465@lib/libcrypto/x509/x509_vpm.c","lib/libcrypto/x509/x509_vpm.c","X509_VERIFY_PARAM_add0_policy",455,465
29,8,155,2,32,"X509_VERIFY_PARAM_set1_policies@468-500@lib/libcrypto/x509/x509_vpm.c","lib/libcrypto/x509/x509_vpm.c","X509_VERIFY_PARAM_set1_policies",468,500
5,1,30,3,4,"X509_VERIFY_PARAM_set1_host@503-507@lib/libcrypto/x509/x509_vpm.c","lib/libcrypto/x509/x509_vpm.c","X509_VERIFY_PARAM_set1_host",503,507
5,1,30,3,4,"X509_VERIFY_PARAM_add1_host@510-514@lib/libcrypto/x509/x509_vpm.c","lib/libcrypto/x509/x509_vpm.c","X509_VERIFY_PARAM_add1_host",510,514
4,1,20,2,3,"X509_VERIFY_PARAM_set_hostflags@517-520@lib/libcrypto/x509/x509_vpm.c","lib/libcrypto/x509/x509_vpm.c","X509_VERIFY_PARAM_set_hostflags",517,520
4,1,15,1,3,"X509_VERIFY_PARAM_get0_peername@523-526@lib/libcrypto/x509/x509_vpm.c","lib/libcrypto/x509/x509_vpm.c","X509_VERIFY_PARAM_get0_peername",523,526
6,1,38,3,5,"X509_VERIFY_PARAM_set1_email@529-534@lib/libcrypto/x509/x509_vpm.c","lib/libcrypto/x509/x509_vpm.c","X509_VERIFY_PARAM_set1_email",529,534
8,4,64,3,7,"X509_VERIFY_PARAM_set1_ip@537-544@lib/libcrypto/x509/x509_vpm.c","lib/libcrypto/x509/x509_vpm.c","X509_VERIFY_PARAM_set1_ip",537,544
9,2,54,2,9,"X509_VERIFY_PARAM_set1_ip_asc@547-556@lib/libcrypto/x509/x509_vpm.c","lib/libcrypto/x509/x509_vpm.c","X509_VERIFY_PARAM_set1_ip_asc",547,556
4,1,14,1,3,"X509_VERIFY_PARAM_get_depth@559-562@lib/libcrypto/x509/x509_vpm.c","lib/libcrypto/x509/x509_vpm.c","X509_VERIFY_PARAM_get_depth",559,562
4,1,14,1,3,"X509_VERIFY_PARAM_get0_name@565-568@lib/libcrypto/x509/x509_vpm.c","lib/libcrypto/x509/x509_vpm.c","X509_VERIFY_PARAM_get0_name",565,568
5,1,36,2,4,"param_cmp@619-623@lib/libcrypto/x509/x509_vpm.c","lib/libcrypto/x509/x509_vpm.c","param_cmp",619,623
22,5,98,1,22,"X509_VERIFY_PARAM_add0_table@626-648@lib/libcrypto/x509/x509_vpm.c","lib/libcrypto/x509/x509_vpm.c","X509_VERIFY_PARAM_add0_table",626,648
7,2,33,1,6,"X509_VERIFY_PARAM_get_count@651-657@lib/libcrypto/x509/x509_vpm.c","lib/libcrypto/x509/x509_vpm.c","X509_VERIFY_PARAM_get_count",651,657
7,2,41,1,6,"X509_VERIFY_PARAM_get0@660-666@lib/libcrypto/x509/x509_vpm.c","lib/libcrypto/x509/x509_vpm.c","X509_VERIFY_PARAM_get0",660,666
18,5,117,1,19,"X509_VERIFY_PARAM_lookup@669-688@lib/libcrypto/x509/x509_vpm.c","lib/libcrypto/x509/x509_vpm.c","X509_VERIFY_PARAM_lookup",669,688
7,2,21,1,6,"X509_VERIFY_PARAM_table_cleanup@691-697@lib/libcrypto/x509/x509_vpm.c","lib/libcrypto/x509/x509_vpm.c","X509_VERIFY_PARAM_table_cleanup",691,697
10,4,69,2,9,"X509_CRL_set_version@67-76@lib/libcrypto/x509/x509cset.c","lib/libcrypto/x509/x509cset.c","X509_CRL_set_version",67,76
6,3,48,2,5,"X509_CRL_set_issuer_name@79-84@lib/libcrypto/x509/x509cset.c","lib/libcrypto/x509/x509cset.c","X509_CRL_set_issuer_name",79,84
15,4,83,2,15,"X509_CRL_set_lastUpdate@87-102@lib/libcrypto/x509/x509cset.c","lib/libcrypto/x509/x509cset.c","X509_CRL_set_lastUpdate",87,102
15,4,83,2,15,"X509_CRL_set_nextUpdate@105-120@lib/libcrypto/x509/x509cset.c","lib/libcrypto/x509/x509cset.c","X509_CRL_set_nextUpdate",105,120
12,2,78,1,14,"X509_CRL_sort@123-137@lib/libcrypto/x509/x509cset.c","lib/libcrypto/x509/x509cset.c","X509_CRL_sort",123,137
15,4,76,2,15,"X509_REVOKED_set_revocationDate@140-155@lib/libcrypto/x509/x509cset.c","lib/libcrypto/x509/x509cset.c","X509_REVOKED_set_revocationDate",140,155
15,4,76,2,15,"X509_REVOKED_set_serialNumber@158-173@lib/libcrypto/x509/x509cset.c","lib/libcrypto/x509/x509cset.c","X509_REVOKED_set_serialNumber",158,173
8,2,55,4,8,"X509_NAME_get_text_by_NID@70-78@lib/libcrypto/x509/x509name.c","lib/libcrypto/x509/x509name.c","X509_NAME_get_text_by_NID",70,78
18,5,130,4,18,"X509_NAME_get_text_by_OBJ@81-99@lib/libcrypto/x509/x509name.c","lib/libcrypto/x509/x509name.c","X509_NAME_get_text_by_OBJ",81,99
6,2,29,1,5,"X509_NAME_entry_count@102-107@lib/libcrypto/x509/x509name.c","lib/libcrypto/x509/x509name.c","X509_NAME_entry_count",102,107
8,2,49,3,8,"X509_NAME_get_index_by_NID@110-118@lib/libcrypto/x509/x509name.c","lib/libcrypto/x509/x509name.c","X509_NAME_get_index_by_NID",110,118
18,5,112,3,18,"X509_NAME_get_index_by_OBJ@122-140@lib/libcrypto/x509/x509name.c","lib/libcrypto/x509/x509name.c","X509_NAME_get_index_by_OBJ",122,140
8,4,48,2,7,"X509_NAME_get_entry@143-150@lib/libcrypto/x509/x509name.c","lib/libcrypto/x509/x509name.c","X509_NAME_get_entry",143,150
24,8,171,2,35,"X509_NAME_delete_entry@153-188@lib/libcrypto/x509/x509name.c","lib/libcrypto/x509/x509name.c","X509_NAME_delete_entry",153,188
12,2,80,7,12,"X509_NAME_add_entry_by_OBJ@191-203@lib/libcrypto/x509/x509name.c","lib/libcrypto/x509/x509name.c","X509_NAME_add_entry_by_OBJ",191,203
12,2,79,7,12,"X509_NAME_add_entry_by_NID@206-218@lib/libcrypto/x509/x509name.c","lib/libcrypto/x509/x509name.c","X509_NAME_add_entry_by_NID",206,218
12,2,82,7,12,"X509_NAME_add_entry_by_txt@221-233@lib/libcrypto/x509/x509name.c","lib/libcrypto/x509/x509name.c","X509_NAME_add_entry_by_txt",221,233
50,14,303,4,54,"X509_NAME_add_entry@238-292@lib/libcrypto/x509/x509name.c","lib/libcrypto/x509/x509name.c","X509_NAME_add_entry",238,292
15,2,90,5,15,"X509_NAME_ENTRY_create_by_txt@295-310@lib/libcrypto/x509/x509name.c","lib/libcrypto/x509/x509name.c","X509_NAME_ENTRY_create_by_txt",295,310
14,2,78,5,14,"X509_NAME_ENTRY_create_by_NID@313-327@lib/libcrypto/x509/x509name.c","lib/libcrypto/x509/x509name.c","X509_NAME_ENTRY_create_by_NID",313,327
21,10,150,5,24,"X509_NAME_ENTRY_create_by_OBJ@330-354@lib/libcrypto/x509/x509name.c","lib/libcrypto/x509/x509name.c","X509_NAME_ENTRY_create_by_OBJ",330,354
10,4,69,2,9,"X509_NAME_ENTRY_set_object@357-366@lib/libcrypto/x509/x509name.c","lib/libcrypto/x509/x509name.c","X509_NAME_ENTRY_set_object",357,366
22,11,172,4,22,"X509_NAME_ENTRY_set_data@369-391@lib/libcrypto/x509/x509name.c","lib/libcrypto/x509/x509name.c","X509_NAME_ENTRY_set_data",369,391
6,2,26,1,5,"X509_NAME_ENTRY_get_object@394-399@lib/libcrypto/x509/x509name.c","lib/libcrypto/x509/x509name.c","X509_NAME_ENTRY_get_object",394,399
6,2,26,1,5,"X509_NAME_ENTRY_get_data@402-407@lib/libcrypto/x509/x509name.c","lib/libcrypto/x509/x509name.c","X509_NAME_ENTRY_get_data",402,407
6,2,36,2,5,"X509_REQ_set_version@67-72@lib/libcrypto/x509/x509rset.c","lib/libcrypto/x509/x509rset.c","X509_REQ_set_version",67,72
6,3,48,2,5,"X509_REQ_set_subject_name@75-80@lib/libcrypto/x509/x509rset.c","lib/libcrypto/x509/x509rset.c","X509_REQ_set_subject_name",75,80
6,3,48,2,5,"X509_REQ_set_pubkey@83-88@lib/libcrypto/x509/x509rset.c","lib/libcrypto/x509/x509rset.c","X509_REQ_set_pubkey",83,88
6,3,50,2,5,"NETSCAPE_SPKI_set_pubkey@66-71@lib/libcrypto/x509/x509spki.c","lib/libcrypto/x509/x509spki.c","NETSCAPE_SPKI_set_pubkey",66,71
6,3,41,1,5,"NETSCAPE_SPKI_get_pubkey@74-79@lib/libcrypto/x509/x509spki.c","lib/libcrypto/x509/x509spki.c","NETSCAPE_SPKI_get_pubkey",74,79
23,4,129,2,23,"NETSCAPE_SPKI_b64_decode@84-107@lib/libcrypto/x509/x509spki.c","lib/libcrypto/x509/x509spki.c","NETSCAPE_SPKI_b64_decode",84,107
20,3,112,1,19,"NETSCAPE_SPKI_b64_encode@112-131@lib/libcrypto/x509/x509spki.c","lib/libcrypto/x509/x509spki.c","NETSCAPE_SPKI_b64_encode",112,131
57,19,240,2,64,"X509_certificate_type@66-130@lib/libcrypto/x509/x509type.c","lib/libcrypto/x509/x509type.c","X509_certificate_type",66,130
4,1,23,2,3,"d2i_X509_bio@77-80@lib/libcrypto/x509/x_all.c","lib/libcrypto/x509/x_all.c","d2i_X509_bio",77,80
4,1,23,2,3,"i2d_X509_bio@83-86@lib/libcrypto/x509/x_all.c","lib/libcrypto/x509/x_all.c","i2d_X509_bio",83,86
4,1,23,2,3,"d2i_X509_fp@89-92@lib/libcrypto/x509/x_all.c","lib/libcrypto/x509/x_all.c","d2i_X509_fp",89,92
4,1,23,2,3,"i2d_X509_fp@95-98@lib/libcrypto/x509/x_all.c","lib/libcrypto/x509/x_all.c","i2d_X509_fp",95,98
4,1,23,2,3,"d2i_X509_CRL_bio@101-104@lib/libcrypto/x509/x_all.c","lib/libcrypto/x509/x_all.c","d2i_X509_CRL_bio",101,104
4,1,23,2,3,"i2d_X509_CRL_bio@107-110@lib/libcrypto/x509/x_all.c","lib/libcrypto/x509/x_all.c","i2d_X509_CRL_bio",107,110
4,1,23,2,3,"d2i_X509_CRL_fp@113-116@lib/libcrypto/x509/x_all.c","lib/libcrypto/x509/x_all.c","d2i_X509_CRL_fp",113,116
4,1,23,2,3,"i2d_X509_CRL_fp@119-122@lib/libcrypto/x509/x_all.c","lib/libcrypto/x509/x_all.c","i2d_X509_CRL_fp",119,122
4,1,23,2,3,"d2i_PKCS7_bio@125-128@lib/libcrypto/x509/x_all.c","lib/libcrypto/x509/x_all.c","d2i_PKCS7_bio",125,128
4,1,23,2,3,"i2d_PKCS7_bio@131-134@lib/libcrypto/x509/x_all.c","lib/libcrypto/x509/x_all.c","i2d_PKCS7_bio",131,134
4,1,23,2,3,"d2i_PKCS7_fp@137-140@lib/libcrypto/x509/x_all.c","lib/libcrypto/x509/x_all.c","d2i_PKCS7_fp",137,140
4,1,23,2,3,"i2d_PKCS7_fp@143-146@lib/libcrypto/x509/x_all.c","lib/libcrypto/x509/x_all.c","i2d_PKCS7_fp",143,146
4,1,23,2,3,"d2i_X509_REQ_bio@149-152@lib/libcrypto/x509/x_all.c","lib/libcrypto/x509/x_all.c","d2i_X509_REQ_bio",149,152
4,1,23,2,3,"i2d_X509_REQ_bio@155-158@lib/libcrypto/x509/x_all.c","lib/libcrypto/x509/x_all.c","i2d_X509_REQ_bio",155,158
4,1,23,2,3,"d2i_X509_REQ_fp@161-164@lib/libcrypto/x509/x_all.c","lib/libcrypto/x509/x_all.c","d2i_X509_REQ_fp",161,164
4,1,23,2,3,"i2d_X509_REQ_fp@167-170@lib/libcrypto/x509/x_all.c","lib/libcrypto/x509/x_all.c","i2d_X509_REQ_fp",167,170
4,1,23,2,3,"d2i_RSAPrivateKey_bio@174-177@lib/libcrypto/x509/x_all.c","lib/libcrypto/x509/x_all.c","d2i_RSAPrivateKey_bio",174,177
4,1,23,2,3,"i2d_RSAPrivateKey_bio@180-183@lib/libcrypto/x509/x_all.c","lib/libcrypto/x509/x_all.c","i2d_RSAPrivateKey_bio",180,183
4,1,23,2,3,"d2i_RSAPrivateKey_fp@186-189@lib/libcrypto/x509/x_all.c","lib/libcrypto/x509/x_all.c","d2i_RSAPrivateKey_fp",186,189
4,1,23,2,3,"i2d_RSAPrivateKey_fp@192-195@lib/libcrypto/x509/x_all.c","lib/libcrypto/x509/x_all.c","i2d_RSAPrivateKey_fp",192,195
4,1,23,2,3,"d2i_RSAPublicKey_bio@198-201@lib/libcrypto/x509/x_all.c","lib/libcrypto/x509/x_all.c","d2i_RSAPublicKey_bio",198,201
4,1,23,2,3,"i2d_RSAPublicKey_bio@204-207@lib/libcrypto/x509/x_all.c","lib/libcrypto/x509/x_all.c","i2d_RSAPublicKey_bio",204,207
4,1,23,2,3,"d2i_RSAPublicKey_fp@210-213@lib/libcrypto/x509/x_all.c","lib/libcrypto/x509/x_all.c","d2i_RSAPublicKey_fp",210,213
4,1,23,2,3,"i2d_RSAPublicKey_fp@216-219@lib/libcrypto/x509/x_all.c","lib/libcrypto/x509/x_all.c","i2d_RSAPublicKey_fp",216,219
4,1,26,2,3,"d2i_RSA_PUBKEY_bio@222-225@lib/libcrypto/x509/x_all.c","lib/libcrypto/x509/x_all.c","d2i_RSA_PUBKEY_bio",222,225
4,1,24,2,3,"i2d_RSA_PUBKEY_bio@228-231@lib/libcrypto/x509/x_all.c","lib/libcrypto/x509/x_all.c","i2d_RSA_PUBKEY_bio",228,231
4,1,28,2,3,"i2d_RSA_PUBKEY_fp@234-237@lib/libcrypto/x509/x_all.c","lib/libcrypto/x509/x_all.c","i2d_RSA_PUBKEY_fp",234,237
5,1,44,2,4,"d2i_RSA_PUBKEY_fp@240-244@lib/libcrypto/x509/x_all.c","lib/libcrypto/x509/x_all.c","d2i_RSA_PUBKEY_fp",240,244
4,1,23,2,3,"d2i_DSAPrivateKey_bio@249-252@lib/libcrypto/x509/x_all.c","lib/libcrypto/x509/x_all.c","d2i_DSAPrivateKey_bio",249,252
4,1,23,2,3,"i2d_DSAPrivateKey_bio@255-258@lib/libcrypto/x509/x_all.c","lib/libcrypto/x509/x_all.c","i2d_DSAPrivateKey_bio",255,258
4,1,23,2,3,"d2i_DSAPrivateKey_fp@261-264@lib/libcrypto/x509/x_all.c","lib/libcrypto/x509/x_all.c","d2i_DSAPrivateKey_fp",261,264
4,1,23,2,3,"i2d_DSAPrivateKey_fp@267-270@lib/libcrypto/x509/x_all.c","lib/libcrypto/x509/x_all.c","i2d_DSAPrivateKey_fp",267,270
4,1,26,2,3,"d2i_DSA_PUBKEY_bio@273-276@lib/libcrypto/x509/x_all.c","lib/libcrypto/x509/x_all.c","d2i_DSA_PUBKEY_bio",273,276
4,1,24,2,3,"i2d_DSA_PUBKEY_bio@279-282@lib/libcrypto/x509/x_all.c","lib/libcrypto/x509/x_all.c","i2d_DSA_PUBKEY_bio",279,282
4,1,26,2,3,"d2i_DSA_PUBKEY_fp@285-288@lib/libcrypto/x509/x_all.c","lib/libcrypto/x509/x_all.c","d2i_DSA_PUBKEY_fp",285,288
4,1,24,2,3,"i2d_DSA_PUBKEY_fp@291-294@lib/libcrypto/x509/x_all.c","lib/libcrypto/x509/x_all.c","i2d_DSA_PUBKEY_fp",291,294
4,1,26,2,3,"d2i_ECPrivateKey_bio@299-302@lib/libcrypto/x509/x_all.c","lib/libcrypto/x509/x_all.c","d2i_ECPrivateKey_bio",299,302
4,1,24,2,3,"i2d_ECPrivateKey_bio@305-308@lib/libcrypto/x509/x_all.c","lib/libcrypto/x509/x_all.c","i2d_ECPrivateKey_bio",305,308
4,1,26,2,3,"d2i_ECPrivateKey_fp@311-314@lib/libcrypto/x509/x_all.c","lib/libcrypto/x509/x_all.c","d2i_ECPrivateKey_fp",311,314
4,1,24,2,3,"i2d_ECPrivateKey_fp@317-320@lib/libcrypto/x509/x_all.c","lib/libcrypto/x509/x_all.c","i2d_ECPrivateKey_fp",317,320
4,1,26,2,3,"d2i_EC_PUBKEY_bio@323-326@lib/libcrypto/x509/x_all.c","lib/libcrypto/x509/x_all.c","d2i_EC_PUBKEY_bio",323,326
4,1,24,2,3,"i2d_EC_PUBKEY_bio@329-332@lib/libcrypto/x509/x_all.c","lib/libcrypto/x509/x_all.c","i2d_EC_PUBKEY_bio",329,332
4,1,26,2,3,"d2i_EC_PUBKEY_fp@334-337@lib/libcrypto/x509/x_all.c","lib/libcrypto/x509/x_all.c","d2i_EC_PUBKEY_fp",334,337
4,1,24,2,3,"i2d_EC_PUBKEY_fp@340-343@lib/libcrypto/x509/x_all.c","lib/libcrypto/x509/x_all.c","i2d_EC_PUBKEY_fp",340,343
4,1,23,2,3,"d2i_PKCS8_bio@347-350@lib/libcrypto/x509/x_all.c","lib/libcrypto/x509/x_all.c","d2i_PKCS8_bio",347,350
4,1,23,2,3,"i2d_PKCS8_bio@353-356@lib/libcrypto/x509/x_all.c","lib/libcrypto/x509/x_all.c","i2d_PKCS8_bio",353,356
4,1,23,2,3,"d2i_PKCS8_fp@359-362@lib/libcrypto/x509/x_all.c","lib/libcrypto/x509/x_all.c","d2i_PKCS8_fp",359,362
4,1,23,2,3,"i2d_PKCS8_fp@365-368@lib/libcrypto/x509/x_all.c","lib/libcrypto/x509/x_all.c","i2d_PKCS8_fp",365,368
5,1,23,2,4,"d2i_PKCS8_PRIV_KEY_INFO_bio@371-375@lib/libcrypto/x509/x_all.c","lib/libcrypto/x509/x_all.c","d2i_PKCS8_PRIV_KEY_INFO_bio",371,375
5,1,23,2,4,"i2d_PKCS8_PRIV_KEY_INFO_bio@378-382@lib/libcrypto/x509/x_all.c","lib/libcrypto/x509/x_all.c","i2d_PKCS8_PRIV_KEY_INFO_bio",378,382
5,1,23,2,4,"d2i_PKCS8_PRIV_KEY_INFO_fp@385-389@lib/libcrypto/x509/x_all.c","lib/libcrypto/x509/x_all.c","d2i_PKCS8_PRIV_KEY_INFO_fp",385,389
5,1,23,2,4,"i2d_PKCS8_PRIV_KEY_INFO_fp@392-396@lib/libcrypto/x509/x_all.c","lib/libcrypto/x509/x_all.c","i2d_PKCS8_PRIV_KEY_INFO_fp",392,396
5,1,26,2,4,"d2i_PrivateKey_bio@399-403@lib/libcrypto/x509/x_all.c","lib/libcrypto/x509/x_all.c","d2i_PrivateKey_bio",399,403
4,1,24,2,3,"i2d_PrivateKey_bio@406-409@lib/libcrypto/x509/x_all.c","lib/libcrypto/x509/x_all.c","i2d_PrivateKey_bio",406,409
5,1,26,2,4,"d2i_PrivateKey_fp@412-416@lib/libcrypto/x509/x_all.c","lib/libcrypto/x509/x_all.c","d2i_PrivateKey_fp",412,416
4,1,24,2,3,"i2d_PrivateKey_fp@419-422@lib/libcrypto/x509/x_all.c","lib/libcrypto/x509/x_all.c","i2d_PrivateKey_fp",419,422
4,1,26,2,3,"d2i_PUBKEY_bio@425-428@lib/libcrypto/x509/x_all.c","lib/libcrypto/x509/x_all.c","d2i_PUBKEY_bio",425,428
4,1,24,2,3,"i2d_PUBKEY_bio@431-434@lib/libcrypto/x509/x_all.c","lib/libcrypto/x509/x_all.c","i2d_PUBKEY_bio",431,434
4,1,24,2,3,"i2d_PUBKEY_fp@437-440@lib/libcrypto/x509/x_all.c","lib/libcrypto/x509/x_all.c","i2d_PUBKEY_fp",437,440
4,1,26,2,3,"d2i_PUBKEY_fp@443-446@lib/libcrypto/x509/x_all.c","lib/libcrypto/x509/x_all.c","d2i_PUBKEY_fp",443,446
11,2,51,2,11,"i2d_PKCS8PrivateKeyInfo_bio@449-460@lib/libcrypto/x509/x_all.c","lib/libcrypto/x509/x_all.c","i2d_PKCS8PrivateKeyInfo_bio",449,460
11,2,51,2,10,"i2d_PKCS8PrivateKeyInfo_fp@463-473@lib/libcrypto/x509/x_all.c","lib/libcrypto/x509/x_all.c","i2d_PKCS8PrivateKeyInfo_fp",463,473
7,2,53,2,6,"X509_verify@476-482@lib/libcrypto/x509/x_all.c","lib/libcrypto/x509/x_all.c","X509_verify",476,482
5,1,35,2,4,"X509_REQ_verify@485-489@lib/libcrypto/x509/x_all.c","lib/libcrypto/x509/x_all.c","X509_REQ_verify",485,489
5,1,35,2,4,"NETSCAPE_SPKI_verify@492-496@lib/libcrypto/x509/x_all.c","lib/libcrypto/x509/x_all.c","NETSCAPE_SPKI_verify",492,496
7,1,58,3,6,"X509_sign@499-505@lib/libcrypto/x509/x_all.c","lib/libcrypto/x509/x_all.c","X509_sign",499,505
7,1,49,2,6,"X509_sign_ctx@508-514@lib/libcrypto/x509/x_all.c","lib/libcrypto/x509/x_all.c","X509_sign_ctx",508,514
5,1,44,3,4,"X509_REQ_sign@517-521@lib/libcrypto/x509/x_all.c","lib/libcrypto/x509/x_all.c","X509_REQ_sign",517,521
5,1,35,2,4,"X509_REQ_sign_ctx@524-528@lib/libcrypto/x509/x_all.c","lib/libcrypto/x509/x_all.c","X509_REQ_sign_ctx",524,528
6,1,58,3,5,"X509_CRL_sign@531-536@lib/libcrypto/x509/x_all.c","lib/libcrypto/x509/x_all.c","X509_CRL_sign",531,536
6,1,49,2,5,"X509_CRL_sign_ctx@539-544@lib/libcrypto/x509/x_all.c","lib/libcrypto/x509/x_all.c","X509_CRL_sign_ctx",539,544
5,1,44,3,4,"NETSCAPE_SPKI_sign@547-551@lib/libcrypto/x509/x_all.c","lib/libcrypto/x509/x_all.c","NETSCAPE_SPKI_sign",547,551
9,2,63,4,8,"X509_pubkey_digest@554-562@lib/libcrypto/x509/x_all.c","lib/libcrypto/x509/x_all.c","X509_pubkey_digest",554,562
6,1,45,4,5,"X509_digest@565-570@lib/libcrypto/x509/x_all.c","lib/libcrypto/x509/x_all.c","X509_digest",565,570
6,1,45,4,5,"X509_CRL_digest@573-578@lib/libcrypto/x509/x_all.c","lib/libcrypto/x509/x_all.c","X509_CRL_digest",573,578
6,1,45,4,5,"X509_REQ_digest@581-586@lib/libcrypto/x509/x_all.c","lib/libcrypto/x509/x_all.c","X509_REQ_digest",581,586
6,1,45,4,5,"X509_NAME_digest@589-594@lib/libcrypto/x509/x_all.c","lib/libcrypto/x509/x_all.c","X509_NAME_digest",589,594
6,1,44,4,5,"PKCS7_ISSUER_AND_SERIAL_digest@597-602@lib/libcrypto/x509/x_all.c","lib/libcrypto/x509/x_all.c","PKCS7_ISSUER_AND_SERIAL_digest",597,602
5,2,32,1,4,"X509_up_ref@605-609@lib/libcrypto/x509/x_all.c","lib/libcrypto/x509/x_all.c","X509_up_ref",605,609
43,12,259,3,47,"policy_cache_create@73-120@lib/libcrypto/x509v3/pcy_cache.c","lib/libcrypto/x509v3/pcy_cache.c","policy_cache_create",73,120
66,20,370,1,93,"policy_cache_new@123-216@lib/libcrypto/x509v3/pcy_cache.c","lib/libcrypto/x509v3/pcy_cache.c","policy_cache_new",123,216
10,4,48,1,9,"policy_cache_free@219-228@lib/libcrypto/x509v3/pcy_cache.c","lib/libcrypto/x509v3/pcy_cache.c","policy_cache_free",219,228
9,2,38,1,9,"policy_cache_set@231-240@lib/libcrypto/x509v3/pcy_cache.c","lib/libcrypto/x509v3/pcy_cache.c","policy_cache_set",231,240
10,2,62,2,10,"policy_cache_find_data@243-253@lib/libcrypto/x509v3/pcy_cache.c","lib/libcrypto/x509v3/pcy_cache.c","policy_cache_find_data",243,253
5,1,36,2,4,"policy_data_cmp@256-260@lib/libcrypto/x509v3/pcy_cache.c","lib/libcrypto/x509v3/pcy_cache.c","policy_data_cmp",256,260
9,3,43,2,8,"policy_cache_set_int@263-271@lib/libcrypto/x509v3/pcy_cache.c","lib/libcrypto/x509v3/pcy_cache.c","policy_cache_set_int",263,271
9,2,49,1,9,"policy_data_free@67-76@lib/libcrypto/x509v3/pcy_data.c","lib/libcrypto/x509v3/pcy_data.c","policy_data_free",67,76
38,10,196,3,43,"policy_data_new@86-129@lib/libcrypto/x509v3/pcy_data.c","lib/libcrypto/x509v3/pcy_data.c","policy_data_new",86,129
6,2,22,1,5,"X509_policy_tree_level_count@69-74@lib/libcrypto/x509v3/pcy_lib.c","lib/libcrypto/x509v3/pcy_lib.c","X509_policy_tree_level_count",69,74
6,4,41,2,5,"X509_policy_tree_get0_level@77-82@lib/libcrypto/x509v3/pcy_lib.c","lib/libcrypto/x509v3/pcy_lib.c","X509_policy_tree_get0_level",77,82
6,2,22,1,5,"X509_policy_tree_get0_policies@85-90@lib/libcrypto/x509v3/pcy_lib.c","lib/libcrypto/x509v3/pcy_lib.c","X509_policy_tree_get0_policies",85,90
9,3,36,1,8,"X509_policy_tree_get0_user_policies@93-101@lib/libcrypto/x509v3/pcy_lib.c","lib/libcrypto/x509v3/pcy_lib.c","X509_policy_tree_get0_user_policies",93,101
13,4,52,1,12,"X509_policy_level_node_count@106-118@lib/libcrypto/x509v3/pcy_lib.c","lib/libcrypto/x509v3/pcy_lib.c","X509_policy_level_node_count",106,118
11,4,51,2,10,"X509_policy_level_get0_node@121-131@lib/libcrypto/x509v3/pcy_lib.c","lib/libcrypto/x509v3/pcy_lib.c","X509_policy_level_get0_node",121,131
6,2,24,1,5,"X509_policy_node_get0_policy@136-141@lib/libcrypto/x509v3/pcy_lib.c","lib/libcrypto/x509v3/pcy_lib.c","X509_policy_node_get0_policy",136,141
6,2,24,1,5,"X509_policy_node_get0_qualifiers@144-149@lib/libcrypto/x509v3/pcy_lib.c","lib/libcrypto/x509v3/pcy_lib.c","X509_policy_node_get0_qualifiers",144,149
6,2,22,1,5,"X509_policy_node_get0_parent@152-157@lib/libcrypto/x509v3/pcy_lib.c","lib/libcrypto/x509v3/pcy_lib.c","X509_policy_node_get0_parent",152,157
48,12,276,2,57,"policy_cache_set_mapping@69-126@lib/libcrypto/x509v3/pcy_map.c","lib/libcrypto/x509v3/pcy_map.c","policy_cache_set_mapping",69,126
4,1,40,2,3,"node_cmp@66-69@lib/libcrypto/x509v3/pcy_node.c","lib/libcrypto/x509v3/pcy_node.c","node_cmp",66,69
4,1,12,1,3,"policy_node_cmp_new@71-74@lib/libcrypto/x509v3/pcy_node.c","lib/libcrypto/x509v3/pcy_node.c","policy_node_cmp_new",71,74
12,2,70,2,14,"tree_find_sk@77-91@lib/libcrypto/x509v3/pcy_node.c","lib/libcrypto/x509v3/pcy_node.c","tree_find_sk",77,91
14,4,87,3,14,"level_find_node@94-108@lib/libcrypto/x509v3/pcy_node.c","lib/libcrypto/x509v3/pcy_node.c","level_find_node",94,108
49,17,253,5,54,"level_add_node@112-166@lib/libcrypto/x509v3/pcy_node.c","lib/libcrypto/x509v3/pcy_node.c","level_add_node",112,166
4,1,13,1,3,"policy_node_free@169-172@lib/libcrypto/x509v3/pcy_node.c","lib/libcrypto/x509v3/pcy_node.c","policy_node_free",169,172
19,6,121,3,20,"policy_node_match@179-199@lib/libcrypto/x509v3/pcy_node.c","lib/libcrypto/x509v3/pcy_node.c","policy_node_match",179,199
20,5,129,4,19,"expected_print@73-92@lib/libcrypto/x509v3/pcy_tree.c","lib/libcrypto/x509v3/pcy_tree.c","expected_print",73,92
28,6,209,3,30,"tree_print@95-125@lib/libcrypto/x509v3/pcy_tree.c","lib/libcrypto/x509v3/pcy_tree.c","tree_print",95,125
106,34,632,3,147,"tree_init@142-289@lib/libcrypto/x509v3/pcy_tree.c","lib/libcrypto/x509v3/pcy_tree.c","tree_init",142,289
19,7,136,2,20,"tree_link_matching_nodes@292-312@lib/libcrypto/x509v3/pcy_tree.c","lib/libcrypto/x509v3/pcy_tree.c","tree_link_matching_nodes",292,312
11,3,67,2,12,"tree_link_nodes@320-332@lib/libcrypto/x509v3/pcy_tree.c","lib/libcrypto/x509v3/pcy_tree.c","tree_link_nodes",320,332
17,4,112,5,23,"tree_add_unmatched@340-363@lib/libcrypto/x509v3/pcy_tree.c","lib/libcrypto/x509v3/pcy_tree.c","tree_add_unmatched",340,363
25,9,178,4,30,"tree_link_unmatched@366-396@lib/libcrypto/x509v3/pcy_tree.c","lib/libcrypto/x509v3/pcy_tree.c","tree_link_unmatched",366,396
18,5,114,3,20,"tree_link_any@399-419@lib/libcrypto/x509v3/pcy_tree.c","lib/libcrypto/x509v3/pcy_tree.c","tree_link_any",399,419
41,12,253,2,45,"tree_prune@427-472@lib/libcrypto/x509v3/pcy_tree.c","lib/libcrypto/x509v3/pcy_tree.c","tree_prune",427,472
12,5,73,2,13,"tree_add_auth_node@475-488@lib/libcrypto/x509v3/pcy_tree.c","lib/libcrypto/x509v3/pcy_tree.c","tree_add_auth_node",475,488
31,9,198,2,41,"tree_calculate_authority_set@500-541@lib/libcrypto/x509v3/pcy_tree.c","lib/libcrypto/x509v3/pcy_tree.c","tree_calculate_authority_set",500,541
44,11,269,3,54,"tree_calculate_user_set@544-598@lib/libcrypto/x509v3/pcy_tree.c","lib/libcrypto/x509v3/pcy_tree.c","tree_calculate_user_set",544,598
19,6,124,1,21,"tree_evaluate@601-622@lib/libcrypto/x509v3/pcy_tree.c","lib/libcrypto/x509v3/pcy_tree.c","tree_evaluate",601,622
5,3,29,1,4,"exnode_free@625-629@lib/libcrypto/x509v3/pcy_tree.c","lib/libcrypto/x509v3/pcy_tree.c","exnode_free",625,629
22,6,126,1,26,"X509_policy_tree_free@632-658@lib/libcrypto/x509v3/pcy_tree.c","lib/libcrypto/x509v3/pcy_tree.c","X509_policy_tree_free",632,658
61,18,294,5,101,"X509_policy_check@669-770@lib/libcrypto/x509v3/pcy_tree.c","lib/libcrypto/x509v3/pcy_tree.c","X509_policy_check",669,770
19,4,125,3,19,"i2v_AUTHORITY_KEYID@91-110@lib/libcrypto/x509v3/v3_akey.c","lib/libcrypto/x509v3/v3_akey.c","i2v_AUTHORITY_KEYID",91,110
80,26,495,3,89,"v2i_AUTHORITY_KEYID@121-210@lib/libcrypto/x509v3/v3_akey.c","lib/libcrypto/x509v3/v3_akey.c","v2i_AUTHORITY_KEYID",121,210
5,1,38,3,4,"d2i_AUTHORITY_KEYID@102-106@lib/libcrypto/x509v3/v3_akeya.c","lib/libcrypto/x509v3/v3_akeya.c","d2i_AUTHORITY_KEYID",102,106
4,1,28,2,3,"i2d_AUTHORITY_KEYID@109-112@lib/libcrypto/x509v3/v3_akeya.c","lib/libcrypto/x509v3/v3_akeya.c","i2d_AUTHORITY_KEYID",109,112
4,1,17,1,3,"AUTHORITY_KEYID_new@115-118@lib/libcrypto/x509v3/v3_akeya.c","lib/libcrypto/x509v3/v3_akeya.c","AUTHORITY_KEYID_new",115,118
4,1,20,1,3,"AUTHORITY_KEYID_free@121-124@lib/libcrypto/x509v3/v3_akeya.c","lib/libcrypto/x509v3/v3_akeya.c","AUTHORITY_KEYID_free",121,124
13,3,77,3,13,"i2v_GENERAL_NAMES@127-140@lib/libcrypto/x509v3/v3_alt.c","lib/libcrypto/x509v3/v3_alt.c","i2v_GENERAL_NAMES",127,140
57,14,395,3,65,"i2v_GENERAL_NAME@143-208@lib/libcrypto/x509v3/v3_alt.c","lib/libcrypto/x509v3/v3_alt.c","i2v_GENERAL_NAME",143,208
51,13,311,2,60,"GENERAL_NAME_print@211-271@lib/libcrypto/x509v3/v3_alt.c","lib/libcrypto/x509v3/v3_alt.c","GENERAL_NAME_print",211,271
31,9,189,3,32,"v2i_issuer_alt@274-306@lib/libcrypto/x509v3/v3_alt.c","lib/libcrypto/x509v3/v3_alt.c","v2i_issuer_alt",274,306
32,10,181,2,36,"copy_issuer@311-347@lib/libcrypto/x509v3/v3_alt.c","lib/libcrypto/x509v3/v3_alt.c","copy_issuer",311,347
35,13,229,3,36,"v2i_subject_alt@350-386@lib/libcrypto/x509v3/v3_alt.c","lib/libcrypto/x509v3/v3_alt.c","v2i_subject_alt",350,386
46,12,253,3,51,"copy_email@393-444@lib/libcrypto/x509v3/v3_alt.c","lib/libcrypto/x509v3/v3_alt.c","copy_email",393,444
25,5,140,3,26,"v2i_GENERAL_NAMES@447-473@lib/libcrypto/x509v3/v3_alt.c","lib/libcrypto/x509v3/v3_alt.c","v2i_GENERAL_NAMES",447,473
5,1,31,3,4,"v2i_GENERAL_NAME@476-480@lib/libcrypto/x509v3/v3_alt.c","lib/libcrypto/x509v3/v3_alt.c","v2i_GENERAL_NAME",476,480
77,20,358,6,88,"a2i_GENERAL_NAME@483-571@lib/libcrypto/x509v3/v3_alt.c","lib/libcrypto/x509v3/v3_alt.c","a2i_GENERAL_NAME",483,571
32,9,199,5,35,"v2i_GENERAL_NAME_ex@574-609@lib/libcrypto/x509v3/v3_alt.c","lib/libcrypto/x509v3/v3_alt.c","v2i_GENERAL_NAME_ex",574,609
23,6,179,3,26,"do_othername@612-638@lib/libcrypto/x509v3/v3_alt.c","lib/libcrypto/x509v3/v3_alt.c","do_othername",612,638
21,4,119,3,23,"do_dirname@641-664@lib/libcrypto/x509v3/v3_alt.c","lib/libcrypto/x509v3/v3_alt.c","do_dirname",641,664
5,1,38,3,4,"d2i_BASIC_CONSTRAINTS@119-123@lib/libcrypto/x509v3/v3_bcons.c","lib/libcrypto/x509v3/v3_bcons.c","d2i_BASIC_CONSTRAINTS",119,123
4,1,28,2,3,"i2d_BASIC_CONSTRAINTS@126-129@lib/libcrypto/x509v3/v3_bcons.c","lib/libcrypto/x509v3/v3_bcons.c","i2d_BASIC_CONSTRAINTS",126,129
4,1,17,1,3,"BASIC_CONSTRAINTS_new@132-135@lib/libcrypto/x509v3/v3_bcons.c","lib/libcrypto/x509v3/v3_bcons.c","BASIC_CONSTRAINTS_new",132,135
4,1,20,1,3,"BASIC_CONSTRAINTS_free@138-141@lib/libcrypto/x509v3/v3_bcons.c","lib/libcrypto/x509v3/v3_bcons.c","BASIC_CONSTRAINTS_free",138,141
7,1,46,3,6,"i2v_BASIC_CONSTRAINTS@145-151@lib/libcrypto/x509v3/v3_bcons.c","lib/libcrypto/x509v3/v3_bcons.c","i2v_BASIC_CONSTRAINTS",145,151
29,7,170,3,30,"v2i_BASIC_CONSTRAINTS@154-184@lib/libcrypto/x509v3/v3_bcons.c","lib/libcrypto/x509v3/v3_bcons.c","v2i_BASIC_CONSTRAINTS",154,184
10,3,66,3,10,"i2v_ASN1_BIT_STRING@126-136@lib/libcrypto/x509v3/v3_bitst.c","lib/libcrypto/x509v3/v3_bitst.c","i2v_ASN1_BIT_STRING",126,136
34,8,188,3,34,"v2i_ASN1_BIT_STRING@139-173@lib/libcrypto/x509v3/v3_bitst.c","lib/libcrypto/x509v3/v3_bitst.c","v2i_ASN1_BIT_STRING",139,173
15,3,106,4,15,"X509V3_EXT_nconf@85-100@lib/libcrypto/x509v3/v3_conf.c","lib/libcrypto/x509v3/v3_conf.c","X509V3_EXT_nconf",85,100
10,2,76,4,10,"X509V3_EXT_nconf_nid@105-115@lib/libcrypto/x509v3/v3_conf.c","lib/libcrypto/x509v3/v3_conf.c","X509V3_EXT_nconf_nid",105,115
52,14,321,5,55,"do_ext_nconf@120-175@lib/libcrypto/x509v3/v3_conf.c","lib/libcrypto/x509v3/v3_conf.c","do_ext_nconf",120,175
35,6,190,4,40,"do_ext_i2d@178-218@lib/libcrypto/x509v3/v3_conf.c","lib/libcrypto/x509v3/v3_conf.c","do_ext_i2d",178,218
9,2,53,3,9,"X509V3_EXT_i2d@223-232@lib/libcrypto/x509v3/v3_conf.c","lib/libcrypto/x509v3/v3_conf.c","X509V3_EXT_i2d",223,232
10,4,65,1,10,"v3_check_critical@236-246@lib/libcrypto/x509v3/v3_conf.c","lib/libcrypto/x509v3/v3_conf.c","v3_check_critical",236,246
17,6,110,1,18,"v3_check_generic@250-268@lib/libcrypto/x509v3/v3_conf.c","lib/libcrypto/x509v3/v3_conf.c","v3_check_generic",250,268
40,6,225,5,46,"v3_generic_extension@272-318@lib/libcrypto/x509v3/v3_conf.c","lib/libcrypto/x509v3/v3_conf.c","v3_generic_extension",272,318
11,2,64,3,11,"generic_asn1@321-332@lib/libcrypto/x509v3/v3_conf.c","lib/libcrypto/x509v3/v3_conf.c","generic_asn1",321,332
19,5,132,4,19,"X509V3_EXT_add_nconf_sk@339-358@lib/libcrypto/x509v3/v3_conf.c","lib/libcrypto/x509v3/v3_conf.c","X509V3_EXT_add_nconf_sk",339,358
7,2,54,4,7,"X509V3_EXT_add_nconf@363-370@lib/libcrypto/x509v3/v3_conf.c","lib/libcrypto/x509v3/v3_conf.c","X509V3_EXT_add_nconf",363,370
8,2,54,4,8,"X509V3_EXT_CRL_add_nconf@375-383@lib/libcrypto/x509v3/v3_conf.c","lib/libcrypto/x509v3/v3_conf.c","X509V3_EXT_CRL_add_nconf",375,383
14,4,89,4,14,"X509V3_EXT_REQ_add_nconf@388-402@lib/libcrypto/x509v3/v3_conf.c","lib/libcrypto/x509v3/v3_conf.c","X509V3_EXT_REQ_add_nconf",388,402
10,5,72,3,9,"X509V3_get_string@407-416@lib/libcrypto/x509v3/v3_conf.c","lib/libcrypto/x509v3/v3_conf.c","X509V3_get_string",407,416
10,5,66,2,9,"X509V3_get_section@419-428@lib/libcrypto/x509v3/v3_conf.c","lib/libcrypto/x509v3/v3_conf.c","X509V3_get_section",419,428
7,3,40,2,6,"X509V3_string_free@431-437@lib/libcrypto/x509v3/v3_conf.c","lib/libcrypto/x509v3/v3_conf.c","X509V3_string_free",431,437
7,3,43,2,6,"X509V3_section_free@440-446@lib/libcrypto/x509v3/v3_conf.c","lib/libcrypto/x509v3/v3_conf.c","X509V3_section_free",440,446
4,1,26,3,3,"nconf_get_string@449-452@lib/libcrypto/x509v3/v3_conf.c","lib/libcrypto/x509v3/v3_conf.c","nconf_get_string",449,452
4,1,20,2,3,"nconf_get_section@455-458@lib/libcrypto/x509v3/v3_conf.c","lib/libcrypto/x509v3/v3_conf.c","nconf_get_section",455,458
5,1,25,2,4,"X509V3_set_nconf@468-472@lib/libcrypto/x509v3/v3_conf.c","lib/libcrypto/x509v3/v3_conf.c","X509V3_set_nconf",468,472
9,1,57,6,8,"X509V3_set_ctx@475-483@lib/libcrypto/x509v3/v3_conf.c","lib/libcrypto/x509v3/v3_conf.c","X509V3_set_ctx",475,483
7,1,47,4,7,"X509V3_EXT_conf@488-495@lib/libcrypto/x509v3/v3_conf.c","lib/libcrypto/x509v3/v3_conf.c","X509V3_EXT_conf",488,495
7,1,46,4,7,"X509V3_EXT_conf_nid@500-507@lib/libcrypto/x509v3/v3_conf.c","lib/libcrypto/x509v3/v3_conf.c","X509V3_EXT_conf_nid",500,507
4,1,26,3,3,"conf_lhash_get_string@510-513@lib/libcrypto/x509v3/v3_conf.c","lib/libcrypto/x509v3/v3_conf.c","conf_lhash_get_string",510,513
4,1,20,2,3,"conf_lhash_get_section@516-519@lib/libcrypto/x509v3/v3_conf.c","lib/libcrypto/x509v3/v3_conf.c","conf_lhash_get_section",516,519
5,1,28,2,4,"X509V3_set_conf_lhash@529-533@lib/libcrypto/x509v3/v3_conf.c","lib/libcrypto/x509v3/v3_conf.c","X509V3_set_conf_lhash",529,533
7,1,47,4,7,"X509V3_EXT_add_conf@536-543@lib/libcrypto/x509v3/v3_conf.c","lib/libcrypto/x509v3/v3_conf.c","X509V3_EXT_add_conf",536,543
7,1,47,4,7,"X509V3_EXT_CRL_add_conf@548-555@lib/libcrypto/x509v3/v3_conf.c","lib/libcrypto/x509v3/v3_conf.c","X509V3_EXT_CRL_add_conf",548,555
7,1,47,4,7,"X509V3_EXT_REQ_add_conf@560-567@lib/libcrypto/x509v3/v3_conf.c","lib/libcrypto/x509v3/v3_conf.c","X509V3_EXT_REQ_add_conf",560,567
5,1,38,3,4,"d2i_CERTIFICATEPOLICIES@122-126@lib/libcrypto/x509v3/v3_cpols.c","lib/libcrypto/x509v3/v3_cpols.c","d2i_CERTIFICATEPOLICIES",122,126
4,1,28,2,3,"i2d_CERTIFICATEPOLICIES@129-132@lib/libcrypto/x509v3/v3_cpols.c","lib/libcrypto/x509v3/v3_cpols.c","i2d_CERTIFICATEPOLICIES",129,132
4,1,17,1,3,"CERTIFICATEPOLICIES_new@135-138@lib/libcrypto/x509v3/v3_cpols.c","lib/libcrypto/x509v3/v3_cpols.c","CERTIFICATEPOLICIES_new",135,138
4,1,20,1,3,"CERTIFICATEPOLICIES_free@141-144@lib/libcrypto/x509v3/v3_cpols.c","lib/libcrypto/x509v3/v3_cpols.c","CERTIFICATEPOLICIES_free",141,144
5,1,38,3,4,"d2i_POLICYINFO@175-179@lib/libcrypto/x509v3/v3_cpols.c","lib/libcrypto/x509v3/v3_cpols.c","d2i_POLICYINFO",175,179
4,1,28,2,3,"i2d_POLICYINFO@182-185@lib/libcrypto/x509v3/v3_cpols.c","lib/libcrypto/x509v3/v3_cpols.c","i2d_POLICYINFO",182,185
4,1,17,1,3,"POLICYINFO_new@188-191@lib/libcrypto/x509v3/v3_cpols.c","lib/libcrypto/x509v3/v3_cpols.c","POLICYINFO_new",188,191
4,1,20,1,3,"POLICYINFO_free@194-197@lib/libcrypto/x509v3/v3_cpols.c","lib/libcrypto/x509v3/v3_cpols.c","POLICYINFO_free",194,197
5,1,38,3,4,"d2i_POLICYQUALINFO@271-275@lib/libcrypto/x509v3/v3_cpols.c","lib/libcrypto/x509v3/v3_cpols.c","d2i_POLICYQUALINFO",271,275
4,1,28,2,3,"i2d_POLICYQUALINFO@278-281@lib/libcrypto/x509v3/v3_cpols.c","lib/libcrypto/x509v3/v3_cpols.c","i2d_POLICYQUALINFO",278,281
4,1,17,1,3,"POLICYQUALINFO_new@284-287@lib/libcrypto/x509v3/v3_cpols.c","lib/libcrypto/x509v3/v3_cpols.c","POLICYQUALINFO_new",284,287
4,1,20,1,3,"POLICYQUALINFO_free@290-293@lib/libcrypto/x509v3/v3_cpols.c","lib/libcrypto/x509v3/v3_cpols.c","POLICYQUALINFO_free",290,293
5,1,38,3,4,"d2i_USERNOTICE@324-328@lib/libcrypto/x509v3/v3_cpols.c","lib/libcrypto/x509v3/v3_cpols.c","d2i_USERNOTICE",324,328
4,1,28,2,3,"i2d_USERNOTICE@331-334@lib/libcrypto/x509v3/v3_cpols.c","lib/libcrypto/x509v3/v3_cpols.c","i2d_USERNOTICE",331,334
4,1,17,1,3,"USERNOTICE_new@337-340@lib/libcrypto/x509v3/v3_cpols.c","lib/libcrypto/x509v3/v3_cpols.c","USERNOTICE_new",337,340
4,1,20,1,3,"USERNOTICE_free@343-346@lib/libcrypto/x509v3/v3_cpols.c","lib/libcrypto/x509v3/v3_cpols.c","USERNOTICE_free",343,346
5,1,38,3,4,"d2i_NOTICEREF@377-381@lib/libcrypto/x509v3/v3_cpols.c","lib/libcrypto/x509v3/v3_cpols.c","d2i_NOTICEREF",377,381
4,1,28,2,3,"i2d_NOTICEREF@384-387@lib/libcrypto/x509v3/v3_cpols.c","lib/libcrypto/x509v3/v3_cpols.c","i2d_NOTICEREF",384,387
4,1,17,1,3,"NOTICEREF_new@390-393@lib/libcrypto/x509v3/v3_cpols.c","lib/libcrypto/x509v3/v3_cpols.c","NOTICEREF_new",390,393
4,1,20,1,3,"NOTICEREF_free@396-399@lib/libcrypto/x509v3/v3_cpols.c","lib/libcrypto/x509v3/v3_cpols.c","NOTICEREF_free",396,399
66,12,353,3,67,"r2i_certpol@402-469@lib/libcrypto/x509v3/v3_cpols.c","lib/libcrypto/x509v3/v3_cpols.c","r2i_certpol",402,469
79,20,489,3,86,"policy_section@472-558@lib/libcrypto/x509v3/v3_cpols.c","lib/libcrypto/x509v3/v3_cpols.c","policy_section",472,558
78,23,478,3,82,"notice_section@561-643@lib/libcrypto/x509v3/v3_cpols.c","lib/libcrypto/x509v3/v3_cpols.c","notice_section",561,643
21,4,117,2,23,"nref_nos@646-669@lib/libcrypto/x509v3/v3_cpols.c","lib/libcrypto/x509v3/v3_cpols.c","nref_nos",646,669
15,3,105,4,16,"i2r_certpol@672-688@lib/libcrypto/x509v3/v3_cpols.c","lib/libcrypto/x509v3/v3_cpols.c","i2r_certpol",672,688
24,4,151,3,27,"print_qualifiers@691-718@lib/libcrypto/x509v3/v3_cpols.c","lib/libcrypto/x509v3/v3_cpols.c","print_qualifiers",691,718
26,6,178,3,26,"print_notice@721-747@lib/libcrypto/x509v3/v3_cpols.c","lib/libcrypto/x509v3/v3_cpols.c","print_notice",721,747
13,3,106,3,14,"X509_POLICY_NODE_print@750-764@lib/libcrypto/x509v3/v3_cpols.c","lib/libcrypto/x509v3/v3_cpols.c","X509_POLICY_NODE_print",750,764
19,4,103,2,19,"gnames_from_sectname@108-127@lib/libcrypto/x509v3/v3_crld.c","lib/libcrypto/x509v3/v3_crld.c","gnames_from_sectname",108,127
55,12,328,3,62,"set_dist_point_name@130-192@lib/libcrypto/x509v3/v3_crld.c","lib/libcrypto/x509v3/v3_crld.c","set_dist_point_name",130,192
34,10,192,2,35,"set_reasons@208-243@lib/libcrypto/x509v3/v3_crld.c","lib/libcrypto/x509v3/v3_crld.c","set_reasons",208,243
20,5,124,4,20,"print_reasons@246-266@lib/libcrypto/x509v3/v3_crld.c","lib/libcrypto/x509v3/v3_crld.c","print_reasons",246,266
32,9,186,2,34,"crldp_from_section@269-303@lib/libcrypto/x509v3/v3_crld.c","lib/libcrypto/x509v3/v3_crld.c","crldp_from_section",269,303
56,13,329,3,57,"v2i_crld@306-363@lib/libcrypto/x509v3/v3_crld.c","lib/libcrypto/x509v3/v3_crld.c","v2i_crld",306,363
14,4,69,4,15,"dpn_cb@366-381@lib/libcrypto/x509v3/v3_crld.c","lib/libcrypto/x509v3/v3_crld.c","dpn_cb",366,381
5,1,38,3,4,"d2i_DIST_POINT_NAME@422-426@lib/libcrypto/x509v3/v3_crld.c","lib/libcrypto/x509v3/v3_crld.c","d2i_DIST_POINT_NAME",422,426
4,1,28,2,3,"i2d_DIST_POINT_NAME@429-432@lib/libcrypto/x509v3/v3_crld.c","lib/libcrypto/x509v3/v3_crld.c","i2d_DIST_POINT_NAME",429,432
4,1,17,1,3,"DIST_POINT_NAME_new@435-438@lib/libcrypto/x509v3/v3_crld.c","lib/libcrypto/x509v3/v3_crld.c","DIST_POINT_NAME_new",435,438
4,1,20,1,3,"DIST_POINT_NAME_free@441-444@lib/libcrypto/x509v3/v3_crld.c","lib/libcrypto/x509v3/v3_crld.c","DIST_POINT_NAME_free",441,444
5,1,38,3,4,"d2i_DIST_POINT@482-486@lib/libcrypto/x509v3/v3_crld.c","lib/libcrypto/x509v3/v3_crld.c","d2i_DIST_POINT",482,486
4,1,28,2,3,"i2d_DIST_POINT@489-492@lib/libcrypto/x509v3/v3_crld.c","lib/libcrypto/x509v3/v3_crld.c","i2d_DIST_POINT",489,492
4,1,17,1,3,"DIST_POINT_new@495-498@lib/libcrypto/x509v3/v3_crld.c","lib/libcrypto/x509v3/v3_crld.c","DIST_POINT_new",495,498
4,1,20,1,3,"DIST_POINT_free@501-504@lib/libcrypto/x509v3/v3_crld.c","lib/libcrypto/x509v3/v3_crld.c","DIST_POINT_free",501,504
5,1,38,3,4,"d2i_CRL_DIST_POINTS@526-530@lib/libcrypto/x509v3/v3_crld.c","lib/libcrypto/x509v3/v3_crld.c","d2i_CRL_DIST_POINTS",526,530
4,1,28,2,3,"i2d_CRL_DIST_POINTS@533-536@lib/libcrypto/x509v3/v3_crld.c","lib/libcrypto/x509v3/v3_crld.c","i2d_CRL_DIST_POINTS",533,536
4,1,17,1,3,"CRL_DIST_POINTS_new@539-542@lib/libcrypto/x509v3/v3_crld.c","lib/libcrypto/x509v3/v3_crld.c","CRL_DIST_POINTS_new",539,542
4,1,20,1,3,"CRL_DIST_POINTS_free@545-548@lib/libcrypto/x509v3/v3_crld.c","lib/libcrypto/x509v3/v3_crld.c","CRL_DIST_POINTS_free",545,548
5,1,38,3,4,"d2i_ISSUING_DIST_POINT@607-611@lib/libcrypto/x509v3/v3_crld.c","lib/libcrypto/x509v3/v3_crld.c","d2i_ISSUING_DIST_POINT",607,611
4,1,28,2,3,"i2d_ISSUING_DIST_POINT@614-617@lib/libcrypto/x509v3/v3_crld.c","lib/libcrypto/x509v3/v3_crld.c","i2d_ISSUING_DIST_POINT",614,617
4,1,17,1,3,"ISSUING_DIST_POINT_new@620-623@lib/libcrypto/x509v3/v3_crld.c","lib/libcrypto/x509v3/v3_crld.c","ISSUING_DIST_POINT_new",620,623
4,1,20,1,3,"ISSUING_DIST_POINT_free@626-629@lib/libcrypto/x509v3/v3_crld.c","lib/libcrypto/x509v3/v3_crld.c","ISSUING_DIST_POINT_free",626,629
51,15,306,3,52,"v2i_idp@648-700@lib/libcrypto/x509v3/v3_crld.c","lib/libcrypto/x509v3/v3_crld.c","v2i_idp",648,700
10,2,74,3,10,"print_gens@703-713@lib/libcrypto/x509v3/v3_crld.c","lib/libcrypto/x509v3/v3_crld.c","print_gens",703,713
15,2,104,3,14,"print_distpoint@716-730@lib/libcrypto/x509v3/v3_crld.c","lib/libcrypto/x509v3/v3_crld.c","print_distpoint",716,730
22,13,196,4,23,"i2r_idp@733-756@lib/libcrypto/x509v3/v3_crld.c","lib/libcrypto/x509v3/v3_crld.c","i2r_idp",733,756
20,5,139,4,20,"i2r_crldp@759-779@lib/libcrypto/x509v3/v3_crld.c","lib/libcrypto/x509v3/v3_crld.c","i2r_crldp",759,779
26,8,169,2,27,"DIST_POINT_set_dpname@782-809@lib/libcrypto/x509v3/v3_crld.c","lib/libcrypto/x509v3/v3_crld.c","DIST_POINT_set_dpname",782,809
11,3,67,2,11,"i2s_ASN1_ENUMERATED_TABLE@96-107@lib/libcrypto/x509v3/v3_enum.c","lib/libcrypto/x509v3/v3_enum.c","i2s_ASN1_ENUMERATED_TABLE",96,107
5,1,38,3,4,"d2i_EXTENDED_KEY_USAGE@126-130@lib/libcrypto/x509v3/v3_extku.c","lib/libcrypto/x509v3/v3_extku.c","d2i_EXTENDED_KEY_USAGE",126,130
4,1,28,2,3,"i2d_EXTENDED_KEY_USAGE@133-136@lib/libcrypto/x509v3/v3_extku.c","lib/libcrypto/x509v3/v3_extku.c","i2d_EXTENDED_KEY_USAGE",133,136
4,1,17,1,3,"EXTENDED_KEY_USAGE_new@139-142@lib/libcrypto/x509v3/v3_extku.c","lib/libcrypto/x509v3/v3_extku.c","EXTENDED_KEY_USAGE_new",139,142
4,1,20,1,3,"EXTENDED_KEY_USAGE_free@145-148@lib/libcrypto/x509v3/v3_extku.c","lib/libcrypto/x509v3/v3_extku.c","EXTENDED_KEY_USAGE_free",145,148
14,2,88,3,14,"i2v_EXTENDED_KEY_USAGE@151-165@lib/libcrypto/x509v3/v3_extku.c","lib/libcrypto/x509v3/v3_extku.c","i2v_EXTENDED_KEY_USAGE",151,165
33,6,178,3,34,"v2i_EXTENDED_KEY_USAGE@168-202@lib/libcrypto/x509v3/v3_extku.c","lib/libcrypto/x509v3/v3_extku.c","v2i_EXTENDED_KEY_USAGE",168,202
5,1,38,3,4,"d2i_OTHERNAME@96-100@lib/libcrypto/x509v3/v3_genn.c","lib/libcrypto/x509v3/v3_genn.c","d2i_OTHERNAME",96,100
4,1,28,2,3,"i2d_OTHERNAME@103-106@lib/libcrypto/x509v3/v3_genn.c","lib/libcrypto/x509v3/v3_genn.c","i2d_OTHERNAME",103,106
4,1,17,1,3,"OTHERNAME_new@109-112@lib/libcrypto/x509v3/v3_genn.c","lib/libcrypto/x509v3/v3_genn.c","OTHERNAME_new",109,112
4,1,20,1,3,"OTHERNAME_free@115-118@lib/libcrypto/x509v3/v3_genn.c","lib/libcrypto/x509v3/v3_genn.c","OTHERNAME_free",115,118
5,1,38,3,4,"d2i_EDIPARTYNAME@149-153@lib/libcrypto/x509v3/v3_genn.c","lib/libcrypto/x509v3/v3_genn.c","d2i_EDIPARTYNAME",149,153
4,1,28,2,3,"i2d_EDIPARTYNAME@156-159@lib/libcrypto/x509v3/v3_genn.c","lib/libcrypto/x509v3/v3_genn.c","i2d_EDIPARTYNAME",156,159
4,1,17,1,3,"EDIPARTYNAME_new@162-165@lib/libcrypto/x509v3/v3_genn.c","lib/libcrypto/x509v3/v3_genn.c","EDIPARTYNAME_new",162,165
4,1,20,1,3,"EDIPARTYNAME_free@168-171@lib/libcrypto/x509v3/v3_genn.c","lib/libcrypto/x509v3/v3_genn.c","EDIPARTYNAME_free",168,171
5,1,38,3,4,"d2i_GENERAL_NAME@253-257@lib/libcrypto/x509v3/v3_genn.c","lib/libcrypto/x509v3/v3_genn.c","d2i_GENERAL_NAME",253,257
4,1,28,2,3,"i2d_GENERAL_NAME@260-263@lib/libcrypto/x509v3/v3_genn.c","lib/libcrypto/x509v3/v3_genn.c","i2d_GENERAL_NAME",260,263
4,1,17,1,3,"GENERAL_NAME_new@266-269@lib/libcrypto/x509v3/v3_genn.c","lib/libcrypto/x509v3/v3_genn.c","GENERAL_NAME_new",266,269
4,1,20,1,3,"GENERAL_NAME_free@272-275@lib/libcrypto/x509v3/v3_genn.c","lib/libcrypto/x509v3/v3_genn.c","GENERAL_NAME_free",272,275
5,1,38,3,4,"d2i_GENERAL_NAMES@297-301@lib/libcrypto/x509v3/v3_genn.c","lib/libcrypto/x509v3/v3_genn.c","d2i_GENERAL_NAMES",297,301
4,1,28,2,3,"i2d_GENERAL_NAMES@304-307@lib/libcrypto/x509v3/v3_genn.c","lib/libcrypto/x509v3/v3_genn.c","i2d_GENERAL_NAMES",304,307
4,1,17,1,3,"GENERAL_NAMES_new@310-313@lib/libcrypto/x509v3/v3_genn.c","lib/libcrypto/x509v3/v3_genn.c","GENERAL_NAMES_new",310,313
4,1,20,1,3,"GENERAL_NAMES_free@316-319@lib/libcrypto/x509v3/v3_genn.c","lib/libcrypto/x509v3/v3_genn.c","GENERAL_NAMES_free",316,319
4,1,17,1,3,"GENERAL_NAME_dup@322-325@lib/libcrypto/x509v3/v3_genn.c","lib/libcrypto/x509v3/v3_genn.c","GENERAL_NAME_dup",322,325
30,13,190,2,35,"GENERAL_NAME_cmp@329-364@lib/libcrypto/x509v3/v3_genn.c","lib/libcrypto/x509v3/v3_genn.c","GENERAL_NAME_cmp",329,364
10,4,68,2,12,"OTHERNAME_cmp@368-380@lib/libcrypto/x509v3/v3_genn.c","lib/libcrypto/x509v3/v3_genn.c","OTHERNAME_cmp",368,380
27,10,114,3,31,"GENERAL_NAME_set0_value@383-414@lib/libcrypto/x509v3/v3_genn.c","lib/libcrypto/x509v3/v3_genn.c","GENERAL_NAME_set0_value",383,414
24,11,105,2,29,"GENERAL_NAME_get0_value@417-446@lib/libcrypto/x509v3/v3_genn.c","lib/libcrypto/x509v3/v3_genn.c","GENERAL_NAME_get0_value",417,446
12,2,58,3,12,"GENERAL_NAME_set0_othername@449-461@lib/libcrypto/x509v3/v3_genn.c","lib/libcrypto/x509v3/v3_genn.c","GENERAL_NAME_set0_othername",449,461
11,4,60,3,10,"GENERAL_NAME_get0_otherName@464-474@lib/libcrypto/x509v3/v3_genn.c","lib/libcrypto/x509v3/v3_genn.c","GENERAL_NAME_get0_otherName",464,474
13,4,80,2,13,"i2s_ASN1_IA5STRING@203-216@lib/libcrypto/x509v3/v3_ia5.c","lib/libcrypto/x509v3/v3_ia5.c","i2s_ASN1_IA5STRING",203,216
19,4,96,3,19,"s2i_ASN1_IA5STRING@219-238@lib/libcrypto/x509v3/v3_ia5.c","lib/libcrypto/x509v3/v3_ia5.c","s2i_ASN1_IA5STRING",219,238
5,1,38,3,4,"d2i_ACCESS_DESCRIPTION@137-141@lib/libcrypto/x509v3/v3_info.c","lib/libcrypto/x509v3/v3_info.c","d2i_ACCESS_DESCRIPTION",137,141
4,1,28,2,3,"i2d_ACCESS_DESCRIPTION@144-147@lib/libcrypto/x509v3/v3_info.c","lib/libcrypto/x509v3/v3_info.c","i2d_ACCESS_DESCRIPTION",144,147
4,1,17,1,3,"ACCESS_DESCRIPTION_new@150-153@lib/libcrypto/x509v3/v3_info.c","lib/libcrypto/x509v3/v3_info.c","ACCESS_DESCRIPTION_new",150,153
4,1,20,1,3,"ACCESS_DESCRIPTION_free@156-159@lib/libcrypto/x509v3/v3_info.c","lib/libcrypto/x509v3/v3_info.c","ACCESS_DESCRIPTION_free",156,159
5,1,38,3,4,"d2i_AUTHORITY_INFO_ACCESS@181-185@lib/libcrypto/x509v3/v3_info.c","lib/libcrypto/x509v3/v3_info.c","d2i_AUTHORITY_INFO_ACCESS",181,185
4,1,28,2,3,"i2d_AUTHORITY_INFO_ACCESS@188-191@lib/libcrypto/x509v3/v3_info.c","lib/libcrypto/x509v3/v3_info.c","i2d_AUTHORITY_INFO_ACCESS",188,191
4,1,17,1,3,"AUTHORITY_INFO_ACCESS_new@194-197@lib/libcrypto/x509v3/v3_info.c","lib/libcrypto/x509v3/v3_info.c","AUTHORITY_INFO_ACCESS_new",194,197
4,1,20,1,3,"AUTHORITY_INFO_ACCESS_free@200-203@lib/libcrypto/x509v3/v3_info.c","lib/libcrypto/x509v3/v3_info.c","AUTHORITY_INFO_ACCESS_free",200,203
30,5,202,3,31,"i2v_AUTHORITY_INFO_ACCESS@206-237@lib/libcrypto/x509v3/v3_info.c","lib/libcrypto/x509v3/v3_info.c","i2v_AUTHORITY_INFO_ACCESS",206,237
52,9,312,3,53,"v2i_AUTHORITY_INFO_ACCESS@240-293@lib/libcrypto/x509v3/v3_info.c","lib/libcrypto/x509v3/v3_info.c","v2i_AUTHORITY_INFO_ACCESS",240,293
5,1,24,2,4,"i2a_ACCESS_DESCRIPTION@296-300@lib/libcrypto/x509v3/v3_info.c","lib/libcrypto/x509v3/v3_info.c","i2a_ACCESS_DESCRIPTION",296,300
4,1,24,3,3,"s2i_asn1_int@98-101@lib/libcrypto/x509v3/v3_int.c","lib/libcrypto/x509v3/v3_int.c","s2i_asn1_int",98,101
12,3,56,1,11,"X509V3_EXT_add@75-86@lib/libcrypto/x509v3/v3_lib.c","lib/libcrypto/x509v3/v3_lib.c","X509V3_EXT_add",75,86
4,1,35,2,3,"ext_cmp@89-92@lib/libcrypto/x509v3/v3_lib.c","lib/libcrypto/x509v3/v3_lib.c","ext_cmp",89,92
6,1,40,2,5,"ext_cmp_BSEARCH_CMP_FN@99-104@lib/libcrypto/x509v3/v3_lib.c","lib/libcrypto/x509v3/v3_lib.c","ext_cmp_BSEARCH_CMP_FN",99,104
5,1,45,3,4,"OBJ_bsearch_ext@107-111@lib/libcrypto/x509v3/v3_lib.c","lib/libcrypto/x509v3/v3_lib.c","OBJ_bsearch_ext",107,111
18,5,97,1,18,"X509V3_EXT_get_nid@114-132@lib/libcrypto/x509v3/v3_lib.c","lib/libcrypto/x509v3/v3_lib.c","X509V3_EXT_get_nid",114,132
7,2,35,1,7,"X509V3_EXT_get@135-142@lib/libcrypto/x509v3/v3_lib.c","lib/libcrypto/x509v3/v3_lib.c","X509V3_EXT_get