23,7,166,2,33,"main@355-388@sbin/atactl/atactl.c","sbin/atactl/atactl.c","main",355,388
5,1,20,1,5,"usage@391-396@sbin/atactl/atactl.c","sbin/atactl/atactl.c","usage",391,396
22,7,106,1,23,"ata_command@402-425@sbin/atactl/atactl.c","sbin/atactl/atactl.c","ata_command",402,425
6,3,46,3,6,"print_bitinfo@431-437@sbin/atactl/atactl.c","sbin/atactl/atactl.c","print_bitinfo",431,437
7,3,52,2,6,"strtoval@445-451@sbin/atactl/atactl.c","sbin/atactl/atactl.c","strtoval",445,451
7,3,44,2,6,"valtostr@459-465@sbin/atactl/atactl.c","sbin/atactl/atactl.c","valtostr",459,465
237,76,1341,2,263,"device_dump@477-740@sbin/atactl/atactl.c","sbin/atactl/atactl.c","device_dump",477,740
96,30,845,2,120,"device_identify@748-868@sbin/atactl/atactl.c","sbin/atactl/atactl.c","device_identify",748,868
19,4,122,2,24,"device_idle@876-900@sbin/atactl/atactl.c","sbin/atactl/atactl.c","device_idle",876,900
50,12,393,2,69,"device_sec_setpass@906-975@sbin/atactl/atactl.c","sbin/atactl/atactl.c","device_sec_setpass",906,975
29,4,198,2,36,"device_sec_unlock@981-1017@sbin/atactl/atactl.c","sbin/atactl/atactl.c","device_sec_unlock",981,1017
39,7,270,2,50,"device_sec_erase@1023-1073@sbin/atactl/atactl.c","sbin/atactl/atactl.c","device_sec_erase",1023,1073
14,2,80,2,18,"device_sec_freeze@1079-1097@sbin/atactl/atactl.c","sbin/atactl/atactl.c","device_sec_freeze",1079,1097
29,4,198,2,36,"device_sec_disablepass@1103-1139@sbin/atactl/atactl.c","sbin/atactl/atactl.c","device_sec_disablepass",1103,1139
18,8,124,2,19,"sec_getpass@1142-1161@sbin/atactl/atactl.c","sbin/atactl/atactl.c","sec_getpass",1142,1161
16,2,92,2,20,"device_smart_enable@1167-1187@sbin/atactl/atactl.c","sbin/atactl/atactl.c","device_smart_enable",1167,1187
16,2,92,2,20,"device_smart_disable@1193-1213@sbin/atactl/atactl.c","sbin/atactl/atactl.c","device_smart_disable",1193,1213
23,4,137,2,28,"device_smart_status@1219-1247@sbin/atactl/atactl.c","sbin/atactl/atactl.c","device_smart_status",1219,1247
21,3,123,2,25,"device_smart_autosave@1253-1278@sbin/atactl/atactl.c","sbin/atactl/atactl.c","device_smart_autosave",1253,1278
21,3,123,2,25,"device_smart_offline@1284-1309@sbin/atactl/atactl.c","sbin/atactl/atactl.c","device_smart_offline",1284,1309
46,5,320,2,52,"device_smart_read@1315-1367@sbin/atactl/atactl.c","sbin/atactl/atactl.c","device_smart_read",1315,1367
128,26,983,2,161,"device_smart_readlog@1373-1534@sbin/atactl/atactl.c","sbin/atactl/atactl.c","device_smart_readlog",1373,1534
34,1,384,1,33,"smart_print_errdata@1545-1578@sbin/atactl/atactl.c","sbin/atactl/atactl.c","smart_print_errdata",1545,1578
8,2,44,2,9,"smart_cksum@1581-1590@sbin/atactl/atactl.c","sbin/atactl/atactl.c","smart_cksum",1581,1590
65,10,481,2,79,"device_attr@1596-1675@sbin/atactl/atactl.c","sbin/atactl/atactl.c","device_attr",1596,1675
23,3,138,2,30,"device_acoustic@1681-1711@sbin/atactl/atactl.c","sbin/atactl/atactl.c","device_acoustic",1681,1711
23,3,138,2,30,"device_apm@1719-1749@sbin/atactl/atactl.c","sbin/atactl/atactl.c","device_apm",1719,1749
38,13,314,2,45,"device_feature@1756-1801@sbin/atactl/atactl.c","sbin/atactl/atactl.c","device_feature",1756,1801
32,10,232,2,41,"device_setidle@1808-1849@sbin/atactl/atactl.c","sbin/atactl/atactl.c","device_setidle",1808,1849
29,5,140,2,35,"device_checkpower@1855-1890@sbin/atactl/atactl.c","sbin/atactl/atactl.c","device_checkpower",1855,1890
49,14,401,2,62,"main@77-139@sbin/badsect/badsect.c","sbin/badsect/badsect.c","main",77,139
37,8,257,2,37,"chkuse@142-179@sbin/badsect/badsect.c","sbin/badsect/badsect.c","chkuse",142,179
7,2,53,3,6,"rdfs@185-191@sbin/badsect/badsect.c","sbin/badsect/badsect.c","rdfs",185,191
158,50,824,2,172,"main@100-272@sbin/bioctl/bioctl.c","sbin/bioctl/bioctl.c","main",100,272
20,1,40,1,21,"usage@275-296@sbin/bioctl/bioctl.c","sbin/bioctl/bioctl.c","usage",275,296
25,6,177,2,27,"str2locator@299-326@sbin/bioctl/bioctl.c","sbin/bioctl/bioctl.c","str2locator",299,326
26,7,173,2,30,"str2patrol@329-359@sbin/bioctl/bioctl.c","sbin/bioctl/bioctl.c","str2patrol",329,359
18,5,103,1,20,"bio_status@362-382@sbin/bioctl/bioctl.c","sbin/bioctl/bioctl.c","bio_status",362,382
187,47,1065,1,207,"bio_inq@385-592@sbin/bioctl/bioctl.c","sbin/bioctl/bioctl.c","bio_inq",385,592
32,10,162,1,42,"bio_alarm@595-637@sbin/bioctl/bioctl.c","sbin/bioctl/bioctl.c","bio_alarm",595,637
24,6,175,1,29,"bio_getvolbyname@640-669@sbin/bioctl/bioctl.c","sbin/bioctl/bioctl.c","bio_getvolbyname",640,669
29,6,204,3,36,"bio_setstate@672-708@sbin/bioctl/bioctl.c","sbin/bioctl/bioctl.c","bio_setstate",672,708
62,17,465,3,79,"bio_setblink@711-790@sbin/bioctl/bioctl.c","sbin/bioctl/bioctl.c","bio_setblink",711,790
21,4,159,3,26,"bio_blink@793-819@sbin/bioctl/bioctl.c","sbin/bioctl/bioctl.c","bio_blink",793,819
91,20,613,3,117,"bio_createraid@822-939@sbin/bioctl/bioctl.c","sbin/bioctl/bioctl.c","bio_createraid",822,939
16,4,121,4,18,"bio_kdf_derive@942-960@sbin/bioctl/bioctl.c","sbin/bioctl/bioctl.c","bio_kdf_derive",942,960
17,4,154,1,22,"bio_kdf_generate@963-985@sbin/bioctl/bioctl.c","sbin/bioctl/bioctl.c","bio_kdf_generate",963,985
39,13,290,2,44,"bio_parse_devlist@988-1032@sbin/bioctl/bioctl.c","sbin/bioctl/bioctl.c","bio_parse_devlist",988,1032
29,8,158,1,33,"bio_createflags@1035-1068@sbin/bioctl/bioctl.c","sbin/bioctl/bioctl.c","bio_createflags",1035,1068
10,2,76,1,12,"bio_deleteraid@1071-1083@sbin/bioctl/bioctl.c","sbin/bioctl/bioctl.c","bio_deleteraid",1071,1083
37,5,308,1,56,"bio_changepass@1086-1142@sbin/bioctl/bioctl.c","sbin/bioctl/bioctl.c","bio_changepass",1086,1142
11,2,64,1,12,"bio_vis@1148-1160@sbin/bioctl/bioctl.c","sbin/bioctl/bioctl.c","bio_vis",1148,1160
8,2,69,1,9,"bio_diskinq@1163-1172@sbin/bioctl/bioctl.c","sbin/bioctl/bioctl.c","bio_diskinq",1163,1172
83,18,386,1,95,"bio_patrol@1175-1270@sbin/bioctl/bioctl.c","sbin/bioctl/bioctl.c","bio_patrol",1175,1270
20,3,135,1,24,"bcrypt_pbkdf_autorounds@1277-1301@sbin/bioctl/bioctl.c","sbin/bioctl/bioctl.c","bcrypt_pbkdf_autorounds",1277,1301
72,27,538,8,87,"derive_key@1304-1391@sbin/bioctl/bioctl.c","sbin/bioctl/bioctl.c","derive_key",1304,1391
5,1,21,1,4,"usage@55-59@sbin/clri/clri.c","sbin/clri/clri.c","usage",55,59
72,20,610,2,97,"main@62-159@sbin/clri/clri.c","sbin/clri/clri.c","main",62,159
11,3,72,1,14,"get_bpf_sock@69-83@sbin/dhclient/bpf.c","sbin/dhclient/bpf.c","get_bpf_sock",69,83
13,4,94,1,17,"get_udp_sock@86-103@sbin/dhclient/bpf.c","sbin/dhclient/bpf.c","get_udp_sock",86,103
32,11,242,0,58,"configure_bpf_sock@181-239@sbin/dhclient/bpf.c","sbin/dhclient/bpf.c","configure_bpf_sock",181,239
82,8,653,0,89,"send_packet@242-331@sbin/dhclient/bpf.c","sbin/dhclient/bpf.c","send_packet",242,331
66,11,438,0,118,"receive_packet@334-452@sbin/dhclient/bpf.c","sbin/dhclient/bpf.c","receive_packet",334,452
24,8,183,2,32,"add_lease@81-113@sbin/dhclient/clparse.c","sbin/dhclient/clparse.c","add_lease",81,113
46,4,265,1,52,"read_client_conf@122-174@sbin/dhclient/clparse.c","sbin/dhclient/clparse.c","read_client_conf",122,174
22,6,119,2,26,"read_client_leases@182-208@sbin/dhclient/clparse.c","sbin/dhclient/clparse.c","read_client_leases",182,208
125,48,719,3,126,"parse_client_statement@238-364@sbin/dhclient/clparse.c","sbin/dhclient/clparse.c","parse_client_statement",238,364
34,11,211,3,39,"parse_hex_octets@367-406@sbin/dhclient/clparse.c","sbin/dhclient/clparse.c","parse_hex_octets",367,406
35,9,218,3,44,"parse_option_list@413-457@sbin/dhclient/clparse.c","sbin/dhclient/clparse.c","parse_option_list",413,457
36,9,179,2,40,"parse_interface_declaration@464-504@sbin/dhclient/clparse.c","sbin/dhclient/clparse.c","parse_interface_declaration",464,504
37,9,190,3,40,"parse_client_lease_statement@516-556@sbin/dhclient/clparse.c","sbin/dhclient/clparse.c","parse_client_lease_statement",516,556
75,23,395,3,80,"parse_client_lease_declaration@573-653@sbin/dhclient/clparse.c","sbin/dhclient/clparse.c","parse_client_lease_declaration",573,653
114,34,672,3,119,"parse_option_decl@656-775@sbin/dhclient/clparse.c","sbin/dhclient/clparse.c","parse_option_decl",656,775
17,4,103,1,20,"parse_reject_statement@778-798@sbin/dhclient/clparse.c","sbin/dhclient/clparse.c","parse_reject_statement",778,798
14,1,86,1,20,"new_parse@92-112@sbin/dhclient/conflex.c","sbin/dhclient/conflex.c","new_parse",92,112
13,2,47,1,12,"eol@128-140@sbin/dhclient/conflex.c","sbin/dhclient/conflex.c","eol",128,140
16,5,80,1,18,"get_char@143-161@sbin/dhclient/conflex.c","sbin/dhclient/conflex.c","get_char",143,161
38,10,195,1,41,"get_token@164-205@sbin/dhclient/conflex.c","sbin/dhclient/conflex.c","get_token",164,205
18,4,77,2,19,"next_token@208-227@sbin/dhclient/conflex.c","sbin/dhclient/conflex.c","next_token",208,227
20,4,86,2,21,"peek_token@230-251@sbin/dhclient/conflex.c","sbin/dhclient/conflex.c","peek_token",230,251
13,4,47,1,13,"skip_to_eol@254-267@sbin/dhclient/conflex.c","sbin/dhclient/conflex.c","skip_to_eol",254,267
27,11,146,1,35,"read_string@270-305@sbin/dhclient/conflex.c","sbin/dhclient/conflex.c","read_string",270,305
36,13,224,2,42,"read_num_or_name@308-350@sbin/dhclient/conflex.c","sbin/dhclient/conflex.c","read_num_or_name",308,350
4,1,32,2,3,"kw_cmp@390-393@sbin/dhclient/conflex.c","sbin/dhclient/conflex.c","kw_cmp",390,393
9,2,63,2,9,"intern@396-405@sbin/dhclient/conflex.c","sbin/dhclient/conflex.c","intern",396,405
4,1,11,1,3,"sighdlr@188-191@sbin/dhclient/dhclient.c","sbin/dhclient/dhclient.c","sighdlr",188,191
14,4,77,2,15,"get_ifa_family@194-209@sbin/dhclient/dhclient.c","sbin/dhclient/dhclient.c","get_ifa_family",194,209
17,4,122,2,19,"interface_link_forceup@212-231@sbin/dhclient/dhclient.c","sbin/dhclient/dhclient.c","interface_link_forceup",212,231
25,10,158,1,28,"interface_status@234-262@sbin/dhclient/dhclient.c","sbin/dhclient/dhclient.c","interface_status",234,262
32,10,199,1,40,"get_hw_address@265-305@sbin/dhclient/dhclient.c","sbin/dhclient/dhclient.c","get_hw_address",265,305
97,35,582,2,109,"routehandler@308-417@sbin/dhclient/dhclient.c","sbin/dhclient/dhclient.c","routehandler",308,417
210,59,1554,2,273,"main@422-695@sbin/dhclient/dhclient.c","sbin/dhclient/dhclient.c","main",422,695
8,1,26,1,8,"usage@698-706@sbin/dhclient/dhclient.c","sbin/dhclient/dhclient.c","usage",698,706
33,10,195,1,37,"state_preboot@709-746@sbin/dhclient/dhclient.c","sbin/dhclient/dhclient.c","state_preboot",709,746
18,3,119,1,25,"state_reboot@752-777@sbin/dhclient/dhclient.c","sbin/dhclient/dhclient.c","state_reboot",752,777
10,1,59,1,11,"state_init@784-795@sbin/dhclient/dhclient.c","sbin/dhclient/dhclient.c","state_init",784,795
39,6,247,1,65,"state_selecting@802-867@sbin/dhclient/dhclient.c","sbin/dhclient/dhclient.c","state_selecting",802,867
34,9,210,3,41,"dhcpoffer@870-911@sbin/dhclient/dhclient.c","sbin/dhclient/dhclient.c","dhcpoffer",870,911
24,7,153,3,32,"dhcpack@914-946@sbin/dhclient/dhclient.c","sbin/dhclient/dhclient.c","dhcpack",914,946
26,9,155,3,37,"dhcpnak@949-986@sbin/dhclient/dhclient.c","sbin/dhclient/dhclient.c","dhcpnak",949,986
71,13,496,1,107,"bind_lease@989-1096@sbin/dhclient/dhclient.c","sbin/dhclient/dhclient.c","bind_lease",989,1096
17,2,116,1,21,"state_bound@1104-1125@sbin/dhclient/dhclient.c","sbin/dhclient/dhclient.c","state_bound",1104,1125
24,7,161,3,27,"addressinuse@1128-1155@sbin/dhclient/dhclient.c","sbin/dhclient/dhclient.c","addressinuse",1128,1155
103,26,679,2,130,"packet_to_lease@1165-1295@sbin/dhclient/dhclient.c","sbin/dhclient/dhclient.c","packet_to_lease",1165,1295
34,7,222,1,57,"send_discover@1303-1360@sbin/dhclient/dhclient.c","sbin/dhclient/dhclient.c","send_discover",1303,1360
15,2,79,1,19,"state_panic@1367-1386@sbin/dhclient/dhclient.c","sbin/dhclient/dhclient.c","state_panic",1367,1386
61,19,400,1,101,"send_request@1389-1490@sbin/dhclient/dhclient.c","sbin/dhclient/dhclient.c","send_request",1389,1490
7,2,39,1,7,"send_decline@1493-1500@sbin/dhclient/dhclient.c","sbin/dhclient/dhclient.c","send_decline",1493,1500
48,8,399,2,65,"make_discover@1503-1568@sbin/dhclient/dhclient.c","sbin/dhclient/dhclient.c","make_discover",1503,1568
58,13,481,2,84,"make_request@1571-1655@sbin/dhclient/dhclient.c","sbin/dhclient/dhclient.c","make_request",1571,1655
43,5,370,2,61,"make_decline@1658-1719@sbin/dhclient/dhclient.c","sbin/dhclient/dhclient.c","make_decline",1658,1719
12,4,75,1,15,"free_client_lease@1722-1737@sbin/dhclient/dhclient.c","sbin/dhclient/dhclient.c","free_client_lease",1722,1737
25,5,141,1,37,"rewrite_client_leases@1740-1777@sbin/dhclient/dhclient.c","sbin/dhclient/dhclient.c","rewrite_client_leases",1740,1777
27,9,176,3,31,"rewrite_option_db@1780-1811@sbin/dhclient/dhclient.c","sbin/dhclient/dhclient.c","rewrite_option_db",1780,1811
6,1,46,4,5,"append_statement@1814-1819@sbin/dhclient/dhclient.c","sbin/dhclient/dhclient.c","append_statement",1814,1819
84,16,654,1,92,"lease_as_proposal@1822-1914@sbin/dhclient/dhclient.c","sbin/dhclient/dhclient.c","lease_as_proposal",1822,1914
79,17,657,3,91,"lease_as_string@1917-2008@sbin/dhclient/dhclient.c","sbin/dhclient/dhclient.c","lease_as_string",1917,2008
17,5,97,1,25,"go_daemon@2011-2036@sbin/dhclient/dhclient.c","sbin/dhclient/dhclient.c","go_daemon",2011,2036
25,7,128,1,28,"rdaemon@2039-2067@sbin/dhclient/dhclient.c","sbin/dhclient/dhclient.c","rdaemon",2039,2067
22,9,127,1,26,"res_hnok_list@2075-2101@sbin/dhclient/dhclient.c","sbin/dhclient/dhclient.c","res_hnok_list",2075,2101
76,20,489,3,92,"fork_privchld@2104-2196@sbin/dhclient/dhclient.c","sbin/dhclient/dhclient.c","fork_privchld",2104,2196
29,10,245,3,32,"get_ifname@2199-2231@sbin/dhclient/dhclient.c","sbin/dhclient/dhclient.c","get_ifname",2199,2231
109,24,925,1,127,"apply_defaults@2234-2361@sbin/dhclient/dhclient.c","sbin/dhclient/dhclient.c","apply_defaults",2234,2361
42,10,305,1,48,"clone_lease@2364-2412@sbin/dhclient/dhclient.c","sbin/dhclient/dhclient.c","clone_lease",2364,2412
25,7,161,1,30,"apply_ignore_list@2420-2450@sbin/dhclient/dhclient.c","sbin/dhclient/dhclient.c","apply_ignore_list",2420,2450
46,12,328,2,55,"take_charge@2453-2508@sbin/dhclient/dhclient.c","sbin/dhclient/dhclient.c","take_charge",2453,2508
31,12,233,1,37,"get_recorded_lease@2511-2548@sbin/dhclient/dhclient.c","sbin/dhclient/dhclient.c","get_recorded_lease",2511,2548
14,4,102,1,22,"set_default_client_identifier@2551-2573@sbin/dhclient/dhclient.c","sbin/dhclient/dhclient.c","set_default_client_identifier",2551,2573
17,5,107,1,19,"lease_expiry@2576-2595@sbin/dhclient/dhclient.c","sbin/dhclient/dhclient.c","lease_expiry",2576,2595
15,3,94,1,17,"lease_renewal@2598-2615@sbin/dhclient/dhclient.c","sbin/dhclient/dhclient.c","lease_renewal",2598,2615
18,4,121,1,20,"lease_rebind@2618-2638@sbin/dhclient/dhclient.c","sbin/dhclient/dhclient.c","lease_rebind",2618,2638
71,21,496,2,91,"dispatch@82-173@sbin/dhclient/dispatch.c","sbin/dhclient/dispatch.c","dispatch",82,173
94,25,566,1,125,"packethandler@176-301@sbin/dhclient/dispatch.c","sbin/dhclient/dispatch.c","packethandler",176,301
15,7,67,1,14,"flush_unpriv_ibuf@307-321@sbin/dhclient/dispatch.c","sbin/dhclient/dispatch.c","flush_unpriv_ibuf",307,321
7,1,43,3,6,"set_timeout@324-330@sbin/dhclient/dispatch.c","sbin/dhclient/dispatch.c","set_timeout",324,330
5,1,21,1,4,"cancel_timeout@333-337@sbin/dhclient/dispatch.c","sbin/dhclient/dispatch.c","cancel_timeout",333,337
7,2,43,1,7,"sendhup@343-350@sbin/dhclient/dispatch.c","sbin/dhclient/dispatch.c","sendhup",343,350
45,8,247,2,48,"get_routes@62-110@sbin/dhclient/kroute.c","sbin/dhclient/kroute.c","get_routes",62,110
13,3,88,2,15,"flush_routes@119-134@sbin/dhclient/kroute.c","sbin/dhclient/kroute.c","flush_routes",119,134
41,12,275,4,47,"priv_flush_routes@137-184@sbin/dhclient/kroute.c","sbin/dhclient/kroute.c","priv_flush_routes",137,184
25,8,176,5,30,"extract_classless_route@187-217@sbin/dhclient/kroute.c","sbin/dhclient/kroute.c","extract_classless_route",187,217
34,7,224,4,73,"set_routes@220-293@sbin/dhclient/kroute.c","sbin/dhclient/kroute.c","set_routes",220,293
14,2,88,4,15,"add_route@299-314@sbin/dhclient/kroute.c","sbin/dhclient/kroute.c","add_route",299,314
55,5,463,4,70,"priv_add_route@317-387@sbin/dhclient/kroute.c","sbin/dhclient/kroute.c","priv_add_route",317,387
29,10,213,3,33,"delete_addresses@396-429@sbin/dhclient/kroute.c","sbin/dhclient/kroute.c","delete_addresses",396,429
10,2,59,1,11,"delete_address@437-448@sbin/dhclient/kroute.c","sbin/dhclient/kroute.c","delete_address",437,448
16,3,132,3,23,"priv_delete_address@451-474@sbin/dhclient/kroute.c","sbin/dhclient/kroute.c","priv_delete_address",451,474
16,4,92,2,18,"set_mtu@482-500@sbin/dhclient/kroute.c","sbin/dhclient/kroute.c","set_mtu",482,500
9,2,83,3,11,"priv_set_mtu@503-514@sbin/dhclient/kroute.c","sbin/dhclient/kroute.c","priv_set_mtu",503,514
13,3,88,3,16,"set_address@522-538@sbin/dhclient/kroute.c","sbin/dhclient/kroute.c","set_address",522,538
18,2,173,3,25,"priv_set_address@541-566@sbin/dhclient/kroute.c","sbin/dhclient/kroute.c","priv_set_address",541,566
9,2,43,1,9,"write_resolv_conf@572-581@sbin/dhclient/kroute.c","sbin/dhclient/kroute.c","write_resolv_conf",572,581
23,5,135,1,27,"priv_write_resolv_conf@584-611@sbin/dhclient/kroute.c","sbin/dhclient/kroute.c","priv_write_resolv_conf",584,611
78,17,550,2,86,"default_route_index@618-704@sbin/dhclient/kroute.c","sbin/dhclient/kroute.c","default_route_index",618,704
68,17,453,5,84,"set_resolv_conf@712-796@sbin/dhclient/kroute.c","sbin/dhclient/kroute.c","set_resolv_conf",712,796
12,3,87,3,12,"get_rtaddrs@803-815@sbin/dhclient/kroute.c","sbin/dhclient/kroute.c","get_rtaddrs",803,815
39,12,263,3,47,"route_in_rtstatic@818-865@sbin/dhclient/kroute.c","sbin/dhclient/kroute.c","route_in_rtstatic",818,865
10,2,48,2,12,"log_init@34-46@sbin/dhclient/log.c","sbin/dhclient/log.c","log_init",34,46
5,2,19,1,4,"log_procinit@49-53@sbin/dhclient/log.c","sbin/dhclient/log.c","log_procinit",49,53
4,1,11,1,3,"log_setverbose@56-59@sbin/dhclient/log.c","sbin/dhclient/log.c","log_setverbose",56,59
4,1,11,1,3,"log_getverbose@62-65@sbin/dhclient/log.c","sbin/dhclient/log.c","log_getverbose",62,65
7,1,38,3,7,"logit@68-75@sbin/dhclient/log.c","sbin/dhclient/log.c","logit",68,75
17,3,99,3,19,"vlog@78-97@sbin/dhclient/log.c","sbin/dhclient/log.c","vlog",78,97
21,3,120,2,25,"log_warn@100-125@sbin/dhclient/log.c","sbin/dhclient/log.c","log_warn",100,125
7,1,35,2,7,"log_warnx@128-135@sbin/dhclient/log.c","sbin/dhclient/log.c","log_warnx",128,135
7,1,35,2,7,"log_info@138-145@sbin/dhclient/log.c","sbin/dhclient/log.c","log_info",138,145
9,2,41,2,9,"log_debug@148-157@sbin/dhclient/log.c","sbin/dhclient/log.c","log_debug",148,157
17,3,106,3,17,"vfatalc@160-177@sbin/dhclient/log.c","sbin/dhclient/log.c","vfatalc",160,177
8,1,40,2,8,"fatal@180-188@sbin/dhclient/log.c","sbin/dhclient/log.c","fatal",180,188
8,1,40,2,8,"fatalx@191-199@sbin/dhclient/log.c","sbin/dhclient/log.c","fatalx",191,199
13,6,88,1,16,"code_to_name@347-363@sbin/dhclient/options.c","sbin/dhclient/options.c","code_to_name",347,363
18,7,122,1,19,"name_to_code@366-385@sbin/dhclient/options.c","sbin/dhclient/options.c","name_to_code",366,385
8,4,42,1,9,"code_to_format@388-397@sbin/dhclient/options.c","sbin/dhclient/options.c","code_to_format",388,397
55,12,385,3,86,"parse_option_buffer@404-490@sbin/dhclient/options.c","sbin/dhclient/options.c","parse_option_buffer",404,490
36,9,257,3,45,"pack_options@498-543@sbin/dhclient/options.c","sbin/dhclient/options.c","pack_options",498,543
22,7,181,3,27,"pretty_print_string@552-579@sbin/dhclient/options.c","sbin/dhclient/options.c","pretty_print_string",552,579
35,9,252,4,40,"pretty_print_classless_routes@586-626@sbin/dhclient/options.c","sbin/dhclient/options.c","pretty_print_classless_routes",586,626
53,8,292,4,78,"expand_search_domain_name@629-707@sbin/dhclient/options.c","sbin/dhclient/options.c","expand_search_domain_name",629,707
27,5,140,2,30,"pretty_print_domain_search@714-744@sbin/dhclient/options.c","sbin/dhclient/options.c","pretty_print_domain_search",714,744
194,50,1059,3,214,"pretty_print_option@750-964@sbin/dhclient/options.c","sbin/dhclient/options.c","pretty_print_option",750,964
28,7,206,1,33,"unpack_options@967-1000@sbin/dhclient/options.c","sbin/dhclient/options.c","unpack_options",967,1000
15,5,101,3,23,"checksum@63-86@sbin/dhclient/packet.c","sbin/dhclient/packet.c","checksum",63,86
5,1,19,1,4,"wrapsum@89-93@sbin/dhclient/packet.c","sbin/dhclient/packet.c","wrapsum",89,93
7,1,56,2,8,"assemble_eh_header@96-104@sbin/dhclient/packet.c","sbin/dhclient/packet.c","assemble_eh_header",96,104
9,2,66,3,12,"decode_hw_header@107-119@sbin/dhclient/packet.c","sbin/dhclient/packet.c","decode_hw_header",107,119
86,24,568,3,112,"decode_udp_ip_header@122-234@sbin/dhclient/packet.c","sbin/dhclient/packet.c","decode_udp_ip_header",122,234
23,8,119,1,23,"skip_to_semi@83-106@sbin/dhclient/parse.c","sbin/dhclient/parse.c","skip_to_semi",83,106
11,2,44,1,11,"parse_semi@109-120@sbin/dhclient/parse.c","sbin/dhclient/parse.c","parse_semi",109,120
23,6,142,3,26,"parse_string@123-149@sbin/dhclient/parse.c","sbin/dhclient/parse.c","parse_string",123,149
34,9,202,2,37,"parse_cidr@157-194@sbin/dhclient/parse.c","sbin/dhclient/parse.c","parse_cidr",157,194
26,5,154,2,29,"parse_ip_addr@197-226@sbin/dhclient/parse.c","sbin/dhclient/parse.c","parse_ip_addr",197,226
17,3,87,2,19,"parse_lease_time@232-251@sbin/dhclient/parse.c","sbin/dhclient/parse.c","parse_lease_time",232,251
22,7,124,2,24,"parse_boolean@254-278@sbin/dhclient/parse.c","sbin/dhclient/parse.c","parse_boolean",254,278
52,9,251,3,57,"parse_decimal@281-338@sbin/dhclient/parse.c","sbin/dhclient/parse.c","parse_decimal",281,338
17,4,121,1,17,"parse_warn@341-358@sbin/dhclient/parse.c","sbin/dhclient/parse.c","parse_warn",341,358
111,27,537,5,123,"dispatch_imsg@42-165@sbin/dhclient/privsep.c","sbin/dhclient/privsep.c","dispatch_imsg",42,165
7,2,57,1,7,"getphysmem@108-115@sbin/disklabel/disklabel.c","sbin/disklabel/disklabel.c","getphysmem",108,115
162,69,899,2,175,"main@118-293@sbin/disklabel/disklabel.c","sbin/disklabel/disklabel.c","main",118,293
11,3,89,3,12,"makelabel@301-313@sbin/disklabel/disklabel.c","sbin/disklabel/disklabel.c","makelabel",301,313
19,5,109,2,22,"writelabel@317-339@sbin/disklabel/disklabel.c","sbin/disklabel/disklabel.c","writelabel",317,339
22,5,75,1,22,"l_perror@342-364@sbin/disklabel/disklabel.c","sbin/disklabel/disklabel.c","l_perror",342,364
12,8,86,1,13,"readlabel@370-383@sbin/disklabel/disklabel.c","sbin/disklabel/disklabel.c","readlabel",370,383
31,7,240,1,32,"parselabel@386-418@sbin/disklabel/disklabel.c","sbin/disklabel/disklabel.c","parselabel",386,418
56,12,481,2,66,"makedisktab@421-487@sbin/disklabel/disklabel.c","sbin/disklabel/disklabel.c","makedisktab",421,487
21,7,113,3,22,"scale@490-512@sbin/disklabel/disklabel.c","sbin/disklabel/disklabel.c","scale",490,512
34,7,240,4,37,"display_partition@518-555@sbin/disklabel/disklabel.c","sbin/disklabel/disklabel.c","display_partition",518,555
23,8,166,2,24,"canonical_unit@558-582@sbin/disklabel/disklabel.c","sbin/disklabel/disklabel.c","canonical_unit",558,582
54,12,501,4,58,"display@585-643@sbin/disklabel/disklabel.c","sbin/disklabel/disklabel.c","display",585,643
65,15,395,2,67,"edit@646-713@sbin/disklabel/disklabel.c","sbin/disklabel/disklabel.c","edit",646,713
41,11,303,1,43,"editit@722-765@sbin/disklabel/disklabel.c","sbin/disklabel/disklabel.c","editit",722,765
7,2,34,1,7,"skip@768-775@sbin/disklabel/disklabel.c","sbin/disklabel/disklabel.c","skip",768,775
11,3,61,1,11,"word@778-789@sbin/disklabel/disklabel.c","sbin/disklabel/disklabel.c","word",778,789
12,3,87,4,12,"getnum@799-811@sbin/disklabel/disklabel.c","sbin/disklabel/disklabel.c","getnum",799,811
24,9,170,2,26,"duid_parse@814-840@sbin/disklabel/disklabel.c","sbin/disklabel/disklabel.c","duid_parse",814,840
259,77,1625,2,282,"getasciilabel@848-1130@sbin/disklabel/disklabel.c","sbin/disklabel/disklabel.c","getasciilabel",848,1130
82,34,558,1,88,"checklabel@1137-1225@sbin/disklabel/disklabel.c","sbin/disklabel/disklabel.c","checklabel",1137,1225
15,1,118,2,17,"cmplabel@1228-1245@sbin/disklabel/disklabel.c","sbin/disklabel/disklabel.c","cmplabel",1228,1245
26,2,90,1,27,"usage@1248-1275@sbin/disklabel/disklabel.c","sbin/disklabel/disklabel.c","usage",1248,1275
10,2,62,1,10,"dkcksum@39-49@sbin/disklabel/dkcksum.c","sbin/disklabel/dkcksum.c","dkcksum",39,49
266,79,1519,1,342,"editor@171-513@sbin/disklabel/editor.c","sbin/disklabel/editor.c","editor",171,513
143,42,1020,1,173,"editor_allocspace@520-693@sbin/disklabel/editor.c","sbin/disklabel/editor.c","editor_allocspace",520,693
78,21,465,2,95,"editor_resize@699-794@sbin/disklabel/editor.c","sbin/disklabel/editor.c","editor_resize",699,794
84,30,615,2,109,"editor_add@800-909@sbin/disklabel/editor.c","sbin/disklabel/editor.c","editor_add",800,909
32,13,205,2,37,"editor_name@915-952@sbin/disklabel/editor.c","sbin/disklabel/editor.c","editor_name",915,952
34,15,222,2,40,"editor_modify@958-998@sbin/disklabel/editor.c","sbin/disklabel/editor.c","editor_modify",958,998
32,9,189,2,35,"editor_delete@1004-1039@sbin/disklabel/editor.c","sbin/disklabel/editor.c","editor_delete",1004,1039
28,7,167,2,32,"editor_change@1045-1077@sbin/disklabel/editor.c","sbin/disklabel/editor.c","editor_change",1045,1077
13,3,80,2,13,"partition_cmp@1084-1097@sbin/disklabel/editor.c","sbin/disklabel/editor.c","partition_cmp",1084,1097
25,10,190,3,26,"getstring@1100-1126@sbin/disklabel/editor.c","sbin/disklabel/editor.c","getstring",1100,1126
122,41,805,7,141,"getuint64@1133-1274@sbin/disklabel/editor.c","sbin/disklabel/editor.c","getuint64",1133,1274
41,10,323,1,53,"has_overlap@1281-1334@sbin/disklabel/editor.c","sbin/disklabel/editor.c","has_overlap",1281,1334
136,31,749,1,152,"edit_parms@1337-1489@sbin/disklabel/editor.c","sbin/disklabel/editor.c","edit_parms",1337,1489
17,7,150,1,24,"sort_partitions@1492-1516@sbin/disklabel/editor.c","sbin/disklabel/editor.c","sort_partitions",1492,1516
68,16,420,3,70,"getdisktype@1522-1592@sbin/disklabel/editor.c","sbin/disklabel/editor.c","getdisktype",1522,1592
28,5,157,1,31,"set_bounds@1599-1630@sbin/disklabel/editor.c","sbin/disklabel/editor.c","set_bounds",1599,1630
20,5,146,1,21,"set_duid@1636-1657@sbin/disklabel/editor.c","sbin/disklabel/editor.c","set_duid",1636,1657
42,10,292,1,49,"free_chunks@1663-1712@sbin/disklabel/editor.c","sbin/disklabel/editor.c","free_chunks",1663,1712
12,3,44,1,12,"find_bounds@1715-1727@sbin/disklabel/editor.c","sbin/disklabel/editor.c","find_bounds",1715,1727
10,3,77,1,12,"editor_countfree@1733-1745@sbin/disklabel/editor.c","sbin/disklabel/editor.c","editor_countfree",1733,1745
23,1,33,1,23,"editor_help@1748-1771@sbin/disklabel/editor.c","sbin/disklabel/editor.c","editor_help",1748,1771
13,4,85,2,13,"mpcopy@1774-1787@sbin/disklabel/editor.c","sbin/disklabel/editor.c","mpcopy",1774,1787
13,9,109,2,14,"mpequal@1790-1804@sbin/disklabel/editor.c","sbin/disklabel/editor.c","mpequal",1790,1804
51,15,467,1,58,"mpsave@1807-1865@sbin/disklabel/editor.c","sbin/disklabel/editor.c","mpsave",1807,1865
9,3,45,1,11,"mpfree@1868-1879@sbin/disklabel/editor.c","sbin/disklabel/editor.c","mpfree",1868,1879
41,14,282,2,46,"get_offset@1882-1928@sbin/disklabel/editor.c","sbin/disklabel/editor.c","get_offset",1882,1928
32,8,196,2,36,"get_size@1931-1967@sbin/disklabel/editor.c","sbin/disklabel/editor.c","get_size",1931,1967
24,7,143,2,25,"get_cpg@1970-1995@sbin/disklabel/editor.c","sbin/disklabel/editor.c","get_cpg",1970,1995
31,10,206,2,33,"get_fsize@1998-2031@sbin/disklabel/editor.c","sbin/disklabel/editor.c","get_fsize",1998,2031
63,23,462,2,82,"get_bsize@2034-2116@sbin/disklabel/editor.c","sbin/disklabel/editor.c","get_bsize",2034,2116
42,9,221,2,42,"get_fstype@2119-2161@sbin/disklabel/editor.c","sbin/disklabel/editor.c","get_fstype",2119,2161
41,17,258,2,42,"get_mp@2164-2206@sbin/disklabel/editor.c","sbin/disklabel/editor.c","get_mp",2164,2206
13,5,101,2,14,"micmp@2209-2223@sbin/disklabel/editor.c","sbin/disklabel/editor.c","micmp",2209,2223
12,4,92,2,14,"get_geometry@2226-2240@sbin/disklabel/editor.c","sbin/disklabel/editor.c","get_geometry",2226,2240
54,16,291,4,53,"set_geometry@2243-2296@sbin/disklabel/editor.c","sbin/disklabel/editor.c","set_geometry",2243,2296
10,2,77,1,11,"zero_partitions@2299-2310@sbin/disklabel/editor.c","sbin/disklabel/editor.c","zero_partitions",2299,2310
19,5,143,2,20,"max_partition_size@2313-2333@sbin/disklabel/editor.c","sbin/disklabel/editor.c","max_partition_size",2313,2333
8,3,58,3,7,"psize@2336-2343@sbin/disklabel/editor.c","sbin/disklabel/editor.c","psize",2336,2343
17,2,120,3,19,"display_edit@2346-2365@sbin/disklabel/editor.c","sbin/disklabel/editor.c","display_edit",2346,2365
38,14,372,1,40,"parse_autotable@2368-2408@sbin/disklabel/editor.c","sbin/disklabel/editor.c","parse_autotable",2368,2408
20,7,137,2,23,"get_token@2411-2434@sbin/disklabel/editor.c","sbin/disklabel/editor.c","get_token",2411,2434
22,6,94,3,26,"apply_unit@2437-2463@sbin/disklabel/editor.c","sbin/disklabel/editor.c","apply_unit",2437,2463
9,6,77,3,8,"parse_sizespec@2466-2474@sbin/disklabel/editor.c","sbin/disklabel/editor.c","parse_sizespec",2466,2474
31,12,244,3,31,"parse_sizerange@2477-2508@sbin/disklabel/editor.c","sbin/disklabel/editor.c","parse_sizerange",2477,2508
13,3,89,2,13,"parse_pct@2511-2524@sbin/disklabel/editor.c","sbin/disklabel/editor.c","parse_pct",2511,2524
108,36,760,2,126,"main@63-189@sbin/dmesg/dmesg.c","sbin/dmesg/dmesg.c","main",63,189
6,1,25,1,6,"usage@192-198@sbin/dmesg/dmesg.c","sbin/dmesg/dmesg.c","usage",192,198
14,3,70,1,14,"rmthost@86-100@sbin/dump/dumprmt.c","sbin/dump/dumprmt.c","rmthost",86,100
4,1,14,1,4,"rmtconnaborted@104-108@sbin/dump/dumprmt.c","sbin/dump/dumprmt.c","rmtconnaborted",104,108
44,11,323,1,49,"rmtgetconn@111-160@sbin/dump/dumprmt.c","sbin/dump/dumprmt.c","rmtgetconn",111,160
13,6,78,1,13,"okname@163-176@sbin/dump/dumprmt.c","sbin/dump/dumprmt.c","okname",163,176
7,1,50,2,7,"rmtopen@179-186@sbin/dump/dumprmt.c","sbin/dump/dumprmt.c","rmtopen",179,186
7,2,25,1,7,"rmtclose@189-196@sbin/dump/dumprmt.c","sbin/dump/dumprmt.c","rmtclose",189,196
18,4,117,2,18,"rmtread@199-217@sbin/dump/dumprmt.c","sbin/dump/dumprmt.c","rmtread",199,217
8,1,63,2,8,"rmtwrite@220-228@sbin/dump/dumprmt.c","sbin/dump/dumprmt.c","rmtwrite",220,228
6,1,45,2,6,"rmtseek@231-237@sbin/dump/dumprmt.c","sbin/dump/dumprmt.c","rmtseek",231,237
8,2,57,2,8,"rmtioctl@240-248@sbin/dump/dumprmt.c","sbin/dump/dumprmt.c","rmtioctl",240,248
6,2,44,2,6,"rmtcall@251-257@sbin/dump/dumprmt.c","sbin/dump/dumprmt.c","rmtcall",251,257
23,7,151,1,25,"rmtreply@260-285@sbin/dump/dumprmt.c","sbin/dump/dumprmt.c","rmtreply",260,285
7,2,33,1,7,"rmtgetb@288-295@sbin/dump/dumprmt.c","sbin/dump/dumprmt.c","rmtgetb",288,295
17,3,78,2,17,"rmtgets@299-316@sbin/dump/dumprmt.c","sbin/dump/dumprmt.c","rmtgets",299,316
23,5,146,1,29,"initdumptimes@61-90@sbin/dump/itime.c","sbin/dump/itime.c","initdumptimes",61,90
20,4,134,1,25,"readdumptimes@93-118@sbin/dump/itime.c","sbin/dump/itime.c","readdumptimes",93,118
23,7,145,1,30,"getdumptime@121-151@sbin/dump/itime.c","sbin/dump/itime.c","getdumptime",121,151
50,11,361,1,55,"putdumptime@154-209@sbin/dump/itime.c","sbin/dump/itime.c","putdumptime",154,209
8,2,52,2,8,"dumprecout@212-220@sbin/dump/itime.c","sbin/dump/itime.c","dumprecout",212,220
14,5,102,2,17,"getrecord@225-242@sbin/dump/itime.c","sbin/dump/itime.c","getrecord",225,242
21,7,169,2,21,"makedumpdate@245-266@sbin/dump/itime.c","sbin/dump/itime.c","makedumpdate",245,266
406,120,2739,2,497,"main@85-582@sbin/dump/main.c","sbin/dump/main.c","main",85,582
10,1,31,1,10,"usage@585-595@sbin/dump/main.c","sbin/dump/main.c","usage",585,595
12,3,73,3,13,"numarg@602-615@sbin/dump/main.c","sbin/dump/main.c","numarg",602,615
15,5,61,1,16,"sig@618-634@sbin/dump/main.c","sbin/dump/main.c","sig",618,634
13,3,92,1,13,"rawname@637-650@sbin/dump/main.c","sbin/dump/main.c","rawname",637,650
28,5,211,1,30,"getduid@653-683@sbin/dump/main.c","sbin/dump/main.c","getduid",653,683
55,18,352,2,68,"obsolete@691-759@sbin/dump/main.c","sbin/dump/main.c","obsolete",691,759
39,11,266,1,48,"query@74-122@sbin/dump/optr.c","sbin/dump/optr.c","query",74,122
23,4,98,1,23,"alarmcatch@133-156@sbin/dump/optr.c","sbin/dump/optr.c","alarmcatch",133,156
6,2,24,1,5,"interrupt@163-168@sbin/dump/optr.c","sbin/dump/optr.c","interrupt",163,168
16,5,123,1,19,"broadcast@174-193@sbin/dump/optr.c","sbin/dump/optr.c","broadcast",174,193
17,3,99,1,17,"timeest@202-219@sbin/dump/optr.c","sbin/dump/optr.c","timeest",202,219
14,2,107,2,16,"msg@222-238@sbin/dump/optr.c","sbin/dump/optr.c","msg",222,238
7,1,38,2,7,"msgtail@241-248@sbin/dump/optr.c","sbin/dump/optr.c","msgtail",241,248
12,2,83,2,14,"quit@252-266@sbin/dump/optr.c","sbin/dump/optr.c","quit",252,266
13,5,107,1,13,"allocfsent@274-287@sbin/dump/optr.c","sbin/dump/optr.c","allocfsent",274,287
26,9,164,1,26,"getfstab@297-323@sbin/dump/optr.c","sbin/dump/optr.c","getfstab",297,323
30,14,224,1,30,"fstabsearch@337-367@sbin/dump/optr.c","sbin/dump/optr.c","fstabsearch",337,367
38,10,237,1,39,"lastdump@376-415@sbin/dump/optr.c","sbin/dump/optr.c","lastdump",376,415
10,2,85,2,10,"datesort@418-428@sbin/dump/optr.c","sbin/dump/optr.c","datesort",418,428
25,7,211,1,36,"alloctape@118-154@sbin/dump/tape.c","sbin/dump/tape.c","alloctape",118,154
12,3,83,2,12,"writerec@157-169@sbin/dump/tape.c","sbin/dump/tape.c","writerec",157,169
17,3,117,2,17,"dumpblock@172-189@sbin/dump/tape.c","sbin/dump/tape.c","dumpblock",172,189
18,3,83,1,20,"tperror@195-215@sbin/dump/tape.c","sbin/dump/tape.c","tperror",195,215
4,1,12,1,4,"sigpipe@219-223@sbin/dump/tape.c","sbin/dump/tape.c","sigpipe",219,223
18,2,115,1,18,"do_stats@230-248@sbin/dump/tape.c","sbin/dump/tape.c","do_stats",230,248
18,2,141,1,18,"statussig@258-276@sbin/dump/tape.c","sbin/dump/tape.c","statussig",258,276
60,16,417,1,75,"flushtape@279-354@sbin/dump/tape.c","sbin/dump/tape.c","flushtape",279,354
41,13,261,1,66,"trewind@357-423@sbin/dump/tape.c","sbin/dump/tape.c","trewind",357,423
15,5,66,1,15,"close_rewind@426-441@sbin/dump/tape.c","sbin/dump/tape.c","close_rewind",426,441
77,14,533,1,105,"rollforward@444-549@sbin/dump/tape.c","sbin/dump/tape.c","rollforward",444,549
103,30,573,1,134,"startnewtape@561-695@sbin/dump/tape.c","sbin/dump/tape.c","startnewtape",561,695
11,4,50,1,14,"dumpabort@699-713@sbin/dump/tape.c","sbin/dump/tape.c","dumpabort",699,713
5,2,23,1,7,"Exit@716-723@sbin/dump/tape.c","sbin/dump/tape.c","Exit",716,723
4,1,10,1,3,"proceed@730-733@sbin/dump/tape.c","sbin/dump/tape.c","proceed",730,733
36,8,296,1,41,"enslave@736-777@sbin/dump/tape.c","sbin/dump/tape.c","enslave",736,777
9,3,59,1,9,"killall@780-789@sbin/dump/tape.c","sbin/dump/tape.c","killall",780,789
71,24,513,2,109,"doslave@799-908@sbin/dump/tape.c","sbin/dump/tape.c","doslave",799,908
7,4,80,4,7,"atomic@916-923@sbin/dump/tape.c","sbin/dump/tape.c","atomic",916,923
14,3,102,1,29,"blockest@80-109@sbin/dump/traverse.c","sbin/dump/traverse.c","blockest",80,109
26,11,159,3,26,"mapfileino@119-145@sbin/dump/traverse.c","sbin/dump/traverse.c","mapfileino",119,145
41,13,278,3,50,"fs_mapinodes@148-198@sbin/dump/traverse.c","sbin/dump/traverse.c","fs_mapinodes",148,198
68,17,429,4,85,"mapfiles@208-293@sbin/dump/traverse.c","sbin/dump/traverse.c","mapfiles",208,293
59,20,426,2,69,"mapdirs@308-377@sbin/dump/traverse.c","sbin/dump/traverse.c","mapdirs",308,377
35,11,262,6,35,"dirindir@385-420@sbin/dump/traverse.c","sbin/dump/traverse.c","dirindir",385,420
55,17,348,6,59,"searchdir@428-487@sbin/dump/traverse.c","sbin/dump/traverse.c","searchdir",428,487
39,10,211,2,43,"main@79-122@sbin/dumpfs/dumpfs.c","sbin/dumpfs/dumpfs.c","main",79,122
24,10,178,1,28,"open_disk@125-153@sbin/dumpfs/dumpfs.c","sbin/dumpfs/dumpfs.c","open_disk",125,153
160,32,1173,2,164,"dumpfs@156-320@sbin/dumpfs/dumpfs.c","sbin/dumpfs/dumpfs.c","dumpfs",156,320
72,14,552,3,75,"dumpcg@323-398@sbin/dumpfs/dumpfs.c","sbin/dumpfs/dumpfs.c","dumpcg",323,398
33,4,200,1,38,"marshal@401-439@sbin/dumpfs/dumpfs.c","sbin/dumpfs/dumpfs.c","marshal",401,439
19,8,124,2,19,"pbits@442-461@sbin/dumpfs/dumpfs.c","sbin/dumpfs/dumpfs.c","pbits",442,461
5,1,21,1,4,"usage@464-468@sbin/dumpfs/dumpfs.c","sbin/dumpfs/dumpfs.c","usage",464,468
29,6,174,2,33,"Xreinit@45-78@sbin/fdisk/cmd.c","sbin/fdisk/cmd.c","Xreinit",45,78
20,3,126,2,28,"Xdisk@81-109@sbin/fdisk/cmd.c","sbin/fdisk/cmd.c","Xdisk",81,109
42,7,263,2,48,"Xswap@112-160@sbin/fdisk/cmd.c","sbin/fdisk/cmd.c","Xswap",112,160
48,8,337,1,57,"Xgedit@163-220@sbin/fdisk/cmd.c","sbin/fdisk/cmd.c","Xgedit",163,220
51,10,410,2,61,"Xedit@223-284@sbin/fdisk/cmd.c","sbin/fdisk/cmd.c","Xedit",223,284
29,5,196,1,35,"Xgsetpid@287-322@sbin/fdisk/cmd.c","sbin/fdisk/cmd.c","Xgsetpid",287,322
21,4,144,2,28,"Xsetpid@325-353@sbin/fdisk/cmd.c","sbin/fdisk/cmd.c","Xsetpid",325,353
29,6,177,2,37,"Xselect@356-393@sbin/fdisk/cmd.c","sbin/fdisk/cmd.c","Xselect",356,393
8,3,51,2,9,"Xprint@396-405@sbin/fdisk/cmd.c","sbin/fdisk/cmd.c","Xprint",396,405
30,9,210,2,37,"Xwrite@408-445@sbin/fdisk/cmd.c","sbin/fdisk/cmd.c","Xwrite",408,445
4,1,18,2,3,"Xquit@448-451@sbin/fdisk/cmd.c","sbin/fdisk/cmd.c","Xquit",448,451
4,1,18,2,3,"Xabort@454-457@sbin/fdisk/cmd.c","sbin/fdisk/cmd.c","Xabort",454,457
4,1,18,2,3,"Xexit@460-463@sbin/fdisk/cmd.c","sbin/fdisk/cmd.c","Xexit",460,463
18,5,130,2,19,"Xhelp@466-485@sbin/fdisk/cmd.c","sbin/fdisk/cmd.c","Xhelp",466,485
7,1,47,2,7,"Xupdate@488-495@sbin/fdisk/cmd.c","sbin/fdisk/cmd.c","Xupdate",488,495
51,12,347,2,57,"Xflag@498-555@sbin/fdisk/cmd.c","sbin/fdisk/cmd.c","Xflag",498,555
22,5,141,2,24,"Xmanual@558-582@sbin/fdisk/cmd.c","sbin/fdisk/cmd.c","Xmanual",558,582
34,13,273,1,39,"DISK_open@41-80@sbin/fdisk/disk.c","sbin/fdisk/disk.c","DISK_open",41,80
18,4,132,1,19,"DISK_printgeometry@87-106@sbin/fdisk/disk.c","sbin/fdisk/disk.c","DISK_printgeometry",87,106
21,5,115,1,25,"DISK_readsector@116-141@sbin/fdisk/disk.c","sbin/fdisk/disk.c","DISK_readsector",116,141
17,4,95,2,21,"DISK_writesector@149-170@sbin/fdisk/disk.c","sbin/fdisk/disk.c","DISK_writesector",149,170
20,1,38,1,20,"usage@48-68@sbin/fdisk/fdisk.c","sbin/fdisk/fdisk.c","usage",48,68
145,51,874,2,164,"main@71-235@sbin/fdisk/fdisk.c","sbin/fdisk/fdisk.c","main",71,235
79,15,559,1,98,"GPT_get_header@46-144@sbin/fdisk/gpt.c","sbin/fdisk/gpt.c","GPT_get_header",46,144
37,6,268,1,42,"GPT_get_partition_table@147-189@sbin/fdisk/gpt.c","sbin/fdisk/gpt.c","GPT_get_partition_table",147,189
18,8,144,1,27,"GPT_get_gpt@192-219@sbin/fdisk/gpt.c","sbin/fdisk/gpt.c","GPT_get_gpt",192,219
31,7,234,2,35,"GPT_print@222-257@sbin/fdisk/gpt.c","sbin/fdisk/gpt.c","GPT_print",222,257
9,2,28,1,8,"GPT_print_parthdr@260-268@sbin/fdisk/gpt.c","sbin/fdisk/gpt.c","GPT_print_parthdr",260,268
27,4,214,3,28,"GPT_print_part@271-299@sbin/fdisk/gpt.c","sbin/fdisk/gpt.c","GPT_print_part",271,299
64,10,594,1,76,"GPT_init@302-378@sbin/fdisk/gpt.c","sbin/fdisk/gpt.c","GPT_init",302,378
53,9,439,1,77,"GPT_write@381-458@sbin/fdisk/gpt.c","sbin/fdisk/gpt.c","GPT_write",381,458
11,2,92,1,12,"MBR_protective_mbr@40-52@sbin/fdisk/mbr.c","sbin/fdisk/mbr.c","MBR_protective_mbr",40,52
8,1,70,1,17,"MBR_init_GPT@55-72@sbin/fdisk/mbr.c","sbin/fdisk/mbr.c","MBR_init_GPT",55,72
56,10,618,1,80,"MBR_init@75-155@sbin/fdisk/mbr.c","sbin/fdisk/mbr.c","MBR_init",75,155
12,2,119,4,14,"MBR_parse@158-172@sbin/fdisk/mbr.c","sbin/fdisk/mbr.c","MBR_parse",158,172
13,2,109,2,14,"MBR_make@175-189@sbin/fdisk/mbr.c","sbin/fdisk/mbr.c","MBR_make",175,189
10,2,83,2,14,"MBR_print@192-206@sbin/fdisk/mbr.c","sbin/fdisk/mbr.c","MBR_print",192,206
10,2,58,2,12,"MBR_read@209-221@sbin/fdisk/mbr.c","sbin/fdisk/mbr.c","MBR_read",209,221
12,2,76,2,21,"MBR_write@224-245@sbin/fdisk/mbr.c","sbin/fdisk/mbr.c","MBR_write",224,245
30,8,208,2,35,"MBR_zapgpt@254-289@sbin/fdisk/mbr.c","sbin/fdisk/mbr.c","MBR_zapgpt",254,289
23,9,137,2,24,"gpt_chk_mbr@302-326@sbin/fdisk/mbr.c","sbin/fdisk/mbr.c","gpt_chk_mbr",302,326
14,5,81,1,17,"unit_lookup@45-62@sbin/fdisk/misc.c","sbin/fdisk/misc.c","unit_lookup",45,62
15,4,86,2,18,"string_from_line@65-83@sbin/fdisk/misc.c","sbin/fdisk/misc.c","string_from_line",65,83
13,2,109,2,17,"ask_cmd@86-103@sbin/fdisk/misc.c","sbin/fdisk/misc.c","ask_cmd",86,103
24,7,152,4,28,"ask_num@106-134@sbin/fdisk/misc.c","sbin/fdisk/misc.c","ask_num",106,134
33,13,208,2,41,"ask_pid@137-178@sbin/fdisk/misc.c","sbin/fdisk/misc.c","ask_pid",137,178
15,7,91,1,19,"ask_yn@181-200@sbin/fdisk/misc.c","sbin/fdisk/misc.c","ask_yn",181,200
105,28,621,4,118,"getuint64@206-324@sbin/fdisk/misc.c","sbin/fdisk/misc.c","getuint64",206,324
11,5,88,2,13,"ask_string@327-340@sbin/fdisk/misc.c","sbin/fdisk/misc.c","ask_string",327,340
15,3,99,2,17,"crc32@354-371@sbin/fdisk/misc.c","sbin/fdisk/misc.c","crc32",354,371
13,4,79,1,14,"utf16le_to_string@374-388@sbin/fdisk/misc.c","sbin/fdisk/misc.c","utf16le_to_string",374,388
13,4,81,1,14,"string_to_utf16le@391-405@sbin/fdisk/misc.c","sbin/fdisk/misc.c","string_to_utf16le",391,405
18,3,169,1,19,"PRT_printall@138-157@sbin/fdisk/part.c","sbin/fdisk/part.c","PRT_printall",138,157
10,3,68,1,11,"PRT_ascii_id@160-171@sbin/fdisk/part.c","sbin/fdisk/part.c","PRT_ascii_id",160,171
25,4,232,4,33,"PRT_parse@174-207@sbin/fdisk/part.c","sbin/fdisk/part.c","PRT_parse",174,207
13,7,71,1,12,"PRT_check_chs@210-222@sbin/fdisk/part.c","sbin/fdisk/part.c","PRT_check_chs",210,222
37,8,325,4,43,"PRT_make@225-268@sbin/fdisk/part.c","sbin/fdisk/part.c","PRT_make",225,268
26,3,157,3,27,"PRT_print@271-298@sbin/fdisk/part.c","sbin/fdisk/part.c","PRT_print",271,298
23,3,151,2,31,"PRT_fix_BN@301-332@sbin/fdisk/part.c","sbin/fdisk/part.c","PRT_fix_BN",301,332
28,3,217,1,38,"PRT_fix_CHS@335-373@sbin/fdisk/part.c","sbin/fdisk/part.c","PRT_fix_CHS",335,373
24,5,165,1,30,"PRT_uuid_to_typename@376-406@sbin/fdisk/part.c","sbin/fdisk/part.c","PRT_uuid_to_typename",376,406
20,4,125,1,23,"PRT_uuid_to_type@409-432@sbin/fdisk/part.c","sbin/fdisk/part.c","PRT_uuid_to_type",409,432
16,6,129,1,19,"PRT_type_to_uuid@435-454@sbin/fdisk/part.c","sbin/fdisk/part.c","PRT_type_to_uuid",435,454
56,20,368,2,78,"USER_edit@59-137@sbin/fdisk/user.c","sbin/fdisk/user.c","USER_edit",59,137
45,14,259,1,49,"USER_print_disk@140-189@sbin/fdisk/user.c","sbin/fdisk/user.c","USER_print_disk",140,189
95,29,573,2,123,"main@89-212@sbin/fsck/fsck.c","sbin/fsck/fsck.c","main",89,212
20,8,93,1,22,"isok@216-238@sbin/fsck/fsck.c","sbin/fsck/fsck.c","isok",216,238
90,22,567,5,108,"checkfs@242-350@sbin/fsck/fsck.c","sbin/fsck/fsck.c","checkfs",242,350
8,4,55,1,10,"selected@354-364@sbin/fsck/fsck.c","sbin/fsck/fsck.c","selected",354,364
8,2,45,1,8,"getoptions@368-376@sbin/fsck/fsck.c","sbin/fsck/fsck.c","getoptions",368,376
14,3,97,1,16,"addoption@380-396@sbin/fsck/fsck.c","sbin/fsck/fsck.c","addoption",380,396
8,1,62,3,8,"addentry@400-408@sbin/fsck/fsck.c","sbin/fsck/fsck.c","addentry",400,408
14,6,93,1,17,"maketypelist@412-429@sbin/fsck/fsck.c","sbin/fsck/fsck.c","maketypelist",412,429
12,5,75,3,13,"catopt@433-446@sbin/fsck/fsck.c","sbin/fsck/fsck.c","catopt",433,446
30,6,197,4,33,"mangle@450-483@sbin/fsck/fsck.c","sbin/fsck/fsck.c","mangle",450,483
13,4,92,2,13,"hasopt@486-499@sbin/fsck/fsck.c","sbin/fsck/fsck.c","hasopt",486,499
8,1,27,1,8,"usage@503-511@sbin/fsck/fsck.c","sbin/fsck/fsck.c","usage",503,511
6,1,29,3,5,"setcdevname@57-62@sbin/fsck/fsutil.c","sbin/fsck/fsutil.c","setcdevname",57,62
4,1,9,1,3,"cdevname@65-68@sbin/fsck/fsutil.c","sbin/fsck/fsutil.c","cdevname",65,68
4,1,9,1,3,"hotroot@71-74@sbin/fsck/fsutil.c","sbin/fsck/fsutil.c","hotroot",71,74
8,1,43,2,8,"errexit@77-85@sbin/fsck/fsutil.c","sbin/fsck/fsutil.c","errexit",77,85
20,7,101,3,21,"vmsg@88-109@sbin/fsck/fsutil.c","sbin/fsck/fsutil.c","vmsg",88,109
7,1,35,2,7,"pfatal@112-119@sbin/fsck/fsutil.c","sbin/fsck/fsutil.c","pfatal",112,119
7,1,35,2,7,"pwarn@122-129@sbin/fsck/fsutil.c","sbin/fsck/fsutil.c","pwarn",122,129
4,1,21,1,3,"xperror@132-135@sbin/fsck/fsutil.c","sbin/fsck/fsutil.c","xperror",132,135
8,1,40,2,8,"panic@138-146@sbin/fsck/fsutil.c","sbin/fsck/fsutil.c","panic",138,146
15,5,116,1,15,"unrawname@149-164@sbin/fsck/fsutil.c","sbin/fsck/fsutil.c","unrawname",149,164
13,2,97,1,13,"rawname@167-180@sbin/fsck/fsutil.c","sbin/fsck/fsutil.c","rawname",167,180
42,11,246,1,47,"blockcheck@183-230@sbin/fsck/fsutil.c","sbin/fsck/fsutil.c","blockcheck",183,230
10,3,47,1,10,"emalloc@234-244@sbin/fsck/fsutil.c","sbin/fsck/fsutil.c","emalloc",234,244
14,4,76,3,14,"ereallocarray@248-262@sbin/fsck/fsutil.c","sbin/fsck/fsutil.c","ereallocarray",248,262
7,2,34,1,6,"estrdup@266-272@sbin/fsck/fsutil.c","sbin/fsck/fsutil.c","estrdup",266,272
140,45,912,4,161,"checkfstab@75-236@sbin/fsck/preen.c","sbin/fsck/preen.c","checkfstab",75,236
24,6,176,1,29,"finddisk@240-269@sbin/fsck/preen.c","sbin/fsck/preen.c","finddisk",240,269
11,1,70,1,11,"printpart@273-284@sbin/fsck/preen.c","sbin/fsck/preen.c","printpart",273,284
16,2,129,4,18,"addpart@288-306@sbin/fsck/preen.c","sbin/fsck/preen.c","addpart",288,306
12,4,106,2,14,"startdisk@310-324@sbin/fsck/preen.c","sbin/fsck/preen.c","startdisk",310,324
27,8,160,1,30,"propagate@73-103@sbin/fsck_ext2fs/dir.c","sbin/fsck_ext2fs/dir.c","propagate",73,103
42,10,317,1,43,"dirscan@109-152@sbin/fsck_ext2fs/dir.c","sbin/fsck_ext2fs/dir.c","dirscan",109,152
54,15,464,1,54,"fsck_readdir@158-212@sbin/fsck_ext2fs/dir.c","sbin/fsck_ext2fs/dir.c","fsck_readdir",158,212
28,15,208,2,28,"dircheck@219-247@sbin/fsck_ext2fs/dir.c","sbin/fsck_ext2fs/dir.c","dircheck",219,247
4,1,20,2,4,"direrror@250-254@sbin/fsck_ext2fs/dir.c","sbin/fsck_ext2fs/dir.c","direrror",250,254
19,6,129,3,19,"fileerror@257-276@sbin/fsck_ext2fs/dir.c","sbin/fsck_ext2fs/dir.c","fileerror",257,276
26,9,191,2,26,"adjust@279-305@sbin/fsck_ext2fs/dir.c","sbin/fsck_ext2fs/dir.c","adjust",279,305
27,5,233,1,27,"mkentry@308-335@sbin/fsck_ext2fs/dir.c","sbin/fsck_ext2fs/dir.c","mkentry",308,335
15,5,116,1,15,"chgino@338-353@sbin/fsck_ext2fs/dir.c","sbin/fsck_ext2fs/dir.c","chgino",338,353
100,26,647,2,100,"linkup@356-456@sbin/fsck_ext2fs/dir.c","sbin/fsck_ext2fs/dir.c","linkup",356,456
12,1,82,3,12,"changeino@462-474@sbin/fsck_ext2fs/dir.c","sbin/fsck_ext2fs/dir.c","changeino",462,474
29,10,226,3,29,"makeentry@480-509@sbin/fsck_ext2fs/dir.c","sbin/fsck_ext2fs/dir.c","makeentry",480,509
55,11,459,2,55,"expanddir@515-570@sbin/fsck_ext2fs/dir.c","sbin/fsck_ext2fs/dir.c","expanddir",515,570
54,10,382,3,54,"allocdir@576-630@sbin/fsck_ext2fs/dir.c","sbin/fsck_ext2fs/dir.c","allocdir",576,630
10,2,55,2,10,"freedir@636-646@sbin/fsck_ext2fs/dir.c","sbin/fsck_ext2fs/dir.c","freedir",636,646
18,3,94,2,18,"lftempname@652-670@sbin/fsck_ext2fs/dir.c","sbin/fsck_ext2fs/dir.c","lftempname",652,670
7,2,36,2,7,"getdirblk@677-684@sbin/fsck_ext2fs/dir.c","sbin/fsck_ext2fs/dir.c","getdirblk",677,684
16,5,77,1,15,"setlarge@69-84@sbin/fsck_ext2fs/inode.c","sbin/fsck_ext2fs/inode.c","setlarge",69,84
9,3,65,1,9,"inosize@87-96@sbin/fsck_ext2fs/inode.c","sbin/fsck_ext2fs/inode.c","inosize",87,96
14,5,97,2,13,"inossize@99-112@sbin/fsck_ext2fs/inode.c","sbin/fsck_ext2fs/inode.c","inossize",99,112
80,20,527,2,82,"ckinode@115-197@sbin/fsck_ext2fs/inode.c","sbin/fsck_ext2fs/inode.c","ckinode",115,197
78,18,532,3,79,"iblock@200-279@sbin/fsck_ext2fs/inode.c","sbin/fsck_ext2fs/inode.c","iblock",200,279
37,7,258,2,37,"chkrange@286-323@sbin/fsck_ext2fs/inode.c","sbin/fsck_ext2fs/inode.c","chkrange",286,323
17,8,132,1,17,"ginode@329-346@sbin/fsck_ext2fs/inode.c","sbin/fsck_ext2fs/inode.c","ginode",329,346
26,5,150,1,28,"getnextinode@357-385@sbin/fsck_ext2fs/inode.c","sbin/fsck_ext2fs/inode.c","getnextinode",357,385
23,4,133,1,23,"resetinodebuf@388-411@sbin/fsck_ext2fs/inode.c","sbin/fsck_ext2fs/inode.c","resetinodebuf",388,411
6,2,25,1,6,"freeinodebuf@414-420@sbin/fsck_ext2fs/inode.c","sbin/fsck_ext2fs/inode.c","freeinodebuf",414,420
33,6,248,2,33,"cacheino@430-463@sbin/fsck_ext2fs/inode.c","sbin/fsck_ext2fs/inode.c","cacheino",430,463
11,3,65,1,11,"getinoinfo@469-480@sbin/fsck_ext2fs/inode.c","sbin/fsck_ext2fs/inode.c","getinoinfo",469,480
11,3,74,1,11,"inocleanup@486-497@sbin/fsck_ext2fs/inode.c","sbin/fsck_ext2fs/inode.c","inocleanup",486,497
4,1,11,1,4,"inodirty@500-504@sbin/fsck_ext2fs/inode.c","sbin/fsck_ext2fs/inode.c","inodirty",500,504
19,6,119,3,19,"clri@507-526@sbin/fsck_ext2fs/inode.c","sbin/fsck_ext2fs/inode.c","clri",507,526
10,2,75,1,10,"findname@529-539@sbin/fsck_ext2fs/inode.c","sbin/fsck_ext2fs/inode.c","findname",529,539
14,6,88,1,14,"findino@542-556@sbin/fsck_ext2fs/inode.c","sbin/fsck_ext2fs/inode.c","findino",542,556
25,6,202,1,29,"pinode@559-588@sbin/fsck_ext2fs/inode.c","sbin/fsck_ext2fs/inode.c","pinode",559,588
18,5,88,3,23,"blkerror@591-614@sbin/fsck_ext2fs/inode.c","sbin/fsck_ext2fs/inode.c","blkerror",591,614
46,12,280,2,46,"allocino@620-666@sbin/fsck_ext2fs/inode.c","sbin/fsck_ext2fs/inode.c","allocino",620,666
15,1,85,1,15,"freeino@672-687@sbin/fsck_ext2fs/inode.c","sbin/fsck_ext2fs/inode.c","freeino",672,687
53,15,266,2,66,"main@63-129@sbin/fsck_ext2fs/main.c","sbin/fsck_ext2fs/main.c","main",63,129
9,3,63,4,9,"argtoi@132-141@sbin/fsck_ext2fs/main.c","sbin/fsck_ext2fs/main.c","argtoi",132,141
116,35,649,4,151,"checkfilesys@148-299@sbin/fsck_ext2fs/main.c","sbin/fsck_ext2fs/main.c","checkfilesys",148,299
8,1,28,1,8,"usage@302-310@sbin/fsck_ext2fs/main.c","sbin/fsck_ext2fs/main.c","usage",302,310
49,16,355,1,63,"pass1@56-119@sbin/fsck_ext2fs/pass1.c","sbin/fsck_ext2fs/pass1.c","pass1",56,119
159,53,1035,2,167,"checkinode@122-289@sbin/fsck_ext2fs/pass1.c","sbin/fsck_ext2fs/pass1.c","checkinode",122,289
61,19,384,1,64,"pass1check@292-356@sbin/fsck_ext2fs/pass1.c","sbin/fsck_ext2fs/pass1.c","pass1check",292,356
25,8,156,1,25,"pass1b@46-71@sbin/fsck_ext2fs/pass1b.c","sbin/fsck_ext2fs/pass1b.c","pass1b",46,71
23,8,148,1,23,"pass1bcheck@74-97@sbin/fsck_ext2fs/pass1b.c","sbin/fsck_ext2fs/pass1b.c","pass1bcheck",74,97
113,30,808,1,132,"pass2@57-189@sbin/fsck_ext2fs/pass2.c","sbin/fsck_ext2fs/pass2.c","pass2",57,189
226,71,1710,1,237,"pass2check@192-429@sbin/fsck_ext2fs/pass2.c","sbin/fsck_ext2fs/pass2.c","pass2check",192,429
5,1,47,2,4,"blksort@435-439@sbin/fsck_ext2fs/pass2.c","sbin/fsck_ext2fs/pass2.c","blksort",435,439
27,10,176,1,27,"pass3@41-68@sbin/fsck_ext2fs/pass3.c","sbin/fsck_ext2fs/pass3.c","pass3",41,68
52,14,277,1,58,"pass4@46-104@sbin/fsck_ext2fs/pass4.c","sbin/fsck_ext2fs/pass4.c","pass4",46,104
26,7,149,1,26,"pass4check@107-133@sbin/fsck_ext2fs/pass4.c","sbin/fsck_ext2fs/pass4.c","pass4check",107,133
160,43,1176,1,180,"pass5@51-231@sbin/fsck_ext2fs/pass5.c","sbin/fsck_ext2fs/pass5.c","pass5",51,231
11,3,71,2,11,"print_bmap@234-245@sbin/fsck_ext2fs/pass5.c","sbin/fsck_ext2fs/pass5.c","print_bmap",234,245
174,48,1207,1,193,"setup@65-258@sbin/fsck_ext2fs/setup.c","sbin/fsck_ext2fs/setup.c","setup",65,258
96,17,842,1,122,"readsb@264-386@sbin/fsck_ext2fs/setup.c","sbin/fsck_ext2fs/setup.c","readsb",264,386
29,1,417,1,29,"copyback_sb@389-418@sbin/fsck_ext2fs/setup.c","sbin/fsck_ext2fs/setup.c","copyback_sb",389,418
8,3,38,2,8,"badsb@421-429@sbin/fsck_ext2fs/setup.c","sbin/fsck_ext2fs/setup.c","badsb",421,429
44,11,385,4,45,"calcsb@438-483@sbin/fsck_ext2fs/setup.c","sbin/fsck_ext2fs/setup.c","calcsb",438,483
11,3,70,2,11,"getdisklabel@486-497@sbin/fsck_ext2fs/setup.c","sbin/fsck_ext2fs/setup.c","getdisklabel",486,497
14,4,63,1,13,"cgoverhead@500-513@sbin/fsck_ext2fs/setup.c","sbin/fsck_ext2fs/setup.c","cgoverhead",500,513
17,9,71,1,18,"ftypeok@57-75@sbin/fsck_ext2fs/utilities.c","sbin/fsck_ext2fs/utilities.c","ftypeok",57,75
33,18,200,1,33,"reply@78-111@sbin/fsck_ext2fs/utilities.c","sbin/fsck_ext2fs/utilities.c","reply",78,111
30,6,183,1,30,"bufinit@117-147@sbin/fsck_ext2fs/utilities.c","sbin/fsck_ext2fs/utilities.c","bufinit",117,147
24,6,173,2,25,"getdatablk@153-178@sbin/fsck_ext2fs/utilities.c","sbin/fsck_ext2fs/utilities.c","getdatablk",153,178
12,2,79,3,12,"getblk@181-193@sbin/fsck_ext2fs/utilities.c","sbin/fsck_ext2fs/utilities.c","getblk",181,193
21,7,172,2,21,"flush@196-217@sbin/fsck_ext2fs/utilities.c","sbin/fsck_ext2fs/utilities.c","flush",196,217
8,3,45,2,8,"rwerror@220-228@sbin/fsck_ext2fs/utilities.c","sbin/fsck_ext2fs/utilities.c","rwerror",220,228
45,15,294,1,48,"ckfini@231-279@sbin/fsck_ext2fs/utilities.c","sbin/fsck_ext2fs/utilities.c","ckfini",231,279
28,5,190,4,28,"bread@282-310@sbin/fsck_ext2fs/utilities.c","sbin/fsck_ext2fs/utilities.c","bread",282,310
28,6,175,4,28,"bwrite@313-341@sbin/fsck_ext2fs/utilities.c","sbin/fsck_ext2fs/utilities.c","bwrite",313,341
12,3,53,1,12,"allocblk@347-359@sbin/fsck_ext2fs/utilities.c","sbin/fsck_ext2fs/utilities.c","allocblk",347,359
7,1,32,1,7,"freeblk@365-372@sbin/fsck_ext2fs/utilities.c","sbin/fsck_ext2fs/utilities.c","freeblk",365,372
51,12,340,4,52,"getpathname@378-430@sbin/fsck_ext2fs/utilities.c","sbin/fsck_ext2fs/utilities.c","getpathname",378,430
5,1,17,1,4,"catch@434-438@sbin/fsck_ext2fs/utilities.c","sbin/fsck_ext2fs/utilities.c","catch",434,438
9,1,49,1,9,"catchquit@447-456@sbin/fsck_ext2fs/utilities.c","sbin/fsck_ext2fs/utilities.c","catchquit",447,456
8,1,41,1,8,"voidquit@464-472@sbin/fsck_ext2fs/utilities.c","sbin/fsck_ext2fs/utilities.c","voidquit",464,472
28,8,134,2,33,"dofix@478-511@sbin/fsck_ext2fs/utilities.c","sbin/fsck_ext2fs/utilities.c","dofix",478,511
19,6,104,1,19,"propagate@72-91@sbin/fsck_ffs/dir.c","sbin/fsck_ffs/dir.c","propagate",72,91
34,9,264,1,34,"dirscan@97-131@sbin/fsck_ffs/dir.c","sbin/fsck_ffs/dir.c","dirscan",97,131
54,15,431,1,54,"fsck_readdir@137-191@sbin/fsck_ffs/dir.c","sbin/fsck_ffs/dir.c","fsck_readdir",137,191
28,13,189,2,28,"dircheck@198-226@sbin/fsck_ffs/dir.c","sbin/fsck_ffs/dir.c","dircheck",198,226
4,1,20,2,3,"direrror@229-232@sbin/fsck_ffs/dir.c","sbin/fsck_ffs/dir.c","direrror",229,232
20,5,123,3,20,"fileerror@235-255@sbin/fsck_ffs/dir.c","sbin/fsck_ffs/dir.c","fileerror",235,255
27,11,194,2,27,"adjust@258-285@sbin/fsck_ffs/dir.c","sbin/fsck_ffs/dir.c","adjust",258,285
23,3,182,1,23,"mkentry@288-311@sbin/fsck_ffs/dir.c","sbin/fsck_ffs/dir.c","mkentry",288,311
9,2,71,1,9,"chgino@314-323@sbin/fsck_ffs/dir.c","sbin/fsck_ffs/dir.c","chgino",314,323
103,27,655,2,110,"linkup@326-436@sbin/fsck_ffs/dir.c","sbin/fsck_ffs/dir.c","linkup",326,436
15,1,88,3,15,"changeino@442-457@sbin/fsck_ffs/dir.c","sbin/fsck_ffs/dir.c","changeino",442,457
28,8,216,3,28,"makeentry@463-491@sbin/fsck_ffs/dir.c","sbin/fsck_ffs/dir.c","makeentry",463,491
54,12,524,2,54,"expanddir@497-551@sbin/fsck_ffs/dir.c","sbin/fsck_ffs/dir.c","expanddir",497,551
57,7,400,3,57,"allocdir@557-614@sbin/fsck_ffs/dir.c","sbin/fsck_ffs/dir.c","allocdir",557,614
10,2,55,2,10,"freedir@620-630@sbin/fsck_ffs/dir.c","sbin/fsck_ffs/dir.c","freedir",620,630
18,3,94,2,18,"lftempname@636-654@sbin/fsck_ffs/dir.c","sbin/fsck_ffs/dir.c","lftempname",636,654
7,2,36,2,7,"getdirblk@661-668@sbin/fsck_ffs/dir.c","sbin/fsck_ffs/dir.c","getdirblk",661,668
88,23,615,2,90,"ckinode@59-149@sbin/fsck_ffs/inode.c","sbin/fsck_ffs/inode.c","ckinode",59,149
76,20,522,3,77,"iblock@152-229@sbin/fsck_ffs/inode.c","sbin/fsck_ffs/inode.c","iblock",152,229
41,13,282,2,41,"chkrange@236-277@sbin/fsck_ffs/inode.c","sbin/fsck_ffs/inode.c","chkrange",236,277
19,8,161,1,19,"ginode@283-302@sbin/fsck_ffs/inode.c","sbin/fsck_ffs/inode.c","ginode",283,302
30,6,165,1,30,"getnextinode@313-343@sbin/fsck_ffs/inode.c","sbin/fsck_ffs/inode.c","getnextinode",313,343
29,6,162,1,29,"setinodebuf@346-375@sbin/fsck_ffs/inode.c","sbin/fsck_ffs/inode.c","setinodebuf",346,375
5,1,15,1,5,"freeinodebuf@378-383@sbin/fsck_ffs/inode.c","sbin/fsck_ffs/inode.c","freeinodebuf",378,383
41,11,316,2,41,"cacheino@393-434@sbin/fsck_ffs/inode.c","sbin/fsck_ffs/inode.c","cacheino",393,434
11,3,65,1,11,"getinoinfo@440-451@sbin/fsck_ffs/inode.c","sbin/fsck_ffs/inode.c","getinoinfo",440,451
11,3,60,1,11,"inocleanup@457-468@sbin/fsck_ffs/inode.c","sbin/fsck_ffs/inode.c","inocleanup",457,468
4,1,11,1,3,"inodirty@471-474@sbin/fsck_ffs/inode.c","sbin/fsck_ffs/inode.c","inodirty",471,474
19,6,122,3,19,"clri@477-496@sbin/fsck_ffs/inode.c","sbin/fsck_ffs/inode.c","clri",477,496
8,2,60,1,8,"findname@499-507@sbin/fsck_ffs/inode.c","sbin/fsck_ffs/inode.c","findname",499,507
12,5,80,1,12,"findino@510-522@sbin/fsck_ffs/inode.c","sbin/fsck_ffs/inode.c","findino",510,522
23,5,179,1,27,"pinode@525-552@sbin/fsck_ffs/inode.c","sbin/fsck_ffs/inode.c","pinode",525,552
18,5,88,3,23,"blkerror@555-578@sbin/fsck_ffs/inode.c","sbin/fsck_ffs/inode.c","blkerror",555,578
81,15,600,2,83,"allocino@584-667@sbin/fsck_ffs/inode.c","sbin/fsck_ffs/inode.c","allocino",584,667
15,1,85,1,15,"freeino@673-688@sbin/fsck_ffs/inode.c","sbin/fsck_ffs/inode.c","freeino",673,688
6,1,21,1,5,"usage@58-63@sbin/fsck_ffs/main.c","sbin/fsck_ffs/main.c","usage",58,63
63,19,312,2,76,"main@65-141@sbin/fsck_ffs/main.c","sbin/fsck_ffs/main.c","main",65,141
9,3,63,4,9,"argtoi@144-153@sbin/fsck_ffs/main.c","sbin/fsck_ffs/main.c","argtoi",144,153
141,42,914,4,187,"checkfilesys@160-347@sbin/fsck_ffs/main.c","sbin/fsck_ffs/main.c","checkfilesys",160,347
6,1,45,2,5,"pass1_info@56-61@sbin/fsck_ffs/pass1.c","sbin/fsck_ffs/pass1.c","pass1_info",56,61
105,26,685,1,132,"pass1@64-196@sbin/fsck_ffs/pass1.c","sbin/fsck_ffs/pass1.c","pass1",64,196
147,50,1044,2,152,"checkinode@199-351@sbin/fsck_ffs/pass1.c","sbin/fsck_ffs/pass1.c","checkinode",199,351
67,19,405,1,70,"pass1check@354-424@sbin/fsck_ffs/pass1.c","sbin/fsck_ffs/pass1.c","pass1check",354,424
6,1,45,2,5,"pass1b_info@48-53@sbin/fsck_ffs/pass1b.c","sbin/fsck_ffs/pass1b.c","pass1b_info",48,53
28,7,158,1,28,"pass1b@56-84@sbin/fsck_ffs/pass1b.c","sbin/fsck_ffs/pass1b.c","pass1b",56,84
23,8,148,1,23,"pass1bcheck@87-110@sbin/fsck_ffs/pass1b.c","sbin/fsck_ffs/pass1b.c","pass1bcheck",87,110
5,1,29,2,4,"pass2_info1@57-61@sbin/fsck_ffs/pass2.c","sbin/fsck_ffs/pass2.c","pass2_info1",57,61
7,2,41,2,6,"pass2_info2@64-70@sbin/fsck_ffs/pass2.c","sbin/fsck_ffs/pass2.c","pass2_info2",64,70
153,38,1026,1,174,"pass2@73-247@sbin/fsck_ffs/pass2.c","sbin/fsck_ffs/pass2.c","pass2",73,247
204,57,1433,1,215,"pass2check@250-465@sbin/fsck_ffs/pass2.c","sbin/fsck_ffs/pass2.c","pass2check",250,465
12,3,79,2,12,"blksort@471-483@sbin/fsck_ffs/pass2.c","sbin/fsck_ffs/pass2.c","blksort",471,483
5,1,29,2,4,"pass3_info@43-47@sbin/fsck_ffs/pass3.c","sbin/fsck_ffs/pass3.c","pass3_info",43,47
34,11,219,1,34,"pass3@50-84@sbin/fsck_ffs/pass3.c","sbin/fsck_ffs/pass3.c","pass3",50,84
6,1,39,2,5,"pass4_info@48-53@sbin/fsck_ffs/pass4.c","sbin/fsck_ffs/pass4.c","pass4_info",48,53
58,14,321,1,64,"pass4@56-120@sbin/fsck_ffs/pass4.c","sbin/fsck_ffs/pass4.c","pass4",56,120
26,7,145,1,26,"pass4check@123-149@sbin/fsck_ffs/pass4.c","sbin/fsck_ffs/pass4.c","pass4check",123,149
5,1,29,2,4,"pass5_info@55-59@sbin/fsck_ffs/pass5.c","sbin/fsck_ffs/pass5.c","pass5_info",55,59
307,82,2284,1,318,"pass5@62-380@sbin/fsck_ffs/pass5.c","sbin/fsck_ffs/pass5.c","pass5",62,380
357,119,2358,2,377,"setup@80-457@sbin/fsck_ffs/setup.c","sbin/fsck_ffs/setup.c","setup",80,457
103,33,697,1,125,"readsb@463-588@sbin/fsck_ffs/setup.c","sbin/fsck_ffs/setup.c","readsb",463,588
8,3,38,2,8,"badsb@591-599@sbin/fsck_ffs/setup.c","sbin/fsck_ffs/setup.c","badsb",591,599
40,10,355,5,46,"calcsb@608-654@sbin/fsck_ffs/setup.c","sbin/fsck_ffs/setup.c","calcsb",608,654
11,3,70,2,11,"getdisklabel@657-668@sbin/fsck_ffs/setup.c","sbin/fsck_ffs/setup.c","getdisklabel",657,668
29,25,218,2,33,"cmpsb@674-707@sbin/fsck_ffs/setup.c","sbin/fsck_ffs/setup.c","cmpsb",674,707
17,9,71,1,16,"ftypeok@59-75@sbin/fsck_ffs/utilities.c","sbin/fsck_ffs/utilities.c","ftypeok",59,75
37,18,215,1,38,"reply@78-116@sbin/fsck_ffs/utilities.c","sbin/fsck_ffs/utilities.c","reply",78,116
14,3,91,1,14,"inoinfo@122-136@sbin/fsck_ffs/utilities.c","sbin/fsck_ffs/utilities.c","inoinfo",122,136
34,7,215,1,34,"bufinit@142-176@sbin/fsck_ffs/utilities.c","sbin/fsck_ffs/utilities.c","bufinit",142,176
23,6,170,2,24,"getdatablk@182-206@sbin/fsck_ffs/utilities.c","sbin/fsck_ffs/utilities.c","getdatablk",182,206
12,2,79,3,12,"getblk@209-221@sbin/fsck_ffs/utilities.c","sbin/fsck_ffs/utilities.c","getblk",209,221
21,7,184,2,21,"flush@224-245@sbin/fsck_ffs/utilities.c","sbin/fsck_ffs/utilities.c","flush",224,245
8,3,49,2,8,"rwerror@248-256@sbin/fsck_ffs/utilities.c","sbin/fsck_ffs/utilities.c","rwerror",248,256
67,16,456,1,72,"ckfini@259-331@sbin/fsck_ffs/utilities.c","sbin/fsck_ffs/utilities.c","ckfini",259,331
28,5,190,4,28,"bread@334-362@sbin/fsck_ffs/utilities.c","sbin/fsck_ffs/utilities.c","bread",334,362
28,6,175,4,28,"bwrite@365-393@sbin/fsck_ffs/utilities.c","sbin/fsck_ffs/utilities.c","bwrite",365,393
37,12,269,1,38,"allocblk@399-437@sbin/fsck_ffs/utilities.c","sbin/fsck_ffs/utilities.c","allocblk",399,437
7,1,35,2,7,"freeblk@443-450@sbin/fsck_ffs/utilities.c","sbin/fsck_ffs/utilities.c","freeblk",443,450
51,12,339,4,51,"getpathname@456-507@sbin/fsck_ffs/utilities.c","sbin/fsck_ffs/utilities.c","getpathname",456,507
5,1,17,1,4,"catch@511-515@sbin/fsck_ffs/utilities.c","sbin/fsck_ffs/utilities.c","catch",511,515
9,1,49,1,9,"catchquit@524-533@sbin/fsck_ffs/utilities.c","sbin/fsck_ffs/utilities.c","catchquit",524,533
8,1,41,1,8,"voidquit@541-549@sbin/fsck_ffs/utilities.c","sbin/fsck_ffs/utilities.c","voidquit",541,549
28,8,134,2,32,"dofix@555-587@sbin/fsck_ffs/utilities.c","sbin/fsck_ffs/utilities.c","dofix",555,587
22,5,171,1,23,"catchinfo@594-617@sbin/fsck_ffs/utilities.c","sbin/fsck_ffs/utilities.c","catchinfo",594,617
221,57,1676,2,260,"readboot@41-301@sbin/fsck_msdos/boot.c","sbin/fsck_msdos/boot.c","readboot",41,301
49,11,363,2,67,"writefsinfo@304-371@sbin/fsck_msdos/boot.c","sbin/fsck_msdos/boot.c","writefsinfo",304,371
133,35,825,1,156,"checkfilesys@48-204@sbin/fsck_msdos/check.c","sbin/fsck_msdos/check.c","checkfilesys",48,204
10,3,53,1,10,"newDosDirEntry@101-111@sbin/fsck_msdos/dir.c","sbin/fsck_msdos/dir.c","newDosDirEntry",101,111
5,1,19,1,4,"freeDosDirEntry@114-118@sbin/fsck_msdos/dir.c","sbin/fsck_msdos/dir.c","freeDosDirEntry",114,118
10,3,53,1,10,"newDirTodo@126-136@sbin/fsck_msdos/dir.c","sbin/fsck_msdos/dir.c","newDirTodo",126,136
5,1,19,1,4,"freeDirTodo@139-143@sbin/fsck_msdos/dir.c","sbin/fsck_msdos/dir.c","freeDirTodo",139,143
23,5,132,1,24,"fullpath@154-178@sbin/fsck_msdos/dir.c","sbin/fsck_msdos/dir.c","fullpath",154,178
10,2,59,1,11,"calcShortSum@184-195@sbin/fsck_msdos/dir.c","sbin/fsck_msdos/dir.c","calcShortSum",184,195
31,9,203,2,34,"resetDosDirSection@211-245@sbin/fsck_msdos/dir.c","sbin/fsck_msdos/dir.c","resetDosDirSection",211,245
24,5,133,1,24,"finishDosDirSection@251-275@sbin/fsck_msdos/dir.c","sbin/fsck_msdos/dir.c","finishDosDirSection",251,275
37,11,232,8,37,"delete@281-318@sbin/fsck_msdos/dir.c","sbin/fsck_msdos/dir.c","delete",281,318
30,9,170,10,29,"removede@321-350@sbin/fsck_msdos/dir.c","sbin/fsck_msdos/dir.c","removede",321,350
43,9,321,4,47,"checksize@356-403@sbin/fsck_msdos/dir.c","sbin/fsck_msdos/dir.c","checksize",356,403
374,135,2714,4,427,"readDosDirSection@412-839@sbin/fsck_msdos/dir.c","sbin/fsck_msdos/dir.c","readDosDirSection",412,839
29,8,174,3,44,"handleDirTree@842-886@sbin/fsck_msdos/dir.c","sbin/fsck_msdos/dir.c","handleDirTree",842,886
74,23,590,4,79,"reconnect@896-975@sbin/fsck_msdos/dir.c","sbin/fsck_msdos/dir.c","reconnect",896,975
5,1,15,1,4,"finishlf@978-982@sbin/fsck_msdos/dir.c","sbin/fsck_msdos/dir.c","finishlf",978,982
26,9,156,4,25,"checkclnum@45-70@sbin/fsck_msdos/fat.c","sbin/fsck_msdos/fat.c","checkclnum",45,70
105,26,801,4,111,"readfat@76-187@sbin/fsck_msdos/fat.c","sbin/fsck_msdos/fat.c","readfat",76,187
10,4,45,1,9,"rsrvdcltype@193-202@sbin/fsck_msdos/fat.c","sbin/fsck_msdos/fat.c","rsrvdcltype",193,202
64,22,414,4,63,"clustdiffer@205-268@sbin/fsck_msdos/fat.c","sbin/fsck_msdos/fat.c","clustdiffer",205,268
10,3,91,4,10,"comparefat@275-285@sbin/fsck_msdos/fat.c","sbin/fsck_msdos/fat.c","comparefat",275,285
11,4,91,3,11,"clearchain@288-299@sbin/fsck_msdos/fat.c","sbin/fsck_msdos/fat.c","clearchain",288,299
19,5,119,4,19,"tryclear@302-321@sbin/fsck_msdos/fat.c","sbin/fsck_msdos/fat.c","tryclear",302,321
71,26,521,2,97,"checkfat@327-424@sbin/fsck_msdos/fat.c","sbin/fsck_msdos/fat.c","checkfat",327,424
76,15,559,3,76,"writefat@430-506@sbin/fsck_msdos/fat.c","sbin/fsck_msdos/fat.c","writefat",430,506
52,22,344,3,56,"checklost@512-568@sbin/fsck_msdos/fat.c","sbin/fsck_msdos/fat.c","checklost",512,568
4,1,11,1,3,"usage@50-53@sbin/fsck_msdos/main.c","sbin/fsck_msdos/main.c","usage",50,53
31,7,140,2,38,"main@56-94@sbin/fsck_msdos/main.c","sbin/fsck_msdos/main.c","main",56,94
33,16,199,3,35,"ask@97-132@sbin/fsck_msdos/main.c","sbin/fsck_msdos/main.c","ask",97,132
5,1,20,1,4,"usage@74-78@sbin/fsdb/fsdb.c","sbin/fsdb/fsdb.c","usage",74,78
31,6,154,2,31,"main@87-118@sbin/fsdb/fsdb.c","sbin/fsdb/fsdb.c","main",87,118
10,2,68,2,11,"helpfn@185-196@sbin/fsdb/fsdb.c","sbin/fsdb/fsdb.c","helpfn",185,196
7,1,37,1,7,"prompt@199-206@sbin/fsdb/fsdb.c","sbin/fsdb/fsdb.c","prompt",199,206
61,14,376,1,71,"cmdloop@210-281@sbin/fsdb/fsdb.c","sbin/fsdb/fsdb.c","cmdloop",210,281
11,1,42,1,11,"CMDFUNCSTART@296-307@sbin/fsdb/fsdb.c","sbin/fsdb/fsdb.c","CMDFUNCSTART",296,307
7,1,24,1,6,"CMDFUNCSTART@309-315@sbin/fsdb/fsdb.c","sbin/fsdb/fsdb.c","CMDFUNCSTART",309,315
13,2,55,1,13,"CMDFUNCSTART@317-330@sbin/fsdb/fsdb.c","sbin/fsdb/fsdb.c","CMDFUNCSTART",317,330
5,1,13,1,4,"CMDFUNCSTART@332-336@sbin/fsdb/fsdb.c","sbin/fsdb/fsdb.c","CMDFUNCSTART",332,336
4,1,10,1,3,"CMDFUNCSTART@339-342@sbin/fsdb/fsdb.c","sbin/fsdb/fsdb.c","CMDFUNCSTART",339,342
10,2,58,1,9,"CMDFUNCSTART@344-353@sbin/fsdb/fsdb.c","sbin/fsdb/fsdb.c","CMDFUNCSTART",344,353
10,2,58,1,9,"CMDFUNCSTART@355-364@sbin/fsdb/fsdb.c","sbin/fsdb/fsdb.c","CMDFUNCSTART",355,364
8,1,59,1,8,"scannames@387-395@sbin/fsdb/fsdb.c","sbin/fsdb/fsdb.c","scannames",387,395
13,1,60,1,14,"CMDFUNCSTART@397-411@sbin/fsdb/fsdb.c","sbin/fsdb/fsdb.c","CMDFUNCSTART",397,411
20,3,99,1,20,"dolookup@414-434@sbin/fsdb/fsdb.c","sbin/fsdb/fsdb.c","dolookup",414,434
27,9,147,1,29,"CMDFUNCSTART@436-465@sbin/fsdb/fsdb.c","sbin/fsdb/fsdb.c","CMDFUNCSTART",436,465
17,3,84,1,18,"CMDFUNCSTART@467-485@sbin/fsdb/fsdb.c","sbin/fsdb/fsdb.c","CMDFUNCSTART",467,485
14,3,65,1,14,"CMDFUNCSTART@487-501@sbin/fsdb/fsdb.c","sbin/fsdb/fsdb.c","CMDFUNCSTART",487,501
9,2,45,1,9,"chinumfunc@506-515@sbin/fsdb/fsdb.c","sbin/fsdb/fsdb.c","chinumfunc",506,515
26,6,147,1,29,"CMDFUNCSTART@517-546@sbin/fsdb/fsdb.c","sbin/fsdb/fsdb.c","CMDFUNCSTART",517,546
15,3,98,1,16,"chnamefunc@549-565@sbin/fsdb/fsdb.c","sbin/fsdb/fsdb.c","chnamefunc",549,565
29,6,182,1,32,"CMDFUNCSTART@567-599@sbin/fsdb/fsdb.c","sbin/fsdb/fsdb.c","CMDFUNCSTART",567,599
27,5,179,1,27,"CMDFUNCSTART@611-638@sbin/fsdb/fsdb.c","sbin/fsdb/fsdb.c","CMDFUNCSTART",611,638
18,4,115,1,20,"CMDFUNCSTART@640-660@sbin/fsdb/fsdb.c","sbin/fsdb/fsdb.c","CMDFUNCSTART",640,660
17,5,96,1,19,"CMDFUNCSTART@662-681@sbin/fsdb/fsdb.c","sbin/fsdb/fsdb.c","CMDFUNCSTART",662,681
21,5,112,1,23,"CMDFUNCSTART@683-706@sbin/fsdb/fsdb.c","sbin/fsdb/fsdb.c","CMDFUNCSTART",683,706
21,6,116,1,23,"CMDFUNCSTART@708-731@sbin/fsdb/fsdb.c","sbin/fsdb/fsdb.c","CMDFUNCSTART",708,731
21,6,114,1,23,"CMDFUNCSTART@733-756@sbin/fsdb/fsdb.c","sbin/fsdb/fsdb.c","CMDFUNCSTART",733,756
22,5,122,1,25,"CMDFUNCSTART@758-783@sbin/fsdb/fsdb.c","sbin/fsdb/fsdb.c","CMDFUNCSTART",758,783
22,5,122,1,24,"CMDFUNCSTART@785-809@sbin/fsdb/fsdb.c","sbin/fsdb/fsdb.c","CMDFUNCSTART",785,809
50,11,370,3,55,"dotime@812-867@sbin/fsdb/fsdb.c","sbin/fsdb/fsdb.c","dotime",812,867
12,2,60,1,12,"CMDFUNCSTART@869-881@sbin/fsdb/fsdb.c","sbin/fsdb/fsdb.c","CMDFUNCSTART",869,881
12,2,60,1,12,"CMDFUNCSTART@883-895@sbin/fsdb/fsdb.c","sbin/fsdb/fsdb.c","CMDFUNCSTART",883,895
12,2,60,1,12,"CMDFUNCSTART@897-909@sbin/fsdb/fsdb.c","sbin/fsdb/fsdb.c","CMDFUNCSTART",897,909
16,6,97,2,16,"crack@53-69@sbin/fsdb/fsdbutil.c","sbin/fsdb/fsdbutil.c","crack",53,69
10,2,81,3,9,"argcount@72-81@sbin/fsdb/fsdbutil.c","sbin/fsdb/fsdbutil.c","argcount",72,81
66,14,525,3,69,"printstat@84-153@sbin/fsdb/fsdbutil.c","sbin/fsdb/fsdbutil.c","printstat",84,153
8,2,24,1,7,"checkactive@156-163@sbin/fsdb/fsdbutil.c","sbin/fsdb/fsdbutil.c","checkactive",156,163
13,3,56,1,12,"checkactivedir@166-178@sbin/fsdb/fsdbutil.c","sbin/fsdb/fsdbutil.c","checkactivedir",166,178
26,10,113,1,25,"printactive@181-206@sbin/fsdb/fsdbutil.c","sbin/fsdb/fsdbutil.c","printactive",181,206
36,11,204,2,40,"main@51-91@sbin/fsirand/fsirand.c","sbin/fsirand/fsirand.c","main",51,91
180,58,1347,1,216,"fsirand@94-310@sbin/fsirand/fsirand.c","sbin/fsirand/fsirand.c","fsirand",94,310
6,1,24,1,5,"usage@313-318@sbin/fsirand/fsirand.c","sbin/fsirand/fsirand.c","usage",313,318
84,16,754,3,149,"growfs@168-317@sbin/growfs/growfs.c","sbin/growfs/growfs.c","growfs",168,317
171,35,1395,4,194,"initcg@326-520@sbin/growfs/growfs.c","sbin/growfs/growfs.c","initcg",326,520
21,7,118,2,34,"frag_adjust@529-563@sbin/growfs/growfs.c","sbin/growfs/growfs.c","frag_adjust",529,563
26,4,192,5,41,"cond_bl_upd@574-615@sbin/growfs/growfs.c","sbin/growfs/growfs.c","cond_bl_upd",574,615
108,22,892,5,198,"updjcg@629-827@sbin/growfs/growfs.c","sbin/growfs/growfs.c","updjcg",629,827
291,64,2500,4,530,"updcsloc@846-1376@sbin/growfs/growfs.c","sbin/growfs/growfs.c","updcsloc",846,1376
14,4,101,4,14,"rdfs@1382-1396@sbin/growfs/growfs.c","sbin/growfs/growfs.c","rdfs",1382,1396
11,4,92,5,12,"wtfs@1402-1414@sbin/growfs/growfs.c","sbin/growfs/growfs.c","wtfs",1402,1414
73,22,561,1,107,"alloc@1422-1529@sbin/growfs/growfs.c","sbin/growfs/growfs.c","alloc",1422,1529
20,5,163,3,20,"isblock@1537-1557@sbin/growfs/growfs.c","sbin/growfs/growfs.c","isblock",1537,1557
20,5,134,3,19,"clrblock@1565-1584@sbin/growfs/growfs.c","sbin/growfs/growfs.c","clrblock",1565,1584
20,5,132,3,19,"setblock@1592-1611@sbin/growfs/growfs.c","sbin/growfs/growfs.c","setblock",1592,1611
25,8,216,3,33,"ginode@1621-1654@sbin/growfs/growfs.c","sbin/growfs/growfs.c","ginode",1621,1654
15,6,90,1,16,"charsperline@1662-1678@sbin/growfs/growfs.c","sbin/growfs/growfs.c","charsperline",1662,1678
159,51,1124,2,253,"main@1703-1956@sbin/growfs/growfs.c","sbin/growfs/growfs.c","main",1703,1956
19,5,116,3,26,"return_disklabel@1962-1988@sbin/growfs/growfs.c","sbin/growfs/growfs.c","return_disklabel",1962,1988
10,3,65,1,11,"get_disklabel@1994-2005@sbin/growfs/growfs.c","sbin/growfs/growfs.c","get_disklabel",1994,2005
5,1,18,1,4,"usage@2012-2016@sbin/growfs/growfs.c","sbin/growfs/growfs.c","usage",2012,2016
19,7,112,1,30,"updclst@2023-2053@sbin/growfs/growfs.c","sbin/growfs/growfs.c","updclst",2023,2053
51,18,376,6,57,"updrefs@2061-2118@sbin/growfs/growfs.c","sbin/growfs/growfs.c","updrefs",2061,2118
32,9,271,8,33,"indirchk@2124-2157@sbin/growfs/growfs.c","sbin/growfs/growfs.c","indirchk",2124,2157
15,1,120,2,14,"ffs1_sb_update@2160-2174@sbin/growfs/growfs.c","sbin/growfs/growfs.c","ffs1_sb_update",2160,2174
4,1,19,2,3,"setdiscover@98-101@sbin/ifconfig/brconfig.c","sbin/ifconfig/brconfig.c","setdiscover",98,101
4,1,19,2,3,"unsetdiscover@104-107@sbin/ifconfig/brconfig.c","sbin/ifconfig/brconfig.c","unsetdiscover",104,107
4,1,19,2,3,"setblocknonip@110-113@sbin/ifconfig/brconfig.c","sbin/ifconfig/brconfig.c","setblocknonip",110,113
4,1,19,2,3,"unsetblocknonip@116-119@sbin/ifconfig/brconfig.c","sbin/ifconfig/brconfig.c","unsetblocknonip",116,119
4,1,19,2,3,"setlearn@122-125@sbin/ifconfig/brconfig.c","sbin/ifconfig/brconfig.c","setlearn",122,125
4,1,19,2,3,"unsetlearn@128-131@sbin/ifconfig/brconfig.c","sbin/ifconfig/brconfig.c","unsetlearn",128,131
4,1,19,2,3,"setstp@134-137@sbin/ifconfig/brconfig.c","sbin/ifconfig/brconfig.c","setstp",134,137
4,1,19,2,3,"unsetstp@140-143@sbin/ifconfig/brconfig.c","sbin/ifconfig/brconfig.c","unsetstp",140,143
4,1,19,2,3,"setedge@146-149@sbin/ifconfig/brconfig.c","sbin/ifconfig/brconfig.c","setedge",146,149
4,1,19,2,3,"unsetedge@152-155@sbin/ifconfig/brconfig.c","sbin/ifconfig/brconfig.c","unsetedge",152,155
4,1,19,2,3,"setautoedge@158-161@sbin/ifconfig/brconfig.c","sbin/ifconfig/brconfig.c","setautoedge",158,161
4,1,19,2,3,"unsetautoedge@164-167@sbin/ifconfig/brconfig.c","sbin/ifconfig/brconfig.c","unsetautoedge",164,167
4,1,19,2,3,"setptp@170-173@sbin/ifconfig/brconfig.c","sbin/ifconfig/brconfig.c","setptp",170,173
4,1,19,2,3,"unsetptp@176-179@sbin/ifconfig/brconfig.c","sbin/ifconfig/brconfig.c","unsetptp",176,179
4,1,19,2,3,"setautoptp@182-185@sbin/ifconfig/brconfig.c","sbin/ifconfig/brconfig.c","setautoptp",182,185
4,1,19,2,3,"unsetautoptp@188-191@sbin/ifconfig/brconfig.c","sbin/ifconfig/brconfig.c","unsetautoptp",188,191
14,4,114,2,16,"addlocal@194-210@sbin/ifconfig/brconfig.c","sbin/ifconfig/brconfig.c","addlocal",194,210
11,3,112,2,13,"bridge_ifsetflag@213-226@sbin/ifconfig/brconfig.c","sbin/ifconfig/brconfig.c","bridge_ifsetflag",213,226
11,3,114,2,14,"bridge_ifclrflag@229-243@sbin/ifconfig/brconfig.c","sbin/ifconfig/brconfig.c","bridge_ifclrflag",229,243
8,2,61,2,8,"bridge_flushall@246-254@sbin/ifconfig/brconfig.c","sbin/ifconfig/brconfig.c","bridge_flushall",246,254
8,2,61,2,8,"bridge_flush@257-265@sbin/ifconfig/brconfig.c","sbin/ifconfig/brconfig.c","bridge_flush",257,265
31,4,224,1,36,"bridge_cfg@268-304@sbin/ifconfig/brconfig.c","sbin/ifconfig/brconfig.c","bridge_cfg",268,304
40,8,294,1,40,"bridge_list@307-347@sbin/ifconfig/brconfig.c","sbin/ifconfig/brconfig.c","bridge_list",307,347
11,3,83,2,11,"bridge_add@350-361@sbin/ifconfig/brconfig.c","sbin/ifconfig/brconfig.c","bridge_add",350,361
8,2,73,2,8,"bridge_delete@364-372@sbin/ifconfig/brconfig.c","sbin/ifconfig/brconfig.c","bridge_delete",364,372
11,3,83,2,11,"bridge_addspan@375-386@sbin/ifconfig/brconfig.c","sbin/ifconfig/brconfig.c","bridge_addspan",375,386
8,2,73,2,8,"bridge_delspan@389-397@sbin/ifconfig/brconfig.c","sbin/ifconfig/brconfig.c","bridge_delspan",389,397
16,7,130,2,17,"bridge_timeout@400-417@sbin/ifconfig/brconfig.c","sbin/ifconfig/brconfig.c","bridge_timeout",400,417
15,7,127,2,16,"bridge_maxage@420-436@sbin/ifconfig/brconfig.c","sbin/ifconfig/brconfig.c","bridge_maxage",420,436
15,7,127,2,16,"bridge_priority@439-455@sbin/ifconfig/brconfig.c","sbin/ifconfig/brconfig.c","bridge_priority",439,455
16,5,123,2,17,"bridge_proto@458-475@sbin/ifconfig/brconfig.c","sbin/ifconfig/brconfig.c","bridge_proto",458,475
15,7,127,2,16,"bridge_fwddelay@478-494@sbin/ifconfig/brconfig.c","sbin/ifconfig/brconfig.c","bridge_fwddelay",478,494
15,7,127,2,16,"bridge_hellotime@497-513@sbin/ifconfig/brconfig.c","sbin/ifconfig/brconfig.c","bridge_hellotime",497,513
15,7,127,2,16,"bridge_maxaddr@516-532@sbin/ifconfig/brconfig.c","sbin/ifconfig/brconfig.c","bridge_maxaddr",516,532
12,3,100,2,14,"bridge_deladdr@535-549@sbin/ifconfig/brconfig.c","sbin/ifconfig/brconfig.c","bridge_deladdr",535,549
16,7,147,2,18,"bridge_ifprio@552-570@sbin/ifconfig/brconfig.c","sbin/ifconfig/brconfig.c","bridge_ifprio",552,570
16,7,147,2,19,"bridge_ifcost@573-592@sbin/ifconfig/brconfig.c","sbin/ifconfig/brconfig.c","bridge_ifcost",573,592
9,2,80,2,11,"bridge_noifcost@595-606@sbin/ifconfig/brconfig.c","sbin/ifconfig/brconfig.c","bridge_noifcost",595,606
14,3,124,2,17,"bridge_addaddr@609-626@sbin/ifconfig/brconfig.c","sbin/ifconfig/brconfig.c","bridge_addaddr",609,626
44,10,343,2,47,"bridge_addrs@629-676@sbin/ifconfig/brconfig.c","sbin/ifconfig/brconfig.c","bridge_addrs",629,676
11,3,94,2,12,"bridge_holdcnt@679-691@sbin/ifconfig/brconfig.c","sbin/ifconfig/brconfig.c","bridge_holdcnt",679,691
16,4,116,1,18,"is_bridge@697-715@sbin/ifconfig/brconfig.c","sbin/ifconfig/brconfig.c","is_bridge",697,715
23,8,175,1,31,"bridge_status@718-749@sbin/ifconfig/brconfig.c","sbin/ifconfig/brconfig.c","bridge_status",718,749
8,2,73,2,8,"bridge_flushrule@752-760@sbin/ifconfig/brconfig.c","sbin/ifconfig/brconfig.c","bridge_flushrule",752,760
28,7,212,2,30,"bridge_rules@763-793@sbin/ifconfig/brconfig.c","sbin/ifconfig/brconfig.c","bridge_rules",763,793
26,9,175,1,29,"bridge_showrule@796-825@sbin/ifconfig/brconfig.c","sbin/ifconfig/brconfig.c","bridge_showrule",796,825
94,25,633,3,103,"bridge_rule@834-937@sbin/ifconfig/brconfig.c","sbin/ifconfig/brconfig.c","bridge_rule",834,937
26,8,178,2,31,"bridge_rulefile@942-973@sbin/ifconfig/brconfig.c","sbin/ifconfig/brconfig.c","bridge_rulefile",942,973
11,3,82,3,11,"bridge_badrule@976-987@sbin/ifconfig/brconfig.c","sbin/ifconfig/brconfig.c","bridge_badrule",976,987
8,2,55,1,9,"is_switch@990-999@sbin/ifconfig/brconfig.c","sbin/ifconfig/brconfig.c","is_switch",990,999
16,4,167,1,21,"switch_cfg@1002-1023@sbin/ifconfig/brconfig.c","sbin/ifconfig/brconfig.c","switch_cfg",1002,1023
13,5,74,1,17,"switch_status@1026-1043@sbin/ifconfig/brconfig.c","sbin/ifconfig/brconfig.c","switch_status",1026,1043
14,5,116,2,15,"switch_datapathid@1046-1061@sbin/ifconfig/brconfig.c","sbin/ifconfig/brconfig.c","switch_datapathid",1046,1061
19,6,145,2,21,"switch_portno@1064-1085@sbin/ifconfig/brconfig.c","sbin/ifconfig/brconfig.c","switch_portno",1064,1085
170,60,1123,2,203,"main@628-831@sbin/ifconfig/ifconfig.c","sbin/ifconfig/ifconfig.c","main",628,831
13,4,61,1,13,"getsock@834-847@sbin/ifconfig/ifconfig.c","sbin/ifconfig/ifconfig.c","getsock",834,847
41,15,310,2,48,"getinfo@850-898@sbin/ifconfig/ifconfig.c","sbin/ifconfig/ifconfig.c","getinfo",850,898
29,9,217,2,32,"printgroup@901-933@sbin/ifconfig/ifconfig.c","sbin/ifconfig/ifconfig.c","printgroup",901,933
12,2,92,1,13,"printgroupattribs@936-949@sbin/ifconfig/ifconfig.c","sbin/ifconfig/ifconfig.c","printgroupattribs",936,949
25,6,179,3,29,"setgroupattribs@952-981@sbin/ifconfig/ifconfig.c","sbin/ifconfig/ifconfig.c","setgroupattribs",952,981
87,29,618,2,96,"printif@984-1080@sbin/ifconfig/ifconfig.c","sbin/ifconfig/ifconfig.c","printif",984,1080
7,2,58,2,9,"clone_create@1084-1093@sbin/ifconfig/ifconfig.c","sbin/ifconfig/ifconfig.c","clone_create",1084,1093
6,2,53,2,6,"clone_destroy@1097-1103@sbin/ifconfig/ifconfig.c","sbin/ifconfig/ifconfig.c","clone_destroy",1097,1103
28,7,219,1,40,"list_cloners@1106-1146@sbin/ifconfig/ifconfig.c","sbin/ifconfig/ifconfig.c","list_cloners",1106,1146
9,4,52,2,13,"setifaddr@1155-1168@sbin/ifconfig/ifconfig.c","sbin/ifconfig/ifconfig.c","setifaddr",1155,1168
9,3,61,2,8,"setifrtlabel@1172-1180@sbin/ifconfig/ifconfig.c","sbin/ifconfig/ifconfig.c","setifrtlabel",1172,1180
4,1,21,2,3,"setifnetmask@1185-1188@sbin/ifconfig/ifconfig.c","sbin/ifconfig/ifconfig.c","setifnetmask",1185,1188
4,1,21,2,3,"setifbroadaddr@1192-1195@sbin/ifconfig/ifconfig.c","sbin/ifconfig/ifconfig.c","setifbroadaddr",1192,1195
6,2,40,2,5,"setifdesc@1200-1205@sbin/ifconfig/ifconfig.c","sbin/ifconfig/ifconfig.c","setifdesc",1200,1205
6,2,45,2,5,"unsetifdesc@1209-1214@sbin/ifconfig/ifconfig.c","sbin/ifconfig/ifconfig.c","unsetifdesc",1209,1214
7,1,30,2,6,"setifipdst@1218-1224@sbin/ifconfig/ifconfig.c","sbin/ifconfig/ifconfig.c","setifipdst",1218,1224
12,5,69,2,11,"notealias@1230-1241@sbin/ifconfig/ifconfig.c","sbin/ifconfig/ifconfig.c","notealias",1230,1241
6,1,27,2,5,"setifdstaddr@1245-1250@sbin/ifconfig/ifconfig.c","sbin/ifconfig/ifconfig.c","setifdstaddr",1245,1250
17,4,140,2,19,"setifflags@1259-1278@sbin/ifconfig/ifconfig.c","sbin/ifconfig/ifconfig.c","setifflags",1259,1278
17,4,136,2,19,"setifxflags@1282-1301@sbin/ifconfig/ifconfig.c","sbin/ifconfig/ifconfig.c","setifxflags",1282,1301
8,2,60,2,8,"addaf@1304-1312@sbin/ifconfig/ifconfig.c","sbin/ifconfig/ifconfig.c","addaf",1304,1312
8,2,60,2,8,"removeaf@1315-1323@sbin/ifconfig/ifconfig.c","sbin/ifconfig/ifconfig.c","removeaf",1315,1323
8,2,38,2,8,"setia6flags@1326-1334@sbin/ifconfig/ifconfig.c","sbin/ifconfig/ifconfig.c","setia6flags",1326,1334
4,1,19,2,4,"setia6pltime@1337-1341@sbin/ifconfig/ifconfig.c","sbin/ifconfig/ifconfig.c","setia6pltime",1337,1341
4,1,19,2,4,"setia6vltime@1344-1348@sbin/ifconfig/ifconfig.c","sbin/ifconfig/ifconfig.c","setia6vltime",1344,1348
18,5,144,2,20,"setia6lifetime@1351-1371@sbin/ifconfig/ifconfig.c","sbin/ifconfig/ifconfig.c","setia6lifetime",1351,1371
29,9,238,2,33,"setia6eui64@1374-1407@sbin/ifconfig/ifconfig.c","sbin/ifconfig/ifconfig.c","setia6eui64",1374,1407
10,2,43,2,9,"setautoconf@1410-1419@sbin/ifconfig/ifconfig.c","sbin/ifconfig/ifconfig.c","setautoconf",1410,1419
10,3,91,2,11,"setifmetric@1424-1435@sbin/ifconfig/ifconfig.c","sbin/ifconfig/ifconfig.c","setifmetric",1424,1435
10,3,91,2,11,"setifmtu@1440-1451@sbin/ifconfig/ifconfig.c","sbin/ifconfig/ifconfig.c","setifmtu",1440,1451
10,3,91,2,11,"setifllprio@1455-1466@sbin/ifconfig/ifconfig.c","sbin/ifconfig/ifconfig.c","setifllprio",1455,1466
15,6,126,2,17,"setifgroup@1470-1487@sbin/ifconfig/ifconfig.c","sbin/ifconfig/ifconfig.c","setifgroup",1470,1487
13,5,118,2,15,"unsetifgroup@1491-1506@sbin/ifconfig/ifconfig.c","sbin/ifconfig/ifconfig.c","unsetifgroup",1491,1506
45,17,290,4,47,"get_string@1509-1556@sbin/ifconfig/ifconfig.c","sbin/ifconfig/ifconfig.c","get_string",1509,1556
22,12,157,2,23,"print_string@1559-1582@sbin/ifconfig/ifconfig.c","sbin/ifconfig/ifconfig.c","print_string",1559,1582
18,4,133,2,19,"setifnwid@1585-1604@sbin/ifconfig/ifconfig.c","sbin/ifconfig/ifconfig.c","setifnwid",1585,1604
19,4,132,2,21,"setifbssid@1607-1628@sbin/ifconfig/ifconfig.c","sbin/ifconfig/ifconfig.c","setifbssid",1607,1628
75,19,497,2,89,"setifnwkey@1631-1720@sbin/ifconfig/ifconfig.c","sbin/ifconfig/ifconfig.c","setifnwkey",1631,1720
9,2,78,2,10,"setifwpa@1724-1734@sbin/ifconfig/ifconfig.c","sbin/ifconfig/ifconfig.c","setifwpa",1724,1734
28,7,218,2,30,"setifwpaprotos@1738-1768@sbin/ifconfig/ifconfig.c","sbin/ifconfig/ifconfig.c","setifwpaprotos",1738,1768
26,7,206,2,27,"setifwpaakms@1772-1799@sbin/ifconfig/ifconfig.c","sbin/ifconfig/ifconfig.c","setifwpaakms",1772,1799
8,3,63,1,8,"getwpacipher@1813-1821@sbin/ifconfig/ifconfig.c","sbin/ifconfig/ifconfig.c","getwpacipher",1813,1821
24,6,192,2,26,"setifwpaciphers@1825-1851@sbin/ifconfig/ifconfig.c","sbin/ifconfig/ifconfig.c","setifwpaciphers",1825,1851
15,4,127,2,16,"setifwpagroupcipher@1855-1871@sbin/ifconfig/ifconfig.c","sbin/ifconfig/ifconfig.c","setifwpagroupcipher",1855,1871
44,15,414,2,50,"setifwpakey@1874-1924@sbin/ifconfig/ifconfig.c","sbin/ifconfig/ifconfig.c","setifwpakey",1874,1924
25,7,140,2,26,"setifchan@1927-1953@sbin/ifconfig/ifconfig.c","sbin/ifconfig/ifconfig.c","setifchan",1927,1953
6,3,26,2,5,"setifscan@1957-1962@sbin/ifconfig/ifconfig.c","sbin/ifconfig/ifconfig.c","setifscan",1957,1962
21,7,166,2,24,"setifnwflag@1967-1991@sbin/ifconfig/ifconfig.c","sbin/ifconfig/ifconfig.c","setifnwflag",1967,1991
4,1,19,2,3,"unsetifnwflag@1994-1997@sbin/ifconfig/ifconfig.c","sbin/ifconfig/ifconfig.c","unsetifnwflag",1994,1997
18,7,149,2,20,"setifpowersave@2001-2021@sbin/ifconfig/ifconfig.c","sbin/ifconfig/ifconfig.c","setifpowersave",2001,2021
15,4,89,1,15,"print_cipherset@2025-2040@sbin/ifconfig/ifconfig.c","sbin/ifconfig/ifconfig.c","print_cipherset",2025,2040
155,51,1261,1,188,"ieee80211_status@2043-2231@sbin/ifconfig/ifconfig.c","sbin/ifconfig/ifconfig.c","ieee80211_status",2043,2231
25,5,169,1,26,"ieee80211_listchans@2234-2260@sbin/ifconfig/ifconfig.c","sbin/ifconfig/ifconfig.c","ieee80211_listchans",2234,2260
5,2,47,2,4,"rssicmp@2267-2271@sbin/ifconfig/ifconfig.c","sbin/ifconfig/ifconfig.c","rssicmp",2267,2271
39,8,268,1,46,"ieee80211_listnodes@2274-2320@sbin/ifconfig/ifconfig.c","sbin/ifconfig/ifconfig.c","ieee80211_listnodes",2274,2320
65,23,461,1,77,"ieee80211_printnode@2323-2400@sbin/ifconfig/ifconfig.c","sbin/ifconfig/ifconfig.c","ieee80211_printnode",2323,2400
15,5,119,1,27,"init_current_media@2403-2430@sbin/ifconfig/ifconfig.c","sbin/ifconfig/ifconfig.c","init_current_media",2403,2430
12,3,83,1,20,"process_media_commands@2433-2453@sbin/ifconfig/ifconfig.c","sbin/ifconfig/ifconfig.c","process_media_commands",2433,2453
21,6,120,2,40,"setmedia@2457-2497@sbin/ifconfig/ifconfig.c","sbin/ifconfig/ifconfig.c","setmedia",2457,2497
14,3,108,2,19,"setmediamode@2501-2520@sbin/ifconfig/ifconfig.c","sbin/ifconfig/ifconfig.c","setmediamode",2501,2520
13,2,86,2,18,"unsetmediamode@2523-2541@sbin/ifconfig/ifconfig.c","sbin/ifconfig/ifconfig.c","unsetmediamode",2523,2541
9,3,54,2,16,"setmediaopt@2544-2560@sbin/ifconfig/ifconfig.c","sbin/ifconfig/ifconfig.c","setmediaopt",2544,2560
9,3,54,2,21,"unsetmediaopt@2564-2585@sbin/ifconfig/ifconfig.c","sbin/ifconfig/ifconfig.c","unsetmediaopt",2564,2585
17,4,125,2,26,"setmediainst@2589-2615@sbin/ifconfig/ifconfig.c","sbin/ifconfig/ifconfig.c","setmediainst",2589,2615
10,3,53,1,10,"get_media_type_string@2631-2641@sbin/ifconfig/ifconfig.c","sbin/ifconfig/ifconfig.c","get_media_type_string",2631,2641
11,4,65,1,11,"get_media_subtype_string@2644-2655@sbin/ifconfig/ifconfig.c","sbin/ifconfig/ifconfig.c","get_media_subtype_string",2644,2655
9,2,52,2,10,"get_media_subtype@2658-2668@sbin/ifconfig/ifconfig.c","sbin/ifconfig/ifconfig.c","get_media_subtype",2658,2668
9,2,52,2,9,"get_media_mode@2671-2680@sbin/ifconfig/ifconfig.c","sbin/ifconfig/ifconfig.c","get_media_mode",2671,2680
18,4,121,2,24,"get_media_options@2683-2707@sbin/ifconfig/ifconfig.c","sbin/ifconfig/ifconfig.c","get_media_options",2683,2707
10,4,67,3,10,"lookup_media_word@2710-2720@sbin/ifconfig/ifconfig.c","sbin/ifconfig/ifconfig.c","lookup_media_word",2710,2720
33,15,237,3,37,"print_media_word@2723-2760@sbin/ifconfig/ifconfig.c","sbin/ifconfig/ifconfig.c","print_media_word",2723,2760
36,13,367,1,42,"phys_status@2764-2806@sbin/ifconfig/ifconfig.c","sbin/ifconfig/ifconfig.c","phys_status",2764,2806
11,3,75,2,11,"get_linkstate@2819-2830@sbin/ifconfig/ifconfig.c","sbin/ifconfig/ifconfig.c","get_linkstate",2819,2830
148,44,1044,3,197,"status@2837-3034@sbin/ifconfig/ifconfig.c","sbin/ifconfig/ifconfig.c","status",2837,3034
49,12,445,1,57,"in_status@3038-3095@sbin/ifconfig/ifconfig.c","sbin/ifconfig/ifconfig.c","in_status",3038,3095
6,2,31,2,5,"setifprefixlen@3099-3104@sbin/ifconfig/ifconfig.c","sbin/ifconfig/ifconfig.c","setifprefixlen",3099,3104
8,3,63,1,9,"in6_fillscopeid@3107-3116@sbin/ifconfig/ifconfig.c","sbin/ifconfig/ifconfig.c","in6_fillscopeid",3107,3116
102,29,818,1,114,"in6_alias@3120-3234@sbin/ifconfig/ifconfig.c","sbin/ifconfig/ifconfig.c","in6_alias",3120,3234
4,1,18,1,3,"in6_status@3237-3240@sbin/ifconfig/ifconfig.c","sbin/ifconfig/ifconfig.c","in6_status",3237,3240
38,10,344,2,45,"settunnel@3244-3289@sbin/ifconfig/ifconfig.c","sbin/ifconfig/ifconfig.c","settunnel",3244,3289
5,2,31,2,4,"deletetunnel@3293-3297@sbin/ifconfig/ifconfig.c","sbin/ifconfig/ifconfig.c","deletetunnel",3293,3297
12,3,95,2,13,"settunnelinst@3300-3313@sbin/ifconfig/ifconfig.c","sbin/ifconfig/ifconfig.c","settunnelinst",3300,3313
12,3,95,2,13,"settunnelttl@3316-3329@sbin/ifconfig/ifconfig.c","sbin/ifconfig/ifconfig.c","settunnelttl",3316,3329
9,2,60,1,10,"mpe_status@3332-3342@sbin/ifconfig/ifconfig.c","sbin/ifconfig/ifconfig.c","mpe_status",3332,3342
41,9,225,1,47,"mpw_status@3345-3392@sbin/ifconfig/ifconfig.c","sbin/ifconfig/ifconfig.c","mpw_status",3345,3392
12,3,96,2,13,"setmpelabel@3396-3409@sbin/ifconfig/ifconfig.c","sbin/ifconfig/ifconfig.c","setmpelabel",3396,3409
37,13,295,1,45,"process_mpw_commands@3412-3457@sbin/ifconfig/ifconfig.c","sbin/ifconfig/ifconfig.c","process_mpw_commands",3412,3457
10,3,59,2,10,"setmpwencap@3460-3470@sbin/ifconfig/ifconfig.c","sbin/ifconfig/ifconfig.c","setmpwencap",3460,3470
13,3,97,2,15,"setmpwlabel@3473-3488@sbin/ifconfig/ifconfig.c","sbin/ifconfig/ifconfig.c","setmpwlabel",3473,3488
9,2,60,2,11,"setmpwneighbor@3491-3502@sbin/ifconfig/ifconfig.c","sbin/ifconfig/ifconfig.c","setmpwneighbor",3491,3502
9,2,39,2,9,"setmpwcontrolword@3505-3514@sbin/ifconfig/ifconfig.c","sbin/ifconfig/ifconfig.c","setmpwcontrolword",3505,3514
16,4,114,2,18,"setvnetid@3534-3552@sbin/ifconfig/ifconfig.c","sbin/ifconfig/ifconfig.c","setvnetid",3534,3552
5,2,31,2,4,"delvnetid@3556-3560@sbin/ifconfig/ifconfig.c","sbin/ifconfig/ifconfig.c","delvnetid",3556,3560
18,5,106,1,21,"getvnetid@3563-3584@sbin/ifconfig/ifconfig.c","sbin/ifconfig/ifconfig.c","getvnetid",3563,3584
12,4,102,2,14,"setifparent@3587-3601@sbin/ifconfig/ifconfig.c","sbin/ifconfig/ifconfig.c","setifparent",3587,3601
5,2,31,2,4,"delifparent@3605-3609@sbin/ifconfig/ifconfig.c","sbin/ifconfig/ifconfig.c","delifparent",3605,3609
17,4,119,1,19,"getifparent@3612-3631@sbin/ifconfig/ifconfig.c","sbin/ifconfig/ifconfig.c","getifparent",3612,3631
29,7,127,1,34,"getencap@3634-3668@sbin/ifconfig/ifconfig.c","sbin/ifconfig/ifconfig.c","getencap",3634,3668
17,4,143,2,21,"setvlantag@3675-3696@sbin/ifconfig/ifconfig.c","sbin/ifconfig/ifconfig.c","setvlantag",3675,3696
22,7,194,2,26,"setvlandev@3700-3726@sbin/ifconfig/ifconfig.c","sbin/ifconfig/ifconfig.c","setvlandev",3700,3726
12,3,117,2,15,"unsetvlandev@3730-3745@sbin/ifconfig/ifconfig.c","sbin/ifconfig/ifconfig.c","unsetvlandev",3730,3745
9,2,78,2,10,"settrunkport@3748-3758@sbin/ifconfig/ifconfig.c","sbin/ifconfig/ifconfig.c","settrunkport",3748,3758
9,2,78,2,10,"unsettrunkport@3761-3771@sbin/ifconfig/ifconfig.c","sbin/ifconfig/ifconfig.c","unsettrunkport",3761,3771
19,5,157,2,21,"settrunkproto@3774-3795@sbin/ifconfig/ifconfig.c","sbin/ifconfig/ifconfig.c","settrunkproto",3774,3795
57,12,464,1,65,"trunk_status@3798-3863@sbin/ifconfig/ifconfig.c","sbin/ifconfig/ifconfig.c","trunk_status",3798,3863
46,11,313,1,51,"carp_status@3870-3921@sbin/ifconfig/ifconfig.c","sbin/ifconfig/ifconfig.c","carp_status",3870,3921
12,3,112,2,15,"setcarp_passwd@3925-3940@sbin/ifconfig/ifconfig.c","sbin/ifconfig/ifconfig.c","setcarp_passwd",3925,3940
17,4,145,2,21,"setcarp_vhid@3944-3965@sbin/ifconfig/ifconfig.c","sbin/ifconfig/ifconfig.c","setcarp_vhid",3944,3965
16,4,136,2,20,"setcarp_advskew@3969-3989@sbin/ifconfig/ifconfig.c","sbin/ifconfig/ifconfig.c","setcarp_advskew",3969,3989
16,4,133,2,20,"setcarp_advbase@3993-4013@sbin/ifconfig/ifconfig.c","sbin/ifconfig/ifconfig.c","setcarp_advbase",3993,4013
23,5,197,2,30,"setcarppeer@4017-4047@sbin/ifconfig/ifconfig.c","sbin/ifconfig/ifconfig.c","setcarppeer",4017,4047
11,3,103,2,14,"unsetcarppeer@4050-4064@sbin/ifconfig/ifconfig.c","sbin/ifconfig/ifconfig.c","unsetcarppeer",4050,4064
17,5,129,2,20,"setcarp_state@4068-4088@sbin/ifconfig/ifconfig.c","sbin/ifconfig/ifconfig.c","setcarp_state",4068,4088
11,3,104,2,14,"setcarpdev@4092-4106@sbin/ifconfig/ifconfig.c","sbin/ifconfig/ifconfig.c","setcarpdev",4092,4106
34,9,278,2,41,"setcarp_nodes@4109-4150@sbin/ifconfig/ifconfig.c","sbin/ifconfig/ifconfig.c","setcarp_nodes",4109,4150
17,6,140,2,22,"setcarp_balancing@4153-4175@sbin/ifconfig/ifconfig.c","sbin/ifconfig/ifconfig.c","setcarp_balancing",4153,4175
11,3,104,2,14,"setpfsync_syncdev@4178-4192@sbin/ifconfig/ifconfig.c","sbin/ifconfig/ifconfig.c","setpfsync_syncdev",4178,4192
11,3,103,2,14,"unsetpfsync_syncdev@4196-4210@sbin/ifconfig/ifconfig.c","sbin/ifconfig/ifconfig.c","unsetpfsync_syncdev",4196,4210
23,5,199,2,30,"setpfsync_syncpeer@4214-4244@sbin/ifconfig/ifconfig.c","sbin/ifconfig/ifconfig.c","setpfsync_syncpeer",4214,4244
11,3,96,2,14,"unsetpfsync_syncpeer@4248-4262@sbin/ifconfig/ifconfig.c","sbin/ifconfig/ifconfig.c","unsetpfsync_syncpeer",4248,4262
16,4,133,2,20,"setpfsync_maxupd@4266-4286@sbin/ifconfig/ifconfig.c","sbin/ifconfig/ifconfig.c","setpfsync_maxupd",4266,4286
11,3,94,2,13,"setpfsync_defer@4289-4302@sbin/ifconfig/ifconfig.c","sbin/ifconfig/ifconfig.c","setpfsync_defer",4289,4302
16,5,121,1,18,"pfsync_status@4305-4323@sbin/ifconfig/ifconfig.c","sbin/ifconfig/ifconfig.c","pfsync_status",4305,4323
75,20,504,1,78,"pflow_status@4326-4404@sbin/ifconfig/ifconfig.c","sbin/ifconfig/ifconfig.c","pflow_status",4326,4404
43,14,302,2,49,"pflow_addr@4407-4456@sbin/ifconfig/ifconfig.c","sbin/ifconfig/ifconfig.c","pflow_addr",4407,4456
10,2,79,2,11,"setpflow_sender@4459-4470@sbin/ifconfig/ifconfig.c","sbin/ifconfig/ifconfig.c","setpflow_sender",4459,4470
9,2,69,2,9,"unsetpflow_sender@4473-4482@sbin/ifconfig/ifconfig.c","sbin/ifconfig/ifconfig.c","unsetpflow_sender",4473,4482
10,2,79,2,11,"setpflow_receiver@4485-4496@sbin/ifconfig/ifconfig.c","sbin/ifconfig/ifconfig.c","setpflow_receiver",4485,4496
9,2,69,2,9,"unsetpflow_receiver@4499-4508@sbin/ifconfig/ifconfig.c","sbin/ifconfig/ifconfig.c","unsetpflow_receiver",4499,4508
20,5,161,2,24,"setpflowproto@4512-4536@sbin/ifconfig/ifconfig.c","sbin/ifconfig/ifconfig.c","setpflowproto",4512,4536
55,13,385,1,66,"pppoe_status@4539-4605@sbin/ifconfig/ifconfig.c","sbin/ifconfig/ifconfig.c","pppoe_status",4539,4605
10,3,81,2,12,"setpppoe_dev@4609-4621@sbin/ifconfig/ifconfig.c","sbin/ifconfig/ifconfig.c","setpppoe_dev",4609,4621
13,4,104,2,15,"setpppoe_svc@4625-4640@sbin/ifconfig/ifconfig.c","sbin/ifconfig/ifconfig.c","setpppoe_svc",4625,4640
13,4,104,2,15,"setpppoe_ac@4644-4659@sbin/ifconfig/ifconfig.c","sbin/ifconfig/ifconfig.c","setpppoe_ac",4644,4659
8,3,66,2,8,"spppauthinfo@4662-4670@sbin/ifconfig/ifconfig.c","sbin/ifconfig/ifconfig.c","spppauthinfo",4662,4670
16,6,119,2,18,"setspppproto@4673-4691@sbin/ifconfig/ifconfig.c","sbin/ifconfig/ifconfig.c","setspppproto",4673,4691
4,1,19,2,3,"setsppppeerproto@4694-4697@sbin/ifconfig/ifconfig.c","sbin/ifconfig/ifconfig.c","setsppppeerproto",4694,4697
12,5,105,2,14,"setspppname@4700-4714@sbin/ifconfig/ifconfig.c","sbin/ifconfig/ifconfig.c","setspppname",4700,4714
4,1,19,2,3,"setsppppeername@4717-4720@sbin/ifconfig/ifconfig.c","sbin/ifconfig/ifconfig.c","setsppppeername",4717,4720
12,5,105,2,14,"setspppkey@4723-4737@sbin/ifconfig/ifconfig.c","sbin/ifconfig/ifconfig.c","setspppkey",4723,4737
4,1,19,2,3,"setsppppeerkey@4740-4743@sbin/ifconfig/ifconfig.c","sbin/ifconfig/ifconfig.c","setsppppeerkey",4740,4743
21,6,126,2,24,"setsppppeerflag@4746-4770@sbin/ifconfig/ifconfig.c","sbin/ifconfig/ifconfig.c","setsppppeerflag",4746,4770
4,1,19,2,3,"unsetsppppeerflag@4773-4776@sbin/ifconfig/ifconfig.c","sbin/ifconfig/ifconfig.c","unsetsppppeerflag",4773,4776
21,6,112,2,20,"sppp_printproto@4779-4799@sbin/ifconfig/ifconfig.c","sbin/ifconfig/ifconfig.c","sppp_printproto",4779,4799
40,9,195,1,43,"sppp_status@4802-4845@sbin/ifconfig/ifconfig.c","sbin/ifconfig/ifconfig.c","sppp_status",4802,4845
17,4,138,2,18,"setkeepalive@4848-4866@sbin/ifconfig/ifconfig.c","sbin/ifconfig/ifconfig.c","setkeepalive",4848,4866
8,2,65,2,8,"unsetkeepalive@4869-4877@sbin/ifconfig/ifconfig.c","sbin/ifconfig/ifconfig.c","unsetkeepalive",4869,4877
12,3,95,2,13,"setifpriority@4880-4893@sbin/ifconfig/ifconfig.c","sbin/ifconfig/ifconfig.c","setifpriority",4880,4893
9,3,47,2,8,"umb_descr2val@4912-4920@sbin/ifconfig/ifconfig.c","sbin/ifconfig/ifconfig.c","umb_descr2val",4912,4920
172,62,1159,1,182,"umb_status@4923-5105@sbin/ifconfig/ifconfig.c","sbin/ifconfig/ifconfig.c","umb_status",4923,5105
15,3,81,2,15,"umb_printclasses@5108-5123@sbin/ifconfig/ifconfig.c","sbin/ifconfig/ifconfig.c","umb_printclasses",5108,5123
16,5,109,1,16,"umb_parse_classes@5126-5142@sbin/ifconfig/ifconfig.c","sbin/ifconfig/ifconfig.c","umb_parse_classes",5126,5142
4,1,23,2,3,"umb_setpin@5145-5148@sbin/ifconfig/ifconfig.c","sbin/ifconfig/ifconfig.c","umb_setpin",5145,5148
4,1,25,2,3,"umb_chgpin@5151-5154@sbin/ifconfig/ifconfig.c","sbin/ifconfig/ifconfig.c","umb_chgpin",5151,5154
4,1,25,2,3,"umb_puk@5157-5160@sbin/ifconfig/ifconfig.c","sbin/ifconfig/ifconfig.c","umb_puk",5157,5160
20,6,191,4,23,"umb_pinop@5163-5186@sbin/ifconfig/ifconfig.c","sbin/ifconfig/ifconfig.c","umb_pinop",5163,5186
15,5,146,2,17,"umb_apn@5189-5206@sbin/ifconfig/ifconfig.c","sbin/ifconfig/ifconfig.c","umb_apn",5189,5206
20,6,134,2,21,"umb_setclass@5209-5230@sbin/ifconfig/ifconfig.c","sbin/ifconfig/ifconfig.c","umb_setclass",5209,5230
11,3,95,2,11,"umb_roaming@5233-5244@sbin/ifconfig/ifconfig.c","sbin/ifconfig/ifconfig.c","umb_roaming",5233,5244
14,6,85,4,15,"utf16_to_char@5247-5262@sbin/ifconfig/ifconfig.c","sbin/ifconfig/ifconfig.c","utf16_to_char",5247,5262
17,4,96,3,23,"char_to_utf16@5265-5288@sbin/ifconfig/ifconfig.c","sbin/ifconfig/ifconfig.c","char_to_utf16",5265,5288
28,9,266,2,29,"in_getaddr@5298-5327@sbin/ifconfig/ifconfig.c","sbin/ifconfig/ifconfig.c","in_getaddr",5298,5327
22,7,185,2,23,"in_getprefix@5331-5354@sbin/ifconfig/ifconfig.c","sbin/ifconfig/ifconfig.c","in_getprefix",5331,5354
25,9,150,3,26,"printb@5360-5386@sbin/ifconfig/ifconfig.c","sbin/ifconfig/ifconfig.c","printb",5360,5386
19,7,111,2,19,"printb_status@5392-5411@sbin/ifconfig/ifconfig.c","sbin/ifconfig/ifconfig.c","printb_status",5392,5411
33,10,283,2,37,"in6_getaddr@5419-5456@sbin/ifconfig/ifconfig.c","sbin/ifconfig/ifconfig.c","in6_getaddr",5419,5456
22,7,185,2,23,"in6_getprefix@5459-5482@sbin/ifconfig/ifconfig.c","sbin/ifconfig/ifconfig.c","in6_getprefix",5459,5482
21,10,163,2,21,"prefix@5485-5506@sbin/ifconfig/ifconfig.c","sbin/ifconfig/ifconfig.c","prefix",5485,5506
8,1,20,1,7,"usage@5510-5517@sbin/ifconfig/ifconfig.c","sbin/ifconfig/ifconfig.c","usage",5510,5517
35,11,239,1,39,"getifgroups@5520-5559@sbin/ifconfig/ifconfig.c","sbin/ifconfig/ifconfig.c","getifgroups",5520,5559
20,6,137,2,21,"printifhwfeatures@5563-5584@sbin/ifconfig/ifconfig.c","sbin/ifconfig/ifconfig.c","printifhwfeatures",5563,5584
8,1,55,1,8,"sec2str@5588-5596@sbin/ifconfig/ifconfig.c","sbin/ifconfig/ifconfig.c","sec2str",5588,5596
21,4,146,2,22,"setiflladdr@5600-5622@sbin/ifconfig/ifconfig.c","sbin/ifconfig/ifconfig.c","setiflladdr",5600,5622
12,3,95,2,13,"setrdomain@5626-5639@sbin/ifconfig/ifconfig.c","sbin/ifconfig/ifconfig.c","setrdomain",5626,5639
10,3,80,2,9,"setpair@5644-5653@sbin/ifconfig/ifconfig.c","sbin/ifconfig/ifconfig.c","setpair",5644,5653
7,2,56,2,6,"unsetpair@5656-5662@sbin/ifconfig/ifconfig.c","sbin/ifconfig/ifconfig.c","unsetpair",5656,5662
3,1,12,2,3,"setignore@5667-5670@sbin/ifconfig/ifconfig.c","sbin/ifconfig/ifconfig.c","setignore",5667,5670
4,1,35,2,3,"caproc@91-94@sbin/iked/ca.c","sbin/iked/ca.c","caproc",91,94
10,3,81,3,18,"ca_run@97-115@sbin/iked/ca.c","sbin/iked/ca.c","ca_run",97,115
25,5,175,3,30,"ca_getkey@118-148@sbin/iked/ca.c","sbin/iked/ca.c","ca_getkey",118,148
24,10,184,1,28,"ca_reset@151-179@sbin/iked/ca.c","sbin/iked/ca.c","ca_reset",151,179
28,8,147,3,29,"ca_dispatch_parent@182-211@sbin/iked/ca.c","sbin/iked/ca.c","ca_dispatch_parent",182,211
18,4,85,3,19,"ca_dispatch_ikev2@214-233@sbin/iked/ca.c","sbin/iked/ca.c","ca_dispatch_ikev2",214,233
33,6,272,7,39,"ca_setcert@236-275@sbin/iked/ca.c","sbin/iked/ca.c","ca_setcert",236,275
38,3,299,7,44,"ca_setreq@278-322@sbin/iked/ca.c","sbin/iked/ca.c","ca_setreq",278,322
38,10,284,4,43,"ca_setauth@325-368@sbin/iked/ca.c","sbin/iked/ca.c","ca_setauth",325,368
52,11,373,2,58,"ca_getcert@371-429@sbin/iked/ca.c","sbin/iked/ca.c","ca_getcert",371,429
61,15,450,2,72,"ca_getreq@432-504@sbin/iked/ca.c","sbin/iked/ca.c","ca_getreq",432,504
46,7,349,2,57,"ca_getauth@507-564@sbin/iked/ca.c","sbin/iked/ca.c","ca_getauth",507,564
122,29,897,1,162,"ca_reload@567-729@sbin/iked/ca.c","sbin/iked/ca.c","ca_reload",567,729
21,5,138,3,25,"ca_by_subjectpubkey@732-757@sbin/iked/ca.c","sbin/iked/ca.c","ca_by_subjectpubkey",732,757
32,9,184,3,35,"ca_by_issuer@760-795@sbin/iked/ca.c","sbin/iked/ca.c","ca_by_issuer",760,795
20,5,132,3,28,"ca_subjectpubkey_digest@798-826@sbin/iked/ca.c","sbin/iked/ca.c","ca_subjectpubkey_digest",798,826
17,3,97,1,19,"ca_x509_serialize@829-848@sbin/iked/ca.c","sbin/iked/ca.c","ca_x509_serialize",829,848
60,13,376,2,68,"ca_pubkey_serialize@851-919@sbin/iked/ca.c","sbin/iked/ca.c","ca_pubkey_serialize",851,919
60,13,376,2,68,"ca_privkey_serialize@922-990@sbin/iked/ca.c","sbin/iked/ca.c","ca_privkey_serialize",922,990
40,11,203,1,43,"ca_privkey_to_method@993-1036@sbin/iked/ca.c","sbin/iked/ca.c","ca_privkey_to_method",993,1036
12,2,72,2,13,"ca_asn1_name@1039-1052@sbin/iked/ca.c","sbin/iked/ca.c","ca_asn1_name",1039,1052
9,2,60,1,10,"ca_x509_name@1055-1065@sbin/iked/ca.c","sbin/iked/ca.c","ca_x509_name",1055,1065
21,5,91,3,20,"ca_x509_name_unescape@1073-1093@sbin/iked/ca.c","sbin/iked/ca.c","ca_x509_name_unescape",1073,1093
52,12,304,1,59,"ca_x509_name_parse@1101-1160@sbin/iked/ca.c","sbin/iked/ca.c","ca_x509_name_parse",1101,1160
104,32,662,4,118,"ca_validate_pubkey@1163-1281@sbin/iked/ca.c","sbin/iked/ca.c","ca_validate_pubkey",1163,1281
72,16,404,4,87,"ca_validate_cert@1284-1371@sbin/iked/ca.c","sbin/iked/ca.c","ca_validate_cert",1284,1371
21,6,154,2,21,"ca_x509_subject_cmp@1375-1396@sbin/iked/ca.c","sbin/iked/ca.c","ca_x509_subject_cmp",1375,1396
22,5,167,2,25,"ca_x509_subjectaltname_cmp@1399-1424@sbin/iked/ca.c","sbin/iked/ca.c","ca_x509_subjectaltname_cmp",1399,1424
60,13,378,3,68,"ca_x509_subjectaltname@1427-1495@sbin/iked/ca.c","sbin/iked/ca.c","ca_x509_subjectaltname",1427,1495
7,1,22,1,8,"ca_sslinit@1498-1506@sbin/iked/ca.c","sbin/iked/ca.c","ca_sslinit",1498,1506
7,2,41,1,7,"ca_sslerror@1509-1516@sbin/iked/ca.c","sbin/iked/ca.c","ca_sslerror",1509,1516
8,1,66,2,9,"get7bits@79-88@sbin/iked/chap_ms.c","sbin/iked/chap_ms.c","get7bits",79,88
12,1,117,2,12,"mschap_des_addparity@93-105@sbin/iked/chap_ms.c","sbin/iked/chap_ms.c","mschap_des_addparity",93,105
9,1,58,3,10,"mschap_des_encrypt@108-118@sbin/iked/chap_ms.c","sbin/iked/chap_ms.c","mschap_des_encrypt",108,118
10,1,83,3,11,"mschap_challenge_response@121-132@sbin/iked/chap_ms.c","sbin/iked/chap_ms.c","mschap_challenge_response",121,132
8,1,53,3,8,"mschap_ntpassword_hash@135-143@sbin/iked/chap_ms.c","sbin/iked/chap_ms.c","mschap_ntpassword_hash",135,143
18,2,126,5,20,"mschap_challenge_hash@146-166@sbin/iked/chap_ms.c","sbin/iked/chap_ms.c","mschap_challenge_hash",146,166
11,1,73,7,12,"mschap_nt_response@169-181@sbin/iked/chap_ms.c","sbin/iked/chap_ms.c","mschap_nt_response",169,181
47,2,459,8,58,"mschap_auth_response@184-242@sbin/iked/chap_ms.c","sbin/iked/chap_ms.c","mschap_auth_response",184,242
18,1,152,3,19,"mschap_masterkey@245-264@sbin/iked/chap_ms.c","sbin/iked/chap_ms.c","mschap_masterkey",245,264
41,4,483,5,43,"mschap_asymetric_startkey@267-310@sbin/iked/chap_ms.c","sbin/iked/chap_ms.c","mschap_asymetric_startkey",267,310
17,1,146,4,20,"mschap_msk@313-333@sbin/iked/chap_ms.c","sbin/iked/chap_ms.c","mschap_msk",313,333
23,3,220,4,27,"mschap_radiuskey@336-363@sbin/iked/chap_ms.c","sbin/iked/chap_ms.c","mschap_radiuskey",336,363
20,3,155,2,24,"config_new_sa@41-65@sbin/iked/config.c","sbin/iked/config.c","config_new_sa",41,65
8,2,33,1,9,"config_getspi@68-77@sbin/iked/config.c","sbin/iked/config.c","config_getspi",68,77
12,3,65,1,14,"config_free_kex@80-94@sbin/iked/config.c","sbin/iked/config.c","config_free_kex",80,94
51,5,394,2,63,"config_free_sa@97-160@sbin/iked/config.c","sbin/iked/config.c","config_free_sa",97,160
10,2,67,1,13,"config_new_policy@163-176@sbin/iked/config.c","sbin/iked/config.c","config_new_policy",163,176
20,4,119,2,25,"config_free_policy@179-204@sbin/iked/config.c","sbin/iked/config.c","config_free_policy",179,204
16,4,101,3,20,"config_add_proposal@207-227@sbin/iked/config.c","sbin/iked/config.c","config_add_proposal",207,227
14,5,99,2,18,"config_free_proposals@230-248@sbin/iked/config.c","sbin/iked/config.c","config_free_proposals",230,248
10,2,77,2,10,"config_free_flows@251-261@sbin/iked/config.c","sbin/iked/config.c","config_free_flows",251,261
24,8,180,4,30,"config_free_childsas@264-294@sbin/iked/config.c","sbin/iked/config.c","config_free_childsas",264,294
66,16,336,5,72,"config_add_transform@297-369@sbin/iked/config.c","sbin/iked/config.c","config_add_transform",297,369
17,5,97,3,20,"config_findtransform@372-392@sbin/iked/config.c","sbin/iked/config.c","config_findtransform",372,392
15,3,131,2,21,"config_new_user@395-416@sbin/iked/config.c","sbin/iked/config.c","config_new_user",395,416
7,2,46,2,8,"config_setcoupled@423-431@sbin/iked/config.c","sbin/iked/config.c","config_setcoupled",423,431
5,2,36,2,4,"config_getcoupled@434-438@sbin/iked/config.c","sbin/iked/config.c","config_getcoupled",434,438
7,2,46,2,8,"config_setmode@441-449@sbin/iked/config.c","sbin/iked/config.c","config_setmode",441,449
12,4,88,2,15,"config_getmode@452-467@sbin/iked/config.c","sbin/iked/config.c","config_getmode",452,467
5,1,42,3,4,"config_setreset@470-474@sbin/iked/config.c","sbin/iked/config.c","config_setreset",470,474
36,10,277,2,40,"config_getreset@477-517@sbin/iked/config.c","sbin/iked/config.c","config_getreset",477,517
10,2,84,4,10,"config_setsocket@520-530@sbin/iked/config.c","sbin/iked/config.c","config_setsocket",520,530
34,7,258,3,41,"config_getsocket@533-574@sbin/iked/config.c","sbin/iked/config.c","config_getsocket",533,574
9,2,64,2,9,"config_setpfkey@577-586@sbin/iked/config.c","sbin/iked/config.c","config_setpfkey",577,586
6,1,39,2,5,"config_getpfkey@589-594@sbin/iked/config.c","sbin/iked/config.c","config_getpfkey",589,594
9,2,63,3,9,"config_setuser@597-606@sbin/iked/config.c","sbin/iked/config.c","config_setuser",597,606
10,2,70,2,13,"config_getuser@609-622@sbin/iked/config.c","sbin/iked/config.c","config_getuser",609,622
36,5,256,3,45,"config_setpolicy@625-670@sbin/iked/config.c","sbin/iked/config.c","config_setpolicy",625,670
20,3,145,3,23,"config_setflow@673-696@sbin/iked/config.c","sbin/iked/config.c","config_setflow",673,696
41,8,330,2,54,"config_getpolicy@699-753@sbin/iked/config.c","sbin/iked/config.c","config_getpolicy",699,753
30,6,211,2,36,"config_getflow@756-792@sbin/iked/config.c","sbin/iked/config.c","config_getflow",756,792
7,2,47,2,7,"config_setcompile@795-802@sbin/iked/config.c","sbin/iked/config.c","config_setcompile",795,802
6,1,34,2,10,"config_getcompile@805-815@sbin/iked/config.c","sbin/iked/config.c","config_getcompile",805,815
8,1,44,1,8,"config_setmobike@818-826@sbin/iked/config.c","sbin/iked/config.c","config_setmobike",818,826
9,2,67,2,9,"config_getmobike@829-838@sbin/iked/config.c","sbin/iked/config.c","config_getmobike",829,838
9,3,56,1,9,"config_setocsp@841-850@sbin/iked/config.c","sbin/iked/config.c","config_setocsp",841,850
11,3,75,2,10,"config_getocsp@853-863@sbin/iked/config.c","sbin/iked/config.c","config_getocsp",853,863
51,8,381,1,62,"config_setkeys@866-928@sbin/iked/config.c","sbin/iked/config.c","config_setkeys",866,928
15,3,130,2,18,"config_getkey@931-949@sbin/iked/config.c","sbin/iked/config.c","config_getkey",931,949
4,1,35,2,3,"control@57-60@sbin/iked/control.c","sbin/iked/control.c","control",57,60
5,2,35,3,10,"control_run@63-73@sbin/iked/control.c","sbin/iked/control.c","control_run",63,73
49,9,367,2,57,"control_init@76-133@sbin/iked/control.c","sbin/iked/control.c","control_init",76,133
14,3,96,1,16,"control_listen@136-152@sbin/iked/control.c","sbin/iked/control.c","control_listen",136,152
8,2,45,1,7,"control_cleanup@155-162@sbin/iked/control.c","sbin/iked/control.c","control_cleanup",155,162
36,9,286,3,45,"control_accept@166-211@sbin/iked/control.c","sbin/iked/control.c","control_accept",166,211
9,2,42,1,10,"control_connbyfd@214-224@sbin/iked/control.c","sbin/iked/control.c","control_connbyfd",214,224
17,3,123,2,22,"control_close@227-249@sbin/iked/control.c","sbin/iked/control.c","control_close",227,249
67,21,390,3,75,"control_dispatch_imsg@253-328@sbin/iked/control.c","sbin/iked/control.c","control_dispatch_imsg",253,328
9,2,68,1,9,"control_imsg_forward@331-340@sbin/iked/control.c","sbin/iked/control.c","control_imsg_forward",331,340
110,29,482,2,116,"hash_new@90-206@sbin/iked/crypto.c","sbin/iked/crypto.c","hash_new",90,206
9,2,61,3,8,"hash_setkey@209-217@sbin/iked/crypto.c","sbin/iked/crypto.c","hash_setkey",209,217
11,3,53,1,10,"hash_free@220-230@sbin/iked/crypto.c","sbin/iked/crypto.c","hash_free",220,230
5,1,35,1,4,"hash_init@233-237@sbin/iked/crypto.c","sbin/iked/crypto.c","hash_init",233,237
4,1,27,3,3,"hash_update@240-243@sbin/iked/crypto.c","sbin/iked/crypto.c","hash_update",240,243
8,3,63,3,10,"hash_final@246-256@sbin/iked/crypto.c","sbin/iked/crypto.c","hash_final",246,256
6,2,29,1,5,"hash_length@259-264@sbin/iked/crypto.c","sbin/iked/crypto.c","hash_length",259,264
4,1,16,1,3,"hash_keylength@267-270@sbin/iked/crypto.c","sbin/iked/crypto.c","hash_keylength",267,270
81,22,395,3,87,"cipher_new@273-360@sbin/iked/crypto.c","sbin/iked/crypto.c","cipher_new",273,360
9,2,61,3,8,"cipher_setkey@363-371@sbin/iked/crypto.c","sbin/iked/crypto.c","cipher_setkey",363,371
19,4,117,3,19,"cipher_setiv@374-393@sbin/iked/crypto.c","sbin/iked/crypto.c","cipher_setiv",374,393
11,3,53,1,10,"cipher_free@396-406@sbin/iked/crypto.c","sbin/iked/crypto.c","cipher_free",396,406
6,1,50,2,5,"cipher_init@409-414@sbin/iked/crypto.c","sbin/iked/crypto.c","cipher_init",409,414
4,1,16,1,3,"cipher_init_encrypt@417-420@sbin/iked/crypto.c","sbin/iked/crypto.c","cipher_init_encrypt",417,420
4,1,16,1,3,"cipher_init_decrypt@423-426@sbin/iked/crypto.c","sbin/iked/crypto.c","cipher_init_decrypt",423,426
12,2,72,5,12,"cipher_update@429-441@sbin/iked/crypto.c","sbin/iked/crypto.c","cipher_update",429,441
11,2,61,3,11,"cipher_final@444-455@sbin/iked/crypto.c","sbin/iked/crypto.c","cipher_final",444,455
4,1,16,1,3,"cipher_length@458-461@sbin/iked/crypto.c","sbin/iked/crypto.c","cipher_length",458,461
6,2,32,1,7,"cipher_keylength@464-471@sbin/iked/crypto.c","sbin/iked/crypto.c","cipher_keylength",464,471
4,1,16,1,3,"cipher_ivlength@474-477@sbin/iked/crypto.c","sbin/iked/crypto.c","cipher_ivlength",474,477
4,1,24,2,3,"cipher_outlength@480-483@sbin/iked/crypto.c","sbin/iked/crypto.c","cipher_outlength",480,483
60,15,342,3,67,"dsa_new@486-553@sbin/iked/crypto.c","sbin/iked/crypto.c","dsa_new",486,553
4,1,24,2,3,"dsa_sign_new@556-559@sbin/iked/crypto.c","sbin/iked/crypto.c","dsa_sign_new",556,559
4,1,24,2,3,"dsa_verify_new@562-565@sbin/iked/crypto.c","sbin/iked/crypto.c","dsa_verify_new",562,565
17,5,95,1,17,"dsa_free@568-585@sbin/iked/crypto.c","sbin/iked/crypto.c","dsa_free",568,585
82,24,472,4,91,"dsa_setkey@588-679@sbin/iked/crypto.c","sbin/iked/crypto.c","dsa_setkey",588,679
47,11,321,3,51,"_dsa_verify_init@682-733@sbin/iked/crypto.c","sbin/iked/crypto.c","_dsa_verify_init",682,733
18,6,140,3,20,"dsa_init@736-756@sbin/iked/crypto.c","sbin/iked/crypto.c","dsa_init",736,756
11,4,85,3,12,"dsa_update@759-771@sbin/iked/crypto.c","sbin/iked/crypto.c","dsa_update",759,771
27,10,212,3,28,"_dsa_sign_encode@775-803@sbin/iked/crypto.c","sbin/iked/crypto.c","_dsa_sign_encode",775,803
7,2,36,1,7,"dsa_prefix@807-814@sbin/iked/crypto.c","sbin/iked/crypto.c","dsa_prefix",807,814
12,5,77,1,12,"dsa_length@817-829@sbin/iked/crypto.c","sbin/iked/crypto.c","dsa_length",817,829
34,9,251,3,39,"_dsa_sign_ecdsa@832-871@sbin/iked/crypto.c","sbin/iked/crypto.c","_dsa_sign_ecdsa",832,871
31,10,180,3,33,"dsa_sign_final@874-907@sbin/iked/crypto.c","sbin/iked/crypto.c","dsa_sign_final",874,907
42,13,251,4,55,"_dsa_verify_prepare@910-965@sbin/iked/crypto.c","sbin/iked/crypto.c","_dsa_verify_prepare",910,965
23,7,168,3,24,"dsa_verify_final@968-992@sbin/iked/crypto.c","sbin/iked/crypto.c","dsa_verify_final",968,992
4,1,8,1,4,"group_init@253-257@sbin/iked/dh.c","sbin/iked/dh.c","group_init",253,257
12,4,71,1,11,"group_free@260-271@sbin/iked/dh.c","sbin/iked/dh.c","group_free",260,271
41,8,214,1,46,"group_get@274-320@sbin/iked/dh.c","sbin/iked/dh.c","group_get",274,320
13,3,79,1,13,"group_getid@323-336@sbin/iked/dh.c","sbin/iked/dh.c","group_getid",323,336
4,1,19,1,3,"dh_init@339-342@sbin/iked/dh.c","sbin/iked/dh.c","dh_init",339,342
4,1,19,1,3,"dh_getlen@345-348@sbin/iked/dh.c","sbin/iked/dh.c","dh_getlen",345,348
7,2,36,1,6,"dh_secretlen@351-357@sbin/iked/dh.c","sbin/iked/dh.c","dh_secretlen",351,357
4,1,25,2,3,"dh_create_exchange@360-363@sbin/iked/dh.c","sbin/iked/dh.c","dh_create_exchange",360,363
4,1,31,3,3,"dh_create_shared@366-369@sbin/iked/dh.c","sbin/iked/dh.c","dh_create_shared",366,369
11,4,80,1,13,"modp_init@372-385@sbin/iked/dh.c","sbin/iked/dh.c","modp_init",372,385
6,2,38,1,5,"modp_getlen@388-393@sbin/iked/dh.c","sbin/iked/dh.c","modp_getlen",388,393
16,4,106,2,20,"modp_create_exchange@396-416@sbin/iked/dh.c","sbin/iked/dh.c","modp_create_exchange",396,416
17,4,123,3,22,"modp_create_shared@419-441@sbin/iked/dh.c","sbin/iked/dh.c","modp_create_shared",419,441
12,4,80,1,11,"ec_init@444-455@sbin/iked/dh.c","sbin/iked/dh.c","ec_init",444,455
6,2,42,1,6,"ec_getlen@458-464@sbin/iked/dh.c","sbin/iked/dh.c","ec_getlen",458,464
4,1,19,1,3,"ec_secretlen@475-478@sbin/iked/dh.c","sbin/iked/dh.c","ec_secretlen",475,478
8,1,51,2,9,"ec_create_exchange@481-490@sbin/iked/dh.c","sbin/iked/dh.c","ec_create_exchange",481,490
36,13,253,3,45,"ec_create_shared@493-538@sbin/iked/dh.c","sbin/iked/dh.c","ec_create_shared",493,538
61,16,364,5,69,"ec_point2raw@541-610@sbin/iked/dh.c","sbin/iked/dh.c","ec_point2raw",541,610
48,16,315,3,55,"ec_raw2point@613-668@sbin/iked/dh.c","sbin/iked/dh.c","ec_raw2point",613,668
12,2,84,1,15,"ec25519_init@671-686@sbin/iked/dh.c","sbin/iked/dh.c","ec25519_init",671,686
6,2,27,1,5,"ec25519_getlen@689-694@sbin/iked/dh.c","sbin/iked/dh.c","ec25519_getlen",689,694
6,1,41,2,6,"ec25519_create_exchange@697-703@sbin/iked/dh.c","sbin/iked/dh.c","ec25519_create_exchange",697,703
6,1,42,3,6,"ec25519_create_shared@706-712@sbin/iked/dh.c","sbin/iked/dh.c","ec25519_create_shared",706,712
11,2,79,1,12,"eap_identity_request@52-64@sbin/iked/eap.c","sbin/iked/eap.c","eap_identity_request",52,64
15,3,100,1,16,"eap_identity_response@67-83@sbin/iked/eap.c","sbin/iked/eap.c","eap_identity_response",67,83
45,7,349,3,53,"eap_challenge_request@86-139@sbin/iked/eap.c","sbin/iked/eap.c","eap_challenge_request",86,139
18,3,131,3,22,"eap_success@142-164@sbin/iked/eap.c","sbin/iked/eap.c","eap_success",142,164
138,28,1038,3,159,"eap_mschap@167-326@sbin/iked/eap.c","sbin/iked/eap.c","eap_mschap",167,326
158,25,966,4,164,"eap_parse@329-493@sbin/iked/eap.c","sbin/iked/eap.c","eap_parse",329,493
7,1,26,1,7,"usage@54-61@sbin/iked/iked.c","sbin/iked/iked.c","usage",54,61
99,22,628,2,126,"main@64-190@sbin/iked/iked.c","sbin/iked/iked.c","main",64,190
38,11,319,1,66,"parent_configure@193-259@sbin/iked/iked.c","sbin/iked/iked.c","parent_configure",193,259
24,8,175,3,30,"parent_reload@262-292@sbin/iked/iked.c","sbin/iked/iked.c","parent_reload",262,292
59,19,321,3,72,"parent_sig_handler@295-367@sbin/iked/iked.c","sbin/iked/iked.c","parent_sig_handler",295,367
12,2,61,3,13,"parent_dispatch_ca@370-383@sbin/iked/iked.c","sbin/iked/iked.c","parent_dispatch_ca",370,383
33,9,213,3,36,"parent_dispatch_control@386-422@sbin/iked/iked.c","sbin/iked/iked.c","parent_dispatch_control",386,422
7,1,32,1,8,"parent_shutdown@425-433@sbin/iked/iked.c","sbin/iked/iked.c","parent_shutdown",425,433
4,1,35,2,3,"ikev2@158-161@sbin/iked/ikev2.c","sbin/iked/ikev2.c","ikev2",158,161
5,2,35,3,11,"ikev2_run@164-175@sbin/iked/ikev2.c","sbin/iked/ikev2.c","ikev2_run",164,175
41,15,249,3,42,"ikev2_dispatch_parent@178-220@sbin/iked/ikev2.c","sbin/iked/ikev2.c","ikev2_dispatch_parent",178,220
111,26,707,3,137,"ikev2_dispatch_cert@223-360@sbin/iked/ikev2.c","sbin/iked/ikev2.c","ikev2_dispatch_cert",223,360
25,3,213,6,31,"ikev2_getimsgdata@363-394@sbin/iked/ikev2.c","sbin/iked/ikev2.c","ikev2_getimsgdata",363,394
94,35,767,2,132,"ikev2_recv@397-529@sbin/iked/ikev2.c","sbin/iked/ikev2.c","ikev2_recv",397,529
31,17,122,3,34,"ikev2_ike_auth_compatible@532-566@sbin/iked/ikev2.c","sbin/iked/ikev2.c","ikev2_ike_auth_compatible",532,566
115,24,828,3,146,"ikev2_ike_auth_recv@569-715@sbin/iked/ikev2.c","sbin/iked/ikev2.c","ikev2_ike_auth_recv",569,715
30,9,212,2,40,"ikev2_ike_auth@718-758@sbin/iked/ikev2.c","sbin/iked/ikev2.c","ikev2_ike_auth",718,758
88,22,563,3,100,"ikev2_init_recv@761-861@sbin/iked/ikev2.c","sbin/iked/ikev2.c","ikev2_init_recv",761,861
21,4,150,2,24,"ikev2_init_ike_sa@864-888@sbin/iked/ikev2.c","sbin/iked/ikev2.c","ikev2_init_ike_sa",864,888
8,1,56,2,9,"ikev2_init_ike_sa_timeout@891-900@sbin/iked/ikev2.c","sbin/iked/ikev2.c","ikev2_init_ike_sa_timeout",891,900
131,36,1100,4,168,"ikev2_init_ike_sa_peer@903-1071@sbin/iked/ikev2.c","sbin/iked/ikev2.c","ikev2_init_ike_sa_peer",903,1071
21,5,149,2,25,"ikev2_init_auth@1074-1099@sbin/iked/ikev2.c","sbin/iked/ikev2.c","ikev2_init_auth",1074,1099
86,28,698,2,113,"ikev2_init_ike_auth@1102-1215@sbin/iked/ikev2.c","sbin/iked/ikev2.c","ikev2_init_ike_auth",1102,1215
26,7,214,2,29,"ikev2_init_done@1218-1247@sbin/iked/ikev2.c","sbin/iked/ikev2.c","ikev2_init_done",1218,1247
74,21,530,3,86,"ikev2_policy2id@1250-1336@sbin/iked/ikev2.c","sbin/iked/ikev2.c","ikev2_policy2id",1250,1336
21,3,155,6,24,"ikev2_add_header@1339-1363@sbin/iked/ikev2.c","sbin/iked/ikev2.c","ikev2_add_header",1339,1363
10,2,64,2,12,"ikev2_set_header@1366-1378@sbin/iked/ikev2.c","sbin/iked/ikev2.c","ikev2_set_header",1366,1378
11,2,68,1,13,"ikev2_add_payload@1381-1394@sbin/iked/ikev2.c","sbin/iked/ikev2.c","ikev2_add_payload",1381,1394
88,19,717,3,106,"ikev2_add_ts_payload@1397-1503@sbin/iked/ikev2.c","sbin/iked/ikev2.c","ikev2_add_ts_payload",1397,1503
19,9,168,5,24,"ikev2_add_ts@1506-1530@sbin/iked/ikev2.c","sbin/iked/ikev2.c","ikev2_add_ts",1506,1530
23,8,181,5,31,"ikev2_add_certreq@1534-1565@sbin/iked/ikev2.c","sbin/iked/ikev2.c","ikev2_add_certreq",1534,1565
40,7,317,5,49,"ikev2_add_ipcompnotify@1568-1617@sbin/iked/ikev2.c","sbin/iked/ikev2.c","ikev2_add_ipcompnotify",1568,1617
20,5,153,5,21,"ikev2_add_mobike@1620-1641@sbin/iked/ikev2.c","sbin/iked/ikev2.c","ikev2_add_mobike",1620,1641
30,5,215,3,37,"ikev2_add_sighashnotify@1644-1681@sbin/iked/ikev2.c","sbin/iked/ikev2.c","ikev2_add_sighashnotify",1644,1681
14,2,83,3,17,"ikev2_next_payload@1684-1701@sbin/iked/ikev2.c","sbin/iked/ikev2.c","ikev2_next_payload",1684,1701
89,12,606,5,100,"ikev2_nat_detection@1704-1804@sbin/iked/ikev2.c","sbin/iked/ikev2.c","ikev2_nat_detection",1704,1804
37,12,354,5,41,"ikev2_add_nat_detection@1807-1848@sbin/iked/ikev2.c","sbin/iked/ikev2.c","ikev2_add_nat_detection",1807,1848
98,38,671,3,110,"ikev2_add_cp@1851-1961@sbin/iked/ikev2.c","sbin/iked/ikev2.c","ikev2_add_cp",1851,1961
91,24,626,8,112,"ikev2_add_proposals@1964-2076@sbin/iked/ikev2.c","sbin/iked/ikev2.c","ikev2_add_proposals",1964,2076
25,4,189,5,28,"ikev2_add_transform@2079-2107@sbin/iked/ikev2.c","sbin/iked/ikev2.c","ikev2_add_transform",2079,2107
10,2,64,3,11,"ikev2_add_data@2110-2121@sbin/iked/ikev2.c","sbin/iked/ikev2.c","ikev2_add_data",2110,2121
10,2,71,2,11,"ikev2_add_buf@2124-2135@sbin/iked/ikev2.c","sbin/iked/ikev2.c","ikev2_add_buf",2124,2135
62,21,419,3,75,"ikev2_resp_informational@2138-2213@sbin/iked/ikev2.c","sbin/iked/ikev2.c","ikev2_resp_informational",2138,2213
102,30,605,3,110,"ikev2_resp_recv@2216-2326@sbin/iked/ikev2.c","sbin/iked/ikev2.c","ikev2_resp_recv",2216,2326
86,24,682,2,109,"ikev2_resp_ike_sa_init@2329-2438@sbin/iked/ikev2.c","sbin/iked/ikev2.c","ikev2_resp_ike_sa_init",2329,2438
31,5,209,2,35,"ikev2_send_auth_failed@2441-2476@sbin/iked/ikev2.c","sbin/iked/ikev2.c","ikev2_send_auth_failed",2441,2476
64,12,360,3,65,"ikev2_add_error@2479-2544@sbin/iked/ikev2.c","sbin/iked/ikev2.c","ikev2_add_error",2479,2544
18,4,115,4,18,"ikev2_send_error@2547-2565@sbin/iked/ikev2.c","sbin/iked/ikev2.c","ikev2_send_error",2547,2565
41,9,301,2,50,"ikev2_send_init_error@2572-2622@sbin/iked/ikev2.c","sbin/iked/ikev2.c","ikev2_send_init_error",2572,2622
115,39,934,2,147,"ikev2_resp_ike_auth@2625-2772@sbin/iked/ikev2.c","sbin/iked/ikev2.c","ikev2_resp_ike_auth",2625,2772
61,20,476,3,82,"ikev2_resp_ike_eap@2775-2857@sbin/iked/ikev2.c","sbin/iked/ikev2.c","ikev2_resp_ike_eap",2775,2857
23,6,147,6,30,"ikev2_send_ike_e@2860-2890@sbin/iked/ikev2.c","sbin/iked/ikev2.c","ikev2_send_ike_e",2860,2890
23,6,165,3,24,"ikev2_set_sa_proposal@2893-2917@sbin/iked/ikev2.c","sbin/iked/ikev2.c","ikev2_set_sa_proposal",2893,2917
125,33,909,4,163,"ikev2_send_create_child_sa@2920-3083@sbin/iked/ikev2.c","sbin/iked/ikev2.c","ikev2_send_create_child_sa",2920,3083
79,20,579,2,104,"ikev2_ike_sa_rekey@3086-3190@sbin/iked/ikev2.c","sbin/iked/ikev2.c","ikev2_ike_sa_rekey",3086,3190
12,3,88,2,12,"ikev2_nonce_cmp@3193-3205@sbin/iked/ikev2.c","sbin/iked/ikev2.c","ikev2_nonce_cmp",3193,3205
159,34,1128,2,201,"ikev2_init_create_child_sa@3208-3409@sbin/iked/ikev2.c","sbin/iked/ikev2.c","ikev2_init_create_child_sa",3208,3409
107,13,879,3,125,"ikev2_ikesa_enable@3412-3537@sbin/iked/ikev2.c","sbin/iked/ikev2.c","ikev2_ikesa_enable",3412,3537
25,5,174,3,28,"ikev2_ikesa_delete@3540-3568@sbin/iked/ikev2.c","sbin/iked/ikev2.c","ikev2_ikesa_delete",3540,3568
13,3,76,2,18,"ikev2_ikesa_recv_delete@3571-3589@sbin/iked/ikev2.c","sbin/iked/ikev2.c","ikev2_ikesa_recv_delete",3571,3589
201,58,1414,2,261,"ikev2_resp_create_child_sa@3592-3853@sbin/iked/ikev2.c","sbin/iked/ikev2.c","ikev2_resp_create_child_sa",3592,3853
6,1,34,2,6,"ikev2_ike_sa_timeout@3856-3862@sbin/iked/ikev2.c","sbin/iked/ikev2.c","ikev2_ike_sa_timeout",3856,3862
6,1,34,2,6,"ikev2_ike_sa_rekey_timeout@3865-3871@sbin/iked/ikev2.c","sbin/iked/ikev2.c","ikev2_ike_sa_rekey_timeout",3865,3871
5,1,41,2,4,"ikev2_ike_sa_rekey_schedule@3874-3878@sbin/iked/ikev2.c","sbin/iked/ikev2.c","ikev2_ike_sa_rekey_schedule",3874,3878
36,9,226,2,41,"ikev2_ike_sa_alive@3881-3922@sbin/iked/ikev2.c","sbin/iked/ikev2.c","ikev2_ike_sa_alive",3881,3922
17,2,190,2,17,"ikev2_ike_sa_keepalive@3925-3942@sbin/iked/ikev2.c","sbin/iked/ikev2.c","ikev2_ike_sa_keepalive",3925,3942
85,23,638,2,110,"ikev2_send_informational@3945-4055@sbin/iked/ikev2.c","sbin/iked/ikev2.c","ikev2_send_informational",3945,4055
15,3,120,4,18,"ikev2_psk@4058-4076@sbin/iked/ikev2.c","sbin/iked/ikev2.c","ikev2_psk",4058,4076
64,34,467,4,84,"ikev2_match_proposals@4079-4163@sbin/iked/ikev2.c","sbin/iked/ikev2.c","ikev2_match_proposals",4079,4163
69,17,555,4,77,"ikev2_sa_negotiate@4171-4248@sbin/iked/ikev2.c","sbin/iked/ikev2.c","ikev2_sa_negotiate",4171,4248
59,13,394,3,67,"ikev2_sa_initiator_dh@4251-4318@sbin/iked/ikev2.c","sbin/iked/ikev2.c","ikev2_sa_initiator_dh",4251,4318
75,21,538,4,86,"ikev2_sa_initiator@4321-4407@sbin/iked/ikev2.c","sbin/iked/ikev2.c","ikev2_sa_initiator",4321,4407
49,11,336,4,56,"ikev2_sa_responder_dh@4410-4466@sbin/iked/ikev2.c","sbin/iked/ikev2.c","ikev2_sa_responder_dh",4410,4466
69,19,524,4,79,"ikev2_sa_responder@4469-4548@sbin/iked/ikev2.c","sbin/iked/ikev2.c","ikev2_sa_responder",4469,4548
149,33,1236,3,205,"ikev2_sa_keys@4551-4756@sbin/iked/ikev2.c","sbin/iked/ikev2.c","ikev2_sa_keys",4551,4756
9,1,48,1,8,"ikev2_sa_cleanup_dh@4759-4767@sbin/iked/ikev2.c","sbin/iked/ikev2.c","ikev2_sa_cleanup_dh",4759,4767
47,7,380,4,69,"ikev2_prfplus@4770-4839@sbin/iked/ikev2.c","sbin/iked/ikev2.c","ikev2_prfplus",4770,4839
77,21,525,2,88,"ikev2_sa_tag@4842-4930@sbin/iked/ikev2.c","sbin/iked/ikev2.c","ikev2_sa_tag",4842,4930
43,9,281,3,48,"ikev2_childsa_delete_proposed@4933-4981@sbin/iked/ikev2.c","sbin/iked/ikev2.c","ikev2_childsa_delete_proposed",4933,4981
214,37,1488,7,251,"ikev2_childsa_negotiate@4984-5235@sbin/iked/ikev2.c","sbin/iked/ikev2.c","ikev2_childsa_negotiate",4984,5235
15,4,88,2,14,"ikev2_ipcomp_csa_free@5239-5253@sbin/iked/ikev2.c","sbin/iked/ikev2.c","ikev2_ipcomp_csa_free",5239,5253
133,33,1128,2,159,"ikev2_ipcomp_enable@5256-5415@sbin/iked/ikev2.c","sbin/iked/ikev2.c","ikev2_ipcomp_enable",5256,5415
73,17,535,2,89,"ikev2_childsa_enable@5418-5507@sbin/iked/ikev2.c","sbin/iked/ikev2.c","ikev2_childsa_enable",5418,5507
44,21,333,6,53,"ikev2_childsa_delete@5510-5563@sbin/iked/ikev2.c","sbin/iked/ikev2.c","ikev2_childsa_delete",5510,5563
41,18,245,4,45,"ikev2_valid_proposal@5566-5611@sbin/iked/ikev2.c","sbin/iked/ikev2.c","ikev2_valid_proposal",5566,5611
41,8,277,2,49,"ikev2_acquire_sa@5615-5664@sbin/iked/ikev2.c","sbin/iked/ikev2.c","ikev2_acquire_sa",5615,5664
9,1,62,2,10,"ikev2_disable_rekeying@5667-5677@sbin/iked/ikev2.c","sbin/iked/ikev2.c","ikev2_disable_rekeying",5667,5677
33,10,220,2,34,"ikev2_rekey_sa@5681-5715@sbin/iked/ikev2.c","sbin/iked/ikev2.c","ikev2_rekey_sa",5681,5715
61,17,415,2,77,"ikev2_drop_sa@5719-5796@sbin/iked/ikev2.c","sbin/iked/ikev2.c","ikev2_drop_sa",5719,5796
73,19,508,3,87,"ikev2_print_id@5799-5886@sbin/iked/ikev2.c","sbin/iked/ikev2.c","ikev2_print_id",5799,5886
126,35,878,3,142,"ikev2_cp_setaddr@5894-6036@sbin/iked/ikev2.c","sbin/iked/ikev2.c","ikev2_cp_setaddr",5894,6036
25,7,165,3,25,"ikev2_cp_fixaddr@6043-6068@sbin/iked/ikev2.c","sbin/iked/ikev2.c","ikev2_cp_fixaddr",6043,6068
64,13,528,2,75,"ikev2_update_sa_addresses@6071-6146@sbin/iked/ikev2.c","sbin/iked/ikev2.c","ikev2_update_sa_addresses",6071,6146
42,7,344,3,50,"ikev2_msg_cb@51-101@sbin/iked/ikev2_msg.c","sbin/iked/ikev2_msg.c","ikev2_msg_cb",51,101
21,2,129,2,24,"ikev1_recv@104-128@sbin/iked/ikev2_msg.c","sbin/iked/ikev2_msg.c","ikev1_recv",104,128
17,2,132,7,17,"ikev2_msg_init@131-148@sbin/iked/ikev2_msg.c","sbin/iked/ikev2_msg.c","ikev2_msg_init",131,148
21,6,186,2,24,"ikev2_msg_copy@151-175@sbin/iked/ikev2_msg.c","sbin/iked/ikev2_msg.c","ikev2_msg_copy",151,175
24,3,160,2,26,"ikev2_msg_cleanup@178-204@sbin/iked/ikev2_msg.c","sbin/iked/ikev2_msg.c","ikev2_msg_cleanup",178,204
57,18,441,3,90,"ikev2_msg_valid_ike_sa@207-297@sbin/iked/ikev2_msg.c","sbin/iked/ikev2_msg.c","ikev2_msg_valid_ike_sa",207,297
60,14,507,2,68,"ikev2_msg_send@300-368@sbin/iked/ikev2_msg.c","sbin/iked/ikev2_msg.c","ikev2_msg_send",300,368
8,2,44,2,9,"ikev2_msg_id@371-380@sbin/iked/ikev2_msg.c","sbin/iked/ikev2_msg.c","ikev2_msg_id",371,380
62,13,500,3,79,"ikev2_msg_encrypt@383-462@sbin/iked/ikev2_msg.c","sbin/iked/ikev2_msg.c","ikev2_msg_encrypt",383,462
41,7,304,3,55,"ikev2_msg_integr@465-520@sbin/iked/ikev2_msg.c","sbin/iked/ikev2_msg.c","ikev2_msg_integr",465,520
83,13,646,4,106,"ikev2_msg_decrypt@523-629@sbin/iked/ikev2_msg.c","sbin/iked/ikev2_msg.c","ikev2_msg_decrypt",523,629
43,11,360,6,58,"ikev2_msg_send_encrypt@632-690@sbin/iked/ikev2_msg.c","sbin/iked/ikev2_msg.c","ikev2_msg_send_encrypt",632,690
45,16,348,3,57,"ikev2_msg_auth@693-750@sbin/iked/ikev2_msg.c","sbin/iked/ikev2_msg.c","ikev2_msg_auth",693,750
63,12,411,6,70,"ikev2_msg_authverify@753-823@sbin/iked/ikev2_msg.c","sbin/iked/ikev2_msg.c","ikev2_msg_authverify",753,823
75,13,460,4,85,"ikev2_msg_authsign@826-911@sbin/iked/ikev2_msg.c","sbin/iked/ikev2_msg.c","ikev2_msg_authsign",826,911
16,7,112,1,19,"ikev2_msg_frompeer@914-933@sbin/iked/ikev2_msg.c","sbin/iked/ikev2_msg.c","ikev2_msg_frompeer",914,933
11,5,69,3,11,"ikev2_msg_getsocket@936-947@sbin/iked/ikev2_msg.c","sbin/iked/ikev2_msg.c","ikev2_msg_getsocket",936,947
9,2,58,3,9,"ikev2_msg_prevail@950-959@sbin/iked/ikev2_msg.c","sbin/iked/ikev2_msg.c","ikev2_msg_prevail",950,959
8,1,50,3,7,"ikev2_msg_dispose@962-969@sbin/iked/ikev2_msg.c","sbin/iked/ikev2_msg.c","ikev2_msg_dispose",962,969
6,2,43,2,6,"ikev2_msg_flushqueue@972-978@sbin/iked/ikev2_msg.c","sbin/iked/ikev2_msg.c","ikev2_msg_flushqueue",972,978
11,3,66,4,12,"ikev2_msg_lookup@981-993@sbin/iked/ikev2_msg.c","sbin/iked/ikev2_msg.c","ikev2_msg_lookup",981,993
13,2,107,3,13,"ikev2_msg_retransmit_response@996-1009@sbin/iked/ikev2_msg.c","sbin/iked/ikev2_msg.c","ikev2_msg_retransmit_response",996,1009
6,1,41,2,6,"ikev2_msg_response_timeout@1012-1018@sbin/iked/ikev2_msg.c","sbin/iked/ikev2_msg.c","ikev2_msg_response_timeout",1012,1018
22,3,158,2,23,"ikev2_msg_retransmit_timeout@1021-1044@sbin/iked/ikev2_msg.c","sbin/iked/ikev2_msg.c","ikev2_msg_retransmit_timeout",1021,1044
23,2,161,4,25,"ikev2_pld_parse@108-133@sbin/iked/ikev2_pld.c","sbin/iked/ikev2_pld.c","ikev2_pld_parse",108,133
25,4,157,4,37,"ikev2_validate_pld@136-173@sbin/iked/ikev2_pld.c","sbin/iked/ikev2_pld.c","ikev2_validate_pld",136,173
90,29,590,5,103,"ikev2_pld_payloads@176-279@sbin/iked/ikev2_pld.c","sbin/iked/ikev2_pld.c","ikev2_pld_payloads",176,279
36,8,218,4,45,"ikev2_validate_sa@282-327@sbin/iked/ikev2_pld.c","sbin/iked/ikev2_pld.c","ikev2_validate_sa",282,327
80,13,524,5,102,"ikev2_pld_sa@334-436@sbin/iked/ikev2_pld.c","sbin/iked/ikev2_pld.c","ikev2_pld_sa",334,436
24,4,157,4,26,"ikev2_validate_xform@439-465@sbin/iked/ikev2_pld.c","sbin/iked/ikev2_pld.c","ikev2_validate_xform",439,465
65,13,435,5,77,"ikev2_pld_xform@468-545@sbin/iked/ikev2_pld.c","sbin/iked/ikev2_pld.c","ikev2_pld_xform",468,545
12,2,85,4,13,"ikev2_validate_attr@548-561@sbin/iked/ikev2_pld.c","sbin/iked/ikev2_pld.c","ikev2_validate_attr",548,561
43,7,275,5,52,"ikev2_pld_attr@564-616@sbin/iked/ikev2_pld.c","sbin/iked/ikev2_pld.c","ikev2_pld_attr",564,616
12,2,85,4,13,"ikev2_validate_ke@619-632@sbin/iked/ikev2_pld.c","sbin/iked/ikev2_pld.c","ikev2_validate_ke",619,632
29,5,213,5,35,"ikev2_pld_ke@635-670@sbin/iked/ikev2_pld.c","sbin/iked/ikev2_pld.c","ikev2_pld_ke",635,670
12,2,85,4,13,"ikev2_validate_id@673-686@sbin/iked/ikev2_pld.c","sbin/iked/ikev2_pld.c","ikev2_validate_id",673,686
43,10,323,6,54,"ikev2_pld_id@689-743@sbin/iked/ikev2_pld.c","sbin/iked/ikev2_pld.c","ikev2_pld_id",689,743
12,2,85,4,13,"ikev2_validate_cert@746-759@sbin/iked/ikev2_pld.c","sbin/iked/ikev2_pld.c","ikev2_validate_cert",746,759
31,5,215,5,38,"ikev2_pld_cert@762-800@sbin/iked/ikev2_pld.c","sbin/iked/ikev2_pld.c","ikev2_pld_cert",762,800
12,2,85,4,13,"ikev2_validate_certreq@803-816@sbin/iked/ikev2_pld.c","sbin/iked/ikev2_pld.c","ikev2_validate_certreq",803,816
36,8,247,5,46,"ikev2_pld_certreq@819-865@sbin/iked/ikev2_pld.c","sbin/iked/ikev2_pld.c","ikev2_pld_certreq",819,865
12,2,85,4,13,"ikev2_validate_auth@868-881@sbin/iked/ikev2_pld.c","sbin/iked/ikev2_pld.c","ikev2_validate_auth",868,881
33,6,241,5,42,"ikev2_pld_auth@884-926@sbin/iked/ikev2_pld.c","sbin/iked/ikev2_pld.c","ikev2_pld_auth",884,926
23,4,146,5,27,"ikev2_pld_nonce@929-956@sbin/iked/ikev2_pld.c","sbin/iked/ikev2_pld.c","ikev2_pld_nonce",929,956
12,2,85,4,13,"ikev2_validate_notify@959-972@sbin/iked/ikev2_pld.c","sbin/iked/ikev2_pld.c","ikev2_validate_notify",959,972
286,63,1664,5,314,"ikev2_pld_notify@975-1289@sbin/iked/ikev2_pld.c","sbin/iked/ikev2_pld.c","ikev2_pld_notify",975,1289
12,2,85,4,13,"ikev2_validate_delete@1292-1305@sbin/iked/ikev2_pld.c","sbin/iked/ikev2_pld.c","ikev2_validate_delete",1292,1305
131,31,859,5,167,"ikev2_pld_delete@1308-1475@sbin/iked/ikev2_pld.c","sbin/iked/ikev2_pld.c","ikev2_pld_delete",1308,1475
12,2,85,4,13,"ikev2_validate_ts@1478-1491@sbin/iked/ikev2_pld.c","sbin/iked/ikev2_pld.c","ikev2_validate_ts",1478,1491
62,5,511,6,69,"ikev2_pld_ts@1494-1563@sbin/iked/ikev2_pld.c","sbin/iked/ikev2_pld.c","ikev2_pld_ts",1494,1563
35,6,268,5,45,"ikev2_pld_e@1566-1611@sbin/iked/ikev2_pld.c","sbin/iked/ikev2_pld.c","ikev2_pld_e",1566,1611
12,2,85,4,13,"ikev2_validate_cp@1614-1627@sbin/iked/ikev2_pld.c","sbin/iked/ikev2_pld.c","ikev2_validate_cp",1614,1627
31,5,236,5,39,"ikev2_pld_cp@1630-1669@sbin/iked/ikev2_pld.c","sbin/iked/ikev2_pld.c","ikev2_pld_cp",1630,1669
12,2,85,4,13,"ikev2_validate_eap@1672-1685@sbin/iked/ikev2_pld.c","sbin/iked/ikev2_pld.c","ikev2_validate_eap",1672,1685
28,5,218,5,33,"ikev2_pld_eap@1688-1721@sbin/iked/ikev2_pld.c","sbin/iked/ikev2_pld.c","ikev2_pld_eap",1688,1721
4,1,31,2,3,"ibuf_cat@40-43@sbin/iked/imsg_util.c","sbin/iked/imsg_util.c","ibuf_cat",40,43
4,1,20,1,3,"ibuf_zero@46-49@sbin/iked/imsg_util.c","sbin/iked/imsg_util.c","ibuf_zero",46,49
20,6,108,2,23,"ibuf_new@52-75@sbin/iked/imsg_util.c","sbin/iked/imsg_util.c","ibuf_new",52,75
8,2,39,1,10,"ibuf_static@78-88@sbin/iked/imsg_util.c","sbin/iked/imsg_util.c","ibuf_static",78,88
7,2,45,2,8,"ibuf_advance@91-99@sbin/iked/imsg_util.c","sbin/iked/imsg_util.c","ibuf_advance",91,99
10,3,44,1,9,"ibuf_release@102-111@sbin/iked/imsg_util.c","sbin/iked/imsg_util.c","ibuf_release",102,111
6,3,34,1,5,"ibuf_length@114-119@sbin/iked/imsg_util.c","sbin/iked/imsg_util.c","ibuf_length",114,119
4,1,21,1,3,"ibuf_data@122-125@sbin/iked/imsg_util.c","sbin/iked/imsg_util.c","ibuf_data",122,125
8,2,51,2,9,"ibuf_getdata@128-137@sbin/iked/imsg_util.c","sbin/iked/imsg_util.c","ibuf_getdata",128,137
7,2,46,2,8,"ibuf_get@140-148@sbin/iked/imsg_util.c","sbin/iked/imsg_util.c","ibuf_get",140,148
6,2,36,1,5,"ibuf_dup@151-156@sbin/iked/imsg_util.c","sbin/iked/imsg_util.c","ibuf_dup",151,156
13,3,73,1,13,"ibuf_random@159-172@sbin/iked/imsg_util.c","sbin/iked/imsg_util.c","ibuf_random",159,172
7,2,37,2,6,"ibuf_setsize@175-181@sbin/iked/imsg_util.c","sbin/iked/imsg_util.c","ibuf_setsize",175,181
14,3,97,3,16,"ibuf_prepend@184-200@sbin/iked/imsg_util.c","sbin/iked/imsg_util.c","ibuf_prepend",184,200
10,2,48,2,12,"log_init@53-65@sbin/iked/log.c","sbin/iked/log.c","log_init",53,65
5,2,19,1,4,"log_procinit@68-72@sbin/iked/log.c","sbin/iked/log.c","log_procinit",68,72
4,1,11,1,3,"log_setverbose@75-78@sbin/iked/log.c","sbin/iked/log.c","log_setverbose",75,78
4,1,11,1,3,"log_getverbose@81-84@sbin/iked/log.c","sbin/iked/log.c","log_getverbose",81,84
7,1,38,3,7,"logit@87-94@sbin/iked/log.c","sbin/iked/log.c","logit",87,94
17,3,99,3,19,"vlog@97-116@sbin/iked/log.c","sbin/iked/log.c","vlog",97,116
21,3,120,2,25,"log_warn@119-144@sbin/iked/log.c","sbin/iked/log.c","log_warn",119,144
7,1,35,2,7,"log_warnx@147-154@sbin/iked/log.c","sbin/iked/log.c","log_warnx",147,154
7,1,35,2,7,"log_info@157-164@sbin/iked/log.c","sbin/iked/log.c","log_info",157,164
9,2,43,2,9,"log_debug@167-176@sbin/iked/log.c","sbin/iked/log.c","log_debug",167,176
17,3,106,3,17,"vfatalc@179-196@sbin/iked/log.c","sbin/iked/log.c","vfatalc",179,196
8,1,40,2,8,"fatal@199-207@sbin/iked/log.c","sbin/iked/log.c","fatal",199,207
8,1,40,2,8,"fatalx@210-218@sbin/iked/log.c","sbin/iked/log.c","fatalx",210,218
71,14,473,1,77,"ocsp_connect@74-151@sbin/iked/ocsp.c","sbin/iked/ocsp.c","ocsp_connect",74,151
18,4,118,3,20,"ocsp_connect_cb@155-175@sbin/iked/ocsp.c","sbin/iked/ocsp.c","ocsp_connect_cb",155,175
21,5,156,3,22,"ocsp_connect_finish@179-201@sbin/iked/ocsp.c","sbin/iked/ocsp.c","ocsp_connect_finish",179,201
47,15,379,6,54,"ocsp_validate_cert@208-262@sbin/iked/ocsp.c","sbin/iked/ocsp.c","ocsp_validate_cert",208,262
18,7,109,1,20,"ocsp_free@266-286@sbin/iked/ocsp.c","sbin/iked/ocsp.c","ocsp_free",266,286
38,7,299,2,46,"ocsp_receive_fd@290-336@sbin/iked/ocsp.c","sbin/iked/ocsp.c","ocsp_receive_fd",290,336
39,11,233,1,40,"ocsp_load_certs@340-380@sbin/iked/ocsp.c","sbin/iked/ocsp.c","ocsp_load_certs",340,380
19,8,159,3,23,"ocsp_callback@384-407@sbin/iked/ocsp.c","sbin/iked/ocsp.c","ocsp_callback",384,407
67,15,379,2,77,"ocsp_parse_response@411-488@sbin/iked/ocsp.c","sbin/iked/ocsp.c","ocsp_parse_response",411,488
14,2,125,2,16,"ocsp_validate_finish@495-511@sbin/iked/ocsp.c","sbin/iked/ocsp.c","ocsp_validate_finish",495,511
30,11,216,3,38,"pfkey_couple@122-160@sbin/iked/pfkey.c","sbin/iked/pfkey.c","pfkey_couple",122,160
10,3,72,3,10,"pfkey_map@163-173@sbin/iked/pfkey.c","sbin/iked/pfkey.c","pfkey_map",163,173
208,27,1660,4,258,"pfkey_flow@176-434@sbin/iked/pfkey.c","sbin/iked/pfkey.c","pfkey_flow",176,434
282,48,2136,4,344,"pfkey_sa@437-781@sbin/iked/pfkey.c","sbin/iked/pfkey.c","pfkey_sa",437,781
88,7,715,3,108,"pfkey_sa_last_used@784-892@sbin/iked/pfkey.c","sbin/iked/pfkey.c","pfkey_sa_last_used",784,892
85,7,697,4,104,"pfkey_sa_getspi@895-999@sbin/iked/pfkey.c","sbin/iked/pfkey.c","pfkey_sa_getspi",895,999
89,4,747,5,110,"pfkey_sagroup@1002-1112@sbin/iked/pfkey.c","sbin/iked/pfkey.c","pfkey_sagroup",1002,1112
25,7,153,6,29,"pfkey_write@1115-1144@sbin/iked/pfkey.c","sbin/iked/pfkey.c","pfkey_write",1115,1144
72,18,446,3,92,"pfkey_reply@1147-1239@sbin/iked/pfkey.c","sbin/iked/pfkey.c","pfkey_reply",1147,1239
17,6,115,2,22,"pfkey_flow_add@1242-1264@sbin/iked/pfkey.c","sbin/iked/pfkey.c","pfkey_flow_add",1242,1264
17,6,116,2,22,"pfkey_flow_delete@1267-1289@sbin/iked/pfkey.c","sbin/iked/pfkey.c","pfkey_flow_delete",1267,1289
18,3,161,3,27,"pfkey_block@1292-1319@sbin/iked/pfkey.c","sbin/iked/pfkey.c","pfkey_block",1292,1319
10,3,79,3,13,"pfkey_sa_init@1322-1335@sbin/iked/pfkey.c","sbin/iked/pfkey.c","pfkey_sa_init",1322,1335
36,14,247,3,42,"pfkey_sa_add@1338-1380@sbin/iked/pfkey.c","sbin/iked/pfkey.c","pfkey_sa_add",1338,1380
14,5,128,2,15,"pfkey_sa_update_addresses@1383-1398@sbin/iked/pfkey.c","sbin/iked/pfkey.c","pfkey_sa_update_addresses",1383,1398
12,5,91,2,15,"pfkey_sa_delete@1401-1416@sbin/iked/pfkey.c","sbin/iked/pfkey.c","pfkey_sa_delete",1401,1416
18,1,124,1,21,"pfkey_flush@1419-1440@sbin/iked/pfkey.c","sbin/iked/pfkey.c","pfkey_flush",1419,1440
36,11,209,2,42,"pfkey_id2ident@1443-1485@sbin/iked/pfkey.c","sbin/iked/pfkey.c","pfkey_id2ident",1443,1485
10,3,53,1,13,"pfkey_socket@1488-1501@sbin/iked/pfkey.c","sbin/iked/pfkey.c","pfkey_socket",1488,1501
39,5,298,2,52,"pfkey_init@1504-1556@sbin/iked/pfkey.c","sbin/iked/pfkey.c","pfkey_init",1504,1556
12,4,91,3,13,"pfkey_find_ext@1559-1572@sbin/iked/pfkey.c","sbin/iked/pfkey.c","pfkey_find_ext",1559,1572
41,7,271,3,48,"pfkey_dispatch@1575-1623@sbin/iked/pfkey.c","sbin/iked/pfkey.c","pfkey_dispatch",1575,1623
24,5,157,3,25,"pfkey_timer_cb@1626-1651@sbin/iked/pfkey.c","sbin/iked/pfkey.c","pfkey_timer_cb",1626,1651
217,36,1491,2,239,"pfkey_process@1658-1897@sbin/iked/pfkey.c","sbin/iked/pfkey.c","pfkey_process",1658,1897
9,1,57,1,8,"policy_init@47-55@sbin/iked/policy.c","sbin/iked/policy.c","policy_init",47,55
29,7,269,2,39,"policy_lookup@58-97@sbin/iked/policy.c","sbin/iked/policy.c","policy_lookup",58,97
49,16,375,2,61,"policy_test@100-161@sbin/iked/policy.c","sbin/iked/policy.c","policy_test",100,161
28,13,203,1,29,"policy_calc_skip_steps@173-202@sbin/iked/policy.c","sbin/iked/policy.c","policy_calc_skip_steps",173,202
5,1,25,2,4,"policy_ref@205-209@sbin/iked/policy.c","sbin/iked/policy.c","policy_ref",205,209
16,5,100,2,16,"policy_unref@212-228@sbin/iked/policy.c","sbin/iked/policy.c","policy_unref",212,228
31,7,192,3,33,"sa_state@231-264@sbin/iked/policy.c","sbin/iked/policy.c","sa_state",231,264
13,2,81,2,15,"sa_stateflags@267-282@sbin/iked/policy.c","sbin/iked/policy.c","sa_stateflags",267,282
21,7,117,2,24,"sa_stateok@285-309@sbin/iked/policy.c","sbin/iked/policy.c","sa_stateok",285,309
65,25,455,5,73,"sa_new@312-385@sbin/iked/policy.c","sbin/iked/policy.c","sa_new",312,385
16,3,124,2,17,"sa_free@388-405@sbin/iked/policy.c","sbin/iked/policy.c","sa_free",388,405
33,9,211,2,35,"flow_replace@409-444@sbin/iked/policy.c","sbin/iked/policy.c","flow_replace",409,444
15,5,119,2,17,"sa_free_flows@447-464@sbin/iked/policy.c","sbin/iked/policy.c","sa_free_flows",447,464
13,2,113,3,12,"sa_address@468-480@sbin/iked/policy.c","sbin/iked/policy.c","sa_address",468,480
16,4,87,1,17,"childsa_free@483-500@sbin/iked/policy.c","sbin/iked/policy.c","childsa_free",483,500
12,6,79,3,13,"childsa_lookup@503-516@sbin/iked/policy.c","sbin/iked/policy.c","childsa_lookup",503,516
4,1,14,1,3,"flow_free@519-522@sbin/iked/policy.c","sbin/iked/policy.c","flow_free",519,522
15,5,113,4,20,"sa_lookup@525-545@sbin/iked/policy.c","sbin/iked/policy.c","sa_lookup",525,545
19,12,175,2,25,"sa_cmp@548-573@sbin/iked/policy.c","sbin/iked/policy.c","sa_cmp",548,573
5,1,47,2,4,"sa_addrpool_cmp@576-580@sbin/iked/policy.c","sbin/iked/policy.c","sa_addrpool_cmp",576,580
5,1,47,2,4,"sa_addrpool6_cmp@583-587@sbin/iked/policy.c","sbin/iked/policy.c","sa_addrpool6_cmp",583,587
8,2,64,2,9,"user_lookup@590-599@sbin/iked/policy.c","sbin/iked/policy.c","user_lookup",590,599
4,1,28,2,3,"user_cmp@602-605@sbin/iked/policy.c","sbin/iked/policy.c","user_cmp",602,605
8,3,58,2,7,"childsa_cmp@608-615@sbin/iked/policy.c","sbin/iked/policy.c","childsa_cmp",608,615
11,4,92,3,12,"addr_cmp@618-630@sbin/iked/policy.c","sbin/iked/policy.c","addr_cmp",618,630
15,6,131,2,16,"flow_cmp@633-649@sbin/iked/policy.c","sbin/iked/policy.c","flow_cmp",633,649
4,1,26,2,3,"flow_equal@652-655@sbin/iked/policy.c","sbin/iked/policy.c","flow_equal",652,655
9,3,55,3,9,"proc_ispeer@47-56@sbin/iked/proc.c","sbin/iked/proc.c","proc_ispeer",47,56
34,10,349,3,62,"proc_init@59-121@sbin/iked/proc.c","sbin/iked/proc.c","proc_init",59,121
16,7,102,1,19,"proc_kill@124-143@sbin/iked/proc.c","sbin/iked/proc.c","proc_kill",124,143
32,8,274,4,41,"proc_open@146-187@sbin/iked/proc.c","sbin/iked/proc.c","proc_open",146,187
50,14,509,3,68,"proc_listen@190-258@sbin/iked/proc.c","sbin/iked/proc.c","proc_listen",190,258
21,6,171,1,26,"proc_close@261-287@sbin/iked/proc.c","sbin/iked/proc.c","proc_close",261,287
11,4,76,1,15,"proc_shutdown@290-305@sbin/iked/proc.c","sbin/iked/proc.c","proc_shutdown",290,305
17,7,61,3,19,"proc_sig_handler@308-327@sbin/iked/proc.c","sbin/iked/proc.c","proc_sig_handler",308,327
80,22,643,6,107,"proc_run@330-437@sbin/iked/proc.c","sbin/iked/proc.c","proc_run",330,437
55,14,356,3,71,"proc_dispatch@440-511@sbin/iked/proc.c","sbin/iked/proc.c","proc_dispatch",440,511
4,1,23,3,3,"proc_dispatch_null@514-517@sbin/iked/proc.c","sbin/iked/proc.c","proc_dispatch_null",514,517
13,3,95,1,14,"imsg_event_add@524-538@sbin/iked/proc.c","sbin/iked/proc.c","imsg_event_add",524,538
10,2,75,7,10,"imsg_compose_event@541-551@sbin/iked/proc.c","sbin/iked/proc.c","imsg_compose_event",541,551
10,2,77,7,10,"imsg_composev_event@554-564@sbin/iked/proc.c","sbin/iked/proc.c","imsg_composev_event",554,564
9,2,57,4,10,"proc_range@567-577@sbin/iked/proc.c","sbin/iked/proc.c","proc_range",567,577
12,3,102,8,13,"proc_compose_imsg@580-593@sbin/iked/proc.c","sbin/iked/proc.c","proc_compose_imsg",580,593
5,1,48,5,4,"proc_compose@596-600@sbin/iked/proc.c","sbin/iked/proc.c","proc_compose",596,600
11,3,102,8,12,"proc_composev_imsg@603-615@sbin/iked/proc.c","sbin/iked/proc.c","proc_composev_imsg",603,615
5,1,50,5,4,"proc_composev@618-622@sbin/iked/proc.c","sbin/iked/proc.c","proc_composev",618,622
6,1,58,4,5,"proc_forward_imsg@625-630@sbin/iked/proc.c","sbin/iked/proc.c","proc_forward_imsg",625,630
6,1,48,3,6,"proc_ibuf@633-639@sbin/iked/proc.c","sbin/iked/proc.c","proc_ibuf",633,639
6,1,46,3,6,"proc_iev@642-648@sbin/iked/proc.c","sbin/iked/proc.c","proc_iev",642,648
8,2,99,3,7,"add@11-18@sbin/iked/smult_curve25519_ref.c","sbin/iked/smult_curve25519_ref.c","add",11,18
13,2,101,3,12,"sub@20-32@sbin/iked/smult_curve25519_ref.c","sbin/iked/smult_curve25519_ref.c","sub",20,32
11,3,136,1,10,"squeeze@34-44@sbin/iked/smult_curve25519_ref.c","sbin/iked/smult_curve25519_ref.c","squeeze",34,44
10,3,107,1,10,"freeze@50-60@sbin/iked/smult_curve25519_ref.c","sbin/iked/smult_curve25519_ref.c","freeze",50,60
13,4,130,3,13,"mult@62-75@sbin/iked/smult_curve25519_ref.c","sbin/iked/smult_curve25519_ref.c","mult",62,75
11,3,148,2,11,"mult121665@77-88@sbin/iked/smult_curve25519_ref.c","sbin/iked/smult_curve25519_ref.c","mult121665",77,88
18,5,182,2,18,"square@90-108@sbin/iked/smult_curve25519_ref.c","sbin/iked/smult_curve25519_ref.c","square",90,108
12,2,111,5,12,"select@110-122@sbin/iked/smult_curve25519_ref.c","sbin/iked/smult_curve25519_ref.c","select",110,122
51,6,486,2,54,"mainloop@124-178@sbin/iked/smult_curve25519_ref.c","sbin/iked/smult_curve25519_ref.c","mainloop",124,178
57,7,553,2,65,"recip@180-245@sbin/iked/smult_curve25519_ref.c","sbin/iked/smult_curve25519_ref.c","recip",180,245
19,4,172,3,18,"crypto_scalarmult_curve25519@247-265@sbin/iked/smult_curve25519_ref.c","sbin/iked/smult_curve25519_ref.c","crypto_scalarmult_curve25519",247,265
11,3,90,4,11,"timer_set@37-48@sbin/iked/timer.c","sbin/iked/timer.c","timer_set",37,48
5,1,36,3,5,"timer_add@51-56@sbin/iked/timer.c","sbin/iked/timer.c","timer_add",51,56
6,4,42,2,5,"timer_del@59-64@sbin/iked/timer.c","sbin/iked/timer.c","timer_del",59,64
6,2,40,3,6,"timer_callback@67-73@sbin/iked/timer.c","sbin/iked/timer.c","timer_callback",67,73
20,3,111,2,20,"socket_af@39-59@sbin/iked/util.c","sbin/iked/util.c","socket_af",39,59
12,3,69,1,13,"socket_getport@62-75@sbin/iked/util.c","sbin/iked/util.c","socket_getport",62,75
14,3,75,2,13,"socket_setport@78-91@sbin/iked/util.c","sbin/iked/util.c","socket_setport",78,91
5,1,33,2,5,"socket_getaddr@94-99@sbin/iked/util.c","sbin/iked/util.c","socket_getaddr",94,99
47,10,274,2,55,"socket_bypass@102-157@sbin/iked/util.c","sbin/iked/util.c","socket_bypass",102,157
53,10,316,2,60,"udp_bind@160-220@sbin/iked/util.c","sbin/iked/util.c","udp_bind",160,220
53,20,578,3,60,"sockaddr_cmp@223-283@sbin/iked/util.c","sbin/iked/util.c","sockaddr_cmp",223,283
46,3,337,8,49,"sendtofrom@286-335@sbin/iked/util.c","sbin/iked/util.c","sendtofrom",286,335
61,11,432,8,67,"recvfromto@338-405@sbin/iked/util.c","sbin/iked/util.c","recvfromto",338,405
24,5,128,2,27,"print_spi@408-435@sbin/iked/util.c","sbin/iked/util.c","print_spi",408,435
19,5,160,2,22,"print_map@438-460@sbin/iked/util.c","sbin/iked/util.c","print_map",438,460
5,2,32,1,4,"lc_string@463-467@sbin/iked/util.c","sbin/iked/util.c","lc_string",463,467
16,7,98,3,17,"print_hex@470-487@sbin/iked/util.c","sbin/iked/util.c","print_hex",470,487
10,4,66,3,11,"print_hexval@490-501@sbin/iked/util.c","sbin/iked/util.c","print_hexval",490,501
31,10,231,2,35,"print_bits@504-539@sbin/iked/util.c","sbin/iked/util.c","print_bits",504,539
9,2,55,1,9,"mask2prefixlen@542-551@sbin/iked/util.c","sbin/iked/util.c","mask2prefixlen",542,551
40,11,187,1,46,"mask2prefixlen6@554-600@sbin/iked/util.c","sbin/iked/util.c","mask2prefixlen6",554,600
8,3,43,1,9,"prefixlen2mask@603-612@sbin/iked/util.c","sbin/iked/util.c","prefixlen2mask",603,612
15,4,107,2,18,"prefixlen2mask6@615-633@sbin/iked/util.c","sbin/iked/util.c","prefixlen2mask6",615,633
27,6,188,3,31,"print_host@636-667@sbin/iked/util.c","sbin/iked/util.c","print_host",636,667
8,3,48,2,9,"get_string@670-679@sbin/iked/util.c","sbin/iked/util.c","get_string",670,679
13,3,98,1,16,"print_proto@682-698@sbin/iked/util.c","sbin/iked/util.c","print_proto",682,698
29,6,195,4,30,"expand_string@701-731@sbin/iked/util.c","sbin/iked/util.c","expand_string",701,731
12,3,94,2,15,"string2unicode@734-749@sbin/iked/util.c","sbin/iked/util.c","string2unicode",734,749
9,2,45,2,9,"print_debug@752-761@sbin/iked/util.c","sbin/iked/util.c","print_debug",752,761
9,2,43,2,9,"print_verbose@764-773@sbin/iked/util.c","sbin/iked/util.c","print_verbose",764,773
59,11,425,2,99,"main@200-299@sbin/init/init.c","sbin/init/init.c","main",200,299
17,3,100,2,20,"handle@305-325@sbin/init/init.c","sbin/init/init.c","handle",305,325
9,2,48,2,9,"delset@331-340@sbin/init/init.c","sbin/init/init.c","delset",331,340
9,1,43,2,9,"stall@348-357@sbin/init/init.c","sbin/init/init.c","stall",348,357
8,1,38,2,8,"warning@365-373@sbin/init/init.c","sbin/init/init.c","warning",365,373
8,1,43,2,8,"emergency@380-388@sbin/init/init.c","sbin/init/init.c","emergency",380,388
7,2,27,1,7,"badsys@397-404@sbin/init/init.c","sbin/init/init.c","badsys",397,404
6,1,27,1,6,"disaster@410-416@sbin/init/init.c","sbin/init/init.c","disaster",410,416
15,3,87,1,18,"getsecuritylevel@422-440@sbin/init/init.c","sbin/init/init.c","getsecuritylevel",422,440
17,5,92,1,21,"setsecuritylevel@446-467@sbin/init/init.c","sbin/init/init.c","setsecuritylevel",446,467
5,2,24,1,4,"transition@474-478@sbin/init/init.c","sbin/init/init.c","transition",474,478
6,2,39,1,6,"clear_session_logs@485-491@sbin/init/init.c","sbin/init/init.c","clear_session_logs",485,491
14,3,78,1,14,"setctty@498-512@sbin/init/init.c","sbin/init/init.c","setctty",498,512
111,33,685,1,167,"f_single_user@518-685@sbin/init/init.c","sbin/init/init.c","f_single_user",518,685
67,17,401,1,84,"f_runcom@691-775@sbin/init/init.c","sbin/init/init.c","f_runcom",691,775
8,3,48,2,7,"cmp_sessions@781-788@sbin/init/init.c","sbin/init/init.c","cmp_sessions",781,788
5,2,36,1,4,"add_session@794-798@sbin/init/init.c","sbin/init/init.c","add_session",794,798
4,1,18,1,3,"del_session@804-807@sbin/init/init.c","sbin/init/init.c","del_session",804,807
6,1,31,1,6,"find_session@813-819@sbin/init/init.c","sbin/init/init.c","find_session",813,819
15,4,114,1,16,"construct_argv@825-841@sbin/init/init.c","sbin/init/init.c","construct_argv",825,841
13,3,64,1,12,"free_session@847-859@sbin/init/init.c","sbin/init/init.c","free_session",847,859
28,8,181,3,34,"new_session@865-899@sbin/init/init.c","sbin/init/init.c","new_session",865,899
33,7,212,2,32,"setupargv@905-937@sbin/init/init.c","sbin/init/init.c","setupargv",905,937
18,5,100,1,29,"f_read_ttys@943-972@sbin/init/init.c","sbin/init/init.c","f_read_ttys",943,972
21,4,115,1,27,"start_window_system@978-1005@sbin/init/init.c","sbin/init/init.c","start_window_system",978,1005
65,17,406,1,78,"start_getty@1014-1092@sbin/init/init.c","sbin/init/init.c","start_getty",1014,1092
29,7,176,1,35,"collect_child@1099-1134@sbin/init/init.c","sbin/init/init.c","collect_child",1099,1134
26,7,75,1,26,"transition_handler@1140-1166@sbin/init/init.c","sbin/init/init.c","transition_handler",1140,1166
25,8,136,1,36,"f_multi_user@1172-1208@sbin/init/init.c","sbin/init/init.c","f_multi_user",1172,1208
47,12,295,1,54,"f_clean_ttys@1214-1268@sbin/init/init.c","sbin/init/init.c","f_clean_ttys",1214,1268
7,2,33,1,8,"f_catatonia@1274-1282@sbin/init/init.c","sbin/init/init.c","f_catatonia",1274,1282
4,1,11,1,3,"alrm_handler@1288-1291@sbin/init/init.c","sbin/init/init.c","alrm_handler",1288,1291
5,1,13,1,4,"f_do_reboot@1299-1303@sbin/init/init.c","sbin/init/init.c","f_do_reboot",1299,1303
5,1,13,1,4,"f_hard_death@1310-1314@sbin/init/init.c","sbin/init/init.c","f_hard_death",1310,1314
62,18,430,1,83,"f_nice_death@1320-1403@sbin/init/init.c","sbin/init/init.c","f_nice_death",1320,1403
25,9,168,1,34,"f_death@1409-1443@sbin/init/init.c","sbin/init/init.c","f_death",1409,1443
9,2,47,1,9,"setprocresources@1447-1456@sbin/init/init.c","sbin/init/init.c","setprocresources",1447,1456
9,2,43,2,8,"ike_section_general@64-72@sbin/ipsecctl/ike.c","sbin/ipsecctl/ike.c","ike_section_general",64,72
18,5,138,2,17,"ike_section_peer@75-92@sbin/ipsecctl/ike.c","sbin/ipsecctl/ike.c","ike_section_peer",75,92
39,12,323,2,40,"ike_section_ids@95-135@sbin/ipsecctl/ike.c","sbin/ipsecctl/ike.c","ike_section_ids",95,135
13,3,133,2,13,"ike_section_ipsec@138-151@sbin/ipsecctl/ike.c","sbin/ipsecctl/ike.c","ike_section_ipsec",138,151
264,69,1170,2,282,"ike_section_p2@154-436@sbin/ipsecctl/ike.c","sbin/ipsecctl/ike.c","ike_section_p2",154,436
181,46,828,2,192,"ike_section_p1@439-631@sbin/ipsecctl/ike.c","sbin/ipsecctl/ike.c","ike_section_p1",439,631
36,7,295,5,39,"ike_section_p2ids_net@634-673@sbin/ipsecctl/ike.c","sbin/ipsecctl/ike.c","ike_section_p2ids_net",634,673
51,15,436,2,53,"ike_section_p2ids@676-729@sbin/ipsecctl/ike.c","sbin/ipsecctl/ike.c","ike_section_p2ids",676,729
16,4,71,2,15,"ike_connect@732-747@sbin/ipsecctl/ike.c","sbin/ipsecctl/ike.c","ike_connect",732,747
18,4,116,2,18,"ike_gen_config@750-768@sbin/ipsecctl/ike.c","sbin/ipsecctl/ike.c","ike_gen_config",750,768
46,12,302,2,50,"ike_delete_config@771-821@sbin/ipsecctl/ike.c","sbin/ipsecctl/ike.c","ike_delete_config",771,821
36,15,356,1,45,"ike_setup_ids@824-869@sbin/ipsecctl/ike.c","sbin/ipsecctl/ike.c","ike_setup_ids",824,869
7,2,39,2,6,"ike_print_config@872-878@sbin/ipsecctl/ike.c","sbin/ipsecctl/ike.c","ike_print_config",872,878
26,7,173,3,28,"ike_ipsec_establish@881-909@sbin/ipsecctl/ike.c","sbin/ipsecctl/ike.c","ike_ipsec_establish",881,909
9,3,63,2,9,"sacompare@92-101@sbin/ipsecctl/ipsecctl.c","sbin/ipsecctl/ipsecctl.c","sacompare",92,101
26,5,159,2,32,"ipsecctl_rules@104-136@sbin/ipsecctl/ipsecctl.c","sbin/ipsecctl/ipsecctl.c","ipsecctl_rules",104,136
18,4,97,2,19,"ipsecctl_fopen@139-158@sbin/ipsecctl/ipsecctl.c","sbin/ipsecctl/ipsecctl.c","ipsecctl_fopen",139,158
26,7,141,2,28,"ipsecctl_commit@161-189@sbin/ipsecctl/ipsecctl.c","sbin/ipsecctl/ipsecctl.c","ipsecctl_commit",161,189
8,3,59,2,9,"ipsecctl_add_rule@192-201@sbin/ipsecctl/ipsecctl.c","sbin/ipsecctl/ipsecctl.c","ipsecctl_add_rule",192,201
51,10,309,1,50,"ipsecctl_free_rule@204-254@sbin/ipsecctl/ipsecctl.c","sbin/ipsecctl/ipsecctl.c","ipsecctl_free_rule",204,254
39,21,335,2,47,"ipsecctl_merge_rules@262-309@sbin/ipsecctl/ipsecctl.c","sbin/ipsecctl/ipsecctl.c","ipsecctl_merge_rules",262,309
22,12,186,2,28,"ipsecctl_cmp_ident@315-343@sbin/ipsecctl/ipsecctl.c","sbin/ipsecctl/ipsecctl.c","ipsecctl_cmp_ident",315,343
13,4,101,2,15,"ipsecctl_rule_matchsrc@350-365@sbin/ipsecctl/ipsecctl.c","sbin/ipsecctl/ipsecctl.c","ipsecctl_rule_matchsrc",350,365
13,4,101,2,15,"ipsecctl_rule_matchdst@371-386@sbin/ipsecctl/ipsecctl.c","sbin/ipsecctl/ipsecctl.c","ipsecctl_rule_matchdst",371,386
16,5,106,1,17,"ipsecctl_print_addr@389-406@sbin/ipsecctl/ipsecctl.c","sbin/ipsecctl/ipsecctl.c","ipsecctl_print_addr",389,406
8,2,42,1,8,"ipsecctl_print_proto@409-417@sbin/ipsecctl/ipsecctl.c","sbin/ipsecctl/ipsecctl.c","ipsecctl_print_proto",409,417
8,2,52,2,8,"ipsecctl_print_port@420-428@sbin/ipsecctl/ipsecctl.c","sbin/ipsecctl/ipsecctl.c","ipsecctl_print_port",420,428
6,2,42,1,6,"ipsecctl_print_key@431-437@sbin/ipsecctl/ipsecctl.c","sbin/ipsecctl/ipsecctl.c","ipsecctl_print_key",431,437
63,16,389,2,64,"ipsecctl_print_flow@440-504@sbin/ipsecctl/ipsecctl.c","sbin/ipsecctl/ipsecctl.c","ipsecctl_print_flow",440,504
36,16,263,2,37,"ipsecctl_print_sa@508-545@sbin/ipsecctl/ipsecctl.c","sbin/ipsecctl/ipsecctl.c","ipsecctl_print_sa",508,545
9,1,68,2,9,"ipsecctl_print_sabundle@548-557@sbin/ipsecctl/ipsecctl.c","sbin/ipsecctl/ipsecctl.c","ipsecctl_print_sabundle",548,557
21,7,129,2,22,"ipsecctl_print_rule@560-582@sbin/ipsecctl/ipsecctl.c","sbin/ipsecctl/ipsecctl.c","ipsecctl_print_rule",560,582
10,4,55,1,12,"ipsecctl_flush@585-597@sbin/ipsecctl/ipsecctl.c","sbin/ipsecctl/ipsecctl.c","ipsecctl_flush",585,597
42,12,311,1,55,"ipsecctl_get_rules@600-655@sbin/ipsecctl/ipsecctl.c","sbin/ipsecctl/ipsecctl.c","ipsecctl_get_rules",600,655
7,2,29,1,6,"ipsecctl_print_title@658-664@sbin/ipsecctl/ipsecctl.c","sbin/ipsecctl/ipsecctl.c","ipsecctl_print_title",658,664
38,8,240,1,44,"ipsecctl_show_flows@667-711@sbin/ipsecctl/ipsecctl.c","sbin/ipsecctl/ipsecctl.c","ipsecctl_show_flows",667,711
52,14,384,1,55,"ipsecctl_show_sas@714-769@sbin/ipsecctl/ipsecctl.c","sbin/ipsecctl/ipsecctl.c","ipsecctl_show_sas",714,769
4,1,15,1,3,"ipsecctl_monitor@772-775@sbin/ipsecctl/ipsecctl.c","sbin/ipsecctl/ipsecctl.c","ipsecctl_monitor",772,775
7,1,26,1,7,"usage@778-785@sbin/ipsecctl/ipsecctl.c","sbin/ipsecctl/ipsecctl.c","usage",778,785
8,5,58,2,7,"ipsecctl_lookup_option@788-795@sbin/ipsecctl/ipsecctl.c","sbin/ipsecctl/ipsecctl.c","ipsecctl_lookup_option",788,795
85,28,355,2,105,"main@798-903@sbin/ipsecctl/ipsecctl.c","sbin/ipsecctl/ipsecctl.c","main",798,903
15,5,98,2,15,"unmask@907-922@sbin/ipsecctl/ipsecctl.c","sbin/ipsecctl/ipsecctl.c","unmask",907,922
8,3,48,2,8,"lookup@217-225@sbin/ipsecctl/pfkdump.c","sbin/ipsecctl/pfkdump.c","lookup",217,225
6,2,37,2,6,"lookup_name@228-234@sbin/ipsecctl/pfkdump.c","sbin/ipsecctl/pfkdump.c","lookup_name",228,234
16,3,101,2,16,"print_ext@237-253@sbin/ipsecctl/pfkdump.c","sbin/ipsecctl/pfkdump.c","print_ext",237,253
23,7,183,1,24,"print_flags@256-280@sbin/ipsecctl/pfkdump.c","sbin/ipsecctl/pfkdump.c","print_flags",256,280
16,2,111,2,16,"print_sa@283-299@sbin/ipsecctl/pfkdump.c","sbin/ipsecctl/pfkdump.c","print_sa",283,299
28,7,183,2,28,"print_addr@303-331@sbin/ipsecctl/pfkdump.c","sbin/ipsecctl/pfkdump.c","print_addr",303,331
12,2,90,2,12,"print_key@335-347@sbin/ipsecctl/pfkdump.c","sbin/ipsecctl/pfkdump.c","print_key",335,347
9,1,47,2,9,"print_life@351-360@sbin/ipsecctl/pfkdump.c","sbin/ipsecctl/pfkdump.c","print_life",351,360
11,2,66,2,12,"print_proto@363-375@sbin/ipsecctl/pfkdump.c","sbin/ipsecctl/pfkdump.c","print_proto",363,375
15,3,74,2,15,"print_flow@379-394@sbin/ipsecctl/pfkdump.c","sbin/ipsecctl/pfkdump.c","print_flow",379,394
7,1,49,2,7,"print_tag@397-404@sbin/ipsecctl/pfkdump.c","sbin/ipsecctl/pfkdump.c","print_tag",397,404
5,1,35,2,5,"print_tap@407-412@sbin/ipsecctl/pfkdump.c","sbin/ipsecctl/pfkdump.c","print_tap",407,412
5,1,40,2,5,"print_satype@415-420@sbin/ipsecctl/pfkdump.c","sbin/ipsecctl/pfkdump.c","print_satype",415,420
13,4,54,2,12,"alg_by_ext@423-435@sbin/ipsecctl/pfkdump.c","sbin/ipsecctl/pfkdump.c","alg_by_ext",423,435
6,1,38,2,5,"print_alg@438-443@sbin/ipsecctl/pfkdump.c","sbin/ipsecctl/pfkdump.c","print_alg",438,443
16,3,127,2,16,"print_supp@447-463@sbin/ipsecctl/pfkdump.c","sbin/ipsecctl/pfkdump.c","print_supp",447,463
23,2,96,2,24,"print_comb@467-491@sbin/ipsecctl/pfkdump.c","sbin/ipsecctl/pfkdump.c","print_comb",467,491
11,2,88,2,11,"print_prop@495-506@sbin/ipsecctl/pfkdump.c","sbin/ipsecctl/pfkdump.c","print_prop",495,506
8,1,43,2,8,"print_sens@510-518@sbin/ipsecctl/pfkdump.c","sbin/ipsecctl/pfkdump.c","print_sens",510,518
6,1,39,2,6,"print_spir@522-528@sbin/ipsecctl/pfkdump.c","sbin/ipsecctl/pfkdump.c","print_spir",522,528
7,1,54,2,7,"print_ident@532-539@sbin/ipsecctl/pfkdump.c","sbin/ipsecctl/pfkdump.c","print_ident",532,539
5,1,35,2,5,"print_policy@543-548@sbin/ipsecctl/pfkdump.c","sbin/ipsecctl/pfkdump.c","print_policy",543,548
5,1,38,2,5,"print_udpenc@552-557@sbin/ipsecctl/pfkdump.c","sbin/ipsecctl/pfkdump.c","print_udpenc",552,557
13,4,108,1,13,"setup_extensions@560-573@sbin/ipsecctl/pfkdump.c","sbin/ipsecctl/pfkdump.c","setup_extensions",560,573
21,4,138,2,21,"parse_addr@576-597@sbin/ipsecctl/pfkdump.c","sbin/ipsecctl/pfkdump.c","parse_addr",576,597
10,2,66,2,10,"parse_key@600-610@sbin/ipsecctl/pfkdump.c","sbin/ipsecctl/pfkdump.c","parse_key",600,610
22,6,85,2,22,"parse_satype@613-635@sbin/ipsecctl/pfkdump.c","sbin/ipsecctl/pfkdump.c","parse_satype",613,635
7,1,41,1,7,"pfkey_get_spi@638-645@sbin/ipsecctl/pfkdump.c","sbin/ipsecctl/pfkdump.c","pfkey_get_spi",638,645
184,45,1034,2,188,"pfkey_print_sa@649-837@sbin/ipsecctl/pfkdump.c","sbin/ipsecctl/pfkdump.c","pfkey_print_sa",649,837
18,4,116,2,19,"pfkey_monitor_sa@841-860@sbin/ipsecctl/pfkdump.c","sbin/ipsecctl/pfkdump.c","pfkey_monitor_sa",841,860
13,4,83,2,13,"pfkey_print_raw@863-876@sbin/ipsecctl/pfkdump.c","sbin/ipsecctl/pfkdump.c","pfkey_print_raw",863,876
277,37,2099,13,322,"pfkey_flow@64-386@sbin/ipsecctl/pfkey.c","sbin/ipsecctl/pfkey.c","pfkey_flow",64,386
215,52,1349,10,237,"pfkey_sa@389-626@sbin/ipsecctl/pfkey.c","sbin/ipsecctl/pfkey.c","pfkey_sa",389,626
110,7,858,8,131,"pfkey_sabundle@629-760@sbin/ipsecctl/pfkey.c","sbin/ipsecctl/pfkey.c","pfkey_sabundle",629,760
33,9,188,3,33,"pfkey_reply@763-796@sbin/ipsecctl/pfkey.c","sbin/ipsecctl/pfkey.c","pfkey_reply",763,796
265,54,1667,2,299,"pfkey_parse@799-1098@sbin/ipsecctl/pfkey.c","sbin/ipsecctl/pfkey.c","pfkey_parse",799,1098
135,33,610,2,140,"pfkey_ipsec_establish@1101-1241@sbin/ipsecctl/pfkey.c","sbin/ipsecctl/pfkey.c","pfkey_ipsec_establish",1101,1241
30,4,183,1,34,"pfkey_ipsec_flush@1244-1278@sbin/ipsecctl/pfkey.c","sbin/ipsecctl/pfkey.c","pfkey_ipsec_flush",1244,1278
18,3,118,1,18,"pfkey_promisc@1281-1299@sbin/ipsecctl/pfkey.c","sbin/ipsecctl/pfkey.c","pfkey_promisc",1281,1299
37,11,222,1,39,"pfkey_monitor@1302-1341@sbin/ipsecctl/pfkey.c","sbin/ipsecctl/pfkey.c","pfkey_monitor",1302,1341
6,2,34,1,6,"pfkey_init@1344-1350@sbin/ipsecctl/pfkey.c","sbin/ipsecctl/pfkey.c","pfkey_init",1344,1350
72,12,348,2,84,"sysdep_cleartext@48-132@sbin/isakmpd/sysdep/openbsd/sysdep.c","sbin/isakmpd/sysdep/openbsd/sysdep.c","sysdep_cleartext",48,132
8,3,30,1,7,"app_init@52-59@sbin/isakmpd/app.c","sbin/isakmpd/app.c","app_init",52,59
4,1,11,1,3,"app_handler@62-65@sbin/isakmpd/app.c","sbin/isakmpd/app.c","app_handler",62,65
6,1,38,3,5,"attribute_set_basic@43-48@sbin/isakmpd/attribute.c","sbin/isakmpd/attribute.c","attribute_set_basic",43,48
8,1,55,4,7,"attribute_set_var@51-58@sbin/isakmpd/attribute.c","sbin/isakmpd/attribute.c","attribute_set_var",51,58
25,7,163,4,25,"attribute_map@67-92@sbin/isakmpd/attribute.c","sbin/isakmpd/attribute.c","attribute_map",67,92
16,2,91,5,16,"attribute_set_constant@95-111@sbin/isakmpd/attribute.c","sbin/isakmpd/attribute.c","attribute_set_constant",95,111
10,4,63,1,11,"cert_init@68-79@sbin/isakmpd/cert.c","sbin/isakmpd/cert.c","cert_init",68,79
9,4,63,1,10,"crl_init@82-92@sbin/isakmpd/cert.c","sbin/isakmpd/cert.c","crl_init",82,92
8,3,51,1,8,"cert_get@95-103@sbin/isakmpd/cert.c","sbin/isakmpd/cert.c","cert_get",95,103
36,6,217,3,42,"certreq_decode@111-153@sbin/isakmpd/cert.c","sbin/isakmpd/cert.c","certreq_decode",111,153
8,2,49,3,8,"cert_free_subjects@156-164@sbin/isakmpd/cert.c","sbin/isakmpd/cert.c","cert_free_subjects",156,164
9,2,53,1,9,"conf_hash@90-99@sbin/isakmpd/conf.c","sbin/isakmpd/conf.c","conf_hash",90,99
20,4,137,2,20,"conf_remove_now@105-125@sbin/isakmpd/conf.c","sbin/isakmpd/conf.c","conf_remove_now",105,125
20,3,130,1,20,"conf_remove_section_now@128-148@sbin/isakmpd/conf.c","sbin/isakmpd/conf.c","conf_remove_section_now",128,148
37,8,251,5,38,"conf_set_now@155-193@sbin/isakmpd/conf.c","sbin/isakmpd/conf.c","conf_set_now",155,193
47,14,302,4,55,"conf_parse_line@200-255@sbin/isakmpd/conf.c","sbin/isakmpd/conf.c","conf_parse_line",200,255
23,6,129,3,24,"conf_parse@259-283@sbin/isakmpd/conf.c","sbin/isakmpd/conf.c","conf_parse",259,283
14,8,107,3,14,"conf_get_trans_str@309-323@sbin/isakmpd/conf.c","sbin/isakmpd/conf.c","conf_get_trans_str",309,323
18,9,138,2,19,"conf_find_trans_xf@328-347@sbin/isakmpd/conf.c","sbin/isakmpd/conf.c","conf_find_trans_xf",328,347
24,6,285,9,27,"conf_load_defaults_mm@351-378@sbin/isakmpd/conf.c","sbin/isakmpd/conf.c","conf_load_defaults_mm",351,378
58,29,622,11,85,"conf_load_defaults_qm@381-466@sbin/isakmpd/conf.c","sbin/isakmpd/conf.c","conf_load_defaults_qm",381,466
108,14,1015,1,124,"conf_load_defaults@469-593@sbin/isakmpd/conf.c","sbin/isakmpd/conf.c","conf_load_defaults",469,593
8,2,49,1,8,"conf_init@596-604@sbin/isakmpd/conf.c","sbin/isakmpd/conf.c","conf_init",596,604
47,11,286,1,57,"conf_reinit@608-665@sbin/isakmpd/conf.c","sbin/isakmpd/conf.c","conf_reinit",608,665
7,2,39,3,7,"conf_get_num@672-679@sbin/isakmpd/conf.c","sbin/isakmpd/conf.c","conf_get_num",672,679
10,3,61,2,10,"conf_get_address@687-697@sbin/isakmpd/conf.c","sbin/isakmpd/conf.c","conf_get_address",687,697
22,5,144,3,22,"conf_match_num@701-723@sbin/isakmpd/conf.c","sbin/isakmpd/conf.c","conf_match_num",701,723
16,4,112,2,16,"conf_get_str@727-743@sbin/isakmpd/conf.c","sbin/isakmpd/conf.c","conf_get_str",727,743
45,13,278,2,48,"conf_get_list@750-798@sbin/isakmpd/conf.c","sbin/isakmpd/conf.c","conf_get_list",750,798
29,7,179,1,30,"conf_get_tag_list@801-831@sbin/isakmpd/conf.c","sbin/isakmpd/conf.c","conf_get_tag_list",801,831
11,2,67,1,11,"conf_free_list@834-845@sbin/isakmpd/conf.c","sbin/isakmpd/conf.c","conf_free_list",834,845
5,1,16,1,5,"conf_begin@848-853@sbin/isakmpd/conf.c","sbin/isakmpd/conf.c","conf_begin",848,853
29,5,196,7,30,"conf_trans_node@856-886@sbin/isakmpd/conf.c","sbin/isakmpd/conf.c","conf_trans_node",856,886
6,1,43,6,5,"conf_set@890-895@sbin/isakmpd/conf.c","sbin/isakmpd/conf.c","conf_set",890,895
5,1,33,3,4,"conf_remove@899-903@sbin/isakmpd/conf.c","sbin/isakmpd/conf.c","conf_remove",899,903
5,1,29,2,4,"conf_remove_section@907-911@sbin/isakmpd/conf.c","sbin/isakmpd/conf.c","conf_remove_section",907,911
33,7,174,2,33,"conf_end@915-948@sbin/isakmpd/conf.c","sbin/isakmpd/conf.c","conf_end",915,948
13,5,94,1,15,"conf_report_dump@960-975@sbin/isakmpd/conf.c","sbin/isakmpd/conf.c","conf_report_dump",960,975
56,15,352,1,63,"conf_report@978-1041@sbin/isakmpd/conf.c","sbin/isakmpd/conf.c","conf_report",978,1041
40,15,254,1,55,"connection_init@86-141@sbin/isakmpd/connection.c","sbin/isakmpd/connection.c","connection_init",86,141
21,4,114,1,22,"connection_checker@145-167@sbin/isakmpd/connection.c","sbin/isakmpd/connection.c","connection_checker",145,167
9,3,53,1,9,"connection_lookup@171-180@sbin/isakmpd/connection.c","sbin/isakmpd/connection.c","connection_lookup",171,180
4,1,18,1,3,"connection_exist@184-187@sbin/isakmpd/connection.c","sbin/isakmpd/connection.c","connection_exist",184,187
9,3,53,1,9,"connection_passive_lookup_by_name@191-200@sbin/isakmpd/connection.c","sbin/isakmpd/connection.c","connection_passive_lookup_by_name",191,200
8,2,57,3,9,"compare_ids@207-216@sbin/isakmpd/connection.c","sbin/isakmpd/connection.c","compare_ids",207,216
33,11,239,2,44,"connection_passive_lookup_by_ids@220-264@sbin/isakmpd/connection.c","sbin/isakmpd/connection.c","connection_passive_lookup_by_ids",220,264
36,6,184,1,38,"connection_setup@272-310@sbin/isakmpd/connection.c","sbin/isakmpd/connection.c","connection_setup",272,310
49,8,259,1,56,"connection_record_passive@313-369@sbin/isakmpd/connection.c","sbin/isakmpd/connection.c","connection_record_passive",313,369
11,2,56,1,12,"connection_teardown@373-385@sbin/isakmpd/connection.c","sbin/isakmpd/connection.c","connection_teardown",373,385
12,2,63,1,13,"connection_passive_teardown@389-402@sbin/isakmpd/connection.c","sbin/isakmpd/connection.c","connection_passive_teardown",389,402
21,4,161,1,21,"connection_report@405-426@sbin/isakmpd/connection.c","sbin/isakmpd/connection.c","connection_report",405,426
16,3,105,1,21,"connection_reinit@430-451@sbin/isakmpd/connection.c","sbin/isakmpd/connection.c","connection_reinit",430,451
8,3,54,2,8,"constant_value@38-46@sbin/isakmpd/constants.c","sbin/isakmpd/constants.c","constant_value",38,46
8,3,48,2,8,"constant_lookup@49-57@sbin/isakmpd/constants.c","sbin/isakmpd/constants.c","constant_lookup",49,57
8,3,48,2,8,"constant_link_lookup@60-68@sbin/isakmpd/constants.c","sbin/isakmpd/constants.c","constant_link_lookup",60,68
10,2,55,2,10,"constant_name@71-81@sbin/isakmpd/constants.c","sbin/isakmpd/constants.c","constant_name",71,81
13,3,74,2,13,"constant_name_maps@84-97@sbin/isakmpd/constants.c","sbin/isakmpd/constants.c","constant_name_maps",84,97
19,2,190,4,19,"cookie_gen@54-73@sbin/isakmpd/cookie.c","sbin/isakmpd/cookie.c","cookie_gen",54,73
10,1,113,3,12,"des3_init@81-93@sbin/isakmpd/crypto.c","sbin/isakmpd/crypto.c","des3_init",81,93
7,1,86,3,7,"des3_encrypt@96-103@sbin/isakmpd/crypto.c","sbin/isakmpd/crypto.c","des3_encrypt",96,103
7,1,86,3,7,"des3_decrypt@106-113@sbin/isakmpd/crypto.c","sbin/isakmpd/crypto.c","des3_decrypt",106,113
5,1,31,3,5,"blf_init@116-121@sbin/isakmpd/crypto.c","sbin/isakmpd/crypto.c","blf_init",116,121
16,2,131,3,17,"blf_encrypt@124-141@sbin/isakmpd/crypto.c","sbin/isakmpd/crypto.c","blf_encrypt",124,141
21,2,170,3,22,"blf_decrypt@144-166@sbin/isakmpd/crypto.c","sbin/isakmpd/crypto.c","blf_decrypt",144,166
5,1,31,3,4,"cast_init@169-173@sbin/isakmpd/crypto.c","sbin/isakmpd/crypto.c","cast_init",169,173
5,1,53,3,4,"cast1_encrypt@176-180@sbin/isakmpd/crypto.c","sbin/isakmpd/crypto.c","cast1_encrypt",176,180
4,1,36,3,3,"cast1_decrypt@183-186@sbin/isakmpd/crypto.c","sbin/isakmpd/crypto.c","cast1_decrypt",183,186
6,1,55,3,5,"aes_init@189-194@sbin/isakmpd/crypto.c","sbin/isakmpd/crypto.c","aes_init",189,194
6,1,58,3,6,"aes_encrypt@197-203@sbin/isakmpd/crypto.c","sbin/isakmpd/crypto.c","aes_encrypt",197,203
6,1,58,3,6,"aes_decrypt@206-212@sbin/isakmpd/crypto.c","sbin/isakmpd/crypto.c","aes_decrypt",206,212
8,3,52,1,9,"crypto_get@215-224@sbin/isakmpd/crypto.c","sbin/isakmpd/crypto.c","crypto_get",215,224
30,5,188,4,34,"crypto_init@227-261@sbin/isakmpd/crypto.c","sbin/isakmpd/crypto.c","crypto_init",227,261
9,1,54,1,10,"crypto_update_iv@264-274@sbin/isakmpd/crypto.c","sbin/isakmpd/crypto.c","crypto_update_iv",264,274
6,1,44,3,6,"crypto_init_iv@277-283@sbin/isakmpd/crypto.c","sbin/isakmpd/crypto.c","crypto_init_iv",277,283
9,1,82,3,8,"crypto_encrypt@286-294@sbin/isakmpd/crypto.c","sbin/isakmpd/crypto.c","crypto_encrypt",286,294
9,1,82,3,12,"crypto_decrypt@297-309@sbin/isakmpd/crypto.c","sbin/isakmpd/crypto.c","crypto_decrypt",297,309
19,3,107,1,19,"crypto_clone_keystate@313-332@sbin/isakmpd/crypto.c","sbin/isakmpd/crypto.c","crypto_clone_keystate",313,332
4,1,8,1,4,"group_init@230-234@sbin/isakmpd/dh.c","sbin/isakmpd/dh.c","group_init",230,234
11,4,58,1,10,"group_free@237-247@sbin/isakmpd/dh.c","sbin/isakmpd/dh.c","group_free",237,247
43,9,237,1,48,"group_get@250-298@sbin/isakmpd/dh.c","sbin/isakmpd/dh.c","group_get",250,298
4,1,19,1,3,"dh_init@301-304@sbin/isakmpd/dh.c","sbin/isakmpd/dh.c","dh_init",301,304
4,1,19,1,3,"dh_getlen@307-310@sbin/isakmpd/dh.c","sbin/isakmpd/dh.c","dh_getlen",307,310
7,2,36,1,6,"dh_secretlen@313-319@sbin/isakmpd/dh.c","sbin/isakmpd/dh.c","dh_secretlen",313,319
4,1,25,2,3,"dh_create_exchange@322-325@sbin/isakmpd/dh.c","sbin/isakmpd/dh.c","dh_create_exchange",322,325
4,1,31,3,3,"dh_create_shared@328-331@sbin/isakmpd/dh.c","sbin/isakmpd/dh.c","dh_create_shared",328,331
11,4,80,1,13,"modp_init@334-347@sbin/isakmpd/dh.c","sbin/isakmpd/dh.c","modp_init",334,347
6,2,38,1,5,"modp_getlen@350-355@sbin/isakmpd/dh.c","sbin/isakmpd/dh.c","modp_getlen",350,355
16,4,106,2,20,"modp_create_exchange@358-378@sbin/isakmpd/dh.c","sbin/isakmpd/dh.c","modp_create_exchange",358,378
17,4,123,3,22,"modp_create_shared@381-403@sbin/isakmpd/dh.c","sbin/isakmpd/dh.c","modp_create_shared",381,403
12,4,80,1,11,"ec_init@406-417@sbin/isakmpd/dh.c","sbin/isakmpd/dh.c","ec_init",406,417
6,2,42,1,6,"ec_getlen@420-426@sbin/isakmpd/dh.c","sbin/isakmpd/dh.c","ec_getlen",420,426
4,1,19,1,3,"ec_secretlen@437-440@sbin/isakmpd/dh.c","sbin/isakmpd/dh.c","ec_secretlen",437,440
8,1,51,2,9,"ec_create_exchange@443-452@sbin/isakmpd/dh.c","sbin/isakmpd/dh.c","ec_create_exchange",443,452
36,13,253,3,45,"ec_create_shared@455-500@sbin/isakmpd/dh.c","sbin/isakmpd/dh.c","ec_create_shared",455,500
61,16,364,5,69,"ec_point2raw@503-572@sbin/isakmpd/dh.c","sbin/isakmpd/dh.c","ec_point2raw",503,572
48,16,315,3,55,"ec_raw2point@575-630@sbin/isakmpd/dh.c","sbin/isakmpd/dh.c","ec_raw2point",575,630
131,31,867,3,170,"dns_get_key@65-235@sbin/isakmpd/dnssec.c","sbin/isakmpd/dnssec.c","dns_get_key",65,235
39,7,219,3,45,"dns_RSA_dns_to_x509@238-283@sbin/isakmpd/dnssec.c","sbin/isakmpd/dnssec.c","dns_RSA_dns_to_x509",238,283
4,1,19,3,3,"dns_RSA_x509_to_dns@287-290@sbin/isakmpd/dnssec.c","sbin/isakmpd/dnssec.c","dns_RSA_x509_to_dns",287,290
4,1,11,1,3,"doi_init@40-43@sbin/isakmpd/doi.c","sbin/isakmpd/doi.c","doi_init",40,43
7,3,43,1,7,"doi_lookup@46-53@sbin/isakmpd/doi.c","sbin/isakmpd/doi.c","doi_lookup",46,53
4,1,19,1,3,"doi_register@56-59@sbin/isakmpd/doi.c","sbin/isakmpd/doi.c","doi_register",56,59
19,3,98,1,21,"dpd_add_vendor_payload@70-91@sbin/isakmpd/dpd.c","sbin/isakmpd/dpd.c","dpd_add_vendor_payload",70,91
24,5,140,2,29,"dpd_check_vendor_payload@97-126@sbin/isakmpd/dpd.c","sbin/isakmpd/dpd.c","dpd_check_vendor_payload",97,126
8,2,46,1,7,"dpd_start@132-139@sbin/isakmpd/dpd.c","sbin/isakmpd/dpd.c","dpd_start",132,139
40,9,217,2,51,"dpd_handle_notify@145-196@sbin/isakmpd/dpd.c","sbin/isakmpd/dpd.c","dpd_handle_notify",145,196
11,5,54,1,14,"dpd_timer_interval@200-214@sbin/isakmpd/dpd.c","sbin/isakmpd/dpd.c","dpd_timer_interval",200,214
24,5,126,3,25,"dpd_timer_reset@217-242@sbin/isakmpd/dpd.c","sbin/isakmpd/dpd.c","dpd_timer_reset",217,242
9,6,86,2,9,"dpd_find_sa@246-255@sbin/isakmpd/dpd.c","sbin/isakmpd/dpd.c","dpd_find_sa",246,255
28,9,229,2,33,"dpd_check_time@264-297@sbin/isakmpd/dpd.c","sbin/isakmpd/dpd.c","dpd_check_time",264,297
31,6,211,1,42,"dpd_event@301-343@sbin/isakmpd/dpd.c","sbin/isakmpd/dpd.c","dpd_event",301,343
25,3,148,1,30,"dpd_check_event@350-380@sbin/isakmpd/dpd.c","sbin/isakmpd/dpd.c","dpd_check_event",350,380
21,8,78,1,20,"exchange_script@166-186@sbin/isakmpd/exchange.c","sbin/isakmpd/exchange.c","exchange_script",166,186
32,16,213,1,37,"exchange_validate@194-231@sbin/isakmpd/exchange.c","sbin/isakmpd/exchange.c","exchange_validate",194,231
22,7,125,1,22,"exchange_handle_leftover_payloads@235-257@sbin/isakmpd/exchange.c","sbin/isakmpd/exchange.c","exchange_handle_leftover_payloads",235,257
83,24,424,1,145,"exchange_run@267-412@sbin/isakmpd/exchange.c","sbin/isakmpd/exchange.c","exchange_run",267,412
10,3,67,1,10,"exchange_init@415-425@sbin/isakmpd/exchange.c","sbin/isakmpd/exchange.c","exchange_init",415,425
13,5,80,1,13,"exchange_lookup_from_icookie@429-442@sbin/isakmpd/exchange.c","sbin/isakmpd/exchange.c","exchange_lookup_from_icookie",429,442
22,10,143,2,29,"exchange_lookup_by_name@446-475@sbin/isakmpd/exchange.c","sbin/isakmpd/exchange.c","exchange_lookup_by_name",446,475
27,9,149,2,30,"exchange_lookup_active@479-509@sbin/isakmpd/exchange.c","sbin/isakmpd/exchange.c","exchange_lookup_active",479,509
17,3,122,1,21,"exchange_enter@512-533@sbin/isakmpd/exchange.c","sbin/isakmpd/exchange.c","exchange_enter",512,533
27,10,193,2,37,"exchange_lookup@540-577@sbin/isakmpd/exchange.c","sbin/isakmpd/exchange.c","exchange_lookup",540,577
44,5,273,4,51,"exchange_create@587-638@sbin/isakmpd/exchange.c","sbin/isakmpd/exchange.c","exchange_create",587,638
7,1,54,3,7,"exchange_run_finalizations@649-656@sbin/isakmpd/exchange.c","sbin/isakmpd/exchange.c","exchange_run_finalizations",649,656
25,4,140,3,26,"exchange_add_finalization@663-689@sbin/isakmpd/exchange.c","sbin/isakmpd/exchange.c","exchange_add_finalization",663,689
10,3,77,3,12,"exchange_establish_transaction@692-704@sbin/isakmpd/exchange.c","sbin/isakmpd/exchange.c","exchange_establish_transaction",692,704
108,24,625,8,136,"exchange_establish_p1@708-844@sbin/isakmpd/exchange.c","sbin/isakmpd/exchange.c","exchange_establish_p1",708,844
87,20,511,6,105,"exchange_establish_p2@848-953@sbin/isakmpd/exchange.c","sbin/isakmpd/exchange.c","exchange_establish_p2",848,953
111,22,648,2,139,"exchange_setup_p1@957-1096@sbin/isakmpd/exchange.c","sbin/isakmpd/exchange.c","exchange_setup_p1",957,1096
19,6,142,2,19,"exchange_setup_p2@1100-1119@sbin/isakmpd/exchange.c","sbin/isakmpd/exchange.c","exchange_setup_p2",1100,1119
29,8,263,4,33,"exchange_dump_real@1123-1156@sbin/isakmpd/exchange.c","sbin/isakmpd/exchange.c","exchange_dump_real",1123,1156
4,1,24,2,3,"exchange_dump@1159-1162@sbin/isakmpd/exchange.c","sbin/isakmpd/exchange.c","exchange_dump",1159,1162
10,3,62,1,10,"exchange_report@1165-1175@sbin/isakmpd/exchange.c","sbin/isakmpd/exchange.c","exchange_report",1165,1175
55,17,359,1,65,"exchange_free_aux@1183-1248@sbin/isakmpd/exchange.c","sbin/isakmpd/exchange.c","exchange_free_aux",1183,1248
6,2,27,1,5,"exchange_free@1252-1257@sbin/isakmpd/exchange.c","sbin/isakmpd/exchange.c","exchange_free",1252,1257
10,1,59,1,10,"exchange_upgrade_p1@1264-1274@sbin/isakmpd/exchange.c","sbin/isakmpd/exchange.c","exchange_upgrade_p1",1264,1274
25,10,238,2,29,"exchange_check_old_sa@1277-1306@sbin/isakmpd/exchange.c","sbin/isakmpd/exchange.c","exchange_check_old_sa",1277,1306
129,38,957,1,181,"exchange_finalize@1309-1490@sbin/isakmpd/exchange.c","sbin/isakmpd/exchange.c","exchange_finalize",1309,1490
29,7,184,4,35,"exchange_nonce@1494-1529@sbin/isakmpd/exchange.c","sbin/isakmpd/exchange.c","exchange_nonce",1494,1529
19,3,109,2,19,"exchange_gen_nonce@1533-1552@sbin/isakmpd/exchange.c","sbin/isakmpd/exchange.c","exchange_gen_nonce",1533,1552
9,1,61,1,9,"exchange_save_nonce@1556-1565@sbin/isakmpd/exchange.c","sbin/isakmpd/exchange.c","exchange_save_nonce",1556,1565
15,2,96,1,16,"exchange_save_certreq@1569-1585@sbin/isakmpd/exchange.c","sbin/isakmpd/exchange.c","exchange_save_certreq",1569,1585
15,4,96,1,15,"exchange_free_aca_list@1589-1604@sbin/isakmpd/exchange.c","sbin/isakmpd/exchange.c","exchange_free_aca_list",1589,1604
34,7,190,1,48,"exchange_add_certreqs@1608-1656@sbin/isakmpd/exchange.c","sbin/isakmpd/exchange.c","exchange_add_certreqs",1608,1656
41,8,253,1,60,"exchange_add_certs@1660-1720@sbin/isakmpd/exchange.c","sbin/isakmpd/exchange.c","exchange_add_certs",1660,1720
10,3,67,3,11,"exchange_establish_finalize@1723-1734@sbin/isakmpd/exchange.c","sbin/isakmpd/exchange.c","exchange_establish_finalize",1723,1734
95,22,491,4,119,"exchange_establish@1741-1860@sbin/isakmpd/exchange.c","sbin/isakmpd/exchange.c","exchange_establish",1741,1860
4,1,24,3,3,"field_debug_raw@63-66@sbin/isakmpd/field.c","sbin/isakmpd/field.c","field_debug_raw",63,66
17,4,67,3,16,"extract_val@73-89@sbin/isakmpd/field.c","sbin/isakmpd/field.c","extract_val",73,89
10,3,59,3,10,"field_debug_num@97-107@sbin/isakmpd/field.c","sbin/isakmpd/field.c","field_debug_num",97,107
30,6,177,3,33,"field_debug_mask@114-147@sbin/isakmpd/field.c","sbin/isakmpd/field.c","field_debug_mask",114,147
4,1,19,3,3,"field_debug_ign@154-157@sbin/isakmpd/field.c","sbin/isakmpd/field.c","field_debug_ign",154,157
7,2,45,3,8,"field_debug_cst@164-172@sbin/isakmpd/field.c","sbin/isakmpd/field.c","field_debug_cst",164,172
9,2,72,2,9,"field_dump_field@176-185@sbin/isakmpd/field.c","sbin/isakmpd/field.c","field_dump_field",176,185
6,2,38,2,6,"field_dump_payload@189-195@sbin/isakmpd/field.c","sbin/isakmpd/field.c","field_dump_payload",189,195
7,2,40,2,7,"field_get_num@199-206@sbin/isakmpd/field.c","sbin/isakmpd/field.c","field_get_num",199,206
14,4,70,3,13,"field_set_num@210-223@sbin/isakmpd/field.c","sbin/isakmpd/field.c","field_set_num",210,223
4,1,32,3,3,"field_get_raw@227-230@sbin/isakmpd/field.c","sbin/isakmpd/field.c","field_get_raw",227,230
4,1,32,3,3,"field_set_raw@234-237@sbin/isakmpd/field.c","sbin/isakmpd/field.c","field_set_raw",234,237
10,3,65,1,12,"hash_get@102-114@sbin/isakmpd/hash.c","sbin/isakmpd/hash.c","hash_get",102,114
22,4,188,3,29,"hmac_init@123-152@sbin/isakmpd/hash.c","sbin/isakmpd/hash.c","hmac_init",123,152
6,1,51,2,5,"hmac_final@159-164@sbin/isakmpd/hash.c","sbin/isakmpd/hash.c","hmac_final",159,164
12,4,100,2,14,"if_map@45-59@sbin/isakmpd/if.c","sbin/isakmpd/if.c","if_map",45,59
8,3,37,1,9,"initiator_send_SA_KE_NONCE_ID@81-90@sbin/isakmpd/ike_aggressive.c","sbin/isakmpd/ike_aggressive.c","initiator_send_SA_KE_NONCE_ID",81,90
8,3,37,1,9,"initiator_recv_SA_KE_NONCE_ID_AUTH@94-103@sbin/isakmpd/ike_aggressive.c","sbin/isakmpd/ike_aggressive.c","initiator_recv_SA_KE_NONCE_ID_AUTH",94,103
7,2,31,1,18,"initiator_send_AUTH@106-124@sbin/isakmpd/ike_aggressive.c","sbin/isakmpd/ike_aggressive.c","initiator_send_AUTH",106,124
8,3,37,1,9,"responder_recv_SA_KE_NONCE_ID@131-140@sbin/isakmpd/ike_aggressive.c","sbin/isakmpd/ike_aggressive.c","responder_recv_SA_KE_NONCE_ID",131,140
10,4,54,1,14,"responder_send_SA_KE_NONCE_ID_AUTH@147-161@sbin/isakmpd/ike_aggressive.c","sbin/isakmpd/ike_aggressive.c","responder_send_SA_KE_NONCE_ID_AUTH",147,161
8,3,41,1,9,"responder_recv_AUTH@168-177@sbin/isakmpd/ike_aggressive.c","sbin/isakmpd/ike_aggressive.c","responder_recv_AUTH",168,177
8,3,51,1,8,"ike_auth_get@119-127@sbin/isakmpd/ike_auth.c","sbin/isakmpd/ike_auth.c","ike_auth_get",119,127
171,30,910,4,201,"ike_auth_get_key@134-335@sbin/isakmpd/ike_auth.c","sbin/isakmpd/ike_auth.c","ike_auth_get_key",134,335
74,14,436,2,93,"pre_shared_gen_skeyid@338-431@sbin/isakmpd/ike_auth.c","sbin/isakmpd/ike_auth.c","pre_shared_gen_skeyid",338,431
40,4,296,2,44,"sig_gen_skeyid@435-479@sbin/isakmpd/ike_auth.c","sbin/isakmpd/ike_auth.c","sig_gen_skeyid",435,479
26,3,205,2,27,"enc_gen_skeyid@487-514@sbin/isakmpd/ike_auth.c","sbin/isakmpd/ike_auth.c","enc_gen_skeyid",487,514
30,6,200,1,36,"pre_shared_decode_hash@518-554@sbin/isakmpd/ike_auth.c","sbin/isakmpd/ike_auth.c","pre_shared_decode_hash",518,554
208,43,1213,1,256,"rsa_sig_decode_hash@558-814@sbin/isakmpd/ike_auth.c","sbin/isakmpd/ike_auth.c","rsa_sig_decode_hash",558,814
19,4,125,1,21,"pre_shared_encode_hash@817-838@sbin/isakmpd/ike_auth.c","sbin/isakmpd/ike_auth.c","pre_shared_encode_hash",817,838
210,36,1159,1,233,"rsa_sig_encode_hash@842-1075@sbin/isakmpd/ike_auth.c","sbin/isakmpd/ike_auth.c","rsa_sig_encode_hash",842,1075
28,8,254,2,32,"ike_auth_hash@1078-1110@sbin/isakmpd/ike_auth.c","sbin/isakmpd/ike_auth.c","ike_auth_hash",1078,1110
45,10,280,4,51,"get_raw_key_from_file@1113-1164@sbin/isakmpd/ike_auth.c","sbin/isakmpd/ike_auth.c","get_raw_key_from_file",1113,1164
9,3,45,1,11,"initiator_send_ID_AUTH@81-92@sbin/isakmpd/ike_main_mode.c","sbin/isakmpd/ike_main_mode.c","initiator_send_ID_AUTH",81,92
8,2,47,1,14,"responder_send_KE_NONCE@96-110@sbin/isakmpd/ike_main_mode.c","sbin/isakmpd/ike_main_mode.c","responder_send_KE_NONCE",96,110
7,2,34,1,8,"responder_send_ID_AUTH@113-121@sbin/isakmpd/ike_main_mode.c","sbin/isakmpd/ike_main_mode.c","responder_send_ID_AUTH",113,121
253,47,1616,1,319,"ike_phase_1_initiator_send_SA@70-389@sbin/isakmpd/ike_phase_1.c","sbin/isakmpd/ike_phase_1.c","ike_phase_1_initiator_send_SA",70,389
25,7,202,1,38,"ike_phase_1_initiator_recv_SA@393-431@sbin/isakmpd/ike_phase_1.c","sbin/isakmpd/ike_phase_1.c","ike_phase_1_initiator_recv_SA",393,431
6,1,39,1,8,"ike_phase_1_initiator_send_KE_NONCE@435-443@sbin/isakmpd/ike_phase_1.c","sbin/isakmpd/ike_phase_1.c","ike_phase_1_initiator_send_KE_NONCE",435,443
6,2,26,1,6,"ike_phase_1_initiator_recv_KE_NONCE@447-453@sbin/isakmpd/ike_phase_1.c","sbin/isakmpd/ike_phase_1.c","ike_phase_1_initiator_recv_KE_NONCE",447,453
35,10,291,1,51,"ike_phase_1_responder_recv_SA@460-511@sbin/isakmpd/ike_phase_1.c","sbin/isakmpd/ike_phase_1.c","ike_phase_1_responder_recv_SA",460,511
12,5,56,1,18,"ike_phase_1_responder_send_SA@515-533@sbin/isakmpd/ike_phase_1.c","sbin/isakmpd/ike_phase_1.c","ike_phase_1_responder_send_SA",515,533
20,7,92,2,29,"ike_phase_1_send_KE_NONCE@537-566@sbin/isakmpd/ike_phase_1.c","sbin/isakmpd/ike_phase_1.c","ike_phase_1_send_KE_NONCE",537,566
16,6,77,1,22,"ike_phase_1_recv_KE_NONCE@570-592@sbin/isakmpd/ike_phase_1.c","sbin/isakmpd/ike_phase_1.c","ike_phase_1_recv_KE_NONCE",570,592
138,19,1117,1,174,"ike_phase_1_post_exchange_KE_NONCE@600-774@sbin/isakmpd/ike_phase_1.c","sbin/isakmpd/ike_phase_1.c","ike_phase_1_post_exchange_KE_NONCE",600,774
6,2,26,1,6,"ike_phase_1_responder_send_ID_AUTH@777-783@sbin/isakmpd/ike_phase_1.c","sbin/isakmpd/ike_phase_1.c","ike_phase_1_responder_send_ID_AUTH",777,783
149,31,805,1,161,"ike_phase_1_send_ID@786-947@sbin/isakmpd/ike_phase_1.c","sbin/isakmpd/ike_phase_1.c","ike_phase_1_send_ID",786,947
11,4,65,1,19,"ike_phase_1_send_AUTH@950-969@sbin/isakmpd/ike_phase_1.c","sbin/isakmpd/ike_phase_1.c","ike_phase_1_send_AUTH",950,969
6,2,26,1,6,"ike_phase_1_recv_ID_AUTH@973-979@sbin/isakmpd/ike_phase_1.c","sbin/isakmpd/ike_phase_1.c","ike_phase_1_recv_ID_AUTH",973,979
109,23,599,1,117,"ike_phase_1_recv_ID@983-1100@sbin/isakmpd/ike_phase_1.c","sbin/isakmpd/ike_phase_1.c","ike_phase_1_recv_ID",983,1100
45,12,385,1,56,"ike_phase_1_recv_AUTH@1104-1160@sbin/isakmpd/ike_phase_1.c","sbin/isakmpd/ike_phase_1.c","ike_phase_1_recv_AUTH",1104,1160
62,11,384,3,77,"ike_phase_1_validate_prop@1175-1252@sbin/isakmpd/ike_phase_1.c","sbin/isakmpd/ike_phase_1.c","ike_phase_1_validate_prop",1175,1252
148,38,723,4,172,"attribute_unacceptable@1260-1432@sbin/isakmpd/ike_phase_1.c","sbin/isakmpd/ike_phase_1.c","attribute_unacceptable",1260,1432
223,47,1400,3,288,"check_policy@91-379@sbin/isakmpd/ike_quick_mode.c","sbin/isakmpd/ike_quick_mode.c","check_policy",91,379
509,78,2856,1,613,"initiator_send_HASH_SA_NONCE@386-999@sbin/isakmpd/ike_quick_mode.c","sbin/isakmpd/ike_quick_mode.c","initiator_send_HASH_SA_NONCE",386,999
189,31,1332,1,255,"initiator_recv_HASH_SA_NONCE@1003-1258@sbin/isakmpd/ike_quick_mode.c","sbin/isakmpd/ike_quick_mode.c","initiator_recv_HASH_SA_NONCE",1003,1258
47,5,373,1,55,"initiator_send_HASH@1261-1316@sbin/isakmpd/ike_quick_mode.c","sbin/isakmpd/ike_quick_mode.c","initiator_send_HASH",1261,1316
100,13,657,1,126,"post_quick_mode@1319-1445@sbin/isakmpd/ike_quick_mode.c","sbin/isakmpd/ike_quick_mode.c","post_quick_mode",1319,1445
239,40,1485,1,321,"responder_recv_HASH_SA_NONCE@1453-1774@sbin/isakmpd/ike_quick_mode.c","sbin/isakmpd/ike_quick_mode.c","responder_recv_HASH_SA_NONCE",1453,1774
98,16,692,1,118,"responder_send_HASH_SA_NONCE@1778-1896@sbin/isakmpd/ike_quick_mode.c","sbin/isakmpd/ike_quick_mode.c","responder_send_HASH_SA_NONCE",1778,1896
19,4,126,1,20,"gen_g_xy@1899-1919@sbin/isakmpd/ike_quick_mode.c","sbin/isakmpd/ike_quick_mode.c","gen_g_xy",1899,1919
58,4,411,1,65,"responder_recv_HASH@1922-1987@sbin/isakmpd/ike_quick_mode.c","sbin/isakmpd/ike_quick_mode.c","responder_recv_HASH",1922,1987
24,1,90,1,33,"init@66-99@sbin/isakmpd/init.c","sbin/isakmpd/init.c","init",66,99
12,1,43,1,39,"reinit@103-142@sbin/isakmpd/init.c","sbin/isakmpd/init.c","reinit",103,142
28,9,220,2,30,"ipsec_sa_check@203-233@sbin/isakmpd/ipsec.c","sbin/isakmpd/ipsec.c","ipsec_sa_check",203,233
8,1,46,3,8,"ipsec_sa_lookup@237-245@sbin/isakmpd/ipsec.c","sbin/isakmpd/ipsec.c","ipsec_sa_lookup",237,245
6,2,40,2,6,"ipsec_sa_check_flow@253-259@sbin/isakmpd/ipsec.c","sbin/isakmpd/ipsec.c","ipsec_sa_check_flow",253,259
29,19,260,2,35,"ipsec_sa_check_flow_any@262-297@sbin/isakmpd/ipsec.c","sbin/isakmpd/ipsec.c","ipsec_sa_check_flow_any",262,297
67,18,427,3,74,"ipsec_sa_tag@306-380@sbin/isakmpd/ipsec.c","sbin/isakmpd/ipsec.c","ipsec_sa_tag",306,380
105,33,595,1,147,"ipsec_finalize_exchange@387-534@sbin/isakmpd/ipsec.c","sbin/isakmpd/ipsec.c","ipsec_finalize_exchange",387,534
158,29,1034,3,196,"ipsec_set_network@538-734@sbin/isakmpd/ipsec.c","sbin/isakmpd/ipsec.c","ipsec_set_network",538,734
26,4,168,1,26,"ipsec_free_exchange_data@738-764@sbin/isakmpd/ipsec.c","sbin/isakmpd/ipsec.c","ipsec_free_exchange_data",738,764
10,1,57,1,10,"ipsec_free_sa_data@768-778@sbin/isakmpd/ipsec.c","sbin/isakmpd/ipsec.c","ipsec_free_sa_data",768,778
7,2,41,1,7,"ipsec_free_proto_data@782-789@sbin/isakmpd/ipsec.c","sbin/isakmpd/ipsec.c","ipsec_free_proto_data",782,789
12,4,34,1,11,"ipsec_exchange_script@793-804@sbin/isakmpd/ipsec.c","sbin/isakmpd/ipsec.c","ipsec_exchange_script",793,804
4,1,12,1,3,"ipsec_init@808-811@sbin/isakmpd/ipsec.c","sbin/isakmpd/ipsec.c","ipsec_init",808,811
38,6,304,1,45,"ipsec_get_keystate@815-860@sbin/isakmpd/ipsec.c","sbin/isakmpd/ipsec.c","ipsec_get_keystate",815,860
4,1,17,1,3,"ipsec_setup_situation@863-866@sbin/isakmpd/ipsec.c","sbin/isakmpd/ipsec.c","ipsec_setup_situation",863,866
4,1,9,1,3,"ipsec_situation_size@869-872@sbin/isakmpd/ipsec.c","sbin/isakmpd/ipsec.c","ipsec_situation_size",869,872
4,1,10,1,3,"ipsec_spi_size@875-878@sbin/isakmpd/ipsec.c","sbin/isakmpd/ipsec.c","ipsec_spi_size",875,878
12,7,76,4,12,"ipsec_validate_attribute@881-893@sbin/isakmpd/ipsec.c","sbin/isakmpd/ipsec.c","ipsec_validate_attribute",881,893
4,2,16,1,3,"ipsec_validate_exchange@896-899@sbin/isakmpd/ipsec.c","sbin/isakmpd/ipsec.c","ipsec_validate_exchange",896,899
43,13,223,5,58,"ipsec_validate_id_information@902-960@sbin/isakmpd/ipsec.c","sbin/isakmpd/ipsec.c","ipsec_validate_id_information",902,960
4,1,14,2,4,"ipsec_validate_key_information@963-967@sbin/isakmpd/ipsec.c","sbin/isakmpd/ipsec.c","ipsec_validate_key_information",963,967
5,3,21,1,4,"ipsec_validate_notification@970-974@sbin/isakmpd/ipsec.c","sbin/isakmpd/ipsec.c","ipsec_validate_notification",970,974
5,3,21,1,4,"ipsec_validate_proto@977-981@sbin/isakmpd/ipsec.c","sbin/isakmpd/ipsec.c","ipsec_validate_proto",977,981
12,3,60,3,14,"ipsec_validate_situation@984-998@sbin/isakmpd/ipsec.c","sbin/isakmpd/ipsec.c","ipsec_validate_situation",984,998
19,13,87,2,23,"ipsec_validate_transform_id@1001-1024@sbin/isakmpd/ipsec.c","sbin/isakmpd/ipsec.c","ipsec_validate_transform_id",1001,1024
38,15,193,1,42,"ipsec_initiator@1027-1069@sbin/isakmpd/ipsec.c","sbin/isakmpd/ipsec.c","ipsec_initiator",1027,1069
38,8,265,5,52,"ipsec_delete_spi_list@1078-1130@sbin/isakmpd/ipsec.c","sbin/isakmpd/ipsec.c","ipsec_delete_spi_list",1078,1130
63,20,337,1,82,"ipsec_responder@1133-1215@sbin/isakmpd/ipsec.c","sbin/isakmpd/ipsec.c","ipsec_responder",1133,1215
16,6,47,1,15,"from_ike_hash@1218-1233@sbin/isakmpd/ipsec.c","sbin/isakmpd/ipsec.c","from_ike_hash",1218,1233
4,1,10,1,4,"from_ike_crypto@1236-1240@sbin/isakmpd/ipsec.c","sbin/isakmpd/ipsec.c","from_ike_crypto",1236,1240
84,48,349,4,93,"ipsec_is_attribute_incompatible@1248-1341@sbin/isakmpd/ipsec.c","sbin/isakmpd/ipsec.c","ipsec_is_attribute_incompatible",1248,1341
16,4,118,4,18,"ipsec_debug_attribute@1348-1366@sbin/isakmpd/ipsec.c","sbin/isakmpd/ipsec.c","ipsec_debug_attribute",1348,1366
149,40,595,4,156,"ipsec_decode_attribute@1374-1530@sbin/isakmpd/ipsec.c","sbin/isakmpd/ipsec.c","ipsec_decode_attribute",1374,1530
18,3,118,4,28,"ipsec_decode_transform@1538-1566@sbin/isakmpd/ipsec.c","sbin/isakmpd/ipsec.c","ipsec_decode_transform",1538,1566
19,11,143,3,32,"ipsec_delete_spi@1573-1605@sbin/isakmpd/ipsec.c","sbin/isakmpd/ipsec.c","ipsec_delete_spi",1573,1605
20,4,151,3,20,"ipsec_g_x@1612-1632@sbin/isakmpd/ipsec.c","sbin/isakmpd/ipsec.c","ipsec_g_x",1612,1632
23,4,139,1,23,"ipsec_gen_g_x@1636-1659@sbin/isakmpd/ipsec.c","sbin/isakmpd/ipsec.c","ipsec_gen_g_x",1636,1659
14,2,109,1,17,"ipsec_save_g_x@1663-1680@sbin/isakmpd/ipsec.c","sbin/isakmpd/ipsec.c","ipsec_save_g_x",1663,1680
14,2,98,3,16,"ipsec_get_spi@1687-1703@sbin/isakmpd/ipsec.c","sbin/isakmpd/ipsec.c","ipsec_get_spi",1687,1703
81,16,439,3,115,"ipsec_handle_leftover_payload@1712-1827@sbin/isakmpd/ipsec.c","sbin/isakmpd/ipsec.c","ipsec_handle_leftover_payload",1712,1827
23,10,102,1,25,"ipsec_esp_enckeylength@1831-1856@sbin/isakmpd/ipsec.c","sbin/isakmpd/ipsec.c","ipsec_esp_enckeylength",1831,1856
19,7,64,1,19,"ipsec_esp_authkeylength@1860-1879@sbin/isakmpd/ipsec.c","sbin/isakmpd/ipsec.c","ipsec_esp_authkeylength",1860,1879
18,7,56,1,17,"ipsec_ah_keylength@1883-1900@sbin/isakmpd/ipsec.c","sbin/isakmpd/ipsec.c","ipsec_ah_keylength",1883,1900
12,3,46,1,11,"ipsec_keymat_length@1904-1915@sbin/isakmpd/ipsec.c","sbin/isakmpd/ipsec.c","ipsec_keymat_length",1904,1915
38,11,205,3,39,"ipsec_get_proto_port@1919-1958@sbin/isakmpd/ipsec.c","sbin/isakmpd/ipsec.c","ipsec_get_proto_port",1919,1958
97,27,459,6,114,"ipsec_get_id@1967-2081@sbin/isakmpd/ipsec.c","sbin/isakmpd/ipsec.c","ipsec_get_id",1967,2081
58,11,354,5,69,"ipsec_decode_id@2088-2157@sbin/isakmpd/ipsec.c","sbin/isakmpd/ipsec.c","ipsec_decode_id",2088,2157
10,1,88,6,11,"ipsec_decode_ids@2160-2171@sbin/isakmpd/ipsec.c","sbin/isakmpd/ipsec.c","ipsec_decode_ids",2160,2171
37,9,243,2,43,"ipsec_build_id@2179-2222@sbin/isakmpd/ipsec.c","sbin/isakmpd/ipsec.c","ipsec_build_id",2179,2222
19,4,102,4,20,"ipsec_clone_id@2228-2248@sbin/isakmpd/ipsec.c","sbin/isakmpd/ipsec.c","ipsec_clone_id",2228,2248
8,3,49,2,8,"ipsec_proto_init@2256-2264@sbin/isakmpd/ipsec.c","sbin/isakmpd/ipsec.c","ipsec_proto_init",2256,2264
24,4,129,1,25,"ipsec_initial_contact@2271-2296@sbin/isakmpd/ipsec.c","sbin/isakmpd/ipsec.c","ipsec_initial_contact",2271,2296
7,2,72,2,7,"addr_cmp@2303-2310@sbin/isakmpd/ipsec.c","sbin/isakmpd/ipsec.c","addr_cmp",2303,2310
30,5,198,1,35,"ipsec_add_contact@2319-2354@sbin/isakmpd/ipsec.c","sbin/isakmpd/ipsec.c","ipsec_add_contact",2319,2354
8,2,67,1,8,"ipsec_contacted@2358-2366@sbin/isakmpd/ipsec.c","sbin/isakmpd/ipsec.c","ipsec_contacted",2358,2366
16,3,78,2,16,"ipsec_add_hash_payload@2370-2386@sbin/isakmpd/ipsec.c","sbin/isakmpd/ipsec.c","ipsec_add_hash_payload",2370,2386
44,5,329,1,53,"ipsec_fill_in_hash@2390-2443@sbin/isakmpd/ipsec.c","sbin/isakmpd/ipsec.c","ipsec_fill_in_hash",2390,2443
11,2,63,1,11,"ipsec_informational_pre_hook@2447-2458@sbin/isakmpd/ipsec.c","sbin/isakmpd/ipsec.c","ipsec_informational_pre_hook",2447,2458
6,2,25,1,5,"ipsec_informational_post_hook@2464-2469@sbin/isakmpd/ipsec.c","sbin/isakmpd/ipsec.c","ipsec_informational_post_hook",2464,2469
36,12,170,2,36,"ipsec_id_size@2472-2508@sbin/isakmpd/ipsec.c","sbin/isakmpd/ipsec.c","ipsec_id_size",2472,2508
60,14,343,2,83,"ipsec_id_string@2514-2597@sbin/isakmpd/ipsec.c","sbin/isakmpd/ipsec.c","ipsec_id_string",2514,2597
193,46,1034,1,254,"cfg_initiator_send_ATTR@95-349@sbin/isakmpd/isakmp_cfg.c","sbin/isakmpd/isakmp_cfg.c","cfg_initiator_send_ATTR",95,349
85,16,487,1,102,"cfg_initiator_recv_ATTR@356-458@sbin/isakmpd/isakmp_cfg.c","sbin/isakmpd/isakmp_cfg.c","cfg_initiator_recv_ATTR",356,458
52,10,300,1,74,"cfg_responder_recv_ATTR@465-539@sbin/isakmpd/isakmp_cfg.c","sbin/isakmpd/isakmp_cfg.c","cfg_responder_recv_ATTR",465,539
39,10,236,1,42,"cfg_responder_send_ATTR@546-588@sbin/isakmpd/isakmp_cfg.c","sbin/isakmpd/isakmp_cfg.c","cfg_responder_send_ATTR",546,588
18,3,104,1,18,"cfg_add_hash@591-609@sbin/isakmpd/isakmp_cfg.c","sbin/isakmpd/isakmp_cfg.c","cfg_add_hash",591,609
17,2,126,4,18,"cfg_finalize_hash@612-630@sbin/isakmpd/isakmp_cfg.c","sbin/isakmpd/isakmp_cfg.c","cfg_finalize_hash",612,630
46,5,288,1,53,"cfg_verify_hash@633-686@sbin/isakmpd/isakmp_cfg.c","sbin/isakmpd/isakmp_cfg.c","cfg_verify_hash",633,686
34,8,185,4,35,"cfg_decode_attribute@694-729@sbin/isakmpd/isakmp_cfg.c","sbin/isakmpd/isakmp_cfg.c","cfg_decode_attribute",694,729
206,73,923,6,244,"cfg_encode_attributes@735-979@sbin/isakmpd/isakmp_cfg.c","sbin/isakmpd/isakmp_cfg.c","cfg_encode_attributes",735,979
4,1,12,1,3,"isakmp_doi_init@105-108@sbin/isakmpd/isakmp_doi.c","sbin/isakmpd/isakmp_doi.c","isakmp_doi_init",105,108
5,1,21,4,5,"isakmp_debug_attribute@111-116@sbin/isakmpd/isakmp_doi.c","sbin/isakmpd/isakmp_doi.c","isakmp_debug_attribute",111,116
3,1,9,1,2,"isakmp_finalize_exchange@119-121@sbin/isakmpd/isakmp_doi.c","sbin/isakmpd/isakmp_doi.c","isakmp_finalize_exchange",119,121
4,1,12,1,3,"isakmp_get_keystate@124-127@sbin/isakmpd/isakmp_doi.c","sbin/isakmpd/isakmp_doi.c","isakmp_get_keystate",124,127
3,1,8,1,3,"isakmp_setup_situation@130-133@sbin/isakmpd/isakmp_doi.c","sbin/isakmpd/isakmp_doi.c","isakmp_setup_situation",130,133
4,1,9,1,3,"isakmp_situation_size@136-139@sbin/isakmpd/isakmp_doi.c","sbin/isakmpd/isakmp_doi.c","isakmp_situation_size",136,139
4,1,10,1,4,"isakmp_spi_size@142-146@sbin/isakmpd/isakmp_doi.c","sbin/isakmpd/isakmp_doi.c","isakmp_spi_size",142,146
5,1,22,4,5,"isakmp_validate_attribute@149-154@sbin/isakmpd/isakmp_doi.c","sbin/isakmpd/isakmp_doi.c","isakmp_validate_attribute",149,154
4,1,11,1,4,"isakmp_validate_exchange@157-161@sbin/isakmpd/isakmp_doi.c","sbin/isakmpd/isakmp_doi.c","isakmp_validate_exchange",157,161
5,1,31,5,4,"isakmp_validate_id_information@164-168@sbin/isakmpd/isakmp_doi.c","sbin/isakmpd/isakmp_doi.c","isakmp_validate_id_information",164,168
4,1,14,2,4,"isakmp_validate_key_information@171-175@sbin/isakmpd/isakmp_doi.c","sbin/isakmpd/isakmp_doi.c","isakmp_validate_key_information",171,175
4,1,11,1,4,"isakmp_validate_notification@178-182@sbin/isakmpd/isakmp_doi.c","sbin/isakmpd/isakmp_doi.c","isakmp_validate_notification",178,182
4,1,11,1,4,"isakmp_validate_proto@185-189@sbin/isakmpd/isakmp_doi.c","sbin/isakmpd/isakmp_doi.c","isakmp_validate_proto",185,189
5,1,23,3,5,"isakmp_validate_situation@192-197@sbin/isakmpd/isakmp_doi.c","sbin/isakmpd/isakmp_doi.c","isakmp_validate_situation",192,197
4,1,14,2,4,"isakmp_validate_transform_id@200-204@sbin/isakmpd/isakmp_doi.c","sbin/isakmpd/isakmp_doi.c","isakmp_validate_transform_id",200,204
9,2,49,1,8,"isakmp_initiator@207-215@sbin/isakmpd/isakmp_doi.c","sbin/isakmpd/isakmp_doi.c","isakmp_initiator",207,215
40,8,193,1,48,"isakmp_responder@218-266@sbin/isakmpd/isakmp_doi.c","sbin/isakmpd/isakmp_doi.c","isakmp_responder",218,266
10,1,27,1,10,"usage@112-122@sbin/isakmpd/isakmpd.c","sbin/isakmpd/isakmpd.c","usage",112,122
82,27,318,2,103,"parse_args@125-228@sbin/isakmpd/isakmpd.c","sbin/isakmpd/isakmpd.c","parse_args",125,228
4,1,11,1,3,"sighup@232-235@sbin/isakmpd/isakmpd.c","sbin/isakmpd/isakmpd.c","sighup",232,235
17,2,81,1,19,"report@239-258@sbin/isakmpd/isakmpd.c","sbin/isakmpd/isakmpd.c","report",239,258
4,1,11,1,3,"sigusr1@261-264@sbin/isakmpd/isakmpd.c","sbin/isakmpd/isakmpd.c","sigusr1",261,264
4,1,20,2,3,"phase2_sa_check@267-270@sbin/isakmpd/isakmpd.c","sbin/isakmpd/isakmpd.c","phase2_sa_check",267,270
4,1,20,2,3,"phase1_sa_check@273-276@sbin/isakmpd/isakmpd.c","sbin/isakmpd/isakmpd.c","phase1_sa_check",273,276
11,3,63,1,20,"set_slave_signals@279-299@sbin/isakmpd/isakmpd.c","sbin/isakmpd/isakmpd.c","set_slave_signals",279,299
20,7,109,1,34,"daemon_shutdown@302-336@sbin/isakmpd/isakmpd.c","sbin/isakmpd/isakmpd.c","daemon_shutdown",302,336
4,1,11,1,3,"daemon_shutdown_now@341-344@sbin/isakmpd/isakmpd.c","sbin/isakmpd/isakmpd.c","daemon_shutdown_now",341,344
14,3,71,1,15,"write_pid_file@348-363@sbin/isakmpd/isakmpd.c","sbin/isakmpd/isakmpd.c","write_pid_file",348,363
19,7,117,1,20,"sanitise_stdfd@366-386@sbin/isakmpd/isakmpd.c","sbin/isakmpd/isakmpd.c","sanitise_stdfd",366,386
86,23,467,2,146,"main@389-535@sbin/isakmpd/isakmpd.c","sbin/isakmpd/isakmpd.c","main",389,535
15,4,54,3,14,"key_free@34-48@sbin/isakmpd/key.c","sbin/isakmpd/key.c","key_free",34,48
40,7,216,5,41,"key_serialize@52-93@sbin/isakmpd/key.c","sbin/isakmpd/key.c","key_serialize",52,93
13,3,59,4,14,"key_printable@97-111@sbin/isakmpd/key.c","sbin/isakmpd/key.c","key_printable",97,111
30,8,138,4,33,"key_internalize@115-148@sbin/isakmpd/key.c","sbin/isakmpd/key.c","key_internalize",115,148
35,5,168,5,37,"key_from_printable@152-189@sbin/isakmpd/key.c","sbin/isakmpd/key.c","key_from_printable",152,189
5,2,14,1,8,"libcrypto_init@36-44@sbin/isakmpd/libcrypto.c","sbin/isakmpd/libcrypto.c","libcrypto_init",36,44
7,2,21,1,6,"log_init@95-101@sbin/isakmpd/log.c","sbin/isakmpd/log.c","log_init",95,101
29,7,171,1,30,"log_reinit@104-134@sbin/isakmpd/log.c","sbin/isakmpd/log.c","log_reinit",104,134
8,4,39,1,7,"log_to@137-144@sbin/isakmpd/log.c","sbin/isakmpd/log.c","log_to",137,144
4,1,9,1,3,"log_current@147-150@sbin/isakmpd/log.c","sbin/isakmpd/log.c","log_current",147,150
10,3,42,1,11,"_log_get_class@153-164@sbin/isakmpd/log.c","sbin/isakmpd/log.c","_log_get_class",153,164
45,13,355,6,59,"_log_print@167-226@sbin/isakmpd/log.c","sbin/isakmpd/log.c","_log_print",167,226
9,4,71,4,13,"log_debug@229-242@sbin/isakmpd/log.c","sbin/isakmpd/log.c","log_debug",229,242
25,8,188,5,30,"log_debug_buf@245-275@sbin/isakmpd/log.c","sbin/isakmpd/log.c","log_debug_buf",245,275
20,5,92,2,19,"log_debug_cmd@278-297@sbin/isakmpd/log.c","sbin/isakmpd/log.c","log_debug_cmd",278,297
15,2,89,1,15,"log_debug_toggle@300-315@sbin/isakmpd/log.c","sbin/isakmpd/log.c","log_debug_toggle",300,315
7,1,41,2,7,"log_print@318-325@sbin/isakmpd/log.c","sbin/isakmpd/log.c","log_print",318,325
9,2,49,2,10,"log_verbose@328-338@sbin/isakmpd/log.c","sbin/isakmpd/log.c","log_verbose",328,338
7,1,41,2,7,"log_error@341-348@sbin/isakmpd/log.c","sbin/isakmpd/log.c","log_error",341,348
7,1,41,2,7,"log_errorx@351-358@sbin/isakmpd/log.c","sbin/isakmpd/log.c","log_errorx",351,358
8,1,46,2,8,"log_fatal@361-369@sbin/isakmpd/log.c","sbin/isakmpd/log.c","log_fatal",361,369
8,1,46,2,8,"log_fatalx@372-380@sbin/isakmpd/log.c","sbin/isakmpd/log.c","log_fatalx",372,380
55,11,283,1,71,"log_packet_init@383-454@sbin/isakmpd/log.c","sbin/isakmpd/log.c","log_packet_init",383,454
14,4,50,1,13,"log_packet_restart@457-470@sbin/isakmpd/log.c","sbin/isakmpd/log.c","log_packet_restart",457,470
8,2,26,1,8,"log_packet_stop@473-481@sbin/isakmpd/log.c","sbin/isakmpd/log.c","log_packet_stop",473,481
84,10,743,4,108,"log_packet_iov@484-592@sbin/isakmpd/log.c","sbin/isakmpd/log.c","log_packet_iov",484,592
64,10,485,3,76,"udp_cksum@596-672@sbin/isakmpd/log.c","sbin/isakmpd/log.c","udp_cksum",596,672
15,3,95,2,16,"in_cksum@676-692@sbin/isakmpd/log.c","sbin/isakmpd/log.c","in_cksum",676,692
36,7,258,3,40,"message_alloc@113-153@sbin/isakmpd/message.c","sbin/isakmpd/message.c","message_alloc",113,153
11,2,67,1,11,"message_alloc_reply@160-171@sbin/isakmpd/message.c","sbin/isakmpd/message.c","message_alloc_reply",160,171
37,14,279,1,41,"message_free@175-216@sbin/isakmpd/message.c","sbin/isakmpd/message.c","message_free",175,216
86,14,502,6,104,"message_parse_payloads@228-332@sbin/isakmpd/message.c","sbin/isakmpd/message.c","message_parse_payloads",228,332
16,3,104,4,19,"message_parse_proposal@341-360@sbin/isakmpd/message.c","sbin/isakmpd/message.c","message_parse_proposal",341,360
12,2,84,4,14,"message_parse_transform@363-377@sbin/isakmpd/message.c","sbin/isakmpd/message.c","message_parse_transform",363,377
47,24,137,1,47,"message_get_field@380-427@sbin/isakmpd/message.c","sbin/isakmpd/message.c","message_get_field",380,427
48,24,241,3,48,"message_validate_payload@430-478@sbin/isakmpd/message.c","sbin/isakmpd/message.c","message_validate_payload",430,478
46,24,135,1,46,"message_payload_sz@482-528@sbin/isakmpd/message.c","sbin/isakmpd/message.c","message_payload_sz",482,528
19,4,95,2,19,"message_validate_attribute@532-551@sbin/isakmpd/message.c","sbin/isakmpd/message.c","message_validate_attribute",532,551
9,2,47,2,8,"message_validate_cert@555-563@sbin/isakmpd/message.c","sbin/isakmpd/message.c","message_validate_cert",555,563
19,5,118,2,23,"message_validate_cert_req@567-590@sbin/isakmpd/message.c","sbin/isakmpd/message.c","message_validate_cert_req",567,590
84,15,511,2,97,"message_validate_delete@597-694@sbin/isakmpd/message.c","sbin/isakmpd/message.c","message_validate_delete",597,694
52,8,385,2,68,"message_validate_hash@700-768@sbin/isakmpd/message.c","sbin/isakmpd/message.c","message_validate_hash",700,768
19,4,122,2,20,"message_validate_id@772-792@sbin/isakmpd/message.c","sbin/isakmpd/message.c","message_validate_id",772,792
18,4,108,2,19,"message_validate_key_exch@796-815@sbin/isakmpd/message.c","sbin/isakmpd/message.c","message_validate_key_exch",796,815
17,3,94,2,22,"message_validate_nat_d@819-841@sbin/isakmpd/message.c","sbin/isakmpd/message.c","message_validate_nat_d",819,841
11,3,61,2,17,"message_validate_nat_oa@845-862@sbin/isakmpd/message.c","sbin/isakmpd/message.c","message_validate_nat_oa",845,862
9,2,48,2,10,"message_validate_nonce@866-876@sbin/isakmpd/message.c","sbin/isakmpd/message.c","message_validate_nonce",866,876
54,20,312,2,59,"message_validate_notify@883-942@sbin/isakmpd/message.c","sbin/isakmpd/message.c","message_validate_notify",883,942
24,6,155,2,29,"message_validate_proposal@946-975@sbin/isakmpd/message.c","sbin/isakmpd/message.c","message_validate_proposal",946,975
56,12,344,2,82,"message_validate_sa@989-1071@sbin/isakmpd/message.c","sbin/isakmpd/message.c","message_validate_sa",989,1071
9,2,48,2,10,"message_validate_sig@1075-1085@sbin/isakmpd/message.c","sbin/isakmpd/message.c","message_validate_sig",1075,1085
36,7,242,2,44,"message_validate_transform@1089-1133@sbin/isakmpd/message.c","sbin/isakmpd/message.c","message_validate_transform",1089,1133
19,4,121,2,20,"message_validate_vendor@1137-1157@sbin/isakmpd/message.c","sbin/isakmpd/message.c","message_validate_vendor",1137,1157
15,2,87,4,16,"message_index_payload@1166-1182@sbin/isakmpd/message.c","sbin/isakmpd/message.c","message_index_payload",1166,1182
18,5,131,2,18,"message_sort_payloads@1191-1209@sbin/isakmpd/message.c","sbin/isakmpd/message.c","message_sort_payloads",1191,1209
17,4,116,1,17,"message_validate_payloads@1213-1230@sbin/isakmpd/message.c","sbin/isakmpd/message.c","message_validate_payloads",1213,1230
202,50,1221,1,289,"message_recv@1238-1527@sbin/isakmpd/message.c","sbin/isakmpd/message.c","message_recv",1238,1527
5,1,20,1,5,"message_send_expire@1530-1535@sbin/isakmpd/message.c","sbin/isakmpd/message.c","message_send_expire",1530,1535
39,10,254,1,55,"message_send@1539-1594@sbin/isakmpd/message.c","sbin/isakmpd/message.c","message_send",1539,1594
14,1,110,4,14,"message_setup_header@1602-1616@sbin/isakmpd/message.c","sbin/isakmpd/message.c","message_setup_header",1602,1616
36,4,254,5,42,"message_add_payload@1627-1669@sbin/isakmpd/message.c","sbin/isakmpd/message.c","message_add_payload",1627,1669
19,9,181,5,19,"message_send_notification@1706-1725@sbin/isakmpd/message.c","sbin/isakmpd/message.c","message_send_notification",1706,1725
39,8,231,1,46,"message_send_delete@1729-1775@sbin/isakmpd/message.c","sbin/isakmpd/message.c","message_send_delete",1729,1775
12,1,94,3,13,"message_send_dpd_notify@1778-1791@sbin/isakmpd/message.c","sbin/isakmpd/message.c","message_send_dpd_notify",1778,1791
64,13,411,1,74,"message_send_info@1795-1869@sbin/isakmpd/message.c","sbin/isakmpd/message.c","message_send_info",1795,1869
33,7,193,5,37,"message_drop@1878-1915@sbin/isakmpd/message.c","sbin/isakmpd/message.c","message_drop",1878,1915
22,6,222,3,22,"message_dump_raw@1922-1944@sbin/isakmpd/message.c","sbin/isakmpd/message.c","message_dump_raw",1922,1944
18,6,155,1,23,"message_packet_log@1947-1970@sbin/isakmpd/message.c","sbin/isakmpd/message.c","message_packet_log",1947,1970
35,5,351,1,48,"message_encrypt@1979-2027@sbin/isakmpd/message.c","sbin/isakmpd/message.c","message_encrypt",1979,2027
37,9,236,1,50,"message_check_duplicate@2034-2084@sbin/isakmpd/message.c","sbin/isakmpd/message.c","message_check_duplicate",2034,2084
10,2,54,3,9,"step_transform@2088-2097@sbin/isakmpd/message.c","sbin/isakmpd/message.c","step_transform",2088,2097
104,29,639,2,172,"message_negotiate_sa@2104-2276@sbin/isakmpd/message.c","sbin/isakmpd/message.c","message_negotiate_sa",2104,2276
137,20,894,1,162,"message_add_sa_payload@2283-2445@sbin/isakmpd/message.c","sbin/isakmpd/message.c","message_add_sa_payload",2283,2445
26,6,200,3,29,"message_copy@2452-2481@sbin/isakmpd/message.c","sbin/isakmpd/message.c","message_copy",2452,2481
11,2,64,2,11,"message_register_post_send@2485-2496@sbin/isakmpd/message.c","sbin/isakmpd/message.c","message_register_post_send",2485,2496
9,2,56,1,9,"message_post_send@2500-2509@sbin/isakmpd/message.c","sbin/isakmpd/message.c","message_post_send",2500,2509
4,1,24,2,3,"payload_first@2512-2515@sbin/isakmpd/message.c","sbin/isakmpd/message.c","payload_first",2512,2515
43,14,315,1,57,"monitor_init@87-144@sbin/isakmpd/monitor.c","sbin/isakmpd/monitor.c","monitor_init",87,144
15,4,83,1,20,"monitor_exit@147-167@sbin/isakmpd/monitor.c","sbin/isakmpd/monitor.c","monitor_exit",147,167
18,3,80,1,20,"monitor_pf_key_v2_open@170-190@sbin/isakmpd/monitor.c","sbin/isakmpd/monitor.c","monitor_pf_key_v2_open",170,190
29,4,176,3,35,"monitor_open@193-228@sbin/isakmpd/monitor.c","sbin/isakmpd/monitor.c","monitor_open",193,228
39,10,220,2,45,"monitor_fopen@231-276@sbin/isakmpd/monitor.c","sbin/isakmpd/monitor.c","monitor_fopen",231,276
12,2,69,2,14,"monitor_stat@279-293@sbin/isakmpd/monitor.c","sbin/isakmpd/monitor.c","monitor_stat",279,293
20,3,128,5,22,"monitor_setsockopt@296-318@sbin/isakmpd/monitor.c","sbin/isakmpd/monitor.c","monitor_setsockopt",296,318
17,3,105,3,19,"monitor_bind@321-340@sbin/isakmpd/monitor.c","sbin/isakmpd/monitor.c","monitor_bind",321,340
14,2,81,1,17,"monitor_req_readdir@343-360@sbin/isakmpd/monitor.c","sbin/isakmpd/monitor.c","monitor_req_readdir",343,360
14,3,73,2,14,"monitor_readdir@363-377@sbin/isakmpd/monitor.c","sbin/isakmpd/monitor.c","monitor_readdir",363,377
6,1,22,1,6,"monitor_init_done@380-386@sbin/isakmpd/monitor.c","sbin/isakmpd/monitor.c","monitor_init_done",380,386
9,2,50,1,11,"set_monitor_signals@393-404@sbin/isakmpd/monitor.c","sbin/isakmpd/monitor.c","set_monitor_signals",393,404
7,2,33,1,7,"sig_pass_to_chld@407-414@sbin/isakmpd/monitor.c","sbin/isakmpd/monitor.c","sig_pass_to_chld",407,414
46,10,177,1,56,"monitor_loop@418-474@sbin/isakmpd/monitor.c","sbin/isakmpd/monitor.c","monitor_loop",418,474
14,4,73,1,16,"m_priv_pfkey_open@479-495@sbin/isakmpd/monitor.c","sbin/isakmpd/monitor.c","m_priv_pfkey_open",479,495
33,9,210,1,38,"m_priv_getfd@499-537@sbin/isakmpd/monitor.c","sbin/isakmpd/monitor.c","m_priv_getfd",499,537
36,5,198,1,43,"m_priv_setsockopt@541-584@sbin/isakmpd/monitor.c","sbin/isakmpd/monitor.c","m_priv_setsockopt",541,584
36,5,191,1,41,"m_priv_bind@588-629@sbin/isakmpd/monitor.c","sbin/isakmpd/monitor.c","m_priv_bind",588,629
18,6,86,2,18,"must_read@640-658@sbin/isakmpd/monitor.c","sbin/isakmpd/monitor.c","must_read",640,658
18,6,88,2,18,"must_write@665-683@sbin/isakmpd/monitor.c","sbin/isakmpd/monitor.c","must_write",665,683
18,7,122,3,31,"m_priv_local_sanitize_path@687-718@sbin/isakmpd/monitor.c","sbin/isakmpd/monitor.c","m_priv_local_sanitize_path",687,718
30,14,92,2,35,"m_priv_check_sockopt@722-757@sbin/isakmpd/monitor.c","sbin/isakmpd/monitor.c","m_priv_check_sockopt",722,757
38,9,193,2,40,"m_priv_check_bind@761-801@sbin/isakmpd/monitor.c","sbin/isakmpd/monitor.c","m_priv_check_bind",761,801
52,11,332,0,61,"m_priv_req_readdir@804-865@sbin/isakmpd/monitor.c","sbin/isakmpd/monitor.c","m_priv_req_readdir",804,865
33,3,208,2,35,"mm_send_fd@39-74@sbin/isakmpd/monitor_fdpass.c","sbin/isakmpd/monitor_fdpass.c","mm_send_fd",39,74
41,5,221,1,42,"mm_receive_fd@77-119@sbin/isakmpd/monitor_fdpass.c","sbin/isakmpd/monitor_fdpass.c","mm_receive_fd",77,119
4,1,10,1,3,"nat_t_init@84-87@sbin/isakmpd/nat_traversal.c","sbin/isakmpd/nat_traversal.c","nat_t_init",84,87
36,5,248,1,44,"nat_t_setup_hashes@91-135@sbin/isakmpd/nat_traversal.c","sbin/isakmpd/nat_traversal.c","nat_t_setup_hashes",91,135
20,4,114,2,22,"nat_t_add_vendor_payload@139-161@sbin/isakmpd/nat_traversal.c","sbin/isakmpd/nat_traversal.c","nat_t_add_vendor_payload",139,161
10,4,52,1,11,"nat_t_add_vendor_payloads@165-176@sbin/isakmpd/nat_traversal.c","sbin/isakmpd/nat_traversal.c","nat_t_add_vendor_payloads",165,176
24,5,136,2,28,"nat_t_check_vendor_payload@182-210@sbin/isakmpd/nat_traversal.c","sbin/isakmpd/nat_traversal.c","nat_t_check_vendor_payload",182,210
30,3,214,3,34,"nat_t_generate_nat_d_hash@214-248@sbin/isakmpd/nat_traversal.c","sbin/isakmpd/nat_traversal.c","nat_t_generate_nat_d_hash",214,248
35,6,195,2,39,"nat_t_add_nat_d@252-291@sbin/isakmpd/nat_traversal.c","sbin/isakmpd/nat_traversal.c","nat_t_add_nat_d",252,291
11,3,75,1,13,"nat_t_exchange_add_nat_d@295-308@sbin/isakmpd/nat_traversal.c","sbin/isakmpd/nat_traversal.c","nat_t_exchange_add_nat_d",295,308
24,6,145,2,31,"nat_t_match_nat_d_payload@312-343@sbin/isakmpd/nat_traversal.c","sbin/isakmpd/nat_traversal.c","nat_t_match_nat_d_payload",312,343
26,6,156,1,33,"nat_t_exchange_check_nat_d@350-383@sbin/isakmpd/nat_traversal.c","sbin/isakmpd/nat_traversal.c","nat_t_exchange_check_nat_d",350,383
19,3,122,1,23,"nat_t_send_keepalive@386-409@sbin/isakmpd/nat_traversal.c","sbin/isakmpd/nat_traversal.c","nat_t_send_keepalive",386,409
20,4,124,1,24,"nat_t_setup_keepalive@412-436@sbin/isakmpd/nat_traversal.c","sbin/isakmpd/nat_traversal.c","nat_t_setup_keepalive",412,436
22,3,115,2,23,"pf_key_v2_msg_new@124-147@sbin/isakmpd/pf_key_v2.c","sbin/isakmpd/pf_key_v2.c","pf_key_v2_msg_new",124,147
14,2,90,3,14,"pf_key_v2_msg_add@151-165@sbin/isakmpd/pf_key_v2.c","sbin/isakmpd/pf_key_v2.c","pf_key_v2_msg_add",151,165
13,3,68,1,13,"pf_key_v2_msg_free@169-182@sbin/isakmpd/pf_key_v2.c","sbin/isakmpd/pf_key_v2.c","pf_key_v2_msg_free",169,182
5,1,16,1,5,"pf_key_v2_seq@186-191@sbin/isakmpd/pf_key_v2.c","sbin/isakmpd/pf_key_v2.c","pf_key_v2_seq",186,191
99,20,556,1,116,"pf_key_v2_read@199-315@sbin/isakmpd/pf_key_v2.c","sbin/isakmpd/pf_key_v2.c","pf_key_v2_read",199,315
53,10,358,1,65,"pf_key_v2_write@319-384@sbin/isakmpd/pf_key_v2.c","sbin/isakmpd/pf_key_v2.c","pf_key_v2_write",319,384
8,2,33,1,8,"pf_key_v2_call@391-399@sbin/isakmpd/pf_key_v2.c","sbin/isakmpd/pf_key_v2.c","pf_key_v2_call",391,399
9,3,56,2,9,"pf_key_v2_find_ext@403-412@sbin/isakmpd/pf_key_v2.c","sbin/isakmpd/pf_key_v2.c","pf_key_v2_find_ext",403,412
73,13,407,1,86,"pf_key_v2_open@419-505@sbin/isakmpd/pf_key_v2.c","sbin/isakmpd/pf_key_v2.c","pf_key_v2_open",419,505
121,23,778,5,135,"pf_key_v2_get_spi@512-647@sbin/isakmpd/pf_key_v2.c","sbin/isakmpd/pf_key_v2.c","pf_key_v2_get_spi",512,647
147,26,941,4,170,"pf_key_v2_get_kernel_sa@651-821@sbin/isakmpd/pf_key_v2.c","sbin/isakmpd/pf_key_v2.c","pf_key_v2_get_kernel_sa",651,821
39,7,285,5,41,"pf_key_v2_setup_sockaddr@824-865@sbin/isakmpd/pf_key_v2.c","sbin/isakmpd/pf_key_v2.c","pf_key_v2_setup_sockaddr",824,865
463,114,2916,4,569,"pf_key_v2_set_spi@873-1442@sbin/isakmpd/pf_key_v2.c","sbin/isakmpd/pf_key_v2.c","pf_key_v2_set_spi",873,1442
5,1,29,1,5,"pf_key_v2_mask_to_bits@1445-1450@sbin/isakmpd/pf_key_v2.c","sbin/isakmpd/pf_key_v2.c","pf_key_v2_mask_to_bits",1445,1450
6,2,31,1,6,"pf_key_v2_mask6_to_bits@1453-1459@sbin/isakmpd/pf_key_v2.c","sbin/isakmpd/pf_key_v2.c","pf_key_v2_mask6_to_bits",1453,1459
191,46,1283,20,223,"pf_key_v2_flow@1466-1689@sbin/isakmpd/pf_key_v2.c","sbin/isakmpd/pf_key_v2.c","pf_key_v2_flow",1466,1689
95,22,617,4,105,"pf_key_v2_convert_id@1692-1797@sbin/isakmpd/pf_key_v2.c","sbin/isakmpd/pf_key_v2.c","pf_key_v2_convert_id",1692,1797
42,6,372,2,47,"pf_key_v2_enable_sa@1801-1848@sbin/isakmpd/pf_key_v2.c","sbin/isakmpd/pf_key_v2.c","pf_key_v2_enable_sa",1801,1848
13,3,80,2,15,"pf_key_v2_conf_refinc@1852-1867@sbin/isakmpd/pf_key_v2.c","sbin/isakmpd/pf_key_v2.c","pf_key_v2_conf_refinc",1852,1867
16,4,98,2,17,"pf_key_v2_conf_refhandle@1874-1891@sbin/isakmpd/pf_key_v2.c","sbin/isakmpd/pf_key_v2.c","pf_key_v2_conf_refhandle",1874,1891
42,7,264,1,58,"pf_key_v2_remove_conf@1895-1953@sbin/isakmpd/pf_key_v2.c","sbin/isakmpd/pf_key_v2.c","pf_key_v2_remove_conf",1895,1953
19,2,216,2,20,"pf_key_v2_disable_sa@1957-1977@sbin/isakmpd/pf_key_v2.c","sbin/isakmpd/pf_key_v2.c","pf_key_v2_disable_sa",1957,1977
116,23,755,3,129,"pf_key_v2_delete_spi@1984-2113@sbin/isakmpd/pf_key_v2.c","sbin/isakmpd/pf_key_v2.c","pf_key_v2_delete_spi",1984,2113
13,5,76,3,19,"pf_key_v2_stayalive@2116-2135@sbin/isakmpd/pf_key_v2.c","sbin/isakmpd/pf_key_v2.c","pf_key_v2_stayalive",2116,2135
12,2,66,1,11,"pf_key_v2_connection_check@2139-2150@sbin/isakmpd/pf_key_v2.c","sbin/isakmpd/pf_key_v2.c","pf_key_v2_connection_check",2139,2150
75,17,401,1,103,"pf_key_v2_expire@2154-2257@sbin/isakmpd/pf_key_v2.c","sbin/isakmpd/pf_key_v2.c","pf_key_v2_expire",2154,2257
11,3,59,1,11,"mask4len@2260-2271@sbin/isakmpd/pf_key_v2.c","sbin/isakmpd/pf_key_v2.c","mask4len",2260,2271
12,5,81,1,12,"mask6len@2278-2290@sbin/isakmpd/pf_key_v2.c","sbin/isakmpd/pf_key_v2.c","mask6len",2278,2290
14,4,137,7,15,"phase2id@2293-2308@sbin/isakmpd/pf_key_v2.c","sbin/isakmpd/pf_key_v2.c","phase2id",2293,2308
671,162,4232,1,853,"pf_key_v2_acquire@2312-3165@sbin/isakmpd/pf_key_v2.c","sbin/isakmpd/pf_key_v2.c","pf_key_v2_acquire",2312,3165
16,4,82,1,17,"pf_key_v2_notify@3168-3185@sbin/isakmpd/pf_key_v2.c","sbin/isakmpd/pf_key_v2.c","pf_key_v2_notify",3168,3185
15,4,64,1,21,"pf_key_v2_handler@3188-3209@sbin/isakmpd/pf_key_v2.c","sbin/isakmpd/pf_key_v2.c","pf_key_v2_handler",3188,3209
124,20,774,4,138,"pf_key_v2_group_spis@3217-3355@sbin/isakmpd/pf_key_v2.c","sbin/isakmpd/pf_key_v2.c","pf_key_v2_group_spis",3217,3355
20,4,154,4,21,"my_inet_ntop4@82-103@sbin/isakmpd/policy.c","sbin/isakmpd/policy.c","my_inet_ntop4",82,103
16,3,163,3,16,"my_inet_ntop6@106-122@sbin/isakmpd/policy.c","sbin/isakmpd/policy.c","my_inet_ntop6",106,122
1532,274,7977,1,1796,"policy_callback@125-1921@sbin/isakmpd/policy.c","sbin/isakmpd/policy.c","policy_callback",125,1921
45,13,308,1,67,"policy_init@1924-1991@sbin/isakmpd/policy.c","sbin/isakmpd/policy.c","policy_init",1924,1991
4,1,9,1,3,"keynote_cert_init@1995-1998@sbin/isakmpd/policy.c","sbin/isakmpd/policy.c","keynote_cert_init",1995,1998
9,2,50,2,10,"keynote_cert_get@2002-2012@sbin/isakmpd/policy.c","sbin/isakmpd/policy.c","keynote_cert_get",2002,2012
22,6,135,1,25,"keynote_cert_validate@2019-2044@sbin/isakmpd/policy.c","sbin/isakmpd/policy.c","keynote_cert_validate",2019,2044
13,4,87,2,16,"keynote_cert_insert@2048-2064@sbin/isakmpd/policy.c","sbin/isakmpd/policy.c","keynote_cert_insert",2048,2064
4,1,13,1,3,"keynote_cert_free@2068-2071@sbin/isakmpd/policy.c","sbin/isakmpd/policy.c","keynote_cert_free",2068,2071
19,3,108,2,22,"keynote_certreq_validate@2075-2097@sbin/isakmpd/policy.c","sbin/isakmpd/policy.c","keynote_certreq_validate",2075,2097
4,1,18,3,4,"keynote_certreq_decode@2101-2105@sbin/isakmpd/policy.c","sbin/isakmpd/policy.c","keynote_certreq_decode",2101,2105
3,1,8,1,3,"keynote_free_aca@2108-2111@sbin/isakmpd/policy.c","sbin/isakmpd/policy.c","keynote_free_aca",2108,2111
93,15,541,5,103,"keynote_cert_obtain@2114-2217@sbin/isakmpd/policy.c","sbin/isakmpd/policy.c","keynote_cert_obtain",2114,2217
5,1,24,4,4,"keynote_cert_get_subjects@2221-2225@sbin/isakmpd/policy.c","sbin/isakmpd/policy.c","keynote_cert_get_subjects",2221,2225
43,11,268,2,46,"keynote_cert_get_key@2229-2275@sbin/isakmpd/policy.c","sbin/isakmpd/policy.c","keynote_cert_get_key",2229,2275
4,1,18,1,3,"keynote_cert_dup@2278-2281@sbin/isakmpd/policy.c","sbin/isakmpd/policy.c","keynote_cert_dup",2278,2281
7,2,57,3,7,"keynote_serialize@2284-2291@sbin/isakmpd/policy.c","sbin/isakmpd/policy.c","keynote_serialize",2284,2291
4,1,18,1,3,"keynote_printable@2295-2298@sbin/isakmpd/policy.c","sbin/isakmpd/policy.c","keynote_printable",2295,2298
4,1,14,1,3,"keynote_from_printable@2302-2305@sbin/isakmpd/policy.c","sbin/isakmpd/policy.c","keynote_from_printable",2302,2305
4,1,9,1,3,"keynote_ca_count@2309-2312@sbin/isakmpd/policy.c","sbin/isakmpd/policy.c","keynote_ca_count",2309,2312
5,1,47,1,4,"prf_hash_init@47-51@sbin/isakmpd/prf.c","sbin/isakmpd/prf.c","prf_hash_init",47,51
5,1,35,3,4,"prf_hash_update@54-58@sbin/isakmpd/prf.c","sbin/isakmpd/prf.c","prf_hash_update",54,58
4,1,27,2,3,"prf_hash_final@61-64@sbin/isakmpd/prf.c","sbin/isakmpd/prf.c","prf_hash_final",61,64
63,8,373,4,73,"prf_alloc@71-144@sbin/isakmpd/prf.c","sbin/isakmpd/prf.c","prf_alloc",71,144
10,2,54,1,10,"prf_free@148-158@sbin/isakmpd/prf.c","sbin/isakmpd/prf.c","prf_free",148,158
11,3,83,1,11,"sa_init@89-100@sbin/isakmpd/sa.c","sbin/isakmpd/sa.c","sa_init",89,100
13,3,83,1,15,"sa_resize@105-120@sbin/isakmpd/sa.c","sbin/isakmpd/sa.c","sa_resize",105,120
14,4,108,2,14,"sa_find@125-139@sbin/isakmpd/sa.c","sbin/isakmpd/sa.c","sa_find",125,139
5,2,33,2,4,"sa_check_icookie@143-147@sbin/isakmpd/sa.c","sbin/isakmpd/sa.c","sa_check_icookie",143,147
4,1,16,1,3,"sa_lookup_from_icookie@151-154@sbin/isakmpd/sa.c","sbin/isakmpd/sa.c","sa_lookup_from_icookie",151,154
6,4,55,2,6,"sa_check_name_phase@163-169@sbin/isakmpd/sa.c","sbin/isakmpd/sa.c","sa_check_name_phase",163,169
7,1,36,2,7,"sa_lookup_by_name@173-180@sbin/isakmpd/sa.c","sbin/isakmpd/sa.c","sa_lookup_by_name",173,180
27,10,241,2,28,"_net_addrcmp@194-222@sbin/isakmpd/sa.c","sbin/isakmpd/sa.c","_net_addrcmp",194,222
18,8,158,2,22,"sa_check_peer@230-252@sbin/isakmpd/sa.c","sbin/isakmpd/sa.c","sa_check_peer",230,252
15,6,136,2,20,"isakmp_sa_check@264-284@sbin/isakmpd/sa.c","sbin/isakmpd/sa.c","isakmp_sa_check",264,284
7,1,38,2,8,"sa_lookup_isakmp_sa@290-298@sbin/isakmpd/sa.c","sbin/isakmpd/sa.c","sa_lookup_isakmp_sa",290,298
8,1,46,3,9,"sa_lookup_by_peer@302-311@sbin/isakmpd/sa.c","sbin/isakmpd/sa.c","sa_lookup_by_peer",302,311
8,1,43,2,9,"sa_isakmp_lookup_by_peer@315-324@sbin/isakmpd/sa.c","sbin/isakmpd/sa.c","sa_isakmp_lookup_by_peer",315,324
19,3,137,1,23,"sa_enter@327-350@sbin/isakmpd/sa.c","sbin/isakmpd/sa.c","sa_enter",327,350
5,2,27,2,4,"sa_lookup_by_header@357-361@sbin/isakmpd/sa.c","sbin/isakmpd/sa.c","sa_lookup_by_header",357,361
25,10,186,2,35,"sa_lookup@368-403@sbin/isakmpd/sa.c","sbin/isakmpd/sa.c","sa_lookup",368,403
37,6,238,2,48,"sa_create@407-455@sbin/isakmpd/sa.c","sbin/isakmpd/sa.c","sa_create",407,455
39,7,381,4,39,"sa_dump@462-501@sbin/isakmpd/sa.c","sbin/isakmpd/sa.c","sa_dump",462,501
21,5,147,4,23,"report_spi@507-530@sbin/isakmpd/sa.c","sbin/isakmpd/sa.c","report_spi",507,530
103,25,474,2,131,"report_proto@538-669@sbin/isakmpd/sa.c","sbin/isakmpd/sa.c","report_proto",538,669
22,7,136,2,25,"report_lifetimes@675-700@sbin/isakmpd/sa.c","sbin/isakmpd/sa.c","report_lifetimes",675,700
6,1,54,2,6,"report_phase1@706-712@sbin/isakmpd/sa.c","sbin/isakmpd/sa.c","report_phase1",706,712
15,4,106,2,20,"report_phase2@718-738@sbin/isakmpd/sa.c","sbin/isakmpd/sa.c","report_phase2",718,738
8,3,62,1,8,"sa_report@742-750@sbin/isakmpd/sa.c","sbin/isakmpd/sa.c","sa_report",742,750
19,7,160,2,28,"sa_dump_all@756-784@sbin/isakmpd/sa.c","sbin/isakmpd/sa.c","sa_dump_all",756,784
8,3,60,1,8,"sa_report_all@788-796@sbin/isakmpd/sa.c","sbin/isakmpd/sa.c","sa_report_all",788,796
26,9,197,1,27,"proto_free@800-827@sbin/isakmpd/sa.c","sbin/isakmpd/sa.c","proto_free",800,827
18,4,87,1,17,"sa_free@831-848@sbin/isakmpd/sa.c","sbin/isakmpd/sa.c","sa_free",831,848
6,1,34,1,5,"sa_remove@852-857@sbin/isakmpd/sa.c","sbin/isakmpd/sa.c","sa_remove",852,857
6,1,31,1,5,"sa_reference@861-866@sbin/isakmpd/sa.c","sbin/isakmpd/sa.c","sa_reference",861,866
45,15,298,1,48,"sa_release@870-918@sbin/isakmpd/sa.c","sbin/isakmpd/sa.c","sa_release",870,918
10,1,67,1,15,"sa_isakmp_upgrade@925-940@sbin/isakmpd/sa.c","sbin/isakmpd/sa.c","sa_isakmp_upgrade",925,940
48,13,266,4,56,"sa_validate_xf_attrs@954-1010@sbin/isakmpd/sa.c","sbin/isakmpd/sa.c","sa_validate_xf_attrs",954,1010
48,13,340,3,62,"sa_validate_proto_xf@1019-1081@sbin/isakmpd/sa.c","sbin/isakmpd/sa.c","sa_validate_proto_xf",1019,1081
64,17,459,4,84,"sa_add_transform@1089-1173@sbin/isakmpd/sa.c","sbin/isakmpd/sa.c","sa_add_transform",1089,1173
6,2,26,2,5,"sa_delete@1177-1182@sbin/isakmpd/sa.c","sbin/isakmpd/sa.c","sa_delete",1177,1182
18,6,124,1,23,"sa_teardown_all@1187-1210@sbin/isakmpd/sa.c","sbin/isakmpd/sa.c","sa_teardown_all",1187,1210
11,2,62,1,16,"sa_soft_expire@1216-1232@sbin/isakmpd/sa.c","sbin/isakmpd/sa.c","sa_soft_expire",1216,1232
10,2,62,1,12,"sa_hard_expire@1236-1248@sbin/isakmpd/sa.c","sbin/isakmpd/sa.c","sa_hard_expire",1236,1248
18,7,123,1,26,"sa_reinit@1251-1277@sbin/isakmpd/sa.c","sbin/isakmpd/sa.c","sa_reinit",1251,1277
23,3,102,1,28,"sa_flag@1283-1311@sbin/isakmpd/sa.c","sbin/isakmpd/sa.c","sa_flag",1283,1311
10,3,59,1,9,"sa_mark_replaced@1315-1324@sbin/isakmpd/sa.c","sbin/isakmpd/sa.c","sa_mark_replaced",1315,1324
12,5,87,2,12,"sa_replace@1328-1340@sbin/isakmpd/sa.c","sbin/isakmpd/sa.c","sa_replace",1328,1340
35,5,202,1,51,"sa_setup_expirations@1349-1400@sbin/isakmpd/sa.c","sbin/isakmpd/sa.c","sa_setup_expirations",1349,1400
4,1,11,1,3,"timer_init@42-45@sbin/isakmpd/timer.c","sbin/isakmpd/timer.c","timer_init",42,45
13,3,81,1,13,"timer_next_event@48-61@sbin/isakmpd/timer.c","sbin/isakmpd/timer.c","timer_next_event",48,61
15,3,104,1,15,"timer_handle_expirations@64-79@sbin/isakmpd/timer.c","sbin/isakmpd/timer.c","timer_handle_expirations",64,79
31,5,228,4,31,"timer_add_event@82-113@sbin/isakmpd/timer.c","sbin/isakmpd/timer.c","timer_add_event",82,113
7,1,43,1,6,"timer_remove_event@116-122@sbin/isakmpd/timer.c","sbin/isakmpd/timer.c","timer_remove_event",116,122
11,3,84,1,12,"timer_report@125-137@sbin/isakmpd/timer.c","sbin/isakmpd/timer.c","timer_report",125,137
8,3,43,1,8,"transport_reinit@53-61@sbin/isakmpd/transport.c","sbin/isakmpd/transport.c","transport_reinit",53,61
5,1,18,1,4,"transport_init@65-69@sbin/isakmpd/transport.c","sbin/isakmpd/transport.c","transport_init",65,69
16,2,91,2,17,"transport_setup@73-90@sbin/isakmpd/transport.c","sbin/isakmpd/transport.c","transport_setup",73,90
7,1,31,1,6,"transport_reference@94-100@sbin/isakmpd/transport.c","sbin/isakmpd/transport.c","transport_reference",94,100
10,2,57,1,10,"transport_release@106-116@sbin/isakmpd/transport.c","sbin/isakmpd/transport.c","transport_release",106,116
24,8,182,1,32,"transport_report@119-151@sbin/isakmpd/transport.c","sbin/isakmpd/transport.c","transport_report",119,151
8,3,50,1,8,"transport_prio_sendqs_empty@154-162@sbin/isakmpd/transport.c","sbin/isakmpd/transport.c","transport_prio_sendqs_empty",154,162
4,1,19,1,3,"transport_method_add@166-169@sbin/isakmpd/transport.c","sbin/isakmpd/transport.c","transport_method_add",166,169
16,4,105,1,17,"transport_fd_set@177-194@sbin/isakmpd/transport.c","sbin/isakmpd/transport.c","transport_fd_set",177,194
19,5,119,1,19,"transport_pending_wfd_set@203-222@sbin/isakmpd/transport.c","sbin/isakmpd/transport.c","transport_pending_wfd_set",203,222
11,4,92,1,11,"transport_handle_messages@229-240@sbin/isakmpd/transport.c","sbin/isakmpd/transport.c","transport_handle_messages",229,240
82,19,579,1,142,"transport_send_messages@252-394@sbin/isakmpd/transport.c","sbin/isakmpd/transport.c","transport_send_messages",252,394
9,3,65,2,9,"transport_create@402-411@sbin/isakmpd/transport.c","sbin/isakmpd/transport.c","transport_create",402,411
4,1,12,1,3,"udp_init@102-105@sbin/isakmpd/udp.c","sbin/isakmpd/udp.c","udp_init",102,105
76,17,489,1,89,"udp_make@109-198@sbin/isakmpd/udp.c","sbin/isakmpd/udp.c","udp_make",109,198
34,4,233,2,38,"udp_clone@202-240@sbin/isakmpd/udp.c","sbin/isakmpd/udp.c","udp_clone",202,240
9,2,51,1,10,"udp_bind@249-259@sbin/isakmpd/udp.c","sbin/isakmpd/udp.c","udp_bind",249,259
84,20,446,1,88,"udp_create@266-354@sbin/isakmpd/udp.c","sbin/isakmpd/udp.c","udp_create",266,354
16,6,120,1,18,"udp_remove@357-375@sbin/isakmpd/udp.c","sbin/isakmpd/udp.c","udp_remove",357,375
16,6,141,1,19,"udp_report@379-398@sbin/isakmpd/udp.c","sbin/isakmpd/udp.c","udp_report",379,398
31,6,219,1,44,"udp_handle_message@407-451@sbin/isakmpd/udp.c","sbin/isakmpd/udp.c","udp_handle_message",407,451
19,2,133,2,24,"udp_send_message@455-479@sbin/isakmpd/udp.c","sbin/isakmpd/udp.c","udp_send_message",455,479
9,2,58,3,10,"udp_fd_set@482-492@sbin/isakmpd/udp.c","sbin/isakmpd/udp.c","udp_fd_set",482,492
5,1,35,2,5,"udp_fd_isset@495-500@sbin/isakmpd/udp.c","sbin/isakmpd/udp.c","udp_fd_isset",495,500
4,1,28,2,3,"udp_get_dst@507-510@sbin/isakmpd/udp.c","sbin/isakmpd/udp.c","udp_get_dst",507,510
4,1,28,2,3,"udp_get_src@517-520@sbin/isakmpd/udp.c","sbin/isakmpd/udp.c","udp_get_src",517,520
20,3,158,1,22,"udp_decode_ids@523-545@sbin/isakmpd/udp.c","sbin/isakmpd/udp.c","udp_decode_ids",523,545
4,1,12,1,3,"udp_encap_init@99-102@sbin/isakmpd/udp_encap.c","sbin/isakmpd/udp_encap.c","udp_encap_init",99,102
77,17,489,1,94,"udp_encap_make@106-200@sbin/isakmpd/udp_encap.c","sbin/isakmpd/udp_encap.c","udp_encap_make",106,200
9,2,51,1,10,"udp_encap_bind@209-219@sbin/isakmpd/udp_encap.c","sbin/isakmpd/udp_encap.c","udp_encap_bind",209,219
85,19,454,1,90,"udp_encap_create@226-316@sbin/isakmpd/udp_encap.c","sbin/isakmpd/udp_encap.c","udp_encap_create",226,316
16,6,141,1,19,"udp_encap_report@320-339@sbin/isakmpd/udp_encap.c","sbin/isakmpd/udp_encap.c","udp_encap_report",320,339
39,10,277,1,59,"udp_encap_handle_message@348-407@sbin/isakmpd/udp_encap.c","sbin/isakmpd/udp_encap.c","udp_encap_handle_message",348,407
40,7,279,2,47,"udp_encap_send_message@414-461@sbin/isakmpd/udp_encap.c","sbin/isakmpd/udp_encap.c","udp_encap_send_message",414,461
22,6,117,1,28,"ui_init@75-103@sbin/isakmpd/ui.c","sbin/isakmpd/ui.c","ui_init",75,103
10,2,56,1,10,"ui_connect@110-120@sbin/isakmpd/ui.c","sbin/isakmpd/ui.c","ui_connect",110,120
45,12,343,1,50,"ui_teardown@124-174@sbin/isakmpd/ui.c","sbin/isakmpd/ui.c","ui_teardown",124,174
4,1,12,1,4,"ui_teardown_all@178-182@sbin/isakmpd/ui.c","sbin/isakmpd/ui.c","ui_teardown_all",178,182
5,1,16,1,10,"ui_conn_reinit_event@185-195@sbin/isakmpd/ui.c","sbin/isakmpd/ui.c","ui_conn_reinit_event",185,195
13,3,58,1,15,"ui_conn_reinit@198-213@sbin/isakmpd/ui.c","sbin/isakmpd/ui.c","ui_conn_reinit",198,213
127,45,912,1,132,"ui_config@220-352@sbin/isakmpd/ui.c","sbin/isakmpd/ui.c","ui_config",220,352
30,7,180,1,31,"ui_delete@355-386@sbin/isakmpd/ui.c","sbin/isakmpd/ui.c","ui_delete",355,386
23,7,141,1,23,"ui_debug@390-413@sbin/isakmpd/ui.c","sbin/isakmpd/ui.c","ui_debug",390,413
17,6,122,1,20,"ui_packetlog@416-436@sbin/isakmpd/ui.c","sbin/isakmpd/ui.c","ui_packetlog",416,436
8,2,37,1,7,"ui_shutdown_daemon@439-446@sbin/isakmpd/ui.c","sbin/isakmpd/ui.c","ui_shutdown_daemon",439,446
9,1,32,1,9,"ui_report@450-459@sbin/isakmpd/ui.c","sbin/isakmpd/ui.c","ui_report",450,459
8,2,33,1,11,"ui_report_sa@463-474@sbin/isakmpd/ui.c","sbin/isakmpd/ui.c","ui_report_sa",463,474
21,6,115,1,22,"ui_setmode@477-499@sbin/isakmpd/ui.c","sbin/isakmpd/ui.c","ui_setmode",477,499
44,13,148,1,56,"ui_handle_command@507-563@sbin/isakmpd/ui.c","sbin/isakmpd/ui.c","ui_handle_command",507,563
54,9,248,1,60,"ui_handler@571-631@sbin/isakmpd/ui.c","sbin/isakmpd/ui.c","ui_handler",571,631
7,2,30,1,7,"ui_open_result@634-641@sbin/isakmpd/ui.c","sbin/isakmpd/ui.c","ui_open_result",634,641
4,1,22,1,3,"decode_16@65-68@sbin/isakmpd/util.c","sbin/isakmpd/util.c","decode_16",65,68
4,1,38,1,3,"decode_32@71-74@sbin/isakmpd/util.c","sbin/isakmpd/util.c","decode_32",71,74
5,1,27,2,4,"encode_16@77-81@sbin/isakmpd/util.c","sbin/isakmpd/util.c","encode_16",77,81
7,1,53,2,6,"encode_32@84-90@sbin/isakmpd/util.c","sbin/isakmpd/util.c","encode_32",84,90
7,3,33,2,6,"zero_test@94-100@sbin/isakmpd/util.c","sbin/isakmpd/util.c","zero_test",94,100
10,7,60,1,9,"hex2nibble@103-112@sbin/isakmpd/util.c","sbin/isakmpd/util.c","hex2nibble",103,112
24,7,150,3,24,"hex2raw@119-143@sbin/isakmpd/util.c","sbin/isakmpd/util.c","hex2raw",119,143
13,3,108,2,15,"raw2hex@151-166@sbin/isakmpd/util.c","sbin/isakmpd/util.c","raw2hex",151,166
20,5,103,1,20,"text2port@169-189@sbin/isakmpd/util.c","sbin/isakmpd/util.c","text2port",169,189
133,33,833,5,153,"text2sockaddr@192-345@sbin/isakmpd/util.c","sbin/isakmpd/util.c","text2sockaddr",192,345
63,18,426,3,72,"sockaddr2text@352-424@sbin/isakmpd/util.c","sbin/isakmpd/util.c","sockaddr2text",352,424
13,3,67,1,12,"sockaddr_addrlen@431-443@sbin/isakmpd/util.c","sbin/isakmpd/util.c","sockaddr_addrlen",431,443
13,3,75,1,12,"sockaddr_addrdata@446-458@sbin/isakmpd/util.c","sbin/isakmpd/util.c","sockaddr_addrdata",446,458
13,3,61,1,12,"sockaddr_port@461-473@sbin/isakmpd/util.c","sbin/isakmpd/util.c","sockaddr_port",461,473
11,3,62,2,11,"sockaddr_set_port@477-488@sbin/isakmpd/util.c","sbin/isakmpd/util.c","sockaddr_set_port",477,488
22,4,129,3,25,"util_ntoa@495-520@sbin/isakmpd/util.c","sbin/isakmpd/util.c","util_ntoa",495,520
23,6,130,3,24,"check_file_secrecy_fd@529-553@sbin/isakmpd/util.c","sbin/isakmpd/util.c","check_file_secrecy_fd",529,553
8,2,47,1,10,"get_timeout@557-567@sbin/isakmpd/util.c","sbin/isakmpd/util.c","get_timeout",557,567
27,6,185,4,28,"expand_string@570-598@sbin/isakmpd/util.c","sbin/isakmpd/util.c","expand_string",570,598
34,5,244,1,38,"setup_vendor_hashes@35-73@sbin/isakmpd/vendor.c","sbin/isakmpd/vendor.c","setup_vendor_hashes",35,73
4,1,10,1,3,"vendor_init@76-79@sbin/isakmpd/vendor.c","sbin/isakmpd/vendor.c","vendor_init",76,79
23,4,141,1,25,"add_vendor_openbsd@82-107@sbin/isakmpd/vendor.c","sbin/isakmpd/vendor.c","add_vendor_openbsd",82,107
27,5,174,2,29,"check_vendor_openbsd@110-139@sbin/isakmpd/vendor.c","sbin/isakmpd/vendor.c","check_vendor_openbsd",110,139
32,9,167,1,44,"virtual_init@94-138@sbin/isakmpd/virtual.c","sbin/isakmpd/virtual.c","virtual_init",94,138
11,3,40,1,10,"virtual_get_default@141-151@sbin/isakmpd/virtual.c","sbin/isakmpd/virtual.c","virtual_get_default",141,151
20,7,131,1,28,"virtual_reinit@163-191@sbin/isakmpd/virtual.c","sbin/isakmpd/virtual.c","virtual_reinit",163,191
22,7,149,1,24,"virtual_listen_lookup@194-218@sbin/isakmpd/virtual.c","sbin/isakmpd/virtual.c","virtual_listen_lookup",194,218
54,9,352,1,65,"virtual_bind@224-289@sbin/isakmpd/virtual.c","sbin/isakmpd/virtual.c","virtual_bind",224,289
28,5,164,1,30,"virtual_bind_ADDR_ANY@292-322@sbin/isakmpd/virtual.c","sbin/isakmpd/virtual.c","virtual_bind_ADDR_ANY",292,322
145,39,876,3,198,"virtual_bind_if@325-523@sbin/isakmpd/virtual.c","sbin/isakmpd/virtual.c","virtual_bind_if",325,523
43,8,293,2,47,"virtual_clone@526-573@sbin/isakmpd/virtual.c","sbin/isakmpd/virtual.c","virtual_clone",526,573
34,7,215,1,37,"virtual_create@576-613@sbin/isakmpd/virtual.c","sbin/isakmpd/virtual.c","virtual_create",576,613
15,6,119,1,17,"virtual_remove@616-633@sbin/isakmpd/virtual.c","sbin/isakmpd/virtual.c","virtual_remove",616,633
3,1,9,1,2,"virtual_report@636-638@sbin/isakmpd/virtual.c","sbin/isakmpd/virtual.c","virtual_report",636,638
10,3,64,1,17,"virtual_handle_message@641-658@sbin/isakmpd/virtual.c","sbin/isakmpd/virtual.c","virtual_handle_message",641,658
33,10,241,2,46,"virtual_send_message@661-707@sbin/isakmpd/virtual.c","sbin/isakmpd/virtual.c","virtual_send_message",661,707
8,2,63,2,8,"virtual_get_src@710-718@sbin/isakmpd/virtual.c","sbin/isakmpd/virtual.c","virtual_get_src",710,718
8,2,63,2,8,"virtual_get_dst@721-729@sbin/isakmpd/virtual.c","sbin/isakmpd/virtual.c","virtual_get_dst",721,729
8,2,52,1,8,"virtual_decode_ids@732-740@sbin/isakmpd/virtual.c","sbin/isakmpd/virtual.c","virtual_decode_ids",732,740
7,2,34,1,6,"virtual_get_queue@743-749@sbin/isakmpd/virtual.c","sbin/isakmpd/virtual.c","virtual_get_queue",743,749
306,108,2147,2,343,"x509_generate_kn@102-445@sbin/isakmpd/x509.c","sbin/isakmpd/x509.c","x509_generate_kn",102,445
12,3,94,2,16,"x509_hash@448-464@sbin/isakmpd/x509.c","sbin/isakmpd/x509.c","x509_hash",448,464
23,6,154,1,25,"x509_hash_init@467-492@sbin/isakmpd/x509.c","sbin/isakmpd/x509.c","x509_hash_init",467,492
32,8,237,2,39,"x509_hash_find@496-535@sbin/isakmpd/x509.c","sbin/isakmpd/x509.c","x509_hash_find",496,535
29,4,177,1,32,"x509_hash_enter@538-570@sbin/isakmpd/x509.c","sbin/isakmpd/x509.c","x509_hash_enter",538,570
61,13,329,4,80,"x509_read_from_dir@575-655@sbin/isakmpd/x509.c","sbin/isakmpd/x509.c","x509_read_from_dir",575,655
56,10,319,2,76,"x509_read_crls_from_dir@659-735@sbin/isakmpd/x509.c","sbin/isakmpd/x509.c","x509_read_crls_from_dir",659,735
38,9,174,1,45,"x509_cert_init@739-784@sbin/isakmpd/x509.c","sbin/isakmpd/x509.c","x509_cert_init",739,784
17,4,75,1,25,"x509_crl_init@787-812@sbin/isakmpd/x509.c","sbin/isakmpd/x509.c","x509_crl_init",787,812
4,1,19,2,3,"x509_cert_get@815-818@sbin/isakmpd/x509.c","sbin/isakmpd/x509.c","x509_cert_get",815,818
49,17,278,1,68,"x509_cert_validate@821-889@sbin/isakmpd/x509.c","sbin/isakmpd/x509.c","x509_cert_validate",821,889
20,4,96,2,22,"x509_cert_insert@892-914@sbin/isakmpd/x509.c","sbin/isakmpd/x509.c","x509_cert_insert",892,914
11,4,67,1,11,"x509_hash_lookup@917-928@sbin/isakmpd/x509.c","sbin/isakmpd/x509.c","x509_hash_lookup",917,928
7,2,42,1,7,"x509_cert_free@931-938@sbin/isakmpd/x509.c","sbin/isakmpd/x509.c","x509_cert_free",931,938
13,4,75,2,18,"x509_certreq_validate@942-960@sbin/isakmpd/x509.c","sbin/isakmpd/x509.c","x509_certreq_validate",942,960
35,7,214,3,44,"x509_certreq_decode@964-1008@sbin/isakmpd/x509.c","sbin/isakmpd/x509.c","x509_certreq_decode",964,1008
10,2,59,1,11,"x509_free_aca@1011-1022@sbin/isakmpd/x509.c","sbin/isakmpd/x509.c","x509_free_aca",1011,1022
22,4,103,2,22,"x509_from_asn@1025-1047@sbin/isakmpd/x509.c","sbin/isakmpd/x509.c","x509_from_asn",1025,1047
20,5,103,5,23,"x509_cert_obtain@1054-1077@sbin/isakmpd/x509.c","sbin/isakmpd/x509.c","x509_cert_obtain",1054,1077
32,7,170,3,40,"x509_cert_subjectaltname@1081-1121@sbin/isakmpd/x509.c","sbin/isakmpd/x509.c","x509_cert_subjectaltname",1081,1121
100,15,589,4,123,"x509_cert_get_subjects@1124-1247@sbin/isakmpd/x509.c","sbin/isakmpd/x509.c","x509_cert_get_subjects",1124,1247
13,3,82,2,16,"x509_cert_get_key@1250-1266@sbin/isakmpd/x509.c","sbin/isakmpd/x509.c","x509_cert_get_key",1250,1266
4,1,14,1,3,"x509_cert_dup@1269-1272@sbin/isakmpd/x509.c","sbin/isakmpd/x509.c","x509_cert_dup",1269,1272
11,2,77,3,11,"x509_serialize@1275-1286@sbin/isakmpd/x509.c","sbin/isakmpd/x509.c","x509_serialize",1275,1286
12,2,55,1,13,"x509_printable@1290-1303@sbin/isakmpd/x509.c","sbin/isakmpd/x509.c","x509_printable",1290,1303
24,4,119,1,24,"x509_from_printable@1307-1331@sbin/isakmpd/x509.c","sbin/isakmpd/x509.c","x509_from_printable",1307,1331
20,3,111,2,20,"x509_DN_string@1334-1354@sbin/isakmpd/x509.c","sbin/isakmpd/x509.c","x509_DN_string",1334,1354
4,1,9,1,3,"x509_ca_count@1358-1361@sbin/isakmpd/x509.c","sbin/isakmpd/x509.c","x509_ca_count",1358,1361
33,8,215,2,34,"kbd_show_enc@92-126@sbin/kbd/kbd_wscons.c","sbin/kbd/kbd_wscons.c","kbd_show_enc",92,126
17,5,108,2,17,"kbd_get_encs@129-146@sbin/kbd/kbd_wscons.c","sbin/kbd/kbd_wscons.c","kbd_get_encs",129,146
64,21,340,1,69,"kbd_list@149-218@sbin/kbd/kbd_wscons.c","sbin/kbd/kbd_wscons.c","kbd_list",149,218
56,21,396,2,59,"kbd_set@221-280@sbin/kbd/kbd_wscons.c","sbin/kbd/kbd_wscons.c","kbd_set",221,280
6,1,29,1,5,"usage@45-50@sbin/kbd/main.c","sbin/kbd/main.c","usage",45,50
23,7,118,2,24,"main@53-77@sbin/kbd/main.c","sbin/kbd/main.c","main",53,77
28,7,158,4,28,"atomicio@44-72@sbin/ldattach/atomicio.c","sbin/ldattach/atomicio.c","atomicio",44,72
48,15,310,4,53,"atomiciov@78-131@sbin/ldattach/atomicio.c","sbin/ldattach/atomicio.c","atomiciov",78,131
7,1,26,1,7,"usage@55-62@sbin/ldattach/ldattach.c","sbin/ldattach/ldattach.c","usage",55,62
39,11,254,2,43,"relay@66-109@sbin/ldattach/ldattach.c","sbin/ldattach/ldattach.c","relay",66,109
185,54,1052,2,221,"main@112-333@sbin/ldattach/ldattach.c","sbin/ldattach/ldattach.c","main",112,333
4,1,11,1,3,"coroner@337-340@sbin/ldattach/ldattach.c","sbin/ldattach/ldattach.c","coroner",337,340
81,16,480,2,96,"main@47-143@sbin/mknod/mknod.c","sbin/mknod/mknod.c","main",47,143
25,12,208,2,29,"compute_device@146-175@sbin/mknod/mknod.c","sbin/mknod/mknod.c","compute_device",146,175
20,5,127,2,29,"domakenodes@178-207@sbin/mknod/mknod.c","sbin/mknod/mknod.c","domakenodes",178,207
14,2,57,1,14,"usage@210-224@sbin/mknod/mknod.c","sbin/mknod/mknod.c","usage",210,224
14,3,90,3,14,"getmntopts@46-60@sbin/mount/getmntopts.c","sbin/mount/getmntopts.c","getmntopts",46,60
53,24,401,4,64,"getmntopt@63-127@sbin/mount/getmntopts.c","sbin/mount/getmntopts.c","getmntopt",63,127
171,61,1025,2,198,"main@102-300@sbin/mount/mount.c","sbin/mount/mount.c","main",102,300
14,5,105,2,14,"hasopt@303-317@sbin/mount/mount.c","sbin/mount/mount.c","hasopt",303,317
11,4,64,1,12,"flags2opts@323-335@sbin/mount/mount.c","sbin/mount/mount.c","flags2opts",323,335
117,28,759,6,135,"mountfs@338-473@sbin/mount/mount.c","sbin/mount/mount.c","mountfs",338,473
128,93,1324,1,143,"prmount@476-619@sbin/mount/mount.c","sbin/mount/mount.c","prmount",476,619
11,4,86,1,11,"getmntpt@622-633@sbin/mount/mount.c","sbin/mount/mount.c","getmntpt",622,633
10,6,73,1,11,"selected@638-649@sbin/mount/mount.c","sbin/mount/mount.c","selected",638,649
22,8,185,1,33,"maketypelist@652-685@sbin/mount/mount.c","sbin/mount/mount.c","maketypelist",652,685
13,5,81,2,14,"catopt@688-702@sbin/mount/mount.c","sbin/mount/mount.c","catopt",688,702
22,5,144,4,23,"mangle@705-728@sbin/mount/mount.c","sbin/mount/mount.c","mangle",705,728
8,1,23,1,7,"usage@731-738@sbin/mount/mount.c","sbin/mount/mount.c","usage",731,738
24,9,162,1,24,"disklabelcheck@741-765@sbin/mount/mount.c","sbin/mount/mount.c","disklabelcheck",741,765
59,15,326,2,65,"main@62-127@sbin/mount_cd9660/mount_cd9660.c","sbin/mount_cd9660/mount_cd9660.c","main",62,127
7,1,22,1,6,"usage@130-136@sbin/mount_cd9660/mount_cd9660.c","sbin/mount_cd9660/mount_cd9660.c","usage",130,136
48,11,255,2,53,"main@55-108@sbin/mount_ext2fs/mount_ext2fs.c","sbin/mount_ext2fs/mount_ext2fs.c","main",55,108
6,1,21,1,5,"ext2fs_usage@111-116@sbin/mount_ext2fs/mount_ext2fs.c","sbin/mount_ext2fs/mount_ext2fs.c","ext2fs_usage",111,116
50,12,267,2,56,"main@62-118@sbin/mount_ffs/mount_ffs.c","sbin/mount_ffs/mount_ffs.c","main",62,118
5,1,21,1,4,"ffs_usage@121-125@sbin/mount_ffs/mount_ffs.c","sbin/mount_ffs/mount_ffs.c","ffs_usage",121,125
82,24,459,2,89,"main@63-152@sbin/mount_msdos/mount_msdos.c","sbin/mount_msdos/mount_msdos.c","main",63,152
12,3,73,1,12,"a_gid@155-167@sbin/mount_msdos/mount_msdos.c","sbin/mount_msdos/mount_msdos.c","a_gid",155,167
12,3,73,1,12,"a_uid@170-182@sbin/mount_msdos/mount_msdos.c","sbin/mount_msdos/mount_msdos.c","a_uid",170,182
13,6,77,1,13,"a_mask@185-198@sbin/mount_msdos/mount_msdos.c","sbin/mount_msdos/mount_msdos.c","a_mask",185,198
6,1,18,1,6,"usage@201-207@sbin/mount_msdos/mount_msdos.c","sbin/mount_msdos/mount_msdos.c","usage",201,207
211,59,1054,2,219,"main@162-381@sbin/mount_nfs/mount_nfs.c","sbin/mount_nfs/mount_nfs.c","main",162,381
130,27,781,2,136,"getnfsargs@384-520@sbin/mount_nfs/mount_nfs.c","sbin/mount_nfs/mount_nfs.c","getnfsargs",384,520
4,1,25,2,3,"xdr_dir@526-529@sbin/mount_nfs/mount_nfs.c","sbin/mount_nfs/mount_nfs.c","xdr_dir",526,529
33,16,244,2,37,"xdr_fh@532-569@sbin/mount_nfs/mount_nfs.c","sbin/mount_nfs/mount_nfs.c","xdr_fh",532,569
10,1,30,1,10,"usage@572-582@sbin/mount_nfs/mount_nfs.c","sbin/mount_nfs/mount_nfs.c","usage",572,582
62,19,401,2,69,"main@59-128@sbin/mount_ntfs/mount_ntfs.c","sbin/mount_ntfs/mount_ntfs.c","main",59,128
13,6,77,1,13,"a_mask@131-144@sbin/mount_ntfs/mount_ntfs.c","sbin/mount_ntfs/mount_ntfs.c","a_mask",131,144
7,1,19,1,6,"usage@147-153@sbin/mount_ntfs/mount_ntfs.c","sbin/mount_ntfs/mount_ntfs.c","usage",147,153
66,16,383,6,80,"mount_tmpfs_parseargs@75-155@sbin/mount_tmpfs/mount_tmpfs.c","sbin/mount_tmpfs/mount_tmpfs.c","mount_tmpfs_parseargs",75,155
8,1,29,1,7,"usage@160-167@sbin/mount_tmpfs/mount_tmpfs.c","sbin/mount_tmpfs/mount_tmpfs.c","usage",160,167
11,2,77,2,13,"mount_tmpfs@172-185@sbin/mount_tmpfs/mount_tmpfs.c","sbin/mount_tmpfs/mount_tmpfs.c","mount_tmpfs",172,185
4,1,21,2,5,"main@188-193@sbin/mount_tmpfs/mount_tmpfs.c","sbin/mount_tmpfs/mount_tmpfs.c","main",188,193
7,2,40,1,7,"a_uid@196-203@sbin/mount_tmpfs/mount_tmpfs.c","sbin/mount_tmpfs/mount_tmpfs.c","a_uid",196,203
7,2,40,1,7,"a_gid@206-213@sbin/mount_tmpfs/mount_tmpfs.c","sbin/mount_tmpfs/mount_tmpfs.c","a_gid",206,213
9,4,60,2,9,"a_num@216-225@sbin/mount_tmpfs/mount_tmpfs.c","sbin/mount_tmpfs/mount_tmpfs.c","a_num",216,225
9,4,53,1,9,"a_mask@228-237@sbin/mount_tmpfs/mount_tmpfs.c","sbin/mount_tmpfs/mount_tmpfs.c","a_mask",228,237
9,3,58,2,9,"pathadj@240-249@sbin/mount_tmpfs/mount_tmpfs.c","sbin/mount_tmpfs/mount_tmpfs.c","pathadj",240,249
6,1,25,1,7,"usage@41-48@sbin/mount_udf/mount_udf.c","sbin/mount_udf/mount_udf.c","usage",41,48
16,3,107,1,20,"lastblock@52-72@sbin/mount_udf/mount_udf.c","sbin/mount_udf/mount_udf.c","lastblock",52,72
25,6,166,2,31,"main@75-106@sbin/mount_udf/mount_udf.c","sbin/mount_udf/mount_udf.c","main",75,106
93,32,507,2,104,"main@76-180@sbin/mount_vnd/mount_vnd.c","sbin/mount_vnd/mount_vnd.c","main",76,180
61,14,419,2,64,"get_pkcs_key@183-247@sbin/mount_vnd/mount_vnd.c","sbin/mount_vnd/mount_vnd.c","get_pkcs_key",183,247
35,9,211,1,43,"getinfo@250-293@sbin/mount_vnd/mount_vnd.c","sbin/mount_vnd/mount_vnd.c","getinfo",250,293
38,15,271,6,47,"config@296-343@sbin/mount_vnd/mount_vnd.c","sbin/mount_vnd/mount_vnd.c","config",296,343
14,2,46,1,15,"usage@346-361@sbin/mount_vnd/mount_vnd.c","sbin/mount_vnd/mount_vnd.c","usage",346,361
93,25,632,2,105,"main@243-348@sbin/mountd/mountd.c","sbin/mountd/mountd.c","main",243,348
4,1,11,1,3,"check_child@351-354@sbin/mountd/mountd.c","sbin/mountd/mountd.c","check_child",351,354
178,41,978,1,184,"privchild@357-541@sbin/mountd/mountd.c","sbin/mountd/mountd.c","privchild",357,541
26,6,158,2,29,"imsg_getfh@544-573@sbin/mountd/mountd.c","sbin/mountd/mountd.c","imsg_getfh",544,573
35,9,244,2,40,"imsg_export@576-616@sbin/mountd/mountd.c","sbin/mountd/mountd.c","imsg_export",576,616
25,5,131,1,27,"recv_imsg@619-646@sbin/mountd/mountd.c","sbin/mountd/mountd.c","recv_imsg",619,646
12,3,84,3,13,"send_imsg@649-662@sbin/mountd/mountd.c","sbin/mountd/mountd.c","send_imsg",649,662
57,13,280,1,59,"mountd_svc_run@665-724@sbin/mountd/mountd.c","sbin/mountd/mountd.c","mountd_svc_run",665,724
146,46,974,2,155,"mntsrv@730-885@sbin/mountd/mountd.c","sbin/mountd/mountd.c","mntsrv",730,885
4,1,25,2,3,"xdr_dir@891-894@sbin/mountd/mountd.c","sbin/mountd/mountd.c","xdr_dir",891,894
23,7,163,2,23,"xdr_fhs@900-923@sbin/mountd/mountd.c","sbin/mountd/mountd.c","xdr_fhs",900,923
21,6,138,2,21,"xdr_mlist@926-947@sbin/mountd/mountd.c","sbin/mountd/mountd.c","xdr_mlist",926,947
26,7,166,2,26,"xdr_explist@953-979@sbin/mountd/mountd.c","sbin/mountd/mountd.c","xdr_explist",953,979
53,21,366,4,53,"put_exlist@986-1039@sbin/mountd/mountd.c","sbin/mountd/mountd.c","put_exlist",986,1039
4,1,11,1,4,"new_exportlist@1046-1050@sbin/mountd/mountd.c","sbin/mountd/mountd.c","new_exportlist",1046,1050
286,71,1755,1,365,"get_exportlist@1056-1421@sbin/mountd/mountd.c","sbin/mountd/mountd.c","get_exportlist",1056,1421
8,2,39,1,8,"get_exp@1427-1435@sbin/mountd/mountd.c","sbin/mountd/mountd.c","get_exp",1427,1435
8,2,39,1,8,"get_grp@1441-1449@sbin/mountd/mountd.c","sbin/mountd/mountd.c","get_grp",1441,1449
12,4,68,2,12,"getexp_err@1455-1467@sbin/mountd/mountd.c","sbin/mountd/mountd.c","getexp_err",1455,1467
12,4,73,1,12,"ex_search@1473-1485@sbin/mountd/mountd.c","sbin/mountd/mountd.c","ex_search",1473,1485
14,2,94,3,15,"add_expdir@1491-1506@sbin/mountd/mountd.c","sbin/mountd/mountd.c","add_expdir",1491,1506
27,6,153,4,31,"hang_dirp@1513-1544@sbin/mountd/mountd.c","sbin/mountd/mountd.c","hang_dirp",1513,1544
34,6,190,4,38,"add_dlist@1551-1589@sbin/mountd/mountd.c","sbin/mountd/mountd.c","add_dlist",1551,1589
14,4,81,2,14,"dirp_search@1595-1609@sbin/mountd/mountd.c","sbin/mountd/mountd.c","dirp_search",1595,1609
36,9,191,4,36,"chk_host@1615-1651@sbin/mountd/mountd.c","sbin/mountd/mountd.c","chk_host",1615,1651
13,5,80,2,13,"scan_tree@1657-1670@sbin/mountd/mountd.c","sbin/mountd/mountd.c","scan_tree",1657,1670
9,2,44,1,9,"free_dir@1676-1685@sbin/mountd/mountd.c","sbin/mountd/mountd.c","free_dir",1676,1685
87,28,572,7,87,"do_opt@1693-1780@sbin/mountd/mountd.c","sbin/mountd/mountd.c","do_opt",1693,1780
71,17,505,3,74,"get_host@1787-1861@sbin/mountd/mountd.c","sbin/mountd/mountd.c","get_host",1787,1861
10,2,58,1,10,"free_exp@1867-1877@sbin/mountd/mountd.c","sbin/mountd/mountd.c","free_exp",1867,1877
9,2,38,1,9,"free_host@1883-1892@sbin/mountd/mountd.c","sbin/mountd/mountd.c","free_host",1883,1892
10,2,49,1,10,"get_ht@1895-1905@sbin/mountd/mountd.c","sbin/mountd/mountd.c","get_ht",1895,1905
5,1,18,1,5,"out_of_mem@1911-1916@sbin/mountd/mountd.c","sbin/mountd/mountd.c","out_of_mem",1911,1916
107,27,653,6,119,"do_mount@1924-2043@sbin/mountd/mountd.c","sbin/mountd/mountd.c","do_mount",1924,2043
40,9,230,3,48,"get_net@2049-2097@sbin/mountd/mountd.c","sbin/mountd/mountd.c","get_net",2049,2097
15,9,95,2,15,"nextfield@2103-2118@sbin/mountd/mountd.c","sbin/mountd/mountd.c","nextfield",2103,2118
31,12,173,1,34,"get_line@2125-2159@sbin/mountd/mountd.c","sbin/mountd/mountd.c","get_line",2125,2159
53,19,410,2,70,"parsecred@2165-2235@sbin/mountd/mountd.c","sbin/mountd/mountd.c","parsecred",2165,2235
28,6,194,1,28,"get_mountlist@2242-2270@sbin/mountd/mountd.c","sbin/mountd/mountd.c","get_mountlist",2242,2270
29,7,168,2,29,"del_mlist@2273-2302@sbin/mountd/mountd.c","sbin/mountd/mountd.c","del_mlist",2273,2302
20,5,149,2,20,"add_mlist@2305-2325@sbin/mountd/mountd.c","sbin/mountd/mountd.c","add_mlist",2305,2325
4,1,11,1,3,"send_umntall@2332-2335@sbin/mountd/mountd.c","sbin/mountd/mountd.c","send_umntall",2332,2335
4,1,17,2,3,"umntall_each@2338-2341@sbin/mountd/mountd.c","sbin/mountd/mountd.c","umntall_each",2338,2341
17,6,126,1,17,"free_grp@2347-2364@sbin/mountd/mountd.c","sbin/mountd/mountd.c","free_grp",2347,2364
18,7,113,1,18,"check_options@2370-2388@sbin/mountd/mountd.c","sbin/mountd/mountd.c","check_options",2370,2388
23,11,149,1,25,"check_dirpath@2395-2420@sbin/mountd/mountd.c","sbin/mountd/mountd.c","check_dirpath",2395,2420
10,3,57,2,10,"matchino@130-140@sbin/ncheck_ffs/ncheck_ffs.c","sbin/ncheck_ffs/ncheck_ffs.c","matchino",130,140
10,3,63,2,10,"matchcache@146-156@sbin/ncheck_ffs/ncheck_ffs.c","sbin/ncheck_ffs/ncheck_ffs.c","matchcache",146,156
16,4,118,2,18,"cacheino@162-180@sbin/ncheck_ffs/ncheck_ffs.c","sbin/ncheck_ffs/ncheck_ffs.c","cacheino",162,180
13,3,78,1,13,"cached@186-199@sbin/ncheck_ffs/ncheck_ffs.c","sbin/ncheck_ffs/ncheck_ffs.c","cached",186,199
20,10,120,1,20,"findinodes@207-227@sbin/ncheck_ffs/ncheck_ffs.c","sbin/ncheck_ffs/ncheck_ffs.c","findinodes",207,227
24,8,180,1,24,"getino@234-258@sbin/ncheck_ffs/ncheck_ffs.c","sbin/ncheck_ffs/ncheck_ffs.c","getino",234,258
39,8,264,3,53,"bread@270-323@sbin/ncheck_ffs/ncheck_ffs.c","sbin/ncheck_ffs/ncheck_ffs.c","bread",270,323
10,2,55,1,10,"addinode@329-339@sbin/ncheck_ffs/ncheck_ffs.c","sbin/ncheck_ffs/ncheck_ffs.c","addinode",329,339
21,8,176,2,21,"scanonedir@345-366@sbin/ncheck_ffs/ncheck_ffs.c","sbin/ncheck_ffs/ncheck_ffs.c","scanonedir",345,366
33,11,253,5,33,"dirindir@373-406@sbin/ncheck_ffs/ncheck_ffs.c","sbin/ncheck_ffs/ncheck_ffs.c","dirindir",373,406
60,21,434,5,60,"searchdir@414-474@sbin/ncheck_ffs/ncheck_ffs.c","sbin/ncheck_ffs/ncheck_ffs.c","searchdir",414,474
13,2,85,1,13,"rawname@477-490@sbin/ncheck_ffs/ncheck_ffs.c","sbin/ncheck_ffs/ncheck_ffs.c","rawname",477,490
8,1,25,1,8,"usage@493-501@sbin/ncheck_ffs/ncheck_ffs.c","sbin/ncheck_ffs/ncheck_ffs.c","usage",493,501
101,42,723,2,112,"main@504-616@sbin/ncheck_ffs/ncheck_ffs.c","sbin/ncheck_ffs/ncheck_ffs.c","main",504,616
75,23,406,2,78,"format_entry@619-697@sbin/ncheck_ffs/ncheck_ffs.c","sbin/ncheck_ffs/ncheck_ffs.c","format_entry",619,697
7,1,34,1,7,"siginfo@154-161@sbin/newfs/mkfs.c","sbin/newfs/mkfs.c","siginfo",154,161
329,70,2622,7,451,"mkfs@165-616@sbin/newfs/mkfs.c","sbin/newfs/mkfs.c","mkfs",165,616
124,24,1067,2,142,"initcg@622-764@sbin/newfs/mkfs.c","sbin/newfs/mkfs.c","initcg",622,764
40,6,398,4,58,"fsinit1@783-841@sbin/newfs/mkfs.c","sbin/newfs/mkfs.c","fsinit1",783,841
30,4,329,1,49,"fsinit2@844-893@sbin/newfs/mkfs.c","sbin/newfs/mkfs.c","fsinit2",844,893
15,2,136,2,15,"makedir@900-915@sbin/newfs/mkfs.c","sbin/newfs/mkfs.c","makedir",900,915
48,9,401,2,48,"alloc@921-969@sbin/newfs/mkfs.c","sbin/newfs/mkfs.c","alloc",921,969
30,5,267,2,36,"iput@975-1011@sbin/newfs/mkfs.c","sbin/newfs/mkfs.c","iput",975,1011
12,3,77,3,12,"rdfs@1017-1029@sbin/newfs/mkfs.c","sbin/newfs/mkfs.c","rdfs",1017,1029
14,4,83,3,14,"wtfs@1035-1049@sbin/newfs/mkfs.c","sbin/newfs/mkfs.c","wtfs",1035,1049
21,6,170,3,24,"isblock@1055-1079@sbin/newfs/mkfs.c","sbin/newfs/mkfs.c","isblock",1055,1079
21,6,143,3,23,"clrblock@1085-1108@sbin/newfs/mkfs.c","sbin/newfs/mkfs.c","clrblock",1085,1108
21,6,141,3,23,"setblock@1114-1137@sbin/newfs/mkfs.c","sbin/newfs/mkfs.c","setblock",1114,1137
15,6,90,1,16,"charsperline@1144-1160@sbin/newfs/mkfs.c","sbin/newfs/mkfs.c","charsperline",1144,1160
8,3,51,1,9,"ilog2@1163-1172@sbin/newfs/mkfs.c","sbin/newfs/mkfs.c","ilog2",1163,1172
23,3,188,1,27,"checksz@1187-1214@sbin/newfs/mkfs.c","sbin/newfs/mkfs.c","checksz",1187,1214
7,2,53,1,7,"getphysmem@156-163@sbin/newfs/newfs.c","sbin/newfs/newfs.c","getphysmem",156,163
378,126,2419,2,425,"main@166-591@sbin/newfs/newfs.c","sbin/newfs/newfs.c","main",166,591
18,4,95,2,19,"getdisklabel@594-613@sbin/newfs/newfs.c","sbin/newfs/newfs.c","getdisklabel",594,613
11,3,68,3,11,"rewritelabel@616-627@sbin/newfs/newfs.c","sbin/newfs/newfs.c","rewritelabel",616,627
14,2,76,2,15,"fatal@630-645@sbin/newfs/newfs.c","sbin/newfs/newfs.c","fatal",630,645
23,2,52,1,24,"usage@648-672@sbin/newfs/newfs.c","sbin/newfs/newfs.c","usage",648,672
39,11,240,3,40,"do_exec@677-717@sbin/newfs/newfs.c","sbin/newfs/newfs.c","do_exec",677,717
9,4,71,1,9,"isdir@720-729@sbin/newfs/newfs.c","sbin/newfs/newfs.c","isdir",720,729
43,15,336,3,44,"copy@732-776@sbin/newfs/newfs.c","sbin/newfs/newfs.c","copy",732,776
29,10,224,2,29,"gettmpmnt@779-808@sbin/newfs/newfs.c","sbin/newfs/newfs.c","gettmpmnt",779,808
307,64,2128,2,480,"mke2fs@182-662@sbin/newfs_ext2fs/mke2fs.c","sbin/newfs_ext2fs/mke2fs.c","mke2fs",182,662
54,13,504,1,83,"initcg@668-751@sbin/newfs_ext2fs/mke2fs.c","sbin/newfs_ext2fs/mke2fs.c","initcg",668,751
48,11,322,1,65,"zap_old_sblock@757-822@sbin/newfs_ext2fs/mke2fs.c","sbin/newfs_ext2fs/mke2fs.c","zap_old_sblock",757,822
16,6,92,1,19,"cgoverhead@831-850@sbin/newfs_ext2fs/mke2fs.c","sbin/newfs_ext2fs/mke2fs.c","cgoverhead",831,850
74,16,631,1,100,"fsinit@883-983@sbin/newfs_ext2fs/mke2fs.c","sbin/newfs_ext2fs/mke2fs.c","fsinit",883,983
18,2,143,2,18,"makedir@990-1008@sbin/newfs_ext2fs/mke2fs.c","sbin/newfs_ext2fs/mke2fs.c","makedir",990,1008
6,1,50,2,6,"copy_dir@1014-1020@sbin/newfs_ext2fs/mke2fs.c","sbin/newfs_ext2fs/mke2fs.c","copy_dir",1014,1020
84,16,653,1,191,"init_resizeino@1029-1220@sbin/newfs_ext2fs/mke2fs.c","sbin/newfs_ext2fs/mke2fs.c","init_resizeino",1029,1220
46,12,322,2,58,"alloc@1229-1287@sbin/newfs_ext2fs/mke2fs.c","sbin/newfs_ext2fs/mke2fs.c","alloc",1229,1287
43,8,358,2,61,"iput@1295-1356@sbin/newfs_ext2fs/mke2fs.c","sbin/newfs_ext2fs/mke2fs.c","iput",1295,1356
10,2,60,3,10,"rdfs@1362-1372@sbin/newfs_ext2fs/mke2fs.c","sbin/newfs_ext2fs/mke2fs.c","rdfs",1362,1372
12,3,66,3,12,"wtfs@1378-1390@sbin/newfs_ext2fs/mke2fs.c","sbin/newfs_ext2fs/mke2fs.c","wtfs",1378,1390
7,3,38,1,8,"ilog2@1393-1401@sbin/newfs_ext2fs/mke2fs.c","sbin/newfs_ext2fs/mke2fs.c","ilog2",1393,1401
8,3,48,3,9,"skpc@1410-1419@sbin/newfs_ext2fs/mke2fs.c","sbin/newfs_ext2fs/mke2fs.c","skpc",1410,1419
10,1,81,1,12,"uuid_get@1422-1434@sbin/newfs_ext2fs/mke2fs.c","sbin/newfs_ext2fs/mke2fs.c","uuid_get",1422,1434
225,74,1288,2,260,"main@113-373@sbin/newfs_ext2fs/newfs_ext2fs.c","sbin/newfs_ext2fs/newfs_ext2fs.c","main",113,373
50,20,258,5,53,"strsuftoi64@376-429@sbin/newfs_ext2fs/newfs_ext2fs.c","sbin/newfs_ext2fs/newfs_ext2fs.c","strsuftoi64",376,429
9,1,41,1,11,"usage@449-460@sbin/newfs_ext2fs/newfs_ext2fs.c","sbin/newfs_ext2fs/newfs_ext2fs.c","usage",449,460
19,4,97,2,21,"getdisklabel@463-484@sbin/newfs_ext2fs/newfs_ext2fs.c","sbin/newfs_ext2fs/newfs_ext2fs.c","getdisklabel",463,484
31,11,277,4,31,"getpartition@487-518@sbin/newfs_ext2fs/newfs_ext2fs.c","sbin/newfs_ext2fs/newfs_ext2fs.c","getpartition",487,518
434,184,3538,2,435,"main@227-662@sbin/newfs_msdos/newfs_msdos.c","sbin/newfs_msdos/newfs_msdos.c","main",227,662
22,11,176,2,22,"check_mounted@668-690@sbin/newfs_msdos/newfs_msdos.c","sbin/newfs_msdos/newfs_msdos.c","check_mounted",668,690
9,4,85,2,9,"getstdfmt@696-705@sbin/newfs_msdos/newfs_msdos.c","sbin/newfs_msdos/newfs_msdos.c","getstdfmt",696,705
54,32,472,5,54,"getdiskinfo@711-765@sbin/newfs_msdos/newfs_msdos.c","sbin/newfs_msdos/newfs_msdos.c","getdiskinfo",711,765
23,8,187,1,22,"print_bpb@771-793@sbin/newfs_msdos/newfs_msdos.c","sbin/newfs_msdos/newfs_msdos.c","print_bpb",771,793
8,3,53,3,7,"ckgeom@799-806@sbin/newfs_msdos/newfs_msdos.c","sbin/newfs_msdos/newfs_msdos.c","ckgeom",799,806
10,6,76,4,10,"argtou@812-822@sbin/newfs_msdos/newfs_msdos.c","sbin/newfs_msdos/newfs_msdos.c","argtou",812,822
10,5,64,1,10,"oklabel@828-838@sbin/newfs_msdos/newfs_msdos.c","sbin/newfs_msdos/newfs_msdos.c","oklabel",828,838
8,5,66,2,8,"mklabel@844-852@sbin/newfs_msdos/newfs_msdos.c","sbin/newfs_msdos/newfs_msdos.c","mklabel",844,852
5,3,34,3,4,"setstr@858-862@sbin/newfs_msdos/newfs_msdos.c","sbin/newfs_msdos/newfs_msdos.c","setstr",858,862
13,1,32,1,13,"usage@868-881@sbin/newfs_msdos/newfs_msdos.c","sbin/newfs_msdos/newfs_msdos.c","usage",868,881
191,47,1240,2,219,"main@105-324@sbin/nfsd/nfsd.c","sbin/nfsd/nfsd.c","main",105,324
5,1,21,1,4,"usage@327-331@sbin/nfsd/nfsd.c","sbin/nfsd/nfsd.c","usage",327,331
7,1,32,1,7,"nonfs@335-342@sbin/nfsd/nfsd.c","sbin/nfsd/nfsd.c","nonfs",335,342
7,2,31,1,7,"reapchild@346-353@sbin/nfsd/nfsd.c","sbin/nfsd/nfsd.c","reapchild",346,353
17,5,122,2,20,"main@43-63@sbin/nologin/nologin.c","sbin/nologin/nologin.c","main",43,63
24,4,161,1,25,"dump_block_zero@49-74@sbin/pdisk/dump.c","sbin/pdisk/dump.c","dump_block_zero",49,74
23,4,138,1,25,"dump_partition_map@78-103@sbin/pdisk/dump.c","sbin/pdisk/dump.c","dump_partition_map",78,103
16,3,112,4,18,"dump_partition_entry@107-125@sbin/pdisk/dump.c","sbin/pdisk/dump.c","dump_partition_entry",107,125
64,15,488,1,65,"show_data_structures@129-194@sbin/pdisk/dump.c","sbin/pdisk/dump.c","show_data_structures",129,194
56,11,393,2,58,"full_dump_partition_entry@198-256@sbin/pdisk/dump.c","sbin/pdisk/dump.c","full_dump_partition_entry",198,256
30,9,178,2,34,"dump_block@260-294@sbin/pdisk/dump.c","sbin/pdisk/dump.c","dump_block",260,294
22,5,191,1,23,"full_dump_block_zero@297-320@sbin/pdisk/dump.c","sbin/pdisk/dump.c","full_dump_block_zero",297,320
12,2,60,1,14,"get_max_type_string_length@323-337@sbin/pdisk/dump.c","sbin/pdisk/dump.c","get_max_type_string_length",323,337
12,2,60,1,14,"get_max_name_string_length@340-354@sbin/pdisk/dump.c","sbin/pdisk/dump.c","get_max_name_string_length",340,354
13,3,65,1,15,"get_max_base_or_length@357-372@sbin/pdisk/dump.c","sbin/pdisk/dump.c","get_max_base_or_length",357,372
14,4,78,3,16,"read_block@86-102@sbin/pdisk/file_media.c","sbin/pdisk/file_media.c","read_block",86,102
9,2,49,3,10,"write_block@105-115@sbin/pdisk/file_media.c","sbin/pdisk/file_media.c","write_block",105,115
49,4,473,2,53,"read_block0@118-171@sbin/pdisk/file_media.c","sbin/pdisk/file_media.c","read_block0",118,171
48,3,390,2,51,"write_block0@174-225@sbin/pdisk/file_media.c","sbin/pdisk/file_media.c","write_block0",174,225
61,3,554,3,67,"read_dpme@228-295@sbin/pdisk/file_media.c","sbin/pdisk/file_media.c","read_dpme",228,295
63,2,510,3,67,"write_dpme@298-365@sbin/pdisk/file_media.c","sbin/pdisk/file_media.c","write_dpme",298,365
7,2,25,0,6,"my_getch@51-57@sbin/pdisk/io.c","sbin/pdisk/io.c","my_getch",51,57
7,2,29,1,10,"my_ungetch@61-71@sbin/pdisk/io.c","sbin/pdisk/io.c","my_ungetch",61,71
16,5,58,1,18,"flush_to_newline@74-92@sbin/pdisk/io.c","sbin/pdisk/io.c","flush_to_newline",74,92
24,10,131,2,27,"get_okay@96-123@sbin/pdisk/io.c","sbin/pdisk/io.c","get_okay",96,123
19,7,96,3,22,"get_command@126-148@sbin/pdisk/io.c","sbin/pdisk/io.c","get_command",126,148
23,8,118,2,25,"get_number_argument@151-176@sbin/pdisk/io.c","sbin/pdisk/io.c","get_number_argument",151,176
18,7,93,1,19,"get_number@180-199@sbin/pdisk/io.c","sbin/pdisk/io.c","get_number",180,199
23,16,151,1,25,"get_dpistr_argument@202-227@sbin/pdisk/io.c","sbin/pdisk/io.c","get_dpistr_argument",202,227
24,8,141,1,25,"get_string@231-256@sbin/pdisk/io.c","sbin/pdisk/io.c","get_string",231,256
36,15,194,1,37,"get_multiplier@260-297@sbin/pdisk/io.c","sbin/pdisk/io.c","get_multiplier",260,297
11,4,50,1,14,"get_partition_modifier@301-315@sbin/pdisk/io.c","sbin/pdisk/io.c","get_partition_modifier",301,315
10,2,35,1,10,"number_of_digits@319-329@sbin/pdisk/io.c","sbin/pdisk/io.c","number_of_digits",319,329
9,1,47,2,9,"bad_input@336-345@sbin/pdisk/io.c","sbin/pdisk/io.c","bad_input",336,345
56,14,321,4,62,"open_partition_map@60-122@sbin/pdisk/partition_map.c","sbin/pdisk/partition_map.c","open_partition_map",60,122
12,3,62,1,14,"free_partition_map@126-140@sbin/pdisk/partition_map.c","sbin/pdisk/partition_map.c","free_partition_map",126,140
89,17,473,1,96,"read_partition_map@143-239@sbin/pdisk/partition_map.c","sbin/pdisk/partition_map.c","read_partition_map",143,239
13,3,82,1,14,"write_partition_map@243-257@sbin/pdisk/partition_map.c","sbin/pdisk/partition_map.c","write_partition_map",243,257
25,4,182,4,31,"create_partition_map@261-292@sbin/pdisk/partition_map.c","sbin/pdisk/partition_map.c","create_partition_map",261,292
62,16,369,5,83,"add_partition_to_map@296-379@sbin/pdisk/partition_map.c","sbin/pdisk/partition_map.c","add_partition_to_map",296,379
28,5,204,6,34,"create_entry@383-417@sbin/pdisk/partition_map.c","sbin/pdisk/partition_map.c","create_entry",383,417
12,4,89,1,11,"dpme_init_flags@420-431@sbin/pdisk/partition_map.c","sbin/pdisk/partition_map.c","dpme_init_flags",420,431
10,1,49,1,11,"renumber_disk_addresses@434-445@sbin/pdisk/partition_map.c","sbin/pdisk/partition_map.c","renumber_disk_addresses",434,445
30,5,170,1,32,"delete_partition_from_map@448-480@sbin/pdisk/partition_map.c","sbin/pdisk/partition_map.c","delete_partition_from_map",448,480
17,4,98,1,18,"contains_driver@484-502@sbin/pdisk/partition_map.c","sbin/pdisk/partition_map.c","contains_driver",484,502
51,12,305,1,60,"combine_entry@506-566@sbin/pdisk/partition_map.c","sbin/pdisk/partition_map.c","combine_entry",506,566
9,1,44,1,11,"delete_entry@570-581@sbin/pdisk/partition_map.c","sbin/pdisk/partition_map.c","delete_entry",570,581
9,2,43,2,9,"find_entry_by_disk_address@585-594@sbin/pdisk/partition_map.c","sbin/pdisk/partition_map.c","find_entry_by_disk_address",585,594
9,2,52,2,9,"find_entry_by_type@598-607@sbin/pdisk/partition_map.c","sbin/pdisk/partition_map.c","find_entry_by_type",598,607
9,2,43,2,9,"find_entry_by_base@610-619@sbin/pdisk/partition_map.c","sbin/pdisk/partition_map.c","find_entry_by_base",610,619
28,6,149,3,33,"move_entry_in_map@623-656@sbin/pdisk/partition_map.c","sbin/pdisk/partition_map.c","move_entry_in_map",623,656
20,4,111,1,22,"insert_in_disk_order@660-682@sbin/pdisk/partition_map.c","sbin/pdisk/partition_map.c","insert_in_disk_order",660,682
22,4,118,1,24,"insert_in_base_order@686-710@sbin/pdisk/partition_map.c","sbin/pdisk/partition_map.c","insert_in_base_order",686,710
45,11,235,2,50,"resize_map@714-764@sbin/pdisk/partition_map.c","sbin/pdisk/partition_map.c","resize_map",714,764
26,5,195,1,39,"remove_driver@768-807@sbin/pdisk/partition_map.c","sbin/pdisk/partition_map.c","remove_driver",768,807
50,13,307,2,59,"main@72-131@sbin/pdisk/pdisk.c","sbin/pdisk/pdisk.c","main",72,131
101,21,326,1,105,"edit@137-242@sbin/pdisk/pdisk.c","sbin/pdisk/pdisk.c","edit",137,242
36,8,190,2,42,"do_create_partition@245-287@sbin/pdisk/pdisk.c","sbin/pdisk/pdisk.c","do_create_partition",245,287
20,4,96,2,20,"get_base_argument@290-310@sbin/pdisk/pdisk.c","sbin/pdisk/pdisk.c","get_base_argument",290,310
28,6,144,2,28,"get_size_argument@314-342@sbin/pdisk/pdisk.c","sbin/pdisk/pdisk.c","get_size_argument",314,342
26,4,142,1,33,"do_rename_partition@346-379@sbin/pdisk/pdisk.c","sbin/pdisk/pdisk.c","do_rename_partition",346,379
26,4,142,1,33,"do_change_type@382-415@sbin/pdisk/pdisk.c","sbin/pdisk/pdisk.c","do_change_type",382,415
14,3,64,1,15,"do_delete_partition@419-434@sbin/pdisk/pdisk.c","sbin/pdisk/pdisk.c","do_delete_partition",419,434
13,3,65,1,13,"do_reorder@438-451@sbin/pdisk/pdisk.c","sbin/pdisk/pdisk.c","do_reorder",438,451
17,4,70,1,17,"do_write_partition_map@455-472@sbin/pdisk/pdisk.c","sbin/pdisk/pdisk.c","do_write_partition_map",455,472
9,2,40,1,9,"do_change_map_size@476-485@sbin/pdisk/pdisk.c","sbin/pdisk/pdisk.c","do_change_map_size",476,485
12,3,52,1,12,"do_display_entry@489-501@sbin/pdisk/pdisk.c","sbin/pdisk/pdisk.c","do_display_entry",489,501
7,2,27,2,6,"do_dump_map@504-510@sbin/pdisk/pdisk.c","sbin/pdisk/pdisk.c","do_dump_map",504,510
6,1,25,1,7,"usage@513-520@sbin/pdisk/pdisk.c","sbin/pdisk/pdisk.c","usage",513,520
77,26,490,3,81,"print_addr@52-133@sbin/pfctl/pf_print_state.c","sbin/pfctl/pf_print_state.c","print_addr",52,133
28,3,193,2,30,"print_name@136-166@sbin/pfctl/pf_print_state.c","sbin/pfctl/pf_print_state.c","print_name",136,166
31,9,233,6,34,"print_host@169-203@sbin/pfctl/pf_print_state.c","sbin/pfctl/pf_print_state.c","print_host",169,203
9,2,75,1,8,"print_seq@206-214@sbin/pfctl/pf_print_state.c","sbin/pfctl/pf_print_state.c","print_seq",206,214
139,47,1239,2,148,"print_state@217-365@sbin/pfctl/pf_print_state.c","sbin/pfctl/pf_print_state.c","print_state",217,365
15,5,98,2,15,"unmask@368-383@sbin/pfctl/pf_print_state.c","sbin/pfctl/pf_print_state.c","unmask",368,383
13,1,74,1,13,"usage@235-248@sbin/pfctl/pfctl.c","sbin/pfctl/pfctl.c","usage",235,248
12,4,64,2,12,"pfctl_enable@251-263@sbin/pfctl/pfctl.c","sbin/pfctl/pfctl.c","pfctl_enable",251,263
12,4,64,2,12,"pfctl_disable@266-278@sbin/pfctl/pfctl.c","sbin/pfctl/pfctl.c","pfctl_disable",266,278
16,6,130,3,17,"pfctl_clear_stats@281-298@sbin/pfctl/pfctl.c","sbin/pfctl/pfctl.c","pfctl_clear_stats",281,298
12,4,79,2,13,"pfctl_clear_interface_flags@301-314@sbin/pfctl/pfctl.c","sbin/pfctl/pfctl.c","pfctl_clear_interface_flags",301,314
12,5,97,3,12,"pfctl_clear_rules@317-329@sbin/pfctl/pfctl.c","sbin/pfctl/pfctl.c","pfctl_clear_rules",317,329
7,3,43,2,6,"pfctl_clear_src_nodes@332-338@sbin/pfctl/pfctl.c","sbin/pfctl/pfctl.c","pfctl_clear_src_nodes",332,338
12,5,110,3,13,"pfctl_clear_states@341-354@sbin/pfctl/pfctl.c","sbin/pfctl/pfctl.c","pfctl_clear_states",341,354
40,12,319,2,47,"pfctl_addrprefix@357-404@sbin/pfctl/pfctl.c","sbin/pfctl/pfctl.c","pfctl_addrprefix",357,404
84,18,774,3,99,"pfctl_kill_src_nodes@407-506@sbin/pfctl/pfctl.c","sbin/pfctl/pfctl.c","pfctl_kill_src_nodes",407,506
88,20,821,4,104,"pfctl_net_kill_states@509-613@sbin/pfctl/pfctl.c","sbin/pfctl/pfctl.c","pfctl_net_kill_states",509,613
20,8,188,4,24,"pfctl_label_kill_states@616-640@sbin/pfctl/pfctl.c","sbin/pfctl/pfctl.c","pfctl_label_kill_states",616,640
27,8,217,2,30,"pfctl_id_kill_states@643-673@sbin/pfctl/pfctl.c","sbin/pfctl/pfctl.c","pfctl_id_kill_states",643,673
48,17,412,4,56,"pfctl_key_kill_states@676-732@sbin/pfctl/pfctl.c","sbin/pfctl/pfctl.c","pfctl_key_kill_states",676,732
44,7,347,2,52,"pfctl_parse_host@735-787@sbin/pfctl/pfctl.c","sbin/pfctl/pfctl.c","pfctl_parse_host",735,787
35,7,264,2,36,"pfctl_print_rule_counters@790-826@sbin/pfctl/pfctl.c","sbin/pfctl/pfctl.c","pfctl_print_rule_counters",790,826
7,2,29,1,6,"pfctl_print_title@829-835@sbin/pfctl/pfctl.c","sbin/pfctl/pfctl.c","pfctl_print_title",829,835
142,37,1056,8,168,"pfctl_show_rules@838-1006@sbin/pfctl/pfctl.c","sbin/pfctl/pfctl.c","pfctl_show_rules",838,1006
42,14,266,2,42,"pfctl_show_src_nodes@1009-1051@sbin/pfctl/pfctl.c","sbin/pfctl/pfctl.c","pfctl_show_src_nodes",1009,1051
46,17,310,4,46,"pfctl_show_states@1054-1100@sbin/pfctl/pfctl.c","sbin/pfctl/pfctl.c","pfctl_show_states",1054,1100
12,3,63,2,12,"pfctl_show_status@1103-1115@sbin/pfctl/pfctl.c","sbin/pfctl/pfctl.c","pfctl_show_status",1103,1115
21,6,146,2,22,"pfctl_show_timeouts@1118-1140@sbin/pfctl/pfctl.c","sbin/pfctl/pfctl.c","pfctl_show_timeouts",1118,1140
19,5,129,2,19,"pfctl_show_limits@1143-1162@sbin/pfctl/pfctl.c","sbin/pfctl/pfctl.c","pfctl_show_limits",1143,1162
30,9,288,3,36,"pfctl_add_rule@1166-1202@sbin/pfctl/pfctl.c","sbin/pfctl/pfctl.c","pfctl_add_rule",1166,1202
11,4,90,3,12,"pfctl_ruleset_trans@1205-1217@sbin/pfctl/pfctl.c","sbin/pfctl/pfctl.c","pfctl_ruleset_trans",1205,1217
26,6,187,2,30,"pfctl_add_queue@1220-1250@sbin/pfctl/pfctl.c","sbin/pfctl/pfctl.c","pfctl_add_queue",1220,1250
8,2,51,2,9,"pfctl_find_queue@1253-1262@sbin/pfctl/pfctl.c","sbin/pfctl/pfctl.c","pfctl_find_queue",1253,1262
40,15,386,1,46,"pfctl_find_childqs@1265-1311@sbin/pfctl/pfctl.c","sbin/pfctl/pfctl.c","pfctl_find_childqs",1265,1311
16,4,140,3,17,"pfctl_load_queue@1314-1331@sbin/pfctl/pfctl.c","sbin/pfctl/pfctl.c","pfctl_load_queue",1314,1331
30,12,255,1,37,"pfctl_load_queues@1334-1371@sbin/pfctl/pfctl.c","sbin/pfctl/pfctl.c","pfctl_load_queues",1334,1371
9,2,51,1,9,"pfctl_clear_queues@1374-1383@sbin/pfctl/pfctl.c","sbin/pfctl/pfctl.c","pfctl_clear_queues",1374,1383
25,7,140,1,25,"pfctl_leafqueue_check@1386-1411@sbin/pfctl/pfctl.c","sbin/pfctl/pfctl.c","pfctl_leafqueue_check",1386,1411
32,10,206,1,34,"pfctl_check_qassignments@1414-1448@sbin/pfctl/pfctl.c","sbin/pfctl/pfctl.c","pfctl_check_qassignments",1414,1448
50,15,373,4,57,"pfctl_load_ruleset@1451-1508@sbin/pfctl/pfctl.c","sbin/pfctl/pfctl.c","pfctl_load_ruleset",1451,1508
38,11,332,4,42,"pfctl_load_rule@1511-1553@sbin/pfctl/pfctl.c","sbin/pfctl/pfctl.c","pfctl_load_rule",1511,1553
106,28,760,6,135,"pfctl_rules@1556-1691@sbin/pfctl/pfctl.c","sbin/pfctl/pfctl.c","pfctl_rules",1556,1691
18,4,97,2,18,"pfctl_fopen@1694-1712@sbin/pfctl/pfctl.c","sbin/pfctl/pfctl.c","pfctl_fopen",1694,1712
46,4,387,1,51,"pfctl_init_options@1715-1766@sbin/pfctl/pfctl.c","sbin/pfctl/pfctl.c","pfctl_init_options",1715,1766
29,16,248,1,46,"pfctl_load_options@1769-1815@sbin/pfctl/pfctl.c","sbin/pfctl/pfctl.c","pfctl_load_options",1769,1815
18,5,132,3,21,"pfctl_set_limit@1818-1839@sbin/pfctl/pfctl.c","sbin/pfctl/pfctl.c","pfctl_set_limit",1818,1839
17,3,107,3,17,"pfctl_load_limit@1842-1859@sbin/pfctl/pfctl.c","sbin/pfctl/pfctl.c","pfctl_load_limit",1842,1859
18,6,137,4,22,"pfctl_set_timeout@1862-1884@sbin/pfctl/pfctl.c","sbin/pfctl/pfctl.c","pfctl_set_timeout",1862,1884
12,2,77,3,12,"pfctl_load_timeout@1887-1899@sbin/pfctl/pfctl.c","sbin/pfctl/pfctl.c","pfctl_load_timeout",1887,1899
15,6,82,3,16,"pfctl_set_reassembly@1902-1918@sbin/pfctl/pfctl.c","sbin/pfctl/pfctl.c","pfctl_set_reassembly",1902,1918
20,7,154,2,24,"pfctl_set_optimization@1921-1945@sbin/pfctl/pfctl.c","sbin/pfctl/pfctl.c","pfctl_set_optimization",1921,1945
15,4,90,2,16,"pfctl_set_logif@1948-1964@sbin/pfctl/pfctl.c","sbin/pfctl/pfctl.c","pfctl_set_logif",1948,1964
15,4,100,2,15,"pfctl_load_logif@1967-1982@sbin/pfctl/pfctl.c","sbin/pfctl/pfctl.c","pfctl_load_logif",1967,1982
8,2,47,2,9,"pfctl_set_hostid@1985-1994@sbin/pfctl/pfctl.c","sbin/pfctl/pfctl.c","pfctl_set_hostid",1985,1994
8,2,41,2,7,"pfctl_load_hostid@1997-2004@sbin/pfctl/pfctl.c","sbin/pfctl/pfctl.c","pfctl_load_hostid",1997,2004
8,2,41,2,7,"pfctl_load_reassembly@2007-2014@sbin/pfctl/pfctl.c","sbin/pfctl/pfctl.c","pfctl_load_reassembly",2007,2014
19,5,115,2,22,"pfctl_set_debug@2017-2039@sbin/pfctl/pfctl.c","sbin/pfctl/pfctl.c","pfctl_set_debug",2017,2039
8,2,44,2,7,"pfctl_load_debug@2042-2049@sbin/pfctl/pfctl.c","sbin/pfctl/pfctl.c","pfctl_load_debug",2042,2049
19,6,144,4,22,"pfctl_set_interface_flags@2052-2074@sbin/pfctl/pfctl.c","sbin/pfctl/pfctl.c","pfctl_set_interface_flags",2052,2074
13,5,101,3,14,"pfctl_debug@2077-2091@sbin/pfctl/pfctl.c","sbin/pfctl/pfctl.c","pfctl_debug",2077,2091
35,11,269,3,36,"pfctl_show_anchors@2094-2130@sbin/pfctl/pfctl.c","sbin/pfctl/pfctl.c","pfctl_show_anchors",2094,2130
13,6,82,2,13,"pfctl_lookup_option@2133-2146@sbin/pfctl/pfctl.c","sbin/pfctl/pfctl.c","pfctl_lookup_option",2133,2146
38,13,261,2,42,"pfctl_state_store@2150-2192@sbin/pfctl/pfctl.c","sbin/pfctl/pfctl.c","pfctl_state_store",2150,2192
20,6,113,2,22,"pfctl_state_load@2195-2217@sbin/pfctl/pfctl.c","sbin/pfctl/pfctl.c","pfctl_state_load",2195,2217
378,115,1927,2,404,"main@2220-2624@sbin/pfctl/pfctl.c","sbin/pfctl/pfctl.c","main",2220,2624
63,12,504,2,77,"pfctl_optimize_ruleset@264-341@sbin/pfctl/pfctl_optimize.c","sbin/pfctl/pfctl_optimize.c","pfctl_optimize_ruleset",264,341
26,13,188,2,74,"optimize_superblock@348-422@sbin/pfctl/pfctl_optimize.c","sbin/pfctl/pfctl_optimize.c","optimize_superblock",348,422
32,6,293,2,34,"remove_identical_rules@429-463@sbin/pfctl/pfctl_optimize.c","sbin/pfctl/pfctl_optimize.c","remove_identical_rules",429,463
118,38,953,2,141,"combine_rules@471-612@sbin/pfctl/pfctl_optimize.c","sbin/pfctl/pfctl_optimize.c","combine_rules",471,612
120,24,808,3,166,"reorder_rules@619-785@sbin/pfctl/pfctl_optimize.c","sbin/pfctl/pfctl_optimize.c","reorder_rules",619,785
42,7,312,2,56,"block_feedback@793-849@sbin/pfctl/pfctl_optimize.c","sbin/pfctl/pfctl_optimize.c","block_feedback",793,849
63,10,447,2,82,"load_feedback_profile@857-939@sbin/pfctl/pfctl_optimize.c","sbin/pfctl/pfctl_optimize.c","load_feedback_profile",857,939
10,3,77,3,10,"skip_compare@946-956@sbin/pfctl/pfctl_optimize.c","sbin/pfctl/pfctl_optimize.c","skip_compare",946,956
13,3,96,4,15,"skip_append@963-978@sbin/pfctl/pfctl_optimize.c","sbin/pfctl/pfctl_optimize.c","skip_append",963,978
32,13,235,4,35,"remove_from_skipsteps@985-1020@sbin/pfctl/pfctl_optimize.c","sbin/pfctl/pfctl_optimize.c","remove_from_skipsteps",985,1020
6,3,40,2,5,"skip_cmp_af@1025-1030@sbin/pfctl/pfctl_optimize.c","sbin/pfctl/pfctl_optimize.c","skip_cmp_af",1025,1030
6,3,40,2,5,"skip_cmp_dir@1034-1039@sbin/pfctl/pfctl_optimize.c","sbin/pfctl/pfctl_optimize.c","skip_cmp_dir",1034,1039
6,3,47,2,5,"skip_cmp_rdom@1043-1048@sbin/pfctl/pfctl_optimize.c","sbin/pfctl/pfctl_optimize.c","skip_cmp_rdom",1043,1048
32,17,387,2,36,"skip_cmp_dst_addr@1052-1088@sbin/pfctl/pfctl_optimize.c","sbin/pfctl/pfctl_optimize.c","skip_cmp_dst_addr",1052,1088
8,5,82,2,12,"skip_cmp_dst_port@1092-1104@sbin/pfctl/pfctl_optimize.c","sbin/pfctl/pfctl_optimize.c","skip_cmp_dst_port",1092,1104
6,3,52,2,5,"skip_cmp_ifp@1108-1113@sbin/pfctl/pfctl_optimize.c","sbin/pfctl/pfctl_optimize.c","skip_cmp_ifp",1108,1113
4,2,31,2,3,"skip_cmp_proto@1117-1120@sbin/pfctl/pfctl_optimize.c","sbin/pfctl/pfctl_optimize.c","skip_cmp_proto",1117,1120
32,17,387,2,36,"skip_cmp_src_addr@1124-1160@sbin/pfctl/pfctl_optimize.c","sbin/pfctl/pfctl_optimize.c","skip_cmp_src_addr",1124,1160
8,5,82,2,12,"skip_cmp_src_port@1164-1176@sbin/pfctl/pfctl_optimize.c","sbin/pfctl/pfctl_optimize.c","skip_cmp_src_port",1164,1176
19,6,145,1,19,"skip_init@1180-1199@sbin/pfctl/pfctl_optimize.c","sbin/pfctl/pfctl_optimize.c","skip_init",1180,1199
44,11,436,5,56,"add_opt_table@1205-1261@sbin/pfctl/pfctl_optimize.c","sbin/pfctl/pfctl_optimize.c","add_opt_table",1205,1261
39,7,264,2,46,"pf_opt_create_table@1269-1315@sbin/pfctl/pfctl_optimize.c","sbin/pfctl/pfctl_optimize.c","pf_opt_create_table",1269,1315
23,6,165,3,24,"construct_superblocks@1321-1345@sbin/pfctl/pfctl_optimize.c","sbin/pfctl/pfctl_optimize.c","construct_superblocks",1321,1345
6,2,54,2,5,"addrs_equal@1352-1357@sbin/pfctl/pfctl_optimize.c","sbin/pfctl/pfctl_optimize.c","addrs_equal",1352,1357
10,7,93,2,9,"addrs_combineable@1364-1373@sbin/pfctl/pfctl_optimize.c","sbin/pfctl/pfctl_optimize.c","addrs_combineable",1364,1373
7,1,59,2,7,"rules_combineable@1380-1387@sbin/pfctl/pfctl_optimize.c","sbin/pfctl/pfctl_optimize.c","rules_combineable",1380,1387
58,20,474,2,82,"superblock_inclusive@1394-1476@sbin/pfctl/pfctl_optimize.c","sbin/pfctl/pfctl_optimize.c","superblock_inclusive",1394,1476
9,4,56,1,10,"interface_group@1484-1494@sbin/pfctl/pfctl_optimize.c","sbin/pfctl/pfctl_optimize.c","interface_group",1484,1494
12,5,128,3,17,"comparable_rule@1501-1518@sbin/pfctl/pfctl_optimize.c","sbin/pfctl/pfctl_optimize.c","comparable_rule",1501,1518
79,45,1117,2,84,"exclude_supersets@1526-1610@sbin/pfctl/pfctl_optimize.c","sbin/pfctl/pfctl_optimize.c","exclude_supersets",1526,1610
13,3,86,2,12,"superblock_free@1614-1626@sbin/pfctl/pfctl_optimize.c","sbin/pfctl/pfctl_optimize.c","superblock_free",1614,1626
6,2,25,1,7,"pf_opt_table_ref@1629-1636@sbin/pfctl/pfctl_optimize.c","sbin/pfctl/pfctl_optimize.c","pf_opt_table_ref",1629,1636
10,4,59,1,9,"pf_opt_table_unref@1639-1648@sbin/pfctl/pfctl_optimize.c","sbin/pfctl/pfctl_optimize.c","pf_opt_table_unref",1639,1648
140,40,893,3,170,"pfctl_file_fingerprints@86-256@sbin/pfctl/pfctl_osfp.c","sbin/pfctl/pfctl_osfp.c","pfctl_file_fingerprints",86,256
5,2,26,2,4,"pfctl_clear_fingerprints@260-264@sbin/pfctl/pfctl_osfp.c","sbin/pfctl/pfctl_osfp.c","pfctl_clear_fingerprints",260,264
11,2,57,1,11,"pfctl_flush_my_fingerprints@268-279@sbin/pfctl/pfctl_osfp.c","sbin/pfctl/pfctl_osfp.c","pfctl_flush_my_fingerprints",268,279
18,4,100,2,19,"pfctl_load_fingerprints@283-302@sbin/pfctl/pfctl_osfp.c","sbin/pfctl/pfctl_osfp.c","pfctl_load_fingerprints",283,302
14,3,70,1,13,"pfctl_show_fingerprints@306-319@sbin/pfctl/pfctl_osfp.c","sbin/pfctl/pfctl_osfp.c","pfctl_show_fingerprints",306,319
87,17,499,1,116,"pfctl_get_fingerprint@323-439@sbin/pfctl/pfctl_osfp.c","sbin/pfctl/pfctl_osfp.c","pfctl_get_fingerprint",323,439
70,16,426,3,75,"pfctl_lookup_fingerprint@443-518@sbin/pfctl/pfctl_osfp.c","sbin/pfctl/pfctl_osfp.c","pfctl_lookup_fingerprint",443,518
8,2,50,2,8,"lookup_name_list@522-530@sbin/pfctl/pfctl_osfp.c","sbin/pfctl/pfctl_osfp.c","lookup_name_list",522,530
47,12,315,3,107,"add_fingerprint@534-641@sbin/pfctl/pfctl_osfp.c","sbin/pfctl/pfctl_osfp.c","add_fingerprint",534,641
31,6,199,1,35,"import_fingerprint@645-680@sbin/pfctl/pfctl_osfp.c","sbin/pfctl/pfctl_osfp.c","import_fingerprint",645,680
21,6,142,2,23,"fingerprint_name_entry@684-707@sbin/pfctl/pfctl_osfp.c","sbin/pfctl/pfctl_osfp.c","fingerprint_name_entry",684,707
11,1,75,3,11,"print_name_list@711-722@sbin/pfctl/pfctl_osfp.c","sbin/pfctl/pfctl_osfp.c","print_name_list",711,722
33,7,200,2,37,"sort_name_list@725-762@sbin/pfctl/pfctl_osfp.c","sbin/pfctl/pfctl_osfp.c","sort_name_list",725,762
80,32,487,9,85,"get_int@766-851@sbin/pfctl/pfctl_osfp.c","sbin/pfctl/pfctl_osfp.c","get_int",766,851
20,4,141,7,21,"get_str@855-876@sbin/pfctl/pfctl_osfp.c","sbin/pfctl/pfctl_osfp.c","get_str",855,876
79,22,475,10,84,"get_tcpopts@880-964@sbin/pfctl/pfctl_osfp.c","sbin/pfctl/pfctl_osfp.c","get_tcpopts",880,964
22,8,146,3,24,"get_field@968-992@sbin/pfctl/pfctl_osfp.c","sbin/pfctl/pfctl_osfp.c","get_field",968,992
91,21,797,1,99,"print_ioctl@997-1096@sbin/pfctl/pfctl_osfp.c","sbin/pfctl/pfctl_osfp.c","print_ioctl",997,1096
18,6,126,2,18,"geticmptypebynumber@214-232@sbin/pfctl/pfctl_parser.c","sbin/pfctl/pfctl_parser.c","geticmptypebynumber",214,232
18,6,135,2,18,"geticmptypebyname@235-253@sbin/pfctl/pfctl_parser.c","sbin/pfctl/pfctl_parser.c","geticmptypebyname",235,253
20,8,147,3,20,"geticmpcodebynumber@256-276@sbin/pfctl/pfctl_parser.c","sbin/pfctl/pfctl_parser.c","geticmpcodebynumber",256,276
20,8,156,3,20,"geticmpcodebyname@279-299@sbin/pfctl/pfctl_parser.c","sbin/pfctl/pfctl_parser.c","geticmpcodebyname",279,299
24,9,180,1,27,"string_to_loglevel@306-333@sbin/pfctl/pfctl_parser.c","sbin/pfctl/pfctl_parser.c","string_to_loglevel",306,333
8,3,44,1,9,"loglevel_to_string@336-345@sbin/pfctl/pfctl_parser.c","sbin/pfctl/pfctl_parser.c","loglevel_to_string",336,345
21,10,148,3,20,"print_op@348-368@sbin/pfctl/pfctl_parser.c","sbin/pfctl/pfctl_parser.c","print_op",348,368
16,5,138,5,16,"print_port@371-387@sbin/pfctl/pfctl_parser.c","sbin/pfctl/pfctl_parser.c","print_port",371,387
11,4,102,5,11,"print_ugid@390-401@sbin/pfctl/pfctl_parser.c","sbin/pfctl/pfctl_parser.c","print_ugid",390,401
7,3,45,1,7,"print_flags@404-411@sbin/pfctl/pfctl_parser.c","sbin/pfctl/pfctl_parser.c","print_flags",404,411
37,19,312,6,37,"print_fromto@414-451@sbin/pfctl/pfctl_parser.c","sbin/pfctl/pfctl_parser.c","print_fromto",414,451
57,23,325,6,56,"print_pool@454-510@sbin/pfctl/pfctl_parser.c","sbin/pfctl/pfctl_parser.c","print_pool",454,510
112,18,946,2,117,"print_status@518-635@sbin/pfctl/pfctl_parser.c","sbin/pfctl/pfctl_parser.c","print_status",518,635
49,10,410,2,52,"print_src_node@638-690@sbin/pfctl/pfctl_parser.c","sbin/pfctl/pfctl_parser.c","print_src_node",638,690
426,164,2935,3,445,"print_rule@693-1138@sbin/pfctl/pfctl_parser.c","sbin/pfctl/pfctl_parser.c","print_rule",693,1138
37,13,226,4,37,"print_tabledef@1141-1178@sbin/pfctl/pfctl_parser.c","sbin/pfctl/pfctl_parser.c","print_tabledef",1141,1178
14,6,104,2,14,"print_bwspec@1181-1195@sbin/pfctl/pfctl_parser.c","sbin/pfctl/pfctl_parser.c","print_bwspec",1181,1195
9,2,56,2,8,"print_scspec@1198-1206@sbin/pfctl/pfctl_parser.c","sbin/pfctl/pfctl_parser.c","print_scspec",1198,1206
29,11,226,1,28,"print_queuespec@1209-1237@sbin/pfctl/pfctl_parser.c","sbin/pfctl/pfctl_parser.c","print_queuespec",1209,1237
12,4,75,1,12,"parse_flags@1240-1252@sbin/pfctl/pfctl_parser.c","sbin/pfctl/pfctl_parser.c","parse_flags",1240,1252
19,6,182,2,22,"set_ipmask@1255-1277@sbin/pfctl/pfctl_parser.c","sbin/pfctl/pfctl_parser.c","set_ipmask",1255,1277
17,7,122,2,18,"check_netmask@1280-1298@sbin/pfctl/pfctl_parser.c","sbin/pfctl/pfctl_parser.c","check_netmask",1280,1298
17,5,132,2,21,"gen_dynnode@1301-1322@sbin/pfctl/pfctl_parser.c","sbin/pfctl/pfctl_parser.c","gen_dynnode",1301,1322
79,20,679,1,84,"ifa_load@1329-1413@sbin/pfctl/pfctl_parser.c","sbin/pfctl/pfctl_parser.c","ifa_load",1329,1413
10,4,65,1,10,"ifa_nametoindex@1416-1426@sbin/pfctl/pfctl_parser.c","sbin/pfctl/pfctl_parser.c","ifa_nametoindex",1416,1426
12,4,74,2,12,"ifa_indextoname@1429-1441@sbin/pfctl/pfctl_parser.c","sbin/pfctl/pfctl_parser.c","ifa_indextoname",1429,1441
26,9,211,1,31,"ifa_exists@1444-1475@sbin/pfctl/pfctl_parser.c","sbin/pfctl/pfctl_parser.c","ifa_exists",1444,1475
35,9,269,2,38,"ifa_grouplookup@1478-1516@sbin/pfctl/pfctl_parser.c","sbin/pfctl/pfctl_parser.c","ifa_grouplookup",1478,1516
76,33,572,2,80,"ifa_lookup@1519-1599@sbin/pfctl/pfctl_parser.c","sbin/pfctl/pfctl_parser.c","ifa_lookup",1519,1599
18,12,154,2,18,"ifa_skip_if@1602-1620@sbin/pfctl/pfctl_parser.c","sbin/pfctl/pfctl_parser.c","ifa_skip_if",1602,1620
51,21,436,2,63,"host@1623-1686@sbin/pfctl/pfctl_parser.c","sbin/pfctl/pfctl_parser.c","host",1623,1686
41,14,290,2,43,"host_if@1689-1732@sbin/pfctl/pfctl_parser.c","sbin/pfctl/pfctl_parser.c","host_if",1689,1732
24,5,187,2,26,"host_v4@1735-1761@sbin/pfctl/pfctl_parser.c","sbin/pfctl/pfctl_parser.c","host_v4",1735,1761
26,3,201,2,27,"host_v6@1764-1791@sbin/pfctl/pfctl_parser.c","sbin/pfctl/pfctl_parser.c","host_v6",1764,1791
72,16,462,4,74,"host_dns@1794-1868@sbin/pfctl/pfctl_parser.c","sbin/pfctl/pfctl_parser.c","host_dns",1794,1868
46,9,272,4,52,"append_addr@1876-1928@sbin/pfctl/pfctl_parser.c","sbin/pfctl/pfctl_parser.c","append_addr",1876,1928
43,12,307,4,44,"append_addr_host@1937-1981@sbin/pfctl/pfctl_parser.c","sbin/pfctl/pfctl_parser.c","append_addr_host",1937,1981
10,2,79,3,11,"pfctl_add_trans@1984-1995@sbin/pfctl/pfctl_parser.c","sbin/pfctl/pfctl_parser.c","pfctl_add_trans",1984,1995
8,3,60,3,8,"pfctl_get_ticket@1998-2006@sbin/pfctl/pfctl_parser.c","sbin/pfctl/pfctl_parser.c","pfctl_get_ticket",1998,2006
9,1,81,4,9,"pfctl_trans@2009-2018@sbin/pfctl/pfctl_parser.c","sbin/pfctl/pfctl_parser.c","pfctl_trans",2009,2018
31,11,219,4,34,"pfctl_show_queues@77-111@sbin/pfctl/pfctl_queue.c","sbin/pfctl/pfctl_queue.c","pfctl_show_queues",77,111
40,7,287,1,43,"pfctl_update_qstats@114-157@sbin/pfctl/pfctl_queue.c","sbin/pfctl/pfctl_queue.c","pfctl_update_qstats",114,157
12,2,95,2,12,"pfctl_insert_queue_node@160-172@sbin/pfctl/pfctl_queue.c","sbin/pfctl/pfctl_queue.c","pfctl_insert_queue_node",160,172
9,3,66,2,9,"pfctl_find_queue_node@175-184@sbin/pfctl/pfctl_queue.c","sbin/pfctl/pfctl_queue.c","pfctl_find_queue_node",175,184
11,4,73,3,12,"pfctl_print_queue_node@187-199@sbin/pfctl/pfctl_queue.c","sbin/pfctl/pfctl_queue.c","pfctl_print_queue_node",187,199
33,6,277,2,37,"pfctl_print_queue_nodestat@202-239@sbin/pfctl/pfctl_queue.c","sbin/pfctl/pfctl_queue.c","pfctl_print_queue_nodestat",202,239
19,5,163,1,20,"update_avg@242-262@sbin/pfctl/pfctl_queue.c","sbin/pfctl/pfctl_queue.c","update_avg",242,262
18,5,132,1,21,"rate2str@268-289@sbin/pfctl/pfctl_queue.c","sbin/pfctl/pfctl_queue.c","rate2str",268,289
13,4,84,3,13,"pfr_clr_tables@60-73@sbin/pfctl/pfctl_radix.c","sbin/pfctl/pfctl_radix.c","pfr_clr_tables",60,73
18,6,122,4,18,"pfr_add_tables@76-94@sbin/pfctl/pfctl_radix.c","sbin/pfctl/pfctl_radix.c","pfr_add_tables",76,94
18,6,122,4,18,"pfr_del_tables@97-115@sbin/pfctl/pfctl_radix.c","sbin/pfctl/pfctl_radix.c","pfr_del_tables",97,115
20,7,138,4,20,"pfr_get_tables@118-138@sbin/pfctl/pfctl_radix.c","sbin/pfctl/pfctl_radix.c","pfr_get_tables",118,138
20,7,138,4,20,"pfr_get_tstats@141-161@sbin/pfctl/pfctl_radix.c","sbin/pfctl/pfctl_radix.c","pfr_get_tstats",141,161
16,4,96,3,16,"pfr_clr_addrs@164-180@sbin/pfctl/pfctl_radix.c","sbin/pfctl/pfctl_radix.c","pfr_clr_addrs",164,180
20,7,138,5,20,"pfr_add_addrs@183-203@sbin/pfctl/pfctl_radix.c","sbin/pfctl/pfctl_radix.c","pfr_add_addrs",183,203
20,7,138,5,20,"pfr_del_addrs@206-226@sbin/pfctl/pfctl_radix.c","sbin/pfctl/pfctl_radix.c","pfr_del_addrs",206,226
27,11,204,8,27,"pfr_set_addrs@229-256@sbin/pfctl/pfctl_radix.c","sbin/pfctl/pfctl_radix.c","pfr_set_addrs",229,256
20,7,136,4,20,"pfr_get_addrs@259-279@sbin/pfctl/pfctl_radix.c","sbin/pfctl/pfctl_radix.c","pfr_get_addrs",259,279
20,7,136,4,20,"pfr_get_astats@282-302@sbin/pfctl/pfctl_radix.c","sbin/pfctl/pfctl_radix.c","pfr_get_astats",282,302
18,6,119,4,18,"pfr_clr_tstats@305-323@sbin/pfctl/pfctl_radix.c","sbin/pfctl/pfctl_radix.c","pfr_clr_tstats",305,323
20,7,136,5,20,"pfr_tst_addrs@326-346@sbin/pfctl/pfctl_radix.c","sbin/pfctl/pfctl_radix.c","pfr_tst_addrs",326,346
23,8,164,7,23,"pfr_ina_define@349-372@sbin/pfctl/pfctl_radix.c","sbin/pfctl/pfctl_radix.c","pfr_ina_define",349,372
22,8,159,3,22,"pfi_get_ifaces@377-399@sbin/pfctl/pfctl_radix.c","sbin/pfctl/pfctl_radix.c","pfi_get_ifaces",377,399
16,7,117,2,16,"pfr_buf_add@413-429@sbin/pfctl/pfctl_radix.c","sbin/pfctl/pfctl_radix.c","pfr_buf_add",413,429
14,7,120,2,14,"pfr_buf_next@436-450@sbin/pfctl/pfctl_radix.c","sbin/pfctl/pfctl_radix.c","pfr_buf_next",436,450
25,10,170,2,25,"pfr_buf_grow@458-483@sbin/pfctl/pfctl_radix.c","sbin/pfctl/pfctl_radix.c","pfr_buf_grow",458,483
8,2,40,1,7,"pfr_buf_clear@489-496@sbin/pfctl/pfctl_radix.c","sbin/pfctl/pfctl_radix.c","pfr_buf_clear",489,496
26,8,157,4,26,"pfr_buf_load@499-525@sbin/pfctl/pfctl_radix.c","sbin/pfctl/pfctl_radix.c","pfr_buf_load",499,525
32,12,181,2,34,"pfr_next_token@528-562@sbin/pfctl/pfctl_radix.c","sbin/pfctl/pfctl_radix.c","pfr_next_token",528,562
11,3,33,1,10,"pfr_strerror@565-575@sbin/pfctl/pfctl_radix.c","sbin/pfctl/pfctl_radix.c","pfr_strerror",565,575
5,2,39,2,4,"pfctl_clear_tables@106-110@sbin/pfctl/pfctl_table.c","sbin/pfctl/pfctl_table.c","pfctl_clear_tables",106,110
5,2,39,2,4,"pfctl_show_tables@113-117@sbin/pfctl/pfctl_table.c","sbin/pfctl/pfctl_table.c","pfctl_show_tables",113,117
7,3,66,7,6,"pfctl_command_tables@120-126@sbin/pfctl/pfctl_table.c","sbin/pfctl/pfctl_table.c","pfctl_command_tables",120,126
227,84,1752,7,236,"pfctl_table@129-365@sbin/pfctl/pfctl_table.c","sbin/pfctl/pfctl_table.c","pfctl_table",129,365
20,12,161,3,19,"print_table@368-387@sbin/pfctl/pfctl_table.c","sbin/pfctl/pfctl_table.c","print_table",368,387
22,5,183,2,22,"print_tstats@390-412@sbin/pfctl/pfctl_table.c","sbin/pfctl/pfctl_table.c","print_tstats",390,412
20,6,141,6,19,"load_addr@415-434@sbin/pfctl/pfctl_table.c","sbin/pfctl/pfctl_table.c","load_addr",415,434
45,18,467,3,48,"print_addrx@437-485@sbin/pfctl/pfctl_table.c","sbin/pfctl/pfctl_table.c","print_addrx",437,485
21,7,190,2,21,"print_astats@488-509@sbin/pfctl/pfctl_table.c","sbin/pfctl/pfctl_table.c","print_astats",488,509
5,1,25,1,4,"radix_perror@512-516@sbin/pfctl/pfctl_table.c","sbin/pfctl/pfctl_table.c","radix_perror",512,516
13,4,130,6,14,"pfctl_define_table@519-533@sbin/pfctl/pfctl_table.c","sbin/pfctl/pfctl_table.c","pfctl_define_table",519,533
38,12,230,1,38,"warn_namespace_collision@536-574@sbin/pfctl/pfctl_table.c","sbin/pfctl/pfctl_table.c","warn_namespace_collision",536,574
15,4,81,3,17,"xprintf@577-594@sbin/pfctl/pfctl_table.c","sbin/pfctl/pfctl_table.c","xprintf",577,594
23,5,135,2,23,"pfctl_show_ifaces@600-623@sbin/pfctl/pfctl_table.c","sbin/pfctl/pfctl_table.c","pfctl_show_ifaces",600,623
25,5,193,2,26,"print_iface@626-652@sbin/pfctl/pfctl_table.c","sbin/pfctl/pfctl_table.c","print_iface",626,652
9,3,36,1,9,"set_suspended@101-110@sbin/pflogd/pflogd.c","sbin/pflogd/pflogd.c","set_suspended",101,110
20,6,141,1,23,"copy_argv@113-136@sbin/pflogd/pflogd.c","sbin/pflogd/pflogd.c","copy_argv",113,136
11,2,61,3,11,"logmsg@139-150@sbin/pflogd/pflogd.c","sbin/pflogd/pflogd.c","logmsg",139,150
7,1,32,1,6,"usage@153-159@sbin/pflogd/pflogd.c","sbin/pflogd/pflogd.c","usage",153,159
4,1,11,1,3,"sig_close@162-165@sbin/pflogd/pflogd.c","sbin/pflogd/pflogd.c","sig_close",162,165
4,1,11,1,3,"sig_hup@168-171@sbin/pflogd/pflogd.c","sbin/pflogd/pflogd.c","sig_hup",168,171
4,1,11,1,3,"sig_alrm@174-177@sbin/pflogd/pflogd.c","sbin/pflogd/pflogd.c","sig_alrm",174,177
11,3,73,1,11,"set_pcap_filter@180-191@sbin/pflogd/pflogd.c","sbin/pflogd/pflogd.c","set_pcap_filter",180,191
4,1,18,1,3,"if_exists@194-197@sbin/pflogd/pflogd.c","sbin/pflogd/pflogd.c","if_exists",194,197
20,4,120,1,24,"init_pcap@200-224@sbin/pflogd/pflogd.c","sbin/pflogd/pflogd.c","init_pcap",200,224
9,3,38,1,11,"set_snaplen@227-238@sbin/pflogd/pflogd.c","sbin/pflogd/pflogd.c","set_snaplen",227,238
10,3,37,1,11,"reset_dump@241-252@sbin/pflogd/pflogd.c","sbin/pflogd/pflogd.c","reset_dump",241,252
64,14,381,1,81,"try_reset_dump@259-340@sbin/pflogd/pflogd.c","sbin/pflogd/pflogd.c","try_reset_dump",259,340
48,16,295,2,65,"scan_dump@343-408@sbin/pflogd/pflogd.c","sbin/pflogd/pflogd.c","scan_dump",343,408
26,6,170,3,32,"dump_packet_nobuf@412-444@sbin/pflogd/pflogd.c","sbin/pflogd/pflogd.c","dump_packet_nobuf",412,444
26,4,141,1,30,"flush_buffer@447-477@sbin/pflogd/pflogd.c","sbin/pflogd/pflogd.c","flush_buffer",447,477
8,1,27,1,8,"purge_buffer@480-488@sbin/pflogd/pflogd.c","sbin/pflogd/pflogd.c","purge_buffer",480,488
32,7,179,3,39,"dump_packet@492-531@sbin/pflogd/pflogd.c","sbin/pflogd/pflogd.c","dump_packet",492,531
140,35,700,2,164,"main@534-698@sbin/pflogd/pflogd.c","sbin/pflogd/pflogd.c","main",534,698
120,28,811,3,147,"priv_init@66-213@sbin/pflogd/privsep.c","sbin/pflogd/privsep.c","priv_init",66,213
8,2,31,1,9,"set_snaplen@217-226@sbin/pflogd/privsep.c","sbin/pflogd/privsep.c","set_snaplen",217,226
32,6,167,1,38,"move_log@229-267@sbin/pflogd/privsep.c","sbin/pflogd/privsep.c","move_log",229,267
28,5,183,1,35,"priv_init_pcap@272-307@sbin/pflogd/privsep.c","sbin/pflogd/privsep.c","priv_init_pcap",272,307
13,3,87,1,19,"priv_set_snaplen@313-332@sbin/pflogd/privsep.c","sbin/pflogd/privsep.c","priv_set_snaplen",313,332
10,2,55,1,12,"priv_open_log@336-348@sbin/pflogd/privsep.c","sbin/pflogd/privsep.c","priv_open_log",336,348
10,2,61,1,12,"priv_move_log@352-364@sbin/pflogd/privsep.c","sbin/pflogd/privsep.c","priv_move_log",352,364
7,2,30,1,7,"sig_pass_to_chld@368-375@sbin/pflogd/privsep.c","sbin/pflogd/privsep.c","sig_pass_to_chld",368,375
18,6,91,3,18,"may_read@379-397@sbin/pflogd/privsep.c","sbin/pflogd/privsep.c","may_read",379,397
17,6,86,3,17,"must_read@402-419@sbin/pflogd/privsep.c","sbin/pflogd/privsep.c","must_read",402,419
17,6,86,3,17,"must_write@424-441@sbin/pflogd/privsep.c","sbin/pflogd/privsep.c","must_write",424,441
33,4,225,2,36,"send_fd@50-86@sbin/pflogd/privsep_fdpass.c","sbin/pflogd/privsep_fdpass.c","send_fd",50,86
42,6,249,1,43,"receive_fd@89-132@sbin/pflogd/privsep_fdpass.c","sbin/pflogd/privsep_fdpass.c","receive_fd",89,132
539,169,3726,2,635,"main@241-876@sbin/ping/ping.c","sbin/ping/ping.c","main",241,876
14,4,37,1,13,"onsignal@879-892@sbin/ping/ping.c","sbin/ping/ping.c","onsignal",879,892
26,8,265,2,27,"fill@895-922@sbin/ping/ping.c","sbin/ping/ping.c","fill",895,922
24,5,135,1,25,"summary@925-950@sbin/ping/ping.c","sbin/ping/ping.c","summary",925,950
11,3,70,2,12,"pr_addr@957-969@sbin/ping/ping.c","sbin/ping/ping.c","pr_addr",957,969
22,5,126,1,31,"retransmit@976-1007@sbin/ping/ping.c","sbin/ping/ping.c","retransmit",976,1007
66,13,497,1,81,"pinger@1018-1099@sbin/ping/ping.c","sbin/ping/ping.c","pinger",1018,1099
179,50,1142,3,202,"pr_pack@1109-1311@sbin/ping/ping.c","sbin/ping/ping.c","pr_pack",1109,1311
111,22,600,2,114,"pr_ipopt@1314-1428@sbin/ping/ping.c","sbin/ping/ping.c","pr_ipopt",1314,1428
19,3,112,2,28,"in_cksum@1435-1463@sbin/ping/ping.c","sbin/ping/ping.c","in_cksum",1435,1463
156,40,603,1,164,"pr_icmph@1470-1634@sbin/ping/ping.c","sbin/ping/ping.c","pr_icmph",1470,1634
19,2,173,1,21,"pr_iph@1641-1662@sbin/ping/ping.c","sbin/ping/ping.c","pr_iph",1641,1662
14,3,131,1,15,"pr_retip@1669-1684@sbin/ping/ping.c","sbin/ping/ping.c","pr_retip",1669,1684
43,3,253,2,45,"map_tos@1688-1733@sbin/ping/ping.c","sbin/ping/ping.c","map_tos",1688,1733
24,7,121,1,25,"pr_exthdrs@1737-1762@sbin/ping/ping.c","sbin/ping/ping.c","pr_exthdrs",1737,1762
39,5,206,1,44,"pr_ip6opt@1765-1809@sbin/ping/ping.c","sbin/ping/ping.c","pr_ip6opt",1765,1809
26,5,179,1,30,"pr_rthdr@1812-1842@sbin/ping/ping.c","sbin/ping/ping.c","pr_rthdr",1812,1842
14,6,105,1,16,"get_hoplim@1845-1861@sbin/ping/ping.c","sbin/ping/ping.c","get_hoplim",1845,1861
34,12,221,2,51,"get_pathmtu@1864-1915@sbin/ping/ping.c","sbin/ping/ping.c","get_pathmtu",1864,1915
113,27,513,2,116,"pr_icmph6@1922-2038@sbin/ping/ping.c","sbin/ping/ping.c","pr_icmph6",1922,2038
19,3,185,1,20,"pr_iph6@2045-2065@sbin/ping/ping.c","sbin/ping/ping.c","pr_iph6",2045,2065
71,14,461,2,75,"pr_retip6@2072-2147@sbin/ping/ping.c","sbin/ping/ping.c","pr_retip6",2072,2147
16,2,39,1,17,"usage@2150-2167@sbin/ping/ping.c","sbin/ping/ping.c","usage",2150,2167
79,26,502,2,79,"main@131-210@sbin/quotacheck/quotacheck.c","sbin/quotacheck/quotacheck.c","main",131,210
7,1,29,1,6,"usage@213-219@sbin/quotacheck/quotacheck.c","sbin/quotacheck/quotacheck.c","usage",213,219
28,12,207,1,28,"needchk@222-250@sbin/quotacheck/quotacheck.c","sbin/quotacheck/quotacheck.c","needchk",222,250
124,44,863,5,131,"chkquota@261-392@sbin/quotacheck/quotacheck.c","sbin/quotacheck/quotacheck.c","chkquota",261,392
85,28,668,3,91,"update@398-489@sbin/quotacheck/quotacheck.c","sbin/quotacheck/quotacheck.c","update",398,489
18,6,116,3,20,"oneof_realpath@495-515@sbin/quotacheck/quotacheck.c","sbin/quotacheck/quotacheck.c","oneof_realpath",495,515
23,6,153,3,26,"oneof_specname@521-547@sbin/quotacheck/quotacheck.c","sbin/quotacheck/quotacheck.c","oneof_specname",521,547
7,2,37,1,7,"getquotagid@553-560@sbin/quotacheck/quotacheck.c","sbin/quotacheck/quotacheck.c","getquotagid",553,560
32,10,253,3,32,"hasquota@566-598@sbin/quotacheck/quotacheck.c","sbin/quotacheck/quotacheck.c","hasquota",566,598
8,3,61,2,8,"lookup@606-614@sbin/quotacheck/quotacheck.c","sbin/quotacheck/quotacheck.c","lookup",606,614
24,6,184,3,24,"addid@620-644@sbin/quotacheck/quotacheck.c","sbin/quotacheck/quotacheck.c","addid",620,644
29,6,155,1,33,"getnextinode@656-689@sbin/quotacheck/quotacheck.c","sbin/quotacheck/quotacheck.c","getnextinode",656,689
27,7,184,1,27,"setinodebuf@695-722@sbin/quotacheck/quotacheck.c","sbin/quotacheck/quotacheck.c","setinodebuf",695,722
5,1,15,1,5,"freeinodebuf@728-733@sbin/quotacheck/quotacheck.c","sbin/quotacheck/quotacheck.c","freeinodebuf",728,733
5,2,44,3,4,"bread@739-743@sbin/quotacheck/quotacheck.c","sbin/quotacheck/quotacheck.c","bread",739,743
9,4,42,1,8,"sleep_while_procs@61-69@sbin/reboot/reboot.c","sbin/reboot/reboot.c","sleep_while_procs",61,69
139,42,816,2,198,"main@72-270@sbin/reboot/reboot.c","sbin/reboot/reboot.c","main",72,270
6,2,26,1,5,"usage@273-278@sbin/reboot/reboot.c","sbin/reboot/reboot.c","usage",273,278
65,18,463,1,65,"extractdirs@135-200@sbin/restore/dirs.c","sbin/restore/dirs.c","extractdirs",135,200
6,3,28,1,6,"skipdirs@206-212@sbin/restore/dirs.c","sbin/restore/dirs.c","skipdirs",206,212
46,10,349,3,59,"treescan@219-278@sbin/restore/dirs.c","sbin/restore/dirs.c","treescan",219,278
18,5,115,1,18,"pathsearch@284-302@sbin/restore/dirs.c","sbin/restore/dirs.c","pathsearch",284,302
17,5,110,2,17,"searchdir@309-326@sbin/restore/dirs.c","sbin/restore/dirs.c","searchdir",309,326
57,19,368,2,60,"putdir@332-392@sbin/restore/dirs.c","sbin/restore/dirs.c","putdir",332,392
13,2,92,1,12,"putent@405-417@sbin/restore/dirs.c","sbin/restore/dirs.c","putent",405,417
7,1,50,1,6,"flushent@423-429@sbin/restore/dirs.c","sbin/restore/dirs.c","flushent",423,429
12,2,93,2,12,"dcvt@432-444@sbin/restore/dirs.c","sbin/restore/dirs.c","dcvt",432,444
12,4,105,3,12,"rst_seekdir@454-466@sbin/restore/dirs.c","sbin/restore/dirs.c","rst_seekdir",454,466
34,10,209,1,34,"rst_readdir@472-506@sbin/restore/dirs.c","sbin/restore/dirs.c","rst_readdir",472,506
13,2,77,1,13,"rst_opendir@512-525@sbin/restore/dirs.c","sbin/restore/dirs.c","rst_opendir",512,525
6,1,25,1,5,"rst_closedir@531-536@sbin/restore/dirs.c","sbin/restore/dirs.c","rst_closedir",531,536
5,1,36,1,4,"rst_telldir@542-546@sbin/restore/dirs.c","sbin/restore/dirs.c","rst_telldir",542,546
14,3,85,1,14,"opendirfile@552-566@sbin/restore/dirs.c","sbin/restore/dirs.c","opendirfile",552,566
58,17,382,1,58,"setdirmodes@572-630@sbin/restore/dirs.c","sbin/restore/dirs.c","setdirmodes",572,630
26,6,205,2,26,"genliteraldir@636-662@sbin/restore/dirs.c","sbin/restore/dirs.c","genliteraldir",636,662
8,2,35,1,8,"inodetype@668-676@sbin/restore/dirs.c","sbin/restore/dirs.c","inodetype",668,676
29,3,272,3,29,"allocinotab@683-712@sbin/restore/dirs.c","sbin/restore/dirs.c","allocinotab",683,712
8,3,52,1,8,"inotablookup@718-726@sbin/restore/dirs.c","sbin/restore/dirs.c","inotablookup",718,726
8,3,44,1,8,"cleanup@732-740@sbin/restore/dirs.c","sbin/restore/dirs.c","cleanup",732,740
155,40,833,1,194,"runcmdshell@92-286@sbin/restore/interactive.c","sbin/restore/interactive.c","runcmdshell",92,286
72,19,471,6,98,"getcmd@300-398@sbin/restore/interactive.c","sbin/restore/interactive.c","getcmd",300,398
33,13,187,2,42,"copynext@404-446@sbin/restore/interactive.c","sbin/restore/interactive.c","copynext",404,446
37,17,296,3,43,"canon@453-496@sbin/restore/interactive.c","sbin/restore/interactive.c","canon",453,496
77,21,545,2,77,"printlist@502-579@sbin/restore/interactive.c","sbin/restore/interactive.c","printlist",502,579
44,18,253,3,50,"mkentry@585-635@sbin/restore/interactive.c","sbin/restore/interactive.c","mkentry",585,635
60,18,383,2,60,"formatf@641-701@sbin/restore/interactive.c","sbin/restore/interactive.c","formatf",641,701
15,5,98,1,15,"glob_readdir@713-728@sbin/restore/interactive.c","sbin/restore/interactive.c","glob_readdir",713,728
12,5,83,2,12,"glob_stat@734-746@sbin/restore/interactive.c","sbin/restore/interactive.c","glob_stat",734,746
5,1,42,2,4,"fcmp@752-756@sbin/restore/interactive.c","sbin/restore/interactive.c","fcmp",752,756
9,4,45,1,9,"onintr@762-771@sbin/restore/interactive.c","sbin/restore/interactive.c","onintr",762,771
168,47,872,2,200,"main@70-270@sbin/restore/main.c","sbin/restore/main.c","main",70,270
5,1,23,1,5,"usage@273-278@sbin/restore/main.c","sbin/restore/main.c","usage",273,278
52,14,342,2,65,"obsolete@286-351@sbin/restore/main.c","sbin/restore/main.c","obsolete",286,351
9,4,75,3,9,"listfile@51-60@sbin/restore/restore.c","sbin/restore/restore.c","listfile",51,60
32,8,196,3,32,"addfile@67-99@sbin/restore/restore.c","sbin/restore/restore.c","addfile",67,99
15,5,89,3,15,"deletefile@107-122@sbin/restore/restore.c","sbin/restore/restore.c","deletefile",107,122
25,6,136,1,25,"removeoldleaves@144-169@sbin/restore/restore.c","sbin/restore/restore.c","removeoldleaves",144,169
158,47,962,3,281,"nodeupdates@181-462@sbin/restore/restore.c","sbin/restore/restore.c","nodeupdates",181,462
15,5,119,1,15,"keyval@468-483@sbin/restore/restore.c","sbin/restore/restore.c","keyval",468,483
33,11,206,1,36,"findunreflinks@489-525@sbin/restore/restore.c","sbin/restore/restore.c","findunreflinks",489,525
22,5,120,1,22,"removeoldnodes@537-559@sbin/restore/restore.c","sbin/restore/restore.c","removeoldnodes",537,559
50,10,297,1,74,"createleaves@566-640@sbin/restore/restore.c","sbin/restore/restore.c","createleaves",566,640
52,14,296,1,82,"createfiles@647-729@sbin/restore/restore.c","sbin/restore/restore.c","createfiles",647,729
23,6,159,1,23,"createlinks@735-758@sbin/restore/restore.c","sbin/restore/restore.c","createlinks",735,758
15,5,96,1,15,"checkrestore@766-781@sbin/restore/restore.c","sbin/restore/restore.c","checkrestore",766,781
21,8,136,3,21,"verifyfile@788-809@sbin/restore/restore.c","sbin/restore/restore.c","verifyfile",788,809
10,5,66,1,10,"lookupino@76-86@sbin/restore/symtab.c","sbin/restore/symtab.c","lookupino",76,86
15,6,104,2,15,"addino@92-107@sbin/restore/symtab.c","sbin/restore/symtab.c","addino",92,107
18,5,112,1,18,"deleteino@113-131@sbin/restore/symtab.c","sbin/restore/symtab.c","deleteino",113,131
23,10,161,1,23,"lookupname@137-160@sbin/restore/symtab.c","sbin/restore/symtab.c","lookupname",137,160
16,4,85,1,16,"lookupparent@166-182@sbin/restore/symtab.c","sbin/restore/symtab.c","lookupparent",166,182
15,3,104,1,15,"myname@188-203@sbin/restore/symtab.c","sbin/restore/symtab.c","myname",188,203
42,10,287,3,42,"addentry@215-257@sbin/restore/symtab.c","sbin/restore/symtab.c","addentry",215,257
37,12,213,1,37,"freeentry@263-300@sbin/restore/symtab.c","sbin/restore/symtab.c","freeentry",263,300
22,4,142,2,22,"moveentry@306-328@sbin/restore/symtab.c","sbin/restore/symtab.c","moveentry",306,328
17,5,94,1,17,"removeentry@334-351@sbin/restore/symtab.c","sbin/restore/symtab.c","removeentry",334,351
20,4,121,1,20,"savename@379-399@sbin/restore/symtab.c","sbin/restore/symtab.c","savename",379,399
8,1,52,1,8,"freename@406-414@sbin/restore/symtab.c","sbin/restore/symtab.c","freename",406,414
69,14,530,2,79,"dumpsymtable@433-512@sbin/restore/symtab.c","sbin/restore/symtab.c","dumpsymtable",433,512
80,20,586,1,87,"initsymtable@518-605@sbin/restore/symtab.c","sbin/restore/symtab.c","initsymtable",518,605
27,8,155,1,34,"setinput@134-168@sbin/restore/tape.c","sbin/restore/tape.c","setinput",134,168
12,3,57,1,12,"newtapebuf@171-183@sbin/restore/tape.c","sbin/restore/tape.c","newtapebuf",171,183
78,26,521,1,80,"setup@190-270@sbin/restore/tape.c","sbin/restore/tape.c","setup",190,270
139,42,865,1,158,"getvol@280-438@sbin/restore/tape.c","sbin/restore/tape.c","getvol",280,438
15,4,70,1,15,"terminateinput@444-459@sbin/restore/tape.c","sbin/restore/tape.c","terminateinput",444,459
15,7,84,1,17,"setdumpnum@466-483@sbin/restore/tape.c","sbin/restore/tape.c","setdumpnum",466,483
14,3,110,1,14,"printdumpinfo@486-500@sbin/restore/tape.c","sbin/restore/tape.c","printdumpinfo",486,500
122,23,796,1,131,"extractfile@503-634@sbin/restore/tape.c","sbin/restore/tape.c","extractfile",503,634
5,3,24,1,5,"skipmaps@640-645@sbin/restore/tape.c","sbin/restore/tape.c","skipmaps",640,645
5,1,19,1,5,"skipfile@651-656@sbin/restore/tape.c","sbin/restore/tape.c","skipfile",651,656
55,22,409,2,55,"getfile@668-723@sbin/restore/tape.c","sbin/restore/tape.c","getfile",668,723
8,3,51,2,8,"xtrfile@729-737@sbin/restore/tape.c","sbin/restore/tape.c","xtrfile",729,737
6,2,48,2,6,"xtrskip@744-750@sbin/restore/tape.c","sbin/restore/tape.c","xtrskip",744,750
8,2,56,2,8,"xtrlnkfile@756-764@sbin/restore/tape.c","sbin/restore/tape.c","xtrlnkfile",756,764
4,1,22,2,4,"xtrlnkskip@771-775@sbin/restore/tape.c","sbin/restore/tape.c","xtrlnkskip",771,775
5,1,24,2,5,"xtrmap@781-786@sbin/restore/tape.c","sbin/restore/tape.c","xtrmap",781,786
5,1,20,2,5,"xtrmapskip@793-798@sbin/restore/tape.c","sbin/restore/tape.c","xtrmapskip",793,798
4,1,13,2,4,"xtrnull@805-809@sbin/restore/tape.c","sbin/restore/tape.c","xtrnull",805,809
91,29,530,1,112,"readtape@816-928@sbin/restore/tape.c","sbin/restore/tape.c","readtape",816,928
21,6,127,1,24,"findtapeblksize@931-955@sbin/restore/tape.c","sbin/restore/tape.c","findtapeblksize",931,955
9,4,31,1,11,"closemt@958-969@sbin/restore/tape.c","sbin/restore/tape.c","closemt",958,969
91,23,618,1,108,"gethead@978-1086@sbin/restore/tape.c","sbin/restore/tape.c","gethead",978,1086
60,16,298,1,63,"accthdr@1092-1155@sbin/restore/tape.c","sbin/restore/tape.c","accthdr",1092,1155
59,16,331,1,72,"findinode@1162-1234@sbin/restore/tape.c","sbin/restore/tape.c","findinode",1162,1234
21,5,109,1,22,"checksum@1237-1259@sbin/restore/tape.c","sbin/restore/tape.c","checksum",1237,1259
7,1,38,2,7,"msg@1265-1272@sbin/restore/tape.c","sbin/restore/tape.c","msg",1265,1272
35,1,373,1,41,"swap_header@1276-1317@sbin/restore/tape.c","sbin/restore/tape.c","swap_header",1276,1317
21,1,243,1,23,"swap_old_header@1320-1343@sbin/restore/tape.c","sbin/restore/tape.c","swap_old_header",1320,1343
21,5,117,1,22,"pathcheck@54-76@sbin/restore/utilities.c","sbin/restore/utilities.c","pathcheck",54,76
12,2,92,1,12,"mktempname@82-94@sbin/restore/utilities.c","sbin/restore/utilities.c","mktempname",82,94
14,4,100,1,14,"gentempname@100-114@sbin/restore/utilities.c","sbin/restore/utilities.c","gentempname",100,114
8,3,50,2,7,"renameit@120-127@sbin/restore/utilities.c","sbin/restore/utilities.c","renameit",120,127
13,4,75,1,13,"newnode@133-146@sbin/restore/utilities.c","sbin/restore/utilities.c","newnode",133,146
16,5,94,1,16,"removenode@152-168@sbin/restore/utilities.c","sbin/restore/utilities.c","removenode",152,168
14,4,79,1,14,"removeleaf@174-188@sbin/restore/utilities.c","sbin/restore/utilities.c","removeleaf",174,188
23,8,137,3,23,"linkit@194-217@sbin/restore/utilities.c","sbin/restore/utilities.c","linkit",194,217
12,5,67,1,12,"lowerbnd@223-235@sbin/restore/utilities.c","sbin/restore/utilities.c","lowerbnd",223,235
12,5,67,1,12,"upperbnd@241-253@sbin/restore/utilities.c","sbin/restore/utilities.c","upperbnd",241,253
20,6,179,2,20,"badentry@259-279@sbin/restore/utilities.c","sbin/restore/utilities.c","badentry",259,279
19,7,171,1,19,"flagvalues@285-304@sbin/restore/utilities.c","sbin/restore/utilities.c","flagvalues",285,304
9,4,67,1,10,"dirlookup@310-320@sbin/restore/utilities.c","sbin/restore/utilities.c","dirlookup",310,320
15,7,90,1,15,"reply@326-341@sbin/restore/utilities.c","sbin/restore/utilities.c","reply",326,341
14,4,70,2,14,"panic@347-361@sbin/restore/utilities.c","sbin/restore/utilities.c","panic",347,361
12,2,45,1,12,"usage@127-139@sbin/route/route.c","sbin/route/route.c","usage",127,139
108,35,537,2,121,"main@146-267@sbin/route/route.c","sbin/route/route.c","main",146,267
127,40,783,2,135,"flushroutes@274-409@sbin/route/route.c","sbin/route/route.c","flushroutes",274,409
36,15,177,2,37,"set_metric@412-449@sbin/route/route.c","sbin/route/route.c","set_metric",412,449
252,98,1274,2,254,"newroute@452-706@sbin/route/route.c","sbin/route/route.c","newroute",452,706
41,12,184,2,43,"show@709-752@sbin/route/route.c","sbin/route/route.c","show",709,752
41,12,276,3,41,"inet_makenetandmask@755-796@sbin/route/route.c","sbin/route/route.c","inet_makenetandmask",755,796
34,11,253,2,40,"inet6_makenetandmask@802-842@sbin/route/route.c","sbin/route/route.c","inet6_makenetandmask",802,842
140,39,884,3,151,"getaddr@849-1000@sbin/route/route.c","sbin/route/route.c","getaddr",849,1000
20,3,128,2,21,"getmplslabel@1003-1024@sbin/route/route.c","sbin/route/route.c","getmplslabel",1003,1024
42,8,292,1,45,"prefixlen@1027-1072@sbin/route/route.c","sbin/route/route.c","prefixlen",1027,1072
27,6,201,1,27,"interfaces@1075-1102@sbin/route/route.c","sbin/route/route.c","interfaces",1075,1102
23,6,140,2,24,"monitor@1105-1129@sbin/route/route.c","sbin/route/route.c","monitor",1105,1129
61,15,402,4,73,"rtmsg@1137-1210@sbin/route/route.c","sbin/route/route.c","rtmsg",1137,1210
25,9,199,3,25,"mask_addr@1213-1238@sbin/route/route.c","sbin/route/route.c","mask_addr",1213,1238
11,3,75,2,11,"get_linkstate@1277-1288@sbin/route/route.c","sbin/route/route.c","get_linkstate",1277,1288
161,29,1023,2,168,"print_rtmsg@1291-1459@sbin/route/route.c","sbin/route/route.c","print_rtmsg",1291,1459
25,10,92,1,24,"priorityname@1462-1486@sbin/route/route.c","sbin/route/route.c","priorityname",1462,1486
30,8,116,1,31,"getpriority@1489-1520@sbin/route/route.c","sbin/route/route.c","getpriority",1489,1520
105,34,621,2,117,"print_getmsg@1523-1640@sbin/route/route.c","sbin/route/route.c","print_getmsg",1523,1640
18,5,57,1,17,"bfd_state@1644-1661@sbin/route/route.c","sbin/route/route.c","bfd_state",1644,1661
33,10,107,1,32,"bfd_diag@1664-1696@sbin/route/route.c","sbin/route/route.c","bfd_diag",1664,1696
17,4,97,1,18,"bfd_calc_uptime@1699-1717@sbin/route/route.c","sbin/route/route.c","bfd_calc_uptime",1699,1717
7,1,57,1,7,"print_bfdmsg@1720-1727@sbin/route/route.c","sbin/route/route.c","print_bfdmsg",1720,1727
42,6,283,2,48,"print_sabfd@1730-1778@sbin/route/route.c","sbin/route/route.c","print_sabfd",1730,1778
8,1,62,1,7,"pmsg_common@1782-1789@sbin/route/route.c","sbin/route/route.c","pmsg_common",1782,1789
38,11,202,2,40,"pmsg_addrs@1792-1832@sbin/route/route.c","sbin/route/route.c","pmsg_addrs",1792,1832
23,8,132,3,23,"bprintf@1835-1858@sbin/route/route.c","sbin/route/route.c","bprintf",1835,1858
4,1,33,2,3,"keycmp@1861-1864@sbin/route/route.c","sbin/route/route.c","keycmp",1861,1864
9,2,62,1,10,"keyword@1867-1877@sbin/route/route.c","sbin/route/route.c","keyword",1867,1877
20,4,106,2,20,"sodump@1880-1900@sbin/route/route.c","sbin/route/route.c","sodump",1880,1900
39,15,283,2,39,"sockaddr@1912-1951@sbin/route/route.c","sbin/route/route.c","sockaddr",1912,1951
10,2,71,1,9,"getlabel@1954-1963@sbin/route/route.c","sbin/route/route.c","getlabel",1954,1963
21,3,136,1,23,"gettable@1966-1989@sbin/route/route.c","sbin/route/route.c","gettable",1966,1989
10,4,67,2,9,"rdomain@1992-2001@sbin/route/route.c","sbin/route/route.c","rdomain",1992,2001
52,9,304,1,54,"print_rtdns@2007-2061@sbin/route/route.c","sbin/route/route.c","print_rtdns",2007,2061
75,11,498,1,80,"print_rtstatic@2067-2147@sbin/route/route.c","sbin/route/route.c","print_rtstatic",2067,2147
18,3,104,1,19,"print_rtsearch@2153-2172@sbin/route/route.c","sbin/route/route.c","print_rtsearch",2153,2172
48,12,321,4,52,"p_rttables@114-166@sbin/route/show.c","sbin/route/show.c","p_rttables",114,166
19,5,52,1,19,"WID_DST@176-195@sbin/route/show.c","sbin/route/show.c","WID_DST",176,195
24,4,126,1,23,"pr_rthdr@201-224@sbin/route/show.c","sbin/route/show.c","pr_rthdr",201,224
12,3,87,3,12,"get_rtaddrs@227-239@sbin/route/show.c","sbin/route/show.c","get_rtaddrs",227,239
48,13,378,1,56,"p_rtentry@245-301@sbin/route/show.c","sbin/route/show.c","p_rtentry",245,301
25,6,80,1,25,"pr_family@307-332@sbin/route/show.c","sbin/route/show.c","pr_family",307,332
39,11,230,4,45,"p_sockaddr@335-380@sbin/route/show.c","sbin/route/show.c","p_sockaddr",335,380
13,4,103,4,14,"p_sockaddr_mpls@386-400@sbin/route/show.c","sbin/route/show.c","p_sockaddr_mpls",386,400
10,4,82,2,10,"p_flags@403-413@sbin/route/show.c","sbin/route/show.c","p_flags",403,413
59,15,410,1,66,"routename@416-482@sbin/route/show.c","sbin/route/show.c","routename",416,482
20,8,135,1,21,"routename4@485-506@sbin/route/show.c","sbin/route/show.c","routename4",485,506
12,3,75,1,14,"routename6@509-523@sbin/route/show.c","sbin/route/show.c","routename6",509,523
30,13,294,2,32,"netname4@530-562@sbin/route/show.c","sbin/route/show.c","netname4",530,562
82,22,441,2,89,"netname6@565-654@sbin/route/show.c","sbin/route/show.c","netname6",565,654
20,5,122,2,19,"netname@661-680@sbin/route/show.c","sbin/route/show.c","netname",661,680
15,3,132,1,15,"any_ntoa@685-700@sbin/route/show.c","sbin/route/show.c","any_ntoa",685,700
17,6,120,1,17,"link_print@703-720@sbin/route/show.c","sbin/route/show.c","link_print",703,720
15,5,60,1,14,"mpls_op@723-737@sbin/route/show.c","sbin/route/show.c","mpls_op",723,737
10,2,71,1,11,"label_print@740-751@sbin/route/show.c","sbin/route/show.c","label_print",740,751
62,21,312,2,75,"main@126-201@sbin/savecore/savecore.c","sbin/savecore/savecore.c","main",126,201
70,17,536,1,86,"kmem_setup@206-292@sbin/savecore/savecore.c","sbin/savecore/savecore.c","kmem_setup",206,292
38,9,254,1,43,"check_kmem@295-338@sbin/savecore/savecore.c","sbin/savecore/savecore.c","check_kmem",295,338
16,3,96,1,24,"dump_exists@341-365@sbin/savecore/savecore.c","sbin/savecore/savecore.c","dump_exists",341,365
6,2,30,1,6,"clear_dump@368-374@sbin/savecore/savecore.c","sbin/savecore/savecore.c","clear_dump",368,374
139,37,1015,1,157,"save_core@379-536@sbin/savecore/savecore.c","sbin/savecore/savecore.c","save_core",379,536
33,7,244,2,33,"find_dev@539-572@sbin/savecore/savecore.c","sbin/savecore/savecore.c","find_dev",539,572
15,4,122,1,15,"rawname@575-590@sbin/savecore/savecore.c","sbin/savecore/savecore.c","rawname",575,590
16,5,99,1,18,"get_crashtime@593-611@sbin/savecore/savecore.c","sbin/savecore/savecore.c","get_crashtime",593,611
50,12,336,1,53,"check_space@614-667@sbin/savecore/savecore.c","sbin/savecore/savecore.c","check_space",614,667
7,1,25,1,6,"usage@670-676@sbin/savecore/savecore.c","sbin/savecore/savecore.c","usage",670,676
83,21,616,3,96,"zwrite@210-306@sbin/savecore/zopen.c","sbin/savecore/zopen.c","zwrite",210,306
29,5,200,4,31,"z_close@309-340@sbin/savecore/zopen.c","sbin/savecore/zopen.c","z_close",309,340
4,1,20,1,3,"zclose@343-346@sbin/savecore/zopen.c","sbin/savecore/zopen.c","zclose",343,346
67,16,461,2,87,"output@369-456@sbin/savecore/zopen.c","sbin/savecore/zopen.c","output",369,456
25,5,151,1,27,"cl_block@460-487@sbin/savecore/zopen.c","sbin/savecore/zopen.c","cl_block",460,487
29,3,221,2,29,"cl_hash@491-520@sbin/savecore/zopen.c","sbin/savecore/zopen.c","cl_hash",491,520
20,6,147,3,19,"zopen@523-542@sbin/savecore/zopen.c","sbin/savecore/zopen.c","zopen",523,542
29,9,219,6,34,"z_open@545-579@sbin/savecore/zopen.c","sbin/savecore/zopen.c","z_open",545,579
61,12,471,4,70,"ufsscan@50-120@sbin/scan_ffs/scan_ffs.c","sbin/scan_ffs/scan_ffs.c","ufsscan",50,120
7,1,25,1,7,"usage@124-131@sbin/scan_ffs/scan_ffs.c","sbin/scan_ffs/scan_ffs.c","usage",124,131
42,13,266,2,48,"main@135-183@sbin/scan_ffs/scan_ffs.c","sbin/scan_ffs/scan_ffs.c","main",135,183
17,2,107,1,20,"scsireq_reset@56-76@sbin/scsi/libscsi.c","sbin/scsi/libscsi.c","scsireq_reset",56,76
7,2,30,1,8,"scsireq_new@81-89@sbin/scsi/libscsi.c","sbin/scsi/libscsi.c","scsireq_new",81,89
155,41,807,6,200,"do_buff_decode@138-338@sbin/scsi/libscsi.c","sbin/scsi/libscsi.c","do_buff_decode",138,338
10,1,76,4,10,"scsireq_decode_visit@341-351@sbin/scsi/libscsi.c","sbin/scsi/libscsi.c","scsireq_decode_visit",341,351
6,1,58,5,7,"scsireq_buff_decode_visit@354-361@sbin/scsi/libscsi.c","sbin/scsi/libscsi.c","scsireq_buff_decode_visit",354,361
138,33,772,8,163,"next_field@395-558@sbin/scsi/libscsi.c","sbin/scsi/libscsi.c","next_field",395,558
96,24,506,7,120,"do_encode@561-681@sbin/scsi/libscsi.c","sbin/scsi/libscsi.c","do_encode",561,681
26,6,153,6,35,"scsireq_build@684-719@sbin/scsi/libscsi.c","sbin/scsi/libscsi.c","scsireq_build",684,719
25,6,158,7,34,"scsireq_build_visit@722-756@sbin/scsi/libscsi.c","sbin/scsi/libscsi.c","scsireq_build_visit",722,756
6,1,55,5,5,"scsireq_buff_encode_visit@759-764@sbin/scsi/libscsi.c","sbin/scsi/libscsi.c","scsireq_buff_encode_visit",759,764
7,1,56,4,6,"scsireq_encode_visit@767-773@sbin/scsi/libscsi.c","sbin/scsi/libscsi.c","scsireq_encode_visit",767,773
11,3,53,1,12,"scsi_debug_output@776-788@sbin/scsi/libscsi.c","sbin/scsi/libscsi.c","scsi_debug_output",776,788
9,3,38,2,10,"scsi_assoc_text@809-819@sbin/scsi/libscsi.c","sbin/scsi/libscsi.c","scsi_assoc_text",809,819
27,12,220,6,34,"scsi_dump@822-856@sbin/scsi/libscsi.c","sbin/scsi/libscsi.c","scsi_dump",822,856
4,1,44,1,3,"g_u_long@867-870@sbin/scsi/libscsi.c","sbin/scsi/libscsi.c","g_u_long",867,870
66,9,534,2,76,"sense_7x_dump@877-953@sbin/scsi/libscsi.c","sbin/scsi/libscsi.c","sense_7x_dump",877,953
20,6,116,2,25,"scsi_sense_dump@958-983@sbin/scsi/libscsi.c","sbin/scsi/libscsi.c","scsi_sense_dump",958,983
14,3,70,2,16,"scsi_retsts_dump@986-1002@sbin/scsi/libscsi.c","sbin/scsi/libscsi.c","scsi_retsts_dump",986,1002
40,13,252,3,50,"scsi_debug@1005-1055@sbin/scsi/libscsi.c","sbin/scsi/libscsi.c","scsi_debug",1005,1055
16,4,106,2,19,"scsi_open@1060-1079@sbin/scsi/libscsi.c","sbin/scsi/libscsi.c","scsi_open",1060,1079
8,2,49,2,10,"scsireq_enter@1082-1092@sbin/scsi/libscsi.c","sbin/scsi/libscsi.c","scsireq_enter",1082,1092
18,1,29,1,19,"usage@84-103@sbin/scsi/scsi.c","sbin/scsi/scsi.c","usage",84,103
47,13,233,2,48,"procargs@106-154@sbin/scsi/scsi.c","sbin/scsi/scsi.c","procargs",106,154
15,5,94,2,17,"iget@168-185@sbin/scsi/scsi.c","sbin/scsi/scsi.c","iget",168,185
15,4,85,2,17,"cget@190-207@sbin/scsi/scsi.c","sbin/scsi/scsi.c","cget",190,207
37,13,191,5,41,"arg_put@211-252@sbin/scsi/scsi.c","sbin/scsi/scsi.c","arg_put",211,252
101,19,562,4,121,"do_cmd@261-382@sbin/scsi/scsi.c","sbin/scsi/scsi.c","do_cmd",261,382
20,3,111,5,24,"mode_sense@384-408@sbin/scsi/scsi.c","sbin/scsi/scsi.c","mode_sense",384,408
18,3,99,4,21,"mode_select@410-431@sbin/scsi/scsi.c","sbin/scsi/scsi.c","mode_select",410,431
13,5,64,1,16,"skipwhite@438-454@sbin/scsi/scsi.c","sbin/scsi/scsi.c","skipwhite",438,454
50,16,262,1,61,"mode_lookup@459-520@sbin/scsi/scsi.c","sbin/scsi/scsi.c","mode_lookup",459,520
4,1,10,1,3,"edit_rewind@536-539@sbin/scsi/scsi.c","sbin/scsi/scsi.c","edit_rewind",536,539
17,4,88,1,21,"edit_done@542-563@sbin/scsi/scsi.c","sbin/scsi/scsi.c","edit_done",542,563
12,3,75,1,13,"edit_init@566-579@sbin/scsi/scsi.c","sbin/scsi/scsi.c","edit_init",566,579
11,4,88,5,11,"edit_check@582-593@sbin/scsi/scsi.c","sbin/scsi/scsi.c","edit_check",582,593
8,3,60,5,8,"edit_defaults@596-604@sbin/scsi/scsi.c","sbin/scsi/scsi.c","edit_defaults",596,604
10,4,71,5,11,"edit_report@607-618@sbin/scsi/scsi.c","sbin/scsi/scsi.c","edit_report",607,618
20,6,147,2,24,"edit_get@621-645@sbin/scsi/scsi.c","sbin/scsi/scsi.c","edit_get",621,645
52,14,354,1,54,"editit@648-702@sbin/scsi/scsi.c","sbin/scsi/scsi.c","editit",648,702
89,15,661,5,125,"mode_edit@705-830@sbin/scsi/scsi.c","sbin/scsi/scsi.c","mode_edit",705,830
20,6,127,2,28,"main@833-861@sbin/scsi/scsi.c","sbin/scsi/scsi.c","main",833,861
111,36,592,2,127,"main@104-231@sbin/shutdown/shutdown.c","sbin/shutdown/shutdown.c","main",104,231
34,10,181,1,38,"loop@234-272@sbin/shutdown/shutdown.c","sbin/shutdown/shutdown.c","loop",234,272
39,10,299,1,50,"timewarn@282-332@sbin/shutdown/shutdown.c","sbin/shutdown/shutdown.c","timewarn",282,332
4,1,14,1,3,"timeout@335-338@sbin/shutdown/shutdown.c","sbin/shutdown/shutdown.c","timeout",335,338
85,29,525,1,97,"die_you_gravy_sucking_pig_dog@341-438@sbin/shutdown/shutdown.c","sbin/shutdown/shutdown.c","die_you_gravy_sucking_pig_dog",341,438
64,24,430,1,79,"getoffset@443-522@sbin/shutdown/shutdown.c","sbin/shutdown/shutdown.c","getoffset",443,522
9,2,44,1,9,"doitfast@525-534@sbin/shutdown/shutdown.c","sbin/shutdown/shutdown.c","doitfast",525,534
18,2,115,1,18,"nolog@537-555@sbin/shutdown/shutdown.c","sbin/shutdown/shutdown.c","nolog",537,555
9,3,37,1,8,"finish@558-566@sbin/shutdown/shutdown.c","sbin/shutdown/shutdown.c","finish",558,566
4,1,13,1,3,"badtime@569-572@sbin/shutdown/shutdown.c","sbin/shutdown/shutdown.c","badtime",569,572
6,1,18,1,5,"usage@575-580@sbin/shutdown/shutdown.c","sbin/shutdown/shutdown.c","usage",575,580
36,6,255,1,42,"control_init@49-91@sbin/slaacd/control.c","sbin/slaacd/control.c","control_init",49,91
12,2,80,1,14,"control_listen@94-108@sbin/slaacd/control.c","sbin/slaacd/control.c","control_listen",94,108
8,2,37,1,7,"control_cleanup@111-118@sbin/slaacd/control.c","sbin/slaacd/control.c","control_cleanup",111,118
34,9,272,3,43,"control_accept@121-164@sbin/slaacd/control.c","sbin/slaacd/control.c","control_accept",121,164
9,2,42,1,10,"control_connbyfd@167-177@sbin/slaacd/control.c","sbin/slaacd/control.c","control_connbyfd",167,177
9,2,42,1,10,"control_connbypid@180-190@sbin/slaacd/control.c","sbin/slaacd/control.c","control_connbypid",180,190
17,3,118,1,22,"control_close@193-215@sbin/slaacd/control.c","sbin/slaacd/control.c","control_close",193,215
64,16,419,3,71,"control_dispatch_imsg@218-289@sbin/slaacd/control.c","sbin/slaacd/control.c","control_dispatch_imsg",218,289
8,2,76,1,9,"control_imsg_relay@292-301@sbin/slaacd/control.c","sbin/slaacd/control.c","control_imsg_relay",292,301
10,3,37,3,14,"engine_sig_handler@268-282@sbin/slaacd/engine.c","sbin/slaacd/engine.c","engine_sig_handler",268,282
40,9,319,2,56,"engine@285-341@sbin/slaacd/engine.c","sbin/slaacd/engine.c","engine",285,341
11,1,64,1,13,"engine_shutdown@344-357@sbin/slaacd/engine.c","sbin/slaacd/engine.c","engine_shutdown",344,357
6,1,38,4,5,"engine_imsg_compose_frontend@360-365@sbin/slaacd/engine.c","sbin/slaacd/engine.c","engine_imsg_compose_frontend",360,365
6,1,38,4,5,"engine_imsg_compose_main@368-373@sbin/slaacd/engine.c","sbin/slaacd/engine.c","engine_imsg_compose_main",368,373
142,36,843,3,157,"engine_dispatch_frontend@376-533@sbin/slaacd/engine.c","sbin/slaacd/engine.c","engine_dispatch_frontend",376,533
174,38,1095,3,206,"engine_dispatch_main@536-742@sbin/slaacd/engine.c","sbin/slaacd/engine.c","engine_dispatch_main",536,742
127,7,982,2,136,"send_interface_info@746-882@sbin/slaacd/engine.c","sbin/slaacd/engine.c","send_interface_info",746,882
20,4,113,2,20,"engine_showinfo_ctl@885-905@sbin/slaacd/engine.c","sbin/slaacd/engine.c","engine_showinfo_ctl",885,905
9,2,41,1,9,"get_slaacd_iface_by_id@909-918@sbin/slaacd/engine.c","sbin/slaacd/engine.c","get_slaacd_iface_by_id",909,918
28,5,167,1,31,"remove_slaacd_iface@921-952@sbin/slaacd/engine.c","sbin/slaacd/engine.c","remove_slaacd_iface",921,952
25,5,150,1,30,"free_ra@955-985@sbin/slaacd/engine.c","sbin/slaacd/engine.c","free_ra",955,985
178,37,1145,2,218,"parse_ra@988-1206@sbin/slaacd/engine.c","sbin/slaacd/engine.c","parse_ra",988,1206
48,3,483,4,65,"gen_addr@1209-1274@sbin/slaacd/engine.c","sbin/slaacd/engine.c","gen_addr",1209,1274
14,5,125,2,16,"in6_prefixlen2mask@1278-1294@sbin/slaacd/engine.c","sbin/slaacd/engine.c","in6_prefixlen2mask",1278,1294
21,10,169,1,21,"in6_mask2prefixlen@1299-1320@sbin/slaacd/engine.c","sbin/slaacd/engine.c","in6_mask2prefixlen",1299,1320
176,32,1005,1,190,"debug_log_ra@1323-1513@sbin/slaacd/engine.c","sbin/slaacd/engine.c","debug_log_ra",1323,1513
37,11,207,2,39,"parse_dnssl@1517-1556@sbin/slaacd/engine.c","sbin/slaacd/engine.c","parse_dnssl",1517,1556
146,28,741,2,173,"update_iface_ra@1558-1731@sbin/slaacd/engine.c","sbin/slaacd/engine.c","update_iface_ra",1558,1731
21,3,124,1,23,"timeout_from_lifetime@1734-1757@sbin/slaacd/engine.c","sbin/slaacd/engine.c","timeout_from_lifetime",1734,1757
15,1,122,1,18,"configure_address@1760-1778@sbin/slaacd/engine.c","sbin/slaacd/engine.c","configure_address",1760,1778
45,5,317,4,51,"gen_address_proposal@1781-1832@sbin/slaacd/engine.c","sbin/slaacd/engine.c","gen_address_proposal",1781,1832
7,2,30,1,7,"free_address_proposal@1835-1842@sbin/slaacd/engine.c","sbin/slaacd/engine.c","free_address_proposal",1835,1842
27,2,204,2,30,"gen_dfr_proposal@1845-1875@sbin/slaacd/engine.c","sbin/slaacd/engine.c","gen_dfr_proposal",1845,1875
28,4,195,1,38,"configure_dfr@1878-1916@sbin/slaacd/engine.c","sbin/slaacd/engine.c","configure_dfr",1878,1916
9,1,75,1,11,"withdraw_dfr@1919-1930@sbin/slaacd/engine.c","sbin/slaacd/engine.c","withdraw_dfr",1919,1930
14,3,54,1,14,"free_dfr_proposal@1933-1947@sbin/slaacd/engine.c","sbin/slaacd/engine.c","free_dfr_proposal",1933,1947
9,1,67,1,11,"send_proposal@1950-1961@sbin/slaacd/engine.c","sbin/slaacd/engine.c","send_proposal",1950,1961
11,1,66,1,14,"start_probe@1964-1978@sbin/slaacd/engine.c","sbin/slaacd/engine.c","start_probe",1964,1978
80,10,507,3,95,"address_proposal_timeout@1981-2076@sbin/slaacd/engine.c","sbin/slaacd/engine.c","address_proposal_timeout",1981,2076
68,7,420,3,78,"dfr_proposal_timeout@2079-2157@sbin/slaacd/engine.c","sbin/slaacd/engine.c","dfr_proposal_timeout",2079,2157
27,6,143,3,28,"iface_timeout@2160-2188@sbin/slaacd/engine.c","sbin/slaacd/engine.c","iface_timeout",2160,2188
10,2,68,2,11,"find_ra@2191-2202@sbin/slaacd/engine.c","sbin/slaacd/engine.c","find_ra",2191,2202
9,2,48,2,10,"find_address_proposal_by_id@2205-2215@sbin/slaacd/engine.c","sbin/slaacd/engine.c","find_address_proposal_by_id",2205,2215
10,2,62,2,11,"find_address_proposal_by_addr@2218-2229@sbin/slaacd/engine.c","sbin/slaacd/engine.c","find_address_proposal_by_addr",2218,2229
9,2,48,2,10,"find_dfr_proposal_by_id@2232-2242@sbin/slaacd/engine.c","sbin/slaacd/engine.c","find_dfr_proposal_by_id",2232,2242
23,3,139,4,24,"find_prefix@2247-2271@sbin/slaacd/engine.c","sbin/slaacd/engine.c","find_prefix",2247,2271
12,3,75,2,16,"real_lifetime@2274-2290@sbin/slaacd/engine.c","sbin/slaacd/engine.c","real_lifetime",2274,2290
10,3,37,3,14,"frontend_sig_handler@98-112@sbin/slaacd/frontend.c","sbin/slaacd/frontend.c","frontend_sig_handler",98,112
125,20,1120,3,167,"frontend@115-282@sbin/slaacd/frontend.c","sbin/slaacd/frontend.c","frontend",115,282
13,1,84,1,15,"frontend_shutdown@285-300@sbin/slaacd/frontend.c","sbin/slaacd/frontend.c","frontend_shutdown",285,300
6,1,38,4,5,"frontend_imsg_compose_main@303-308@sbin/slaacd/frontend.c","sbin/slaacd/frontend.c","frontend_imsg_compose_main",303,308
6,1,41,5,5,"frontend_imsg_compose_engine@311-316@sbin/slaacd/frontend.c","sbin/slaacd/frontend.c","frontend_imsg_compose_engine",311,316
65,20,379,3,80,"frontend_dispatch_main@319-399@sbin/slaacd/frontend.c","sbin/slaacd/frontend.c","frontend_dispatch_main",319,399
60,25,314,3,65,"frontend_dispatch_engine@402-467@sbin/slaacd/frontend.c","sbin/slaacd/frontend.c","frontend_dispatch_engine",402,467
8,2,58,1,8,"get_flags@470-478@sbin/slaacd/frontend.c","sbin/slaacd/frontend.c","get_flags",470,478
8,2,58,1,8,"get_xflags@481-489@sbin/slaacd/frontend.c","sbin/slaacd/frontend.c","get_xflags",481,489
19,2,141,2,24,"update_iface@492-516@sbin/slaacd/frontend.c","sbin/slaacd/frontend.c","update_iface",492,516
72,16,571,2,91,"update_autoconf_addresses@520-611@sbin/slaacd/frontend.c","sbin/slaacd/frontend.c","update_autoconf_addresses",520,611
14,4,99,1,19,"frontend_startup@615-634@sbin/slaacd/frontend.c","sbin/slaacd/frontend.c","frontend_startup",615,634
24,7,161,3,30,"route_receive@637-667@sbin/slaacd/frontend.c","sbin/slaacd/frontend.c","route_receive",637,667
103,21,705,2,115,"handle_route_message@670-785@sbin/slaacd/frontend.c","sbin/slaacd/frontend.c","handle_route_message",670,785
12,3,87,3,12,"get_rtaddrs@791-803@sbin/slaacd/frontend.c","sbin/slaacd/frontend.c","get_rtaddrs",791,803
37,9,258,3,41,"get_lladdr@806-847@sbin/slaacd/frontend.c","sbin/slaacd/frontend.c","get_lladdr",806,847
55,13,399,3,65,"icmp6_receive@850-915@sbin/slaacd/frontend.c","sbin/slaacd/frontend.c","icmp6_receive",850,915
13,2,90,1,16,"send_solicitation@918-934@sbin/slaacd/frontend.c","sbin/slaacd/frontend.c","send_solicitation",918,934
10,2,48,2,12,"log_init@34-46@sbin/slaacd/log.c","sbin/slaacd/log.c","log_init",34,46
5,2,19,1,4,"log_procinit@49-53@sbin/slaacd/log.c","sbin/slaacd/log.c","log_procinit",49,53
4,1,11,1,3,"log_setverbose@56-59@sbin/slaacd/log.c","sbin/slaacd/log.c","log_setverbose",56,59
4,1,11,1,3,"log_getverbose@62-65@sbin/slaacd/log.c","sbin/slaacd/log.c","log_getverbose",62,65
7,1,38,3,7,"logit@68-75@sbin/slaacd/log.c","sbin/slaacd/log.c","logit",68,75
17,3,99,3,19,"vlog@78-97@sbin/slaacd/log.c","sbin/slaacd/log.c","vlog",78,97
21,3,120,2,25,"log_warn@100-125@sbin/slaacd/log.c","sbin/slaacd/log.c","log_warn",100,125
7,1,35,2,7,"log_warnx@128-135@sbin/slaacd/log.c","sbin/slaacd/log.c","log_warnx",128,135
7,1,35,2,7,"log_info@138-145@sbin/slaacd/log.c","sbin/slaacd/log.c","log_info",138,145
9,2,41,2,9,"log_debug@148-157@sbin/slaacd/log.c","sbin/slaacd/log.c","log_debug",148,157
17,3,106,3,17,"vfatalc@160-177@sbin/slaacd/log.c","sbin/slaacd/log.c","vfatalc",160,177
8,1,40,2,8,"fatal@180-188@sbin/slaacd/log.c","sbin/slaacd/log.c","fatal",180,188
8,1,40,2,8,"fatalx@191-199@sbin/slaacd/log.c","sbin/slaacd/log.c","fatalx",191,199
13,4,47,3,17,"main_sig_handler@115-132@sbin/slaacd/slaacd.c","sbin/slaacd/slaacd.c","main_sig_handler",115,132
7,1,25,1,7,"usage@135-142@sbin/slaacd/slaacd.c","sbin/slaacd/slaacd.c","usage",135,142
102,25,716,2,138,"main@145-283@sbin/slaacd/slaacd.c","sbin/slaacd/slaacd.c","main",145,283
25,9,162,1,32,"main_shutdown@286-318@sbin/slaacd/slaacd.c","sbin/slaacd/slaacd.c","main_shutdown",286,318
41,11,220,6,44,"start_child@321-365@sbin/slaacd/slaacd.c","sbin/slaacd/slaacd.c","start_child",321,365
66,18,389,3,75,"main_dispatch_frontend@368-443@sbin/slaacd/slaacd.c","sbin/slaacd/slaacd.c","main_dispatch_frontend",368,443
71,21,458,3,75,"main_dispatch_engine@446-521@sbin/slaacd/slaacd.c","sbin/slaacd/slaacd.c","main_dispatch_engine",446,521
8,2,49,4,7,"main_imsg_compose_frontend@524-531@sbin/slaacd/slaacd.c","sbin/slaacd/slaacd.c","main_imsg_compose_frontend",524,531
8,2,49,4,7,"main_imsg_compose_engine@534-541@sbin/slaacd/slaacd.c","sbin/slaacd/slaacd.c","main_imsg_compose_engine",534,541
9,2,73,1,9,"imsg_event_add@544-553@sbin/slaacd/slaacd.c","sbin/slaacd/slaacd.c","imsg_event_add",544,553
9,2,70,7,10,"imsg_compose_event@556-566@sbin/slaacd/slaacd.c","sbin/slaacd/slaacd.c","imsg_compose_event",556,566
17,4,123,2,18,"main_imsg_send_ipc_sockets@569-587@sbin/slaacd/slaacd.c","sbin/slaacd/slaacd.c","main_imsg_send_ipc_sockets",569,587
71,10,575,1,81,"handle_proposal@593-674@sbin/slaacd/slaacd.c","sbin/slaacd/slaacd.c","handle_proposal",593,674
31,4,229,1,41,"configure_interface@677-718@sbin/slaacd/slaacd.c","sbin/slaacd/slaacd.c","configure_interface",677,718
71,6,643,2,80,"configure_gateway@721-801@sbin/slaacd/slaacd.c","sbin/slaacd/slaacd.c","configure_gateway",721,801
4,1,16,1,3,"add_gateway@804-807@sbin/slaacd/slaacd.c","sbin/slaacd/slaacd.c","add_gateway",804,807
4,1,16,1,3,"delete_gateway@810-813@sbin/slaacd/slaacd.c","sbin/slaacd/slaacd.c","delete_gateway",810,813
12,2,81,1,12,"sin6_to_str@817-829@sbin/slaacd/slaacd.c","sbin/slaacd/slaacd.c","sin6_to_str",817,829
95,32,421,2,124,"main@119-243@sbin/swapctl/swapctl.c","sbin/swapctl/swapctl.c","main",119,243
41,13,194,2,45,"swapon_command@249-294@sbin/swapctl/swapctl.c","sbin/swapctl/swapctl.c","swapon_command",249,294
5,2,28,1,5,"change_priority@300-305@sbin/swapctl/swapctl.c","sbin/swapctl/swapctl.c","change_priority",300,305
6,3,36,1,6,"add_swap@311-317@sbin/swapctl/swapctl.c","sbin/swapctl/swapctl.c","add_swap",311,317
5,2,30,1,5,"del_swap@323-328@sbin/swapctl/swapctl.c","sbin/swapctl/swapctl.c","del_swap",323,328
92,30,564,1,123,"do_fstab@331-454@sbin/swapctl/swapctl.c","sbin/swapctl/swapctl.c","do_fstab",331,454
10,1,56,1,10,"usage@457-467@sbin/swapctl/swapctl.c","sbin/swapctl/swapctl.c","usage",457,467
71,15,531,4,76,"list_swap@48-124@sbin/swapctl/swaplist.c","sbin/swapctl/swaplist.c","list_swap",48,124
36,12,179,2,44,"main@218-262@sbin/sysctl/sysctl.c","sbin/sysctl/sysctl.c","main",218,262
19,6,165,2,19,"listall@268-287@sbin/sysctl/sysctl.c","sbin/sysctl/sysctl.c","listall",268,287
627,238,3901,2,685,"parse@295-980@sbin/sysctl/sysctl.c","sbin/sysctl/sysctl.c","parse",295,980
19,6,146,3,19,"parse_ports@983-1002@sbin/sysctl/sysctl.c","sbin/sysctl/sysctl.c","parse_ports",983,1002
48,15,308,7,48,"parse_baddynamic@1005-1053@sbin/sysctl/sysctl.c","sbin/sysctl/sysctl.c","parse_baddynamic",1005,1053
20,4,144,1,20,"debuginit@1059-1079@sbin/sysctl/sysctl.c","sbin/sysctl/sysctl.c","debuginit",1059,1079
66,12,490,1,72,"vfsinit@1092-1164@sbin/sysctl/sysctl.c","sbin/sysctl/sysctl.c","vfsinit",1092,1164
30,9,206,5,33,"sysctl_vfsgen@1167-1200@sbin/sysctl/sysctl.c","sbin/sysctl/sysctl.c","sysctl_vfsgen",1167,1200
20,5,153,5,21,"sysctl_vfs@1203-1224@sbin/sysctl/sysctl.c","sbin/sysctl/sysctl.c","sysctl_vfs",1203,1224
13,3,101,5,13,"sysctl_fs@1233-1246@sbin/sysctl/sysctl.c","sbin/sysctl/sysctl.c","sysctl_fs",1233,1246
38,8,258,5,41,"sysctl_bios@1256-1297@sbin/sysctl/sysctl.c","sbin/sysctl/sysctl.c","sysctl_bios",1256,1297
13,3,101,5,13,"sysctl_swpenc@1307-1320@sbin/sysctl/sysctl.c","sbin/sysctl/sysctl.c","sysctl_swpenc",1307,1320
66,19,412,5,66,"sysctl_nchstats@1620-1686@sbin/sysctl/sysctl.c","sbin/sysctl/sysctl.c","sysctl_nchstats",1620,1686
18,5,126,5,19,"sysctl_tty@1692-1711@sbin/sysctl/sysctl.c","sbin/sysctl/sysctl.c","sysctl_tty",1692,1711
53,15,337,5,53,"sysctl_forkstat@1717-1770@sbin/sysctl/sysctl.c","sbin/sysctl/sysctl.c","sysctl_forkstat",1717,1770
100,28,808,5,100,"sysctl_malloc@1776-1876@sbin/sysctl/sysctl.c","sbin/sysctl/sysctl.c","sysctl_malloc",1776,1876
50,15,325,5,50,"sysctl_chipset@1886-1936@sbin/sysctl/sysctl.c","sbin/sysctl/sysctl.c","sysctl_chipset",1886,1936
42,11,302,5,43,"sysctl_inet@1942-1985@sbin/sysctl/sysctl.c","sbin/sysctl/sysctl.c","sysctl_inet",1942,1985
42,11,302,5,43,"sysctl_inet6@2078-2121@sbin/sysctl/sysctl.c","sbin/sysctl/sysctl.c","sysctl_inet6",2078,2121
13,3,94,5,13,"sysctl_bpf@2125-2138@sbin/sysctl/sysctl.c","sbin/sysctl/sysctl.c","sysctl_bpf",2125,2138
27,6,196,5,28,"sysctl_mpls@2145-2173@sbin/sysctl/sysctl.c","sbin/sysctl/sysctl.c","sysctl_mpls",2145,2173
27,6,196,5,28,"sysctl_pipex@2177-2205@sbin/sysctl/sysctl.c","sbin/sysctl/sysctl.c","sysctl_pipex",2177,2205
18,3,104,5,18,"sysctl_seminfo@2211-2229@sbin/sysctl/sysctl.c","sbin/sysctl/sysctl.c","sysctl_seminfo",2211,2229
18,3,104,5,18,"sysctl_shminfo@2235-2253@sbin/sysctl/sysctl.c","sbin/sysctl/sysctl.c","sysctl_shminfo",2235,2253
14,3,101,5,14,"sysctl_watchdog@2259-2273@sbin/sysctl/sysctl.c","sbin/sysctl/sysctl.c","sysctl_watchdog",2259,2273
14,3,101,5,14,"sysctl_tc@2279-2293@sbin/sysctl/sysctl.c","sbin/sysctl/sysctl.c","sysctl_tc",2279,2293
78,22,548,5,108,"sysctl_sensors@2299-2407@sbin/sysctl/sysctl.c","sbin/sysctl/sysctl.c","sysctl_sensors",2299,2407
37,10,260,4,46,"print_sensordev@2414-2460@sbin/sysctl/sysctl.c","sbin/sysctl/sysctl.c","print_sensordev",2414,2460
136,41,643,1,140,"print_sensor@2463-2603@sbin/sysctl/sysctl.c","sbin/sysctl/sysctl.c","print_sensor",2463,2603
18,7,142,4,18,"findname@2609-2627@sbin/sysctl/sysctl.c","sbin/sysctl/sysctl.c","findname",2609,2627
8,1,23,1,8,"usage@2630-2638@sbin/sysctl/sysctl.c","sbin/sysctl/sysctl.c","usage",2630,2638
36,12,175,2,41,"main@62-103@sbin/ttyflags/ttyflags.c","sbin/ttyflags/ttyflags.c","main",62,103
10,3,55,1,10,"all@109-119@sbin/ttyflags/ttyflags.c","sbin/ttyflags/ttyflags.c","all",109,119
18,4,86,2,19,"ttys@125-144@sbin/ttyflags/ttyflags.c","sbin/ttyflags/ttyflags.c","ttys",125,144
84,31,595,2,91,"ttyflags@152-243@sbin/ttyflags/ttyflags.c","sbin/ttyflags/ttyflags.c","ttyflags",152,243
5,1,21,1,4,"usage@249-253@sbin/ttyflags/ttyflags.c","sbin/ttyflags/ttyflags.c","usage",249,253
133,31,765,2,162,"main@78-240@sbin/tunefs/tunefs.c","sbin/tunefs/tunefs.c","main",78,240
9,2,66,4,9,"getnum@243-252@sbin/tunefs/tunefs.c","sbin/tunefs/tunefs.c","getnum",243,252
10,1,27,1,11,"usage@255-266@sbin/tunefs/tunefs.c","sbin/tunefs/tunefs.c","usage",255,266
24,10,138,2,26,"getsb@269-295@sbin/tunefs/tunefs.c","sbin/tunefs/tunefs.c","getsb",269,295
6,2,57,4,5,"bwrite@298-303@sbin/tunefs/tunefs.c","sbin/tunefs/tunefs.c","bwrite",298,303
6,2,62,4,5,"bread@306-311@sbin/tunefs/tunefs.c","sbin/tunefs/tunefs.c","bread",306,311
19,5,140,3,19,"openpartition@314-333@sbin/tunefs/tunefs.c","sbin/tunefs/tunefs.c","openpartition",314,333
42,17,215,2,49,"main@69-118@sbin/umount/umount.c","sbin/umount/umount.c","main",69,118
19,6,109,1,21,"umountall@121-142@sbin/umount/umount.c","sbin/umount/umount.c","umountall",121,142
92,22,640,1,110,"umountfs@145-255@sbin/umount/umount.c","sbin/umount/umount.c","umountfs",145,255
27,10,209,3,27,"getmntname@258-285@sbin/umount/umount.c","sbin/umount/umount.c","getmntname",258,285
10,6,73,1,11,"selected@290-301@sbin/umount/umount.c","sbin/umount/umount.c","selected",290,301
22,8,183,1,33,"maketypelist@304-337@sbin/umount/umount.c","sbin/umount/umount.c","maketypelist",304,337
23,10,173,1,25,"namematch@340-365@sbin/umount/umount.c","sbin/umount/umount.c","namematch",340,365
4,1,25,2,3,"xdr_dir@372-375@sbin/umount/umount.c","sbin/umount/umount.c","xdr_dir",372,375
8,1,22,1,7,"usage@379-386@sbin/umount/umount.c","sbin/umount/umount.c","usage",379,386
96,40,632,1,103,"display_get_values@77-180@sbin/wsconsctl/display.c","sbin/wsconsctl/display.c","display_get_values",77,180
77,23,449,1,86,"display_put_values@183-269@sbin/wsconsctl/display.c","sbin/wsconsctl/display.c","display_put_values",183,269
8,2,46,1,9,"display_next_device@272-281@sbin/wsconsctl/display.c","sbin/wsconsctl/display.c","display_next_device",272,281
71,32,618,1,79,"keyboard_get_values@75-154@sbin/wsconsctl/keyboard.c","sbin/wsconsctl/keyboard.c","keyboard_get_values",75,154
82,29,599,1,90,"keyboard_put_values@157-247@sbin/wsconsctl/keyboard.c","sbin/wsconsctl/keyboard.c","keyboard_put_values",157,247
6,1,33,1,6,"keyboard_next_device@250-256@sbin/wsconsctl/keyboard.c","sbin/wsconsctl/keyboard.c","keyboard_next_device",250,256
4,1,42,2,3,"cmp_name@88-91@sbin/wsconsctl/keysym.c","sbin/wsconsctl/keysym.c","cmp_name",88,91
9,2,78,2,9,"cmp_ksym@94-103@sbin/wsconsctl/keysym.c","sbin/wsconsctl/keysym.c","cmp_ksym",94,103
9,2,66,1,11,"sort_ksym_tab@106-117@sbin/wsconsctl/keysym.c","sbin/wsconsctl/keysym.c","sort_ksym_tab",106,117
23,4,132,1,26,"ksym2name@120-146@sbin/wsconsctl/keysym.c","sbin/wsconsctl/keysym.c","ksym2name",120,146
17,4,94,1,19,"name2ksym@149-168@sbin/wsconsctl/keysym.c","sbin/wsconsctl/keysym.c","name2ksym",149,168
24,9,72,1,23,"ksymenc@171-194@sbin/wsconsctl/keysym.c","sbin/wsconsctl/keysym.c","ksymenc",171,194
9,6,59,1,10,"ksym_upcase@197-207@sbin/wsconsctl/keysym.c","sbin/wsconsctl/keysym.c","ksym_upcase",197,207
22,8,136,2,24,"mouse_init@69-93@sbin/wsconsctl/mouse.c","sbin/wsconsctl/mouse.c","mouse_init",69,93
35,14,239,1,38,"mouse_get_values@96-134@sbin/wsconsctl/mouse.c","sbin/wsconsctl/mouse.c","mouse_get_values",96,134
51,15,301,1,53,"mouse_put_values@137-190@sbin/wsconsctl/mouse.c","sbin/wsconsctl/mouse.c","mouse_put_values",137,190
6,1,33,1,6,"mouse_next_device@193-199@sbin/wsconsctl/mouse.c","sbin/wsconsctl/mouse.c","mouse_next_device",193,199
43,11,302,2,59,"mousecfg_init@103-162@sbin/wsconsctl/mousecfg.c","sbin/wsconsctl/mousecfg.c","mousecfg_init",103,162
10,4,97,1,11,"index_of@166-177@sbin/wsconsctl/mousecfg.c","sbin/wsconsctl/mousecfg.c","index_of",166,177
11,3,79,1,11,"mousecfg_get_field@180-191@sbin/wsconsctl/mousecfg.c","sbin/wsconsctl/mousecfg.c","mousecfg_get_field",180,191
18,7,164,2,23,"mousecfg_put_field@194-217@sbin/wsconsctl/mousecfg.c","sbin/wsconsctl/mousecfg.c","mousecfg_put_field",194,217
6,4,64,2,7,"get_value@220-227@sbin/wsconsctl/mousecfg.c","sbin/wsconsctl/mousecfg.c","get_value",220,227
6,4,68,3,7,"set_value@230-237@sbin/wsconsctl/mousecfg.c","sbin/wsconsctl/mousecfg.c","set_value",230,237
31,8,308,2,31,"read_param@245-276@sbin/wsconsctl/mousecfg.c","sbin/wsconsctl/mousecfg.c","read_param",245,276
20,7,143,1,22,"mousecfg_pr_field@279-301@sbin/wsconsctl/mousecfg.c","sbin/wsconsctl/mousecfg.c","mousecfg_pr_field",279,301
33,14,247,2,35,"mousecfg_rd_field@304-339@sbin/wsconsctl/mousecfg.c","sbin/wsconsctl/mousecfg.c","mousecfg_rd_field",304,339
10,4,77,2,12,"field_by_name@189-201@sbin/wsconsctl/util.c","sbin/wsconsctl/util.c","field_by_name",189,201
7,3,43,2,7,"field_by_value@204-211@sbin/wsconsctl/util.c","sbin/wsconsctl/util.c","field_by_value",204,211
13,4,94,4,14,"int2name@214-228@sbin/wsconsctl/util.c","sbin/wsconsctl/util.c","int2name",214,228
8,3,65,3,8,"name2int@231-239@sbin/wsconsctl/util.c","sbin/wsconsctl/util.c","name2int",231,239
78,19,557,3,81,"pr_field@242-323@sbin/wsconsctl/util.c","sbin/wsconsctl/util.c","pr_field",242,323
146,54,1102,3,151,"rd_field@326-477@sbin/wsconsctl/util.c","sbin/wsconsctl/util.c","rd_field",326,477
30,13,263,1,31,"print_kmap@480-511@sbin/wsconsctl/util.c","sbin/wsconsctl/util.c","print_kmap",480,511
17,3,98,1,17,"print_emul@514-531@sbin/wsconsctl/util.c","sbin/wsconsctl/util.c","print_emul",514,531
17,3,98,1,17,"print_screen@534-551@sbin/wsconsctl/util.c","sbin/wsconsctl/util.c","print_screen",534,551
9,1,26,1,8,"usage@70-78@sbin/wsconsctl/wsconsctl.c","sbin/wsconsctl/wsconsctl.c","usage",70,78
192,62,1282,2,208,"main@81-289@sbin/wsconsctl/wsconsctl.c","sbin/wsconsctl/wsconsctl.c","main",81,289
37,11,245,2,42,"tab_by_name@292-334@sbin/wsconsctl/wsconsctl.c","sbin/wsconsctl/wsconsctl.c","tab_by_name",292,334