10,2,53,0,13,"api_up1000_init@82-95@sys/arch/alpha/alpha/api_up1000.c","sys/arch/alpha/alpha/api_up1000.c","api_up1000_init",82,95
38,6,234,0,58,"api_up1000_cons_init@98-156@sys/arch/alpha/alpha/api_up1000.c","sys/arch/alpha/alpha/api_up1000.c","api_up1000_cons_init",98,156
107,35,651,2,138,"api_up1000_device_register@159-297@sys/arch/alpha/alpha/api_up1000.c","sys/arch/alpha/alpha/api_up1000.c","api_up1000_device_register",159,297
7,2,34,1,8,"unmap_startup@71-79@sys/arch/alpha/alpha/autoconf.c","sys/arch/alpha/alpha/autoconf.c","unmap_startup",71,79
12,2,56,0,20,"cpu_configure@86-106@sys/arch/alpha/alpha/autoconf.c","sys/arch/alpha/alpha/autoconf.c","cpu_configure",86,106
12,2,48,1,13,"diskconf@109-122@sys/arch/alpha/alpha/autoconf.c","sys/arch/alpha/alpha/autoconf.c","diskconf",109,122
42,11,314,0,55,"parse_prom_bootdev@125-180@sys/arch/alpha/alpha/autoconf.c","sys/arch/alpha/alpha/autoconf.c","parse_prom_bootdev",125,180
18,6,91,1,22,"atoi@183-205@sys/arch/alpha/alpha/autoconf.c","sys/arch/alpha/alpha/autoconf.c","atoi",183,205
10,3,45,2,13,"device_register@208-221@sys/arch/alpha/alpha/autoconf.c","sys/arch/alpha/alpha/autoconf.c","device_register",208,221
10,2,43,2,14,"clockattach@74-88@sys/arch/alpha/alpha/clock.c","sys/arch/alpha/alpha/clock.c","clockattach",74,88
28,4,180,1,57,"cpu_initclocks@108-165@sys/arch/alpha/alpha/clock.c","sys/arch/alpha/alpha/clock.c","cpu_initclocks",108,165
4,1,9,1,5,"setstatclockrate@173-178@sys/arch/alpha/alpha/clock.c","sys/arch/alpha/alpha/clock.c","setstatclockrate",173,178
55,18,365,1,74,"inittodr@186-260@sys/arch/alpha/alpha/clock.c","sys/arch/alpha/alpha/clock.c","inittodr",186,260
18,3,132,0,24,"resettodr@270-294@sys/arch/alpha/alpha/clock.c","sys/arch/alpha/alpha/clock.c","resettodr",270,294
4,1,14,1,3,"rpcc_get_timecount@297-300@sys/arch/alpha/alpha/clock.c","sys/arch/alpha/alpha/clock.c","rpcc_get_timecount",297,300
5,2,26,1,5,"iskmemdev@225-230@sys/arch/alpha/alpha/conf.c","sys/arch/alpha/alpha/conf.c","iskmemdev",225,230
5,2,26,1,5,"iszerodev@236-241@sys/arch/alpha/alpha/conf.c","sys/arch/alpha/alpha/conf.c","iszerodev",236,241
4,1,13,0,3,"getnulldev@244-247@sys/arch/alpha/alpha/conf.c","sys/arch/alpha/alpha/conf.c","getnulldev",244,247
9,3,64,3,15,"cpumatch@201-216@sys/arch/alpha/alpha/cpu.c","sys/arch/alpha/alpha/cpu.c","cpumatch",201,216
111,34,785,3,168,"cpuattach@219-387@sys/arch/alpha/alpha/cpu.c","sys/arch/alpha/alpha/cpu.c","cpuattach",219,387
20,5,108,1,27,"cpu_announce_extensions@390-417@sys/arch/alpha/alpha/cpu.c","sys/arch/alpha/alpha/cpu.c","cpu_announce_extensions",390,417
21,6,134,1,30,"cpu_boot_secondary_processors@421-451@sys/arch/alpha/alpha/cpu.c","sys/arch/alpha/alpha/cpu.c","cpu_boot_secondary_processors",421,451
41,8,278,1,67,"cpu_boot_secondary@454-521@sys/arch/alpha/alpha/cpu.c","sys/arch/alpha/alpha/cpu.c","cpu_boot_secondary",454,521
9,2,50,2,9,"cpu_pause_resume@524-533@sys/arch/alpha/alpha/cpu.c","sys/arch/alpha/alpha/cpu.c","cpu_pause_resume",524,533
10,2,47,1,10,"cpu_pause_resume_all@536-546@sys/arch/alpha/alpha/cpu.c","sys/arch/alpha/alpha/cpu.c","cpu_pause_resume_all",536,546
12,1,91,1,16,"cpu_halt@549-565@sys/arch/alpha/alpha/cpu.c","sys/arch/alpha/alpha/cpu.c","cpu_halt",549,565
23,2,146,1,43,"cpu_hatch@568-611@sys/arch/alpha/alpha/cpu.c","sys/arch/alpha/alpha/cpu.c","cpu_hatch",568,611
28,7,188,2,38,"cpu_iccb_send@614-652@sys/arch/alpha/alpha/cpu.c","sys/arch/alpha/alpha/cpu.c","cpu_iccb_send",614,652
33,8,181,1,37,"cpu_iccb_receive@655-692@sys/arch/alpha/alpha/cpu.c","sys/arch/alpha/alpha/cpu.c","cpu_iccb_receive",655,692
5,2,26,1,4,"cpu_unidle@695-699@sys/arch/alpha/alpha/cpu.c","sys/arch/alpha/alpha/cpu.c","cpu_unidle",695,699
11,3,57,1,11,"platform_lookup@189-200@sys/arch/alpha/alpha/cpuconf.c","sys/arch/alpha/alpha/cpuconf.c","platform_lookup",189,200
9,1,37,0,9,"platform_not_configured@203-212@sys/arch/alpha/alpha/cpuconf.c","sys/arch/alpha/alpha/cpuconf.c","platform_not_configured",203,212
7,2,40,0,7,"platform_not_supported@215-222@sys/arch/alpha/alpha/cpuconf.c","sys/arch/alpha/alpha/cpuconf.c","platform_not_supported",215,222
12,3,77,1,13,"pal_opname@192-205@sys/arch/alpha/alpha/db_disasm.c","sys/arch/alpha/alpha/db_disasm.c","pal_opname",192,205
12,3,95,1,14,"arit_name@247-261@sys/arch/alpha/alpha/db_disasm.c","sys/arch/alpha/alpha/db_disasm.c","arit_name",247,261
20,8,166,1,23,"logical_name@288-311@sys/arch/alpha/alpha/db_disasm.c","sys/arch/alpha/alpha/db_disasm.c","logical_name",288,311
17,5,151,1,19,"bitop_name@337-356@sys/arch/alpha/alpha/db_disasm.c","sys/arch/alpha/alpha/db_disasm.c","bitop_name",337,356
11,3,75,1,13,"mul_name@367-380@sys/arch/alpha/alpha/db_disasm.c","sys/arch/alpha/alpha/db_disasm.c","mul_name",367,380
19,7,114,1,21,"special_name@393-414@sys/arch/alpha/alpha/db_disasm.c","sys/arch/alpha/alpha/db_disasm.c","special_name",393,414
15,6,91,1,17,"intmisc_name@436-453@sys/arch/alpha/alpha/db_disasm.c","sys/arch/alpha/alpha/db_disasm.c","intmisc_name",436,453
14,3,95,3,15,"float_name@458-473@sys/arch/alpha/alpha/db_disasm.c","sys/arch/alpha/alpha/db_disasm.c","float_name",458,473
11,4,58,1,11,"register_name@808-819@sys/arch/alpha/alpha/db_disasm.c","sys/arch/alpha/alpha/db_disasm.c","register_name",808,819
9,1,46,2,10,"db_disasm@829-839@sys/arch/alpha/alpha/db_disasm.c","sys/arch/alpha/alpha/db_disasm.c","db_disasm",829,839
212,76,1074,3,265,"alpha_print_instruction@842-1107@sys/arch/alpha/alpha/db_disasm.c","sys/arch/alpha/alpha/db_disasm.c","alpha_print_instruction",842,1107
25,5,131,5,47,"ddb_trap@140-187@sys/arch/alpha/alpha/db_interface.c","sys/arch/alpha/alpha/db_interface.c","ddb_trap",140,187
10,2,50,3,10,"db_read_bytes@193-203@sys/arch/alpha/alpha/db_interface.c","sys/arch/alpha/alpha/db_interface.c","db_read_bytes",193,203
11,2,54,3,11,"db_write_bytes@209-220@sys/arch/alpha/alpha/db_interface.c","sys/arch/alpha/alpha/db_interface.c","db_write_bytes",209,220
4,1,11,0,4,"db_enter@223-227@sys/arch/alpha/alpha/db_interface.c","sys/arch/alpha/alpha/db_interface.c","db_enter",223,227
12,4,63,2,14,"db_register_value@271-285@sys/arch/alpha/alpha/db_interface.c","sys/arch/alpha/alpha/db_interface.c","db_register_value",271,285
9,3,53,1,9,"db_inst_call@292-301@sys/arch/alpha/alpha/db_interface.c","sys/arch/alpha/alpha/db_interface.c","db_inst_call",292,301
8,2,41,1,8,"db_inst_return@304-312@sys/arch/alpha/alpha/db_interface.c","sys/arch/alpha/alpha/db_interface.c","db_inst_return",304,312
8,2,41,1,8,"db_inst_trap_return@315-323@sys/arch/alpha/alpha/db_interface.c","sys/arch/alpha/alpha/db_interface.c","db_inst_trap_return",315,323
26,17,86,1,27,"db_inst_branch@326-353@sys/arch/alpha/alpha/db_interface.c","sys/arch/alpha/alpha/db_interface.c","db_inst_branch",326,353
19,7,71,1,21,"db_inst_unconditional_flow_transfer@356-377@sys/arch/alpha/alpha/db_interface.c","sys/arch/alpha/alpha/db_interface.c","db_inst_unconditional_flow_transfer",356,377
8,2,45,2,8,"db_inst_spill@381-389@sys/arch/alpha/alpha/db_interface.c","sys/arch/alpha/alpha/db_interface.c","db_inst_spill",381,389
22,11,153,1,28,"db_inst_load@393-421@sys/arch/alpha/alpha/db_interface.c","sys/arch/alpha/alpha/db_interface.c","db_inst_load",393,421
38,18,154,3,48,"db_branch_taken@424-472@sys/arch/alpha/alpha/db_interface.c","sys/arch/alpha/alpha/db_interface.c","db_branch_taken",424,472
10,3,50,1,10,"db_valid_breakpoint@480-490@sys/arch/alpha/alpha/db_interface.c","sys/arch/alpha/alpha/db_interface.c","db_valid_breakpoint",480,490
8,2,49,2,7,"next_instr_address@493-500@sys/arch/alpha/alpha/db_interface.c","sys/arch/alpha/alpha/db_interface.c","next_instr_address",493,500
36,8,195,4,41,"db_mach_cpu@504-545@sys/arch/alpha/alpha/db_interface.c","sys/arch/alpha/alpha/db_interface.c","db_mach_cpu",504,545
4,1,10,0,3,"db_machine_init@549-552@sys/arch/alpha/alpha/db_interface.c","sys/arch/alpha/alpha/db_interface.c","db_machine_init",549,552
4,2,30,1,3,"sext@120-123@sys/arch/alpha/alpha/db_trace.c","sys/arch/alpha/alpha/db_trace.c","sext",120,123
4,1,19,1,3,"rega@126-129@sys/arch/alpha/alpha/db_trace.c","sys/arch/alpha/alpha/db_trace.c","rega",126,129
4,1,19,1,3,"regb@132-135@sys/arch/alpha/alpha/db_trace.c","sys/arch/alpha/alpha/db_trace.c","regb",132,135
4,1,14,1,3,"regc@138-141@sys/arch/alpha/alpha/db_trace.c","sys/arch/alpha/alpha/db_trace.c","regc",138,141
4,1,17,1,3,"disp@144-147@sys/arch/alpha/alpha/db_trace.c","sys/arch/alpha/alpha/db_trace.c","disp",144,147
86,27,694,5,143,"db_stack_trace_print@168-311@sys/arch/alpha/alpha/db_trace.c","sys/arch/alpha/alpha/db_trace.c","db_stack_trace_print",168,311
23,6,119,0,25,"_dec_1000a_init@117-142@sys/arch/alpha/alpha/dec_1000a.c","sys/arch/alpha/alpha/dec_1000a.c","_dec_1000a_init",117,142
56,7,313,0,82,"dec_1000a_cons_init@145-227@sys/arch/alpha/alpha/dec_1000a.c","sys/arch/alpha/alpha/dec_1000a.c","dec_1000a_cons_init",145,227
69,22,414,2,92,"dec_1000a_device_register@230-322@sys/arch/alpha/alpha/dec_1000a.c","sys/arch/alpha/alpha/dec_1000a.c","dec_1000a_device_register",230,322
18,4,99,0,23,"dec_2100_a50_init@92-115@sys/arch/alpha/alpha/dec_2100_a50.c","sys/arch/alpha/alpha/dec_2100_a50.c","dec_2100_a50_init",92,115
38,6,234,0,58,"dec_2100_a50_cons_init@118-176@sys/arch/alpha/alpha/dec_2100_a50.c","sys/arch/alpha/alpha/dec_2100_a50.c","dec_2100_a50_cons_init",118,176
69,22,414,2,92,"dec_2100_a50_device_register@179-271@sys/arch/alpha/alpha/dec_2100_a50.c","sys/arch/alpha/alpha/dec_2100_a50.c","dec_2100_a50_device_register",179,271
247,41,1824,4,291,"dec_2100_a50_mcheck@275-566@sys/arch/alpha/alpha/dec_2100_a50.c","sys/arch/alpha/alpha/dec_2100_a50.c","dec_2100_a50_mcheck",275,566
17,3,76,4,16,"dec_2100_a50_mcheck_handler@569-585@sys/arch/alpha/alpha/dec_2100_a50.c","sys/arch/alpha/alpha/dec_2100_a50.c","dec_2100_a50_mcheck_handler",569,585
14,3,81,0,16,"dec_3000_300_init@74-90@sys/arch/alpha/alpha/dec_3000_300.c","sys/arch/alpha/alpha/dec_3000_300.c","dec_3000_300_init",74,90
30,7,157,0,55,"dec_3000_300_cons_init@93-148@sys/arch/alpha/alpha/dec_3000_300.c","sys/arch/alpha/alpha/dec_3000_300.c","dec_3000_300_cons_init",93,148
74,33,470,2,115,"dec_3000_300_device_register@151-266@sys/arch/alpha/alpha/dec_3000_300.c","sys/arch/alpha/alpha/dec_3000_300.c","dec_3000_300_device_register",151,266
24,6,125,0,30,"dec_3000_500_init@79-109@sys/arch/alpha/alpha/dec_3000_500.c","sys/arch/alpha/alpha/dec_3000_500.c","dec_3000_500_init",79,109
30,7,157,0,54,"dec_3000_500_cons_init@112-166@sys/arch/alpha/alpha/dec_3000_500.c","sys/arch/alpha/alpha/dec_3000_500.c","dec_3000_500_cons_init",112,166
74,33,470,2,115,"dec_3000_500_device_register@169-284@sys/arch/alpha/alpha/dec_3000_500.c","sys/arch/alpha/alpha/dec_3000_500.c","dec_3000_500_device_register",169,284
11,2,59,0,14,"dec_550_init@82-96@sys/arch/alpha/alpha/dec_550.c","sys/arch/alpha/alpha/dec_550.c","dec_550_init",82,96
38,6,234,0,58,"dec_550_cons_init@99-157@sys/arch/alpha/alpha/dec_550.c","sys/arch/alpha/alpha/dec_550.c","dec_550_cons_init",99,157
90,23,570,2,111,"dec_550_device_register@160-271@sys/arch/alpha/alpha/dec_550.c","sys/arch/alpha/alpha/dec_550.c","dec_550_device_register",160,271
5,1,16,0,5,"dec_550_powerdown@274-279@sys/arch/alpha/alpha/dec_550.c","sys/arch/alpha/alpha/dec_550.c","dec_550_powerdown",274,279
13,2,73,0,16,"dec_6600_init@99-115@sys/arch/alpha/alpha/dec_6600.c","sys/arch/alpha/alpha/dec_6600.c","dec_6600_init",99,115
43,6,254,0,66,"dec_6600_cons_init@118-184@sys/arch/alpha/alpha/dec_6600.c","sys/arch/alpha/alpha/dec_6600.c","dec_6600_cons_init",118,184
110,29,661,2,137,"dec_6600_device_register@187-324@sys/arch/alpha/alpha/dec_6600.c","sys/arch/alpha/alpha/dec_6600.c","dec_6600_device_register",187,324
52,12,386,4,84,"dec_6600_environmental_mcheck@328-412@sys/arch/alpha/alpha/dec_6600.c","sys/arch/alpha/alpha/dec_6600.c","dec_6600_environmental_mcheck",328,412
15,5,93,2,16,"dec_6600_print_syndrome@430-446@sys/arch/alpha/alpha/dec_6600.c","sys/arch/alpha/alpha/dec_6600.c","dec_6600_print_syndrome",430,446
85,22,436,4,100,"dec_6600_mcheck@449-549@sys/arch/alpha/alpha/dec_6600.c","sys/arch/alpha/alpha/dec_6600.c","dec_6600_mcheck",449,549
19,6,96,4,27,"dec_6600_mcheck_handler@553-580@sys/arch/alpha/alpha/dec_6600.c","sys/arch/alpha/alpha/dec_6600.c","dec_6600_mcheck_handler",553,580
14,3,82,1,16,"dec_alphabook1_init@77-93@sys/arch/alpha/alpha/dec_alphabook1.c","sys/arch/alpha/alpha/dec_alphabook1.c","dec_alphabook1_init",77,93
38,6,236,1,58,"dec_alphabook1_cons_init@96-154@sys/arch/alpha/alpha/dec_alphabook1.c","sys/arch/alpha/alpha/dec_alphabook1.c","dec_alphabook1_cons_init",96,154
67,22,414,2,90,"dec_alphabook1_device_register@157-247@sys/arch/alpha/alpha/dec_alphabook1.c","sys/arch/alpha/alpha/dec_alphabook1.c","dec_alphabook1_device_register",157,247
6,1,22,0,6,"lca_preinit@80-86@sys/arch/alpha/alpha/dec_axppci_33.c","sys/arch/alpha/alpha/dec_axppci_33.c","lca_preinit",80,86
31,4,202,0,41,"dec_axppci_33_init@99-140@sys/arch/alpha/alpha/dec_axppci_33.c","sys/arch/alpha/alpha/dec_axppci_33.c","dec_axppci_33_init",99,140
36,6,223,0,56,"dec_axppci_33_cons_init@143-199@sys/arch/alpha/alpha/dec_axppci_33.c","sys/arch/alpha/alpha/dec_axppci_33.c","dec_axppci_33_cons_init",143,199
69,22,414,2,92,"dec_axppci_33_device_register@202-294@sys/arch/alpha/alpha/dec_axppci_33.c","sys/arch/alpha/alpha/dec_axppci_33.c","dec_axppci_33_device_register",202,294
10,2,53,0,13,"dec_eb164_init@77-90@sys/arch/alpha/alpha/dec_eb164.c","sys/arch/alpha/alpha/dec_eb164.c","dec_eb164_init",77,90
40,8,254,0,66,"dec_eb164_cons_init@93-159@sys/arch/alpha/alpha/dec_eb164.c","sys/arch/alpha/alpha/dec_eb164.c","dec_eb164_cons_init",93,159
97,26,612,2,128,"dec_eb164_device_register@162-290@sys/arch/alpha/alpha/dec_eb164.c","sys/arch/alpha/alpha/dec_eb164.c","dec_eb164_device_register",162,290
14,3,81,0,16,"dec_eb64plus_init@79-95@sys/arch/alpha/alpha/dec_eb64plus.c","sys/arch/alpha/alpha/dec_eb64plus.c","dec_eb64plus_init",79,95
38,6,234,0,58,"dec_eb64plus_cons_init@98-156@sys/arch/alpha/alpha/dec_eb64plus.c","sys/arch/alpha/alpha/dec_eb64plus.c","dec_eb64plus_cons_init",98,156
69,22,414,2,92,"dec_eb64plus_device_register@159-251@sys/arch/alpha/alpha/dec_eb64plus.c","sys/arch/alpha/alpha/dec_eb64plus.c","dec_eb64plus_device_register",159,251
33,8,167,0,47,"dec_kn300_init@91-138@sys/arch/alpha/alpha/dec_kn300.c","sys/arch/alpha/alpha/dec_kn300.c","dec_kn300_init",91,138
36,6,228,0,55,"dec_kn300_cons_init@141-196@sys/arch/alpha/alpha/dec_kn300.c","sys/arch/alpha/alpha/dec_kn300.c","dec_kn300_cons_init",141,196
91,22,566,2,111,"dec_kn300_device_register@199-310@sys/arch/alpha/alpha/dec_kn300.c","sys/arch/alpha/alpha/dec_kn300.c","dec_kn300_device_register",199,310
14,3,81,0,16,"dec_kn20aa_init@79-95@sys/arch/alpha/alpha/dec_kn20aa.c","sys/arch/alpha/alpha/dec_kn20aa.c","dec_kn20aa_init",79,95
38,6,234,0,58,"dec_kn20aa_cons_init@98-156@sys/arch/alpha/alpha/dec_kn20aa.c","sys/arch/alpha/alpha/dec_kn20aa.c","dec_kn20aa_cons_init",98,156
69,22,414,2,92,"dec_kn20aa_device_register@159-251@sys/arch/alpha/alpha/dec_kn20aa.c","sys/arch/alpha/alpha/dec_kn20aa.c","dec_kn20aa_device_register",159,251
36,11,220,4,48,"readdisklabel@50-98@sys/arch/alpha/alpha/disksubr.c","sys/arch/alpha/alpha/disksubr.c","readdisklabel",50,98
28,4,212,3,36,"writedisklabel@104-140@sys/arch/alpha/alpha/disksubr.c","sys/arch/alpha/alpha/disksubr.c","writedisklabel",104,140
20,5,117,2,20,"this_cannot_happen@143-163@sys/arch/alpha/alpha/fp_complete.c","sys/arch/alpha/alpha/fp_complete.c","this_cannot_happen",143,163
5,1,31,3,4,"sts@166-170@sys/arch/alpha/alpha/fp_complete.c","sys/arch/alpha/alpha/fp_complete.c","sts",166,170
5,1,31,3,4,"stt@173-177@sys/arch/alpha/alpha/fp_complete.c","sys/arch/alpha/alpha/fp_complete.c","stt",173,177
5,1,31,3,4,"lds@180-184@sys/arch/alpha/alpha/fp_complete.c","sys/arch/alpha/alpha/fp_complete.c","lds",180,184
5,1,31,3,4,"ldt@187-191@sys/arch/alpha/alpha/fp_complete.c","sys/arch/alpha/alpha/fp_complete.c","ldt",187,191
4,1,21,2,3,"compare_lt@194-197@sys/arch/alpha/alpha/fp_complete.c","sys/arch/alpha/alpha/fp_complete.c","compare_lt",194,197
4,1,21,2,3,"compare_le@200-203@sys/arch/alpha/alpha/fp_complete.c","sys/arch/alpha/alpha/fp_complete.c","compare_le",200,203
9,3,52,2,8,"compare_un@206-214@sys/arch/alpha/alpha/fp_complete.c","sys/arch/alpha/alpha/fp_complete.c","compare_un",206,214
4,1,21,2,3,"compare_eq@217-220@sys/arch/alpha/alpha/fp_complete.c","sys/arch/alpha/alpha/fp_complete.c","compare_eq",217,220
25,4,174,2,35,"cvt_qs_ts_st_gf_qf@233-268@sys/arch/alpha/alpha/fp_complete.c","sys/arch/alpha/alpha/fp_complete.c","cvt_qs_ts_st_gf_qf",233,268
11,1,91,2,11,"cvt_gd@271-282@sys/arch/alpha/alpha/fp_complete.c","sys/arch/alpha/alpha/fp_complete.c","cvt_gd",271,282
22,5,121,2,25,"cvt_qt_dg_qg@285-310@sys/arch/alpha/alpha/fp_complete.c","sys/arch/alpha/alpha/fp_complete.c","cvt_qt_dg_qg",285,310
9,1,63,2,9,"cvt_tq_gq@322-331@sys/arch/alpha/alpha/fp_complete.c","sys/arch/alpha/alpha/fp_complete.c","cvt_tq_gq",322,331
16,4,132,2,51,"fp_c_to_fpcr_1@334-385@sys/arch/alpha/alpha/fp_complete.c","sys/arch/alpha/alpha/fp_complete.c","fp_c_to_fpcr_1",334,385
4,1,25,1,3,"fp_c_to_fpcr@388-391@sys/arch/alpha/alpha/fp_complete.c","sys/arch/alpha/alpha/fp_complete.c","fp_c_to_fpcr",388,391
13,2,75,2,13,"alpha_write_fp_c@394-407@sys/arch/alpha/alpha/fp_complete.c","sys/arch/alpha/alpha/fp_complete.c","alpha_write_fp_c",394,407
4,1,18,1,9,"alpha_read_fp_c@410-419@sys/arch/alpha/alpha/fp_complete.c","sys/arch/alpha/alpha/fp_complete.c","alpha_read_fp_c",410,419
4,1,13,2,3,"float64_unk@422-425@sys/arch/alpha/alpha/fp_complete.c","sys/arch/alpha/alpha/fp_complete.c","float64_unk",422,425
64,16,437,2,65,"alpha_fp_interpret@500-565@sys/arch/alpha/alpha/fp_complete.c","sys/arch/alpha/alpha/fp_complete.c","alpha_fp_interpret",500,565
33,5,238,3,42,"alpha_fp_complete_at@568-610@sys/arch/alpha/alpha/fp_complete.c","sys/arch/alpha/alpha/fp_complete.c","alpha_fp_complete_at",568,610
69,19,429,4,83,"alpha_fp_complete@613-696@sys/arch/alpha/alpha/fp_complete.c","sys/arch/alpha/alpha/fp_complete.c","alpha_fp_complete",613,696
67,17,517,2,78,"in_cksumdata@86-164@sys/arch/alpha/alpha/in_cksum.c","sys/arch/alpha/alpha/in_cksum.c","in_cksumdata",86,164
25,6,140,2,26,"in_cksum@167-193@sys/arch/alpha/alpha/in_cksum.c","sys/arch/alpha/alpha/in_cksum.c","in_cksum",167,193
44,13,306,4,54,"in4_cksum@196-250@sys/arch/alpha/alpha/in_cksum.c","sys/arch/alpha/alpha/in_cksum.c","in4_cksum",196,250
8,2,42,1,8,"scb_init@104-112@sys/arch/alpha/alpha/interrupt.c","sys/arch/alpha/alpha/interrupt.c","scb_init",104,112
4,1,18,2,4,"scb_stray@115-119@sys/arch/alpha/alpha/interrupt.c","sys/arch/alpha/alpha/interrupt.c","scb_stray",115,119
15,5,114,3,20,"scb_set@122-142@sys/arch/alpha/alpha/interrupt.c","sys/arch/alpha/alpha/interrupt.c","scb_set",122,142
18,3,112,2,26,"scb_alloc@146-172@sys/arch/alpha/alpha/interrupt.c","sys/arch/alpha/alpha/interrupt.c","scb_alloc",146,172
15,5,102,1,20,"scb_free@176-196@sys/arch/alpha/alpha/interrupt.c","sys/arch/alpha/alpha/interrupt.c","scb_free",176,196
63,19,366,4,98,"interrupt@199-297@sys/arch/alpha/alpha/interrupt.c","sys/arch/alpha/alpha/interrupt.c","interrupt",199,297
41,7,239,4,54,"machine_check@300-354@sys/arch/alpha/alpha/interrupt.c","sys/arch/alpha/alpha/interrupt.c","machine_check",300,354
4,1,23,2,3,"badaddr@359-362@sys/arch/alpha/alpha/interrupt.c","sys/arch/alpha/alpha/interrupt.c","badaddr",359,362
49,11,263,3,71,"badaddr_read@365-436@sys/arch/alpha/alpha/interrupt.c","sys/arch/alpha/alpha/interrupt.c","badaddr_read",365,436
11,2,60,0,11,"softintr_init@448-459@sys/arch/alpha/alpha/interrupt.c","sys/arch/alpha/alpha/interrupt.c","softintr_init",448,459
28,8,181,0,40,"softintr_dispatch@467-507@sys/arch/alpha/alpha/interrupt.c","sys/arch/alpha/alpha/interrupt.c","softintr_dispatch",467,507
22,6,67,1,22,"ipl2si@510-532@sys/arch/alpha/alpha/interrupt.c","sys/arch/alpha/alpha/interrupt.c","ipl2si",510,532
16,2,104,3,17,"softintr_establish@540-557@sys/arch/alpha/alpha/interrupt.c","sys/arch/alpha/alpha/interrupt.c","softintr_establish",540,557
12,2,77,1,13,"softintr_disestablish@565-578@sys/arch/alpha/alpha/interrupt.c","sys/arch/alpha/alpha/interrupt.c","softintr_disestablish",565,578
12,2,75,1,12,"softintr_schedule@584-596@sys/arch/alpha/alpha/interrupt.c","sys/arch/alpha/alpha/interrupt.c","softintr_schedule",584,596
4,1,13,1,3,"intr_barrier@599-602@sys/arch/alpha/alpha/interrupt.c","sys/arch/alpha/alpha/interrupt.c","intr_barrier",599,602
5,2,30,1,4,"splraise@605-609@sys/arch/alpha/alpha/interrupt.c","sys/arch/alpha/alpha/interrupt.c","splraise",605,609
10,3,55,2,19,"splassert_check@613-632@sys/arch/alpha/alpha/interrupt.c","sys/arch/alpha/alpha/interrupt.c","splassert_check",613,632
11,4,80,2,11,"alpha_ipi_process@79-90@sys/arch/alpha/alpha/ipifuncs.c","sys/arch/alpha/alpha/ipifuncs.c","alpha_ipi_process",79,90
10,5,70,2,13,"alpha_send_ipi@96-109@sys/arch/alpha/alpha/ipifuncs.c","sys/arch/alpha/alpha/ipifuncs.c","alpha_send_ipi",96,109
15,3,80,1,16,"alpha_broadcast_ipi@115-131@sys/arch/alpha/alpha/ipifuncs.c","sys/arch/alpha/alpha/ipifuncs.c","alpha_broadcast_ipi",115,131
15,3,82,2,16,"alpha_multicast_ipi@137-153@sys/arch/alpha/alpha/ipifuncs.c","sys/arch/alpha/alpha/ipifuncs.c","alpha_multicast_ipi",137,153
7,1,36,2,8,"alpha_ipi_halt@156-164@sys/arch/alpha/alpha/ipifuncs.c","sys/arch/alpha/alpha/ipifuncs.c","alpha_ipi_halt",156,164
4,1,18,2,3,"alpha_ipi_imb@167-170@sys/arch/alpha/alpha/ipifuncs.c","sys/arch/alpha/alpha/ipifuncs.c","alpha_ipi_imb",167,170
4,2,19,2,5,"alpha_ipi_ast@173-178@sys/arch/alpha/alpha/ipifuncs.c","sys/arch/alpha/alpha/ipifuncs.c","alpha_ipi_ast",173,178
6,2,31,2,5,"alpha_ipi_synch_fpu@181-186@sys/arch/alpha/alpha/ipifuncs.c","sys/arch/alpha/alpha/ipifuncs.c","alpha_ipi_synch_fpu",181,186
6,2,31,2,5,"alpha_ipi_discard_fpu@189-194@sys/arch/alpha/alpha/ipifuncs.c","sys/arch/alpha/alpha/ipifuncs.c","alpha_ipi_discard_fpu",189,194
15,2,90,2,25,"alpha_ipi_pause@197-222@sys/arch/alpha/alpha/ipifuncs.c","sys/arch/alpha/alpha/ipifuncs.c","alpha_ipi_pause",197,222
19,1,73,3,20,"__cpu_cas@37-57@sys/arch/alpha/alpha/lock_machdep.c","sys/arch/alpha/alpha/lock_machdep.c","__cpu_cas",37,57
5,1,21,1,4,"__mp_lock_init@60-64@sys/arch/alpha/alpha/lock_machdep.c","sys/arch/alpha/alpha/lock_machdep.c","__mp_lock_init",60,64
14,6,76,1,18,"__mp_lock_spin@67-85@sys/arch/alpha/alpha/lock_machdep.c","sys/arch/alpha/alpha/lock_machdep.c","__mp_lock_spin",67,85
19,4,93,1,32,"__mp_lock@88-120@sys/arch/alpha/alpha/lock_machdep.c","sys/arch/alpha/alpha/lock_machdep.c","__mp_lock",88,120
15,4,73,1,18,"__mp_unlock@123-141@sys/arch/alpha/alpha/lock_machdep.c","sys/arch/alpha/alpha/lock_machdep.c","__mp_unlock",123,141
15,3,76,1,19,"__mp_release_all@144-163@sys/arch/alpha/alpha/lock_machdep.c","sys/arch/alpha/alpha/lock_machdep.c","__mp_release_all",144,163
10,3,52,1,13,"__mp_release_all_but_one@166-179@sys/arch/alpha/alpha/lock_machdep.c","sys/arch/alpha/alpha/lock_machdep.c","__mp_release_all_but_one",166,179
5,2,22,2,4,"__mp_acquire_count@182-186@sys/arch/alpha/alpha/lock_machdep.c","sys/arch/alpha/alpha/lock_machdep.c","__mp_acquire_count",182,186
4,1,23,2,3,"__mp_lock_held@189-192@sys/arch/alpha/alpha/lock_machdep.c","sys/arch/alpha/alpha/lock_machdep.c","__mp_lock_held",189,192
315,79,1980,5,569,"alpha_init@206-775@sys/arch/alpha/alpha/machdep.c","sys/arch/alpha/alpha/machdep.c","alpha_init",206,775
5,3,18,0,11,"consinit@778-789@sys/arch/alpha/alpha/machdep.c","sys/arch/alpha/alpha/machdep.c","consinit",778,789
41,8,268,0,78,"cpu_startup@792-870@sys/arch/alpha/alpha/machdep.c","sys/arch/alpha/alpha/machdep.c","cpu_startup",792,870
11,2,78,0,15,"alpha_dsr_sysname@876-891@sys/arch/alpha/alpha/machdep.c","sys/arch/alpha/alpha/machdep.c","alpha_dsr_sysname",876,891
10,3,64,2,10,"alpha_variation_name@898-908@sys/arch/alpha/alpha/machdep.c","sys/arch/alpha/alpha/machdep.c","alpha_variation_name",898,908
7,1,46,0,7,"alpha_unknown_sysname@914-921@sys/arch/alpha/alpha/machdep.c","sys/arch/alpha/alpha/machdep.c","alpha_unknown_sysname",914,921
23,7,159,0,31,"identifycpu@924-955@sys/arch/alpha/alpha/machdep.c","sys/arch/alpha/alpha/machdep.c","identifycpu",924,955
59,19,311,1,82,"boot@961-1043@sys/arch/alpha/alpha/machdep.c","sys/arch/alpha/alpha/machdep.c","boot",961,1043
9,2,62,0,10,"cpu_dumpsize@1056-1066@sys/arch/alpha/alpha/machdep.c","sys/arch/alpha/alpha/machdep.c","cpu_dumpsize",1056,1066
8,2,44,0,8,"cpu_dump_mempagecnt@1072-1080@sys/arch/alpha/alpha/machdep.c","sys/arch/alpha/alpha/machdep.c","cpu_dump_mempagecnt",1072,1080
25,2,238,0,39,"cpu_dump@1086-1125@sys/arch/alpha/alpha/machdep.c","sys/arch/alpha/alpha/machdep.c","cpu_dump",1086,1125
17,6,101,1,24,"dumpconf@1135-1159@sys/arch/alpha/alpha/machdep.c","sys/arch/alpha/alpha/machdep.c","dumpconf",1135,1159
78,18,431,0,107,"dumpsys@1167-1274@sys/arch/alpha/alpha/machdep.c","sys/arch/alpha/alpha/machdep.c","dumpsys",1167,1274
36,1,447,2,37,"frametoreg@1277-1314@sys/arch/alpha/alpha/machdep.c","sys/arch/alpha/alpha/machdep.c","frametoreg",1277,1314
35,1,438,2,37,"regtoframe@1317-1354@sys/arch/alpha/alpha/machdep.c","sys/arch/alpha/alpha/machdep.c","regtoframe",1317,1354
8,3,49,1,8,"printregs@1357-1365@sys/arch/alpha/alpha/machdep.c","sys/arch/alpha/alpha/machdep.c","printregs",1357,1365
9,1,45,1,10,"regdump@1368-1378@sys/arch/alpha/alpha/machdep.c","sys/arch/alpha/alpha/machdep.c","regdump",1368,1378
60,9,558,6,86,"sendsig@1391-1477@sys/arch/alpha/alpha/machdep.c","sys/arch/alpha/alpha/machdep.c","sendsig",1391,1477
34,5,324,3,49,"sys_sigreturn@1491-1540@sys/arch/alpha/alpha/machdep.c","sys/arch/alpha/alpha/machdep.c","sys_sigreturn",1491,1540
51,18,328,7,70,"cpu_sysctl@1546-1616@sys/arch/alpha/alpha/machdep.c","sys/arch/alpha/alpha/machdep.c","cpu_sysctl",1546,1616
29,8,250,4,46,"setregs@1622-1668@sys/arch/alpha/alpha/machdep.c","sys/arch/alpha/alpha/machdep.c","setregs",1622,1668
22,6,123,2,35,"fpusave_cpu@1674-1709@sys/arch/alpha/alpha/machdep.c","sys/arch/alpha/alpha/machdep.c","fpusave_cpu",1674,1709
33,11,181,2,54,"fpusave_proc@1715-1769@sys/arch/alpha/alpha/machdep.c","sys/arch/alpha/alpha/machdep.c","fpusave_proc",1715,1769
8,2,31,0,9,"spl0@1772-1781@sys/arch/alpha/alpha/machdep.c","sys/arch/alpha/alpha/machdep.c","spl0",1772,1781
23,5,108,1,36,"delay@1787-1823@sys/arch/alpha/alpha/machdep.c","sys/arch/alpha/alpha/machdep.c","delay",1787,1823
17,5,97,1,22,"alpha_pa_access@1826-1848@sys/arch/alpha/alpha/machdep.c","sys/arch/alpha/alpha/machdep.c","alpha_pa_access",1826,1848
5,1,19,1,5,"alpha_XXX_dmamap@1854-1859@sys/arch/alpha/alpha/machdep.c","sys/arch/alpha/alpha/machdep.c","alpha_XXX_dmamap",1854,1859
9,2,37,3,10,"mbmatch@58-68@sys/arch/alpha/alpha/mainbus.c","sys/arch/alpha/alpha/mainbus.c","mbmatch",58,68
24,4,141,3,31,"mbattach@71-102@sys/arch/alpha/alpha/mainbus.c","sys/arch/alpha/alpha/mainbus.c","mbattach",71,102
9,2,44,2,10,"mbprint@105-115@sys/arch/alpha/alpha/mainbus.c","sys/arch/alpha/alpha/mainbus.c","mbprint",105,115
9,1,52,2,13,"mcclock_attach@58-71@sys/arch/alpha/alpha/mcclock.c","sys/arch/alpha/alpha/mcclock.c","mcclock_attach",58,71
8,1,49,1,8,"mcclock_init@74-82@sys/arch/alpha/alpha/mcclock.c","sys/arch/alpha/alpha/mcclock.c","mcclock_init",74,82
19,1,122,3,20,"mcclock_get@88-108@sys/arch/alpha/alpha/mcclock.c","sys/arch/alpha/alpha/mcclock.c","mcclock_get",88,108
21,1,137,2,23,"mcclock_set@114-137@sys/arch/alpha/alpha/mcclock.c","sys/arch/alpha/alpha/mcclock.c","mcclock_set",114,137
24,13,114,4,29,"mmopen@71-100@sys/arch/alpha/alpha/mem.c","sys/arch/alpha/alpha/mem.c","mmopen",71,100
6,3,36,4,8,"mmclose@103-111@sys/arch/alpha/alpha/mem.c","sys/arch/alpha/alpha/mem.c","mmclose",103,111
70,20,408,3,88,"mmrw@114-202@sys/arch/alpha/alpha/mem.c","sys/arch/alpha/alpha/mem.c","mmrw",114,202
20,7,99,3,35,"mmmmap@205-240@sys/arch/alpha/alpha/mem.c","sys/arch/alpha/alpha/mem.c","mmmmap",205,240
4,1,26,5,3,"mmioctl@243-246@sys/arch/alpha/alpha/mem.c","sys/arch/alpha/alpha/mem.c","mmioctl",243,246
6,1,30,2,5,"__mtx_init@39-44@sys/arch/alpha/alpha/mutex.c","sys/arch/alpha/alpha/mutex.c","__mtx_init",39,44
12,5,55,1,17,"__mtx_enter@57-74@sys/arch/alpha/alpha/mutex.c","sys/arch/alpha/alpha/mutex.c","__mtx_enter",57,74
20,8,125,1,27,"__mtx_enter_try@77-104@sys/arch/alpha/alpha/mutex.c","sys/arch/alpha/alpha/mutex.c","__mtx_enter_try",77,104
10,5,66,1,17,"__mtx_enter@107-124@sys/arch/alpha/alpha/mutex.c","sys/arch/alpha/alpha/mutex.c","__mtx_enter",107,124
5,1,19,1,4,"__mtx_enter_try@127-131@sys/arch/alpha/alpha/mutex.c","sys/arch/alpha/alpha/mutex.c","__mtx_enter_try",127,131
11,4,53,1,17,"__mtx_leave@135-152@sys/arch/alpha/alpha/mutex.c","sys/arch/alpha/alpha/mutex.c","__mtx_leave",135,152
92,15,814,3,203,"pmap_bootstrap@706-909@sys/arch/alpha/alpha/pmap.c","sys/arch/alpha/alpha/pmap.c","pmap_bootstrap",706,909
7,4,28,1,10,"pmap_uses_prom_console@913-923@sys/arch/alpha/alpha/pmap.c","sys/arch/alpha/alpha/pmap.c","pmap_uses_prom_console",913,923
44,14,321,3,77,"pmap_steal_memory@947-1024@sys/arch/alpha/alpha/pmap.c","sys/arch/alpha/alpha/pmap.c","pmap_steal_memory",947,1024
17,5,115,1,34,"pmap_init@1035-1069@sys/arch/alpha/alpha/pmap.c","sys/arch/alpha/alpha/pmap.c","pmap_init",1035,1069
26,6,167,1,34,"pmap_create@1077-1111@sys/arch/alpha/alpha/pmap.c","sys/arch/alpha/alpha/pmap.c","pmap_create",1077,1111
16,4,88,1,25,"pmap_destroy@1120-1145@sys/arch/alpha/alpha/pmap.c","sys/arch/alpha/alpha/pmap.c","pmap_destroy",1120,1145
6,3,28,1,9,"pmap_reference@1153-1162@sys/arch/alpha/alpha/pmap.c","sys/arch/alpha/alpha/pmap.c","pmap_reference",1153,1162
6,3,47,3,9,"pmap_remove@1173-1182@sys/arch/alpha/alpha/pmap.c","sys/arch/alpha/alpha/pmap.c","pmap_remove",1173,1182
76,25,447,4,145,"pmap_do_remove@1193-1338@sys/arch/alpha/alpha/pmap.c","sys/arch/alpha/alpha/pmap.c","pmap_do_remove",1193,1338
67,20,461,2,90,"pmap_page_protect@1347-1437@sys/arch/alpha/alpha/pmap.c","sys/arch/alpha/alpha/pmap.c","pmap_page_protect",1347,1437
49,15,326,4,61,"pmap_protect@1446-1507@sys/arch/alpha/alpha/pmap.c","sys/arch/alpha/alpha/pmap.c","pmap_protect",1446,1507
150,50,897,5,286,"pmap_enter@1524-1810@sys/arch/alpha/alpha/pmap.c","sys/arch/alpha/alpha/pmap.c","pmap_enter",1524,1810
29,11,211,3,56,"pmap_kenter_pa@1821-1877@sys/arch/alpha/alpha/pmap.c","sys/arch/alpha/alpha/pmap.c","pmap_kenter_pa",1821,1877
32,12,190,2,48,"pmap_kremove@1886-1934@sys/arch/alpha/alpha/pmap.c","sys/arch/alpha/alpha/pmap.c","pmap_kremove",1886,1934
19,8,110,2,34,"pmap_unwire@1944-1978@sys/arch/alpha/alpha/pmap.c","sys/arch/alpha/alpha/pmap.c","pmap_unwire",1944,1978
47,13,267,3,58,"pmap_extract@1987-2045@sys/arch/alpha/alpha/pmap.c","sys/arch/alpha/alpha/pmap.c","pmap_extract",1987,2045
8,4,41,1,23,"pmap_collect@2069-2092@sys/arch/alpha/alpha/pmap.c","sys/arch/alpha/alpha/pmap.c","pmap_collect",2069,2092
10,3,73,1,17,"pmap_activate@2105-2122@sys/arch/alpha/alpha/pmap.c","sys/arch/alpha/alpha/pmap.c","pmap_activate",2105,2122
7,3,52,1,13,"pmap_deactivate@2135-2148@sys/arch/alpha/alpha/pmap.c","sys/arch/alpha/alpha/pmap.c","pmap_deactivate",2135,2148
37,4,128,1,45,"pmap_zero_page@2160-2205@sys/arch/alpha/alpha/pmap.c","sys/arch/alpha/alpha/pmap.c","pmap_zero_page",2160,2205
11,3,79,2,13,"pmap_copy_page@2217-2230@sys/arch/alpha/alpha/pmap.c","sys/arch/alpha/alpha/pmap.c","pmap_copy_page",2217,2230
15,4,94,1,19,"pmap_clear_modify@2238-2257@sys/arch/alpha/alpha/pmap.c","sys/arch/alpha/alpha/pmap.c","pmap_clear_modify",2238,2257
15,4,98,1,19,"pmap_clear_reference@2265-2284@sys/arch/alpha/alpha/pmap.c","sys/arch/alpha/alpha/pmap.c","pmap_clear_reference",2265,2284
9,3,53,1,11,"pmap_is_referenced@2293-2304@sys/arch/alpha/alpha/pmap.c","sys/arch/alpha/alpha/pmap.c","pmap_is_referenced",2293,2304
9,3,53,1,11,"pmap_is_modified@2313-2324@sys/arch/alpha/alpha/pmap.c","sys/arch/alpha/alpha/pmap.c","pmap_is_modified",2313,2324
25,5,151,1,27,"alpha_protection_init@2338-2365@sys/arch/alpha/alpha/pmap.c","sys/arch/alpha/alpha/pmap.c","alpha_protection_init",2338,2365
49,13,316,5,90,"pmap_remove_mapping@2385-2475@sys/arch/alpha/alpha/pmap.c","sys/arch/alpha/alpha/pmap.c","pmap_remove_mapping",2385,2475
27,6,183,4,36,"pmap_changebit@2488-2524@sys/arch/alpha/alpha/pmap.c","sys/arch/alpha/alpha/pmap.c","pmap_changebit",2488,2524
90,31,520,4,152,"pmap_emulate_reference@2534-2686@sys/arch/alpha/alpha/pmap.c","sys/arch/alpha/alpha/pmap.c","pmap_emulate_reference",2534,2686
13,2,93,1,14,"pmap_pv_dump@2695-2709@sys/arch/alpha/alpha/pmap.c","sys/arch/alpha/alpha/pmap.c","pmap_pv_dump",2695,2709
16,5,87,1,20,"vtophys@2721-2741@sys/arch/alpha/alpha/pmap.c","sys/arch/alpha/alpha/pmap.c","vtophys",2721,2741
27,8,168,5,43,"pmap_pv_enter@2751-2794@sys/arch/alpha/alpha/pmap.c","sys/arch/alpha/alpha/pmap.c","pmap_pv_enter",2751,2794
16,8,123,4,26,"pmap_pv_remove@2802-2828@sys/arch/alpha/alpha/pmap.c","sys/arch/alpha/alpha/pmap.c","pmap_pv_remove",2802,2828
8,2,51,3,8,"pmap_pv_page_alloc@2836-2844@sys/arch/alpha/alpha/pmap.c","sys/arch/alpha/alpha/pmap.c","pmap_pv_page_alloc",2836,2844
4,1,24,2,4,"pmap_pv_page_free@2852-2856@sys/arch/alpha/alpha/pmap.c","sys/arch/alpha/alpha/pmap.c","pmap_pv_page_free",2852,2856
18,5,97,2,26,"pmap_physpage_alloc@2867-2893@sys/arch/alpha/alpha/pmap.c","sys/arch/alpha/alpha/pmap.c","pmap_physpage_alloc",2867,2893
9,4,48,1,13,"pmap_physpage_free@2901-2914@sys/arch/alpha/alpha/pmap.c","sys/arch/alpha/alpha/pmap.c","pmap_physpage_free",2901,2914
10,1,51,1,12,"pmap_physpage_addref@2922-2934@sys/arch/alpha/alpha/pmap.c","sys/arch/alpha/alpha/pmap.c","pmap_physpage_addref",2922,2934
12,3,64,1,20,"pmap_physpage_delref@2942-2962@sys/arch/alpha/alpha/pmap.c","sys/arch/alpha/alpha/pmap.c","pmap_physpage_delref",2942,2962
56,11,357,1,92,"pmap_growkernel@2973-3065@sys/arch/alpha/alpha/pmap.c","sys/arch/alpha/alpha/pmap.c","pmap_growkernel",2973,3065
12,2,74,2,16,"pmap_lev1map_create@3076-3092@sys/arch/alpha/alpha/pmap.c","sys/arch/alpha/alpha/pmap.c","pmap_lev1map_create",3076,3092
7,1,38,1,15,"pmap_lev1map_destroy@3103-3118@sys/arch/alpha/alpha/pmap.c","sys/arch/alpha/alpha/pmap.c","pmap_lev1map_destroy",3103,3118
13,3,102,1,23,"pmap_l1pt_ctor@3126-3149@sys/arch/alpha/alpha/pmap.c","sys/arch/alpha/alpha/pmap.c","pmap_l1pt_ctor",3126,3149
8,2,53,3,12,"pmap_l1pt_alloc@3161-3173@sys/arch/alpha/alpha/pmap.c","sys/arch/alpha/alpha/pmap.c","pmap_l1pt_alloc",3161,3173
4,1,24,2,4,"pmap_l1pt_free@3181-3185@sys/arch/alpha/alpha/pmap.c","sys/arch/alpha/alpha/pmap.c","pmap_l1pt_free",3181,3185
10,3,76,3,18,"pmap_ptpage_alloc@3196-3214@sys/arch/alpha/alpha/pmap.c","sys/arch/alpha/alpha/pmap.c","pmap_ptpage_alloc",3196,3214
8,2,41,2,15,"pmap_ptpage_free@3225-3240@sys/arch/alpha/alpha/pmap.c","sys/arch/alpha/alpha/pmap.c","pmap_ptpage_free",3225,3240
22,6,157,4,45,"pmap_l3pt_delref@3251-3296@sys/arch/alpha/alpha/pmap.c","sys/arch/alpha/alpha/pmap.c","pmap_l3pt_delref",3251,3296
11,4,66,3,21,"pmap_l2pt_delref@3307-3328@sys/arch/alpha/alpha/pmap.c","sys/arch/alpha/alpha/pmap.c","pmap_l2pt_delref",3307,3328
5,1,25,2,4,"pmap_l1pt_delref@3339-3343@sys/arch/alpha/alpha/pmap.c","sys/arch/alpha/alpha/pmap.c","pmap_l1pt_delref",3339,3343
47,21,266,2,140,"pmap_asn_alloc@3357-3497@sys/arch/alpha/alpha/pmap.c","sys/arch/alpha/alpha/pmap.c","pmap_asn_alloc",3357,3497
38,7,215,4,74,"pmap_tlb_shootdown@3510-3584@sys/arch/alpha/alpha/pmap.c","sys/arch/alpha/alpha/pmap.c","pmap_tlb_shootdown",3510,3584
4,1,14,1,4,"pmap_tlb_shootnow@3593-3597@sys/arch/alpha/alpha/pmap.c","sys/arch/alpha/alpha/pmap.c","pmap_tlb_shootnow",3593,3597
27,5,173,2,31,"pmap_do_tlb_shootdown@3605-3636@sys/arch/alpha/alpha/pmap.c","sys/arch/alpha/alpha/pmap.c","pmap_do_tlb_shootdown",3605,3636
8,2,51,1,8,"pmap_tlb_shootdown_q_drain@3648-3656@sys/arch/alpha/alpha/pmap.c","sys/arch/alpha/alpha/pmap.c","pmap_tlb_shootdown_q_drain",3648,3656
8,2,47,1,8,"pmap_tlb_shootdown_job_get@3667-3675@sys/arch/alpha/alpha/pmap.c","sys/arch/alpha/alpha/pmap.c","pmap_tlb_shootdown_job_get",3667,3675
5,1,26,2,4,"pmap_tlb_shootdown_job_put@3685-3689@sys/arch/alpha/alpha/pmap.c","sys/arch/alpha/alpha/pmap.c","pmap_tlb_shootdown_job_put",3685,3689
9,1,66,2,9,"process_read_regs@98-107@sys/arch/alpha/alpha/process_machdep.c","sys/arch/alpha/alpha/process_machdep.c","process_read_regs",98,107
9,2,58,2,10,"process_read_fpregs@110-120@sys/arch/alpha/alpha/process_machdep.c","sys/arch/alpha/alpha/process_machdep.c","process_read_fpregs",110,120
9,1,66,2,9,"process_write_regs@125-134@sys/arch/alpha/alpha/process_machdep.c","sys/arch/alpha/alpha/process_machdep.c","process_write_regs",125,134
8,1,43,2,8,"process_set_pc@137-145@sys/arch/alpha/alpha/process_machdep.c","sys/arch/alpha/alpha/process_machdep.c","process_set_pc",137,145
9,2,58,2,10,"process_write_fpregs@148-158@sys/arch/alpha/alpha/process_machdep.c","sys/arch/alpha/alpha/process_machdep.c","process_write_fpregs",148,158
15,1,106,3,15,"ptrace_read_int@170-185@sys/arch/alpha/alpha/process_machdep.c","sys/arch/alpha/alpha/process_machdep.c","ptrace_read_int",170,185
15,1,106,3,15,"ptrace_write_int@188-203@sys/arch/alpha/alpha/process_machdep.c","sys/arch/alpha/alpha/process_machdep.c","ptrace_write_int",188,203
40,2,111,2,44,"ptrace_read_register@206-250@sys/arch/alpha/alpha/process_machdep.c","sys/arch/alpha/alpha/process_machdep.c","ptrace_read_register",206,250
4,1,28,2,3,"ptrace_clear_bpt@253-256@sys/arch/alpha/alpha/process_machdep.c","sys/arch/alpha/alpha/process_machdep.c","ptrace_clear_bpt",253,256
9,2,57,2,8,"ptrace_set_bpt@259-267@sys/arch/alpha/alpha/process_machdep.c","sys/arch/alpha/alpha/process_machdep.c","ptrace_set_bpt",259,267
70,28,466,2,80,"process_sstep@270-350@sys/arch/alpha/alpha/process_machdep.c","sys/arch/alpha/alpha/process_machdep.c","process_sstep",270,350
6,1,39,0,10,"prom_lev1map@64-74@sys/arch/alpha/alpha/prom.c","sys/arch/alpha/alpha/prom.c","prom_lev1map",64,74
7,1,51,1,8,"init_prom_interface@78-86@sys/arch/alpha/alpha/prom.c","sys/arch/alpha/alpha/prom.c","init_prom_interface",78,86
8,1,39,0,11,"init_bootstrap_console@89-100@sys/arch/alpha/alpha/prom.c","sys/arch/alpha/alpha/prom.c","init_bootstrap_console",89,100
15,5,69,1,23,"prom_enter@107-130@sys/arch/alpha/alpha/prom.c","sys/arch/alpha/alpha/prom.c","prom_enter",107,130
14,5,62,1,20,"prom_leave@133-153@sys/arch/alpha/alpha/prom.c","sys/arch/alpha/alpha/prom.c","prom_leave",133,153
5,1,14,1,4,"prom_cache_sync@157-161@sys/arch/alpha/alpha/prom.c","sys/arch/alpha/alpha/prom.c","prom_cache_sync",157,161
11,2,69,2,13,"promcnputc@175-188@sys/arch/alpha/alpha/prom.c","sys/arch/alpha/alpha/prom.c","promcnputc",175,188
11,4,61,1,11,"promcngetc@196-207@sys/arch/alpha/alpha/prom.c","sys/arch/alpha/alpha/prom.c","promcngetc",196,207
12,3,67,2,12,"promcnlookc@215-227@sys/arch/alpha/alpha/prom.c","sys/arch/alpha/alpha/prom.c","promcnlookc",215,227
13,2,95,3,15,"prom_getenv@230-245@sys/arch/alpha/alpha/prom.c","sys/arch/alpha/alpha/prom.c","prom_getenv",230,245
12,2,61,1,24,"prom_halt@248-272@sys/arch/alpha/alpha/prom.c","sys/arch/alpha/alpha/prom.c","prom_halt",248,272
10,2,65,0,11,"hwrpb_checksum@275-286@sys/arch/alpha/alpha/prom.c","sys/arch/alpha/alpha/prom.c","hwrpb_checksum",275,286
9,1,60,0,12,"hwrpb_primary_init@289-301@sys/arch/alpha/alpha/prom.c","sys/arch/alpha/alpha/prom.c","hwrpb_primary_init",289,301
10,1,61,0,15,"hwrpb_restart_setup@304-319@sys/arch/alpha/alpha/prom.c","sys/arch/alpha/alpha/prom.c","hwrpb_restart_setup",304,319
13,1,96,1,19,"console_restart@322-341@sys/arch/alpha/alpha/prom.c","sys/arch/alpha/alpha/prom.c","console_restart",322,341
41,8,271,4,47,"promopen@60-107@sys/arch/alpha/alpha/promcons.c","sys/arch/alpha/alpha/promcons.c","promopen",60,107
12,1,76,4,12,"promclose@110-122@sys/arch/alpha/alpha/promcons.c","sys/arch/alpha/alpha/promcons.c","promclose",110,122
8,1,56,3,8,"promread@125-133@sys/arch/alpha/alpha/promcons.c","sys/arch/alpha/alpha/promcons.c","promread",125,133
8,1,56,3,8,"promwrite@136-144@sys/arch/alpha/alpha/promcons.c","sys/arch/alpha/alpha/promcons.c","promwrite",136,144
18,3,113,5,19,"promioctl@147-166@sys/arch/alpha/alpha/promcons.c","sys/arch/alpha/alpha/promcons.c","promioctl",147,166
6,1,21,2,6,"promparam@169-175@sys/arch/alpha/alpha/promcons.c","sys/arch/alpha/alpha/promcons.c","promparam",169,175
15,3,84,1,15,"promstart@178-193@sys/arch/alpha/alpha/promcons.c","sys/arch/alpha/alpha/promcons.c","promstart",178,193
12,3,59,2,12,"promstop@199-211@sys/arch/alpha/alpha/promcons.c","sys/arch/alpha/alpha/promcons.c","promstop",199,211
11,3,67,1,11,"promtimeout@214-225@sys/arch/alpha/alpha/promcons.c","sys/arch/alpha/alpha/promcons.c","promtimeout",214,225
7,2,29,1,8,"promtty@228-236@sys/arch/alpha/alpha/promcons.c","sys/arch/alpha/alpha/promcons.c","promtty",228,236
60,12,312,3,67,"sys_sysarch@77-144@sys/arch/alpha/alpha/sys_machdep.c","sys/arch/alpha/alpha/sys_machdep.c","sys_sysarch",77,144
4,1,22,3,3,"sys_sysarch@146-149@sys/arch/alpha/alpha/sys_machdep.c","sys/arch/alpha/alpha/sys_machdep.c","sys_sysarch",146,149
11,1,60,0,19,"trap_init@142-161@sys/arch/alpha/alpha/trap.c","sys/arch/alpha/alpha/trap.c","trap_init",142,161
46,10,247,7,47,"printtrap@164-211@sys/arch/alpha/alpha/trap.c","sys/arch/alpha/alpha/trap.c","printtrap",164,211
197,49,987,5,291,"trap@221-512@sys/arch/alpha/alpha/trap.c","sys/arch/alpha/alpha/trap.c","trap",221,512
77,16,466,2,91,"syscall@528-619@sys/arch/alpha/alpha/trap.c","sys/arch/alpha/alpha/trap.c","syscall",528,619
12,1,77,1,19,"child_return@625-644@sys/arch/alpha/alpha/trap.c","sys/arch/alpha/alpha/trap.c","child_return",625,644
26,10,181,2,42,"alpha_enable_fp@652-694@sys/arch/alpha/alpha/trap.c","sys/arch/alpha/alpha/trap.c","alpha_enable_fp",652,694
14,3,102,1,21,"ast@701-722@sys/arch/alpha/alpha/trap.c","sys/arch/alpha/alpha/trap.c","ast",701,722
17,5,143,1,20,"Sfloat_to_reg@790-810@sys/arch/alpha/alpha/trap.c","sys/arch/alpha/alpha/trap.c","Sfloat_to_reg",790,810
12,2,105,1,15,"reg_to_Sfloat@813-828@sys/arch/alpha/alpha/trap.c","sys/arch/alpha/alpha/trap.c","reg_to_Sfloat",813,828
5,1,15,1,5,"Tfloat_reg_cvt@835-840@sys/arch/alpha/alpha/trap.c","sys/arch/alpha/alpha/trap.c","Tfloat_reg_cvt",835,840
16,4,152,1,19,"Ffloat_to_reg@844-863@sys/arch/alpha/alpha/trap.c","sys/arch/alpha/alpha/trap.c","Ffloat_to_reg",844,863
13,2,125,1,16,"reg_to_Ffloat@866-882@sys/arch/alpha/alpha/trap.c","sys/arch/alpha/alpha/trap.c","reg_to_Ffloat",866,882
12,1,103,1,13,"Gfloat_reg_cvt@889-902@sys/arch/alpha/alpha/trap.c","sys/arch/alpha/alpha/trap.c","Gfloat_reg_cvt",889,902
101,28,592,4,172,"unaligned_fixup@918-1090@sys/arch/alpha/alpha/trap.c","sys/arch/alpha/alpha/trap.c","unaligned_fixup",918,1090
119,39,757,2,171,"handle_opdec@1107-1278@sys/arch/alpha/alpha/trap.c","sys/arch/alpha/alpha/trap.c","handle_opdec",1107,1278
8,2,40,1,15,"cpu_exit@52-67@sys/arch/alpha/alpha/vm_machdep.c","sys/arch/alpha/alpha/vm_machdep.c","cpu_exit",52,67
33,9,369,6,87,"cpu_fork@85-172@sys/arch/alpha/alpha/vm_machdep.c","sys/arch/alpha/alpha/vm_machdep.c","cpu_fork",85,172
27,4,192,2,27,"vmapbuf@180-207@sys/arch/alpha/alpha/vm_machdep.c","sys/arch/alpha/alpha/vm_machdep.c","vmapbuf",180,207
16,2,115,2,16,"vunmapbuf@213-229@sys/arch/alpha/alpha/vm_machdep.c","sys/arch/alpha/alpha/vm_machdep.c","vunmapbuf",213,229
7,2,40,1,6,"tcb_get@232-238@sys/arch/alpha/alpha/vm_machdep.c","sys/arch/alpha/alpha/vm_machdep.c","tcb_get",232,238
6,1,45,2,6,"tcb_set@241-247@sys/arch/alpha/alpha/vm_machdep.c","sys/arch/alpha/alpha/vm_machdep.c","tcb_set",241,247
32,5,207,7,46,"_bus_dmamap_create@57-103@sys/arch/alpha/dev/bus_dma.c","sys/arch/alpha/dev/bus_dma.c","_bus_dmamap_create",57,103
6,1,23,2,6,"_bus_dmamap_destroy@110-116@sys/arch/alpha/dev/bus_dma.c","sys/arch/alpha/dev/bus_dma.c","_bus_dmamap_destroy",110,116
69,17,428,9,104,"_bus_dmamap_load_buffer_direct@125-229@sys/arch/alpha/dev/bus_dma.c","sys/arch/alpha/dev/bus_dma.c","_bus_dmamap_load_buffer_direct",125,229
28,4,179,6,36,"_bus_dmamap_load_direct@238-274@sys/arch/alpha/dev/bus_dma.c","sys/arch/alpha/dev/bus_dma.c","_bus_dmamap_load_direct",238,274
35,9,244,4,46,"_bus_dmamap_load_mbuf_direct@280-326@sys/arch/alpha/dev/bus_dma.c","sys/arch/alpha/dev/bus_dma.c","_bus_dmamap_load_mbuf_direct",280,326
43,10,290,4,60,"_bus_dmamap_load_uio_direct@332-392@sys/arch/alpha/dev/bus_dma.c","sys/arch/alpha/dev/bus_dma.c","_bus_dmamap_load_uio_direct",332,392
10,1,40,6,10,"_bus_dmamap_load_raw_direct@398-408@sys/arch/alpha/dev/bus_dma.c","sys/arch/alpha/dev/bus_dma.c","_bus_dmamap_load_raw_direct",398,408
9,1,42,2,13,"_bus_dmamap_unload@415-428@sys/arch/alpha/dev/bus_dma.c","sys/arch/alpha/dev/bus_dma.c","_bus_dmamap_unload",415,428
9,1,33,5,12,"_bus_dmamap_sync@435-447@sys/arch/alpha/dev/bus_dma.c","sys/arch/alpha/dev/bus_dma.c","_bus_dmamap_sync",435,447
11,1,77,8,11,"_bus_dmamem_alloc@454-465@sys/arch/alpha/dev/bus_dma.c","sys/arch/alpha/dev/bus_dma.c","_bus_dmamem_alloc",454,465
48,9,292,10,64,"_bus_dmamem_alloc_range@472-536@sys/arch/alpha/dev/bus_dma.c","sys/arch/alpha/dev/bus_dma.c","_bus_dmamem_alloc_range",472,536
20,3,114,3,24,"_bus_dmamem_free@543-567@sys/arch/alpha/dev/bus_dma.c","sys/arch/alpha/dev/bus_dma.c","_bus_dmamem_free",543,567
44,8,292,6,52,"_bus_dmamem_map@574-626@sys/arch/alpha/dev/bus_dma.c","sys/arch/alpha/dev/bus_dma.c","_bus_dmamem_map",574,626
12,5,67,3,19,"_bus_dmamem_unmap@633-652@sys/arch/alpha/dev/bus_dma.c","sys/arch/alpha/dev/bus_dma.c","_bus_dmamem_unmap",633,652
24,7,138,6,29,"_bus_dmamem_mmap@659-688@sys/arch/alpha/dev/bus_dma.c","sys/arch/alpha/dev/bus_dma.c","_bus_dmamem_mmap",659,688
65,9,346,9,86,"alpha_sgmap_init@57-143@sys/arch/alpha/dev/sgmap_common.c","sys/arch/alpha/dev/sgmap_common.c","alpha_sgmap_init",57,143
9,2,55,3,8,"alpha_sgmap_dmamap_setup@146-154@sys/arch/alpha/dev/sgmap_common.c","sys/arch/alpha/dev/sgmap_common.c","alpha_sgmap_dmamap_setup",146,154
23,3,109,7,27,"alpha_sgmap_dmamap_create@157-184@sys/arch/alpha/dev/sgmap_common.c","sys/arch/alpha/dev/sgmap_common.c","alpha_sgmap_dmamap_create",157,184
5,1,20,1,4,"alpha_sgmap_dmamap_teardown@187-191@sys/arch/alpha/dev/sgmap_common.c","sys/arch/alpha/dev/sgmap_common.c","alpha_sgmap_dmamap_teardown",187,191
8,1,35,2,8,"alpha_sgmap_dmamap_destroy@194-202@sys/arch/alpha/dev/sgmap_common.c","sys/arch/alpha/dev/sgmap_common.c","alpha_sgmap_dmamap_destroy",194,202
6,1,21,1,6,"__C( SGMAP_TYPE , _init_spill_page_pte)@45-51@sys/arch/alpha/dev/sgmap_typedep.c","sys/arch/alpha/dev/sgmap_typedep.c","__C( SGMAP_TYPE , _init_spill_page_pte)",45,51
84,24,582,8,140,"__C( SGMAP_TYPE , _load_buffer)@54-194@sys/arch/alpha/dev/sgmap_typedep.c","sys/arch/alpha/dev/sgmap_typedep.c","__C( SGMAP_TYPE , _load_buffer)",54,194
31,6,229,7,44,"__C( SGMAP_TYPE , _load)@197-241@sys/arch/alpha/dev/sgmap_typedep.c","sys/arch/alpha/dev/sgmap_typedep.c","__C( SGMAP_TYPE , _load)",197,241
42,11,322,5,60,"__C( SGMAP_TYPE , _load_mbuf)@244-304@sys/arch/alpha/dev/sgmap_typedep.c","sys/arch/alpha/dev/sgmap_typedep.c","__C( SGMAP_TYPE , _load_mbuf)",244,304
49,12,361,5,73,"__C( SGMAP_TYPE , _load_uio)@307-380@sys/arch/alpha/dev/sgmap_typedep.c","sys/arch/alpha/dev/sgmap_typedep.c","__C( SGMAP_TYPE , _load_uio)",307,380
9,1,77,7,9,"__C( SGMAP_TYPE , _load_raw)@383-392@sys/arch/alpha/dev/sgmap_typedep.c","sys/arch/alpha/dev/sgmap_typedep.c","__C( SGMAP_TYPE , _load_raw)",383,392
37,8,275,3,55,"__C( SGMAP_TYPE , _unload)@395-450@sys/arch/alpha/dev/sgmap_typedep.c","sys/arch/alpha/dev/sgmap_typedep.c","__C( SGMAP_TYPE , _unload)",395,450
17,6,62,1,17,"intr_typename@47-64@sys/arch/alpha/dev/shared_intr.c","sys/arch/alpha/dev/shared_intr.c","intr_typename",47,64
19,4,127,1,21,"alpha_shared_intr_alloc@67-88@sys/arch/alpha/dev/shared_intr.c","sys/arch/alpha/dev/shared_intr.c","alpha_shared_intr_alloc",67,88
21,9,127,2,34,"alpha_shared_intr_dispatch@91-125@sys/arch/alpha/dev/shared_intr.c","sys/arch/alpha/dev/shared_intr.c","alpha_shared_intr_dispatch",91,125
5,1,25,1,4,"if@138-142@sys/arch/alpha/dev/shared_intr.c","sys/arch/alpha/dev/shared_intr.c","if",138,142
23,8,127,1,25,"switch@154-179@sys/arch/alpha/dev/shared_intr.c","sys/arch/alpha/dev/shared_intr.c","switch",154,179
10,1,66,2,14,"alpha_shared_intr_disestablish@195-209@sys/arch/alpha/dev/shared_intr.c","sys/arch/alpha/dev/shared_intr.c","alpha_shared_intr_disestablish",195,209
6,1,27,2,6,"alpha_shared_intr_get_sharetype@212-218@sys/arch/alpha/dev/shared_intr.c","sys/arch/alpha/dev/shared_intr.c","alpha_shared_intr_get_sharetype",212,218
6,1,32,2,6,"alpha_shared_intr_isactive@221-227@sys/arch/alpha/dev/shared_intr.c","sys/arch/alpha/dev/shared_intr.c","alpha_shared_intr_isactive",221,227
5,2,44,2,5,"alpha_shared_intr_firstactive@230-235@sys/arch/alpha/dev/shared_intr.c","sys/arch/alpha/dev/shared_intr.c","alpha_shared_intr_firstactive",230,235
10,3,59,3,13,"alpha_shared_intr_set_dfltsharetype@238-251@sys/arch/alpha/dev/shared_intr.c","sys/arch/alpha/dev/shared_intr.c","alpha_shared_intr_set_dfltsharetype",238,251
10,1,52,3,9,"alpha_shared_intr_set_maxstrays@254-263@sys/arch/alpha/dev/shared_intr.c","sys/arch/alpha/dev/shared_intr.c","alpha_shared_intr_set_maxstrays",254,263
6,1,26,2,10,"alpha_shared_intr_reset_strays@266-276@sys/arch/alpha/dev/shared_intr.c","sys/arch/alpha/dev/shared_intr.c","alpha_shared_intr_reset_strays",266,276
13,4,90,3,15,"alpha_shared_intr_stray@279-294@sys/arch/alpha/dev/shared_intr.c","sys/arch/alpha/dev/shared_intr.c","alpha_shared_intr_stray",279,294
7,1,32,3,7,"alpha_shared_intr_set_private@297-304@sys/arch/alpha/dev/shared_intr.c","sys/arch/alpha/dev/shared_intr.c","alpha_shared_intr_set_private",297,304
6,1,27,2,6,"alpha_shared_intr_get_private@307-313@sys/arch/alpha/dev/shared_intr.c","sys/arch/alpha/dev/shared_intr.c","alpha_shared_intr_get_private",307,313
8,1,54,1,8,"ecuf_init@161-169@sys/arch/alpha/eisa/eisa_machdep.c","sys/arch/alpha/eisa/eisa_machdep.c","ecuf_init",161,169
23,5,224,2,28,"eisa_parse_mem@172-200@sys/arch/alpha/eisa/eisa_machdep.c","sys/arch/alpha/eisa/eisa_machdep.c","eisa_parse_mem",172,200
18,8,156,2,23,"eisa_parse_irq@203-226@sys/arch/alpha/eisa/eisa_machdep.c","sys/arch/alpha/eisa/eisa_machdep.c","eisa_parse_irq",203,226
19,5,163,2,24,"eisa_parse_dma@229-253@sys/arch/alpha/eisa/eisa_machdep.c","sys/arch/alpha/eisa/eisa_machdep.c","eisa_parse_dma",229,253
18,6,156,2,23,"eisa_parse_io@256-279@sys/arch/alpha/eisa/eisa_machdep.c","sys/arch/alpha/eisa/eisa_machdep.c","eisa_parse_io",256,279
9,2,58,3,9,"eisa_read_config_bytes@282-291@sys/arch/alpha/eisa/eisa_machdep.c","sys/arch/alpha/eisa/eisa_machdep.c","eisa_read_config_bytes",282,291
11,2,76,2,12,"eisa_read_config_word@294-306@sys/arch/alpha/eisa/eisa_machdep.c","sys/arch/alpha/eisa/eisa_machdep.c","eisa_read_config_word",294,306
17,4,103,3,18,"eisa_uncompress@309-327@sys/arch/alpha/eisa/eisa_machdep.c","sys/arch/alpha/eisa/eisa_machdep.c","eisa_uncompress",309,327
170,37,1213,1,247,"eisa_init@330-577@sys/arch/alpha/eisa/eisa_machdep.c","sys/arch/alpha/eisa/eisa_machdep.c","eisa_init",330,577
22,8,149,1,29,"eisa_compute_maxslots@584-613@sys/arch/alpha/eisa/eisa_machdep.c","sys/arch/alpha/eisa/eisa_machdep.c","eisa_compute_maxslots",584,613
6,1,26,1,6,"alpha_rpcc@333-339@sys/arch/alpha/include/alpha_cpu.h","sys/arch/alpha/include/alpha_cpu.h","alpha_rpcc",333,339
9,1,46,1,11,"alpha_pal_rdmces@364-375@sys/arch/alpha/include/alpha_cpu.h","sys/arch/alpha/include/alpha_cpu.h","alpha_pal_rdmces",364,375
9,1,46,1,11,"alpha_pal_rdps@378-389@sys/arch/alpha/include/alpha_cpu.h","sys/arch/alpha/include/alpha_cpu.h","alpha_pal_rdps",378,389
8,1,36,1,9,"alpha_pal_rdunique@392-401@sys/arch/alpha/include/alpha_cpu.h","sys/arch/alpha/include/alpha_cpu.h","alpha_pal_rdunique",392,401
9,1,46,1,11,"alpha_pal_rdusp@404-415@sys/arch/alpha/include/alpha_cpu.h","sys/arch/alpha/include/alpha_cpu.h","alpha_pal_rdusp",404,415
9,1,46,1,11,"alpha_pal_rdval@418-429@sys/arch/alpha/include/alpha_cpu.h","sys/arch/alpha/include/alpha_cpu.h","alpha_pal_rdval",418,429
10,1,71,1,12,"alpha_pal_swpctx@432-444@sys/arch/alpha/include/alpha_cpu.h","sys/arch/alpha/include/alpha_cpu.h","alpha_pal_swpctx",432,444
10,1,71,1,12,"alpha_pal_swpipl@447-459@sys/arch/alpha/include/alpha_cpu.h","sys/arch/alpha/include/alpha_cpu.h","alpha_pal_swpipl",447,459
9,1,74,2,10,"alpha_pal_tbi@462-472@sys/arch/alpha/include/alpha_cpu.h","sys/arch/alpha/include/alpha_cpu.h","alpha_pal_tbi",462,472
9,1,46,1,11,"alpha_pal_whami@475-486@sys/arch/alpha/include/alpha_cpu.h","sys/arch/alpha/include/alpha_cpu.h","alpha_pal_whami",475,486
8,1,50,1,9,"alpha_pal_wrfen@489-498@sys/arch/alpha/include/alpha_cpu.h","sys/arch/alpha/include/alpha_cpu.h","alpha_pal_wrfen",489,498
8,1,50,1,9,"alpha_pal_wripir@501-510@sys/arch/alpha/include/alpha_cpu.h","sys/arch/alpha/include/alpha_cpu.h","alpha_pal_wripir",501,510
7,1,40,1,7,"alpha_pal_wrunique@513-520@sys/arch/alpha/include/alpha_cpu.h","sys/arch/alpha/include/alpha_cpu.h","alpha_pal_wrunique",513,520
8,1,50,1,9,"alpha_pal_wrusp@523-532@sys/arch/alpha/include/alpha_cpu.h","sys/arch/alpha/include/alpha_cpu.h","alpha_pal_wrusp",523,532
8,1,50,1,9,"alpha_pal_wrmces@535-544@sys/arch/alpha/include/alpha_cpu.h","sys/arch/alpha/include/alpha_cpu.h","alpha_pal_wrmces",535,544
8,1,50,1,9,"alpha_pal_wrval@547-556@sys/arch/alpha/include/alpha_cpu.h","sys/arch/alpha/include/alpha_cpu.h","alpha_pal_wrval",547,556
18,1,51,2,18,"atomic_setbits_ulong@49-67@sys/arch/alpha/include/atomic.h","sys/arch/alpha/include/atomic.h","atomic_setbits_ulong",49,67
18,1,51,2,18,"atomic_clearbits_ulong@75-93@sys/arch/alpha/include/atomic.h","sys/arch/alpha/include/atomic.h","atomic_clearbits_ulong",75,93
18,1,51,2,18,"atomic_add_ulong@101-119@sys/arch/alpha/include/atomic.h","sys/arch/alpha/include/atomic.h","atomic_add_ulong",101,119
18,1,51,2,18,"atomic_sub_ulong@127-145@sys/arch/alpha/include/atomic.h","sys/arch/alpha/include/atomic.h","atomic_sub_ulong",127,145
19,1,63,2,20,"atomic_loadlatch_ulong@153-173@sys/arch/alpha/include/atomic.h","sys/arch/alpha/include/atomic.h","atomic_loadlatch_ulong",153,173
18,1,51,2,18,"atomic_setbits_int@181-199@sys/arch/alpha/include/atomic.h","sys/arch/alpha/include/atomic.h","atomic_setbits_int",181,199
18,1,51,2,18,"atomic_clearbits_int@207-225@sys/arch/alpha/include/atomic.h","sys/arch/alpha/include/atomic.h","atomic_clearbits_int",207,225
18,1,49,2,18,"atomic_add_int@233-251@sys/arch/alpha/include/atomic.h","sys/arch/alpha/include/atomic.h","atomic_add_int",233,251
8,1,34,1,9,"alpha_ldbu@51-60@sys/arch/alpha/include/bwx.h","sys/arch/alpha/include/bwx.h","alpha_ldbu",51,60
8,1,34,1,9,"alpha_ldwu@63-72@sys/arch/alpha/include/bwx.h","sys/arch/alpha/include/bwx.h","alpha_ldwu",63,72
4,1,15,1,3,"alpha_ldlu@75-78@sys/arch/alpha/include/bwx.h","sys/arch/alpha/include/bwx.h","alpha_ldlu",75,78
7,1,31,2,7,"alpha_stb@81-88@sys/arch/alpha/include/bwx.h","sys/arch/alpha/include/bwx.h","alpha_stb",81,88
7,1,31,2,7,"alpha_stw@91-98@sys/arch/alpha/include/bwx.h","sys/arch/alpha/include/bwx.h","alpha_stw",91,98
7,1,31,2,7,"alpha_stl@101-108@sys/arch/alpha/include/bwx.h","sys/arch/alpha/include/bwx.h","alpha_stl",101,108
9,1,33,1,10,"alpha_sextb@111-121@sys/arch/alpha/include/bwx.h","sys/arch/alpha/include/bwx.h","alpha_sextb",111,121
9,1,33,1,10,"alpha_sextw@124-134@sys/arch/alpha/include/bwx.h","sys/arch/alpha/include/bwx.h","alpha_sextw",124,134
14,3,81,3,15,"pmap_l2pte@240-255@sys/arch/alpha/include/pmap.h","sys/arch/alpha/include/pmap.h","pmap_l2pte",240,255
18,4,126,3,20,"pmap_l3pte@258-278@sys/arch/alpha/include/pmap.h","sys/arch/alpha/include/pmap.h","pmap_l3pte",258,278
8,1,33,1,8,"__alpha_get_tcb@36-44@sys/arch/alpha/include/tcb.h","sys/arch/alpha/include/tcb.h","__alpha_get_tcb",36,44
7,1,40,1,7,"__alpha_set_tcb@48-55@sys/arch/alpha/include/tcb.h","sys/arch/alpha/include/tcb.h","__alpha_set_tcb",48,55
9,3,42,2,10,"isa_display_console@53-63@sys/arch/alpha/isa/isa_machdep.c","sys/arch/alpha/isa/isa_machdep.c","isa_display_console",53,63
42,9,278,7,76,"isadma_bounce_dmamap_create@101-177@sys/arch/alpha/isa/isadma_bounce.c","sys/arch/alpha/isa/isadma_bounce.c","isadma_bounce_dmamap_create",101,177
8,2,50,2,12,"isadma_bounce_dmamap_destroy@183-195@sys/arch/alpha/isa/isadma_bounce.c","sys/arch/alpha/isa/isadma_bounce.c","isadma_bounce_dmamap_destroy",183,195
30,8,213,6,57,"isadma_bounce_dmamap_load@201-258@sys/arch/alpha/isa/isadma_bounce.c","sys/arch/alpha/isa/isadma_bounce.c","isadma_bounce_dmamap_load",201,258
35,11,248,4,66,"isadma_bounce_dmamap_load_mbuf@264-330@sys/arch/alpha/isa/isadma_bounce.c","sys/arch/alpha/isa/isadma_bounce.c","isadma_bounce_dmamap_load_mbuf",264,330
5,1,23,4,5,"isadma_bounce_dmamap_load_uio@336-341@sys/arch/alpha/isa/isadma_bounce.c","sys/arch/alpha/isa/isadma_bounce.c","isadma_bounce_dmamap_load_uio",336,341
5,1,28,6,5,"isadma_bounce_dmamap_load_raw@348-353@sys/arch/alpha/isa/isadma_bounce.c","sys/arch/alpha/isa/isadma_bounce.c","isadma_bounce_dmamap_load_raw",348,353
10,3,65,2,19,"isadma_bounce_dmamap_unload@359-378@sys/arch/alpha/isa/isadma_bounce.c","sys/arch/alpha/isa/isadma_bounce.c","isadma_bounce_dmamap_unload",359,378
70,22,410,5,129,"isadma_bounce_dmamap_sync@381-510@sys/arch/alpha/isa/isadma_bounce.c","sys/arch/alpha/isa/isadma_bounce.c","isadma_bounce_dmamap_sync",381,510
13,2,105,8,16,"isadma_bounce_dmamem_alloc@516-532@sys/arch/alpha/isa/isadma_bounce.c","sys/arch/alpha/isa/isadma_bounce.c","isadma_bounce_dmamem_alloc",516,532
25,3,157,4,27,"isadma_bounce_alloc_bouncebuf@539-566@sys/arch/alpha/isa/isadma_bounce.c","sys/arch/alpha/isa/isadma_bounce.c","isadma_bounce_alloc_bouncebuf",539,566
11,1,63,2,11,"isadma_bounce_free_bouncebuf@569-580@sys/arch/alpha/isa/isadma_bounce.c","sys/arch/alpha/isa/isadma_bounce.c","isadma_bounce_free_bouncebuf",569,580
14,1,92,1,16,"jensen_inb@59-75@sys/arch/alpha/isa/isafcns_jensen.c","sys/arch/alpha/isa/isafcns_jensen.c","jensen_inb",59,75
14,1,92,1,16,"jensen_inw@78-94@sys/arch/alpha/isa/isafcns_jensen.c","sys/arch/alpha/isa/isafcns_jensen.c","jensen_inw",78,94
14,1,92,1,16,"jensen_inl@97-113@sys/arch/alpha/isa/isafcns_jensen.c","sys/arch/alpha/isa/isafcns_jensen.c","jensen_inl",97,113
12,1,72,2,14,"jensen_outb@116-130@sys/arch/alpha/isa/isafcns_jensen.c","sys/arch/alpha/isa/isafcns_jensen.c","jensen_outb",116,130
12,1,72,2,14,"jensen_outw@133-147@sys/arch/alpha/isa/isafcns_jensen.c","sys/arch/alpha/isa/isafcns_jensen.c","jensen_outw",133,147
12,1,72,2,14,"jensen_outl@150-164@sys/arch/alpha/isa/isafcns_jensen.c","sys/arch/alpha/isa/isafcns_jensen.c","jensen_outl",150,164
16,3,92,1,18,"isapnp_map@64-82@sys/arch/alpha/isa/isapnp_machdep.c","sys/arch/alpha/isa/isapnp_machdep.c","isapnp_map",64,82
6,1,37,1,6,"isapnp_unmap@88-94@sys/arch/alpha/isa/isapnp_machdep.c","sys/arch/alpha/isa/isapnp_machdep.c","isapnp_unmap",88,94
10,4,61,1,21,"isapnp_map_readport@103-124@sys/arch/alpha/isa/isapnp_machdep.c","sys/arch/alpha/isa/isapnp_machdep.c","isapnp_map_readport",103,124
4,1,11,1,4,"isapnp_unmap_readport@130-134@sys/arch/alpha/isa/isapnp_machdep.c","sys/arch/alpha/isa/isapnp_machdep.c","isapnp_unmap_readport",130,134
18,8,129,3,23,"mcclock_isa_match@66-89@sys/arch/alpha/isa/mcclock_isa.c","sys/arch/alpha/isa/mcclock_isa.c","mcclock_isa_match",66,89
12,2,89,3,13,"mcclock_isa_attach@92-105@sys/arch/alpha/isa/mcclock_isa.c","sys/arch/alpha/isa/mcclock_isa.c","mcclock_isa_attach",92,105
10,1,68,3,10,"mcclock_isa_write@108-118@sys/arch/alpha/isa/mcclock_isa.c","sys/arch/alpha/isa/mcclock_isa.c","mcclock_isa_write",108,118
10,1,63,2,10,"mcclock_isa_read@121-131@sys/arch/alpha/isa/mcclock_isa.c","sys/arch/alpha/isa/mcclock_isa.c","mcclock_isa_read",121,131
9,1,45,2,8,"mcbusprint@93-101@sys/arch/alpha/mcbus/mcbus.c","sys/arch/alpha/mcbus/mcbus.c","mcbusprint",93,101
12,3,88,3,14,"mcbussbm@104-118@sys/arch/alpha/mcbus/mcbus.c","sys/arch/alpha/mcbus/mcbus.c","mcbussbm",104,118
12,3,66,3,18,"mcbusmatch@121-139@sys/arch/alpha/mcbus/mcbus.c","sys/arch/alpha/mcbus/mcbus.c","mcbusmatch",121,139
34,5,250,3,45,"mcbusattach@142-187@sys/arch/alpha/mcbus/mcbus.c","sys/arch/alpha/mcbus/mcbus.c","mcbusattach",142,187
21,6,70,1,20,"mcbus_node_type_str@190-210@sys/arch/alpha/mcbus/mcbus.c","sys/arch/alpha/mcbus/mcbus.c","mcbus_node_type_str",190,210
10,2,48,3,11,"mcmemmatch@64-75@sys/arch/alpha/mcbus/mcmem.c","sys/arch/alpha/mcbus/mcmem.c","mcmemmatch",64,75
7,1,29,3,6,"mcmemattach@78-84@sys/arch/alpha/mcbus/mcmem.c","sys/arch/alpha/mcbus/mcmem.c","mcmemattach",78,84
12,3,64,3,15,"apecsmatch@108-123@sys/arch/alpha/pci/apecs.c","sys/arch/alpha/pci/apecs.c","apecsmatch",108,123
30,4,195,2,40,"apecs_init@129-169@sys/arch/alpha/pci/apecs.c","sys/arch/alpha/pci/apecs.c","apecs_init",129,169
49,14,295,3,75,"apecsattach@172-247@sys/arch/alpha/pci/apecs.c","sys/arch/alpha/pci/apecs.c","apecsattach",172,247
10,2,54,2,11,"apecsprint@250-261@sys/arch/alpha/pci/apecs.c","sys/arch/alpha/pci/apecs.c","apecsprint",250,261
18,3,80,3,21,"apecs_bus_get_window@265-286@sys/arch/alpha/pci/apecs.c","sys/arch/alpha/pci/apecs.c","apecs_bus_get_window",265,286
68,2,389,1,98,"apecs_dma_init@94-192@sys/arch/alpha/pci/apecs_dma.c","sys/arch/alpha/pci/apecs_dma.c","apecs_dma_init",94,192
15,4,61,2,27,"apecs_dma_get_tag@199-226@sys/arch/alpha/pci/apecs_dma.c","sys/arch/alpha/pci/apecs_dma.c","apecs_dma_get_tag",199,226
15,2,76,6,16,"apecs_bus_dmamap_load_sgmap@232-248@sys/arch/alpha/pci/apecs_dma.c","sys/arch/alpha/pci/apecs_dma.c","apecs_bus_dmamap_load_sgmap",232,248
12,2,61,4,13,"apecs_bus_dmamap_load_mbuf_sgmap@254-267@sys/arch/alpha/pci/apecs_dma.c","sys/arch/alpha/pci/apecs_dma.c","apecs_bus_dmamap_load_mbuf_sgmap",254,267
12,2,61,4,13,"apecs_bus_dmamap_load_uio_sgmap@273-286@sys/arch/alpha/pci/apecs_dma.c","sys/arch/alpha/pci/apecs_dma.c","apecs_bus_dmamap_load_uio_sgmap",273,286
15,2,74,6,16,"apecs_bus_dmamap_load_raw_sgmap@292-308@sys/arch/alpha/pci/apecs_dma.c","sys/arch/alpha/pci/apecs_dma.c","apecs_bus_dmamap_load_raw_sgmap",292,308
8,1,36,2,16,"apecs_bus_dmamap_unload_sgmap@314-330@sys/arch/alpha/pci/apecs_dma.c","sys/arch/alpha/pci/apecs_dma.c","apecs_bus_dmamap_unload_sgmap",314,330
13,1,63,2,13,"apecs_pci_init@56-69@sys/arch/alpha/pci/apecs_pci.c","sys/arch/alpha/pci/apecs_pci.c","apecs_pci_init",56,69
5,1,23,3,4,"apecs_attach_hook@72-76@sys/arch/alpha/pci/apecs_pci.c","sys/arch/alpha/pci/apecs_pci.c","apecs_attach_hook",72,76
6,1,18,2,6,"apecs_bus_maxdevs@79-85@sys/arch/alpha/pci/apecs_pci.c","sys/arch/alpha/pci/apecs_pci.c","apecs_bus_maxdevs",79,85
6,1,45,4,6,"apecs_make_tag@88-94@sys/arch/alpha/pci/apecs_pci.c","sys/arch/alpha/pci/apecs_pci.c","apecs_make_tag",88,94
12,4,85,5,12,"apecs_decompose_tag@97-109@sys/arch/alpha/pci/apecs_pci.c","sys/arch/alpha/pci/apecs_pci.c","apecs_decompose_tag",97,109
4,1,14,2,3,"apecs_conf_size@112-115@sys/arch/alpha/pci/apecs_pci.c","sys/arch/alpha/pci/apecs_pci.c","apecs_conf_size",112,115
37,6,216,3,45,"apecs_conf_read@118-163@sys/arch/alpha/pci/apecs_pci.c","sys/arch/alpha/pci/apecs_pci.c","apecs_conf_read",118,163
38,4,196,4,46,"apecs_conf_write@166-212@sys/arch/alpha/pci/apecs_pci.c","sys/arch/alpha/pci/apecs_pci.c","apecs_conf_write",166,212
12,3,64,3,15,"ciamatch@144-159@sys/arch/alpha/pci/cia.c","sys/arch/alpha/pci/cia.c","ciamatch",144,159
65,18,401,2,101,"cia_init@165-266@sys/arch/alpha/pci/cia.c","sys/arch/alpha/pci/cia.c","cia_init",165,266
88,22,465,3,146,"ciaattach@269-415@sys/arch/alpha/pci/cia.c","sys/arch/alpha/pci/cia.c","ciaattach",269,415
10,2,54,2,11,"ciaprint@418-429@sys/arch/alpha/pci/cia.c","sys/arch/alpha/pci/cia.c","ciaprint",418,429
18,4,88,2,21,"cia_pyxis_intr_enable@432-453@sys/arch/alpha/pci/cia.c","sys/arch/alpha/pci/cia.c","cia_pyxis_intr_enable",432,453
95,6,553,1,147,"cia_dma_init@99-246@sys/arch/alpha/pci/cia_dma.c","sys/arch/alpha/pci/cia_dma.c","cia_dma_init",99,246
15,4,61,2,33,"cia_dma_get_tag@253-286@sys/arch/alpha/pci/cia_dma.c","sys/arch/alpha/pci/cia_dma.c","cia_dma_get_tag",253,286
28,5,144,7,46,"cia_bus_dmamap_create_direct@292-338@sys/arch/alpha/pci/cia_dma.c","sys/arch/alpha/pci/cia_dma.c","cia_bus_dmamap_create_direct",292,338
7,1,26,2,6,"cia_bus_dmamap_destroy_direct@344-350@sys/arch/alpha/pci/cia_dma.c","sys/arch/alpha/pci/cia_dma.c","cia_bus_dmamap_destroy_direct",344,350
15,2,76,6,16,"cia_bus_dmamap_load_sgmap@356-372@sys/arch/alpha/pci/cia_dma.c","sys/arch/alpha/pci/cia_dma.c","cia_bus_dmamap_load_sgmap",356,372
12,2,61,4,13,"cia_bus_dmamap_load_mbuf_sgmap@378-391@sys/arch/alpha/pci/cia_dma.c","sys/arch/alpha/pci/cia_dma.c","cia_bus_dmamap_load_mbuf_sgmap",378,391
12,2,61,4,13,"cia_bus_dmamap_load_uio_sgmap@397-410@sys/arch/alpha/pci/cia_dma.c","sys/arch/alpha/pci/cia_dma.c","cia_bus_dmamap_load_uio_sgmap",397,410
15,2,74,6,16,"cia_bus_dmamap_load_raw_sgmap@416-432@sys/arch/alpha/pci/cia_dma.c","sys/arch/alpha/pci/cia_dma.c","cia_bus_dmamap_load_raw_sgmap",416,432
8,1,36,2,16,"cia_bus_dmamap_unload_sgmap@438-454@sys/arch/alpha/pci/cia_dma.c","sys/arch/alpha/pci/cia_dma.c","cia_bus_dmamap_unload_sgmap",438,454
6,1,20,0,6,"cia_tlb_invalidate@460-466@sys/arch/alpha/pci/cia_dma.c","sys/arch/alpha/pci/cia_dma.c","cia_tlb_invalidate",460,466
20,2,107,0,38,"cia_broken_pyxis_tlb_invalidate@472-510@sys/arch/alpha/pci/cia_dma.c","sys/arch/alpha/pci/cia_dma.c","cia_broken_pyxis_tlb_invalidate",472,510
13,1,63,2,13,"cia_pci_init@54-67@sys/arch/alpha/pci/cia_pci.c","sys/arch/alpha/pci/cia_pci.c","cia_pci_init",54,67
5,1,23,3,4,"cia_attach_hook@70-74@sys/arch/alpha/pci/cia_pci.c","sys/arch/alpha/pci/cia_pci.c","cia_attach_hook",70,74
6,1,18,2,6,"cia_bus_maxdevs@77-83@sys/arch/alpha/pci/cia_pci.c","sys/arch/alpha/pci/cia_pci.c","cia_bus_maxdevs",77,83
6,1,45,4,6,"cia_make_tag@86-92@sys/arch/alpha/pci/cia_pci.c","sys/arch/alpha/pci/cia_pci.c","cia_make_tag",86,92
12,4,85,5,12,"cia_decompose_tag@95-107@sys/arch/alpha/pci/cia_pci.c","sys/arch/alpha/pci/cia_pci.c","cia_decompose_tag",95,107
4,1,14,2,3,"cia_conf_size@110-113@sys/arch/alpha/pci/cia_pci.c","sys/arch/alpha/pci/cia_pci.c","cia_conf_size",110,113
67,11,363,3,95,"cia_conf_read@116-211@sys/arch/alpha/pci/cia_pci.c","sys/arch/alpha/pci/cia_pci.c","cia_conf_read",116,211
50,7,256,4,63,"cia_conf_write@214-277@sys/arch/alpha/pci/cia_pci.c","sys/arch/alpha/pci/cia_pci.c","cia_conf_write",214,277
23,3,155,2,39,"irongate_init@79-118@sys/arch/alpha/pci/irongate.c","sys/arch/alpha/pci/irongate.c","irongate_init",79,118
9,3,58,3,12,"irongate_match@121-133@sys/arch/alpha/pci/irongate.c","sys/arch/alpha/pci/irongate.c","irongate_match",121,133
30,4,185,3,51,"irongate_attach@136-187@sys/arch/alpha/pci/irongate.c","sys/arch/alpha/pci/irongate.c","irongate_attach",136,187
8,2,51,2,9,"irongate_print@190-199@sys/arch/alpha/pci/irongate.c","sys/arch/alpha/pci/irongate.c","irongate_print",190,199
23,4,113,3,28,"irongate_bus_get_window@203-231@sys/arch/alpha/pci/irongate.c","sys/arch/alpha/pci/irongate.c","irongate_bus_get_window",203,231
46,12,261,2,63,"irongate_bus_mem_init2@69-132@sys/arch/alpha/pci/irongate_bus_mem.c","sys/arch/alpha/pci/irongate_bus_mem.c","irongate_bus_mem_init2",69,132
50,2,276,1,64,"irongate_dma_init@76-140@sys/arch/alpha/pci/irongate_dma.c","sys/arch/alpha/pci/irongate_dma.c","irongate_dma_init",76,140
13,4,57,2,21,"irongate_dma_get_tag@147-168@sys/arch/alpha/pci/irongate_dma.c","sys/arch/alpha/pci/irongate_dma.c","irongate_dma_get_tag",147,168
11,1,59,2,11,"irongate_pci_init@70-81@sys/arch/alpha/pci/irongate_pci.c","sys/arch/alpha/pci/irongate_pci.c","irongate_pci_init",70,81
4,1,19,3,3,"irongate_attach_hook@84-87@sys/arch/alpha/pci/irongate_pci.c","sys/arch/alpha/pci/irongate_pci.c","irongate_attach_hook",84,87
4,1,14,2,4,"irongate_bus_maxdevs@90-94@sys/arch/alpha/pci/irongate_pci.c","sys/arch/alpha/pci/irongate_pci.c","irongate_bus_maxdevs",90,94
4,1,39,4,4,"irongate_make_tag@97-101@sys/arch/alpha/pci/irongate_pci.c","sys/arch/alpha/pci/irongate_pci.c","irongate_make_tag",97,101
9,4,77,5,9,"irongate_decompose_tag@104-113@sys/arch/alpha/pci/irongate_pci.c","sys/arch/alpha/pci/irongate_pci.c","irongate_decompose_tag",104,113
4,1,14,2,3,"irongate_conf_size@116-119@sys/arch/alpha/pci/irongate_pci.c","sys/arch/alpha/pci/irongate_pci.c","irongate_conf_size",116,119
8,2,58,3,16,"irongate_conf_read@122-138@sys/arch/alpha/pci/irongate_pci.c","sys/arch/alpha/pci/irongate_pci.c","irongate_conf_read",122,138
13,1,74,3,14,"irongate_conf_read0@141-155@sys/arch/alpha/pci/irongate_pci.c","sys/arch/alpha/pci/irongate_pci.c","irongate_conf_read0",141,155
12,1,73,4,12,"irongate_conf_write@158-170@sys/arch/alpha/pci/irongate_pci.c","sys/arch/alpha/pci/irongate_pci.c","irongate_conf_write",158,170
12,3,64,3,15,"lcamatch@114-129@sys/arch/alpha/pci/lca.c","sys/arch/alpha/pci/lca.c","lcamatch",114,129
25,3,148,2,71,"lca_init@135-206@sys/arch/alpha/pci/lca.c","sys/arch/alpha/pci/lca.c","lca_init",135,206
38,8,201,3,62,"lcaattach@209-271@sys/arch/alpha/pci/lca.c","sys/arch/alpha/pci/lca.c","lcaattach",209,271
10,2,54,2,11,"lcaprint@274-285@sys/arch/alpha/pci/lca.c","sys/arch/alpha/pci/lca.c","lcaprint",274,285
18,3,80,3,21,"lca_bus_get_window@289-310@sys/arch/alpha/pci/lca.c","sys/arch/alpha/pci/lca.c","lca_bus_get_window",289,310
8,1,49,4,9,"lca_machine_check@314-323@sys/arch/alpha/pci/lca.c","sys/arch/alpha/pci/lca.c","lca_machine_check",314,323
71,2,414,1,101,"lca_dma_init@94-195@sys/arch/alpha/pci/lca_dma.c","sys/arch/alpha/pci/lca_dma.c","lca_dma_init",94,195
15,4,61,2,27,"lca_dma_get_tag@202-229@sys/arch/alpha/pci/lca_dma.c","sys/arch/alpha/pci/lca_dma.c","lca_dma_get_tag",202,229
15,2,76,6,16,"lca_bus_dmamap_load_sgmap@235-251@sys/arch/alpha/pci/lca_dma.c","sys/arch/alpha/pci/lca_dma.c","lca_bus_dmamap_load_sgmap",235,251
12,2,61,4,13,"lca_bus_dmamap_load_mbuf_sgmap@257-270@sys/arch/alpha/pci/lca_dma.c","sys/arch/alpha/pci/lca_dma.c","lca_bus_dmamap_load_mbuf_sgmap",257,270
12,2,61,4,13,"lca_bus_dmamap_load_uio_sgmap@276-289@sys/arch/alpha/pci/lca_dma.c","sys/arch/alpha/pci/lca_dma.c","lca_bus_dmamap_load_uio_sgmap",276,289
15,2,74,6,16,"lca_bus_dmamap_load_raw_sgmap@295-311@sys/arch/alpha/pci/lca_dma.c","sys/arch/alpha/pci/lca_dma.c","lca_bus_dmamap_load_raw_sgmap",295,311
8,1,36,2,16,"lca_bus_dmamap_unload_sgmap@317-333@sys/arch/alpha/pci/lca_dma.c","sys/arch/alpha/pci/lca_dma.c","lca_bus_dmamap_unload_sgmap",317,333
13,1,63,2,13,"lca_pci_init@56-69@sys/arch/alpha/pci/lca_pci.c","sys/arch/alpha/pci/lca_pci.c","lca_pci_init",56,69
5,1,23,3,4,"lca_attach_hook@72-76@sys/arch/alpha/pci/lca_pci.c","sys/arch/alpha/pci/lca_pci.c","lca_attach_hook",72,76
9,2,28,2,9,"lca_bus_maxdevs@79-88@sys/arch/alpha/pci/lca_pci.c","sys/arch/alpha/pci/lca_pci.c","lca_bus_maxdevs",79,88
6,1,45,4,6,"lca_make_tag@91-97@sys/arch/alpha/pci/lca_pci.c","sys/arch/alpha/pci/lca_pci.c","lca_make_tag",91,97
12,4,85,5,12,"lca_decompose_tag@100-112@sys/arch/alpha/pci/lca_pci.c","sys/arch/alpha/pci/lca_pci.c","lca_decompose_tag",100,112
4,1,14,2,3,"lca_conf_size@115-118@sys/arch/alpha/pci/lca_pci.c","sys/arch/alpha/pci/lca_pci.c","lca_conf_size",115,118
45,7,275,3,60,"lca_conf_read@121-181@sys/arch/alpha/pci/lca_pci.c","sys/arch/alpha/pci/lca_pci.c","lca_conf_read",121,181
34,4,193,4,47,"lca_conf_write@184-231@sys/arch/alpha/pci/lca_pci.c","sys/arch/alpha/pci/lca_pci.c","lca_conf_write",184,231
10,2,54,2,10,"mcpciaprint@118-128@sys/arch/alpha/pci/mcpcia.c","sys/arch/alpha/pci/mcpcia.c","mcpciaprint",118,128
10,2,48,3,11,"mcpciamatch@131-142@sys/arch/alpha/pci/mcpcia.c","sys/arch/alpha/pci/mcpcia.c","mcpciamatch",131,142
49,5,332,3,75,"mcpciaattach@145-220@sys/arch/alpha/pci/mcpcia.c","sys/arch/alpha/pci/mcpcia.c","mcpciaattach",145,220
18,4,111,0,32,"mcpcia_init@223-255@sys/arch/alpha/pci/mcpcia.c","sys/arch/alpha/pci/mcpcia.c","mcpcia_init",223,255
39,5,262,2,57,"mcpcia_init0@258-315@sys/arch/alpha/pci/mcpcia.c","sys/arch/alpha/pci/mcpcia.c","mcpcia_init0",258,315
20,4,113,0,27,"mcpcia_config_cleanup@318-345@sys/arch/alpha/pci/mcpcia.c","sys/arch/alpha/pci/mcpcia.c","mcpcia_config_cleanup",318,345
110,1,701,1,153,"mcpcia_dma_init@95-248@sys/arch/alpha/pci/mcpcia_dma.c","sys/arch/alpha/pci/mcpcia_dma.c","mcpcia_dma_init",95,248
15,4,61,2,27,"mcpcia_dma_get_tag@255-282@sys/arch/alpha/pci/mcpcia_dma.c","sys/arch/alpha/pci/mcpcia_dma.c","mcpcia_dma_get_tag",255,282
16,2,86,6,16,"mcpcia_bus_dmamap_load_sgmap@288-304@sys/arch/alpha/pci/mcpcia_dma.c","sys/arch/alpha/pci/mcpcia_dma.c","mcpcia_bus_dmamap_load_sgmap",288,304
13,2,71,4,13,"mcpcia_bus_dmamap_load_mbuf_sgmap@310-323@sys/arch/alpha/pci/mcpcia_dma.c","sys/arch/alpha/pci/mcpcia_dma.c","mcpcia_bus_dmamap_load_mbuf_sgmap",310,323
13,2,71,4,13,"mcpcia_bus_dmamap_load_uio_sgmap@329-342@sys/arch/alpha/pci/mcpcia_dma.c","sys/arch/alpha/pci/mcpcia_dma.c","mcpcia_bus_dmamap_load_uio_sgmap",329,342
16,2,84,6,16,"mcpcia_bus_dmamap_load_raw_sgmap@348-364@sys/arch/alpha/pci/mcpcia_dma.c","sys/arch/alpha/pci/mcpcia_dma.c","mcpcia_bus_dmamap_load_raw_sgmap",348,364
9,1,46,2,16,"mcpcia_bus_dmamap_unload_sgmap@370-386@sys/arch/alpha/pci/mcpcia_dma.c","sys/arch/alpha/pci/mcpcia_dma.c","mcpcia_bus_dmamap_unload_sgmap",370,386
13,1,63,2,12,"mcpcia_pci_init@58-70@sys/arch/alpha/pci/mcpcia_pci.c","sys/arch/alpha/pci/mcpcia_pci.c","mcpcia_pci_init",58,70
5,1,23,3,4,"mcpcia_attach_hook@73-77@sys/arch/alpha/pci/mcpcia_pci.c","sys/arch/alpha/pci/mcpcia_pci.c","mcpcia_attach_hook",73,77
6,1,20,2,5,"mcpcia_bus_maxdevs@80-85@sys/arch/alpha/pci/mcpcia_pci.c","sys/arch/alpha/pci/mcpcia_pci.c","mcpcia_bus_maxdevs",80,85
8,1,54,4,7,"mcpcia_make_tag@88-95@sys/arch/alpha/pci/mcpcia_pci.c","sys/arch/alpha/pci/mcpcia_pci.c","mcpcia_make_tag",88,95
12,4,85,5,11,"mcpcia_decompose_tag@98-109@sys/arch/alpha/pci/mcpcia_pci.c","sys/arch/alpha/pci/mcpcia_pci.c","mcpcia_decompose_tag",98,109
4,1,14,2,3,"mcpcia_conf_size@112-115@sys/arch/alpha/pci/mcpcia_pci.c","sys/arch/alpha/pci/mcpcia_pci.c","mcpcia_conf_size",112,115
24,5,168,3,28,"mcpcia_conf_read@118-146@sys/arch/alpha/pci/mcpcia_pci.c","sys/arch/alpha/pci/mcpcia_pci.c","mcpcia_conf_read",118,146
22,4,140,4,27,"mcpcia_conf_write@149-176@sys/arch/alpha/pci/mcpcia_pci.c","sys/arch/alpha/pci/mcpcia_pci.c","mcpcia_conf_write",149,176
26,4,142,4,32,"pci_1000_pickintr@105-137@sys/arch/alpha/pci/pci_1000.c","sys/arch/alpha/pci/pci_1000.c","pci_1000_pickintr",105,137
34,10,184,2,43,"dec_1000_intr_map@140-183@sys/arch/alpha/pci/pci_1000.c","sys/arch/alpha/pci/pci_1000.c","dec_1000_intr_map",140,183
11,2,62,2,12,"dec_1000_intr_string@186-198@sys/arch/alpha/pci/pci_1000.c","sys/arch/alpha/pci/pci_1000.c","dec_1000_intr_string",186,198
7,2,28,2,9,"dec_1000_intr_line@201-210@sys/arch/alpha/pci/pci_1000.c","sys/arch/alpha/pci/pci_1000.c","dec_1000_intr_line",201,210
5,1,34,1,4,"if@229-233@sys/arch/alpha/pci/pci_1000.c","sys/arch/alpha/pci/pci_1000.c","if",229,233
16,2,88,2,18,"dec_1000_intr_disestablish@238-256@sys/arch/alpha/pci/pci_1000.c","sys/arch/alpha/pci/pci_1000.c","dec_1000_intr_disestablish",238,256
14,3,71,2,15,"dec_1000_iointr@259-274@sys/arch/alpha/pci/pci_1000.c","sys/arch/alpha/pci/pci_1000.c","dec_1000_iointr",259,274
5,1,21,1,4,"dec_1000_enable_intr@291-295@sys/arch/alpha/pci/pci_1000.c","sys/arch/alpha/pci/pci_1000.c","dec_1000_enable_intr",291,295
5,1,23,1,4,"dec_1000_disable_intr@298-302@sys/arch/alpha/pci/pci_1000.c","sys/arch/alpha/pci/pci_1000.c","dec_1000_disable_intr",298,302
4,1,10,0,3,"pci_1000_imi@307-310@sys/arch/alpha/pci/pci_1000.c","sys/arch/alpha/pci/pci_1000.c","pci_1000_imi",307,310
26,5,158,4,32,"pci_1000a_pickintr@108-140@sys/arch/alpha/pci/pci_1000a.c","sys/arch/alpha/pci/pci_1000a.c","pci_1000a_pickintr",108,140
64,11,374,2,84,"dec_1000a_intr_map@143-227@sys/arch/alpha/pci/pci_1000a.c","sys/arch/alpha/pci/pci_1000a.c","dec_1000a_intr_map",143,227
11,2,62,2,13,"dec_1000a_intr_string@230-243@sys/arch/alpha/pci/pci_1000a.c","sys/arch/alpha/pci/pci_1000a.c","dec_1000a_intr_string",230,243
7,2,28,2,9,"dec_1000a_intr_line@246-255@sys/arch/alpha/pci/pci_1000a.c","sys/arch/alpha/pci/pci_1000a.c","dec_1000a_intr_line",246,255
5,1,34,1,5,"if@274-279@sys/arch/alpha/pci/pci_1000a.c","sys/arch/alpha/pci/pci_1000a.c","if",274,279
16,2,88,2,18,"dec_1000a_intr_disestablish@284-302@sys/arch/alpha/pci/pci_1000a.c","sys/arch/alpha/pci/pci_1000a.c","dec_1000a_intr_disestablish",284,302
14,3,71,2,15,"dec_1000a_iointr@305-320@sys/arch/alpha/pci/pci_1000a.c","sys/arch/alpha/pci/pci_1000a.c","dec_1000a_iointr",305,320
7,1,43,1,7,"dec_1000a_enable_intr@334-341@sys/arch/alpha/pci/pci_1000a.c","sys/arch/alpha/pci/pci_1000a.c","dec_1000a_enable_intr",334,341
7,1,45,1,7,"dec_1000a_disable_intr@344-351@sys/arch/alpha/pci/pci_1000a.c","sys/arch/alpha/pci/pci_1000a.c","dec_1000a_disable_intr",344,351
5,1,29,0,4,"pci_1000a_imi@356-360@sys/arch/alpha/pci/pci_1000a.c","sys/arch/alpha/pci/pci_1000a.c","pci_1000a_imi",356,360
22,3,133,1,31,"pci_2100_a50_pickintr@65-96@sys/arch/alpha/pci/pci_2100_a50.c","sys/arch/alpha/pci/pci_2100_a50.c","pci_2100_a50_pickintr",65,96
84,21,350,2,93,"dec_2100_a50_intr_map@99-192@sys/arch/alpha/pci/pci_2100_a50.c","sys/arch/alpha/pci/pci_2100_a50.c","dec_2100_a50_intr_map",99,192
6,1,23,2,5,"dec_2100_a50_intr_string@195-200@sys/arch/alpha/pci/pci_2100_a50.c","sys/arch/alpha/pci/pci_2100_a50.c","dec_2100_a50_intr_string",195,200
6,1,23,2,5,"dec_2100_a50_intr_line@203-208@sys/arch/alpha/pci/pci_2100_a50.c","sys/arch/alpha/pci/pci_2100_a50.c","dec_2100_a50_intr_line",203,208
5,1,22,2,4,"dec_2100_a50_intr_disestablish@223-227@sys/arch/alpha/pci/pci_2100_a50.c","sys/arch/alpha/pci/pci_2100_a50.c","dec_2100_a50_intr_disestablish",223,227
27,5,147,1,40,"pci_550_pickintr@126-166@sys/arch/alpha/pci/pci_550.c","sys/arch/alpha/pci/pci_550.c","pci_550_pickintr",126,166
43,15,238,2,70,"dec_550_intr_map@169-239@sys/arch/alpha/pci/pci_550.c","sys/arch/alpha/pci/pci_550.c","dec_550_intr_map",169,239
14,5,79,2,19,"dec_550_intr_string@242-261@sys/arch/alpha/pci/pci_550.c","sys/arch/alpha/pci/pci_550.c","dec_550_intr_string",242,261
8,3,40,2,10,"dec_550_intr_line@264-274@sys/arch/alpha/pci/pci_550.c","sys/arch/alpha/pci/pci_550.c","dec_550_intr_line",264,274
5,1,34,1,4,"if@302-306@sys/arch/alpha/pci/pci_550.c","sys/arch/alpha/pci/pci_550.c","if",302,306
21,4,116,2,32,"dec_550_intr_disestablish@311-343@sys/arch/alpha/pci/pci_550.c","sys/arch/alpha/pci/pci_550.c","dec_550_intr_disestablish",311,343
6,1,23,2,5,"dec_550_pciide_compat_intr_disestablish@375-380@sys/arch/alpha/pci/pci_550.c","sys/arch/alpha/pci/pci_550.c","dec_550_pciide_compat_intr_disestablish",375,380
16,4,84,2,18,"dec_550_iointr@383-401@sys/arch/alpha/pci/pci_550.c","sys/arch/alpha/pci/pci_550.c","dec_550_iointr",383,401
5,1,18,1,5,"dec_550_intr_enable@404-409@sys/arch/alpha/pci/pci_550.c","sys/arch/alpha/pci/pci_550.c","dec_550_intr_enable",404,409
5,1,18,1,5,"dec_550_intr_disable@412-417@sys/arch/alpha/pci/pci_550.c","sys/arch/alpha/pci/pci_550.c","dec_550_intr_disable",412,417
29,5,146,1,37,"pci_6600_pickintr@94-131@sys/arch/alpha/pci/pci_6600.c","sys/arch/alpha/pci/pci_6600.c","pci_6600_pickintr",94,131
27,7,142,2,36,"dec_6600_intr_map@134-170@sys/arch/alpha/pci/pci_6600.c","sys/arch/alpha/pci/pci_6600.c","dec_6600_intr_map",134,170
12,3,69,2,16,"dec_6600_intr_string@173-189@sys/arch/alpha/pci/pci_6600.c","sys/arch/alpha/pci/pci_6600.c","dec_6600_intr_string",173,189
9,3,40,2,12,"dec_6600_intr_line@192-204@sys/arch/alpha/pci/pci_6600.c","sys/arch/alpha/pci/pci_6600.c","dec_6600_intr_line",192,204
5,1,34,1,4,"if@230-234@sys/arch/alpha/pci/pci_6600.c","sys/arch/alpha/pci/pci_6600.c","if",230,234
20,4,109,2,31,"dec_6600_intr_disestablish@239-270@sys/arch/alpha/pci/pci_6600.c","sys/arch/alpha/pci/pci_6600.c","dec_6600_intr_disestablish",239,270
15,4,84,2,17,"dec_6600_iointr@273-290@sys/arch/alpha/pci/pci_6600.c","sys/arch/alpha/pci/pci_6600.c","dec_6600_iointr",273,290
7,1,27,1,6,"dec_6600_intr_enable@293-299@sys/arch/alpha/pci/pci_6600.c","sys/arch/alpha/pci/pci_6600.c","dec_6600_intr_enable",293,299
7,1,29,1,6,"dec_6600_intr_disable@302-308@sys/arch/alpha/pci/pci_6600.c","sys/arch/alpha/pci/pci_6600.c","dec_6600_intr_disable",302,308
6,1,23,2,5,"dec_6600_pciide_compat_intr_disestablish@344-349@sys/arch/alpha/pci/pci_6600.c","sys/arch/alpha/pci/pci_6600.c","dec_6600_pciide_compat_intr_disestablish",344,349
21,3,125,1,30,"pci_alphabook1_pickintr@92-122@sys/arch/alpha/pci/pci_alphabook1.c","sys/arch/alpha/pci/pci_alphabook1.c","pci_alphabook1_pickintr",92,122
25,6,132,2,40,"dec_alphabook1_intr_map@125-165@sys/arch/alpha/pci/pci_alphabook1.c","sys/arch/alpha/pci/pci_alphabook1.c","dec_alphabook1_intr_map",125,165
4,1,19,2,3,"dec_alphabook1_intr_string@168-171@sys/arch/alpha/pci/pci_alphabook1.c","sys/arch/alpha/pci/pci_alphabook1.c","dec_alphabook1_intr_string",168,171
4,1,19,2,3,"dec_alphabook1_intr_line@174-177@sys/arch/alpha/pci/pci_alphabook1.c","sys/arch/alpha/pci/pci_alphabook1.c","dec_alphabook1_intr_line",174,177
6,1,51,6,9,"dec_alphabook1_intr_establish@180-189@sys/arch/alpha/pci/pci_alphabook1.c","sys/arch/alpha/pci/pci_alphabook1.c","dec_alphabook1_intr_establish",180,189
4,1,19,2,3,"dec_alphabook1_intr_disestablish@192-195@sys/arch/alpha/pci/pci_alphabook1.c","sys/arch/alpha/pci/pci_alphabook1.c","dec_alphabook1_intr_disestablish",192,195
23,3,133,1,32,"pci_axppci_33_pickintr@65-97@sys/arch/alpha/pci/pci_axppci_33.c","sys/arch/alpha/pci/pci_axppci_33.c","pci_axppci_33_pickintr",65,97
81,20,332,2,91,"dec_axppci_33_intr_map@100-191@sys/arch/alpha/pci/pci_axppci_33.c","sys/arch/alpha/pci/pci_axppci_33.c","dec_axppci_33_intr_map",100,191
6,1,23,2,5,"dec_axppci_33_intr_string@194-199@sys/arch/alpha/pci/pci_axppci_33.c","sys/arch/alpha/pci/pci_axppci_33.c","dec_axppci_33_intr_string",194,199
6,1,23,2,5,"dec_axppci_33_intr_line@202-207@sys/arch/alpha/pci/pci_axppci_33.c","sys/arch/alpha/pci/pci_axppci_33.c","dec_axppci_33_intr_line",202,207
5,1,22,2,4,"dec_axppci_33_intr_disestablish@222-226@sys/arch/alpha/pci/pci_axppci_33.c","sys/arch/alpha/pci/pci_axppci_33.c","dec_axppci_33_intr_disestablish",222,226
60,1,607,2,97,"__C( CHIP , _bus_io_init)@189-286@sys/arch/alpha/pci/pci_bwx_bus_io_chipdep.c","sys/arch/alpha/pci/pci_bwx_bus_io_chipdep.c","__C( CHIP , _bus_io_init)",189,286
21,6,128,5,31,"__C( CHIP , _io_map)@289-320@sys/arch/alpha/pci/pci_bwx_bus_io_chipdep.c","sys/arch/alpha/pci/pci_bwx_bus_io_chipdep.c","__C( CHIP , _io_map)",289,320
19,6,125,3,27,"__C( CHIP , _io_unmap)@323-350@sys/arch/alpha/pci/pci_bwx_bus_io_chipdep.c","sys/arch/alpha/pci/pci_bwx_bus_io_chipdep.c","__C( CHIP , _io_unmap)",323,350
8,1,40,5,8,"__C( CHIP , _io_subregion)@353-361@sys/arch/alpha/pci/pci_bwx_bus_io_chipdep.c","sys/arch/alpha/pci/pci_bwx_bus_io_chipdep.c","__C( CHIP , _io_subregion)",353,361
10,1,62,9,11,"__C( CHIP , _io_alloc)@364-375@sys/arch/alpha/pci/pci_bwx_bus_io_chipdep.c","sys/arch/alpha/pci/pci_bwx_bus_io_chipdep.c","__C( CHIP , _io_alloc)",364,375
7,1,34,3,8,"__C( CHIP , _io_free)@378-386@sys/arch/alpha/pci/pci_bwx_bus_io_chipdep.c","sys/arch/alpha/pci/pci_bwx_bus_io_chipdep.c","__C( CHIP , _io_free)",378,386
6,1,19,2,9,"__C( CHIP , _io_vaddr)@389-398@sys/arch/alpha/pci/pci_bwx_bus_io_chipdep.c","sys/arch/alpha/pci/pci_bwx_bus_io_chipdep.c","__C( CHIP , _io_vaddr)",389,398
11,3,57,5,11,"__C( CHIP , _io_barrier)@401-412@sys/arch/alpha/pci/pci_bwx_bus_io_chipdep.c","sys/arch/alpha/pci/pci_bwx_bus_io_chipdep.c","__C( CHIP , _io_barrier)",401,412
10,1,44,3,10,"__C( CHIP , _io_read_1)@415-425@sys/arch/alpha/pci/pci_bwx_bus_io_chipdep.c","sys/arch/alpha/pci/pci_bwx_bus_io_chipdep.c","__C( CHIP , _io_read_1)",415,425
13,3,66,3,15,"__C( CHIP , _io_read_2)@428-443@sys/arch/alpha/pci/pci_bwx_bus_io_chipdep.c","sys/arch/alpha/pci/pci_bwx_bus_io_chipdep.c","__C( CHIP , _io_read_2)",428,443
13,3,64,3,15,"__C( CHIP , _io_read_4)@446-461@sys/arch/alpha/pci/pci_bwx_bus_io_chipdep.c","sys/arch/alpha/pci/pci_bwx_bus_io_chipdep.c","__C( CHIP , _io_read_4)",446,461
7,1,34,3,8,"__C( CHIP , _io_read_8)@464-472@sys/arch/alpha/pci/pci_bwx_bus_io_chipdep.c","sys/arch/alpha/pci/pci_bwx_bus_io_chipdep.c","__C( CHIP , _io_read_8)",464,472
11,1,48,4,11,"__C( CHIP , _io_write_1)@514-525@sys/arch/alpha/pci/pci_bwx_bus_io_chipdep.c","sys/arch/alpha/pci/pci_bwx_bus_io_chipdep.c","__C( CHIP , _io_write_1)",514,525
14,3,70,4,16,"__C( CHIP , _io_write_2)@528-544@sys/arch/alpha/pci/pci_bwx_bus_io_chipdep.c","sys/arch/alpha/pci/pci_bwx_bus_io_chipdep.c","__C( CHIP , _io_write_2)",528,544
14,3,68,4,16,"__C( CHIP , _io_write_4)@547-563@sys/arch/alpha/pci/pci_bwx_bus_io_chipdep.c","sys/arch/alpha/pci/pci_bwx_bus_io_chipdep.c","__C( CHIP , _io_write_4)",547,563
9,1,43,4,10,"__C( CHIP , _io_write_8)@566-576@sys/arch/alpha/pci/pci_bwx_bus_io_chipdep.c","sys/arch/alpha/pci/pci_bwx_bus_io_chipdep.c","__C( CHIP , _io_write_8)",566,576
61,1,607,2,98,"__C( CHIP , _bus_mem_init)@197-295@sys/arch/alpha/pci/pci_bwx_bus_mem_chipdep.c","sys/arch/alpha/pci/pci_bwx_bus_mem_chipdep.c","__C( CHIP , _bus_mem_init)",197,295
20,5,117,5,26,"__C( CHIP , _mem_map)@298-324@sys/arch/alpha/pci/pci_bwx_bus_mem_chipdep.c","sys/arch/alpha/pci/pci_bwx_bus_mem_chipdep.c","__C( CHIP , _mem_map)",298,324
19,6,125,3,26,"__C( CHIP , _mem_unmap)@327-353@sys/arch/alpha/pci/pci_bwx_bus_mem_chipdep.c","sys/arch/alpha/pci/pci_bwx_bus_mem_chipdep.c","__C( CHIP , _mem_unmap)",327,353
8,1,40,5,8,"__C( CHIP , _mem_subregion)@356-364@sys/arch/alpha/pci/pci_bwx_bus_mem_chipdep.c","sys/arch/alpha/pci/pci_bwx_bus_mem_chipdep.c","__C( CHIP , _mem_subregion)",356,364
24,6,159,9,36,"__C( CHIP , _mem_alloc)@367-403@sys/arch/alpha/pci/pci_bwx_bus_mem_chipdep.c","sys/arch/alpha/pci/pci_bwx_bus_mem_chipdep.c","__C( CHIP , _mem_alloc)",367,403
7,1,33,3,8,"__C( CHIP , _mem_free)@406-414@sys/arch/alpha/pci/pci_bwx_bus_mem_chipdep.c","sys/arch/alpha/pci/pci_bwx_bus_mem_chipdep.c","__C( CHIP , _mem_free)",406,414
6,1,23,2,6,"__C( CHIP , _mem_vaddr)@417-423@sys/arch/alpha/pci/pci_bwx_bus_mem_chipdep.c","sys/arch/alpha/pci/pci_bwx_bus_mem_chipdep.c","__C( CHIP , _mem_vaddr)",417,423
11,3,57,5,11,"__C( CHIP , _mem_barrier)@426-437@sys/arch/alpha/pci/pci_bwx_bus_mem_chipdep.c","sys/arch/alpha/pci/pci_bwx_bus_mem_chipdep.c","__C( CHIP , _mem_barrier)",426,437
10,1,44,3,10,"__C( CHIP , _mem_read_1)@440-450@sys/arch/alpha/pci/pci_bwx_bus_mem_chipdep.c","sys/arch/alpha/pci/pci_bwx_bus_mem_chipdep.c","__C( CHIP , _mem_read_1)",440,450
13,3,66,3,15,"__C( CHIP , _mem_read_2)@453-468@sys/arch/alpha/pci/pci_bwx_bus_mem_chipdep.c","sys/arch/alpha/pci/pci_bwx_bus_mem_chipdep.c","__C( CHIP , _mem_read_2)",453,468
13,3,64,3,15,"__C( CHIP , _mem_read_4)@471-486@sys/arch/alpha/pci/pci_bwx_bus_mem_chipdep.c","sys/arch/alpha/pci/pci_bwx_bus_mem_chipdep.c","__C( CHIP , _mem_read_4)",471,486
8,1,38,3,10,"__C( CHIP , _mem_read_8)@489-499@sys/arch/alpha/pci/pci_bwx_bus_mem_chipdep.c","sys/arch/alpha/pci/pci_bwx_bus_mem_chipdep.c","__C( CHIP , _mem_read_8)",489,499
11,1,48,4,11,"__C( CHIP , _mem_write_1)@541-552@sys/arch/alpha/pci/pci_bwx_bus_mem_chipdep.c","sys/arch/alpha/pci/pci_bwx_bus_mem_chipdep.c","__C( CHIP , _mem_write_1)",541,552
14,3,70,4,16,"__C( CHIP , _mem_write_2)@555-571@sys/arch/alpha/pci/pci_bwx_bus_mem_chipdep.c","sys/arch/alpha/pci/pci_bwx_bus_mem_chipdep.c","__C( CHIP , _mem_write_2)",555,571
14,3,68,4,16,"__C( CHIP , _mem_write_4)@574-590@sys/arch/alpha/pci/pci_bwx_bus_mem_chipdep.c","sys/arch/alpha/pci/pci_bwx_bus_mem_chipdep.c","__C( CHIP , _mem_write_4)",574,590
9,1,43,4,10,"__C( CHIP , _mem_write_8)@593-603@sys/arch/alpha/pci/pci_bwx_bus_mem_chipdep.c","sys/arch/alpha/pci/pci_bwx_bus_mem_chipdep.c","__C( CHIP , _mem_write_8)",593,603
30,6,176,1,41,"pci_eb164_pickintr@113-154@sys/arch/alpha/pci/pci_eb164.c","sys/arch/alpha/pci/pci_eb164.c","pci_eb164_pickintr",113,154
40,15,216,2,59,"dec_eb164_intr_map@157-216@sys/arch/alpha/pci/pci_eb164.c","sys/arch/alpha/pci/pci_eb164.c","dec_eb164_intr_map",157,216
11,3,59,2,13,"dec_eb164_intr_string@219-232@sys/arch/alpha/pci/pci_eb164.c","sys/arch/alpha/pci/pci_eb164.c","dec_eb164_intr_string",219,232
6,1,20,2,5,"dec_eb164_intr_line@235-240@sys/arch/alpha/pci/pci_eb164.c","sys/arch/alpha/pci/pci_eb164.c","dec_eb164_intr_line",235,240
5,1,34,1,4,"if@261-265@sys/arch/alpha/pci/pci_eb164.c","sys/arch/alpha/pci/pci_eb164.c","if",261,265
17,3,95,2,21,"dec_eb164_intr_disestablish@270-291@sys/arch/alpha/pci/pci_eb164.c","sys/arch/alpha/pci/pci_eb164.c","dec_eb164_intr_disestablish",270,291
4,1,19,2,3,"dec_eb164_pciide_compat_intr_disestablish@325-328@sys/arch/alpha/pci/pci_eb164.c","sys/arch/alpha/pci/pci_eb164.c","dec_eb164_pciide_compat_intr_disestablish",325,328
14,3,71,2,15,"eb164_iointr@331-346@sys/arch/alpha/pci/pci_eb164.c","sys/arch/alpha/pci/pci_eb164.c","eb164_iointr",331,346
9,2,63,1,12,"eb164_intr_enable@352-364@sys/arch/alpha/pci/pci_eb164.c","sys/arch/alpha/pci/pci_eb164.c","eb164_intr_enable",352,364
9,2,63,1,12,"eb164_intr_disable@367-379@sys/arch/alpha/pci/pci_eb164.c","sys/arch/alpha/pci/pci_eb164.c","eb164_intr_disable",367,379
25,5,149,1,32,"pci_eb64plus_pickintr@106-138@sys/arch/alpha/pci/pci_eb64plus.c","sys/arch/alpha/pci/pci_eb64plus.c","pci_eb64plus_pickintr",106,138
19,5,100,2,25,"dec_eb64plus_intr_map@141-166@sys/arch/alpha/pci/pci_eb64plus.c","sys/arch/alpha/pci/pci_eb64plus.c","dec_eb64plus_intr_map",141,166
10,2,52,2,10,"dec_eb64plus_intr_string@169-179@sys/arch/alpha/pci/pci_eb64plus.c","sys/arch/alpha/pci/pci_eb64plus.c","dec_eb64plus_intr_string",169,179
5,1,34,1,4,"if@199-203@sys/arch/alpha/pci/pci_eb64plus.c","sys/arch/alpha/pci/pci_eb64plus.c","if",199,203
16,2,88,2,18,"dec_eb64plus_intr_disestablish@208-226@sys/arch/alpha/pci/pci_eb64plus.c","sys/arch/alpha/pci/pci_eb64plus.c","dec_eb64plus_intr_disestablish",208,226
14,3,71,2,15,"eb64plus_iointr@229-244@sys/arch/alpha/pci/pci_eb64plus.c","sys/arch/alpha/pci/pci_eb64plus.c","eb64plus_iointr",229,244
9,2,63,1,12,"eb64plus_intr_enable@250-262@sys/arch/alpha/pci/pci_eb64plus.c","sys/arch/alpha/pci/pci_eb64plus.c","eb64plus_intr_enable",250,262
9,2,63,1,12,"eb64plus_intr_disable@265-277@sys/arch/alpha/pci/pci_eb64plus.c","sys/arch/alpha/pci/pci_eb64plus.c","eb64plus_intr_disable",265,277
21,3,119,1,27,"pci_kn20aa_pickintr@76-103@sys/arch/alpha/pci/pci_kn20aa.c","sys/arch/alpha/pci/pci_kn20aa.c","pci_kn20aa_pickintr",76,103
51,11,248,2,68,"dec_kn20aa_intr_map@106-174@sys/arch/alpha/pci/pci_kn20aa.c","sys/arch/alpha/pci/pci_kn20aa.c","dec_kn20aa_intr_map",106,174
10,2,52,2,11,"dec_kn20aa_intr_string@177-188@sys/arch/alpha/pci/pci_kn20aa.c","sys/arch/alpha/pci/pci_kn20aa.c","dec_kn20aa_intr_string",177,188
6,1,20,2,5,"dec_kn20aa_intr_line@191-196@sys/arch/alpha/pci/pci_kn20aa.c","sys/arch/alpha/pci/pci_kn20aa.c","dec_kn20aa_intr_line",191,196
5,1,34,1,4,"if@215-219@sys/arch/alpha/pci/pci_kn20aa.c","sys/arch/alpha/pci/pci_kn20aa.c","if",215,219
16,2,88,2,17,"dec_kn20aa_intr_disestablish@224-241@sys/arch/alpha/pci/pci_kn20aa.c","sys/arch/alpha/pci/pci_kn20aa.c","dec_kn20aa_intr_disestablish",224,241
14,3,71,2,15,"kn20aa_iointr@244-259@sys/arch/alpha/pci/pci_kn20aa.c","sys/arch/alpha/pci/pci_kn20aa.c","kn20aa_iointr",244,259
7,1,31,1,13,"kn20aa_enable_intr@262-275@sys/arch/alpha/pci/pci_kn20aa.c","sys/arch/alpha/pci/pci_kn20aa.c","kn20aa_enable_intr",262,275
7,1,31,1,7,"kn20aa_disable_intr@278-285@sys/arch/alpha/pci/pci_kn20aa.c","sys/arch/alpha/pci/pci_kn20aa.c","kn20aa_disable_intr",278,285
25,5,147,2,32,"pci_kn300_pickintr@83-115@sys/arch/alpha/pci/pci_kn300.c","sys/arch/alpha/pci/pci_kn300.c","pci_kn300_pickintr",83,115
37,7,255,2,57,"dec_kn300_intr_map@118-175@sys/arch/alpha/pci/pci_kn300.c","sys/arch/alpha/pci/pci_kn300.c","dec_kn300_intr_map",118,175
12,2,61,2,14,"dec_kn300_intr_string@178-192@sys/arch/alpha/pci/pci_kn300.c","sys/arch/alpha/pci/pci_kn300.c","dec_kn300_intr_string",178,192
9,1,66,1,8,"if@213-221@sys/arch/alpha/pci/pci_kn300.c","sys/arch/alpha/pci/pci_kn300.c","if",213,221
5,1,20,2,4,"dec_kn300_intr_disestablish@226-230@sys/arch/alpha/pci/pci_kn300.c","sys/arch/alpha/pci/pci_kn300.c","dec_kn300_intr_disestablish",226,230
23,6,131,2,44,"kn300_iointr@233-277@sys/arch/alpha/pci/pci_kn300.c","sys/arch/alpha/pci/pci_kn300.c","kn300_iointr",233,277
8,1,39,2,7,"kn300_enable_intr@280-287@sys/arch/alpha/pci/pci_kn300.c","sys/arch/alpha/pci/pci_kn300.c","kn300_enable_intr",280,287
8,1,39,2,7,"kn300_disable_intr@290-297@sys/arch/alpha/pci/pci_kn300.c","sys/arch/alpha/pci/pci_kn300.c","kn300_disable_intr",290,297
35,9,212,6,44,"pci_display_console@64-108@sys/arch/alpha/pci/pci_machdep.c","sys/arch/alpha/pci/pci_machdep.c","pci_display_console",64,108
29,9,171,4,31,"alpha_sysctl_chipset@111-142@sys/arch/alpha/pci/pci_machdep.c","sys/arch/alpha/pci/pci_machdep.c","alpha_sysctl_chipset",111,142
8,4,61,2,9,"pci_intr_map@145-154@sys/arch/alpha/pci/pci_machdep.c","sys/arch/alpha/pci/pci_machdep.c","pci_intr_map",145,154
21,10,141,3,24,"siomatch@105-129@sys/arch/alpha/pci/sio.c","sys/arch/alpha/pci/sio.c","siomatch",105,129
11,3,60,3,12,"pcebmatch@132-144@sys/arch/alpha/pci/sio.c","sys/arch/alpha/pci/sio.c","pcebmatch",132,144
14,2,101,3,16,"sioattach@147-163@sys/arch/alpha/pci/sio.c","sys/arch/alpha/pci/sio.c","sioattach",147,163
14,2,59,2,14,"sioactivate@166-180@sys/arch/alpha/pci/sio.c","sys/arch/alpha/pci/sio.c","sioactivate",166,180
35,3,277,1,40,"sio_bridge_callback@183-223@sys/arch/alpha/pci/sio.c","sys/arch/alpha/pci/sio.c","sio_bridge_callback",183,223
9,2,45,2,9,"sioprint@226-235@sys/arch/alpha/pci/sio.c","sys/arch/alpha/pci/sio.c","sioprint",226,235
5,1,23,3,5,"sio_isa_attach_hook@238-243@sys/arch/alpha/pci/sio.c","sys/arch/alpha/pci/sio.c","sio_isa_attach_hook",238,243
6,2,30,3,7,"sio_eisa_attach_hook@246-253@sys/arch/alpha/pci/sio.c","sys/arch/alpha/pci/sio.c","sio_eisa_attach_hook",246,253
17,3,70,3,20,"sio_eisa_intr_map@256-276@sys/arch/alpha/pci/sio.c","sys/arch/alpha/pci/sio.c","sio_eisa_intr_map",256,276
70,6,699,2,120,"__C( CHIP , _bus_io_init)@187-307@sys/arch/alpha/pci/pci_swiz_bus_io_chipdep.c","sys/arch/alpha/pci/pci_swiz_bus_io_chipdep.c","__C( CHIP , _bus_io_init)",187,307
43,15,293,5,63,"__C( CHIP , _io_map)@310-373@sys/arch/alpha/pci/pci_swiz_bus_io_chipdep.c","sys/arch/alpha/pci/pci_swiz_bus_io_chipdep.c","__C( CHIP , _io_map)",310,373
40,14,305,3,57,"__C( CHIP , _io_unmap)@376-433@sys/arch/alpha/pci/pci_swiz_bus_io_chipdep.c","sys/arch/alpha/pci/pci_swiz_bus_io_chipdep.c","__C( CHIP , _io_unmap)",376,433
8,1,40,5,8,"__C( CHIP , _io_subregion)@436-444@sys/arch/alpha/pci/pci_swiz_bus_io_chipdep.c","sys/arch/alpha/pci/pci_swiz_bus_io_chipdep.c","__C( CHIP , _io_subregion)",436,444
10,1,62,9,11,"__C( CHIP , _io_alloc)@447-458@sys/arch/alpha/pci/pci_swiz_bus_io_chipdep.c","sys/arch/alpha/pci/pci_swiz_bus_io_chipdep.c","__C( CHIP , _io_alloc)",447,458
7,1,34,3,8,"__C( CHIP , _io_free)@461-469@sys/arch/alpha/pci/pci_swiz_bus_io_chipdep.c","sys/arch/alpha/pci/pci_swiz_bus_io_chipdep.c","__C( CHIP , _io_free)",461,469
6,1,19,2,9,"__C( CHIP , _io_vaddr)@472-481@sys/arch/alpha/pci/pci_swiz_bus_io_chipdep.c","sys/arch/alpha/pci/pci_swiz_bus_io_chipdep.c","__C( CHIP , _io_vaddr)",472,481
11,3,57,5,11,"__C( CHIP , _io_barrier)@484-495@sys/arch/alpha/pci/pci_swiz_bus_io_chipdep.c","sys/arch/alpha/pci/pci_swiz_bus_io_chipdep.c","__C( CHIP , _io_barrier)",484,495
17,1,101,3,19,"__C( CHIP , _io_read_1)@498-517@sys/arch/alpha/pci/pci_swiz_bus_io_chipdep.c","sys/arch/alpha/pci/pci_swiz_bus_io_chipdep.c","__C( CHIP , _io_read_1)",498,517
17,1,101,3,19,"__C( CHIP , _io_read_2)@520-539@sys/arch/alpha/pci/pci_swiz_bus_io_chipdep.c","sys/arch/alpha/pci/pci_swiz_bus_io_chipdep.c","__C( CHIP , _io_read_2)",520,539
18,2,105,3,23,"__C( CHIP , _io_read_4)@542-565@sys/arch/alpha/pci/pci_swiz_bus_io_chipdep.c","sys/arch/alpha/pci/pci_swiz_bus_io_chipdep.c","__C( CHIP , _io_read_4)",542,565
7,1,34,3,8,"__C( CHIP , _io_read_8)@568-576@sys/arch/alpha/pci/pci_swiz_bus_io_chipdep.c","sys/arch/alpha/pci/pci_swiz_bus_io_chipdep.c","__C( CHIP , _io_read_8)",568,576
16,1,93,4,16,"__C( CHIP , _io_write_1)@618-634@sys/arch/alpha/pci/pci_swiz_bus_io_chipdep.c","sys/arch/alpha/pci/pci_swiz_bus_io_chipdep.c","__C( CHIP , _io_write_1)",618,634
16,1,93,4,16,"__C( CHIP , _io_write_2)@637-653@sys/arch/alpha/pci/pci_swiz_bus_io_chipdep.c","sys/arch/alpha/pci/pci_swiz_bus_io_chipdep.c","__C( CHIP , _io_write_2)",637,653
16,1,86,4,16,"__C( CHIP , _io_write_4)@656-672@sys/arch/alpha/pci/pci_swiz_bus_io_chipdep.c","sys/arch/alpha/pci/pci_swiz_bus_io_chipdep.c","__C( CHIP , _io_write_4)",656,672
9,1,43,4,10,"__C( CHIP , _io_write_8)@675-685@sys/arch/alpha/pci/pci_swiz_bus_io_chipdep.c","sys/arch/alpha/pci/pci_swiz_bus_io_chipdep.c","__C( CHIP , _io_write_8)",675,685
101,16,911,2,167,"__C( CHIP , _bus_mem_init)@197-364@sys/arch/alpha/pci/pci_swiz_bus_mem_chipdep.c","sys/arch/alpha/pci/pci_swiz_bus_mem_chipdep.c","__C( CHIP , _bus_mem_init)",197,364
13,4,69,3,14,"__C( CHIP , _xlate_addr_to_dense_handle)@376-390@sys/arch/alpha/pci/pci_swiz_bus_mem_chipdep.c","sys/arch/alpha/pci/pci_swiz_bus_mem_chipdep.c","__C( CHIP , _xlate_addr_to_dense_handle)",376,390
14,4,73,3,17,"__C( CHIP , _xlate_dense_handle_to_addr)@393-410@sys/arch/alpha/pci/pci_swiz_bus_mem_chipdep.c","sys/arch/alpha/pci/pci_swiz_bus_mem_chipdep.c","__C( CHIP , _xlate_dense_handle_to_addr)",393,410
28,10,172,3,34,"__C( CHIP , _xlate_addr_to_sparse_handle)@413-447@sys/arch/alpha/pci/pci_swiz_bus_mem_chipdep.c","sys/arch/alpha/pci/pci_swiz_bus_mem_chipdep.c","__C( CHIP , _xlate_addr_to_sparse_handle)",413,447
26,10,206,3,33,"__C( CHIP , _xlate_sparse_handle_to_addr)@450-483@sys/arch/alpha/pci/pci_swiz_bus_mem_chipdep.c","sys/arch/alpha/pci/pci_swiz_bus_mem_chipdep.c","__C( CHIP , _xlate_sparse_handle_to_addr)",450,483
78,38,613,5,115,"__C( CHIP , _mem_map)@486-601@sys/arch/alpha/pci/pci_swiz_bus_mem_chipdep.c","sys/arch/alpha/pci/pci_swiz_bus_mem_chipdep.c","__C( CHIP , _mem_map)",486,601
42,16,300,3,63,"__C( CHIP , _mem_unmap)@604-667@sys/arch/alpha/pci/pci_swiz_bus_mem_chipdep.c","sys/arch/alpha/pci/pci_swiz_bus_mem_chipdep.c","__C( CHIP , _mem_unmap)",604,667
8,1,40,5,8,"__C( CHIP , _mem_subregion)@670-678@sys/arch/alpha/pci/pci_swiz_bus_mem_chipdep.c","sys/arch/alpha/pci/pci_swiz_bus_mem_chipdep.c","__C( CHIP , _mem_subregion)",670,678
10,1,62,9,11,"__C( CHIP , _mem_alloc)@681-692@sys/arch/alpha/pci/pci_swiz_bus_mem_chipdep.c","sys/arch/alpha/pci/pci_swiz_bus_mem_chipdep.c","__C( CHIP , _mem_alloc)",681,692
7,1,34,3,8,"__C( CHIP , _mem_free)@695-703@sys/arch/alpha/pci/pci_swiz_bus_mem_chipdep.c","sys/arch/alpha/pci/pci_swiz_bus_mem_chipdep.c","__C( CHIP , _mem_free)",695,703
8,2,39,2,12,"__C( CHIP , _mem_vaddr)@706-718@sys/arch/alpha/pci/pci_swiz_bus_mem_chipdep.c","sys/arch/alpha/pci/pci_swiz_bus_mem_chipdep.c","__C( CHIP , _mem_vaddr)",706,718
11,3,57,5,11,"__C( CHIP , _mem_barrier)@721-732@sys/arch/alpha/pci/pci_swiz_bus_mem_chipdep.c","sys/arch/alpha/pci/pci_swiz_bus_mem_chipdep.c","__C( CHIP , _mem_barrier)",721,732
19,2,126,3,22,"__C( CHIP , _mem_read_1)@735-757@sys/arch/alpha/pci/pci_swiz_bus_mem_chipdep.c","sys/arch/alpha/pci/pci_swiz_bus_mem_chipdep.c","__C( CHIP , _mem_read_1)",735,757
19,2,126,3,22,"__C( CHIP , _mem_read_2)@760-782@sys/arch/alpha/pci/pci_swiz_bus_mem_chipdep.c","sys/arch/alpha/pci/pci_swiz_bus_mem_chipdep.c","__C( CHIP , _mem_read_2)",760,782
20,3,130,3,26,"__C( CHIP , _mem_read_4)@785-811@sys/arch/alpha/pci/pci_swiz_bus_mem_chipdep.c","sys/arch/alpha/pci/pci_swiz_bus_mem_chipdep.c","__C( CHIP , _mem_read_4)",785,811
10,2,63,3,13,"__C( CHIP , _mem_read_8)@814-827@sys/arch/alpha/pci/pci_swiz_bus_mem_chipdep.c","sys/arch/alpha/pci/pci_swiz_bus_mem_chipdep.c","__C( CHIP , _mem_read_8)",814,827
20,2,122,4,20,"__C( CHIP , _mem_write_1)@869-889@sys/arch/alpha/pci/pci_swiz_bus_mem_chipdep.c","sys/arch/alpha/pci/pci_swiz_bus_mem_chipdep.c","__C( CHIP , _mem_write_1)",869,889
20,2,122,4,20,"__C( CHIP , _mem_write_2)@892-912@sys/arch/alpha/pci/pci_swiz_bus_mem_chipdep.c","sys/arch/alpha/pci/pci_swiz_bus_mem_chipdep.c","__C( CHIP , _mem_write_2)",892,912
20,2,115,4,20,"__C( CHIP , _mem_write_4)@915-935@sys/arch/alpha/pci/pci_swiz_bus_mem_chipdep.c","sys/arch/alpha/pci/pci_swiz_bus_mem_chipdep.c","__C( CHIP , _mem_write_4)",915,935
14,2,72,4,15,"__C( CHIP , _mem_write_8)@938-953@sys/arch/alpha/pci/pci_swiz_bus_mem_chipdep.c","sys/arch/alpha/pci/pci_swiz_bus_mem_chipdep.c","__C( CHIP , _mem_write_8)",938,953
17,2,85,1,22,"pci_up1000_pickintr@72-94@sys/arch/alpha/pci/pci_up1000.c","sys/arch/alpha/pci/pci_up1000.c","pci_up1000_pickintr",72,94
21,7,113,2,30,"api_up1000_intr_map@97-127@sys/arch/alpha/pci/pci_up1000.c","sys/arch/alpha/pci/pci_up1000.c","api_up1000_intr_map",97,127
5,2,26,2,7,"api_up1000_intr_string@130-137@sys/arch/alpha/pci/pci_up1000.c","sys/arch/alpha/pci/pci_up1000.c","api_up1000_intr_string",130,137
4,1,19,2,3,"api_up1000_intr_line@140-143@sys/arch/alpha/pci/pci_up1000.c","sys/arch/alpha/pci/pci_up1000.c","api_up1000_intr_line",140,143
7,2,58,6,9,"api_up1000_intr_establish@146-155@sys/arch/alpha/pci/pci_up1000.c","sys/arch/alpha/pci/pci_up1000.c","api_up1000_intr_establish",146,155
5,2,26,2,7,"api_up1000_intr_disestablish@158-165@sys/arch/alpha/pci/pci_up1000.c","sys/arch/alpha/pci/pci_up1000.c","api_up1000_intr_disestablish",158,165
16,4,124,6,23,"api_up1000_pciide_compat_intr_establish@168-191@sys/arch/alpha/pci/pci_up1000.c","sys/arch/alpha/pci/pci_up1000.c","api_up1000_pciide_compat_intr_establish",168,191
4,1,19,2,3,"api_up1000_pciide_compat_intr_disestablish@194-197@sys/arch/alpha/pci/pci_up1000.c","sys/arch/alpha/pci/pci_up1000.c","api_up1000_pciide_compat_intr_disestablish",194,197
6,1,22,2,5,"pciide_machdep_compat_intr_disestablish@71-76@sys/arch/alpha/pci/pciide_machdep.c","sys/arch/alpha/pci/pciide_machdep.c","pciide_machdep_compat_intr_disestablish",71,76
22,4,136,0,39,"i82378_setup_elcr@146-185@sys/arch/alpha/pci/sio_pic.c","sys/arch/alpha/pci/sio_pic.c","i82378_setup_elcr",146,185
5,1,21,1,5,"i82378_read_elcr@188-193@sys/arch/alpha/pci/sio_pic.c","sys/arch/alpha/pci/sio_pic.c","i82378_read_elcr",188,193
6,1,25,2,6,"i82378_write_elcr@196-202@sys/arch/alpha/pci/sio_pic.c","sys/arch/alpha/pci/sio_pic.c","i82378_write_elcr",196,202
19,3,102,0,37,"cy82c693_setup_elcr@213-250@sys/arch/alpha/pci/sio_pic.c","sys/arch/alpha/pci/sio_pic.c","cy82c693_setup_elcr",213,250
5,1,21,1,5,"cy82c693_read_elcr@253-258@sys/arch/alpha/pci/sio_pic.c","sys/arch/alpha/pci/sio_pic.c","cy82c693_read_elcr",253,258
6,1,25,2,6,"cy82c693_write_elcr@261-267@sys/arch/alpha/pci/sio_pic.c","sys/arch/alpha/pci/sio_pic.c","cy82c693_write_elcr",261,267
31,6,259,3,52,"sio_setirqstat@287-339@sys/arch/alpha/pci/sio_pic.c","sys/arch/alpha/pci/sio_pic.c","sio_setirqstat",287,339
51,16,313,2,80,"sio_intr_setup@342-422@sys/arch/alpha/pci/sio_pic.c","sys/arch/alpha/pci/sio_pic.c","sio_intr_setup",342,422
9,3,67,0,14,"sio_intr_shutdown@425-439@sys/arch/alpha/pci/sio_pic.c","sys/arch/alpha/pci/sio_pic.c","sio_intr_shutdown",425,439
10,4,60,2,11,"sio_intr_string@442-453@sys/arch/alpha/pci/sio_pic.c","sys/arch/alpha/pci/sio_pic.c","sio_intr_string",442,453
6,1,20,2,5,"sio_intr_line@456-461@sys/arch/alpha/pci/sio_pic.c","sys/arch/alpha/pci/sio_pic.c","sio_intr_line",456,461
6,1,43,1,5,"if@488-493@sys/arch/alpha/pci/sio_pic.c","sys/arch/alpha/pci/sio_pic.c","if",488,493
27,7,132,2,49,"sio_intr_disestablish@499-548@sys/arch/alpha/pci/sio_pic.c","sys/arch/alpha/pci/sio_pic.c","sio_intr_disestablish",499,548
14,5,77,2,25,"sio_iointr@551-576@sys/arch/alpha/pci/sio_pic.c","sys/arch/alpha/pci/sio_pic.c","sio_iointr",551,576
44,14,308,4,73,"sio_intr_alloc@581-654@sys/arch/alpha/pci/sio_pic.c","sys/arch/alpha/pci/sio_pic.c","sio_intr_alloc",581,654
19,11,101,3,25,"sio_intr_check@663-688@sys/arch/alpha/pci/sio_pic.c","sys/arch/alpha/pci/sio_pic.c","sio_intr_check",663,688
10,2,51,1,9,"specific_eoi@691-700@sys/arch/alpha/pci/sio_pic.c","sys/arch/alpha/pci/sio_pic.c","specific_eoi",691,700
14,4,64,3,14,"tscmatch@97-111@sys/arch/alpha/pci/tsc.c","sys/arch/alpha/pci/tsc.c","tscmatch",97,111
44,9,336,3,49,"tscattach@114-163@sys/arch/alpha/pci/tsc.c","sys/arch/alpha/pci/tsc.c","tscattach",114,163
11,3,59,2,11,"tscprint@166-177@sys/arch/alpha/pci/tsc.c","sys/arch/alpha/pci/tsc.c","tscprint",166,177
14,3,61,3,14,"tspmatch@182-196@sys/arch/alpha/pci/tsc.c","sys/arch/alpha/pci/tsc.c","tspmatch",182,196
25,2,166,3,36,"tspattach@199-235@sys/arch/alpha/pci/tsc.c","sys/arch/alpha/pci/tsc.c","tspattach",199,235
45,7,298,2,51,"tsp_init@238-289@sys/arch/alpha/pci/tsc.c","sys/arch/alpha/pci/tsc.c","tsp_init",238,289
10,2,52,2,10,"tspprint@292-302@sys/arch/alpha/pci/tsc.c","sys/arch/alpha/pci/tsc.c","tspprint",292,302
24,4,121,3,29,"tsp_bus_get_window@306-335@sys/arch/alpha/pci/tsc.c","sys/arch/alpha/pci/tsc.c","tsp_bus_get_window",306,335
5,1,43,3,5,"tsciic_match@95-100@sys/arch/alpha/pci/tsciic.c","sys/arch/alpha/pci/tsciic.c","tsciic_match",95,100
19,1,149,3,21,"tsciic_attach@103-124@sys/arch/alpha/pci/tsciic.c","sys/arch/alpha/pci/tsciic.c","tsciic_attach",103,124
7,3,44,2,8,"tsciic_acquire_bus@127-135@sys/arch/alpha/pci/tsciic.c","sys/arch/alpha/pci/tsciic.c","tsciic_acquire_bus",127,135
7,3,38,2,8,"tsciic_release_bus@138-146@sys/arch/alpha/pci/tsciic.c","sys/arch/alpha/pci/tsciic.c","tsciic_release_bus",138,146
4,1,22,2,3,"tsciic_send_start@149-152@sys/arch/alpha/pci/tsciic.c","sys/arch/alpha/pci/tsciic.c","tsciic_send_start",149,152
4,1,22,2,3,"tsciic_send_stop@155-158@sys/arch/alpha/pci/tsciic.c","sys/arch/alpha/pci/tsciic.c","tsciic_send_stop",155,158
4,1,27,3,3,"tsciic_initiate_xfer@161-164@sys/arch/alpha/pci/tsciic.c","sys/arch/alpha/pci/tsciic.c","tsciic_initiate_xfer",161,164
4,1,28,3,3,"tsciic_read_byte@167-170@sys/arch/alpha/pci/tsciic.c","sys/arch/alpha/pci/tsciic.c","tsciic_read_byte",167,170
4,1,27,3,3,"tsciic_write_byte@173-176@sys/arch/alpha/pci/tsciic.c","sys/arch/alpha/pci/tsciic.c","tsciic_write_byte",173,176
9,3,51,2,9,"tsciicbb_set_bits@180-189@sys/arch/alpha/pci/tsciic.c","sys/arch/alpha/pci/tsciic.c","tsciicbb_set_bits",180,189
3,1,11,2,3,"tsciicbb_set_dir@192-195@sys/arch/alpha/pci/tsciic.c","sys/arch/alpha/pci/tsciic.c","tsciicbb_set_dir",192,195
9,3,46,1,9,"tsciicbb_read@198-207@sys/arch/alpha/pci/tsciic.c","sys/arch/alpha/pci/tsciic.c","tsciicbb_read",198,207
23,5,168,1,28,"tsp_bus_mem_init2@71-99@sys/arch/alpha/pci/tsp_bus_mem.c","sys/arch/alpha/pci/tsp_bus_mem.c","tsp_bus_mem_init2",71,99
93,13,740,2,126,"tsp_dma_init@102-228@sys/arch/alpha/pci/tsp_dma.c","sys/arch/alpha/pci/tsp_dma.c","tsp_dma_init",102,228
15,4,61,2,27,"tsp_dma_get_tag@235-262@sys/arch/alpha/pci/tsp_dma.c","sys/arch/alpha/pci/tsp_dma.c","tsp_dma_get_tag",235,262
15,2,79,6,16,"tsp_bus_dmamap_load_sgmap@268-284@sys/arch/alpha/pci/tsp_dma.c","sys/arch/alpha/pci/tsp_dma.c","tsp_bus_dmamap_load_sgmap",268,284
12,2,64,4,13,"tsp_bus_dmamap_load_mbuf_sgmap@290-303@sys/arch/alpha/pci/tsp_dma.c","sys/arch/alpha/pci/tsp_dma.c","tsp_bus_dmamap_load_mbuf_sgmap",290,303
12,2,64,4,13,"tsp_bus_dmamap_load_uio_sgmap@309-322@sys/arch/alpha/pci/tsp_dma.c","sys/arch/alpha/pci/tsp_dma.c","tsp_bus_dmamap_load_uio_sgmap",309,322
15,2,77,6,16,"tsp_bus_dmamap_load_raw_sgmap@328-344@sys/arch/alpha/pci/tsp_dma.c","sys/arch/alpha/pci/tsp_dma.c","tsp_bus_dmamap_load_raw_sgmap",328,344
8,1,39,2,16,"tsp_bus_dmamap_unload_sgmap@350-366@sys/arch/alpha/pci/tsp_dma.c","sys/arch/alpha/pci/tsp_dma.c","tsp_bus_dmamap_unload_sgmap",350,366
7,1,26,1,7,"tsp_tlb_invalidate@372-379@sys/arch/alpha/pci/tsp_dma.c","sys/arch/alpha/pci/tsp_dma.c","tsp_tlb_invalidate",372,379
13,1,63,2,12,"tsp_pci_init@64-76@sys/arch/alpha/pci/tsp_pci.c","sys/arch/alpha/pci/tsp_pci.c","tsp_pci_init",64,76
5,1,23,3,4,"tsp_attach_hook@79-83@sys/arch/alpha/pci/tsp_pci.c","sys/arch/alpha/pci/tsp_pci.c","tsp_attach_hook",79,83
6,1,18,2,5,"tsp_bus_maxdevs@86-91@sys/arch/alpha/pci/tsp_pci.c","sys/arch/alpha/pci/tsp_pci.c","tsp_bus_maxdevs",86,91
6,1,39,4,5,"tsp_make_tag@94-99@sys/arch/alpha/pci/tsp_pci.c","sys/arch/alpha/pci/tsp_pci.c","tsp_make_tag",94,99
12,4,85,5,11,"tsp_decompose_tag@102-113@sys/arch/alpha/pci/tsp_pci.c","sys/arch/alpha/pci/tsp_pci.c","tsp_decompose_tag",102,113
4,1,14,2,3,"tsp_conf_size@116-119@sys/arch/alpha/pci/tsp_pci.c","sys/arch/alpha/pci/tsp_pci.c","tsp_conf_size",116,119
13,1,68,3,13,"tsp_conf_read@127-140@sys/arch/alpha/pci/tsp_pci.c","sys/arch/alpha/pci/tsp_pci.c","tsp_conf_read",127,140
13,1,68,4,13,"tsp_conf_write@143-156@sys/arch/alpha/pci/tsp_pci.c","sys/arch/alpha/pci/tsp_pci.c","tsp_conf_write",143,156
17,7,123,3,17,"loadrandom@67-84@sys/arch/alpha/stand/boot/boot.c","sys/arch/alpha/stand/boot/boot.c","loadrandom",67,84
54,6,419,0,74,"main@87-161@sys/arch/alpha/stand/boot/boot.c","sys/arch/alpha/stand/boot/boot.c","main",87,161
70,22,438,3,82,"devopen@44-126@sys/arch/alpha/stand/boot/devopen.c","sys/arch/alpha/stand/boot/devopen.c","devopen",44,126
24,5,163,6,29,"diskstrategy@57-86@sys/arch/alpha/stand/boot/disk.c","sys/arch/alpha/stand/boot/disk.c","diskstrategy",57,86
55,12,426,4,67,"diskopen@89-156@sys/arch/alpha/stand/boot/disk.c","sys/arch/alpha/stand/boot/disk.c","diskopen",89,156
9,1,52,1,10,"diskclose@159-169@sys/arch/alpha/stand/boot/disk.c","sys/arch/alpha/stand/boot/disk.c","diskclose",159,169
23,1,191,5,27,"main@35-62@sys/arch/alpha/stand/boot/test.c","sys/arch/alpha/stand/boot/test.c","main",35,62
42,11,202,2,51,"net_open@102-153@sys/arch/alpha/stand/netboot/dev_net.c","sys/arch/alpha/stand/netboot/dev_net.c","net_open",102,153
20,7,91,1,26,"net_close@156-182@sys/arch/alpha/stand/netboot/dev_net.c","sys/arch/alpha/stand/netboot/dev_net.c","net_close",156,182
4,1,8,0,3,"net_ioctl@185-188@sys/arch/alpha/stand/netboot/dev_net.c","sys/arch/alpha/stand/netboot/dev_net.c","net_ioctl",185,188
4,1,8,0,3,"net_strategy@191-194@sys/arch/alpha/stand/netboot/dev_net.c","sys/arch/alpha/stand/netboot/dev_net.c","net_strategy",191,194
30,9,165,1,57,"net_getparams@197-254@sys/arch/alpha/stand/netboot/dev_net.c","sys/arch/alpha/stand/netboot/dev_net.c","net_getparams",197,254
90,36,575,3,112,"devopen@45-157@sys/arch/alpha/stand/netboot/devopen.c","sys/arch/alpha/stand/netboot/devopen.c","devopen",45,157
20,4,127,0,26,"getsecs@8-34@sys/arch/alpha/stand/netboot/getsecs.c","sys/arch/alpha/stand/netboot/getsecs.c","getsecs",8,34
4,1,18,2,4,"prom_match@89-93@sys/arch/alpha/stand/netboot/if_prom.c","sys/arch/alpha/stand/netboot/if_prom.c","prom_match",89,93
4,1,16,2,4,"prom_probe@96-100@sys/arch/alpha/stand/netboot/if_prom.c","sys/arch/alpha/stand/netboot/if_prom.c","prom_probe",96,100
5,1,30,3,6,"prom_put@103-109@sys/arch/alpha/stand/netboot/if_prom.c","sys/arch/alpha/stand/netboot/if_prom.c","prom_put",103,109
23,6,147,4,24,"prom_get@113-137@sys/arch/alpha/stand/netboot/if_prom.c","sys/arch/alpha/stand/netboot/if_prom.c","prom_get",113,137
74,15,463,2,94,"prom_init@142-236@sys/arch/alpha/stand/netboot/if_prom.c","sys/arch/alpha/stand/netboot/if_prom.c","prom_init",142,236
4,1,14,1,4,"prom_end@239-243@sys/arch/alpha/stand/netboot/if_prom.c","sys/arch/alpha/stand/netboot/if_prom.c","prom_end",239,243
27,3,191,0,36,"main@57-93@sys/arch/alpha/stand/netboot/netboot.c","sys/arch/alpha/stand/netboot/netboot.c","main",57,93
8,1,50,0,8,"usage@57-65@sys/arch/alpha/stand/setnetbootinfo/setnetbootinfo.c","sys/arch/alpha/stand/setnetbootinfo/setnetbootinfo.c","usage",57,65
158,56,1004,2,184,"main@68-252@sys/arch/alpha/stand/setnetbootinfo/setnetbootinfo.c","sys/arch/alpha/stand/setnetbootinfo/setnetbootinfo.c","main",68,252
19,2,128,0,27,"OSFpal@41-68@sys/arch/alpha/stand/OSFpal.c","sys/arch/alpha/stand/OSFpal.c","OSFpal",41,68
14,2,80,1,22,"open_dev@48-70@sys/arch/alpha/stand/bootxx.c","sys/arch/alpha/stand/bootxx.c","open_dev",48,70
51,10,308,2,56,"load_file@73-129@sys/arch/alpha/stand/bootxx.c","sys/arch/alpha/stand/bootxx.c","load_file",73,129
18,3,98,0,24,"main@132-156@sys/arch/alpha/stand/bootxx.c","sys/arch/alpha/stand/bootxx.c","main",132,156
31,11,259,2,44,"main@45-89@sys/arch/alpha/stand/headersize.c","sys/arch/alpha/stand/headersize.c","main",45,89
7,1,22,1,6,"usage@79-85@sys/arch/alpha/stand/installboot.c","sys/arch/alpha/stand/installboot.c","usage",79,85
107,31,791,2,143,"main@88-231@sys/arch/alpha/stand/installboot.c","sys/arch/alpha/stand/installboot.c","main",88,231
56,11,377,2,68,"loadprotoblocks@234-302@sys/arch/alpha/stand/installboot.c","sys/arch/alpha/stand/installboot.c","loadprotoblocks",234,302
7,3,71,5,7,"devread@305-312@sys/arch/alpha/stand/installboot.c","sys/arch/alpha/stand/installboot.c","devread",305,312
94,30,807,3,133,"loadblocknums@317-450@sys/arch/alpha/stand/installboot.c","sys/arch/alpha/stand/installboot.c","loadblocknums",317,450
29,5,179,1,32,"check_phdr@35-67@sys/arch/alpha/stand/loadfile_subr.c","sys/arch/alpha/stand/loadfile_subr.c","check_phdr",35,67
13,1,90,0,16,"init_prom_calls@40-56@sys/arch/alpha/stand/prom.c","sys/arch/alpha/stand/prom.c","init_prom_calls",40,56
9,4,53,0,9,"getchar@59-68@sys/arch/alpha/stand/prom.c","sys/arch/alpha/stand/prom.c","getchar",59,68
18,5,108,1,18,"putchar@71-89@sys/arch/alpha/stand/prom.c","sys/arch/alpha/stand/prom.c","putchar",71,89
16,3,113,3,23,"prom_getenv@92-115@sys/arch/alpha/stand/prom.c","sys/arch/alpha/stand/prom.c","prom_getenv",92,115
6,2,22,1,6,"puts@5-11@sys/arch/alpha/stand/puts.c","sys/arch/alpha/stand/puts.c","puts",5,11
10,2,55,3,11,"cfbmatch@118-129@sys/arch/alpha/tc/cfb.c","sys/arch/alpha/tc/cfb.c","cfbmatch",118,129
48,6,398,2,61,"cfb_getdevconfig@132-193@sys/arch/alpha/tc/cfb.c","sys/arch/alpha/tc/cfb.c","cfb_getdevconfig",132,193
33,3,234,3,38,"cfbattach@196-234@sys/arch/alpha/tc/cfb.c","sys/arch/alpha/tc/cfb.c","cfbattach",196,234
46,17,332,5,64,"cfbioctl@237-301@sys/arch/alpha/tc/cfb.c","sys/arch/alpha/tc/cfb.c","cfbioctl",237,301
10,2,48,3,10,"cfbmmap@304-314@sys/arch/alpha/tc/cfb.c","sys/arch/alpha/tc/cfb.c","cfbmmap",304,314
7,1,40,1,8,"cfbintr@317-325@sys/arch/alpha/tc/cfb.c","sys/arch/alpha/tc/cfb.c","cfbintr",317,325
19,2,118,6,20,"cfb_alloc_screen@328-348@sys/arch/alpha/tc/cfb.c","sys/arch/alpha/tc/cfb.c","cfb_alloc_screen",328,348
9,2,42,2,10,"cfb_free_screen@351-361@sys/arch/alpha/tc/cfb.c","sys/arch/alpha/tc/cfb.c","cfb_free_screen",351,361
12,1,71,1,15,"cfb_cnattach@376-391@sys/arch/alpha/tc/cfb.c","sys/arch/alpha/tc/cfb.c","cfb_cnattach",376,391
13,5,80,3,18,"ioasicmatch@134-152@sys/arch/alpha/tc/ioasic.c","sys/arch/alpha/tc/ioasic.c","ioasicmatch",134,152
37,7,289,3,58,"ioasicattach@155-213@sys/arch/alpha/tc/ioasic.c","sys/arch/alpha/tc/ioasic.c","ioasicattach",155,213
21,6,174,0,29,"ioasic_intr_disestablish@251-280@sys/arch/alpha/tc/ioasic.c","sys/arch/alpha/tc/ioasic.c","ioasic_intr_disestablish",251,280
6,1,20,0,6,"ioasic_intrnull@283-289@sys/arch/alpha/tc/ioasic.c","sys/arch/alpha/tc/ioasic.c","ioasic_intrnull",283,289
25,3,137,0,40,"ioasic_intr@295-335@sys/arch/alpha/tc/ioasic.c","sys/arch/alpha/tc/ioasic.c","ioasic_intr",295,335
56,16,324,0,79,"ioasic_led_blink@352-431@sys/arch/alpha/tc/ioasic.c","sys/arch/alpha/tc/ioasic.c","ioasic_led_blink",352,431
9,2,52,3,10,"mcclock_ioasic_match@69-79@sys/arch/alpha/tc/mcclock_ioasic.c","sys/arch/alpha/tc/mcclock_ioasic.c","mcclock_ioasic_match",69,79
9,1,65,3,10,"mcclock_ioasic_attach@82-92@sys/arch/alpha/tc/mcclock_ioasic.c","sys/arch/alpha/tc/mcclock_ioasic.c","mcclock_ioasic_attach",82,92
7,1,43,3,7,"mcclock_ioasic_write@95-102@sys/arch/alpha/tc/mcclock_ioasic.c","sys/arch/alpha/tc/mcclock_ioasic.c","mcclock_ioasic_write",95,102
7,1,40,2,7,"mcclock_ioasic_read@105-112@sys/arch/alpha/tc/mcclock_ioasic.c","sys/arch/alpha/tc/mcclock_ioasic.c","mcclock_ioasic_read",105,112
10,2,55,3,11,"sfbmatch@121-132@sys/arch/alpha/tc/sfb.c","sys/arch/alpha/tc/sfb.c","sfbmatch",121,132
75,10,605,2,98,"sfb_getdevconfig@135-233@sys/arch/alpha/tc/sfb.c","sys/arch/alpha/tc/sfb.c","sfb_getdevconfig",135,233
37,4,269,3,42,"sfbattach@236-278@sys/arch/alpha/tc/sfb.c","sys/arch/alpha/tc/sfb.c","sfbattach",236,278
46,17,332,5,64,"sfbioctl@281-345@sys/arch/alpha/tc/sfb.c","sys/arch/alpha/tc/sfb.c","sfbioctl",281,345
10,3,52,3,10,"sfbmmap@348-358@sys/arch/alpha/tc/sfb.c","sys/arch/alpha/tc/sfb.c","sfbmmap",348,358
19,2,118,6,20,"sfb_alloc_screen@361-381@sys/arch/alpha/tc/sfb.c","sys/arch/alpha/tc/sfb.c","sfb_alloc_screen",361,381
9,2,42,2,10,"sfb_free_screen@384-394@sys/arch/alpha/tc/sfb.c","sys/arch/alpha/tc/sfb.c","sfb_free_screen",384,394
12,1,70,1,14,"sfb_cnattach@410-424@sys/arch/alpha/tc/sfb.c","sys/arch/alpha/tc/sfb.c","sfb_cnattach",410,424
10,2,58,1,10,"sfb_blank@432-442@sys/arch/alpha/tc/sfb.c","sys/arch/alpha/tc/sfb.c","sfb_blank",432,442
10,2,57,1,10,"sfb_unblank@445-455@sys/arch/alpha/tc/sfb.c","sys/arch/alpha/tc/sfb.c","sfb_unblank",445,455
12,2,81,0,19,"tc_3000_300_intr_setup@87-106@sys/arch/alpha/tc/tc_3000_300.c","sys/arch/alpha/tc/tc_3000_300.c","tc_3000_300_intr_setup",87,106
10,3,30,1,10,"switch@133-143@sys/arch/alpha/tc/tc_3000_300.c","sys/arch/alpha/tc/tc_3000_300.c","switch",133,143
27,6,146,3,34,"tc_3000_300_intr_disestablish@147-181@sys/arch/alpha/tc/tc_3000_300.c","sys/arch/alpha/tc/tc_3000_300.c","tc_3000_300_intr_disestablish",147,181
6,1,20,1,6,"tc_3000_300_intrnull@184-190@sys/arch/alpha/tc/tc_3000_300.c","sys/arch/alpha/tc/tc_3000_300.c","tc_3000_300_intrnull",184,190
37,5,194,2,81,"tc_3000_300_iointr@193-274@sys/arch/alpha/tc/tc_3000_300.c","sys/arch/alpha/tc/tc_3000_300.c","tc_3000_300_iointr",193,274
13,3,53,1,16,"tc_3000_300_fb_cnattach@283-299@sys/arch/alpha/tc/tc_3000_300.c","sys/arch/alpha/tc/tc_3000_300.c","tc_3000_300_fb_cnattach",283,299
14,3,98,0,22,"tc_3000_500_intr_setup@102-124@sys/arch/alpha/tc/tc_3000_500.c","sys/arch/alpha/tc/tc_3000_500.c","tc_3000_500_intr_setup",102,124
18,4,119,3,24,"tc_3000_500_intr_disestablish@155-179@sys/arch/alpha/tc/tc_3000_500.c","sys/arch/alpha/tc/tc_3000_500.c","tc_3000_500_intr_disestablish",155,179
6,1,20,1,6,"tc_3000_500_intrnull@182-188@sys/arch/alpha/tc/tc_3000_500.c","sys/arch/alpha/tc/tc_3000_500.c","tc_3000_500_intrnull",182,188
36,4,192,2,75,"tc_3000_500_iointr@191-266@sys/arch/alpha/tc/tc_3000_500.c","sys/arch/alpha/tc/tc_3000_500.c","tc_3000_500_iointr",191,266
17,4,70,1,26,"tc_3000_500_fb_cnattach@275-301@sys/arch/alpha/tc/tc_3000_500.c","sys/arch/alpha/tc/tc_3000_500.c","tc_3000_500_fb_cnattach",275,301
19,2,85,3,19,"tc_3000_500_ioslot@309-328@sys/arch/alpha/tc/tc_3000_500.c","sys/arch/alpha/tc/tc_3000_500.c","tc_3000_500_ioslot",309,328
10,3,58,2,14,"tc_3000_500_activate@331-345@sys/arch/alpha/tc/tc_3000_500.c","sys/arch/alpha/tc/tc_3000_500.c","tc_3000_500_activate",331,345
7,1,27,1,7,"tc_bus_mem_init@229-236@sys/arch/alpha/tc/tc_bus_mem.c","sys/arch/alpha/tc/tc_bus_mem.c","tc_bus_mem_init",229,236
19,5,97,5,21,"tc_mem_map@240-261@sys/arch/alpha/tc/tc_bus_mem.c","sys/arch/alpha/tc/tc_bus_mem.c","tc_mem_map",240,261
6,1,20,3,7,"tc_mem_unmap@265-272@sys/arch/alpha/tc/tc_bus_mem.c","sys/arch/alpha/tc/tc_bus_mem.c","tc_mem_unmap",265,272
13,3,79,5,16,"tc_mem_subregion@275-291@sys/arch/alpha/tc/tc_bus_mem.c","sys/arch/alpha/tc/tc_bus_mem.c","tc_mem_subregion",275,291
9,1,53,9,10,"tc_mem_alloc@294-304@sys/arch/alpha/tc/tc_bus_mem.c","sys/arch/alpha/tc/tc_bus_mem.c","tc_mem_alloc",294,304
7,1,25,3,8,"tc_mem_free@307-315@sys/arch/alpha/tc/tc_bus_mem.c","sys/arch/alpha/tc/tc_bus_mem.c","tc_mem_free",307,315
7,3,37,2,12,"tc_mem_vaddr@318-330@sys/arch/alpha/tc/tc_bus_mem.c","sys/arch/alpha/tc/tc_bus_mem.c","tc_mem_vaddr",318,330
11,3,58,5,11,"tc_mem_barrier@333-344@sys/arch/alpha/tc/tc_bus_mem.c","sys/arch/alpha/tc/tc_bus_mem.c","tc_mem_barrier",333,344
12,2,62,3,14,"tc_mem_read_1@347-361@sys/arch/alpha/tc/tc_bus_mem.c","sys/arch/alpha/tc/tc_bus_mem.c","tc_mem_read_1",347,361
12,2,62,3,14,"tc_mem_read_2@364-378@sys/arch/alpha/tc/tc_bus_mem.c","sys/arch/alpha/tc/tc_bus_mem.c","tc_mem_read_2",364,378
13,2,75,3,15,"tc_mem_read_4@381-396@sys/arch/alpha/tc/tc_bus_mem.c","sys/arch/alpha/tc/tc_bus_mem.c","tc_mem_read_4",381,396
12,2,62,3,14,"tc_mem_read_8@399-413@sys/arch/alpha/tc/tc_bus_mem.c","sys/arch/alpha/tc/tc_bus_mem.c","tc_mem_read_8",399,413
22,2,145,4,27,"tc_mem_write_1@454-481@sys/arch/alpha/tc/tc_bus_mem.c","sys/arch/alpha/tc/tc_bus_mem.c","tc_mem_write_1",454,481
22,2,146,4,27,"tc_mem_write_2@484-511@sys/arch/alpha/tc/tc_bus_mem.c","sys/arch/alpha/tc/tc_bus_mem.c","tc_mem_write_2",484,511
14,2,79,4,15,"tc_mem_write_4@514-529@sys/arch/alpha/tc/tc_bus_mem.c","sys/arch/alpha/tc/tc_bus_mem.c","tc_mem_write_4",514,529
13,2,66,4,14,"tc_mem_write_8@532-546@sys/arch/alpha/tc/tc_bus_mem.c","sys/arch/alpha/tc/tc_bus_mem.c","tc_mem_write_8",532,546
7,1,15,0,9,"tc_dma_init@67-76@sys/arch/alpha/tc/tc_dma.c","sys/arch/alpha/tc/tc_dma.c","tc_dma_init",67,76
6,1,20,1,7,"tc_dma_get_tag_3000_300@44-51@sys/arch/alpha/tc/tc_dma_3000_300.c","sys/arch/alpha/tc/tc_dma_3000_300.c","tc_dma_get_tag_3000_300",44,51
14,2,83,1,27,"tc_dma_init_3000_500@81-108@sys/arch/alpha/tc/tc_dma_3000_500.c","sys/arch/alpha/tc/tc_dma_3000_500.c","tc_dma_init_3000_500",81,108
5,1,13,1,4,"tc_dma_get_tag_3000_500@114-118@sys/arch/alpha/tc/tc_dma_3000_500.c","sys/arch/alpha/tc/tc_dma_3000_500.c","tc_dma_get_tag_3000_500",114,118
10,1,59,6,9,"tc_bus_dmamap_load_sgmap@124-133@sys/arch/alpha/tc/tc_dma_3000_500.c","sys/arch/alpha/tc/tc_dma_3000_500.c","tc_bus_dmamap_load_sgmap",124,133
8,1,44,4,7,"tc_bus_dmamap_load_mbuf_sgmap@139-146@sys/arch/alpha/tc/tc_dma_3000_500.c","sys/arch/alpha/tc/tc_dma_3000_500.c","tc_bus_dmamap_load_mbuf_sgmap",139,146
8,1,44,4,7,"tc_bus_dmamap_load_uio_sgmap@152-159@sys/arch/alpha/tc/tc_dma_3000_500.c","sys/arch/alpha/tc/tc_dma_3000_500.c","tc_bus_dmamap_load_uio_sgmap",152,159
10,1,57,6,9,"tc_bus_dmamap_load_raw_sgmap@165-174@sys/arch/alpha/tc/tc_dma_3000_500.c","sys/arch/alpha/tc/tc_dma_3000_500.c","tc_bus_dmamap_load_raw_sgmap",165,174
7,1,32,2,14,"tc_bus_dmamap_unload_sgmap@180-194@sys/arch/alpha/tc/tc_dma_3000_500.c","sys/arch/alpha/tc/tc_dma_3000_500.c","tc_bus_dmamap_unload_sgmap",180,194
11,3,61,3,14,"tcasicmatch@65-79@sys/arch/alpha/tc/tcasic.c","sys/arch/alpha/tc/tcasic.c","tcasicmatch",65,79
54,7,288,3,73,"tcasicattach@82-155@sys/arch/alpha/tc/tcasic.c","sys/arch/alpha/tc/tcasic.c","tcasicattach",82,155
9,3,39,2,10,"tcasicactivate@158-168@sys/arch/alpha/tc/tcasic.c","sys/arch/alpha/tc/tcasic.c","tcasicactivate",158,168
8,2,33,2,9,"tcasicprint@171-180@sys/arch/alpha/tc/tcasic.c","sys/arch/alpha/tc/tcasic.c","tcasicprint",171,180
15,6,124,1,18,"tc_fb_cnattach@242-260@sys/arch/alpha/tc/tcasic.c","sys/arch/alpha/tc/tcasic.c","tc_fb_cnattach",242,260
5,1,14,1,4,"tc_fb_cnattach@266-270@sys/arch/alpha/tc/tcasic.c","sys/arch/alpha/tc/tcasic.c","tc_fb_cnattach",266,270
18,3,126,3,21,"acpi_map@68-89@sys/arch/amd64/amd64/acpi_machdep.c","sys/arch/amd64/amd64/acpi_machdep.c","acpi_map",68,89
5,1,33,1,4,"acpi_unmap@92-96@sys/arch/amd64/amd64/acpi_machdep.c","sys/arch/amd64/amd64/acpi_machdep.c","acpi_unmap",92,96
42,11,294,6,50,"acpi_intr_establish@99-149@sys/arch/amd64/amd64/acpi_machdep.c","sys/arch/amd64/amd64/acpi_machdep.c","acpi_intr_establish",99,149
22,9,171,3,28,"acpi_scan@152-180@sys/arch/amd64/amd64/acpi_machdep.c","sys/arch/amd64/amd64/acpi_machdep.c","acpi_scan",152,180
33,8,204,3,49,"acpi_probe@183-232@sys/arch/amd64/amd64/acpi_machdep.c","sys/arch/amd64/amd64/acpi_machdep.c","acpi_probe",183,232
11,3,70,1,12,"acpi_acquire_glk@240-252@sys/arch/amd64/amd64/acpi_machdep.c","sys/arch/amd64/amd64/acpi_machdep.c","acpi_acquire_glk",240,252
9,2,56,1,10,"acpi_release_glk@260-270@sys/arch/amd64/amd64/acpi_machdep.c","sys/arch/amd64/amd64/acpi_machdep.c","acpi_release_glk",260,270
22,1,162,1,38,"acpi_attach_machdep@273-311@sys/arch/amd64/amd64/acpi_machdep.c","sys/arch/amd64/amd64/acpi_machdep.c","acpi_attach_machdep",273,311
5,2,20,2,7,"acpi_sleep_clocks@316-323@sys/arch/amd64/amd64/acpi_machdep.c","sys/arch/amd64/amd64/acpi_machdep.c","acpi_sleep_clocks",316,323
13,6,56,1,21,"acpi_resume_clocks@331-352@sys/arch/amd64/amd64/acpi_machdep.c","sys/arch/amd64/amd64/acpi_machdep.c","acpi_resume_clocks",331,352
32,9,211,2,65,"acpi_sleep_cpu@359-424@sys/arch/amd64/amd64/acpi_machdep.c","sys/arch/amd64/amd64/acpi_machdep.c","acpi_sleep_cpu",359,424
7,2,39,1,9,"acpi_resume_cpu@427-436@sys/arch/amd64/amd64/acpi_machdep.c","sys/arch/amd64/amd64/acpi_machdep.c","acpi_resume_cpu",427,436
14,4,71,1,20,"acpi_sleep_mp@440-460@sys/arch/amd64/amd64/acpi_machdep.c","sys/arch/amd64/amd64/acpi_machdep.c","acpi_sleep_mp",440,460
35,5,226,1,42,"acpi_resume_mp@463-505@sys/arch/amd64/amd64/acpi_machdep.c","sys/arch/amd64/amd64/acpi_machdep.c","acpi_resume_mp",463,505
34,3,243,1,47,"aesni_setup@127-174@sys/arch/amd64/amd64/aesni.c","sys/arch/amd64/amd64/aesni.c","aesni_setup",127,174
136,29,930,2,162,"aesni_newsession@177-339@sys/arch/amd64/amd64/aesni.c","sys/arch/amd64/amd64/aesni.c","aesni_newsession",177,339
46,9,326,1,55,"aesni_freesession@342-397@sys/arch/amd64/amd64/aesni.c","sys/arch/amd64/amd64/aesni.c","aesni_freesession",342,397
10,2,58,4,11,"aesni_swauth@400-411@sys/arch/amd64/amd64/aesni.c","sys/arch/amd64/amd64/aesni.c","aesni_swauth",400,411
165,33,1190,4,196,"aesni_encdec@414-610@sys/arch/amd64/amd64/aesni.c","sys/arch/amd64/amd64/aesni.c","aesni_encdec",414,610
69,26,335,1,76,"aesni_process@613-689@sys/arch/amd64/amd64/aesni.c","sys/arch/amd64/amd64/aesni.c","aesni_process",613,689
4,1,10,1,3,"pclmul_setup@692-695@sys/arch/amd64/amd64/aesni.c","sys/arch/amd64/amd64/aesni.c","pclmul_setup",692,695
6,1,32,3,5,"ghash_update_pclmul@698-703@sys/arch/amd64/amd64/aesni.c","sys/arch/amd64/amd64/aesni.c","ghash_update_pclmul",698,703
6,3,29,1,5,"mtrr2mrt@109-114@sys/arch/amd64/amd64/amd64_mem.c","sys/arch/amd64/amd64/amd64_mem.c","mtrr2mrt",109,114
10,6,50,2,9,"mtrrconflict@120-129@sys/arch/amd64/amd64/amd64_mem.c","sys/arch/amd64/amd64/amd64_mem.c","mtrrconflict",120,129
10,4,78,2,10,"mem_range_match@135-145@sys/arch/amd64/amd64/amd64_mem.c","sys/arch/amd64/amd64/amd64_mem.c","mem_range_match",135,145
74,20,596,1,84,"mrfetch@153-237@sys/arch/amd64/amd64/amd64_mem.c","sys/arch/amd64/amd64/amd64_mem.c","mrfetch",153,237
12,4,60,1,13,"mtrrtype@243-256@sys/arch/amd64/amd64/amd64_mem.c","sys/arch/amd64/amd64/amd64_mem.c","mtrrtype",243,256
6,1,22,1,7,"mrt2mtrr@259-266@sys/arch/amd64/amd64/amd64_mem.c","sys/arch/amd64/amd64/amd64_mem.c","mrt2mtrr",259,266
7,2,27,1,8,"mrstore@275-283@sys/arch/amd64/amd64/amd64_mem.c","sys/arch/amd64/amd64/amd64_mem.c","mrstore",275,283
61,12,453,1,76,"mrstoreone@291-367@sys/arch/amd64/amd64/amd64_mem.c","sys/arch/amd64/amd64/amd64_mem.c","mrstoreone",291,367
9,4,82,2,9,"mtrrfixsearch@373-382@sys/arch/amd64/amd64/amd64_mem.c","sys/arch/amd64/amd64/amd64_mem.c","mtrrfixsearch",373,382
17,7,174,3,23,"mrsetlow@393-416@sys/arch/amd64/amd64/amd64_mem.c","sys/arch/amd64/amd64/amd64_mem.c","mrsetlow",393,416
35,12,249,3,50,"mrsetvariable@423-473@sys/arch/amd64/amd64/amd64_mem.c","sys/arch/amd64/amd64/amd64_mem.c","mrsetvariable",423,473
32,11,212,3,40,"mrset@479-519@sys/arch/amd64/amd64/amd64_mem.c","sys/arch/amd64/amd64/amd64_mem.c","mrset",479,519
56,12,407,1,79,"mrinit@526-605@sys/arch/amd64/amd64/amd64_mem.c","sys/arch/amd64/amd64/amd64_mem.c","mrinit",526,605
4,1,14,1,3,"mrinit_cpu@611-614@sys/arch/amd64/amd64/amd64_mem.c","sys/arch/amd64/amd64/amd64_mem.c","mrinit_cpu",611,614
6,1,22,1,5,"mrreload_cpu@617-622@sys/arch/amd64/amd64/amd64_mem.c","sys/arch/amd64/amd64/amd64_mem.c","mrreload_cpu",617,622
10,2,56,2,12,"amd64_errata_testmsr@249-261@sys/arch/amd64/amd64/amd64errata.c","sys/arch/amd64/amd64/amd64errata.c","amd64_errata_testmsr",249,261
15,4,104,2,21,"amd64_errata_setmsr@264-285@sys/arch/amd64/amd64/amd64errata.c","sys/arch/amd64/amd64/amd64errata.c","amd64_errata_setmsr",264,285
76,31,481,1,107,"amd64_errata@288-395@sys/arch/amd64/amd64/amd64errata.c","sys/arch/amd64/amd64/amd64errata.c","amd64_errata",288,395
8,2,56,5,9,"apic_format_redir@42-51@sys/arch/amd64/amd64/apic.c","sys/arch/amd64/amd64/apic.c","apic_format_redir",42,51
9,2,48,1,9,"unmap_startup@102-111@sys/arch/amd64/amd64/autoconf.c","sys/arch/amd64/amd64/autoconf.c","unmap_startup",102,111
26,9,123,1,47,"cpu_configure@117-164@sys/arch/amd64/amd64/autoconf.c","sys/arch/amd64/amd64/autoconf.c","cpu_configure",117,164
3,1,13,2,2,"device_register@167-169@sys/arch/amd64/amd64/autoconf.c","sys/arch/amd64/amd64/autoconf.c","device_register",167,169
40,9,261,1,49,"diskconf@177-226@sys/arch/amd64/amd64/autoconf.c","sys/arch/amd64/amd64/autoconf.c","diskconf",177,226
7,3,47,3,8,"bios_match@71-79@sys/arch/amd64/amd64/bios.c","sys/arch/amd64/amd64/bios.c","bios_match",71,79
104,26,769,3,132,"bios_attach@82-214@sys/arch/amd64/amd64/bios.c","sys/arch/amd64/amd64/bios.c","bios_attach",82,214
22,11,159,1,23,"smbios_find@217-240@sys/arch/amd64/amd64/bios.c","sys/arch/amd64/amd64/bios.c","smbios_find",217,240
40,16,298,2,48,"smbios_find_table@252-300@sys/arch/amd64/amd64/bios.c","sys/arch/amd64/amd64/bios.c","smbios_find_table",252,300
19,7,131,4,20,"smbios_get_string@303-323@sys/arch/amd64/amd64/bios.c","sys/arch/amd64/amd64/bios.c","smbios_get_string",303,323
20,9,162,1,27,"fixstring@326-353@sys/arch/amd64/amd64/bios.c","sys/arch/amd64/amd64/bios.c","fixstring",326,353
106,35,821,1,124,"smbios_info@356-480@sys/arch/amd64/amd64/bios.c","sys/arch/amd64/amd64/bios.c","smbios_info",356,480
8,2,40,2,8,"bios_print@483-491@sys/arch/amd64/amd64/bios.c","sys/arch/amd64/amd64/bios.c","bios_print",483,491
21,3,152,7,35,"_bus_dmamap_create@107-142@sys/arch/amd64/amd64/bus_dma.c","sys/arch/amd64/amd64/bus_dma.c","_bus_dmamap_create",107,142
7,1,45,2,7,"_bus_dmamap_destroy@149-156@sys/arch/amd64/amd64/bus_dma.c","sys/arch/amd64/amd64/bus_dma.c","_bus_dmamap_destroy",149,156
18,3,116,6,23,"_bus_dmamap_load@163-186@sys/arch/amd64/amd64/bus_dma.c","sys/arch/amd64/amd64/bus_dma.c","_bus_dmamap_load",163,186
28,8,189,4,36,"_bus_dmamap_load_mbuf@192-228@sys/arch/amd64/amd64/bus_dma.c","sys/arch/amd64/amd64/bus_dma.c","_bus_dmamap_load_mbuf",192,228
35,9,234,4,49,"_bus_dmamap_load_uio@234-283@sys/arch/amd64/amd64/bus_dma.c","sys/arch/amd64/amd64/bus_dma.c","_bus_dmamap_load_uio",234,283
57,16,396,6,80,"_bus_dmamap_load_raw@290-370@sys/arch/amd64/amd64/bus_dma.c","sys/arch/amd64/amd64/bus_dma.c","_bus_dmamap_load_raw",290,370
5,1,22,2,8,"_bus_dmamap_unload@377-385@sys/arch/amd64/amd64/bus_dma.c","sys/arch/amd64/amd64/bus_dma.c","_bus_dmamap_unload",377,385
4,1,19,5,4,"_bus_dmamap_sync@392-396@sys/arch/amd64/amd64/bus_dma.c","sys/arch/amd64/amd64/bus_dma.c","_bus_dmamap_sync",392,396
7,1,62,8,13,"_bus_dmamem_alloc@403-416@sys/arch/amd64/amd64/bus_dma.c","sys/arch/amd64/amd64/bus_dma.c","_bus_dmamem_alloc",403,416
17,3,108,3,21,"_bus_dmamem_free@423-444@sys/arch/amd64/amd64/bus_dma.c","sys/arch/amd64/amd64/bus_dma.c","_bus_dmamem_free",423,444
41,10,304,6,46,"_bus_dmamem_map@451-497@sys/arch/amd64/amd64/bus_dma.c","sys/arch/amd64/amd64/bus_dma.c","_bus_dmamem_map",451,497
8,5,61,3,11,"_bus_dmamem_unmap@504-515@sys/arch/amd64/amd64/bus_dma.c","sys/arch/amd64/amd64/bus_dma.c","_bus_dmamem_unmap",504,515
22,8,145,6,28,"_bus_dmamem_mmap@522-550@sys/arch/amd64/amd64/bus_dma.c","sys/arch/amd64/amd64/bus_dma.c","_bus_dmamem_mmap",522,550
57,14,378,9,82,"_bus_dmamap_load_buffer@562-644@sys/arch/amd64/amd64/bus_dma.c","sys/arch/amd64/amd64/bus_dma.c","_bus_dmamap_load_buffer",562,644
46,10,309,10,63,"_bus_dmamem_alloc_range@651-714@sys/arch/amd64/amd64/bus_dma.c","sys/arch/amd64/amd64/bus_dma.c","_bus_dmamem_alloc_range",651,714
9,1,60,1,19,"x86_bus_space_init@311-330@sys/arch/amd64/amd64/bus_space.c","sys/arch/amd64/amd64/bus_space.c","x86_bus_space_init",311,330
4,1,10,1,3,"x86_bus_space_mallocok@333-336@sys/arch/amd64/amd64/bus_space.c","sys/arch/amd64/amd64/bus_space.c","x86_bus_space_mallocok",333,336
36,12,209,5,55,"bus_space_map@339-394@sys/arch/amd64/amd64/bus_space.c","sys/arch/amd64/amd64/bus_space.c","bus_space_map",339,394
9,2,52,5,17,"_bus_space_map@397-414@sys/arch/amd64/amd64/bus_space.c","sys/arch/amd64/amd64/bus_space.c","_bus_space_map",397,414
37,11,222,9,60,"bus_space_alloc@417-477@sys/arch/amd64/amd64/bus_space.c","sys/arch/amd64/amd64/bus_space.c","bus_space_alloc",417,477
26,8,179,4,35,"x86_mem_add_mapping@480-515@sys/arch/amd64/amd64/bus_space.c","sys/arch/amd64/amd64/bus_space.c","x86_mem_add_mapping",480,515
26,8,173,4,40,"_bus_space_unmap@528-568@sys/arch/amd64/amd64/bus_space.c","sys/arch/amd64/amd64/bus_space.c","_bus_space_unmap",528,568
32,10,218,3,46,"bus_space_unmap@571-617@sys/arch/amd64/amd64/bus_space.c","sys/arch/amd64/amd64/bus_space.c","bus_space_unmap",571,617
4,1,22,3,5,"bus_space_free@620-625@sys/arch/amd64/amd64/bus_space.c","sys/arch/amd64/amd64/bus_space.c","bus_space_free",620,625
6,1,32,5,6,"bus_space_subregion@628-634@sys/arch/amd64/amd64/bus_space.c","sys/arch/amd64/amd64/bus_space.c","bus_space_subregion",628,634
4,1,20,2,3,"x86_bus_space_io_read_1@637-640@sys/arch/amd64/amd64/bus_space.c","sys/arch/amd64/amd64/bus_space.c","x86_bus_space_io_read_1",637,640
4,1,20,2,3,"x86_bus_space_io_read_2@643-646@sys/arch/amd64/amd64/bus_space.c","sys/arch/amd64/amd64/bus_space.c","x86_bus_space_io_read_2",643,646
4,1,20,2,3,"x86_bus_space_io_read_4@649-652@sys/arch/amd64/amd64/bus_space.c","sys/arch/amd64/amd64/bus_space.c","x86_bus_space_io_read_4",649,652
4,1,15,2,3,"x86_bus_space_io_read_8@655-658@sys/arch/amd64/amd64/bus_space.c","sys/arch/amd64/amd64/bus_space.c","x86_bus_space_io_read_8",655,658
5,1,28,4,4,"x86_bus_space_io_read_multi_1@661-665@sys/arch/amd64/amd64/bus_space.c","sys/arch/amd64/amd64/bus_space.c","x86_bus_space_io_read_multi_1",661,665
5,1,28,4,4,"x86_bus_space_io_read_multi_2@668-672@sys/arch/amd64/amd64/bus_space.c","sys/arch/amd64/amd64/bus_space.c","x86_bus_space_io_read_multi_2",668,672
5,1,28,4,4,"x86_bus_space_io_read_multi_4@675-679@sys/arch/amd64/amd64/bus_space.c","sys/arch/amd64/amd64/bus_space.c","x86_bus_space_io_read_multi_4",675,679
5,1,22,4,4,"x86_bus_space_io_read_multi_8@682-686@sys/arch/amd64/amd64/bus_space.c","sys/arch/amd64/amd64/bus_space.c","x86_bus_space_io_read_multi_8",682,686
18,1,83,4,17,"x86_bus_space_io_read_region_1@689-706@sys/arch/amd64/amd64/bus_space.c","sys/arch/amd64/amd64/bus_space.c","x86_bus_space_io_read_region_1",689,706
18,1,89,4,17,"x86_bus_space_io_read_region_2@709-726@sys/arch/amd64/amd64/bus_space.c","sys/arch/amd64/amd64/bus_space.c","x86_bus_space_io_read_region_2",709,726
18,1,83,4,17,"x86_bus_space_io_read_region_4@729-746@sys/arch/amd64/amd64/bus_space.c","sys/arch/amd64/amd64/bus_space.c","x86_bus_space_io_read_region_4",729,746
5,1,22,4,4,"x86_bus_space_io_read_region_8@749-753@sys/arch/amd64/amd64/bus_space.c","sys/arch/amd64/amd64/bus_space.c","x86_bus_space_io_read_region_8",749,753
4,1,22,3,3,"x86_bus_space_io_write_1@756-759@sys/arch/amd64/amd64/bus_space.c","sys/arch/amd64/amd64/bus_space.c","x86_bus_space_io_write_1",756,759
4,1,22,3,3,"x86_bus_space_io_write_2@762-765@sys/arch/amd64/amd64/bus_space.c","sys/arch/amd64/amd64/bus_space.c","x86_bus_space_io_write_2",762,765
4,1,22,3,3,"x86_bus_space_io_write_4@768-771@sys/arch/amd64/amd64/bus_space.c","sys/arch/amd64/amd64/bus_space.c","x86_bus_space_io_write_4",768,771
4,1,18,3,3,"x86_bus_space_io_write_8@774-777@sys/arch/amd64/amd64/bus_space.c","sys/arch/amd64/amd64/bus_space.c","x86_bus_space_io_write_8",774,777
5,1,29,4,4,"x86_bus_space_io_write_multi_1@780-784@sys/arch/amd64/amd64/bus_space.c","sys/arch/amd64/amd64/bus_space.c","x86_bus_space_io_write_multi_1",780,784
5,1,29,4,4,"x86_bus_space_io_write_multi_2@787-791@sys/arch/amd64/amd64/bus_space.c","sys/arch/amd64/amd64/bus_space.c","x86_bus_space_io_write_multi_2",787,791
5,1,29,4,4,"x86_bus_space_io_write_multi_4@794-798@sys/arch/amd64/amd64/bus_space.c","sys/arch/amd64/amd64/bus_space.c","x86_bus_space_io_write_multi_4",794,798
5,1,23,4,4,"x86_bus_space_io_write_multi_8@801-805@sys/arch/amd64/amd64/bus_space.c","sys/arch/amd64/amd64/bus_space.c","x86_bus_space_io_write_multi_8",801,805
18,1,84,4,17,"x86_bus_space_io_write_region_1@808-825@sys/arch/amd64/amd64/bus_space.c","sys/arch/amd64/amd64/bus_space.c","x86_bus_space_io_write_region_1",808,825
18,1,84,4,17,"x86_bus_space_io_write_region_2@828-845@sys/arch/amd64/amd64/bus_space.c","sys/arch/amd64/amd64/bus_space.c","x86_bus_space_io_write_region_2",828,845
18,1,84,4,17,"x86_bus_space_io_write_region_4@848-865@sys/arch/amd64/amd64/bus_space.c","sys/arch/amd64/amd64/bus_space.c","x86_bus_space_io_write_region_4",848,865
5,1,23,4,4,"x86_bus_space_io_write_region_8@868-872@sys/arch/amd64/amd64/bus_space.c","sys/arch/amd64/amd64/bus_space.c","x86_bus_space_io_write_region_8",868,872
7,2,35,4,7,"x86_bus_space_io_set_multi_1@875-882@sys/arch/amd64/amd64/bus_space.c","sys/arch/amd64/amd64/bus_space.c","x86_bus_space_io_set_multi_1",875,882
7,2,35,4,7,"x86_bus_space_io_set_multi_2@885-892@sys/arch/amd64/amd64/bus_space.c","sys/arch/amd64/amd64/bus_space.c","x86_bus_space_io_set_multi_2",885,892
7,2,35,4,7,"x86_bus_space_io_set_multi_4@895-902@sys/arch/amd64/amd64/bus_space.c","sys/arch/amd64/amd64/bus_space.c","x86_bus_space_io_set_multi_4",895,902
5,1,21,4,4,"x86_bus_space_io_set_multi_8@905-909@sys/arch/amd64/amd64/bus_space.c","sys/arch/amd64/amd64/bus_space.c","x86_bus_space_io_set_multi_8",905,909
7,2,43,4,7,"x86_bus_space_io_set_region_1@912-919@sys/arch/amd64/amd64/bus_space.c","sys/arch/amd64/amd64/bus_space.c","x86_bus_space_io_set_region_1",912,919
7,2,47,4,7,"x86_bus_space_io_set_region_2@922-929@sys/arch/amd64/amd64/bus_space.c","sys/arch/amd64/amd64/bus_space.c","x86_bus_space_io_set_region_2",922,929
7,2,47,4,7,"x86_bus_space_io_set_region_4@932-939@sys/arch/amd64/amd64/bus_space.c","sys/arch/amd64/amd64/bus_space.c","x86_bus_space_io_set_region_4",932,939
5,1,21,4,4,"x86_bus_space_io_set_region_8@942-946@sys/arch/amd64/amd64/bus_space.c","sys/arch/amd64/amd64/bus_space.c","x86_bus_space_io_set_region_8",942,946
14,4,111,5,16,"x86_bus_space_io_copy_1@949-965@sys/arch/amd64/amd64/bus_space.c","sys/arch/amd64/amd64/bus_space.c","x86_bus_space_io_copy_1",949,965
14,4,119,5,16,"x86_bus_space_io_copy_2@968-984@sys/arch/amd64/amd64/bus_space.c","sys/arch/amd64/amd64/bus_space.c","x86_bus_space_io_copy_2",968,984
14,4,119,5,16,"x86_bus_space_io_copy_4@987-1003@sys/arch/amd64/amd64/bus_space.c","sys/arch/amd64/amd64/bus_space.c","x86_bus_space_io_copy_4",987,1003
5,1,24,5,4,"x86_bus_space_io_copy_8@1006-1010@sys/arch/amd64/amd64/bus_space.c","sys/arch/amd64/amd64/bus_space.c","x86_bus_space_io_copy_8",1006,1010
4,1,12,1,3,"x86_bus_space_io_vaddr@1013-1016@sys/arch/amd64/amd64/bus_space.c","sys/arch/amd64/amd64/bus_space.c","x86_bus_space_io_vaddr",1013,1016
4,1,22,4,4,"x86_bus_space_io_mmap@1019-1023@sys/arch/amd64/amd64/bus_space.c","sys/arch/amd64/amd64/bus_space.c","x86_bus_space_io_mmap",1019,1023
4,1,27,3,3,"x86_bus_space_mem_write_1@1026-1029@sys/arch/amd64/amd64/bus_space.c","sys/arch/amd64/amd64/bus_space.c","x86_bus_space_mem_write_1",1026,1029
4,1,27,3,3,"x86_bus_space_mem_write_2@1032-1035@sys/arch/amd64/amd64/bus_space.c","sys/arch/amd64/amd64/bus_space.c","x86_bus_space_mem_write_2",1032,1035
4,1,25,2,3,"x86_bus_space_mem_read_1@1038-1041@sys/arch/amd64/amd64/bus_space.c","sys/arch/amd64/amd64/bus_space.c","x86_bus_space_mem_read_1",1038,1041
4,1,25,2,3,"x86_bus_space_mem_read_2@1044-1047@sys/arch/amd64/amd64/bus_space.c","sys/arch/amd64/amd64/bus_space.c","x86_bus_space_mem_read_2",1044,1047
4,1,25,2,3,"x86_bus_space_mem_read_4@1050-1053@sys/arch/amd64/amd64/bus_space.c","sys/arch/amd64/amd64/bus_space.c","x86_bus_space_mem_read_4",1050,1053
4,1,25,2,3,"x86_bus_space_mem_read_8@1056-1059@sys/arch/amd64/amd64/bus_space.c","sys/arch/amd64/amd64/bus_space.c","x86_bus_space_mem_read_8",1056,1059
15,1,82,4,14,"x86_bus_space_mem_read_multi_1@1062-1076@sys/arch/amd64/amd64/bus_space.c","sys/arch/amd64/amd64/bus_space.c","x86_bus_space_mem_read_multi_1",1062,1076
15,1,82,4,14,"x86_bus_space_mem_read_multi_2@1079-1093@sys/arch/amd64/amd64/bus_space.c","sys/arch/amd64/amd64/bus_space.c","x86_bus_space_mem_read_multi_2",1079,1093
15,1,82,4,14,"x86_bus_space_mem_read_multi_4@1096-1110@sys/arch/amd64/amd64/bus_space.c","sys/arch/amd64/amd64/bus_space.c","x86_bus_space_mem_read_multi_4",1096,1110
15,1,82,4,14,"x86_bus_space_mem_read_multi_8@1113-1127@sys/arch/amd64/amd64/bus_space.c","sys/arch/amd64/amd64/bus_space.c","x86_bus_space_mem_read_multi_8",1113,1127
13,1,68,4,12,"x86_bus_space_mem_read_region_1@1130-1142@sys/arch/amd64/amd64/bus_space.c","sys/arch/amd64/amd64/bus_space.c","x86_bus_space_mem_read_region_1",1130,1142
13,1,68,4,12,"x86_bus_space_mem_read_region_2@1145-1157@sys/arch/amd64/amd64/bus_space.c","sys/arch/amd64/amd64/bus_space.c","x86_bus_space_mem_read_region_2",1145,1157
13,1,68,4,12,"x86_bus_space_mem_read_region_4@1160-1172@sys/arch/amd64/amd64/bus_space.c","sys/arch/amd64/amd64/bus_space.c","x86_bus_space_mem_read_region_4",1160,1172
13,1,68,4,12,"x86_bus_space_mem_read_region_8@1175-1187@sys/arch/amd64/amd64/bus_space.c","sys/arch/amd64/amd64/bus_space.c","x86_bus_space_mem_read_region_8",1175,1187
4,1,27,3,3,"x86_bus_space_mem_write_4@1190-1193@sys/arch/amd64/amd64/bus_space.c","sys/arch/amd64/amd64/bus_space.c","x86_bus_space_mem_write_4",1190,1193
4,1,27,3,3,"x86_bus_space_mem_write_8@1196-1199@sys/arch/amd64/amd64/bus_space.c","sys/arch/amd64/amd64/bus_space.c","x86_bus_space_mem_write_8",1196,1199
14,1,77,4,13,"x86_bus_space_mem_write_multi_1@1202-1215@sys/arch/amd64/amd64/bus_space.c","sys/arch/amd64/amd64/bus_space.c","x86_bus_space_mem_write_multi_1",1202,1215
14,1,77,4,13,"x86_bus_space_mem_write_multi_2@1218-1231@sys/arch/amd64/amd64/bus_space.c","sys/arch/amd64/amd64/bus_space.c","x86_bus_space_mem_write_multi_2",1218,1231
14,1,77,4,13,"x86_bus_space_mem_write_multi_4@1234-1247@sys/arch/amd64/amd64/bus_space.c","sys/arch/amd64/amd64/bus_space.c","x86_bus_space_mem_write_multi_4",1234,1247
14,1,77,4,13,"x86_bus_space_mem_write_multi_8@1250-1263@sys/arch/amd64/amd64/bus_space.c","sys/arch/amd64/amd64/bus_space.c","x86_bus_space_mem_write_multi_8",1250,1263
13,1,69,4,12,"x86_bus_space_mem_write_region_1@1266-1278@sys/arch/amd64/amd64/bus_space.c","sys/arch/amd64/amd64/bus_space.c","x86_bus_space_mem_write_region_1",1266,1278
13,1,69,4,12,"x86_bus_space_mem_write_region_2@1281-1293@sys/arch/amd64/amd64/bus_space.c","sys/arch/amd64/amd64/bus_space.c","x86_bus_space_mem_write_region_2",1281,1293
13,1,69,4,12,"x86_bus_space_mem_write_region_4@1296-1308@sys/arch/amd64/amd64/bus_space.c","sys/arch/amd64/amd64/bus_space.c","x86_bus_space_mem_write_region_4",1296,1308
13,1,69,4,12,"x86_bus_space_mem_write_region_8@1311-1323@sys/arch/amd64/amd64/bus_space.c","sys/arch/amd64/amd64/bus_space.c","x86_bus_space_mem_write_region_8",1311,1323
7,2,40,4,7,"x86_bus_space_mem_set_multi_1@1326-1333@sys/arch/amd64/amd64/bus_space.c","sys/arch/amd64/amd64/bus_space.c","x86_bus_space_mem_set_multi_1",1326,1333
7,2,40,4,7,"x86_bus_space_mem_set_multi_2@1336-1343@sys/arch/amd64/amd64/bus_space.c","sys/arch/amd64/amd64/bus_space.c","x86_bus_space_mem_set_multi_2",1336,1343
7,2,40,4,7,"x86_bus_space_mem_set_multi_4@1346-1353@sys/arch/amd64/amd64/bus_space.c","sys/arch/amd64/amd64/bus_space.c","x86_bus_space_mem_set_multi_4",1346,1353
7,2,40,4,7,"x86_bus_space_mem_set_multi_8@1356-1363@sys/arch/amd64/amd64/bus_space.c","sys/arch/amd64/amd64/bus_space.c","x86_bus_space_mem_set_multi_8",1356,1363
7,2,48,4,7,"x86_bus_space_mem_set_region_1@1366-1373@sys/arch/amd64/amd64/bus_space.c","sys/arch/amd64/amd64/bus_space.c","x86_bus_space_mem_set_region_1",1366,1373
7,2,52,4,7,"x86_bus_space_mem_set_region_2@1376-1383@sys/arch/amd64/amd64/bus_space.c","sys/arch/amd64/amd64/bus_space.c","x86_bus_space_mem_set_region_2",1376,1383
7,2,52,4,7,"x86_bus_space_mem_set_region_4@1386-1393@sys/arch/amd64/amd64/bus_space.c","sys/arch/amd64/amd64/bus_space.c","x86_bus_space_mem_set_region_4",1386,1393
7,2,52,4,7,"x86_bus_space_mem_set_region_8@1396-1403@sys/arch/amd64/amd64/bus_space.c","sys/arch/amd64/amd64/bus_space.c","x86_bus_space_mem_set_region_8",1396,1403
16,4,131,5,18,"x86_bus_space_mem_copy_1@1406-1424@sys/arch/amd64/amd64/bus_space.c","sys/arch/amd64/amd64/bus_space.c","x86_bus_space_mem_copy_1",1406,1424
16,4,139,5,18,"x86_bus_space_mem_copy_2@1427-1445@sys/arch/amd64/amd64/bus_space.c","sys/arch/amd64/amd64/bus_space.c","x86_bus_space_mem_copy_2",1427,1445
16,4,139,5,18,"x86_bus_space_mem_copy_4@1448-1466@sys/arch/amd64/amd64/bus_space.c","sys/arch/amd64/amd64/bus_space.c","x86_bus_space_mem_copy_4",1448,1466
16,4,139,5,18,"x86_bus_space_mem_copy_8@1469-1487@sys/arch/amd64/amd64/bus_space.c","sys/arch/amd64/amd64/bus_space.c","x86_bus_space_mem_copy_8",1469,1487
4,1,16,1,3,"x86_bus_space_mem_vaddr@1490-1493@sys/arch/amd64/amd64/bus_space.c","sys/arch/amd64/amd64/bus_space.c","x86_bus_space_mem_vaddr",1490,1493
4,1,23,4,10,"x86_bus_space_mem_mmap@1496-1506@sys/arch/amd64/amd64/bus_space.c","sys/arch/amd64/amd64/bus_space.c","x86_bus_space_mem_mmap",1496,1506
35,9,197,4,40,"print_cache_config@42-82@sys/arch/amd64/amd64/cacheinfo.c","sys/arch/amd64/amd64/cacheinfo.c","print_cache_config",42,82
37,9,201,4,39,"print_tlb_config@85-124@sys/arch/amd64/amd64/cacheinfo.c","sys/arch/amd64/amd64/cacheinfo.c","print_tlb_config",85,124
9,3,61,2,10,"cache_info_lookup@127-137@sys/arch/amd64/amd64/cacheinfo.c","sys/arch/amd64/amd64/cacheinfo.c","cache_info_lookup",127,137
75,12,687,1,106,"amd_cpu_cacheinfo@156-262@sys/arch/amd64/amd64/cacheinfo.c","sys/arch/amd64/amd64/cacheinfo.c","amd_cpu_cacheinfo",156,262
18,4,150,1,18,"x86_print_cacheinfo@265-283@sys/arch/amd64/amd64/cacheinfo.c","sys/arch/amd64/amd64/cacheinfo.c","x86_print_cacheinfo",265,283
24,5,117,2,24,"codepatch_fill_nop@39-63@sys/arch/amd64/amd64/codepatch.c","sys/arch/amd64/amd64/codepatch.c","codepatch_fill_nop",39,63
15,2,137,2,17,"codepatch_maprw@70-87@sys/arch/amd64/amd64/codepatch.c","sys/arch/amd64/amd64/codepatch.c","codepatch_maprw",70,87
7,2,43,1,6,"codepatch_unmaprw@90-96@sys/arch/amd64/amd64/codepatch.c","sys/arch/amd64/amd64/codepatch.c","codepatch_unmaprw",90,96
17,3,97,1,18,"codepatch_nop@100-118@sys/arch/amd64/amd64/codepatch.c","sys/arch/amd64/amd64/codepatch.c","codepatch_nop",100,118
22,4,146,3,24,"codepatch_replace@122-146@sys/arch/amd64/amd64/codepatch.c","sys/arch/amd64/amd64/codepatch.c","codepatch_replace",122,146
24,4,170,2,26,"codepatch_call@150-176@sys/arch/amd64/amd64/codepatch.c","sys/arch/amd64/amd64/codepatch.c","codepatch_call",150,176
4,3,33,1,4,"iskmemdev@320-324@sys/arch/amd64/amd64/conf.c","sys/arch/amd64/amd64/conf.c","iskmemdev",320,324
4,2,24,1,4,"iszerodev@330-334@sys/arch/amd64/amd64/conf.c","sys/arch/amd64/amd64/conf.c","iszerodev",330,334
4,1,14,1,3,"getnulldev@337-340@sys/arch/amd64/amd64/conf.c","sys/arch/amd64/amd64/conf.c","getnulldev",337,340
14,3,55,1,17,"dev_rawpart@408-425@sys/arch/amd64/amd64/conf.c","sys/arch/amd64/amd64/conf.c","dev_rawpart",408,425
3,1,6,1,3,"consinit@31-34@sys/arch/amd64/amd64/consinit.c","sys/arch/amd64/amd64/consinit.c","consinit",31,34
12,2,56,1,15,"replacesmap@138-153@sys/arch/amd64/amd64/cpu.c","sys/arch/amd64/amd64/cpu.c","replacesmap",138,153
10,3,65,3,12,"cpu_match@192-204@sys/arch/amd64/amd64/cpu.c","sys/arch/amd64/amd64/cpu.c","cpu_match",192,204
25,7,128,1,34,"cpu_vm_init@207-241@sys/arch/amd64/amd64/cpu.c","sys/arch/amd64/amd64/cpu.c","cpu_vm_init",207,241
15,5,104,1,30,"cpu_idle_mwait_cycle@250-280@sys/arch/amd64/amd64/cpu.c","sys/arch/amd64/amd64/cpu.c","cpu_idle_mwait_cycle",250,280
31,11,193,1,39,"cpu_init_mwait@283-322@sys/arch/amd64/amd64/cpu.c","sys/arch/amd64/amd64/cpu.c","cpu_init_mwait",283,322
97,24,590,3,152,"cpu_attach@325-477@sys/arch/amd64/amd64/cpu.c","sys/arch/amd64/amd64/cpu.c","cpu_attach",325,477
36,13,232,1,56,"cpu_init@484-540@sys/arch/amd64/amd64/cpu.c","sys/arch/amd64/amd64/cpu.c","cpu_init",484,540
10,3,66,1,12,"cpu_init_vmm@552-564@sys/arch/amd64/amd64/cpu.c","sys/arch/amd64/amd64/cpu.c","cpu_init_vmm",552,564
18,6,103,1,18,"cpu_boot_secondary_processors@569-587@sys/arch/amd64/amd64/cpu.c","sys/arch/amd64/amd64/cpu.c","cpu_boot_secondary_processors",569,587
15,5,73,1,15,"cpu_init_idle_pcbs@590-605@sys/arch/amd64/amd64/cpu.c","sys/arch/amd64/amd64/cpu.c","cpu_init_idle_pcbs",590,605
27,9,197,1,41,"cpu_start_secondary@608-649@sys/arch/amd64/amd64/cpu.c","sys/arch/amd64/amd64/cpu.c","cpu_start_secondary",608,649
13,5,80,1,16,"cpu_boot_secondary@652-668@sys/arch/amd64/amd64/cpu.c","sys/arch/amd64/amd64/cpu.c","cpu_boot_secondary",652,668
43,12,284,1,73,"cpu_hatch@679-752@sys/arch/amd64/amd64/cpu.c","sys/arch/amd64/amd64/cpu.c","cpu_hatch",679,752
15,2,68,1,15,"cpu_debug_dump@763-778@sys/arch/amd64/amd64/cpu.c","sys/arch/amd64/amd64/cpu.c","cpu_debug_dump",763,778
24,4,149,1,45,"mp_cpu_start@782-827@sys/arch/amd64/amd64/cpu.c","sys/arch/amd64/amd64/cpu.c","mp_cpu_start",782,827
5,1,25,1,8,"mp_cpu_start_cleanup@830-838@sys/arch/amd64/amd64/cpu.c","sys/arch/amd64/amd64/cpu.c","mp_cpu_start_cleanup",830,838
12,1,105,1,12,"cpu_init_msrs@845-857@sys/arch/amd64/amd64/cpu.c","sys/arch/amd64/amd64/cpu.c","cpu_init_msrs",845,857
13,2,99,1,22,"patinit@860-882@sys/arch/amd64/amd64/cpu.c","sys/arch/amd64/amd64/cpu.c","patinit",860,882
27,7,149,1,30,"rdrand@888-918@sys/arch/amd64/amd64/cpu.c","sys/arch/amd64/amd64/cpu.c","rdrand",888,918
11,3,55,2,12,"cpu_activate@921-933@sys/arch/amd64/amd64/cpu.c","sys/arch/amd64/amd64/cpu.c","cpu_activate",921,933
45,10,297,5,48,"db_read_address@903-951@sys/arch/amd64/amd64/db_disasm.c","sys/arch/amd64/amd64/db_disasm.c","db_read_address",903,951
18,7,129,3,19,"db_print_address@954-973@sys/arch/amd64/amd64/db_disasm.c","sys/arch/amd64/amd64/db_disasm.c","db_print_address",954,973
10,1,83,5,13,"db_disasm_3dnow@979-992@sys/arch/amd64/amd64/db_disasm.c","sys/arch/amd64/amd64/db_disasm.c","db_disasm_3dnow",979,992
76,19,458,6,84,"db_disasm_esc@999-1083@sys/arch/amd64/amd64/db_disasm.c","sys/arch/amd64/amd64/db_disasm.c","db_disasm_esc",999,1083
350,98,2024,2,372,"db_disasm@1091-1463@sys/arch/amd64/amd64/db_disasm.c","sys/arch/amd64/amd64/db_disasm.c","db_disasm",1091,1463
9,3,50,2,8,"db_printtrap@96-104@sys/arch/amd64/amd64/db_interface.c","sys/arch/amd64/amd64/db_interface.c","db_printtrap",96,104
40,14,179,3,55,"db_ktrap@110-165@sys/arch/amd64/amd64/db_interface.c","sys/arch/amd64/amd64/db_interface.c","db_ktrap",110,165
31,9,148,4,31,"db_cpuinfo_cmd@170-201@sys/arch/amd64/amd64/db_interface.c","sys/arch/amd64/amd64/db_interface.c","db_cpuinfo_cmd",170,201
16,9,103,4,16,"db_startproc_cmd@204-220@sys/arch/amd64/amd64/db_interface.c","sys/arch/amd64/amd64/db_interface.c","db_startproc_cmd",204,220
16,9,103,4,16,"db_stopproc_cmd@223-239@sys/arch/amd64/amd64/db_interface.c","sys/arch/amd64/amd64/db_interface.c","db_stopproc_cmd",223,239
16,6,86,4,15,"db_ddbproc_cmd@242-257@sys/arch/amd64/amd64/db_interface.c","sys/arch/amd64/amd64/db_interface.c","db_ddbproc_cmd",242,257
52,19,324,1,66,"db_enter_ddb@260-326@sys/arch/amd64/amd64/db_interface.c","sys/arch/amd64/amd64/db_interface.c","db_enter_ddb",260,326
8,3,45,1,7,"db_startcpu@329-336@sys/arch/amd64/amd64/db_interface.c","sys/arch/amd64/amd64/db_interface.c","db_startcpu",329,336
12,4,73,1,11,"db_stopcpu@339-350@sys/arch/amd64/amd64/db_interface.c","sys/arch/amd64/amd64/db_interface.c","db_stopcpu",339,350
4,1,13,1,3,"x86_ipi_db@353-356@sys/arch/amd64/amd64/db_interface.c","sys/arch/amd64/amd64/db_interface.c","x86_ipi_db",353,356
9,5,47,1,13,"db_machine_init@383-396@sys/arch/amd64/amd64/db_interface.c","sys/arch/amd64/amd64/db_interface.c","db_machine_init",383,396
4,1,10,1,3,"db_enter@399-402@sys/arch/amd64/amd64/db_interface.c","sys/arch/amd64/amd64/db_interface.c","db_enter",399,402
19,5,125,3,23,"db_read_bytes@63-86@sys/arch/amd64/amd64/db_memrw.c","sys/arch/amd64/amd64/db_memrw.c","db_read_bytes",63,86
36,8,216,3,64,"db_write_text@93-157@sys/arch/amd64/amd64/db_memrw.c","sys/arch/amd64/amd64/db_memrw.c","db_write_text",93,157
24,7,156,3,30,"db_write_bytes@163-193@sys/arch/amd64/amd64/db_memrw.c","sys/arch/amd64/amd64/db_memrw.c","db_write_bytes",163,193
33,6,202,5,36,"db_nextframe@96-132@sys/arch/amd64/amd64/db_trace.c","sys/arch/amd64/amd64/db_trace.c","db_nextframe",96,132
20,11,123,1,19,"db_is_trap@135-154@sys/arch/amd64/amd64/db_trace.c","sys/arch/amd64/amd64/db_trace.c","db_is_trap",135,154
138,39,897,5,169,"db_stack_trace_print@166-335@sys/arch/amd64/amd64/db_trace.c","sys/arch/amd64/amd64/db_trace.c","db_stack_trace_print",166,335
45,9,271,1,60,"db_save_stack_trace@338-398@sys/arch/amd64/amd64/db_trace.c","sys/arch/amd64/amd64/db_trace.c","db_save_stack_trace",338,398
5,1,49,1,5,"db_get_pc@401-406@sys/arch/amd64/amd64/db_trace.c","sys/arch/amd64/amd64/db_trace.c","db_get_pc",401,406
4,1,16,1,3,"db_get_probe_addr@409-412@sys/arch/amd64/amd64/db_trace.c","sys/arch/amd64/amd64/db_trace.c","db_get_probe_addr",409,412
43,13,306,4,56,"readdisklabel@65-121@sys/arch/amd64/amd64/disksubr.c","sys/arch/amd64/amd64/disksubr.c","readdisklabel",65,121
30,4,213,3,36,"writedisklabel@127-163@sys/arch/amd64/amd64/disksubr.c","sys/arch/amd64/amd64/disksubr.c","writedisklabel",127,163
110,36,790,1,177,"dkcsumattach@53-230@sys/arch/amd64/amd64/dkcsum.c","sys/arch/amd64/amd64/dkcsum.c","dkcsumattach",53,230
14,6,89,3,15,"efifb_match@147-162@sys/arch/amd64/amd64/efifb.c","sys/arch/amd64/amd64/efifb.c","efifb_match",147,162
64,7,479,3,76,"efifb_attach@165-241@sys/arch/amd64/amd64/efifb.c","sys/arch/amd64/amd64/efifb.c","efifb_attach",165,241
28,2,242,1,30,"efifb_rasops_preinit@244-274@sys/arch/amd64/amd64/efifb.c","sys/arch/amd64/amd64/efifb.c","efifb_rasops_preinit",244,274
64,17,330,5,65,"efifb_ioctl@277-342@sys/arch/amd64/amd64/efifb.c","sys/arch/amd64/amd64/efifb.c","efifb_ioctl",277,342
7,3,56,3,8,"efifb_mmap@345-353@sys/arch/amd64/amd64/efifb.c","sys/arch/amd64/amd64/efifb.c","efifb_mmap",345,353
7,1,63,6,7,"efifb_alloc_screen@356-363@sys/arch/amd64/amd64/efifb.c","sys/arch/amd64/amd64/efifb.c","efifb_alloc_screen",356,363
6,1,38,2,6,"efifb_free_screen@366-372@sys/arch/amd64/amd64/efifb.c","sys/arch/amd64/amd64/efifb.c","efifb_free_screen",366,372
7,1,66,5,7,"efifb_show_screen@375-382@sys/arch/amd64/amd64/efifb.c","sys/arch/amd64/amd64/efifb.c","efifb_show_screen",375,382
6,1,48,3,6,"efifb_load_font@385-391@sys/arch/amd64/amd64/efifb.c","sys/arch/amd64/amd64/efifb.c","efifb_load_font",385,391
6,1,42,2,6,"efifb_list_font@394-400@sys/arch/amd64/amd64/efifb.c","sys/arch/amd64/amd64/efifb.c","efifb_list_font",394,400
9,3,52,1,10,"efifb_cnattach@403-413@sys/arch/amd64/amd64/efifb.c","sys/arch/amd64/amd64/efifb.c","efifb_cnattach",403,413
10,1,109,1,9,"efifb_efiinfo_init@416-425@sys/arch/amd64/amd64/efifb.c","sys/arch/amd64/amd64/efifb.c","efifb_efiinfo_init",416,425
18,1,153,1,21,"efifb_cnattach_common@427-448@sys/arch/amd64/amd64/efifb.c","sys/arch/amd64/amd64/efifb.c","efifb_cnattach_common",427,448
23,8,131,1,28,"efifb_is_console@451-479@sys/arch/amd64/amd64/efifb.c","sys/arch/amd64/amd64/efifb.c","efifb_is_console",451,479
4,1,12,1,3,"efifb_cndetach@482-485@sys/arch/amd64/amd64/efifb.c","sys/arch/amd64/amd64/efifb.c","efifb_cndetach",482,485
14,3,102,1,18,"efifb_cb_cnattach@488-506@sys/arch/amd64/amd64/efifb.c","sys/arch/amd64/amd64/efifb.c","efifb_cb_cnattach",488,506
4,2,19,1,3,"efifb_cb_found@509-512@sys/arch/amd64/amd64/efifb.c","sys/arch/amd64/amd64/efifb.c","efifb_cb_found",509,512
12,2,89,2,14,"cb_checksum@515-529@sys/arch/amd64/amd64/efifb.c","sys/arch/amd64/amd64/efifb.c","cb_checksum",515,529
27,8,190,1,35,"cb_find_fb@532-567@sys/arch/amd64/amd64/efifb.c","sys/arch/amd64/amd64/efifb.c","cb_find_fb",532,567
44,9,184,1,44,"p4_get_bus_clock@107-151@sys/arch/amd64/amd64/est.c","sys/arch/amd64/amd64/est.c","p4_get_bus_clock",107,151
65,19,227,1,66,"p3_get_bus_clock@154-220@sys/arch/amd64/amd64/est.c","sys/arch/amd64/amd64/est.c","p3_get_bus_clock",154,220
26,5,175,1,33,"est_acpi_init@227-260@sys/arch/amd64/amd64/est.c","sys/arch/amd64/amd64/est.c","est_acpi_init",227,260
34,6,229,2,39,"est_acpi_pss_changed@263-302@sys/arch/amd64/amd64/est.c","sys/arch/amd64/amd64/est.c","est_acpi_pss_changed",263,302
93,24,640,1,140,"est_init@306-446@sys/arch/amd64/amd64/est.c","sys/arch/amd64/amd64/est.c","est_init",306,446
16,3,103,1,19,"est_setperf@449-468@sys/arch/amd64/amd64/est.c","sys/arch/amd64/amd64/est.c","est_setperf",449,468
15,3,92,1,15,"fpuinit@95-110@sys/arch/amd64/amd64/fpu.c","sys/arch/amd64/amd64/fpu.c","fpuinit",95,110
32,4,196,1,39,"fputrap@120-159@sys/arch/amd64/amd64/fpu.c","sys/arch/amd64/amd64/fpu.c","fputrap",120,159
18,3,75,1,19,"x86fpflags_to_siginfo@162-181@sys/arch/amd64/amd64/fpu.c","sys/arch/amd64/amd64/fpu.c","x86fpflags_to_siginfo",162,181
55,10,346,2,79,"fpudna@191-270@sys/arch/amd64/amd64/fpu.c","sys/arch/amd64/amd64/fpu.c","fpudna",191,270
26,6,150,2,37,"fpusave_cpu@274-311@sys/arch/amd64/amd64/fpu.c","sys/arch/amd64/amd64/fpu.c","fpusave_cpu",274,311
22,6,132,2,27,"fpusave_proc@317-344@sys/arch/amd64/amd64/fpu.c","sys/arch/amd64/amd64/fpu.c","fpusave_proc",317,344
24,3,140,1,37,"fpu_kernel_enter@347-384@sys/arch/amd64/amd64/fpu.c","sys/arch/amd64/amd64/fpu.c","fpu_kernel_enter",347,384
4,1,10,1,4,"fpu_kernel_exit@387-391@sys/arch/amd64/amd64/fpu.c","sys/arch/amd64/amd64/fpu.c","fpu_kernel_exit",387,391
20,3,183,1,20,"gdt_alloc_cpu@51-71@sys/arch/amd64/amd64/gdt.c","sys/arch/amd64/amd64/gdt.c","gdt_alloc_cpu",51,71
9,1,73,1,10,"gdt_init_cpu@79-89@sys/arch/amd64/amd64/gdt.c","sys/arch/amd64/amd64/gdt.c","gdt_init_cpu",79,89
34,21,285,1,46,"get_hibernate_io_function@74-120@sys/arch/amd64/amd64/hibernate_machdep.c","sys/arch/amd64/amd64/hibernate_machdep.c","get_hibernate_io_function",74,120
56,11,467,1,74,"get_hibernate_info_md@126-200@sys/arch/amd64/amd64/hibernate_machdep.c","sys/arch/amd64/amd64/hibernate_machdep.c","get_hibernate_info_md",126,200
7,2,34,3,6,"hibernate_enter_resume_mapping@210-216@sys/arch/amd64/amd64/hibernate_machdep.c","sys/arch/amd64/amd64/hibernate_machdep.c","hibernate_enter_resume_mapping",210,216
36,3,280,2,45,"hibernate_enter_resume_2m_pde@222-267@sys/arch/amd64/amd64/hibernate_machdep.c","sys/arch/amd64/amd64/hibernate_machdep.c","hibernate_enter_resume_2m_pde",222,267
9,1,66,2,12,"hibernate_enter_resume_4k_pte@273-285@sys/arch/amd64/amd64/hibernate_machdep.c","sys/arch/amd64/amd64/hibernate_machdep.c","hibernate_enter_resume_4k_pte",273,285
74,4,604,3,106,"hibernate_populate_resume_pt@294-400@sys/arch/amd64/amd64/hibernate_machdep.c","sys/arch/amd64/amd64/hibernate_machdep.c","hibernate_populate_resume_pt",294,400
7,3,42,2,7,"hibernate_inflate_skip@410-417@sys/arch/amd64/amd64/hibernate_machdep.c","sys/arch/amd64/amd64/hibernate_machdep.c","hibernate_inflate_skip",410,417
4,1,10,1,3,"hibernate_enable_intr_machdep@420-423@sys/arch/amd64/amd64/hibernate_machdep.c","sys/arch/amd64/amd64/hibernate_machdep.c","hibernate_enable_intr_machdep",420,423
4,1,10,1,3,"hibernate_disable_intr_machdep@426-429@sys/arch/amd64/amd64/hibernate_machdep.c","sys/arch/amd64/amd64/hibernate_machdep.c","hibernate_disable_intr_machdep",426,429
24,6,147,1,29,"hibernate_quiesce_cpus@439-468@sys/arch/amd64/amd64/hibernate_machdep.c","sys/arch/amd64/amd64/hibernate_machdep.c","hibernate_quiesce_cpus",439,468
20,4,160,1,30,"i8259_default_setup@108-138@sys/arch/amd64/amd64/i8259.c","sys/arch/amd64/amd64/i8259.c","i8259_default_setup",108,138
15,3,75,2,17,"i8259_hwmask@141-158@sys/arch/amd64/amd64/i8259.c","sys/arch/amd64/amd64/i8259.c","i8259_hwmask",141,158
17,3,83,2,19,"i8259_hwunmask@161-180@sys/arch/amd64/amd64/i8259.c","sys/arch/amd64/amd64/i8259.c","i8259_hwunmask",161,180
14,4,92,1,15,"i8259_reinit_irqs@183-198@sys/arch/amd64/amd64/i8259.c","sys/arch/amd64/amd64/i8259.c","i8259_reinit_irqs",183,198
5,2,34,5,4,"i8259_setup@201-205@sys/arch/amd64/amd64/i8259.c","sys/arch/amd64/amd64/i8259.c","i8259_setup",201,205
5,1,18,1,4,"cpu_amd64speed@210-214@sys/arch/amd64/amd64/identcpu.c","sys/arch/amd64/amd64/identcpu.c","cpu_amd64speed",210,214
25,10,168,1,35,"intelcore_update_sensor@233-268@sys/arch/amd64/amd64/identcpu.c","sys/arch/amd64/amd64/identcpu.c","intelcore_update_sensor",233,268
64,18,399,1,85,"via_nano_setup@279-364@sys/arch/amd64/amd64/identcpu.c","sys/arch/amd64/amd64/identcpu.c","via_nano_setup",279,364
10,1,66,1,11,"via_update_sensor@369-380@sys/arch/amd64/amd64/identcpu.c","sys/arch/amd64/amd64/identcpu.c","via_update_sensor",369,380
26,5,176,1,34,"cpu_freq_ctr@384-418@sys/arch/amd64/amd64/identcpu.c","sys/arch/amd64/amd64/identcpu.c","cpu_freq_ctr",384,418
11,2,60,1,13,"cpu_freq@421-434@sys/arch/amd64/amd64/identcpu.c","sys/arch/amd64/amd64/identcpu.c","cpu_freq",421,434
188,77,1602,1,248,"identifycpu@437-685@sys/arch/amd64/amd64/identcpu.c","sys/arch/amd64/amd64/identcpu.c","identifycpu",437,685
7,2,28,1,8,"log2@692-700@sys/arch/amd64/amd64/identcpu.c","sys/arch/amd64/amd64/identcpu.c","log2",692,700
13,3,85,1,16,"mask_width@703-719@sys/arch/amd64/amd64/identcpu.c","sys/arch/amd64/amd64/identcpu.c","mask_width",703,719
54,8,436,1,77,"cpu_topology@726-803@sys/arch/amd64/amd64/identcpu.c","sys/arch/amd64/amd64/identcpu.c","cpu_topology",726,803
65,17,446,1,104,"cpu_check_vmm_cap@816-920@sys/arch/amd64/amd64/identcpu.c","sys/arch/amd64/amd64/identcpu.c","cpu_check_vmm_cap",816,920
11,2,68,1,16,"intr_default_setup@81-97@sys/arch/amd64/amd64/intr.c","sys/arch/amd64/amd64/intr.c","intr_default_setup",81,97
5,1,28,1,4,"x86_nmi@104-108@sys/arch/amd64/amd64/intr.c","sys/arch/amd64/amd64/intr.c","x86_nmi",104,108
45,15,363,1,53,"intr_calculatemasks@114-167@sys/arch/amd64/amd64/intr.c","sys/arch/amd64/amd64/intr.c","intr_calculatemasks",114,167
43,15,264,4,46,"intr_allocate_slot_cpu@170-216@sys/arch/amd64/amd64/intr.c","sys/arch/amd64/amd64/intr.c","intr_allocate_slot_cpu",170,216
7,2,31,1,9,"ioapic_lock@108-117@sys/arch/amd64/amd64/ioapic.c","sys/arch/amd64/amd64/ioapic.c","ioapic_lock",108,117
5,2,27,2,6,"ioapic_unlock@120-126@sys/arch/amd64/amd64/ioapic.c","sys/arch/amd64/amd64/ioapic.c","ioapic_unlock",120,126
7,1,36,2,8,"ioapic_read_ul@132-140@sys/arch/amd64/amd64/ioapic.c","sys/arch/amd64/amd64/ioapic.c","ioapic_read_ul",132,140
5,1,33,3,4,"ioapic_write_ul@143-147@sys/arch/amd64/amd64/ioapic.c","sys/arch/amd64/amd64/ioapic.c","ioapic_write_ul",143,147
9,1,44,2,9,"ioapic_read@150-159@sys/arch/amd64/amd64/ioapic.c","sys/arch/amd64/amd64/ioapic.c","ioapic_read",150,159
7,1,41,3,7,"ioapic_write@162-169@sys/arch/amd64/amd64/ioapic.c","sys/arch/amd64/amd64/ioapic.c","ioapic_write",162,169
13,5,70,1,19,"ioapic_find@172-191@sys/arch/amd64/amd64/ioapic.c","sys/arch/amd64/amd64/ioapic.c","ioapic_find",172,191
10,4,56,1,11,"ioapic_find_bybase@198-209@sys/arch/amd64/amd64/ioapic.c","sys/arch/amd64/amd64/ioapic.c","ioapic_find_bybase",198,209
6,1,22,1,5,"ioapic_add@212-217@sys/arch/amd64/amd64/ioapic.c","sys/arch/amd64/amd64/ioapic.c","ioapic_add",212,217
6,1,59,3,6,"ioapic_print_redir@220-226@sys/arch/amd64/amd64/ioapic.c","sys/arch/amd64/amd64/ioapic.c","ioapic_print_redir",220,226
8,2,63,3,8,"ioapic_match@238-246@sys/arch/amd64/amd64/ioapic.c","sys/arch/amd64/amd64/ioapic.c","ioapic_match",238,246
13,2,82,1,15,"ioapic_set_id@250-265@sys/arch/amd64/amd64/ioapic.c","sys/arch/amd64/amd64/ioapic.c","ioapic_set_id",250,265
66,13,502,3,95,"ioapic_attach@271-366@sys/arch/amd64/amd64/ioapic.c","sys/arch/amd64/amd64/ioapic.c","ioapic_attach",271,366
11,2,65,2,13,"ioapic_activate@369-382@sys/arch/amd64/amd64/ioapic.c","sys/arch/amd64/amd64/ioapic.c","ioapic_activate",369,382
39,10,254,4,55,"apic_set_redir@385-440@sys/arch/amd64/amd64/ioapic.c","sys/arch/amd64/amd64/ioapic.c","apic_set_redir",385,440
25,7,149,1,29,"ioapic_enable@447-476@sys/arch/amd64/amd64/ioapic.c","sys/arch/amd64/amd64/ioapic.c","ioapic_enable",447,476
14,2,82,2,14,"ioapic_hwmask@479-493@sys/arch/amd64/amd64/ioapic.c","sys/arch/amd64/amd64/ioapic.c","ioapic_hwmask",479,493
14,2,82,2,14,"ioapic_hwunmask@496-510@sys/arch/amd64/amd64/ioapic.c","sys/arch/amd64/amd64/ioapic.c","ioapic_hwunmask",496,510
13,2,85,5,13,"ioapic_addroute@513-526@sys/arch/amd64/amd64/ioapic.c","sys/arch/amd64/amd64/ioapic.c","ioapic_addroute",513,526
12,2,71,5,12,"ioapic_delroute@529-541@sys/arch/amd64/amd64/ioapic.c","sys/arch/amd64/amd64/ioapic.c","ioapic_delroute",529,541
13,4,81,1,13,"ioapic_dump@547-560@sys/arch/amd64/amd64/ioapic.c","sys/arch/amd64/amd64/ioapic.c","ioapic_dump",547,560
7,2,46,2,9,"x86_send_ipi@46-55@sys/arch/amd64/amd64/ipi.c","sys/arch/amd64/amd64/ipi.c","x86_send_ipi",46,55
7,2,42,2,8,"x86_fast_ipi@58-66@sys/arch/amd64/amd64/ipi.c","sys/arch/amd64/amd64/ipi.c","x86_fast_ipi",58,66
17,4,86,1,18,"x86_broadcast_ipi@69-87@sys/arch/amd64/amd64/ipi.c","sys/arch/amd64/amd64/ipi.c","x86_broadcast_ipi",69,87
19,4,116,1,21,"x86_ipi_handler@90-111@sys/arch/amd64/amd64/ipi.c","sys/arch/amd64/amd64/ipi.c","x86_ipi_handler",90,111
3,1,9,1,2,"x86_64_ipi_nop@108-110@sys/arch/amd64/amd64/ipifuncs.c","sys/arch/amd64/amd64/ipifuncs.c","x86_64_ipi_nop",108,110
14,2,63,1,15,"x86_64_ipi_halt@113-128@sys/arch/amd64/amd64/ipifuncs.c","sys/arch/amd64/amd64/ipifuncs.c","x86_64_ipi_halt",113,128
5,2,26,1,4,"x86_64_ipi_flush_fpu@131-135@sys/arch/amd64/amd64/ipifuncs.c","sys/arch/amd64/amd64/ipifuncs.c","x86_64_ipi_flush_fpu",131,135
5,2,26,1,4,"x86_64_ipi_synch_fpu@138-142@sys/arch/amd64/amd64/ipifuncs.c","sys/arch/amd64/amd64/ipifuncs.c","x86_64_ipi_synch_fpu",138,142
5,2,27,1,4,"x86_64_ipi_reload_mtrr@146-150@sys/arch/amd64/amd64/ipifuncs.c","sys/arch/amd64/amd64/ipifuncs.c","x86_64_ipi_reload_mtrr",146,150
4,1,14,1,3,"x86_64_ipi_start_vmm@155-158@sys/arch/amd64/amd64/ipifuncs.c","sys/arch/amd64/amd64/ipifuncs.c","x86_64_ipi_start_vmm",155,158
4,1,14,1,3,"x86_64_ipi_stop_vmm@161-164@sys/arch/amd64/amd64/ipifuncs.c","sys/arch/amd64/amd64/ipifuncs.c","x86_64_ipi_stop_vmm",161,164
10,2,60,1,12,"k1x_setperf@80-92@sys/arch/amd64/amd64/k1x-pstate.c","sys/arch/amd64/amd64/k1x-pstate.c","k1x_setperf",80,92
25,7,153,2,29,"k1x_transition@95-124@sys/arch/amd64/amd64/k1x-pstate.c","sys/arch/amd64/amd64/k1x-pstate.c","k1x_transition",95,124
21,4,152,3,21,"k1x_acpi_states@129-150@sys/arch/amd64/amd64/k1x-pstate.c","sys/arch/amd64/amd64/k1x-pstate.c","k1x_acpi_states",129,150
9,2,47,1,11,"k1x_acpi_init@153-164@sys/arch/amd64/amd64/k1x-pstate.c","sys/arch/amd64/amd64/k1x-pstate.c","k1x_acpi_init",153,164
27,6,150,1,32,"k1x_init@169-201@sys/arch/amd64/amd64/k1x-pstate.c","sys/arch/amd64/amd64/k1x-pstate.c","k1x_init",169,201
5,1,29,1,4,"i82489_readreg@111-115@sys/arch/amd64/amd64/lapic.c","sys/arch/amd64/amd64/lapic.c","i82489_readreg",111,115
4,1,15,1,3,"i82489_cpu_number@118-121@sys/arch/amd64/amd64/lapic.c","sys/arch/amd64/amd64/lapic.c","i82489_cpu_number",118,121
5,1,33,2,4,"i82489_writereg@124-128@sys/arch/amd64/amd64/lapic.c","sys/arch/amd64/amd64/lapic.c","i82489_writereg",124,128
4,1,20,1,3,"x2apic_readreg@131-134@sys/arch/amd64/amd64/lapic.c","sys/arch/amd64/amd64/lapic.c","x2apic_readreg",131,134
4,1,14,1,3,"x2apic_cpu_number@137-140@sys/arch/amd64/amd64/lapic.c","sys/arch/amd64/amd64/lapic.c","x2apic_cpu_number",137,140
4,1,24,2,3,"x2apic_writereg@143-146@sys/arch/amd64/amd64/lapic.c","sys/arch/amd64/amd64/lapic.c","x2apic_writereg",143,146
5,1,44,2,4,"x2apic_writeicr@150-154@sys/arch/amd64/amd64/lapic.c","sys/arch/amd64/amd64/lapic.c","x2apic_writeicr",150,154
6,2,20,1,5,"lapic_cpu_number@158-163@sys/arch/amd64/amd64/lapic.c","sys/arch/amd64/amd64/lapic.c","lapic_cpu_number",158,163
31,6,162,1,57,"lapic_map@167-224@sys/arch/amd64/amd64/lapic.c","sys/arch/amd64/amd64/lapic.c","lapic_map",167,224
4,1,15,1,3,"lapic_enable@230-233@sys/arch/amd64/amd64/lapic.c","sys/arch/amd64/amd64/lapic.c","lapic_enable",230,233
4,1,13,1,3,"lapic_disable@236-239@sys/arch/amd64/amd64/lapic.c","sys/arch/amd64/amd64/lapic.c","lapic_disable",236,239
54,18,367,1,82,"lapic_set_lvt@242-324@sys/arch/amd64/amd64/lapic.c","sys/arch/amd64/amd64/lapic.c","lapic_set_lvt",242,324
24,6,158,1,40,"lapic_boot_init@330-370@sys/arch/amd64/amd64/lapic.c","sys/arch/amd64/amd64/lapic.c","lapic_boot_init",330,370
4,1,12,1,3,"lapic_gettick@373-376@sys/arch/amd64/amd64/lapic.c","sys/arch/amd64/amd64/lapic.c","lapic_gettick",373,376
10,1,60,2,11,"lapic_clockintr@391-402@sys/arch/amd64/amd64/lapic.c","sys/arch/amd64/amd64/lapic.c","lapic_clockintr",391,402
7,1,38,1,13,"lapic_startclock@405-418@sys/arch/amd64/amd64/lapic.c","sys/arch/amd64/amd64/lapic.c","lapic_startclock",405,418
5,1,14,1,5,"lapic_initclocks@421-426@sys/arch/amd64/amd64/lapic.c","sys/arch/amd64/amd64/lapic.c","lapic_initclocks",421,426
11,3,46,1,11,"wait_next_cycle@433-444@sys/arch/amd64/amd64/lapic.c","sys/arch/amd64/amd64/lapic.c","wait_next_cycle",433,444
42,5,287,1,86,"lapic_calibrate_timer@458-544@sys/arch/amd64/amd64/lapic.c","sys/arch/amd64/amd64/lapic.c","lapic_calibrate_timer",458,544
21,5,99,1,24,"lapic_delay@551-575@sys/arch/amd64/amd64/lapic.c","sys/arch/amd64/amd64/lapic.c","lapic_delay",551,575
10,5,50,1,14,"i82489_icr_wait@585-599@sys/arch/amd64/amd64/lapic.c","sys/arch/amd64/amd64/lapic.c","i82489_icr_wait",585,599
12,2,72,1,17,"i82489_ipi_init@602-619@sys/arch/amd64/amd64/lapic.c","sys/arch/amd64/amd64/lapic.c","i82489_ipi_init",602,619
12,2,72,3,17,"i82489_ipi@622-639@sys/arch/amd64/amd64/lapic.c","sys/arch/amd64/amd64/lapic.c","i82489_ipi",622,639
11,2,65,1,14,"x2apic_ipi_init@642-656@sys/arch/amd64/amd64/lapic.c","sys/arch/amd64/amd64/lapic.c","x2apic_ipi_init",642,656
8,2,57,3,10,"x2apic_ipi@659-669@sys/arch/amd64/amd64/lapic.c","sys/arch/amd64/amd64/lapic.c","x2apic_ipi",659,669
7,2,22,1,6,"x86_ipi_init@672-678@sys/arch/amd64/amd64/lapic.c","sys/arch/amd64/amd64/lapic.c","x86_ipi_init",672,678
9,1,47,2,9,"lapic_hwmask@693-702@sys/arch/amd64/amd64/lapic.c","sys/arch/amd64/amd64/lapic.c","lapic_hwmask",693,702
9,1,47,2,9,"lapic_hwunmask@705-714@sys/arch/amd64/amd64/lapic.c","sys/arch/amd64/amd64/lapic.c","lapic_hwunmask",705,714
3,1,23,5,2,"lapic_setup@717-719@sys/arch/amd64/amd64/lapic.c","sys/arch/amd64/amd64/lapic.c","lapic_setup",717,719
22,3,147,1,25,"viac3_crypto_setup@84-109@sys/arch/amd64/amd64/via.c","sys/arch/amd64/amd64/via.c","viac3_crypto_setup",84,109
133,28,884,2,152,"viac3_crypto_newsession@112-264@sys/arch/amd64/amd64/via.c","sys/arch/amd64/amd64/via.c","viac3_crypto_newsession",112,264
28,6,203,1,31,"viac3_crypto_freesession@267-298@sys/arch/amd64/amd64/via.c","sys/arch/amd64/amd64/via.c","viac3_crypto_freesession",267,298
12,1,100,6,15,"viac3_cbc@301-316@sys/arch/amd64/amd64/via.c","sys/arch/amd64/amd64/via.c","viac3_cbc",301,316
10,2,58,4,11,"viac3_crypto_swauth@319-330@sys/arch/amd64/amd64/via.c","sys/arch/amd64/amd64/via.c","viac3_crypto_swauth",319,330
78,17,654,5,86,"viac3_crypto_encdec@333-419@sys/arch/amd64/amd64/via.c","sys/arch/amd64/amd64/via.c","viac3_crypto_encdec",333,419
49,16,258,1,53,"viac3_crypto_process@422-475@sys/arch/amd64/amd64/via.c","sys/arch/amd64/amd64/via.c","viac3_crypto_process",422,475
17,4,141,1,31,"viac3_rnd@505-536@sys/arch/amd64/amd64/via.c","sys/arch/amd64/amd64/via.c","viac3_rnd",505,536
24,3,179,1,43,"cpu_startup@268-311@sys/arch/amd64/amd64/machdep.c","sys/arch/amd64/amd64/machdep.c","cpu_startup",268,311
15,1,127,1,18,"x86_64_proc0_tss_ldt_init@317-335@sys/arch/amd64/amd64/machdep.c","sys/arch/amd64/amd64/machdep.c","x86_64_proc0_tss_ldt_init",317,335
8,1,67,1,9,"x86_64_init_pcb_tss_ldt@343-352@sys/arch/amd64/amd64/machdep.c","sys/arch/amd64/amd64/machdep.c","x86_64_init_pcb_tss_ldt",343,352
19,7,89,1,21,"bios_getdiskinfo@356-377@sys/arch/amd64/amd64/machdep.c","sys/arch/amd64/amd64/machdep.c","bios_getdiskinfo",356,377
28,10,187,7,32,"bios_sysctl@380-412@sys/arch/amd64/amd64/machdep.c","sys/arch/amd64/amd64/machdep.c","bios_sysctl",380,412
77,27,505,7,84,"cpu_sysctl@418-502@sys/arch/amd64/amd64/machdep.c","sys/arch/amd64/amd64/machdep.c","cpu_sysctl",418,502
51,9,481,6,65,"sendsig@515-580@sys/arch/amd64/amd64/machdep.c","sys/arch/amd64/amd64/machdep.c","sendsig",515,580
39,9,339,3,61,"sys_sigreturn@593-654@sys/arch/amd64/amd64/machdep.c","sys/arch/amd64/amd64/machdep.c","sys_sigreturn",593,654
14,4,67,1,19,"cpu_kick@659-678@sys/arch/amd64/amd64/machdep.c","sys/arch/amd64/amd64/machdep.c","cpu_kick",659,678
5,1,21,1,4,"signotify@686-690@sys/arch/amd64/amd64/machdep.c","sys/arch/amd64/amd64/machdep.c","signotify",686,690
9,4,52,1,13,"cpu_unidle@694-707@sys/arch/amd64/amd64/machdep.c","sys/arch/amd64/amd64/machdep.c","cpu_unidle",694,707
49,15,237,1,63,"boot@714-777@sys/arch/amd64/amd64/machdep.c","sys/arch/amd64/amd64/machdep.c","boot",714,777
31,3,270,1,49,"cpu_dump@790-839@sys/arch/amd64/amd64/machdep.c","sys/arch/amd64/amd64/machdep.c","cpu_dump",790,839
17,6,101,1,24,"dumpconf@849-873@sys/arch/amd64/amd64/machdep.c","sys/arch/amd64/amd64/machdep.c","dumpconf",849,873
87,22,493,1,115,"dumpsys@883-998@sys/arch/amd64/amd64/machdep.c","sys/arch/amd64/amd64/machdep.c","dumpsys",883,998
10,2,45,1,16,"reset_segs@1006-1022@sys/arch/amd64/amd64/machdep.c","sys/arch/amd64/amd64/machdep.c","reset_segs",1006,1022
33,2,222,4,37,"setregs@1028-1065@sys/arch/amd64/amd64/machdep.c","sys/arch/amd64/amd64/machdep.c","setregs",1028,1065
15,1,102,6,14,"setgate@1076-1090@sys/arch/amd64/amd64/machdep.c","sys/arch/amd64/amd64/machdep.c","setgate",1076,1090
4,1,22,1,3,"unsetgate@1093-1096@sys/arch/amd64/amd64/machdep.c","sys/arch/amd64/amd64/machdep.c","unsetgate",1093,1096
5,1,31,3,4,"setregion@1099-1103@sys/arch/amd64/amd64/machdep.c","sys/arch/amd64/amd64/machdep.c","setregion",1099,1103
15,1,117,8,14,"set_mem_segment@1109-1123@sys/arch/amd64/amd64/machdep.c","sys/arch/amd64/amd64/machdep.c","set_mem_segment",1109,1123
13,1,102,6,12,"set_sys_segment@1126-1138@sys/arch/amd64/amd64/machdep.c","sys/arch/amd64/amd64/machdep.c","set_sys_segment",1126,1138
6,1,36,1,6,"cpu_init_idt@1140-1146@sys/arch/amd64/amd64/machdep.c","sys/arch/amd64/amd64/machdep.c","cpu_init_idt",1140,1146
17,4,98,1,25,"cpu_init_extents@1149-1174@sys/arch/amd64/amd64/machdep.c","sys/arch/amd64/amd64/machdep.c","cpu_init_extents",1149,1174
32,4,193,1,56,"map_tramps@1179-1235@sys/arch/amd64/amd64/machdep.c","sys/arch/amd64/amd64/machdep.c","map_tramps",1179,1235
191,61,1510,1,363,"init_x86_64@1243-1606@sys/arch/amd64/amd64/machdep.c","sys/arch/amd64/amd64/machdep.c","init_x86_64",1243,1606
14,3,93,1,28,"cpu_reset@1609-1637@sys/arch/amd64/amd64/machdep.c","sys/arch/amd64/amd64/machdep.c","cpu_reset",1609,1637
9,2,57,1,10,"cpu_dumpsize@1643-1653@sys/arch/amd64/amd64/machdep.c","sys/arch/amd64/amd64/machdep.c","cpu_dumpsize",1643,1653
8,2,45,1,8,"cpu_dump_mempagecnt@1659-1667@sys/arch/amd64/amd64/machdep.c","sys/arch/amd64/amd64/machdep.c","cpu_dump_mempagecnt",1659,1667
11,6,65,1,23,"amd64_pa_used@1673-1696@sys/arch/amd64/amd64/machdep.c","sys/arch/amd64/amd64/machdep.c","amd64_pa_used",1673,1696
4,1,13,1,3,"cpu_initclocks@1699-1702@sys/arch/amd64/amd64/machdep.c","sys/arch/amd64/amd64/machdep.c","cpu_initclocks",1699,1702
8,2,35,1,9,"need_resched@1705-1714@sys/arch/amd64/amd64/machdep.c","sys/arch/amd64/amd64/machdep.c","need_resched",1705,1714
11,3,52,2,11,"idt_vec_alloc@1722-1733@sys/arch/amd64/amd64/machdep.c","sys/arch/amd64/amd64/machdep.c","idt_vec_alloc",1722,1733
6,1,50,2,8,"idt_vec_set@1736-1744@sys/arch/amd64/amd64/machdep.c","sys/arch/amd64/amd64/machdep.c","idt_vec_set",1736,1744
5,1,23,1,4,"idt_vec_free@1747-1751@sys/arch/amd64/amd64/machdep.c","sys/arch/amd64/amd64/machdep.c","idt_vec_free",1747,1751
11,3,64,2,12,"splassert_check@1755-1767@sys/arch/amd64/amd64/machdep.c","sys/arch/amd64/amd64/machdep.c","splassert_check",1755,1767
6,2,38,2,7,"copyin32@1771-1778@sys/arch/amd64/amd64/machdep.c","sys/arch/amd64/amd64/machdep.c","copyin32",1771,1778
87,32,505,2,119,"getbootinfo@1781-1900@sys/arch/amd64/amd64/machdep.c","sys/arch/amd64/amd64/machdep.c","getbootinfo",1781,1900
15,5,91,2,19,"check_context@1903-1922@sys/arch/amd64/amd64/machdep.c","sys/arch/amd64/amd64/machdep.c","check_context",1903,1922
4,1,22,3,3,"mainbus_match@146-149@sys/arch/amd64/amd64/mainbus.c","sys/arch/amd64/amd64/mainbus.c","mainbus_match",146,149
65,24,456,3,107,"mainbus_attach@155-262@sys/arch/amd64/amd64/mainbus.c","sys/arch/amd64/amd64/mainbus.c","mainbus_attach",155,262
9,3,64,2,10,"mainbus_print@265-275@sys/arch/amd64/amd64/mainbus.c","sys/arch/amd64/amd64/mainbus.c","mainbus_print",265,275
24,13,114,4,29,"mmopen@79-108@sys/arch/amd64/amd64/mem.c","sys/arch/amd64/amd64/mem.c","mmopen",79,108
6,3,36,4,7,"mmclose@111-118@sys/arch/amd64/amd64/mem.c","sys/arch/amd64/amd64/mem.c","mmclose",111,118
59,20,363,3,69,"mmrw@121-190@sys/arch/amd64/amd64/mem.c","sys/arch/amd64/amd64/mem.c","mmrw",121,190
31,15,147,3,42,"mmmmap@193-235@sys/arch/amd64/amd64/mem.c","sys/arch/amd64/amd64/mem.c","mmmmap",193,235
9,4,55,5,10,"mmioctl@238-248@sys/arch/amd64/amd64/mem.c","sys/arch/amd64/amd64/mem.c","mmioctl",238,248
39,10,301,5,46,"mem_ioctl@258-304@sys/arch/amd64/amd64/mem.c","sys/arch/amd64/amd64/mem.c","mem_ioctl",258,304
11,3,70,2,12,"mem_range_attr_get@311-323@sys/arch/amd64/amd64/mem.c","sys/arch/amd64/amd64/mem.c","mem_range_attr_get",311,323
6,2,43,2,7,"mem_range_attr_set@326-333@sys/arch/amd64/amd64/mem.c","sys/arch/amd64/amd64/mem.c","mem_range_attr_set",326,333
8,1,33,1,9,"mp_setperf@36-45@sys/arch/amd64/amd64/mp_setperf.c","sys/arch/amd64/amd64/mp_setperf.c","mp_setperf",36,45
4,1,14,1,3,"x86_setperf_ipi@48-51@sys/arch/amd64/amd64/mp_setperf.c","sys/arch/amd64/amd64/mp_setperf.c","x86_setperf_ipi",48,51
8,2,29,1,8,"mp_setperf_init@54-62@sys/arch/amd64/amd64/mp_setperf.c","sys/arch/amd64/amd64/mp_setperf.c","mp_setperf_init",54,62
8,2,58,3,8,"mpbios_match@196-204@sys/arch/amd64/amd64/mpbios.c","sys/arch/amd64/amd64/mpbios.c","mpbios_match",196,204
4,1,23,3,3,"mpbios_attach@207-210@sys/arch/amd64/amd64/mpbios.c","sys/arch/amd64/amd64/mpbios.c","mpbios_attach",207,210
7,2,40,2,7,"mp_print@213-220@sys/arch/amd64/amd64/mpbios.c","sys/arch/amd64/amd64/mpbios.c","mp_print",213,220
8,2,68,3,9,"mp_match@223-232@sys/arch/amd64/amd64/mpbios.c","sys/arch/amd64/amd64/mpbios.c","mp_match",223,232
18,2,125,3,20,"mpbios_map@239-259@sys/arch/amd64/amd64/mpbios.c","sys/arch/amd64/amd64/mpbios.c","mpbios_map",239,259
5,1,33,1,4,"mpbios_unmap@262-266@sys/arch/amd64/amd64/mpbios.c","sys/arch/amd64/amd64/mpbios.c","mpbios_unmap",262,266
79,17,441,1,109,"mpbios_probe@272-381@sys/arch/amd64/amd64/mpbios.c","sys/arch/amd64/amd64/mpbios.c","mpbios_probe",272,381
9,2,49,2,10,"mpbios_cksum@389-399@sys/arch/amd64/amd64/mpbios.c","sys/arch/amd64/amd64/mpbios.c","mpbios_cksum",389,399
22,5,189,4,27,"mpbios_search@411-438@sys/arch/amd64/amd64/mpbios.c","sys/arch/amd64/amd64/mpbios.c","mpbios_search",411,438
108,26,603,1,139,"mpbios_scan@491-630@sys/arch/amd64/amd64/mpbios.c","sys/arch/amd64/amd64/mpbios.c","mpbios_scan",491,630
18,4,115,2,26,"mpbios_cpu@633-659@sys/arch/amd64/amd64/mpbios.c","sys/arch/amd64/amd64/mpbios.c","mpbios_cpu",633,659
20,4,100,2,32,"mp_cfg_special_intr@668-700@sys/arch/amd64/amd64/mpbios.c","sys/arch/amd64/amd64/mpbios.c","mp_cfg_special_intr",668,700
33,8,152,2,35,"mp_cfg_pci_intr@705-740@sys/arch/amd64/amd64/mpbios.c","sys/arch/amd64/amd64/mpbios.c","mp_cfg_pci_intr",705,740
40,9,189,2,46,"mp_cfg_eisa_intr@744-790@sys/arch/amd64/amd64/mpbios.c","sys/arch/amd64/amd64/mpbios.c","mp_cfg_eisa_intr",744,790
33,8,152,2,35,"mp_cfg_isa_intr@795-830@sys/arch/amd64/amd64/mpbios.c","sys/arch/amd64/amd64/mpbios.c","mp_cfg_isa_intr",795,830
3,1,7,1,2,"mp_print_special_intr@834-836@sys/arch/amd64/amd64/mpbios.c","sys/arch/amd64/amd64/mpbios.c","mp_print_special_intr",834,836
4,1,29,1,3,"mp_print_pci_intr@839-842@sys/arch/amd64/amd64/mpbios.c","sys/arch/amd64/amd64/mpbios.c","mp_print_pci_intr",839,842
4,1,14,1,3,"mp_print_isa_intr@845-848@sys/arch/amd64/amd64/mpbios.c","sys/arch/amd64/amd64/mpbios.c","mp_print_isa_intr",845,848
4,1,14,1,3,"mp_print_eisa_intr@852-855@sys/arch/amd64/amd64/mpbios.c","sys/arch/amd64/amd64/mpbios.c","mp_print_eisa_intr",852,855
42,9,325,2,55,"mpbios_bus@867-922@sys/arch/amd64/amd64/mpbios.c","sys/arch/amd64/amd64/mpbios.c","mpbios_bus",867,922
15,3,124,2,18,"mpbios_ioapic@926-944@sys/arch/amd64/amd64/mpbios.c","sys/arch/amd64/amd64/mpbios.c","mpbios_ioapic",926,944
93,17,544,3,114,"mpbios_int@947-1061@sys/arch/amd64/amd64/mpbios.c","sys/arch/amd64/amd64/mpbios.c","mpbios_int",947,1061
9,4,58,1,10,"mpbios_icu_lookup@54-64@sys/arch/amd64/amd64/mpbios_intr_fixup.c","sys/arch/amd64/amd64/mpbios_intr_fixup.c","mpbios_icu_lookup",54,64
23,6,194,2,25,"nforce4_mpbios_fixup@85-110@sys/arch/amd64/amd64/mpbios_intr_fixup.c","sys/arch/amd64/amd64/mpbios_intr_fixup.c","nforce4_mpbios_fixup",85,110
13,3,99,2,14,"mcp04_mpbios_fixup@117-131@sys/arch/amd64/amd64/mpbios_intr_fixup.c","sys/arch/amd64/amd64/mpbios_intr_fixup.c","mcp04_mpbios_fixup",117,131
6,1,38,2,8,"via8237_mpbios_fixup@138-146@sys/arch/amd64/amd64/mpbios_intr_fixup.c","sys/arch/amd64/amd64/mpbios_intr_fixup.c","via8237_mpbios_fixup",138,146
24,7,196,4,30,"mpbios_pin_fixup@149-179@sys/arch/amd64/amd64/mpbios_intr_fixup.c","sys/arch/amd64/amd64/mpbios_intr_fixup.c","mpbios_pin_fixup",149,179
37,11,243,1,49,"mpbios_intr_fixup@182-231@sys/arch/amd64/amd64/mpbios_intr_fixup.c","sys/arch/amd64/amd64/mpbios_intr_fixup.c","mpbios_intr_fixup",182,231
16,8,124,1,20,"mem_range_attach@39-59@sys/arch/amd64/amd64/mtrr.c","sys/arch/amd64/amd64/mtrr.c","mem_range_attach",39,59
9,5,34,1,11,"nvramattach@57-68@sys/arch/amd64/amd64/nvram.c","sys/arch/amd64/amd64/nvram.c","nvramattach",57,68
8,4,57,4,11,"nvramopen@71-82@sys/arch/amd64/amd64/nvram.c","sys/arch/amd64/amd64/nvram.c","nvramopen",71,82
4,1,23,4,3,"nvramclose@85-88@sys/arch/amd64/amd64/nvram.c","sys/arch/amd64/amd64/nvram.c","nvramclose",85,88
21,8,165,3,33,"nvramread@91-124@sys/arch/amd64/amd64/nvram.c","sys/arch/amd64/amd64/nvram.c","nvramread",91,124
6,2,31,1,6,"nvram_get_byte@127-133@sys/arch/amd64/amd64/nvram.c","sys/arch/amd64/amd64/nvram.c","nvram_get_byte",127,133
13,3,84,1,18,"nvram_csum_valid@136-154@sys/arch/amd64/amd64/nvram.c","sys/arch/amd64/amd64/nvram.c","nvram_csum_valid",136,154
13,5,104,1,13,"pctrrd@55-68@sys/arch/amd64/amd64/pctr.c","sys/arch/amd64/amd64/pctr.c","pctrrd",55,68
23,5,113,1,27,"pctrattach@71-98@sys/arch/amd64/amd64/pctr.c","sys/arch/amd64/amd64/pctr.c","pctrattach",71,98
6,2,35,4,6,"pctropen@101-107@sys/arch/amd64/amd64/pctr.c","sys/arch/amd64/amd64/pctr.c","pctropen",101,107
4,1,23,4,4,"pctrclose@110-114@sys/arch/amd64/amd64/pctr.c","sys/arch/amd64/amd64/pctr.c","pctrclose",110,114
24,6,132,3,27,"pctrsel@117-144@sys/arch/amd64/amd64/pctr.c","sys/arch/amd64/amd64/pctr.c","pctrsel",117,144
23,9,116,5,23,"pctrioctl@147-170@sys/arch/amd64/amd64/pctr.c","sys/arch/amd64/amd64/pctr.c","pctrioctl",147,170
5,2,33,1,4,"pmap_is_curpmap@323-327@sys/arch/amd64/amd64/pmap.c","sys/arch/amd64/amd64/pmap.c","pmap_is_curpmap",323,327
5,2,36,2,4,"pmap_is_active@335-339@sys/arch/amd64/amd64/pmap.c","sys/arch/amd64/amd64/pmap.c","pmap_is_active",335,339
5,3,34,1,4,"pmap_pte2flags@343-347@sys/arch/amd64/amd64/pmap.c","sys/arch/amd64/amd64/pmap.c","pmap_pte2flags",343,347
6,2,37,2,5,"pmap_sync_flags_pte@350-355@sys/arch/amd64/amd64/pmap.c","sys/arch/amd64/amd64/pmap.c","pmap_sync_flags_pte",350,355
15,4,108,4,26,"pmap_map_ptes@362-388@sys/arch/amd64/amd64/pmap.c","sys/arch/amd64/amd64/pmap.c","pmap_map_ptes",362,388
9,3,58,2,9,"pmap_unmap_ptes@391-400@sys/arch/amd64/amd64/pmap.c","sys/arch/amd64/amd64/pmap.c","pmap_unmap_ptes",391,400
30,7,180,2,42,"pmap_fix_ept@414-456@sys/arch/amd64/amd64/pmap.c","sys/arch/amd64/amd64/pmap.c","pmap_fix_ept",414,456
21,3,151,4,26,"pmap_find_pte_direct@459-485@sys/arch/amd64/amd64/pmap.c","sys/arch/amd64/amd64/pmap.c","pmap_find_pte_direct",459,485
21,11,164,3,29,"pmap_kenter_pa@504-533@sys/arch/amd64/amd64/pmap.c","sys/arch/amd64/amd64/pmap.c","pmap_kenter_pa",504,533
14,3,98,2,19,"pmap_kremove@547-566@sys/arch/amd64/amd64/pmap.c","sys/arch/amd64/amd64/pmap.c","pmap_kremove",547,566
83,10,680,2,169,"pmap_bootstrap@587-756@sys/arch/amd64/amd64/pmap.c","sys/arch/amd64/amd64/pmap.c","pmap_bootstrap",587,756
18,3,103,1,19,"pmap_prealloc_lowmem_ptps@763-782@sys/arch/amd64/amd64/pmap.c","sys/arch/amd64/amd64/pmap.c","pmap_prealloc_lowmem_ptps",763,782
4,1,10,1,7,"pmap_init@791-798@sys/arch/amd64/amd64/pmap.c","sys/arch/amd64/amd64/pmap.c","pmap_init",791,798
11,1,83,5,10,"pmap_enter_pv@820-830@sys/arch/amd64/amd64/pmap.c","sys/arch/amd64/amd64/pmap.c","pmap_enter_pv",820,830
15,4,104,3,15,"pmap_remove_pv@840-855@sys/arch/amd64/amd64/pmap.c","sys/arch/amd64/amd64/pmap.c","pmap_remove_pv",840,855
10,4,92,4,12,"pmap_find_ptp@862-874@sys/arch/amd64/amd64/pmap.c","sys/arch/amd64/amd64/pmap.c","pmap_find_ptp",862,874
14,2,105,4,15,"pmap_freepage@877-892@sys/arch/amd64/amd64/pmap.c","sys/arch/amd64/amd64/pmap.c","pmap_freepage",877,892
29,7,222,6,31,"pmap_free_ptp@895-926@sys/arch/amd64/amd64/pmap.c","sys/arch/amd64/amd64/pmap.c","pmap_free_ptp",895,926
50,11,339,3,77,"pmap_get_ptp@936-1013@sys/arch/amd64/amd64/pmap.c","sys/arch/amd64/amd64/pmap.c","pmap_get_ptp",936,1013
15,2,148,1,29,"pmap_pdp_ctor@1024-1053@sys/arch/amd64/amd64/pmap.c","sys/arch/amd64/amd64/pmap.c","pmap_pdp_ctor",1024,1053
20,2,150,1,34,"pmap_create@1063-1097@sys/arch/amd64/amd64/pmap.c","sys/arch/amd64/amd64/pmap.c","pmap_create",1063,1097
24,6,164,1,48,"pmap_destroy@1105-1153@sys/arch/amd64/amd64/pmap.c","sys/arch/amd64/amd64/pmap.c","pmap_destroy",1105,1153
4,1,22,1,3,"pmap_reference@1160-1163@sys/arch/amd64/amd64/pmap.c","sys/arch/amd64/amd64/pmap.c","pmap_reference",1160,1163
11,2,80,1,15,"pmap_activate@1173-1188@sys/arch/amd64/amd64/pmap.c","sys/arch/amd64/amd64/pmap.c","pmap_activate",1173,1188
5,1,39,1,8,"pmap_deactivate@1195-1203@sys/arch/amd64/amd64/pmap.c","sys/arch/amd64/amd64/pmap.c","pmap_deactivate",1195,1203
15,4,86,3,15,"pmap_pdes_valid@1214-1229@sys/arch/amd64/amd64/pmap.c","sys/arch/amd64/amd64/pmap.c","pmap_pdes_valid",1214,1229
22,10,177,3,25,"pmap_extract@1236-1261@sys/arch/amd64/amd64/pmap.c","sys/arch/amd64/amd64/pmap.c","pmap_extract",1236,1261
4,1,17,1,3,"pmap_zero_page@1268-1271@sys/arch/amd64/amd64/pmap.c","sys/arch/amd64/amd64/pmap.c","pmap_zero_page",1268,1271
12,3,64,2,14,"pmap_flush_cache@1277-1291@sys/arch/amd64/amd64/pmap.c","sys/arch/amd64/amd64/pmap.c","pmap_flush_cache",1277,1291
6,1,47,2,6,"pmap_copy_page@1298-1304@sys/arch/amd64/amd64/pmap.c","sys/arch/amd64/amd64/pmap.c","pmap_copy_page",1298,1304
39,15,250,7,67,"pmap_remove_ptes@1321-1388@sys/arch/amd64/amd64/pmap.c","sys/arch/amd64/amd64/pmap.c","pmap_remove_ptes",1321,1388
35,12,223,6,52,"pmap_remove_pte@1401-1453@sys/arch/amd64/amd64/pmap.c","sys/arch/amd64/amd64/pmap.c","pmap_remove_pte",1401,1453
4,1,26,3,3,"pmap_remove@1462-1465@sys/arch/amd64/amd64/pmap.c","sys/arch/amd64/amd64/pmap.c","pmap_remove",1462,1465
81,23,541,4,137,"pmap_do_remove@1474-1611@sys/arch/amd64/amd64/pmap.c","sys/arch/amd64/amd64/pmap.c","pmap_do_remove",1474,1611
66,13,483,1,94,"pmap_page_remove@1620-1714@sys/arch/amd64/amd64/pmap.c","sys/arch/amd64/amd64/pmap.c","pmap_page_remove",1620,1714
23,5,161,2,28,"pmap_test_attrs@1728-1756@sys/arch/amd64/amd64/pmap.c","sys/arch/amd64/amd64/pmap.c","pmap_test_attrs",1728,1756
26,4,187,2,30,"pmap_clear_attrs@1765-1795@sys/arch/amd64/amd64/pmap.c","sys/arch/amd64/amd64/pmap.c","pmap_clear_attrs",1765,1795
43,14,292,4,68,"pmap_write_protect@1823-1891@sys/arch/amd64/amd64/pmap.c","sys/arch/amd64/amd64/pmap.c","pmap_write_protect",1823,1891
21,7,125,2,29,"pmap_unwire@1904-1933@sys/arch/amd64/amd64/pmap.c","sys/arch/amd64/amd64/pmap.c","pmap_unwire",1904,1933
3,1,9,1,10,"pmap_collect@1943-1953@sys/arch/amd64/amd64/pmap.c","sys/arch/amd64/amd64/pmap.c","pmap_collect",1943,1953
140,44,812,5,218,"pmap_enter@1973-2191@sys/arch/amd64/amd64/pmap.c","sys/arch/amd64/amd64/pmap.c","pmap_enter",1973,2191
21,3,138,3,28,"pmap_get_physpage@2194-2222@sys/arch/amd64/amd64/pmap.c","sys/arch/amd64/amd64/pmap.c","pmap_get_physpage",2194,2222
28,5,179,4,32,"pmap_alloc_level@2232-2264@sys/arch/amd64/amd64/pmap.c","sys/arch/amd64/amd64/pmap.c","pmap_alloc_level",2232,2264
32,5,223,1,48,"pmap_growkernel@2276-2324@sys/arch/amd64/amd64/pmap.c","sys/arch/amd64/amd64/pmap.c","pmap_growkernel",2276,2324
46,12,276,3,59,"pmap_steal_memory@2327-2386@sys/arch/amd64/amd64/pmap.c","sys/arch/amd64/amd64/pmap.c","pmap_steal_memory",2327,2386
5,1,22,2,4,"pmap_virtual_space@2389-2393@sys/arch/amd64/amd64/pmap.c","sys/arch/amd64/amd64/pmap.c","pmap_virtual_space",2389,2393
10,2,50,2,13,"pmap_convert@2408-2421@sys/arch/amd64/amd64/pmap.c","sys/arch/amd64/amd64/pmap.c","pmap_convert",2408,2421
31,10,193,3,34,"pmap_tlb_shootpage@2452-2486@sys/arch/amd64/amd64/pmap.c","sys/arch/amd64/amd64/pmap.c","pmap_tlb_shootpage",2452,2486
34,11,217,4,37,"pmap_tlb_shootrange@2489-2526@sys/arch/amd64/amd64/pmap.c","sys/arch/amd64/amd64/pmap.c","pmap_tlb_shootrange",2489,2526
29,10,183,2,33,"pmap_tlb_shoottlb@2529-2562@sys/arch/amd64/amd64/pmap.c","sys/arch/amd64/amd64/pmap.c","pmap_tlb_shoottlb",2529,2562
5,2,16,1,4,"pmap_tlb_shootwait@2565-2569@sys/arch/amd64/amd64/pmap.c","sys/arch/amd64/amd64/pmap.c","pmap_tlb_shootwait",2565,2569
5,2,24,3,5,"pmap_tlb_shootpage@2574-2579@sys/arch/amd64/amd64/pmap.c","sys/arch/amd64/amd64/pmap.c","pmap_tlb_shootpage",2574,2579
8,3,47,4,10,"pmap_tlb_shootrange@2582-2592@sys/arch/amd64/amd64/pmap.c","sys/arch/amd64/amd64/pmap.c","pmap_tlb_shootrange",2582,2592
5,2,20,2,4,"pmap_tlb_shoottlb@2595-2599@sys/arch/amd64/amd64/pmap.c","sys/arch/amd64/amd64/pmap.c","pmap_tlb_shoottlb",2595,2599
11,3,49,1,12,"k8pnow_read_pending_wait@154-166@sys/arch/amd64/amd64/powernow-k8.c","sys/arch/amd64/amd64/powernow-k8.c","k8pnow_read_pending_wait",154,166
10,2,59,1,12,"k8_powernow_setperf@169-181@sys/arch/amd64/amd64/powernow-k8.c","sys/arch/amd64/amd64/powernow-k8.c","k8_powernow_setperf",169,181
65,20,446,2,91,"k8pnow_transition@184-275@sys/arch/amd64/amd64/powernow-k8.c","sys/arch/amd64/amd64/powernow-k8.c","k8pnow_transition",184,275
21,4,156,2,25,"k8pnow_decode_pst@282-307@sys/arch/amd64/amd64/powernow-k8.c","sys/arch/amd64/amd64/powernow-k8.c","k8pnow_decode_pst",282,307
27,6,214,4,30,"k8pnow_acpi_states@312-342@sys/arch/amd64/amd64/powernow-k8.c","sys/arch/amd64/amd64/powernow-k8.c","k8pnow_acpi_states",312,342
32,5,209,2,40,"k8pnow_acpi_pss_changed@345-385@sys/arch/amd64/amd64/powernow-k8.c","sys/arch/amd64/amd64/powernow-k8.c","k8pnow_acpi_pss_changed",345,385
19,2,127,2,22,"k8pnow_acpi_init@388-410@sys/arch/amd64/amd64/powernow-k8.c","sys/arch/amd64/amd64/powernow-k8.c","k8pnow_acpi_init",388,410
35,8,261,4,40,"k8pnow_states@415-455@sys/arch/amd64/amd64/powernow-k8.c","sys/arch/amd64/amd64/powernow-k8.c","k8pnow_states",415,455
43,9,261,1,56,"k8_powernow_init@458-514@sys/arch/amd64/amd64/powernow-k8.c","sys/arch/amd64/amd64/powernow-k8.c","k8_powernow_init",458,514
4,1,18,1,4,"process_frame@74-78@sys/arch/amd64/amd64/process_machdep.c","sys/arch/amd64/amd64/process_machdep.c","process_frame",74,78
4,1,23,1,4,"process_fpframe@81-85@sys/arch/amd64/amd64/process_machdep.c","sys/arch/amd64/amd64/process_machdep.c","process_fpframe",81,85
29,1,233,2,30,"process_read_regs@88-118@sys/arch/amd64/amd64/process_machdep.c","sys/arch/amd64/amd64/process_machdep.c","process_read_regs",88,118
17,2,118,2,19,"process_read_fpregs@121-140@sys/arch/amd64/amd64/process_machdep.c","sys/arch/amd64/amd64/process_machdep.c","process_read_fpregs",121,140
28,2,211,2,35,"process_write_regs@145-180@sys/arch/amd64/amd64/process_machdep.c","sys/arch/amd64/amd64/process_machdep.c","process_write_regs",145,180
12,2,81,2,13,"process_write_fpregs@183-196@sys/arch/amd64/amd64/process_machdep.c","sys/arch/amd64/amd64/process_machdep.c","process_write_fpregs",183,196
9,2,44,2,10,"process_sstep@199-209@sys/arch/amd64/amd64/process_machdep.c","sys/arch/amd64/amd64/process_machdep.c","process_sstep",199,209
8,2,48,2,9,"process_set_pc@212-221@sys/arch/amd64/amd64/process_machdep.c","sys/arch/amd64/amd64/process_machdep.c","process_set_pc",212,221
11,2,67,2,13,"rbus_pccbb_parent_mem@53-66@sys/arch/amd64/amd64/rbus_machdep.c","sys/arch/amd64/amd64/rbus_machdep.c","rbus_pccbb_parent_mem",53,66
14,3,86,2,22,"rbus_pccbb_parent_io@69-91@sys/arch/amd64/amd64/rbus_machdep.c","sys/arch/amd64/amd64/rbus_machdep.c","rbus_pccbb_parent_io",69,91
4,1,19,3,3,"pccbb_attach_hook@94-97@sys/arch/amd64/amd64/rbus_machdep.c","sys/arch/amd64/amd64/rbus_machdep.c","pccbb_attach_hook",94,97
11,2,64,1,11,"softintr_init@58-69@sys/arch/amd64/amd64/softintr.c","sys/arch/amd64/amd64/softintr.c","softintr_init",58,69
25,3,149,1,30,"softintr_dispatch@77-107@sys/arch/amd64/amd64/softintr.c","sys/arch/amd64/amd64/softintr.c","softintr_dispatch",77,107
29,6,140,3,34,"softintr_establish@115-149@sys/arch/amd64/amd64/softintr.c","sys/arch/amd64/amd64/softintr.c","softintr_establish",115,149
12,2,79,1,13,"softintr_disestablish@157-170@sys/arch/amd64/amd64/softintr.c","sys/arch/amd64/amd64/softintr.c","softintr_disestablish",157,170
19,8,120,3,26,"amd64_iopl@57-83@sys/arch/amd64/amd64/sys_machdep.c","sys/arch/amd64/amd64/sys_machdep.c","amd64_iopl",57,83
5,1,38,2,5,"amd64_get_fsbase@86-91@sys/arch/amd64/amd64/sys_machdep.c","sys/arch/amd64/amd64/sys_machdep.c","amd64_get_fsbase",86,91
11,3,66,2,12,"amd64_set_fsbase@94-106@sys/arch/amd64/amd64/sys_machdep.c","sys/arch/amd64/amd64/sys_machdep.c","amd64_set_fsbase",94,106
30,8,175,3,40,"sys_sysarch@109-149@sys/arch/amd64/amd64/sys_machdep.c","sys/arch/amd64/amd64/sys_machdep.c","sys_sysarch",109,149
244,76,1490,1,312,"trap@140-452@sys/arch/amd64/amd64/trap.c","sys/arch/amd64/amd64/trap.c","trap",140,452
15,1,183,1,14,"frame_dump@456-470@sys/arch/amd64/amd64/trap.c","sys/arch/amd64/amd64/trap.c","frame_dump",456,470
11,1,70,1,11,"ast@480-491@sys/arch/amd64/amd64/trap.c","sys/arch/amd64/amd64/trap.c","ast",480,491
85,20,472,1,101,"syscall@499-600@sys/arch/amd64/amd64/trap.c","sys/arch/amd64/amd64/trap.c","syscall",499,600
10,1,53,1,12,"child_return@603-615@sys/arch/amd64/amd64/trap.c","sys/arch/amd64/amd64/trap.c","child_return",603,615
33,14,166,1,34,"tsc_freq_cpuid@43-77@sys/arch/amd64/amd64/tsc.c","sys/arch/amd64/amd64/tsc.c","tsc_freq_cpuid",43,77
16,3,101,3,17,"get_tsc_and_timecount@80-97@sys/arch/amd64/amd64/tsc.c","sys/arch/amd64/amd64/tsc.c","get_tsc_and_timecount",80,97
6,1,33,3,6,"calculate_tsc_freq@100-106@sys/arch/amd64/amd64/tsc.c","sys/arch/amd64/amd64/tsc.c","calculate_tsc_freq",100,106
8,2,49,3,9,"calculate_tc_delay@109-118@sys/arch/amd64/amd64/tsc.c","sys/arch/amd64/amd64/tsc.c","calculate_tc_delay",109,118
30,8,218,1,41,"measure_tsc_freq@121-162@sys/arch/amd64/amd64/tsc.c","sys/arch/amd64/amd64/tsc.c","measure_tsc_freq",121,162
15,5,76,1,17,"calibrate_tsc_freq@165-182@sys/arch/amd64/amd64/tsc.c","sys/arch/amd64/amd64/tsc.c","calibrate_tsc_freq",165,182
8,3,42,1,10,"cpu_recalibrate_tsc@185-195@sys/arch/amd64/amd64/tsc.c","sys/arch/amd64/amd64/tsc.c","cpu_recalibrate_tsc",185,195
4,1,14,1,3,"tsc_get_timecount@198-201@sys/arch/amd64/amd64/tsc.c","sys/arch/amd64/amd64/tsc.c","tsc_get_timecount",198,201
19,5,101,2,22,"tsc_timecounter_init@204-226@sys/arch/amd64/amd64/tsc.c","sys/arch/amd64/amd64/tsc.c","tsc_timecounter_init",204,226
19,8,94,1,24,"vmm_enabled@296-320@sys/arch/amd64/amd64/vmm.c","sys/arch/amd64/amd64/vmm.c","vmm_enabled",296,320
7,2,53,3,7,"vmm_probe@323-330@sys/arch/amd64/amd64/vmm.c","sys/arch/amd64/amd64/vmm.c","vmm_probe",323,330
52,11,357,3,60,"vmm_attach@340-400@sys/arch/amd64/amd64/vmm.c","sys/arch/amd64/amd64/vmm.c","vmm_attach",340,400
8,4,51,4,11,"vmmopen@408-419@sys/arch/amd64/amd64/vmm.c","sys/arch/amd64/amd64/vmm.c","vmmopen",408,419
38,10,212,5,39,"vmmioctl@428-467@sys/arch/amd64/amd64/vmm.c","sys/arch/amd64/amd64/vmm.c","vmmioctl",428,467
18,10,69,2,20,"pledge_ioctl_vmm@476-496@sys/arch/amd64/amd64/vmm.c","sys/arch/amd64/amd64/vmm.c","pledge_ioctl_vmm",476,496
4,1,21,4,3,"vmmclose@504-507@sys/arch/amd64/amd64/vmm.c","sys/arch/amd64/amd64/vmm.c","vmmclose",504,507
40,7,236,1,52,"vm_resetcpu@524-576@sys/arch/amd64/amd64/vmm.c","sys/arch/amd64/amd64/vmm.c","vm_resetcpu",524,576
26,7,159,1,48,"vm_intr_pending@592-640@sys/arch/amd64/amd64/vmm.c","sys/arch/amd64/amd64/vmm.c","vm_intr_pending",592,640
34,10,231,2,40,"vm_rwregs@659-699@sys/arch/amd64/amd64/vmm.c","sys/arch/amd64/amd64/vmm.c","vm_rwregs",659,699
17,4,111,2,24,"vm_find@717-741@sys/arch/amd64/amd64/vmm.c","sys/arch/amd64/amd64/vmm.c","vm_find",717,741
29,9,160,1,40,"vmm_start@749-789@sys/arch/amd64/amd64/vmm.c","sys/arch/amd64/amd64/vmm.c","vmm_start",749,789
29,9,154,1,40,"vmm_stop@797-837@sys/arch/amd64/amd64/vmm.c","sys/arch/amd64/amd64/vmm.c","vmm_stop",797,837
37,9,192,1,53,"start_vmm_on_cpu@846-899@sys/arch/amd64/amd64/vmm.c","sys/arch/amd64/amd64/vmm.c","start_vmm_on_cpu",846,899
20,5,98,1,30,"stop_vmm_on_cpu@908-938@sys/arch/amd64/amd64/vmm.c","sys/arch/amd64/amd64/vmm.c","stop_vmm_on_cpu",908,938
36,20,279,1,66,"vm_create_check_mem_ranges@954-1020@sys/arch/amd64/amd64/vmm.c","sys/arch/amd64/amd64/vmm.c","vm_create_check_mem_ranges",954,1020
56,7,400,2,71,"vm_create@1035-1106@sys/arch/amd64/amd64/vmm.c","sys/arch/amd64/amd64/vmm.c","vm_create",1035,1106
46,7,305,2,62,"vm_impl_init_vmx@1122-1184@sys/arch/amd64/amd64/vmm.c","sys/arch/amd64/amd64/vmm.c","vm_impl_init_vmx",1122,1184
41,6,283,2,57,"vm_impl_init_svm@1200-1257@sys/arch/amd64/amd64/vmm.c","sys/arch/amd64/amd64/vmm.c","vm_impl_init_svm",1200,1257
11,5,65,2,10,"vm_impl_init@1273-1283@sys/arch/amd64/amd64/vmm.c","sys/arch/amd64/amd64/vmm.c","vm_impl_init",1273,1283
3,1,9,1,3,"vm_impl_deinit_vmx@1294-1297@sys/arch/amd64/amd64/vmm.c","sys/arch/amd64/amd64/vmm.c","vm_impl_deinit_vmx",1294,1297
3,1,9,1,3,"vm_impl_deinit_svm@1308-1311@sys/arch/amd64/amd64/vmm.c","sys/arch/amd64/amd64/vmm.c","vm_impl_deinit_svm",1308,1311
11,5,54,1,10,"vm_impl_deinit@1322-1332@sys/arch/amd64/amd64/vmm.c","sys/arch/amd64/amd64/vmm.c","vm_impl_deinit",1322,1332
14,5,66,1,20,"vcpu_reload_vmcs_vmx@1348-1368@sys/arch/amd64/amd64/vmm.c","sys/arch/amd64/amd64/vmm.c","vcpu_reload_vmcs_vmx",1348,1368
94,26,724,3,102,"vcpu_readregs_vmx@1385-1487@sys/arch/amd64/amd64/vmm.c","sys/arch/amd64/amd64/vmm.c","vcpu_readregs_vmx",1385,1487
5,1,22,3,4,"vcpu_readregs_svm@1495-1499@sys/arch/amd64/amd64/vmm.c","sys/arch/amd64/amd64/vmm.c","vcpu_readregs_svm",1495,1499
100,29,719,4,107,"vcpu_writeregs_vmx@1517-1624@sys/arch/amd64/amd64/vmm.c","sys/arch/amd64/amd64/vmm.c","vcpu_writeregs_vmx",1517,1624
82,4,934,3,86,"vcpu_writeregs_svm@1641-1727@sys/arch/amd64/amd64/vmm.c","sys/arch/amd64/amd64/vmm.c","vcpu_writeregs_svm",1641,1727
55,4,402,2,105,"vcpu_reset_regs_svm@1743-1848@sys/arch/amd64/amd64/vmm.c","sys/arch/amd64/amd64/vmm.c","vcpu_reset_regs_svm",1743,1848
19,6,146,2,29,"svm_setmsrbr@1860-1889@sys/arch/amd64/amd64/vmm.c","sys/arch/amd64/amd64/vmm.c","svm_setmsrbr",1860,1889
19,6,146,2,29,"svm_setmsrbw@1901-1930@sys/arch/amd64/amd64/vmm.c","sys/arch/amd64/amd64/vmm.c","svm_setmsrbw",1901,1930
5,1,26,2,4,"svm_setmsrbrw@1942-1946@sys/arch/amd64/amd64/vmm.c","sys/arch/amd64/amd64/vmm.c","svm_setmsrbrw",1942,1946
14,4,104,2,20,"vmx_setmsrbr@1958-1978@sys/arch/amd64/amd64/vmm.c","sys/arch/amd64/amd64/vmm.c","vmx_setmsrbr",1958,1978
14,4,106,2,20,"vmx_setmsrbw@1990-2010@sys/arch/amd64/amd64/vmm.c","sys/arch/amd64/amd64/vmm.c","vmx_setmsrbw",1990,2010
5,1,26,2,4,"vmx_setmsrbrw@2022-2026@sys/arch/amd64/amd64/vmm.c","sys/arch/amd64/amd64/vmm.c","vmx_setmsrbrw",2022,2026
8,2,49,2,11,"svm_set_clean@2045-2056@sys/arch/amd64/amd64/vmm.c","sys/arch/amd64/amd64/vmm.c","svm_set_clean",2045,2056
8,2,49,2,11,"svm_set_dirty@2072-2083@sys/arch/amd64/amd64/vmm.c","sys/arch/amd64/amd64/vmm.c","svm_set_dirty",2072,2083
368,57,2059,2,549,"vcpu_reset_regs_vmx@2099-2648@sys/arch/amd64/amd64/vmm.c","sys/arch/amd64/amd64/vmm.c","vcpu_reset_regs_vmx",2099,2648
147,30,887,1,195,"vcpu_init_vmx@2667-2862@sys/arch/amd64/amd64/vmm.c","sys/arch/amd64/amd64/vmm.c","vcpu_init_vmx",2667,2862
13,5,75,2,14,"vcpu_reset_regs@2879-2893@sys/arch/amd64/amd64/vmm.c","sys/arch/amd64/amd64/vmm.c","vcpu_reset_regs",2879,2893
75,14,485,1,102,"vcpu_init_svm@2912-3014@sys/arch/amd64/amd64/vmm.c","sys/arch/amd64/amd64/vmm.c","vcpu_init_svm",2912,3014
16,5,88,1,17,"vcpu_init@3022-3039@sys/arch/amd64/amd64/vmm.c","sys/arch/amd64/amd64/vmm.c","vcpu_init",3022,3039
17,6,122,1,17,"vcpu_deinit_vmx@3050-3067@sys/arch/amd64/amd64/vmm.c","sys/arch/amd64/amd64/vmm.c","vcpu_deinit_vmx",3050,3067
16,5,120,1,16,"vcpu_deinit_svm@3078-3094@sys/arch/amd64/amd64/vmm.c","sys/arch/amd64/amd64/vmm.c","vcpu_deinit_svm",3078,3094
11,5,54,1,10,"vcpu_deinit@3105-3115@sys/arch/amd64/amd64/vmm.c","sys/arch/amd64/amd64/vmm.c","vcpu_deinit",3105,3115
18,3,120,1,23,"vm_teardown@3126-3149@sys/arch/amd64/amd64/vmm.c","sys/arch/amd64/amd64/vmm.c","vm_teardown",3126,3149
50,13,205,4,53,"vcpu_vmx_check_cap@3163-3216@sys/arch/amd64/amd64/vmm.c","sys/arch/amd64/amd64/vmm.c","vcpu_vmx_check_cap",3163,3216
89,35,458,5,154,"vcpu_vmx_compute_ctrl@3243-3397@sys/arch/amd64/amd64/vmm.c","sys/arch/amd64/amd64/vmm.c","vcpu_vmx_compute_ctrl",3243,3397
52,6,366,1,55,"vm_get_info@3419-3474@sys/arch/amd64/amd64/vmm.c","sys/arch/amd64/amd64/vmm.c","vm_get_info",3419,3474
34,7,201,1,42,"vm_terminate@3489-3531@sys/arch/amd64/amd64/vmm.c","sys/arch/amd64/amd64/vmm.c","vm_terminate",3489,3531
69,19,424,1,102,"vm_run@3551-3653@sys/arch/amd64/amd64/vmm.c","sys/arch/amd64/amd64/vmm.c","vm_run",3551,3653
9,3,48,1,9,"vcpu_must_stop@3671-3680@sys/arch/amd64/amd64/vmm.c","sys/arch/amd64/amd64/vmm.c","vcpu_must_stop",3671,3680
19,4,118,1,27,"vmm_fpusave@3689-3716@sys/arch/amd64/amd64/vmm.c","sys/arch/amd64/amd64/vmm.c","vmm_fpusave",3689,3716
303,76,1490,2,443,"vcpu_run_vmx@3733-4176@sys/arch/amd64/amd64/vmm.c","sys/arch/amd64/amd64/vmm.c","vcpu_run_vmx",3733,4176
15,2,81,1,18,"vmx_handle_intr@4186-4204@sys/arch/amd64/amd64/vmm.c","sys/arch/amd64/amd64/vmm.c","vmx_handle_intr",4186,4204
12,2,66,1,15,"svm_handle_hlt@4220-4235@sys/arch/amd64/amd64/vmm.c","sys/arch/amd64/amd64/vmm.c","svm_handle_hlt",4220,4235
24,5,120,1,28,"vmx_handle_hlt@4255-4283@sys/arch/amd64/amd64/vmm.c","sys/arch/amd64/amd64/vmm.c","vmx_handle_hlt",4255,4283
10,3,54,2,10,"vmx_get_exit_info@4293-4303@sys/arch/amd64/amd64/vmm.c","sys/arch/amd64/amd64/vmm.c","vmx_get_exit_info",4293,4303
73,17,318,1,80,"svm_handle_exit@4312-4392@sys/arch/amd64/amd64/vmm.c","sys/arch/amd64/amd64/vmm.c","svm_handle_exit",4312,4392
101,22,429,1,112,"vmx_handle_exit@4401-4513@sys/arch/amd64/amd64/vmm.c","sys/arch/amd64/amd64/vmm.c","vmx_handle_exit",4401,4513
7,1,33,1,7,"vmm_inject_ud@4527-4534@sys/arch/amd64/amd64/vmm.c","sys/arch/amd64/amd64/vmm.c","vmm_inject_ud",4527,4534
7,1,33,1,7,"vmm_inject_db@4548-4555@sys/arch/amd64/amd64/vmm.c","sys/arch/amd64/amd64/vmm.c","vmm_inject_db",4548,4555
18,6,116,2,27,"vmm_get_guest_memtype@4563-4590@sys/arch/amd64/amd64/vmm.c","sys/arch/amd64/amd64/vmm.c","vmm_get_guest_memtype",4563,4590
9,3,39,1,8,"vmm_get_guest_faulttype@4599-4607@sys/arch/amd64/amd64/vmm.c","sys/arch/amd64/amd64/vmm.c","vmm_get_guest_faulttype",4599,4607
8,2,36,1,8,"vmx_get_exit_qualification@4615-4623@sys/arch/amd64/amd64/vmm.c","sys/arch/amd64/amd64/vmm.c","vmx_get_exit_qualification",4615,4623
15,4,69,1,16,"vmx_get_guest_faulttype@4632-4648@sys/arch/amd64/amd64/vmm.c","sys/arch/amd64/amd64/vmm.c","vmx_get_guest_faulttype",4632,4648
6,2,26,1,5,"svm_get_guest_faulttype@4657-4662@sys/arch/amd64/amd64/vmm.c","sys/arch/amd64/amd64/vmm.c","svm_get_guest_faulttype",4657,4662
12,2,88,2,14,"svm_fault_page@4671-4685@sys/arch/amd64/amd64/vmm.c","sys/arch/amd64/amd64/vmm.c","svm_fault_page",4671,4685
19,2,93,1,22,"svm_handle_np_fault@4694-4716@sys/arch/amd64/amd64/vmm.c","sys/arch/amd64/amd64/vmm.c","svm_handle_np_fault",4694,4716
15,3,94,2,18,"vmx_fault_page@4725-4743@sys/arch/amd64/amd64/vmm.c","sys/arch/amd64/amd64/vmm.c","vmx_fault_page",4725,4743
21,3,97,1,23,"vmx_handle_np_fault@4752-4775@sys/arch/amd64/amd64/vmm.c","sys/arch/amd64/amd64/vmm.c","vmx_handle_np_fault",4752,4775
45,16,315,1,69,"svm_handle_inout@4794-4863@sys/arch/amd64/amd64/vmm.c","sys/arch/amd64/amd64/vmm.c","svm_handle_inout",4794,4863
50,18,370,1,74,"vmx_handle_inout@4874-4948@sys/arch/amd64/amd64/vmm.c","sys/arch/amd64/amd64/vmm.c","vmx_handle_inout",4874,4948
66,12,382,1,78,"vmx_load_pdptes@4965-5043@sys/arch/amd64/amd64/vmm.c","sys/arch/amd64/amd64/vmm.c","vmx_load_pdptes",4965,5043
42,12,247,2,64,"vmx_handle_cr0_write@5060-5124@sys/arch/amd64/amd64/vmm.c","sys/arch/amd64/amd64/vmm.c","vmx_handle_cr0_write",5060,5124
9,2,44,2,15,"vmx_handle_cr4_write@5141-5156@sys/arch/amd64/amd64/vmm.c","sys/arch/amd64/amd64/vmm.c","vmx_handle_cr4_write",5141,5156
68,28,478,1,84,"vmx_handle_cr@5164-5248@sys/arch/amd64/amd64/vmm.c","sys/arch/amd64/amd64/vmm.c","vmx_handle_cr",5164,5248
24,5,137,1,35,"vmx_handle_rdmsr@5267-5302@sys/arch/amd64/amd64/vmm.c","sys/arch/amd64/amd64/vmm.c","vmx_handle_rdmsr",5267,5302
18,3,94,1,24,"vmx_handle_xsetbv@5317-5341@sys/arch/amd64/amd64/vmm.c","sys/arch/amd64/amd64/vmm.c","vmx_handle_xsetbv",5317,5341
11,1,63,1,16,"svm_handle_xsetbv@5356-5372@sys/arch/amd64/amd64/vmm.c","sys/arch/amd64/amd64/vmm.c","svm_handle_xsetbv",5356,5372
18,4,112,2,28,"vmm_handle_xsetbv@5389-5417@sys/arch/amd64/amd64/vmm.c","sys/arch/amd64/amd64/vmm.c","vmm_handle_xsetbv",5389,5417
11,1,79,1,14,"vmx_handle_misc_enable_msr@5431-5445@sys/arch/amd64/amd64/vmm.c","sys/arch/amd64/amd64/vmm.c","vmx_handle_misc_enable_msr",5431,5445
28,5,145,1,38,"vmx_handle_wrmsr@5462-5500@sys/arch/amd64/amd64/vmm.c","sys/arch/amd64/amd64/vmm.c","vmx_handle_wrmsr",5462,5500
25,4,154,1,33,"svm_handle_msr@5514-5547@sys/arch/amd64/amd64/vmm.c","sys/arch/amd64/amd64/vmm.c","svm_handle_msr",5514,5547
257,42,1483,1,277,"vmm_handle_cpuid@5562-5839@sys/arch/amd64/amd64/vmm.c","sys/arch/amd64/amd64/vmm.c","vmm_handle_cpuid",5562,5839
157,39,883,2,259,"vcpu_run_svm@5856-6115@sys/arch/amd64/amd64/vmm.c","sys/arch/amd64/amd64/vmm.c","vcpu_run_svm",5856,6115
24,5,160,1,27,"vmm_alloc_vpid@6131-6158@sys/arch/amd64/amd64/vmm.c","sys/arch/amd64/amd64/vmm.c","vmm_alloc_vpid",6131,6158
11,1,74,1,12,"vmm_free_vpid@6169-6181@sys/arch/amd64/amd64/vmm.c","sys/arch/amd64/amd64/vmm.c","vmm_free_vpid",6169,6181
67,61,378,1,66,"vmx_exit_reason_decode@6189-6255@sys/arch/amd64/amd64/vmm.c","sys/arch/amd64/amd64/vmm.c","vmx_exit_reason_decode",6189,6255
148,143,870,1,147,"svm_exit_reason_decode@6263-6410@sys/arch/amd64/amd64/vmm.c","sys/arch/amd64/amd64/vmm.c","svm_exit_reason_decode",6263,6410
23,18,120,1,22,"vmx_instruction_error_decode@6418-6440@sys/arch/amd64/amd64/vmm.c","sys/arch/amd64/amd64/vmm.c","vmx_instruction_error_decode",6418,6440
11,6,48,1,10,"vcpu_state_decode@6448-6458@sys/arch/amd64/amd64/vmm.c","sys/arch/amd64/amd64/vmm.c","vcpu_state_decode",6448,6458
100,4,750,1,99,"dump_vcpu@6467-6566@sys/arch/amd64/amd64/vmm.c","sys/arch/amd64/amd64/vmm.c","dump_vcpu",6467,6566
17,6,99,2,26,"vmx_dump_vmcs_field@6578-6604@sys/arch/amd64/amd64/vmm.c","sys/arch/amd64/amd64/vmm.c","vmx_dump_vmcs_field",6578,6604
442,46,2383,1,505,"vmx_dump_vmcs@6612-7117@sys/arch/amd64/amd64/vmm.c","sys/arch/amd64/amd64/vmm.c","vmx_dump_vmcs",6612,7117
266,43,1520,1,313,"vmx_vcpu_dump_regs@7129-7442@sys/arch/amd64/amd64/vmm.c","sys/arch/amd64/amd64/vmm.c","vmx_vcpu_dump_regs",7129,7442
30,25,162,1,34,"msr_name_decode@7456-7490@sys/arch/amd64/amd64/vmm.c","sys/arch/amd64/amd64/vmm.c","msr_name_decode",7456,7490
59,25,400,1,65,"vmm_segment_desc_decode@7501-7566@sys/arch/amd64/amd64/vmm.c","sys/arch/amd64/amd64/vmm.c","vmm_segment_desc_decode",7501,7566
24,3,166,1,26,"vmm_decode_cr0@7569-7595@sys/arch/amd64/amd64/vmm.c","sys/arch/amd64/amd64/vmm.c","vmm_decode_cr0",7569,7595
24,5,140,1,28,"vmm_decode_cr3@7598-7626@sys/arch/amd64/amd64/vmm.c","sys/arch/amd64/amd64/vmm.c","vmm_decode_cr3",7598,7626
32,3,230,1,34,"vmm_decode_cr4@7629-7663@sys/arch/amd64/amd64/vmm.c","sys/arch/amd64/amd64/vmm.c","vmm_decode_cr4",7629,7663
16,3,102,1,18,"vmm_decode_apicbase_msr_value@7666-7684@sys/arch/amd64/amd64/vmm.c","sys/arch/amd64/amd64/vmm.c","vmm_decode_apicbase_msr_value",7666,7684
20,4,130,1,23,"vmm_decode_ia32_fc_value@7687-7710@sys/arch/amd64/amd64/vmm.c","sys/arch/amd64/amd64/vmm.c","vmm_decode_ia32_fc_value",7687,7710
19,4,119,1,22,"vmm_decode_mtrrcap_value@7713-7735@sys/arch/amd64/amd64/vmm.c","sys/arch/amd64/amd64/vmm.c","vmm_decode_mtrrcap_value",7713,7735
4,1,18,1,3,"vmm_decode_perf_status_value@7738-7741@sys/arch/amd64/amd64/vmm.c","sys/arch/amd64/amd64/vmm.c","vmm_decode_perf_status_value",7738,7741
5,2,33,1,4,"vmm_decode_perf_ctl_value@7743-7747@sys/arch/amd64/amd64/vmm.c","sys/arch/amd64/amd64/vmm.c","vmm_decode_perf_ctl_value",7743,7747
29,9,180,1,32,"vmm_decode_mtrrdeftype_value@7750-7782@sys/arch/amd64/amd64/vmm.c","sys/arch/amd64/amd64/vmm.c","vmm_decode_mtrrdeftype_value",7750,7782
17,3,111,1,19,"vmm_decode_efer_value@7785-7804@sys/arch/amd64/amd64/vmm.c","sys/arch/amd64/amd64/vmm.c","vmm_decode_efer_value",7785,7804
14,9,103,2,13,"vmm_decode_msr_value@7807-7820@sys/arch/amd64/amd64/vmm.c","sys/arch/amd64/amd64/vmm.c","vmm_decode_msr_value",7807,7820
31,3,227,1,34,"vmm_decode_rflags@7823-7857@sys/arch/amd64/amd64/vmm.c","sys/arch/amd64/amd64/vmm.c","vmm_decode_rflags",7823,7857
23,3,159,1,25,"vmm_decode_misc_enable_value@7860-7885@sys/arch/amd64/amd64/vmm.c","sys/arch/amd64/amd64/vmm.c","vmm_decode_misc_enable_value",7860,7885
29,7,261,6,57,"cpu_fork@65-122@sys/arch/amd64/amd64/vm_machdep.c","sys/arch/amd64/amd64/vm_machdep.c","cpu_fork",65,122
7,2,38,1,9,"cpu_exit@131-140@sys/arch/amd64/amd64/vm_machdep.c","sys/arch/amd64/amd64/vm_machdep.c","cpu_exit",131,140
6,1,43,1,5,"setguardpage@146-151@sys/arch/amd64/amd64/vm_machdep.c","sys/arch/amd64/amd64/vm_machdep.c","setguardpage",146,151
20,3,151,2,32,"vmapbuf@159-191@sys/arch/amd64/amd64/vm_machdep.c","sys/arch/amd64/amd64/vm_machdep.c","vmapbuf",159,191
14,2,103,2,14,"vunmapbuf@197-211@sys/arch/amd64/amd64/vm_machdep.c","sys/arch/amd64/amd64/vm_machdep.c","vunmapbuf",197,211
4,1,24,1,3,"tcb_get@214-217@sys/arch/amd64/amd64/vm_machdep.c","sys/arch/amd64/amd64/vm_machdep.c","tcb_get",214,217
6,1,37,2,5,"tcb_set@220-225@sys/arch/amd64/amd64/vm_machdep.c","sys/arch/amd64/amd64/vm_machdep.c","tcb_set",220,225
13,4,70,1,17,"wscnprobe@82-99@sys/arch/amd64/amd64/wscons_machdep.c","sys/arch/amd64/amd64/wscons_machdep.c","wscnprobe",82,99
10,3,40,1,11,"wscninit@102-113@sys/arch/amd64/amd64/wscons_machdep.c","sys/arch/amd64/amd64/wscons_machdep.c","wscninit",102,113
4,1,17,2,3,"wscnputc@116-119@sys/arch/amd64/amd64/wscons_machdep.c","sys/arch/amd64/amd64/wscons_machdep.c","wscnputc",116,119
4,1,15,1,3,"wscngetc@122-125@sys/arch/amd64/amd64/wscons_machdep.c","sys/arch/amd64/amd64/wscons_machdep.c","wscngetc",122,125
4,1,17,2,3,"wscnpollc@128-131@sys/arch/amd64/amd64/wscons_machdep.c","sys/arch/amd64/amd64/wscons_machdep.c","wscnpollc",128,131
12,9,75,1,19,"wscn_video_init@137-156@sys/arch/amd64/amd64/wscons_machdep.c","sys/arch/amd64/amd64/wscons_machdep.c","wscn_video_init",137,156
11,8,50,1,17,"wscn_input_init@183-200@sys/arch/amd64/amd64/wscons_machdep.c","sys/arch/amd64/amd64/wscons_machdep.c","wscn_input_init",183,200
7,1,57,3,7,"_atomic_cas_uint@59-66@sys/arch/amd64/include/atomic.h","sys/arch/amd64/include/atomic.h","_atomic_cas_uint",59,66
7,1,57,3,7,"_atomic_cas_ulong@70-77@sys/arch/amd64/include/atomic.h","sys/arch/amd64/include/atomic.h","_atomic_cas_ulong",70,77
7,1,66,3,7,"_atomic_cas_ptr@81-88@sys/arch/amd64/include/atomic.h","sys/arch/amd64/include/atomic.h","_atomic_cas_ptr",81,88
7,1,47,2,7,"_atomic_swap_uint@92-99@sys/arch/amd64/include/atomic.h","sys/arch/amd64/include/atomic.h","_atomic_swap_uint",92,99
7,1,47,2,7,"_atomic_swap_ulong@104-111@sys/arch/amd64/include/atomic.h","sys/arch/amd64/include/atomic.h","_atomic_swap_ulong",104,111
7,1,45,2,7,"_atomic_swap_64@115-122@sys/arch/amd64/include/atomic.h","sys/arch/amd64/include/atomic.h","_atomic_swap_64",115,122
7,1,56,2,7,"_atomic_swap_ptr@126-133@sys/arch/amd64/include/atomic.h","sys/arch/amd64/include/atomic.h","_atomic_swap_ptr",126,133
5,1,23,1,4,"_atomic_inc_int@137-141@sys/arch/amd64/include/atomic.h","sys/arch/amd64/include/atomic.h","_atomic_inc_int",137,141
5,1,23,1,4,"_atomic_inc_long@145-149@sys/arch/amd64/include/atomic.h","sys/arch/amd64/include/atomic.h","_atomic_inc_long",145,149
5,1,23,1,4,"_atomic_dec_int@153-157@sys/arch/amd64/include/atomic.h","sys/arch/amd64/include/atomic.h","_atomic_dec_int",153,157
5,1,23,1,4,"_atomic_dec_long@161-165@sys/arch/amd64/include/atomic.h","sys/arch/amd64/include/atomic.h","_atomic_dec_long",161,165
6,1,32,2,5,"_atomic_add_int@169-174@sys/arch/amd64/include/atomic.h","sys/arch/amd64/include/atomic.h","_atomic_add_int",169,174
6,1,32,2,5,"_atomic_add_long@178-183@sys/arch/amd64/include/atomic.h","sys/arch/amd64/include/atomic.h","_atomic_add_long",178,183
6,1,32,2,5,"_atomic_sub_int@187-192@sys/arch/amd64/include/atomic.h","sys/arch/amd64/include/atomic.h","_atomic_sub_int",187,192
6,1,32,2,5,"_atomic_sub_long@196-201@sys/arch/amd64/include/atomic.h","sys/arch/amd64/include/atomic.h","_atomic_sub_long",196,201
7,1,45,2,8,"_atomic_add_int_nv@206-214@sys/arch/amd64/include/atomic.h","sys/arch/amd64/include/atomic.h","_atomic_add_int_nv",206,214
7,1,45,2,8,"_atomic_add_long_nv@218-226@sys/arch/amd64/include/atomic.h","sys/arch/amd64/include/atomic.h","_atomic_add_long_nv",218,226
7,1,47,2,8,"_atomic_sub_int_nv@230-238@sys/arch/amd64/include/atomic.h","sys/arch/amd64/include/atomic.h","_atomic_sub_int_nv",230,238
7,1,47,2,8,"_atomic_sub_long_nv@242-250@sys/arch/amd64/include/atomic.h","sys/arch/amd64/include/atomic.h","_atomic_sub_long_nv",242,250
4,1,30,2,3,"x86_atomic_setbits_u32@290-293@sys/arch/amd64/include/atomic.h","sys/arch/amd64/include/atomic.h","x86_atomic_setbits_u32",290,293
4,1,30,2,3,"x86_atomic_clearbits_u32@296-299@sys/arch/amd64/include/atomic.h","sys/arch/amd64/include/atomic.h","x86_atomic_clearbits_u32",296,299
4,1,30,2,3,"x86_atomic_setbits_u64@302-305@sys/arch/amd64/include/atomic.h","sys/arch/amd64/include/atomic.h","x86_atomic_setbits_u64",302,305
4,1,30,2,3,"x86_atomic_clearbits_u64@308-311@sys/arch/amd64/include/atomic.h","sys/arch/amd64/include/atomic.h","x86_atomic_clearbits_u64",308,311
15,3,61,5,14,"bus_space_barrier@476-490@sys/arch/amd64/include/bus.h","sys/arch/amd64/include/bus.h","bus_space_barrier",476,490
4,1,21,1,3,"invlpg@49-52@sys/arch/amd64/include/cpufunc.h","sys/arch/amd64/include/cpufunc.h","invlpg",49,52
4,1,22,1,3,"lidt@55-58@sys/arch/amd64/include/cpufunc.h","sys/arch/amd64/include/cpufunc.h","lidt",55,58
4,1,19,1,3,"lldt@61-64@sys/arch/amd64/include/cpufunc.h","sys/arch/amd64/include/cpufunc.h","lldt",61,64
4,1,19,1,3,"ltr@67-70@sys/arch/amd64/include/cpufunc.h","sys/arch/amd64/include/cpufunc.h","ltr",67,70
5,1,24,1,4,"lcr8@73-77@sys/arch/amd64/include/cpufunc.h","sys/arch/amd64/include/cpufunc.h","lcr8",73,77
5,1,24,1,4,"lcr0@83-87@sys/arch/amd64/include/cpufunc.h","sys/arch/amd64/include/cpufunc.h","lcr0",83,87
8,1,30,1,7,"rcr0@90-97@sys/arch/amd64/include/cpufunc.h","sys/arch/amd64/include/cpufunc.h","rcr0",90,97
6,1,23,1,5,"rcr2@100-105@sys/arch/amd64/include/cpufunc.h","sys/arch/amd64/include/cpufunc.h","rcr2",100,105
4,1,19,1,3,"lcr3@108-111@sys/arch/amd64/include/cpufunc.h","sys/arch/amd64/include/cpufunc.h","lcr3",108,111
6,1,23,1,5,"rcr3@114-119@sys/arch/amd64/include/cpufunc.h","sys/arch/amd64/include/cpufunc.h","rcr3",114,119
5,1,24,1,5,"lcr4@125-130@sys/arch/amd64/include/cpufunc.h","sys/arch/amd64/include/cpufunc.h","lcr4",125,130
6,1,26,1,5,"rcr4@133-138@sys/arch/amd64/include/cpufunc.h","sys/arch/amd64/include/cpufunc.h","rcr4",133,138
6,1,32,1,5,"tlbflush@141-146@sys/arch/amd64/include/cpufunc.h","sys/arch/amd64/include/cpufunc.h","tlbflush",141,146
4,1,12,1,3,"disable_intr@156-159@sys/arch/amd64/include/cpufunc.h","sys/arch/amd64/include/cpufunc.h","disable_intr",156,159
4,1,12,1,3,"enable_intr@162-165@sys/arch/amd64/include/cpufunc.h","sys/arch/amd64/include/cpufunc.h","enable_intr",162,165
6,1,25,1,6,"read_rflags@168-174@sys/arch/amd64/include/cpufunc.h","sys/arch/amd64/include/cpufunc.h","read_rflags",168,174
4,1,19,1,3,"write_rflags@177-180@sys/arch/amd64/include/cpufunc.h","sys/arch/amd64/include/cpufunc.h","write_rflags",177,180
7,1,24,1,7,"intr_disable@183-190@sys/arch/amd64/include/cpufunc.h","sys/arch/amd64/include/cpufunc.h","intr_disable",183,190
4,1,12,1,3,"intr_restore@193-196@sys/arch/amd64/include/cpufunc.h","sys/arch/amd64/include/cpufunc.h","intr_restore",193,196
6,1,51,1,5,"rdmsr@199-204@sys/arch/amd64/include/cpufunc.h","sys/arch/amd64/include/cpufunc.h","rdmsr",199,204
5,1,37,2,4,"wrmsr@207-211@sys/arch/amd64/include/cpufunc.h","sys/arch/amd64/include/cpufunc.h","wrmsr",207,211
8,1,59,2,7,"rdmsr_locked@222-229@sys/arch/amd64/include/cpufunc.h","sys/arch/amd64/include/cpufunc.h","rdmsr_locked",222,229
5,1,45,3,4,"wrmsr_locked@232-236@sys/arch/amd64/include/cpufunc.h","sys/arch/amd64/include/cpufunc.h","wrmsr_locked",232,236
4,1,12,1,3,"wbinvd@239-242@sys/arch/amd64/include/cpufunc.h","sys/arch/amd64/include/cpufunc.h","wbinvd",239,242
4,1,24,1,3,"clflush@245-248@sys/arch/amd64/include/cpufunc.h","sys/arch/amd64/include/cpufunc.h","clflush",245,248
4,1,16,1,3,"mfence@251-254@sys/arch/amd64/include/cpufunc.h","sys/arch/amd64/include/cpufunc.h","mfence",251,254
6,1,45,1,6,"rdtsc@257-263@sys/arch/amd64/include/cpufunc.h","sys/arch/amd64/include/cpufunc.h","rdtsc",257,263
6,1,51,1,6,"rdpmc@266-272@sys/arch/amd64/include/cpufunc.h","sys/arch/amd64/include/cpufunc.h","rdpmc",266,272
5,1,38,3,5,"monitor@275-280@sys/arch/amd64/include/cpufunc.h","sys/arch/amd64/include/cpufunc.h","monitor",275,280
4,1,27,2,4,"mwait@283-287@sys/arch/amd64/include/cpufunc.h","sys/arch/amd64/include/cpufunc.h","mwait",283,287
7,1,49,2,7,"xsetbv@290-297@sys/arch/amd64/include/cpufunc.h","sys/arch/amd64/include/cpufunc.h","xsetbv",290,297
6,1,51,1,7,"xgetbv@300-307@sys/arch/amd64/include/cpufunc.h","sys/arch/amd64/include/cpufunc.h","xgetbv",300,307
4,1,12,1,3,"breakpoint@311-314@sys/arch/amd64/include/cpufunc.h","sys/arch/amd64/include/cpufunc.h","breakpoint",311,314
8,1,52,2,8,"xsave@85-93@sys/arch/amd64/include/fpu.h","sys/arch/amd64/include/fpu.h","xsave",85,93
7,1,51,2,7,"xrstor@96-103@sys/arch/amd64/include/fpu.h","sys/arch/amd64/include/fpu.h","xrstor",96,103
6,1,29,1,5,"__inbc@61-66@sys/arch/amd64/include/pio.h","sys/arch/amd64/include/pio.h","__inbc",61,66
6,1,29,1,5,"__inb@69-74@sys/arch/amd64/include/pio.h","sys/arch/amd64/include/pio.h","__inb",69,74
9,1,54,3,8,"insb@77-85@sys/arch/amd64/include/pio.h","sys/arch/amd64/include/pio.h","insb",77,85
6,1,29,1,5,"__inwc@91-96@sys/arch/amd64/include/pio.h","sys/arch/amd64/include/pio.h","__inwc",91,96
6,1,29,1,5,"__inw@99-104@sys/arch/amd64/include/pio.h","sys/arch/amd64/include/pio.h","__inw",99,104
9,1,54,3,8,"insw@107-115@sys/arch/amd64/include/pio.h","sys/arch/amd64/include/pio.h","insw",107,115
6,1,29,1,5,"__inlc@121-126@sys/arch/amd64/include/pio.h","sys/arch/amd64/include/pio.h","__inlc",121,126
6,1,29,1,5,"__inl@129-134@sys/arch/amd64/include/pio.h","sys/arch/amd64/include/pio.h","__inl",129,134
9,1,54,3,8,"insl@137-145@sys/arch/amd64/include/pio.h","sys/arch/amd64/include/pio.h","insl",137,145
4,1,27,2,3,"__outbc@152-155@sys/arch/amd64/include/pio.h","sys/arch/amd64/include/pio.h","__outbc",152,155
4,1,27,2,3,"__outb@158-161@sys/arch/amd64/include/pio.h","sys/arch/amd64/include/pio.h","__outb",158,161
8,1,53,3,7,"outsb@164-171@sys/arch/amd64/include/pio.h","sys/arch/amd64/include/pio.h","outsb",164,171
4,1,27,2,3,"__outwc@178-181@sys/arch/amd64/include/pio.h","sys/arch/amd64/include/pio.h","__outwc",178,181
4,1,27,2,3,"__outw@184-187@sys/arch/amd64/include/pio.h","sys/arch/amd64/include/pio.h","__outw",184,187
8,1,53,3,7,"outsw@190-197@sys/arch/amd64/include/pio.h","sys/arch/amd64/include/pio.h","outsw",190,197
4,1,27,2,3,"__outlc@204-207@sys/arch/amd64/include/pio.h","sys/arch/amd64/include/pio.h","__outlc",204,207
4,1,27,2,3,"__outl@210-213@sys/arch/amd64/include/pio.h","sys/arch/amd64/include/pio.h","__outl",210,213
8,1,53,3,7,"outsl@216-223@sys/arch/amd64/include/pio.h","sys/arch/amd64/include/pio.h","outsl",216,223
3,1,9,1,3,"pmap_remove_all@401-404@sys/arch/amd64/include/pmap.h","sys/arch/amd64/include/pmap.h","pmap_remove_all",401,404
4,1,12,1,3,"pmap_update_pg@412-415@sys/arch/amd64/include/pmap.h","sys/arch/amd64/include/pmap.h","pmap_update_pg",412,415
5,1,20,2,4,"pmap_update_2pg@422-426@sys/arch/amd64/include/pmap.h","sys/arch/amd64/include/pmap.h","pmap_update_2pg",422,426
10,3,54,2,9,"pmap_page_protect@438-447@sys/arch/amd64/include/pmap.h","sys/arch/amd64/include/pmap.h","pmap_page_protect",438,447
10,3,65,4,9,"pmap_protect@458-467@sys/arch/amd64/include/pmap.h","sys/arch/amd64/include/pmap.h","pmap_protect",458,467
4,1,17,1,3,"vtopte@479-482@sys/arch/amd64/include/pmap.h","sys/arch/amd64/include/pmap.h","vtopte",479,482
10,3,48,1,13,"kvtopte@485-498@sys/arch/amd64/include/pmap.h","sys/arch/amd64/include/pmap.h","kvtopte",485,498
6,1,29,1,5,"__amd64_read_tcb@40-45@sys/arch/amd64/include/tcb.h","sys/arch/amd64/include/tcb.h","__amd64_read_tcb",40,45
6,1,33,2,5,"mc146818_read@135-140@sys/arch/amd64/isa/clock.c","sys/arch/amd64/isa/clock.c","mc146818_read",135,140
7,1,40,3,6,"mc146818_write@143-149@sys/arch/amd64/isa/clock.c","sys/arch/amd64/isa/clock.c","mc146818_write",143,149
7,1,29,1,6,"startclocks@156-162@sys/arch/amd64/isa/clock.c","sys/arch/amd64/isa/clock.c","startclocks",156,162
14,3,54,1,16,"clockintr@165-181@sys/arch/amd64/isa/clock.c","sys/arch/amd64/isa/clock.c","clockintr",165,181
10,2,47,1,15,"rtcintr@184-199@sys/arch/amd64/isa/clock.c","sys/arch/amd64/isa/clock.c","rtcintr",184,199
14,1,82,1,16,"gettick@202-218@sys/arch/amd64/isa/clock.c","sys/arch/amd64/isa/clock.c","gettick",202,218
36,5,257,1,55,"i8254_delay@228-283@sys/arch/amd64/isa/clock.c","sys/arch/amd64/isa/clock.c","i8254_delay",228,283
8,3,43,1,13,"rtcdrain@286-299@sys/arch/amd64/isa/clock.c","sys/arch/amd64/isa/clock.c","rtcdrain",286,299
11,1,56,1,13,"i8254_initclocks@302-315@sys/arch/amd64/isa/clock.c","sys/arch/amd64/isa/clock.c","i8254_initclocks",302,315
8,1,56,1,17,"rtcstart@318-335@sys/arch/amd64/isa/clock.c","sys/arch/amd64/isa/clock.c","rtcstart",318,335
4,1,15,1,3,"rtcstop@338-341@sys/arch/amd64/isa/clock.c","sys/arch/amd64/isa/clock.c","rtcstop",338,341
7,2,41,1,6,"rtcget@344-350@sys/arch/amd64/isa/clock.c","sys/arch/amd64/isa/clock.c","rtcget",344,350
4,1,15,1,3,"rtcput@353-356@sys/arch/amd64/isa/clock.c","sys/arch/amd64/isa/clock.c","rtcput",353,356
4,1,29,1,3,"bcdtobin@359-362@sys/arch/amd64/isa/clock.c","sys/arch/amd64/isa/clock.c","bcdtobin",359,362
4,1,38,1,3,"bintobcd@365-368@sys/arch/amd64/isa/clock.c","sys/arch/amd64/isa/clock.c","bintobcd",365,368
9,2,61,1,10,"cmoscheck@378-388@sys/arch/amd64/isa/clock.c","sys/arch/amd64/isa/clock.c","cmoscheck",378,388
32,12,188,1,40,"clock_expandyear@406-446@sys/arch/amd64/isa/clock.c","sys/arch/amd64/isa/clock.c","clock_expandyear",406,446
46,8,304,1,69,"inittodr@453-522@sys/arch/amd64/isa/clock.c","sys/arch/amd64/isa/clock.c","inittodr",453,522
32,6,252,1,42,"resettodr@528-570@sys/arch/amd64/isa/clock.c","sys/arch/amd64/isa/clock.c","resettodr",528,570
11,3,44,1,10,"setstatclockrate@573-583@sys/arch/amd64/isa/clock.c","sys/arch/amd64/isa/clock.c","setstatclockrate",573,583
4,1,12,1,3,"i8254_inittimecounter@586-589@sys/arch/amd64/isa/clock.c","sys/arch/amd64/isa/clock.c","i8254_inittimecounter",586,589
11,1,50,1,12,"i8254_inittimecounter_simple@596-608@sys/arch/amd64/isa/clock.c","sys/arch/amd64/isa/clock.c","i8254_inittimecounter_simple",596,608
7,1,47,1,7,"i8254_startclock@611-618@sys/arch/amd64/isa/clock.c","sys/arch/amd64/isa/clock.c","i8254_startclock",611,618
4,1,18,1,3,"i8254_simple_get_timecount@621-624@sys/arch/amd64/isa/clock.c","sys/arch/amd64/isa/clock.c","i8254_simple_get_timecount",621,624
20,2,108,1,24,"i8254_get_timecount@627-651@sys/arch/amd64/isa/clock.c","sys/arch/amd64/isa/clock.c","i8254_get_timecount",627,651
6,3,37,1,11,"isa_strayintr@160-171@sys/arch/amd64/isa/isa_machdep.c","sys/arch/amd64/isa/isa_machdep.c","isa_strayintr",160,171
4,1,11,1,3,"fakeintr@178-181@sys/arch/amd64/isa/isa_machdep.c","sys/arch/amd64/isa/isa_machdep.c","fakeintr",178,181
39,14,230,4,67,"isa_intr_alloc@186-253@sys/arch/amd64/isa/isa_machdep.c","sys/arch/amd64/isa/isa_machdep.c","isa_intr_alloc",186,253
20,9,95,3,20,"isa_intr_check@262-282@sys/arch/amd64/isa/isa_machdep.c","sys/arch/amd64/isa/isa_machdep.c","isa_intr_check",262,282
22,6,146,7,28,"isa_intr_establish@289-317@sys/arch/amd64/isa/isa_machdep.c","sys/arch/amd64/isa/isa_machdep.c","isa_intr_establish",289,317
5,1,18,2,4,"isa_intr_disestablish@323-327@sys/arch/amd64/isa/isa_machdep.c","sys/arch/amd64/isa/isa_machdep.c","isa_intr_disestablish",323,327
8,2,36,3,12,"isa_attach_hook@330-342@sys/arch/amd64/isa/isa_machdep.c","sys/arch/amd64/isa/isa_machdep.c","isa_attach_hook",330,342
43,10,276,7,80,"_isa_bus_dmamap_create@369-449@sys/arch/amd64/isa/isa_machdep.c","sys/arch/amd64/isa/isa_machdep.c","_isa_bus_dmamap_create",369,449
8,2,50,2,12,"_isa_bus_dmamap_destroy@455-467@sys/arch/amd64/isa/isa_machdep.c","sys/arch/amd64/isa/isa_machdep.c","_isa_bus_dmamap_destroy",455,467
32,7,219,6,61,"_isa_bus_dmamap_load@473-534@sys/arch/amd64/isa/isa_machdep.c","sys/arch/amd64/isa/isa_machdep.c","_isa_bus_dmamap_load",473,534
5,1,23,4,5,"_isa_bus_dmamap_load_mbuf@540-545@sys/arch/amd64/isa/isa_machdep.c","sys/arch/amd64/isa/isa_machdep.c","_isa_bus_dmamap_load_mbuf",540,545
5,1,23,4,5,"_isa_bus_dmamap_load_uio@551-556@sys/arch/amd64/isa/isa_machdep.c","sys/arch/amd64/isa/isa_machdep.c","_isa_bus_dmamap_load_uio",551,556
5,1,28,6,5,"_isa_bus_dmamap_load_raw@563-568@sys/arch/amd64/isa/isa_machdep.c","sys/arch/amd64/isa/isa_machdep.c","_isa_bus_dmamap_load_raw",563,568
9,3,59,2,18,"_isa_bus_dmamap_unload@574-592@sys/arch/amd64/isa/isa_machdep.c","sys/arch/amd64/isa/isa_machdep.c","_isa_bus_dmamap_unload",574,592
25,13,188,5,41,"_isa_bus_dmamap_sync@598-639@sys/arch/amd64/isa/isa_machdep.c","sys/arch/amd64/isa/isa_machdep.c","_isa_bus_dmamap_sync",598,639
13,2,105,8,16,"_isa_bus_dmamem_alloc@645-661@sys/arch/amd64/isa/isa_machdep.c","sys/arch/amd64/isa/isa_machdep.c","_isa_bus_dmamem_alloc",645,661
35,9,195,5,54,"_isa_dma_check_buffer@672-726@sys/arch/amd64/isa/isa_machdep.c","sys/arch/amd64/isa/isa_machdep.c","_isa_dma_check_buffer",672,726
27,3,164,4,29,"_isa_dma_alloc_bouncebuf@729-758@sys/arch/amd64/isa/isa_machdep.c","sys/arch/amd64/isa/isa_machdep.c","_isa_dma_alloc_bouncebuf",729,758
12,1,68,2,13,"_isa_dma_free_bouncebuf@761-774@sys/arch/amd64/isa/isa_machdep.c","sys/arch/amd64/isa/isa_machdep.c","_isa_dma_free_bouncebuf",761,774
8,3,54,3,9,"aapic_match@43-52@sys/arch/amd64/pci/aapic.c","sys/arch/amd64/pci/aapic.c","aapic_match",43,52
20,3,156,3,26,"aapic_attach@55-81@sys/arch/amd64/pci/aapic.c","sys/arch/amd64/pci/aapic.c","aapic_attach",55,81
4,1,10,1,3,"agp_flush_cache@60-63@sys/arch/amd64/pci/agp_machdep.c","sys/arch/amd64/pci/agp_machdep.c","agp_flush_cache",60,63
4,1,17,2,3,"agp_flush_cache_range@66-69@sys/arch/amd64/pci/agp_machdep.c","sys/arch/amd64/pci/agp_machdep.c","agp_flush_cache_range",66,69
17,3,123,5,19,"agp_init_map@78-97@sys/arch/amd64/pci/agp_machdep.c","sys/arch/amd64/pci/agp_machdep.c","agp_init_map",78,97
5,1,37,1,4,"agp_destroy_map@100-104@sys/arch/amd64/pci/agp_machdep.c","sys/arch/amd64/pci/agp_machdep.c","agp_destroy_map",100,104
5,1,39,4,4,"agp_map_subregion@108-112@sys/arch/amd64/pci/agp_machdep.c","sys/arch/amd64/pci/agp_machdep.c","agp_map_subregion",108,112
4,1,15,3,4,"agp_unmap_subregion@115-119@sys/arch/amd64/pci/agp_machdep.c","sys/arch/amd64/pci/agp_machdep.c","agp_unmap_subregion",115,119
5,1,27,3,4,"agp_map_atomic@122-126@sys/arch/amd64/pci/agp_machdep.c","sys/arch/amd64/pci/agp_machdep.c","agp_map_atomic",122,126
3,1,12,2,3,"agp_unmap_atomic@129-132@sys/arch/amd64/pci/agp_machdep.c","sys/arch/amd64/pci/agp_machdep.c","agp_unmap_atomic",129,132
8,3,54,3,9,"pchbmatch@135-144@sys/arch/amd64/pci/pchb.c","sys/arch/amd64/pci/pchb.c","pchbmatch",135,144
97,21,605,3,127,"pchbattach@147-274@sys/arch/amd64/pci/pchb.c","sys/arch/amd64/pci/pchb.c","pchbattach",147,274
19,3,101,2,20,"pchbactivate@277-297@sys/arch/amd64/pci/pchb.c","sys/arch/amd64/pci/pchb.c","pchbactivate",277,297
8,2,49,2,8,"pchb_print@300-308@sys/arch/amd64/pci/pchb.c","sys/arch/amd64/pci/pchb.c","pchb_print",300,308
14,3,95,1,21,"pchb_rnd@315-336@sys/arch/amd64/pci/pchb.c","sys/arch/amd64/pci/pchb.c","pchb_rnd",315,336
25,4,190,3,26,"pchb_amd64ht_attach@339-365@sys/arch/amd64/pci/pchb.c","sys/arch/amd64/pci/pchb.c","pchb_amd64ht_attach",339,365
34,10,186,3,61,"pci_attach_hook@145-206@sys/arch/amd64/pci/pci_machdep.c","sys/arch/amd64/pci/pci_machdep.c","pci_attach_hook",145,206
4,1,15,2,3,"pci_bus_maxdevs@209-212@sys/arch/amd64/pci/pci_machdep.c","sys/arch/amd64/pci/pci_machdep.c","pci_bus_maxdevs",209,212
7,4,61,4,7,"pci_make_tag@215-222@sys/arch/amd64/pci/pci_machdep.c","sys/arch/amd64/pci/pci_machdep.c","pci_make_tag",215,222
9,4,76,5,8,"pci_decompose_tag@225-233@sys/arch/amd64/pci/pci_machdep.c","sys/arch/amd64/pci/pci_machdep.c","pci_decompose_tag",225,233
10,4,49,2,11,"pci_conf_size@236-247@sys/arch/amd64/pci/pci_machdep.c","sys/arch/amd64/pci/pci_machdep.c","pci_conf_size",236,247
8,3,50,1,8,"pci_mcfg_map_bus@250-258@sys/arch/amd64/pci/pci_machdep.c","sys/arch/amd64/pci/pci_machdep.c","pci_mcfg_map_bus",250,258
21,5,131,3,24,"pci_conf_read@261-285@sys/arch/amd64/pci/pci_machdep.c","sys/arch/amd64/pci/pci_machdep.c","pci_conf_read",261,285
19,5,127,4,21,"pci_conf_write@288-309@sys/arch/amd64/pci/pci_machdep.c","sys/arch/amd64/pci/pci_machdep.c","pci_conf_write",288,309
3,1,12,2,2,"msi_hwmask@331-333@sys/arch/amd64/pci/pci_machdep.c","sys/arch/amd64/pci/pci_machdep.c","msi_hwmask",331,333
3,1,12,2,2,"msi_hwunmask@336-338@sys/arch/amd64/pci/pci_machdep.c","sys/arch/amd64/pci/pci_machdep.c","msi_hwunmask",336,338
19,3,169,5,21,"msi_addroute@341-362@sys/arch/amd64/pci/pci_machdep.c","sys/arch/amd64/pci/pci_machdep.c","msi_addroute",341,362
9,2,69,5,9,"msi_delroute@365-374@sys/arch/amd64/pci/pci_machdep.c","sys/arch/amd64/pci/pci_machdep.c","msi_delroute",365,374
12,4,82,2,13,"pci_intr_map_msi@377-390@sys/arch/amd64/pci/pci_machdep.c","sys/arch/amd64/pci/pci_machdep.c","pci_intr_map_msi",377,390
3,1,12,2,2,"msix_hwmask@422-424@sys/arch/amd64/pci/pci_machdep.c","sys/arch/amd64/pci/pci_machdep.c","msix_hwmask",422,424
3,1,12,2,2,"msix_hwunmask@427-429@sys/arch/amd64/pci/pci_machdep.c","sys/arch/amd64/pci/pci_machdep.c","msix_hwunmask",427,429
33,4,303,5,39,"msix_addroute@432-471@sys/arch/amd64/pci/pci_machdep.c","sys/arch/amd64/pci/pci_machdep.c","msix_addroute",432,471
27,4,226,5,31,"msix_delroute@474-505@sys/arch/amd64/pci/pci_machdep.c","sys/arch/amd64/pci/pci_machdep.c","msix_delroute",474,505
16,5,116,3,19,"pci_intr_map_msix@508-527@sys/arch/amd64/pci/pci_machdep.c","sys/arch/amd64/pci/pci_machdep.c","pci_intr_map_msix",508,527
81,29,472,2,119,"pci_intr_map@530-649@sys/arch/amd64/pci/pci_machdep.c","sys/arch/amd64/pci/pci_machdep.c","pci_intr_map",530,649
18,6,138,2,23,"pci_intr_string@652-675@sys/arch/amd64/pci/pci_machdep.c","sys/arch/amd64/pci/pci_machdep.c","pci_intr_string",652,675
33,9,262,6,41,"pci_intr_establish@683-724@sys/arch/amd64/pci/pci_machdep.c","sys/arch/amd64/pci/pci_machdep.c","pci_intr_establish",683,724
4,1,16,2,3,"pci_intr_disestablish@727-730@sys/arch/amd64/pci/pci_machdep.c","sys/arch/amd64/pci/pci_machdep.c","pci_intr_disestablish",727,730
39,11,234,1,66,"pci_init_extents@737-803@sys/arch/amd64/pci/pci_machdep.c","sys/arch/amd64/pci/pci_machdep.c","pci_init_extents",737,803
4,2,21,2,5,"pci_dev_postattach@813-818@sys/arch/amd64/pci/pci_machdep.c","sys/arch/amd64/pci/pci_machdep.c","pci_dev_postattach",813,818
5,2,26,2,7,"pci_min_powerstate@821-828@sys/arch/amd64/pci/pci_machdep.c","sys/arch/amd64/pci/pci_machdep.c","pci_min_powerstate",821,828
4,2,27,4,5,"pci_set_powerstate_md@831-836@sys/arch/amd64/pci/pci_machdep.c","sys/arch/amd64/pci/pci_machdep.c","pci_set_powerstate_md",831,836
31,12,146,3,36,"pcibmatch@61-97@sys/arch/amd64/pci/pcib.c","sys/arch/amd64/pci/pcib.c","pcibmatch",61,97
5,1,30,3,8,"pcibattach@100-108@sys/arch/amd64/pci/pcib.c","sys/arch/amd64/pci/pcib.c","pcibattach",100,108
10,2,61,1,15,"pcib_callback@111-126@sys/arch/amd64/pci/pcib.c","sys/arch/amd64/pci/pcib.c","pcib_callback",111,126
6,2,29,2,6,"pcib_print@129-135@sys/arch/amd64/pci/pcib.c","sys/arch/amd64/pci/pcib.c","pcib_print",129,135
10,1,71,5,11,"pciide_machdep_compat_intr_establish@54-65@sys/arch/amd64/pci/pciide_machdep.c","sys/arch/amd64/pci/pciide_machdep.c","pciide_machdep_compat_intr_establish",54,65
4,1,18,2,3,"pciide_machdep_compat_intr_disestablish@68-71@sys/arch/amd64/pci/pciide_machdep.c","sys/arch/amd64/pci/pciide_machdep.c","pciide_machdep_compat_intr_disestablish",68,71
8,4,40,2,9,"vm86_emu_inb@60-69@sys/arch/amd64/pci/vga_post.c","sys/arch/amd64/pci/vga_post.c","vm86_emu_inb",60,69
6,3,31,2,6,"vm86_emu_inw@72-78@sys/arch/amd64/pci/vga_post.c","sys/arch/amd64/pci/vga_post.c","vm86_emu_inw",72,78
6,3,31,2,6,"vm86_emu_inl@81-87@sys/arch/amd64/pci/vga_post.c","sys/arch/amd64/pci/vga_post.c","vm86_emu_inl",81,87
8,4,42,3,9,"vm86_emu_outb@90-99@sys/arch/amd64/pci/vga_post.c","sys/arch/amd64/pci/vga_post.c","vm86_emu_outb",90,99
6,3,34,3,6,"vm86_emu_outw@102-108@sys/arch/amd64/pci/vga_post.c","sys/arch/amd64/pci/vga_post.c","vm86_emu_outw",102,108
6,3,34,3,6,"vm86_emu_outl@111-117@sys/arch/amd64/pci/vga_post.c","sys/arch/amd64/pci/vga_post.c","vm86_emu_outl",111,117
56,6,442,3,67,"vga_post_init@120-187@sys/arch/amd64/pci/vga_post.c","sys/arch/amd64/pci/vga_post.c","vga_post_init",120,187
11,1,100,1,15,"vga_post_call@190-205@sys/arch/amd64/pci/vga_post.c","sys/arch/amd64/pci/vga_post.c","vga_post_call",190,205
8,1,61,1,7,"vga_post_free@208-215@sys/arch/amd64/pci/vga_post.c","sys/arch/amd64/pci/vga_post.c","vga_post_free",208,215
7,2,21,1,7,"ddb_vgapost@219-226@sys/arch/amd64/pci/vga_post.c","sys/arch/amd64/pci/vga_post.c","ddb_vgapost",219,226
53,14,303,2,75,"efi_main@71-146@sys/arch/amd64/stand/efiboot/efiboot.c","sys/arch/amd64/stand/efiboot/efiboot.c","efi_main",71,146
13,4,65,1,14,"efi_cleanup@149-163@sys/arch/amd64/stand/efiboot/efiboot.c","sys/arch/amd64/stand/efiboot/efiboot.c","efi_cleanup",149,163
50,15,354,1,63,"efi_diskprobe@171-234@sys/arch/amd64/stand/efiboot/efiboot.c","sys/arch/amd64/stand/efiboot/efiboot.c","efi_diskprobe",171,234
9,3,58,2,10,"efi_device_path_depth@241-251@sys/arch/amd64/stand/efiboot/efiboot.c","sys/arch/amd64/stand/efiboot/efiboot.c","efi_device_path_depth",241,251
18,9,139,3,19,"efi_device_path_ncmp@254-273@sys/arch/amd64/stand/efiboot/efiboot.c","sys/arch/amd64/stand/efiboot/efiboot.c","efi_device_path_ncmp",254,273
9,2,45,1,9,"efi_heap_init@281-290@sys/arch/amd64/stand/efiboot/efiboot.c","sys/arch/amd64/stand/efiboot/efiboot.c","efi_heap_init",281,290
26,7,155,1,27,"efi_memprobe@293-320@sys/arch/amd64/stand/efiboot/efiboot.c","sys/arch/amd64/stand/efiboot/efiboot.c","efi_memprobe",293,320
71,26,524,1,78,"efi_memprobe_internal@323-401@sys/arch/amd64/stand/efiboot/efiboot.c","sys/arch/amd64/stand/efiboot/efiboot.c","efi_memprobe_internal",323,401
34,13,241,1,34,"efi_video_init@420-454@sys/arch/amd64/stand/efiboot/efiboot.c","sys/arch/amd64/stand/efiboot/efiboot.c","efi_video_init",420,454
7,1,42,1,6,"efi_video_reset@457-463@sys/arch/amd64/stand/efiboot/efiboot.c","sys/arch/amd64/stand/efiboot/efiboot.c","efi_video_reset",457,463
6,1,38,1,5,"efi_cons_probe@466-471@sys/arch/amd64/stand/efiboot/efiboot.c","sys/arch/amd64/stand/efiboot/efiboot.c","efi_cons_probe",466,471
3,1,9,1,2,"efi_cons_init@474-476@sys/arch/amd64/stand/efiboot/efiboot.c","sys/arch/amd64/stand/efiboot/efiboot.c","efi_cons_init",474,476
23,6,135,1,26,"efi_cons_getc@479-505@sys/arch/amd64/stand/efiboot/efiboot.c","sys/arch/amd64/stand/efiboot/efiboot.c","efi_cons_getc",479,505
9,2,54,2,11,"efi_cons_putc@508-519@sys/arch/amd64/stand/efiboot/efiboot.c","sys/arch/amd64/stand/efiboot/efiboot.c","efi_cons_putc",508,519
4,1,12,1,4,"efi_cons_getshifts@522-526@sys/arch/amd64/stand/efiboot/efiboot.c","sys/arch/amd64/stand/efiboot/efiboot.c","efi_cons_getshifts",522,526
52,15,366,1,61,"efi_com_probe@534-595@sys/arch/amd64/stand/efiboot/efiboot.c","sys/arch/amd64/stand/efiboot/efiboot.c","efi_com_probe",534,595
4,2,30,1,3,"efi_valid_com@598-601@sys/arch/amd64/stand/efiboot/efiboot.c","sys/arch/amd64/stand/efiboot/efiboot.c","efi_valid_com",598,601
26,6,165,2,31,"comspeed@604-635@sys/arch/amd64/stand/efiboot/efiboot.c","sys/arch/amd64/stand/efiboot/efiboot.c","comspeed",604,635
7,3,47,1,7,"efi_com_init@638-645@sys/arch/amd64/stand/efiboot/efiboot.c","sys/arch/amd64/stand/efiboot/efiboot.c","efi_com_init",638,645
30,11,174,1,34,"efi_com_getc@648-682@sys/arch/amd64/stand/efiboot/efiboot.c","sys/arch/amd64/stand/efiboot/efiboot.c","efi_com_getc",648,682
11,2,69,2,11,"efi_com_putc@685-696@sys/arch/amd64/stand/efiboot/efiboot.c","sys/arch/amd64/stand/efiboot/efiboot.c","efi_com_putc",685,696
8,3,50,1,9,"efi_gop_setmode@714-723@sys/arch/amd64/stand/efiboot/efiboot.c","sys/arch/amd64/stand/efiboot/efiboot.c","efi_gop_setmode",714,723
74,15,467,1,83,"efi_makebootargs@726-809@sys/arch/amd64/stand/efiboot/efiboot.c","sys/arch/amd64/stand/efiboot/efiboot.c","efi_makebootargs",726,809
8,3,38,1,9,"_rtt@812-821@sys/arch/amd64/stand/efiboot/efiboot.c","sys/arch/amd64/stand/efiboot/efiboot.c","_rtt",812,821
22,6,233,1,28,"getsecs@824-852@sys/arch/amd64/stand/efiboot/efiboot.c","sys/arch/amd64/stand/efiboot/efiboot.c","getsecs",824,852
7,2,33,1,6,"Xexit_efi@858-864@sys/arch/amd64/stand/efiboot/efiboot.c","sys/arch/amd64/stand/efiboot/efiboot.c","Xexit_efi",858,864
23,8,161,1,24,"Xvideo_efi@867-891@sys/arch/amd64/stand/efiboot/efiboot.c","sys/arch/amd64/stand/efiboot/efiboot.c","Xvideo_efi",867,891
5,1,26,1,4,"Xpoweroff_efi@894-898@sys/arch/amd64/stand/efiboot/efiboot.c","sys/arch/amd64/stand/efiboot/efiboot.c","Xpoweroff_efi",894,898
36,9,231,1,38,"Xgop_efi@901-939@sys/arch/amd64/stand/efiboot/efiboot.c","sys/arch/amd64/stand/efiboot/efiboot.c","Xgop_efi",901,939
10,1,77,2,10,"efid_init@72-82@sys/arch/amd64/stand/efiboot/efidev.c","sys/arch/amd64/stand/efiboot/efidev.c","efid_init",72,82
62,18,463,5,73,"efid_io@85-158@sys/arch/amd64/stand/efiboot/efidev.c","sys/arch/amd64/stand/efiboot/efidev.c","efid_io",85,158
6,2,57,5,7,"efid_diskio@161-168@sys/arch/amd64/stand/efiboot/efidev.c","sys/arch/amd64/stand/efiboot/efidev.c","efid_diskio",161,168
23,9,137,2,24,"gpt_chk_mbr@181-205@sys/arch/amd64/stand/efiboot/efidev.c","sys/arch/amd64/stand/efiboot/efidev.c","gpt_chk_mbr",181,205
50,16,305,2,63,"findopenbsd@219-282@sys/arch/amd64/stand/efiboot/efidev.c","sys/arch/amd64/stand/efiboot/efidev.c","findopenbsd",219,282
99,19,660,2,114,"findopenbsd_gpt@293-407@sys/arch/amd64/stand/efiboot/efidev.c","sys/arch/amd64/stand/efiboot/efidev.c","findopenbsd_gpt",293,407
41,13,285,2,61,"efi_getdisklabel@410-471@sys/arch/amd64/stand/efiboot/efidev.c","sys/arch/amd64/stand/efiboot/efidev.c","efi_getdisklabel",410,471
44,8,342,2,57,"efi_getdisklabel_cd9660@474-531@sys/arch/amd64/stand/efiboot/efidev.c","sys/arch/amd64/stand/efiboot/efidev.c","efi_getdisklabel_cd9660",474,531
129,41,755,2,180,"efiopen@534-714@sys/arch/amd64/stand/efiboot/efidev.c","sys/arch/amd64/stand/efiboot/efidev.c","efiopen",534,714
24,8,179,6,32,"efistrategy@717-749@sys/arch/amd64/stand/efiboot/efidev.c","sys/arch/amd64/stand/efiboot/efidev.c","efistrategy",717,749
5,1,18,1,5,"eficlose@752-757@sys/arch/amd64/stand/efiboot/efidev.c","sys/arch/amd64/stand/efiboot/efidev.c","eficlose",752,757
4,1,19,3,4,"efiioctl@760-764@sys/arch/amd64/stand/efiboot/efidev.c","sys/arch/amd64/stand/efiboot/efidev.c","efiioctl",760,764
29,4,177,1,31,"efi_dump_diskinfo@767-798@sys/arch/amd64/stand/efiboot/efidev.c","sys/arch/amd64/stand/efiboot/efidev.c","efi_dump_diskinfo",767,798
6,2,27,1,5,"heap_init@24-29@sys/arch/amd64/stand/efiboot/heap.h","sys/arch/amd64/stand/efiboot/heap.h","heap_init",24,29
41,12,202,2,55,"self_reloc@67-122@sys/arch/amd64/stand/efiboot/self_reloc.c","sys/arch/amd64/stand/efiboot/self_reloc.c","self_reloc",67,122
47,11,290,1,55,"efi_pxeprobe@50-105@sys/arch/amd64/stand/efiboot/efipxe.c","sys/arch/amd64/stand/efiboot/efipxe.c","efi_pxeprobe",50,105
35,6,253,2,40,"tftp_open@122-162@sys/arch/amd64/stand/efiboot/efipxe.c","sys/arch/amd64/stand/efiboot/efipxe.c","tftp_open",122,162
8,1,53,1,8,"tftp_close@165-173@sys/arch/amd64/stand/efiboot/efipxe.c","sys/arch/amd64/stand/efiboot/efipxe.c","tftp_close",165,173
19,5,120,4,22,"tftp_read@176-198@sys/arch/amd64/stand/efiboot/efipxe.c","sys/arch/amd64/stand/efiboot/efipxe.c","tftp_read",176,198
4,1,23,4,3,"tftp_write@201-204@sys/arch/amd64/stand/efiboot/efipxe.c","sys/arch/amd64/stand/efiboot/efipxe.c","tftp_write",201,204
26,7,133,3,26,"tftp_seek@207-233@sys/arch/amd64/stand/efiboot/efipxe.c","sys/arch/amd64/stand/efiboot/efipxe.c","tftp_seek",207,233
10,1,58,2,11,"tftp_stat@236-247@sys/arch/amd64/stand/efiboot/efipxe.c","sys/arch/amd64/stand/efiboot/efipxe.c","tftp_stat",236,247
4,1,16,2,3,"tftp_readdir@250-253@sys/arch/amd64/stand/efiboot/efipxe.c","sys/arch/amd64/stand/efiboot/efipxe.c","tftp_readdir",250,253
18,6,113,2,23,"tftpopen@259-282@sys/arch/amd64/stand/efiboot/efipxe.c","sys/arch/amd64/stand/efiboot/efipxe.c","tftpopen",259,282
4,1,12,1,3,"tftpclose@285-288@sys/arch/amd64/stand/efiboot/efipxe.c","sys/arch/amd64/stand/efiboot/efipxe.c","tftpclose",285,288
4,1,19,3,3,"tftpioctl@291-294@sys/arch/amd64/stand/efiboot/efipxe.c","sys/arch/amd64/stand/efiboot/efipxe.c","tftpioctl",291,294
5,1,28,6,4,"tftpstrategy@297-301@sys/arch/amd64/stand/efiboot/efipxe.c","sys/arch/amd64/stand/efiboot/efipxe.c","tftpstrategy",297,301
12,3,91,1,15,"pc_probe@52-67@sys/arch/amd64/stand/libsa/bioscons.c","sys/arch/amd64/stand/libsa/bioscons.c","pc_probe",52,67
3,1,9,1,2,"pc_init@70-72@sys/arch/amd64/stand/libsa/bioscons.c","sys/arch/amd64/stand/libsa/bioscons.c","pc_init",70,72
16,3,124,1,23,"pc_getc@75-98@sys/arch/amd64/stand/libsa/bioscons.c","sys/arch/amd64/stand/libsa/bioscons.c","pc_getc",75,98
7,1,43,1,8,"pc_getshifts@101-109@sys/arch/amd64/stand/libsa/bioscons.c","sys/arch/amd64/stand/libsa/bioscons.c","pc_getshifts",101,109
5,1,38,2,4,"pc_putc@112-116@sys/arch/amd64/stand/libsa/bioscons.c","sys/arch/amd64/stand/libsa/bioscons.c","pc_putc",112,116
11,2,82,1,14,"com_probe@121-135@sys/arch/amd64/stand/libsa/bioscons.c","sys/arch/amd64/stand/libsa/bioscons.c","com_probe",121,135
18,6,153,1,22,"com_init@141-163@sys/arch/amd64/stand/libsa/bioscons.c","sys/arch/amd64/stand/libsa/bioscons.c","com_init",141,163
9,4,75,1,11,"com_getc@166-177@sys/arch/amd64/stand/libsa/bioscons.c","sys/arch/amd64/stand/libsa/bioscons.c","com_getc",166,177
37,16,261,2,51,"comspeed@181-232@sys/arch/amd64/stand/libsa/bioscons.c","sys/arch/amd64/stand/libsa/bioscons.c","comspeed",181,232
7,3,55,2,8,"com_putc@235-243@sys/arch/amd64/stand/libsa/bioscons.c","sys/arch/amd64/stand/libsa/bioscons.c","com_putc",235,243
7,2,55,1,8,"biosdreset@76-84@sys/arch/amd64/stand/libsa/biosdev.c","sys/arch/amd64/stand/libsa/biosdev.c","biosdreset",76,84
52,22,359,2,90,"bios_getdiskinfo@92-182@sys/arch/amd64/stand/libsa/biosdev.c","sys/arch/amd64/stand/libsa/biosdev.c","bios_getdiskinfo",92,182
21,3,129,7,23,"CHS_rw@188-211@sys/arch/amd64/stand/libsa/biosdev.c","sys/arch/amd64/stand/libsa/biosdev.c","CHS_rw",188,211
19,5,183,5,26,"EDD_rw@214-240@sys/arch/amd64/stand/libsa/biosdev.c","sys/arch/amd64/stand/libsa/biosdev.c","EDD_rw",214,240
65,22,479,5,95,"biosd_io@246-341@sys/arch/amd64/stand/libsa/biosdev.c","sys/arch/amd64/stand/libsa/biosdev.c","biosd_io",246,341
4,1,39,5,3,"biosd_diskio@344-347@sys/arch/amd64/stand/libsa/biosdev.c","sys/arch/amd64/stand/libsa/biosdev.c","biosd_diskio",344,347
53,17,326,2,68,"findopenbsd@352-420@sys/arch/amd64/stand/libsa/biosdev.c","sys/arch/amd64/stand/libsa/biosdev.c","findopenbsd",352,420
24,10,153,2,35,"bios_getdisklabel@423-458@sys/arch/amd64/stand/libsa/biosdev.c","sys/arch/amd64/stand/libsa/biosdev.c","bios_getdisklabel",423,458
125,38,741,2,171,"biosopen@461-632@sys/arch/amd64/stand/libsa/biosdev.c","sys/arch/amd64/stand/libsa/biosdev.c","biosopen",461,632
7,4,36,1,8,"biosdisk_err@671-679@sys/arch/amd64/stand/libsa/biosdev.c","sys/arch/amd64/stand/libsa/biosdev.c","biosdisk_err",671,679
8,4,48,1,10,"biosdisk_errno@701-711@sys/arch/amd64/stand/libsa/biosdev.c","sys/arch/amd64/stand/libsa/biosdev.c","biosdisk_errno",701,711
24,8,184,6,35,"biosstrategy@714-749@sys/arch/amd64/stand/libsa/biosdev.c","sys/arch/amd64/stand/libsa/biosdev.c","biosstrategy",714,749
5,1,18,1,5,"biosclose@752-757@sys/arch/amd64/stand/libsa/biosdev.c","sys/arch/amd64/stand/libsa/biosdev.c","biosclose",752,757
4,1,19,3,3,"biosioctl@760-763@sys/arch/amd64/stand/libsa/biosdev.c","sys/arch/amd64/stand/libsa/biosdev.c","biosioctl",760,763
14,2,77,1,18,"getSYSCONFaddr@39-57@sys/arch/amd64/stand/libsa/biosprobe.c","sys/arch/amd64/stand/libsa/biosprobe.c","getSYSCONFaddr",39,57
17,3,85,1,22,"getEBDAaddr@60-82@sys/arch/amd64/stand/libsa/biosprobe.c","sys/arch/amd64/stand/libsa/biosprobe.c","getEBDAaddr",60,82
6,1,17,1,8,"Xdiskinfo@76-84@sys/arch/amd64/stand/libsa/cmd_i386.c","sys/arch/amd64/stand/libsa/cmd_i386.c","Xdiskinfo",76,84
5,1,11,1,4,"Xregs@88-92@sys/arch/amd64/stand/libsa/cmd_i386.c","sys/arch/amd64/stand/libsa/cmd_i386.c","Xregs",88,92
47,17,387,1,60,"Xboot@97-157@sys/arch/amd64/stand/libsa/cmd_i386.c","sys/arch/amd64/stand/libsa/cmd_i386.c","Xboot",97,157
55,16,253,1,66,"Xmemory@161-227@sys/arch/amd64/stand/libsa/cmd_i386.c","sys/arch/amd64/stand/libsa/cmd_i386.c","Xmemory",161,227
7,2,40,1,8,"Xcomaddr@231-239@sys/arch/amd64/stand/libsa/cmd_i386.c","sys/arch/amd64/stand/libsa/cmd_i386.c","Xcomaddr",231,239
23,13,159,3,36,"devopen@62-98@sys/arch/amd64/stand/libsa/dev_i386.c","sys/arch/amd64/stand/libsa/dev_i386.c","devopen",62,98
46,14,285,2,63,"devboot@101-164@sys/arch/amd64/stand/libsa/dev_i386.c","sys/arch/amd64/stand/libsa/dev_i386.c","devboot",101,164
6,1,37,1,6,"ttyname@169-175@sys/arch/amd64/stand/libsa/dev_i386.c","sys/arch/amd64/stand/libsa/dev_i386.c","ttyname",169,175
13,9,124,1,13,"ttydev@178-191@sys/arch/amd64/stand/libsa/dev_i386.c","sys/arch/amd64/stand/libsa/dev_i386.c","ttydev",178,191
6,2,30,2,7,"cnspeed@194-201@sys/arch/amd64/stand/libsa/dev_i386.c","sys/arch/amd64/stand/libsa/dev_i386.c","cnspeed",194,201
6,1,32,1,5,"diskinfo_init@73-78@sys/arch/amd64/stand/libsa/diskprobe.c","sys/arch/amd64/stand/libsa/diskprobe.c","diskinfo_init",73,78
19,5,123,1,35,"floppyprobe@82-117@sys/arch/amd64/stand/libsa/diskprobe.c","sys/arch/amd64/stand/libsa/diskprobe.c","floppyprobe",82,117
47,10,302,1,61,"hardprobe@121-182@sys/arch/amd64/stand/libsa/diskprobe.c","sys/arch/amd64/stand/libsa/diskprobe.c","hardprobe",121,182
55,8,309,1,65,"efi_hardprobe@187-252@sys/arch/amd64/stand/libsa/diskprobe.c","sys/arch/amd64/stand/libsa/diskprobe.c","efi_hardprobe",187,252
27,8,185,1,48,"diskprobe@258-306@sys/arch/amd64/stand/libsa/diskprobe.c","sys/arch/amd64/stand/libsa/diskprobe.c","diskprobe",258,306
49,5,407,1,71,"cdprobe@310-381@sys/arch/amd64/stand/libsa/diskprobe.c","sys/arch/amd64/stand/libsa/diskprobe.c","cdprobe",310,381
8,3,49,1,9,"dklookup@387-396@sys/arch/amd64/stand/libsa/diskprobe.c","sys/arch/amd64/stand/libsa/diskprobe.c","dklookup",387,396
22,5,141,1,24,"dump_diskinfo@399-423@sys/arch/amd64/stand/libsa/diskprobe.c","sys/arch/amd64/stand/libsa/diskprobe.c","dump_diskinfo",399,423
8,2,32,1,9,"bios_dklookup@429-438@sys/arch/amd64/stand/libsa/diskprobe.c","sys/arch/amd64/stand/libsa/diskprobe.c","bios_dklookup",429,438
26,9,193,1,32,"disksum@447-479@sys/arch/amd64/stand/libsa/diskprobe.c","sys/arch/amd64/stand/libsa/diskprobe.c","disksum",447,479
4,2,23,1,3,"bootdev_has_hibernate@482-485@sys/arch/amd64/stand/libsa/diskprobe.c","sys/arch/amd64/stand/libsa/diskprobe.c","bootdev_has_hibernate",482,485
15,5,133,1,18,"check_hibernate@488-506@sys/arch/amd64/stand/libsa/diskprobe.c","sys/arch/amd64/stand/libsa/diskprobe.c","check_hibernate",488,506
66,14,531,2,105,"run_loadfile@57-162@sys/arch/amd64/stand/libsa/exec_i386.c","sys/arch/amd64/stand/libsa/exec_i386.c","run_loadfile",57,162
4,1,11,1,3,"gateA20on@50-53@sys/arch/amd64/stand/libsa/gateA20.c","sys/arch/amd64/stand/libsa/gateA20.c","gateA20on",50,53
27,11,192,1,33,"gateA20@60-93@sys/arch/amd64/stand/libsa/gateA20.c","sys/arch/amd64/stand/libsa/gateA20.c","gateA20",60,93
15,4,92,1,20,"machdep@48-68@sys/arch/amd64/stand/libsa/machdep.c","sys/arch/amd64/stand/libsa/machdep.c","machdep",48,68
5,1,26,1,8,"check_skip_conf@71-79@sys/arch/amd64/stand/libsa/machdep.c","sys/arch/amd64/stand/libsa/machdep.c","check_skip_conf",71,79
12,2,71,1,16,"checkA20@47-63@sys/arch/amd64/stand/libsa/memprobe.c","sys/arch/amd64/stand/libsa/memprobe.c","checkA20",47,63
23,7,163,1,27,"bios_E820@71-98@sys/arch/amd64/stand/libsa/memprobe.c","sys/arch/amd64/stand/libsa/memprobe.c","bios_E820",71,98
13,3,82,1,18,"bios_8800@107-125@sys/arch/amd64/stand/libsa/memprobe.c","sys/arch/amd64/stand/libsa/memprobe.c","bios_8800",107,125
10,2,64,1,14,"bios_int12@133-147@sys/arch/amd64/stand/libsa/memprobe.c","sys/arch/amd64/stand/libsa/memprobe.c","bios_int12",133,147
26,7,190,1,34,"addrprobe@170-204@sys/arch/amd64/stand/libsa/memprobe.c","sys/arch/amd64/stand/libsa/memprobe.c","addrprobe",170,204
12,4,71,1,21,"badprobe@217-238@sys/arch/amd64/stand/libsa/memprobe.c","sys/arch/amd64/stand/libsa/memprobe.c","badprobe",217,238
37,15,275,1,72,"memprobe@241-313@sys/arch/amd64/stand/libsa/memprobe.c","sys/arch/amd64/stand/libsa/memprobe.c","memprobe",241,313
16,4,111,1,19,"dump_biosmem@317-336@sys/arch/amd64/stand/libsa/memprobe.c","sys/arch/amd64/stand/libsa/memprobe.c","dump_biosmem",317,336
16,7,130,1,19,"mem_limit@339-358@sys/arch/amd64/stand/libsa/memprobe.c","sys/arch/amd64/stand/libsa/memprobe.c","mem_limit",339,358
30,11,242,2,34,"mem_delete@361-395@sys/arch/amd64/stand/libsa/memprobe.c","sys/arch/amd64/stand/libsa/memprobe.c","mem_delete",361,395
32,11,226,2,39,"mem_add@398-437@sys/arch/amd64/stand/libsa/memprobe.c","sys/arch/amd64/stand/libsa/memprobe.c","mem_add",398,437
8,2,45,1,8,"mem_pass@440-448@sys/arch/amd64/stand/libsa/memprobe.c","sys/arch/amd64/stand/libsa/memprobe.c","mem_pass",440,448
20,3,133,3,25,"pxesendudp@125-150@sys/arch/amd64/stand/libsa/pxe.c","sys/arch/amd64/stand/libsa/pxe.c","pxesendudp",125,150
25,3,185,4,34,"pxereadudp@157-191@sys/arch/amd64/stand/libsa/pxe.c","sys/arch/amd64/stand/libsa/pxe.c","pxereadudp",157,191
22,5,122,1,36,"pxe_netif_open@205-241@sys/arch/amd64/stand/libsa/pxe.c","sys/arch/amd64/stand/libsa/pxe.c","pxe_netif_open",205,241
12,4,60,1,17,"pxe_netif_close@244-261@sys/arch/amd64/stand/libsa/pxe.c","sys/arch/amd64/stand/libsa/pxe.c","pxe_netif_close",244,261
5,2,15,1,7,"pxe_netif_shutdown@264-271@sys/arch/amd64/stand/libsa/pxe.c","sys/arch/amd64/stand/libsa/pxe.c","pxe_netif_shutdown",264,271
8,3,23,1,10,"pxesocktodesc@274-284@sys/arch/amd64/stand/libsa/pxe.c","sys/arch/amd64/stand/libsa/pxe.c","pxesocktodesc",274,284
8,3,28,1,7,"pxeprobe@299-306@sys/arch/amd64/stand/libsa/pxe.c","sys/arch/amd64/stand/libsa/pxe.c","pxeprobe",299,306
103,26,626,1,142,"pxe_init@309-451@sys/arch/amd64/stand/libsa/pxe.c","sys/arch/amd64/stand/libsa/pxe.c","pxe_init",309,451
30,8,228,1,46,"pxeinfo@454-500@sys/arch/amd64/stand/libsa/pxe.c","sys/arch/amd64/stand/libsa/pxe.c","pxeinfo",454,500
29,10,161,1,45,"pxe_shutdown@503-548@sys/arch/amd64/stand/libsa/pxe.c","sys/arch/amd64/stand/libsa/pxe.c","pxe_shutdown",503,548
28,11,121,2,39,"net_open@69-108@sys/arch/amd64/stand/libsa/pxe_net.c","sys/arch/amd64/stand/libsa/pxe_net.c","net_open",69,108
19,8,83,1,26,"net_close@111-137@sys/arch/amd64/stand/libsa/pxe_net.c","sys/arch/amd64/stand/libsa/pxe_net.c","net_close",111,137
4,1,19,3,3,"net_ioctl@140-143@sys/arch/amd64/stand/libsa/pxe_net.c","sys/arch/amd64/stand/libsa/pxe_net.c","net_ioctl",140,143
5,1,28,6,4,"net_strategy@146-150@sys/arch/amd64/stand/libsa/pxe_net.c","sys/arch/amd64/stand/libsa/pxe_net.c","net_strategy",146,150
9,3,35,1,15,"net_getparams@160-175@sys/arch/amd64/stand/libsa/pxe_net.c","sys/arch/amd64/stand/libsa/pxe_net.c","net_getparams",160,175
4,1,26,1,3,"bcdtoint@43-46@sys/arch/amd64/stand/libsa/time.c","sys/arch/amd64/stand/libsa/time.c","bcdtoint",43,46
11,4,96,6,18,"compute@56-74@sys/arch/amd64/stand/libsa/time.c","sys/arch/amd64/stand/libsa/time.c","compute",56,74
20,2,115,2,20,"bios_time_date@77-97@sys/arch/amd64/stand/libsa/time.c","sys/arch/amd64/stand/libsa/time.c","bios_time_date",77,97
4,1,19,1,3,"biosdate@100-103@sys/arch/amd64/stand/libsa/time.c","sys/arch/amd64/stand/libsa/time.c","biosdate",100,103
4,1,19,1,3,"biostime@106-109@sys/arch/amd64/stand/libsa/time.c","sys/arch/amd64/stand/libsa/time.c","biostime",106,109
12,4,92,1,18,"getsecs@115-133@sys/arch/amd64/stand/libsa/time.c","sys/arch/amd64/stand/libsa/time.c","getsecs",115,133
7,2,35,1,12,"sleep@136-148@sys/arch/amd64/stand/libsa/time.c","sys/arch/amd64/stand/libsa/time.c","sleep",136,148
35,7,287,2,50,"srprobe_meta_opt_load@39-89@sys/arch/amd64/stand/libsa/softraid_amd64.c","sys/arch/amd64/stand/libsa/softraid_amd64.c","srprobe_meta_opt_load",39,89
26,4,209,1,31,"srprobe_keydisk_load@92-123@sys/arch/amd64/stand/libsa/softraid_amd64.c","sys/arch/amd64/stand/libsa/softraid_amd64.c","srprobe_keydisk_load",92,123
132,29,923,1,183,"srprobe@126-309@sys/arch/amd64/stand/libsa/softraid_amd64.c","sys/arch/amd64/stand/libsa/softraid_amd64.c","srprobe",126,309
56,13,428,6,75,"sr_strategy@312-387@sys/arch/amd64/stand/libsa/softraid_amd64.c","sys/arch/amd64/stand/libsa/softraid_amd64.c","sr_strategy",312,387
23,9,137,2,24,"gpt_chk_mbr@400-424@sys/arch/amd64/stand/libsa/softraid_amd64.c","sys/arch/amd64/stand/libsa/softraid_amd64.c","gpt_chk_mbr",400,424
95,16,660,2,111,"findopenbsd_gpt@427-538@sys/arch/amd64/stand/libsa/softraid_amd64.c","sys/arch/amd64/stand/libsa/softraid_amd64.c","findopenbsd_gpt",427,538
41,10,332,2,51,"sr_getdisklabel@541-592@sys/arch/amd64/stand/libsa/softraid_amd64.c","sys/arch/amd64/stand/libsa/softraid_amd64.c","sr_getdisklabel",541,592
47,22,331,3,77,"devopen@58-135@sys/arch/amd64/stand/pxeboot/devopen.c","sys/arch/amd64/stand/pxeboot/devopen.c","devopen",58,135
8,1,40,2,7,"devboot@138-145@sys/arch/amd64/stand/pxeboot/devopen.c","sys/arch/amd64/stand/pxeboot/devopen.c","devboot",138,145
6,1,37,1,6,"ttyname@150-156@sys/arch/amd64/stand/pxeboot/devopen.c","sys/arch/amd64/stand/pxeboot/devopen.c","ttyname",150,156
13,9,126,1,13,"ttydev@159-172@sys/arch/amd64/stand/pxeboot/devopen.c","sys/arch/amd64/stand/pxeboot/devopen.c","ttydev",159,172
6,2,32,2,7,"cnspeed@175-182@sys/arch/amd64/stand/pxeboot/devopen.c","sys/arch/amd64/stand/pxeboot/devopen.c","cnspeed",175,182
47,15,289,2,60,"oopen@76-136@sys/arch/amd64/stand/pxeboot/open.c","sys/arch/amd64/stand/pxeboot/open.c","oopen",76,136
4,1,26,3,3,"sendudp@62-65@sys/arch/amd64/stand/pxeboot/pxe_udp.c","sys/arch/amd64/stand/pxeboot/pxe_udp.c","sendudp",62,65
4,1,31,4,3,"readudp@72-75@sys/arch/amd64/stand/pxeboot/pxe_udp.c","sys/arch/amd64/stand/pxeboot/pxe_udp.c","readudp",72,75
19,4,138,2,44,"arm32_vector_init@127-171@sys/arch/arm/arm/arm32_machdep.c","sys/arch/arm/arm/arm32_machdep.c","arm32_vector_init",127,171
5,2,14,0,4,"halt@178-182@sys/arch/arm/arm/arm32_machdep.c","sys/arch/arm/arm/arm32_machdep.c","halt",178,182
17,4,68,1,28,"bootsync@188-216@sys/arch/arm/arm/arm32_machdep.c","sys/arch/arm/arm/arm32_machdep.c","bootsync",188,216
33,2,265,0,71,"cpu_startup@225-296@sys/arch/arm/arm/arm32_machdep.c","sys/arch/arm/arm/arm32_machdep.c","cpu_startup",225,296
27,7,159,7,35,"cpu_sysctl@303-338@sys/arch/arm/arm/arm32_machdep.c","sys/arch/arm/arm/arm32_machdep.c","cpu_sysctl",303,338
14,1,100,4,17,"setregs@106-123@sys/arch/arm/arm/arm_machdep.c","sys/arch/arm/arm/arm_machdep.c","setregs",106,123
12,4,65,1,18,"ast@78-96@sys/arch/arm/arm/ast.c","sys/arch/arm/arm/ast.c","ast",78,96
13,5,96,2,14,"_bus_dma_busaddr_to_paddr@66-80@sys/arch/arm/arm/bus_dma.c","sys/arch/arm/arm/bus_dma.c","_bus_dma_busaddr_to_paddr",66,80
12,4,78,3,13,"_bus_dma_inrange@86-99@sys/arch/arm/arm/bus_dma.c","sys/arch/arm/arm/bus_dma.c","_bus_dma_inrange",86,99
28,5,206,7,47,"_bus_dmamap_create@106-153@sys/arch/arm/arm/bus_dma.c","sys/arch/arm/arm/bus_dma.c","_bus_dmamap_create",106,153
5,2,28,2,8,"_bus_dmamap_destroy@160-168@sys/arch/arm/arm/bus_dma.c","sys/arch/arm/arm/bus_dma.c","_bus_dmamap_destroy",160,168
25,5,162,6,37,"_bus_dmamap_load@175-212@sys/arch/arm/arm/bus_dma.c","sys/arch/arm/arm/bus_dma.c","_bus_dmamap_load",175,212
36,11,236,4,56,"_bus_dmamap_load_mbuf@218-274@sys/arch/arm/arm/bus_dma.c","sys/arch/arm/arm/bus_dma.c","_bus_dmamap_load_mbuf",218,274
39,9,256,4,55,"_bus_dmamap_load_uio@280-335@sys/arch/arm/arm/bus_dma.c","sys/arch/arm/arm/bus_dma.c","_bus_dmamap_load_uio",280,335
73,18,514,6,111,"_bus_dmamap_load_raw@342-453@sys/arch/arm/arm/bus_dma.c","sys/arch/arm/arm/bus_dma.c","_bus_dmamap_load_raw",342,453
9,2,49,2,16,"_bus_dmamap_unload@460-476@sys/arch/arm/arm/bus_dma.c","sys/arch/arm/arm/bus_dma.c","_bus_dmamap_unload",460,476
52,11,268,4,64,"_bus_dmamap_sync_segment@479-543@sys/arch/arm/arm/bus_dma.c","sys/arch/arm/arm/bus_dma.c","_bus_dmamap_sync_segment",479,543
18,3,119,5,21,"_bus_dmamap_sync_linear@546-567@sys/arch/arm/arm/bus_dma.c","sys/arch/arm/arm/bus_dma.c","_bus_dmamap_sync_linear",546,567
25,4,167,5,50,"_bus_dmamap_sync_mbuf@570-620@sys/arch/arm/arm/bus_dma.c","sys/arch/arm/arm/bus_dma.c","_bus_dmamap_sync_mbuf",570,620
26,4,173,5,36,"_bus_dmamap_sync_uio@623-659@sys/arch/arm/arm/bus_dma.c","sys/arch/arm/arm/bus_dma.c","_bus_dmamap_sync_uio",623,659
17,3,110,5,20,"_bus_dmamap_sync_raw@662-682@sys/arch/arm/arm/bus_dma.c","sys/arch/arm/arm/bus_dma.c","_bus_dmamap_sync_raw",662,682
43,15,260,5,87,"_bus_dmamap_sync@697-784@sys/arch/arm/arm/bus_dma.c","sys/arch/arm/arm/bus_dma.c","_bus_dmamap_sync",697,784
28,7,200,8,35,"_bus_dmamem_alloc@792-827@sys/arch/arm/arm/bus_dma.c","sys/arch/arm/arm/bus_dma.c","_bus_dmamem_alloc",792,827
18,4,119,3,24,"_bus_dmamem_free@834-858@sys/arch/arm/arm/bus_dma.c","sys/arch/arm/arm/bus_dma.c","_bus_dmamem_free",834,858
40,11,288,6,54,"_bus_dmamem_map@865-919@sys/arch/arm/arm/bus_dma.c","sys/arch/arm/arm/bus_dma.c","_bus_dmamem_map",865,919
8,4,58,3,13,"_bus_dmamem_unmap@926-939@sys/arch/arm/arm/bus_dma.c","sys/arch/arm/arm/bus_dma.c","_bus_dmamem_unmap",926,939
20,7,127,6,25,"_bus_dmamem_mmap@946-971@sys/arch/arm/arm/bus_dma.c","sys/arch/arm/arm/bus_dma.c","_bus_dmamem_mmap",946,971
99,22,614,9,139,"_bus_dmamap_load_buffer@984-1123@sys/arch/arm/arm/bus_dma.c","sys/arch/arm/arm/bus_dma.c","_bus_dmamap_load_buffer",984,1123
45,12,313,10,68,"_bus_dmamem_alloc_range@1130-1198@sys/arch/arm/arm/bus_dma.c","sys/arch/arm/arm/bus_dma.c","_bus_dmamem_alloc_range",1130,1198
24,7,188,6,33,"arm32_dma_range_intersect@1205-1238@sys/arch/arm/arm/bus_dma.c","sys/arch/arm/arm/bus_dma.c","arm32_dma_range_intersect",1205,1238
4,2,24,1,3,"iskmemdev@403-406@sys/arch/arm/arm/conf.c","sys/arch/arm/arm/conf.c","iskmemdev",403,406
4,2,24,1,3,"iszerodev@412-415@sys/arch/arm/arm/conf.c","sys/arch/arm/arm/conf.c","iszerodev",412,415
4,1,14,1,3,"getnulldev@451-454@sys/arch/arm/arm/conf.c","sys/arch/arm/arm/conf.c","getnulldev",451,454
9,3,65,3,10,"cpu_match@82-92@sys/arch/arm/arm/cpu.c","sys/arch/arm/arm/cpu.c","cpu_match",82,92
16,2,88,3,19,"cpu_attach@95-114@sys/arch/arm/arm/cpu.c","sys/arch/arm/arm/cpu.c","cpu_attach",95,114
76,17,401,2,90,"identify_arm_cpu@186-276@sys/arch/arm/arm/cpu.c","sys/arch/arm/arm/cpu.c","identify_arm_cpu",186,276
20,2,141,1,34,"cpu_alloc_idle_pcb@280-314@sys/arch/arm/arm/cpu.c","sys/arch/arm/arm/cpu.c","cpu_alloc_idle_pcb",280,314
4,1,13,1,3,"intr_barrier@318-321@sys/arch/arm/arm/cpu.c","sys/arch/arm/arm/cpu.c","intr_barrier",318,321
7,2,28,1,8,"log2@158-166@sys/arch/arm/arm/cpufunc.c","sys/arch/arm/arm/cpufunc.c","log2",158,166
66,10,416,1,83,"arm_get_cachetype_cp15v7@169-252@sys/arch/arm/arm/cpufunc.c","sys/arch/arm/arm/cpufunc.c","arm_get_cachetype_cp15v7",169,252
7,1,27,0,6,"armv7_idcache_wbinv_all@257-263@sys/arch/arm/arm/cpufunc.c","sys/arch/arm/arm/cpufunc.c","armv7_idcache_wbinv_all",257,263
27,4,133,0,37,"armv7_dcache_wbinv_all@267-304@sys/arch/arm/arm/cpufunc.c","sys/arch/arm/arm/cpufunc.c","armv7_dcache_wbinv_all",267,304
29,5,132,0,42,"set_cpufuncs@312-354@sys/arch/arm/arm/cpufunc.c","sys/arch/arm/arm/cpufunc.c","set_cpufuncs",312,354
46,10,171,0,72,"armv7_setup@361-433@sys/arch/arm/arm/cpufunc.c","sys/arch/arm/arm/cpufunc.c","armv7_setup",361,433
4,1,17,1,4,"db_disasm_read_word@57-61@sys/arch/arm/arm/db_disasm.c","sys/arch/arm/arm/db_disasm.c","db_disasm_read_word",57,61
4,1,19,1,4,"db_disasm_printaddr@64-68@sys/arch/arm/arm/db_disasm.c","sys/arch/arm/arm/db_disasm.c","db_disasm_printaddr",64,68
4,1,21,2,4,"db_disasm@71-75@sys/arch/arm/arm/db_disasm.c","sys/arch/arm/arm/db_disasm.c","db_disasm",71,75
6,2,35,3,6,"db_access_und_sp@98-104@sys/arch/arm/arm/db_interface.c","sys/arch/arm/arm/db_interface.c","db_access_und_sp",98,104
6,2,35,3,6,"db_access_abt_sp@107-113@sys/arch/arm/arm/db_interface.c","sys/arch/arm/arm/db_interface.c","db_access_abt_sp",107,113
6,2,35,3,6,"db_access_irq_sp@116-122@sys/arch/arm/arm/db_interface.c","sys/arch/arm/arm/db_interface.c","db_access_irq_sp",116,122
23,4,93,2,31,"db_ktrap@129-160@sys/arch/arm/arm/db_interface.c","sys/arch/arm/arm/db_interface.c","db_ktrap",129,160
13,5,76,1,17,"db_validate_address@167-184@sys/arch/arm/arm/db_interface.c","sys/arch/arm/arm/db_interface.c","db_validate_address",167,184
26,10,183,3,29,"db_read_bytes@190-219@sys/arch/arm/arm/db_interface.c","sys/arch/arm/arm/db_interface.c","db_read_bytes",190,219
61,11,342,3,84,"db_write_text@222-306@sys/arch/arm/arm/db_interface.c","sys/arch/arm/arm/db_interface.c","db_write_text",222,306
23,5,127,3,28,"db_write_bytes@312-340@sys/arch/arm/arm/db_interface.c","sys/arch/arm/arm/db_interface.c","db_write_bytes",312,340
4,1,11,1,3,"db_enter@343-346@sys/arch/arm/arm/db_interface.c","sys/arch/arm/arm/db_interface.c","db_enter",343,346
12,3,74,4,12,"db_trapper@357-369@sys/arch/arm/arm/db_interface.c","sys/arch/arm/arm/db_interface.c","db_trapper",357,369
6,1,25,1,10,"db_machine_init@377-387@sys/arch/arm/arm/db_interface.c","sys/arch/arm/arm/db_interface.c","db_machine_init",377,387
39,17,184,2,39,"db_fetch_reg@390-429@sys/arch/arm/arm/db_interface.c","sys/arch/arm/arm/db_interface.c","db_fetch_reg",390,429
45,12,330,3,45,"db_branch_taken@432-477@sys/arch/arm/arm/db_interface.c","sys/arch/arm/arm/db_interface.c","db_branch_taken",432,477
20,2,157,4,22,"db_show_frame_cmd@44-66@sys/arch/arm/arm/db_machdep.c","sys/arch/arm/arm/db_machdep.c","db_show_frame_cmd",44,66
79,19,521,5,99,"db_stack_trace_print@84-183@sys/arch/arm/arm/db_trace.c","sys/arch/arm/arm/db_trace.c","db_stack_trace_print",84,183
188,59,1198,3,241,"disasm@289-530@sys/arch/arm/arm/disassem.c","sys/arch/arm/arm/disassem.c","disasm",289,530
16,4,106,2,15,"disasm_register_shift@534-549@sys/arch/arm/arm/disassem.c","sys/arch/arm/arm/disassem.c","disasm_register_shift",534,549
30,9,176,2,32,"disasm_print_reglist@553-585@sys/arch/arm/arm/disassem.c","sys/arch/arm/arm/disassem.c","disasm_print_reglist",553,585
25,8,175,3,26,"disasm_insn_ldrstr@588-614@sys/arch/arm/arm/disassem.c","sys/arch/arm/arm/disassem.c","disasm_insn_ldrstr",588,614
25,8,194,3,26,"disasm_insn_ldrhstrh@617-643@sys/arch/arm/arm/disassem.c","sys/arch/arm/arm/disassem.c","disasm_insn_ldrhstrh",617,643
16,6,174,3,21,"disasm_insn_ldcstc@646-667@sys/arch/arm/arm/disassem.c","sys/arch/arm/arm/disassem.c","disasm_insn_ldcstc",646,667
4,1,19,1,3,"disassemble_readword@670-673@sys/arch/arm/arm/disassem.c","sys/arch/arm/arm/disassem.c","disassemble_readword",670,673
4,1,14,1,3,"disassemble_printaddr@676-679@sys/arch/arm/arm/disassem.c","sys/arch/arm/arm/disassem.c","disassemble_printaddr",676,679
4,1,20,1,4,"disassemble@686-690@sys/arch/arm/arm/disassem.c","sys/arch/arm/arm/disassem.c","disassemble",686,690
26,8,157,4,35,"readdisklabel@56-91@sys/arch/arm/arm/disksubr.c","sys/arch/arm/arm/disksubr.c","readdisklabel",56,91
30,4,213,3,36,"writedisklabel@97-133@sys/arch/arm/arm/disksubr.c","sys/arch/arm/arm/disksubr.c","writedisklabel",97,133
120,31,778,1,194,"data_abort_handler@170-364@sys/arch/arm/arm/fault.c","sys/arch/arm/arm/fault.c","data_abort_handler",170,364
35,5,248,5,42,"dab_fatal@380-422@sys/arch/arm/arm/fault.c","sys/arch/arm/arm/fault.c","dab_fatal",380,422
13,2,97,5,19,"dab_align@434-453@sys/arch/arm/arm/fault.c","sys/arch/arm/arm/fault.c","dab_align",434,453
27,8,194,5,65,"dab_buserr@478-543@sys/arch/arm/arm/fault.c","sys/arch/arm/arm/fault.c","dab_buserr",478,543
47,12,344,1,72,"prefetch_abort_handler@557-629@sys/arch/arm/arm/fault.c","sys/arch/arm/arm/fault.c","prefetch_abort_handler",557,629
33,10,212,3,40,"badaddr_read@637-677@sys/arch/arm/arm/fault.c","sys/arch/arm/arm/fault.c","badaddr_read",637,677
7,3,46,2,12,"fiq_installhandler@65-77@sys/arch/arm/arm/fiq.c","sys/arch/arm/arm/fiq.c","fiq_installhandler",65,77
25,6,146,1,37,"fiq_claim@85-122@sys/arch/arm/arm/fiq.c","sys/arch/arm/arm/fiq.c","fiq_claim",85,122
23,6,149,1,34,"fiq_release@130-164@sys/arch/arm/arm/fiq.c","sys/arch/arm/arm/fiq.c","fiq_release",130,164
24,13,114,4,29,"mmopen@102-131@sys/arch/arm/arm/mem.c","sys/arch/arm/arm/mem.c","mmopen",102,131
6,3,36,4,7,"mmclose@134-141@sys/arch/arm/arm/mem.c","sys/arch/arm/arm/mem.c","mmclose",134,141
69,18,440,3,76,"mmrw@144-220@sys/arch/arm/arm/mem.c","sys/arch/arm/arm/mem.c","mmrw",144,220
10,4,66,3,21,"mmmmap@223-244@sys/arch/arm/arm/mem.c","sys/arch/arm/arm/mem.c","mmmmap",223,244
4,1,26,5,3,"mmioctl@247-250@sys/arch/arm/arm/mem.c","sys/arch/arm/arm/mem.c","mmioctl",247,250
3,1,7,1,2,"openpromattach@68-70@sys/arch/arm/arm/openprom.c","sys/arch/arm/arm/openprom.c","openpromattach",68,70
4,1,23,4,3,"openpromopen@73-76@sys/arch/arm/arm/openprom.c","sys/arch/arm/arm/openprom.c","openpromopen",73,76
4,1,23,4,3,"openpromclose@79-82@sys/arch/arm/arm/openprom.c","sys/arch/arm/arm/openprom.c","openpromclose",79,82
7,4,50,2,7,"openpromcheckid@89-96@sys/arch/arm/arm/openprom.c","sys/arch/arm/arm/openprom.c","openpromcheckid",89,96
11,2,81,3,13,"openpromgetstr@99-112@sys/arch/arm/arm/openprom.c","sys/arch/arm/arm/openprom.c","openpromgetstr",99,112
136,34,841,5,154,"openpromioctl@115-269@sys/arch/arm/arm/openprom.c","sys/arch/arm/arm/openprom.c","openpromioctl",115,269
7,4,39,1,7,"pmap_is_current@426-433@sys/arch/arm/arm/pmap7.c","sys/arch/arm/arm/pmap7.c","pmap_is_current",426,433
5,2,22,2,4,"pmap_tlb_flushID_SE@441-445@sys/arch/arm/arm/pmap7.c","sys/arch/arm/arm/pmap7.c","pmap_tlb_flushID_SE",441,445
5,2,18,1,4,"pmap_tlb_flushID@448-452@sys/arch/arm/arm/pmap7.c","sys/arch/arm/arm/pmap7.c","pmap_tlb_flushID",448,452
11,3,77,2,13,"pmap_get_l2_bucket@459-472@sys/arch/arm/arm/pmap7.c","sys/arch/arm/arm/pmap7.c","pmap_get_l2_bucket",459,472
14,2,104,5,17,"pmap_enter_pv@492-509@sys/arch/arm/arm/pmap7.c","sys/arch/arm/arm/pmap7.c","pmap_enter_pv",492,509
9,4,61,3,10,"pmap_find_pv@518-528@sys/arch/arm/arm/pmap7.c","sys/arch/arm/arm/pmap7.c","pmap_find_pv",518,528
21,5,135,3,24,"pmap_remove_pv@540-564@sys/arch/arm/arm/pmap7.c","sys/arch/arm/arm/pmap7.c","pmap_remove_pv",540,564
21,5,157,5,30,"pmap_modify_pv@577-607@sys/arch/arm/arm/pmap7.c","sys/arch/arm/arm/pmap7.c","pmap_modify_pv",577,607
34,7,214,1,44,"pmap_alloc_l1@615-659@sys/arch/arm/arm/pmap7.c","sys/arch/arm/arm/pmap7.c","pmap_alloc_l1",615,659
25,2,179,1,30,"pmap_free_l1@666-696@sys/arch/arm/arm/pmap7.c","sys/arch/arm/arm/pmap7.c","pmap_free_l1",666,696
4,1,20,1,3,"pmap_free_l2_ptp@704-707@sys/arch/arm/arm/pmap7.c","sys/arch/arm/arm/pmap7.c","pmap_free_l2_ptp",704,707
30,6,209,2,57,"pmap_alloc_l2_bucket@722-779@sys/arch/arm/arm/pmap7.c","sys/arch/arm/arm/pmap7.c","pmap_alloc_l2_bucket",722,779
24,4,157,3,69,"pmap_free_l2_bucket@791-860@sys/arch/arm/arm/pmap7.c","sys/arch/arm/arm/pmap7.c","pmap_free_l2_bucket",791,860
44,7,269,2,66,"pmap_clearbit@868-934@sys/arch/arm/arm/pmap7.c","sys/arch/arm/arm/pmap7.c","pmap_clearbit",868,934
17,7,104,1,25,"pmap_clean_page@942-967@sys/arch/arm/arm/pmap7.c","sys/arch/arm/arm/pmap7.c","pmap_clean_page",942,967
45,11,273,1,63,"pmap_page_remove@977-1040@sys/arch/arm/arm/pmap7.c","sys/arch/arm/arm/pmap7.c","pmap_page_remove",977,1040
9,1,45,1,11,"pmap_create@1048-1059@sys/arch/arm/arm/pmap7.c","sys/arch/arm/arm/pmap7.c","pmap_create",1048,1059
107,31,678,5,205,"pmap_enter@1074-1279@sys/arch/arm/arm/pmap7.c","sys/arch/arm/arm/pmap7.c","pmap_enter",1074,1279
53,11,274,3,85,"pmap_remove@1289-1374@sys/arch/arm/arm/pmap7.c","sys/arch/arm/arm/pmap7.c","pmap_remove",1289,1374
29,6,190,3,35,"pmap_kenter_pa@1384-1419@sys/arch/arm/arm/pmap7.c","sys/arch/arm/arm/pmap7.c","pmap_kenter_pa",1384,1419
6,2,35,4,5,"pmap_kenter_cache@1422-1427@sys/arch/arm/arm/pmap7.c","sys/arch/arm/arm/pmap7.c","pmap_kenter_cache",1422,1427
33,6,181,2,38,"pmap_kremove@1430-1468@sys/arch/arm/arm/pmap7.c","sys/arch/arm/arm/pmap7.c","pmap_kremove",1430,1468
36,7,227,3,56,"pmap_extract@1471-1527@sys/arch/arm/arm/pmap7.c","sys/arch/arm/arm/pmap7.c","pmap_extract",1471,1527
57,17,343,4,71,"pmap_protect@1530-1601@sys/arch/arm/arm/pmap7.c","sys/arch/arm/arm/pmap7.c","pmap_protect",1530,1601
18,5,76,2,21,"pmap_page_protect@1604-1625@sys/arch/arm/arm/pmap7.c","sys/arch/arm/arm/pmap7.c","pmap_page_protect",1604,1625
10,2,45,1,11,"pmap_clear_modify@1633-1644@sys/arch/arm/arm/pmap7.c","sys/arch/arm/arm/pmap7.c","pmap_clear_modify",1633,1644
10,2,45,1,11,"pmap_clear_reference@1652-1663@sys/arch/arm/arm/pmap7.c","sys/arch/arm/arm/pmap7.c","pmap_clear_reference",1652,1663
34,3,244,4,59,"dab_access@1687-1746@sys/arch/arm/arm/pmap7.c","sys/arch/arm/arm/pmap7.c","dab_access",1687,1746
3,1,7,1,6,"pmap_collect@1755-1761@sys/arch/arm/arm/pmap7.c","sys/arch/arm/arm/pmap7.c","pmap_collect",1755,1761
5,2,30,3,5,"pmap_proc_iflush@1771-1776@sys/arch/arm/arm/pmap7.c","sys/arch/arm/arm/pmap7.c","pmap_proc_iflush",1771,1776
16,2,115,2,22,"pmap_unwire@1786-1808@sys/arch/arm/arm/pmap7.c","sys/arch/arm/arm/pmap7.c","pmap_unwire",1786,1808
19,3,107,1,28,"pmap_activate@1811-1839@sys/arch/arm/arm/pmap7.c","sys/arch/arm/arm/pmap7.c","pmap_activate",1811,1839
3,1,7,1,5,"pmap_update@1842-1847@sys/arch/arm/arm/pmap7.c","sys/arch/arm/arm/pmap7.c","pmap_update",1842,1847
9,2,38,1,19,"pmap_destroy@1854-1873@sys/arch/arm/arm/pmap7.c","sys/arch/arm/arm/pmap7.c","pmap_destroy",1854,1873
6,2,20,1,6,"pmap_reference@1882-1888@sys/arch/arm/arm/pmap7.c","sys/arch/arm/arm/pmap7.c","pmap_reference",1882,1888
11,3,65,1,17,"pmap_zero_page_generic@1899-1916@sys/arch/arm/arm/pmap7.c","sys/arch/arm/arm/pmap7.c","pmap_zero_page_generic",1899,1916
16,3,108,2,23,"pmap_copy_page_generic@1926-1949@sys/arch/arm/arm/pmap7.c","sys/arch/arm/arm/pmap7.c","pmap_copy_page_generic",1926,1949
5,1,22,2,4,"pmap_virtual_space@1959-1963@sys/arch/arm/arm/pmap7.c","sys/arch/arm/arm/pmap7.c","pmap_virtual_space",1959,1963
27,5,178,3,31,"pmap_grow_map@1969-2000@sys/arch/arm/arm/pmap7.c","sys/arch/arm/arm/pmap7.c","pmap_grow_map",1969,2000
42,9,266,2,78,"pmap_grow_l2_bucket@2007-2085@sys/arch/arm/arm/pmap7.c","sys/arch/arm/arm/pmap7.c","pmap_grow_l2_bucket",2007,2085
30,3,158,1,49,"pmap_growkernel@2088-2137@sys/arch/arm/arm/pmap7.c","sys/arch/arm/arm/pmap7.c","pmap_growkernel",2088,2137
11,1,74,1,13,"vector_page_setprot@2147-2160@sys/arch/arm/arm/pmap7.c","sys/arch/arm/arm/pmap7.c","vector_page_setprot",2147,2160
5,1,29,2,4,"pmap_set_pcb_pagedir@2167-2171@sys/arch/arm/arm/pmap7.c","sys/arch/arm/arm/pmap7.c","pmap_set_pcb_pagedir",2167,2171
23,5,155,4,27,"pmap_get_pde_pte@2189-2216@sys/arch/arm/arm/pmap7.c","sys/arch/arm/arm/pmap7.c","pmap_get_pde_pte",2189,2216
10,3,76,2,15,"pmap_init_l1@2221-2236@sys/arch/arm/arm/pmap7.c","sys/arch/arm/arm/pmap7.c","pmap_init_l1",2221,2236
74,8,575,3,136,"pmap_bootstrap@2258-2394@sys/arch/arm/arm/pmap7.c","sys/arch/arm/arm/pmap7.c","pmap_bootstrap",2258,2394
14,4,94,4,16,"pmap_alloc_specials@2397-2413@sys/arch/arm/arm/pmap7.c","sys/arch/arm/arm/pmap7.c","pmap_alloc_specials",2397,2413
5,1,28,1,5,"pmap_init@2416-2421@sys/arch/arm/arm/pmap7.c","sys/arch/arm/arm/pmap7.c","pmap_init",2416,2421
18,4,119,3,21,"pmap_bootstrap_pv_page_alloc@2427-2448@sys/arch/arm/arm/pmap7.c","sys/arch/arm/arm/pmap7.c","pmap_bootstrap_pv_page_alloc",2427,2448
13,3,68,2,14,"pmap_bootstrap_pv_page_free@2451-2465@sys/arch/arm/arm/pmap7.c","sys/arch/arm/arm/pmap7.c","pmap_bootstrap_pv_page_free",2451,2465
7,1,38,1,6,"pmap_postinit@2475-2481@sys/arch/arm/arm/pmap7.c","sys/arch/arm/arm/pmap7.c","pmap_postinit",2475,2481
11,3,67,1,14,"kernel_pt_lookup@2509-2523@sys/arch/arm/arm/pmap7.c","sys/arch/arm/arm/pmap7.c","kernel_pt_lookup",2509,2523
20,4,102,5,23,"pmap_map_section@2531-2554@sys/arch/arm/arm/pmap7.c","sys/arch/arm/arm/pmap7.c","pmap_map_section",2531,2554
31,6,223,5,42,"pmap_map_entry@2562-2604@sys/arch/arm/arm/pmap7.c","sys/arch/arm/arm/pmap7.c","pmap_map_entry",2562,2604
12,2,132,3,16,"pmap_link_l2pt@2613-2629@sys/arch/arm/arm/pmap7.c","sys/arch/arm/arm/pmap7.c","pmap_link_l2pt",2613,2629
82,16,550,6,120,"pmap_map_chunk@2639-2759@sys/arch/arm/arm/pmap7.c","sys/arch/arm/arm/pmap7.c","pmap_map_chunk",2639,2759
43,3,205,1,60,"pmap_pte_init_armv7@2813-2873@sys/arch/arm/arm/pmap7.c","sys/arch/arm/arm/pmap7.c","pmap_pte_init_armv7",2813,2873
10,2,47,2,11,"pmap_prefer@2879-2890@sys/arch/arm/arm/pmap7.c","sys/arch/arm/arm/pmap7.c","pmap_prefer",2879,2890
4,1,18,1,4,"process_frame@118-122@sys/arch/arm/arm/process_machdep.c","sys/arch/arm/arm/process_machdep.c","process_frame",118,122
14,4,116,2,18,"process_read_regs@125-143@sys/arch/arm/arm/process_machdep.c","sys/arch/arm/arm/process_machdep.c","process_read_regs",125,143
5,1,32,2,5,"process_read_fpregs@146-151@sys/arch/arm/arm/process_machdep.c","sys/arch/arm/arm/process_machdep.c","process_read_fpregs",146,151
15,4,124,2,18,"process_write_regs@156-174@sys/arch/arm/arm/process_machdep.c","sys/arch/arm/arm/process_machdep.c","process_write_regs",156,174
4,1,19,2,4,"process_write_fpregs@177-181@sys/arch/arm/arm/process_machdep.c","sys/arch/arm/arm/process_machdep.c","process_write_fpregs",177,181
6,2,24,2,5,"process_sstep@184-189@sys/arch/arm/arm/process_machdep.c","sys/arch/arm/arm/process_machdep.c","process_sstep",184,189
7,1,43,2,8,"process_set_pc@192-200@sys/arch/arm/arm/process_machdep.c","sys/arch/arm/arm/process_machdep.c","process_set_pc",192,200
4,1,18,1,3,"process_frame@62-65@sys/arch/arm/arm/sig_machdep.c","sys/arch/arm/arm/sig_machdep.c","process_frame",62,65
55,6,512,6,80,"sendsig@77-157@sys/arch/arm/arm/sig_machdep.c","sys/arch/arm/arm/sig_machdep.c","sendsig",77,157
44,6,360,3,59,"sys_sigreturn@171-230@sys/arch/arm/arm/sig_machdep.c","sys/arch/arm/arm/sig_machdep.c","sys_sigreturn",171,230
11,2,61,1,11,"softintr_init@55-66@sys/arch/arm/arm/softintr.c","sys/arch/arm/arm/softintr.c","softintr_init",55,66
18,3,109,1,21,"softintr_dispatch@76-97@sys/arch/arm/arm/softintr.c","sys/arch/arm/arm/softintr.c","softintr_dispatch",76,97
30,7,142,3,35,"softintr_establish@105-140@sys/arch/arm/arm/softintr.c","sys/arch/arm/arm/softintr.c","softintr_establish",105,140
12,2,75,1,13,"softintr_disestablish@148-161@sys/arch/arm/arm/softintr.c","sys/arch/arm/arm/softintr.c","softintr_disestablish",148,161
22,8,175,1,28,"dumpconf@83-111@sys/arch/arm/arm/stubs.c","sys/arch/arm/arm/stubs.c","dumpconf",83,111
94,19,547,0,111,"dumpsys@124-235@sys/arch/arm/arm/stubs.c","sys/arch/arm/arm/stubs.c","dumpsys",124,235
40,10,251,3,49,"arm32_sync_icache@60-109@sys/arch/arm/arm/sys_machdep.c","sys/arch/arm/arm/sys_machdep.c","arm32_sync_icache",60,109
9,1,37,3,11,"arm32_drain_writebuf@112-123@sys/arch/arm/arm/sys_machdep.c","sys/arch/arm/arm/sys_machdep.c","arm32_drain_writebuf",112,123
21,3,101,3,25,"sys_sysarch@126-151@sys/arch/arm/arm/sys_machdep.c","sys/arch/arm/arm/sys_machdep.c","sys_sysarch",126,151
63,11,380,1,82,"swi_handler@96-178@sys/arch/arm/arm/syscall.c","sys/arch/arm/arm/syscall.c","swi_handler",96,178
9,1,47,1,10,"child_return@181-191@sys/arch/arm/arm/syscall.c","sys/arch/arm/arm/syscall.c","child_return",181,191
10,2,68,2,12,"install_coproc_handler@74-86@sys/arch/arm/arm/undefined.c","sys/arch/arm/arm/undefined.c","install_coproc_handler",74,86
4,1,25,2,4,"install_coproc_handler_static@89-93@sys/arch/arm/arm/undefined.c","sys/arch/arm/arm/undefined.c","install_coproc_handler_static",89,93
6,1,31,1,6,"remove_coproc_handler@96-102@sys/arch/arm/arm/undefined.c","sys/arch/arm/arm/undefined.c","remove_coproc_handler",96,102
14,5,85,4,14,"gdb_trapper@106-120@sys/arch/arm/arm/undefined.c","sys/arch/arm/arm/undefined.c","gdb_trapper",106,120
8,2,44,0,11,"undefined_init@125-136@sys/arch/arm/arm/undefined.c","sys/arch/arm/arm/undefined.c","undefined_init",125,136
64,17,404,1,117,"undefinedinstruction@140-257@sys/arch/arm/arm/undefined.c","sys/arch/arm/arm/undefined.c","undefinedinstruction",140,257
26,4,242,6,42,"cpu_fork@88-130@sys/arch/arm/arm/vm_machdep.c","sys/arch/arm/arm/vm_machdep.c","cpu_fork",88,130
5,1,19,1,4,"cpu_exit@133-137@sys/arch/arm/arm/vm_machdep.c","sys/arch/arm/arm/vm_machdep.c","cpu_exit",133,137
23,3,168,2,30,"vmapbuf@145-175@sys/arch/arm/arm/vm_machdep.c","sys/arch/arm/arm/vm_machdep.c","vmapbuf",145,175
14,2,109,2,20,"vunmapbuf@181-201@sys/arch/arm/arm/vm_machdep.c","sys/arch/arm/arm/vm_machdep.c","vunmapbuf",181,201
6,1,30,2,5,"_mtx_init@46-51@sys/arch/arm/armv7/armv7_mutex.c","sys/arch/arm/armv7/armv7_mutex.c","_mtx_init",46,51
8,3,46,1,10,"__mtx_enter@54-64@sys/arch/arm/armv7/armv7_mutex.c","sys/arch/arm/armv7/armv7_mutex.c","__mtx_enter",54,64
12,4,62,1,15,"__mtx_enter_try@67-82@sys/arch/arm/armv7/armv7_mutex.c","sys/arch/arm/armv7/armv7_mutex.c","__mtx_enter_try",67,82
8,3,42,1,9,"__mtx_leave@85-94@sys/arch/arm/armv7/armv7_mutex.c","sys/arch/arm/armv7/armv7_mutex.c","__mtx_leave",85,94
19,4,142,5,26,"armv7_bs_map@168-194@sys/arch/arm/armv7/armv7_space.c","sys/arch/arm/armv7/armv7_space.c","armv7_bs_map",168,194
9,1,66,3,10,"armv7_bs_unmap@197-207@sys/arch/arm/armv7/armv7_space.c","sys/arch/arm/armv7/armv7_space.c","armv7_bs_unmap",197,207
6,1,33,5,6,"armv7_bs_subregion@211-217@sys/arch/arm/armv7/armv7_space.c","sys/arch/arm/armv7/armv7_space.c","armv7_bs_subregion",211,217
5,1,24,5,4,"armv7_bs_barrier@220-224@sys/arch/arm/armv7/armv7_space.c","sys/arch/arm/armv7/armv7_space.c","armv7_bs_barrier",220,224
4,1,20,2,4,"armv7_bs_vaddr@227-231@sys/arch/arm/armv7/armv7_space.c","sys/arch/arm/armv7/armv7_space.c","armv7_bs_vaddr",227,231
6,1,39,9,6,"armv7_bs_alloc@235-241@sys/arch/arm/armv7/armv7_space.c","sys/arch/arm/armv7/armv7_space.c","armv7_bs_alloc",235,241
4,1,19,3,4,"armv7_bs_free@244-248@sys/arch/arm/armv7/armv7_space.c","sys/arch/arm/armv7/armv7_space.c","armv7_bs_free",244,248
6,1,25,1,7,"agtimer_readcnt64@97-104@sys/arch/arm/cortex/agtimer.c","sys/arch/arm/cortex/agtimer.c","agtimer_readcnt64",97,104
6,1,25,1,7,"agtimer_get_ctrl@107-114@sys/arch/arm/cortex/agtimer.c","sys/arch/arm/cortex/agtimer.c","agtimer_get_ctrl",107,114
7,1,31,1,9,"agtimer_set_ctrl@117-126@sys/arch/arm/cortex/agtimer.c","sys/arch/arm/cortex/agtimer.c","agtimer_set_ctrl",117,126
7,1,31,1,8,"agtimer_set_tval@129-137@sys/arch/arm/cortex/agtimer.c","sys/arch/arm/cortex/agtimer.c","agtimer_set_tval",129,137
5,1,39,3,5,"agtimer_match@140-145@sys/arch/arm/cortex/agtimer.c","sys/arch/arm/cortex/agtimer.c","agtimer_match",140,145
17,2,130,3,32,"agtimer_attach@148-180@sys/arch/arm/cortex/agtimer.c","sys/arch/arm/cortex/agtimer.c","agtimer_attach",148,180
4,1,14,1,3,"agtimer_get_timecount@183-186@sys/arch/arm/cortex/agtimer.c","sys/arch/arm/cortex/agtimer.c","agtimer_get_timecount",183,186
41,10,239,1,65,"agtimer_intr@189-254@sys/arch/arm/cortex/agtimer.c","sys/arch/arm/cortex/agtimer.c","agtimer_intr",189,254
11,2,56,1,13,"agtimer_set_clockrate@257-270@sys/arch/arm/cortex/agtimer.c","sys/arch/arm/cortex/agtimer.c","agtimer_set_clockrate",257,270
27,2,177,0,34,"agtimer_cpu_initclocks@273-307@sys/arch/arm/cortex/agtimer.c","sys/arch/arm/cortex/agtimer.c","agtimer_cpu_initclocks",273,307
26,7,146,1,28,"agtimer_delay@310-338@sys/arch/arm/cortex/agtimer.c","sys/arch/arm/cortex/agtimer.c","agtimer_delay",310,338
14,2,90,1,23,"agtimer_setstatclockrate@341-364@sys/arch/arm/cortex/agtimer.c","sys/arch/arm/cortex/agtimer.c","agtimer_setstatclockrate",341,364
14,1,88,1,15,"agtimer_startclock@367-382@sys/arch/arm/cortex/agtimer.c","sys/arch/arm/cortex/agtimer.c","agtimer_startclock",367,382
11,3,68,1,13,"agtimer_init@385-398@sys/arch/arm/cortex/agtimer.c","sys/arch/arm/cortex/agtimer.c","agtimer_init",385,398
9,3,65,3,10,"ampintc_match@200-210@sys/arch/arm/cortex/ampintc.c","sys/arch/arm/cortex/ampintc.c","ampintc_match",200,210
57,7,560,3,83,"ampintc_attach@213-296@sys/arch/arm/cortex/ampintc.c","sys/arch/arm/cortex/ampintc.c","ampintc_attach",213,296
7,1,49,2,13,"ampintc_set_priority@299-312@sys/arch/arm/cortex/ampintc.c","sys/arch/arm/cortex/ampintc.c","ampintc_set_priority",299,312
11,1,66,1,14,"ampintc_setipl@315-329@sys/arch/arm/cortex/ampintc.c","sys/arch/arm/cortex/ampintc.c","ampintc_setipl",315,329
8,2,58,1,11,"ampintc_intr_enable@332-343@sys/arch/arm/cortex/ampintc.c","sys/arch/arm/cortex/ampintc.c","ampintc_intr_enable",332,343
6,1,38,1,6,"ampintc_intr_disable@346-352@sys/arch/arm/cortex/ampintc.c","sys/arch/arm/cortex/ampintc.c","ampintc_intr_disable",346,352
33,7,194,1,39,"ampintc_calc_mask@356-395@sys/arch/arm/cortex/ampintc.c","sys/arch/arm/cortex/ampintc.c","ampintc_calc_mask",356,395
7,2,37,1,8,"ampintc_splx@398-406@sys/arch/arm/cortex/ampintc.c","sys/arch/arm/cortex/ampintc.c","ampintc_splx",398,406
7,1,33,1,6,"ampintc_spllower@409-415@sys/arch/arm/cortex/ampintc.c","sys/arch/arm/cortex/ampintc.c","ampintc_spllower",409,415
10,2,45,1,19,"ampintc_splraise@418-437@sys/arch/arm/cortex/ampintc.c","sys/arch/arm/cortex/ampintc.c","ampintc_splraise",418,437
7,1,36,1,8,"ampintc_iack@441-449@sys/arch/arm/cortex/ampintc.c","sys/arch/arm/cortex/ampintc.c","ampintc_iack",441,449
5,1,29,1,5,"ampintc_eoi@452-457@sys/arch/arm/cortex/ampintc.c","sys/arch/arm/cortex/ampintc.c","ampintc_eoi",452,457
13,2,98,3,14,"ampintc_route@460-474@sys/arch/arm/cortex/ampintc.c","sys/arch/arm/cortex/ampintc.c","ampintc_route",460,474
37,9,200,1,49,"ampintc_irq_handler@477-526@sys/arch/arm/cortex/ampintc.c","sys/arch/arm/cortex/ampintc.c","ampintc_irq_handler",477,526
5,1,44,5,4,"ampintc_intr_establish_ext@529-533@sys/arch/arm/cortex/ampintc.c","sys/arch/arm/cortex/ampintc.c","ampintc_intr_establish_ext",529,533
14,3,108,6,18,"ampintc_intr_establish_fdt@536-554@sys/arch/arm/cortex/ampintc.c","sys/arch/arm/cortex/ampintc.c","ampintc_intr_establish_fdt",536,554
25,5,179,5,33,"ampintc_intr_establish@557-590@sys/arch/arm/cortex/ampintc.c","sys/arch/arm/cortex/ampintc.c","ampintc_intr_establish",557,590
15,3,106,1,21,"ampintc_intr_disestablish@593-614@sys/arch/arm/cortex/ampintc.c","sys/arch/arm/cortex/ampintc.c","ampintc_intr_disestablish",593,614
7,1,51,1,7,"ampintc_intr_string@617-624@sys/arch/arm/cortex/ampintc.c","sys/arch/arm/cortex/ampintc.c","ampintc_intr_string",617,624
12,2,90,1,13,"amptimer_readcnt64@129-142@sys/arch/arm/cortex/amptimer.c","sys/arch/arm/cortex/amptimer.c","amptimer_readcnt64",129,142
6,2,37,3,6,"amptimer_match@145-151@sys/arch/arm/cortex/amptimer.c","sys/arch/arm/cortex/amptimer.c","amptimer_match",145,151
32,5,285,3,60,"amptimer_attach@154-214@sys/arch/arm/cortex/amptimer.c","sys/arch/arm/cortex/amptimer.c","amptimer_attach",154,214
5,1,32,1,4,"amptimer_get_timecount@217-221@sys/arch/arm/cortex/amptimer.c","sys/arch/arm/cortex/amptimer.c","amptimer_get_timecount",217,221
64,13,437,1,95,"amptimer_intr@224-319@sys/arch/arm/cortex/amptimer.c","sys/arch/arm/cortex/amptimer.c","amptimer_intr",224,319
11,2,56,1,13,"amptimer_set_clockrate@322-335@sys/arch/arm/cortex/amptimer.c","sys/arch/arm/cortex/amptimer.c","amptimer_set_clockrate",322,335
35,5,270,0,51,"amptimer_cpu_initclocks@338-389@sys/arch/arm/cortex/amptimer.c","sys/arch/arm/cortex/amptimer.c","amptimer_cpu_initclocks",338,389
28,7,186,1,30,"amptimer_delay@392-422@sys/arch/arm/cortex/amptimer.c","sys/arch/arm/cortex/amptimer.c","amptimer_delay",392,422
14,2,90,1,23,"amptimer_setstatclockrate@425-448@sys/arch/arm/cortex/amptimer.c","sys/arch/arm/cortex/amptimer.c","amptimer_setstatclockrate",425,448
10,1,77,1,11,"amptimer_startclock@451-462@sys/arch/arm/cortex/amptimer.c","sys/arch/arm/cortex/amptimer.c","amptimer_startclock",451,462
6,2,39,3,6,"arml2cc_match@128-134@sys/arch/arm/cortex/arml2cc.c","sys/arch/arm/cortex/arml2cc.c","arml2cc_match",128,134
26,3,229,3,33,"arml2cc_attach@137-170@sys/arch/arm/cortex/arml2cc.c","sys/arch/arm/cortex/arml2cc.c","arml2cc_attach",137,170
10,1,56,1,12,"arml2cc_enable@173-185@sys/arch/arm/cortex/arml2cc.c","sys/arch/arm/cortex/arml2cc.c","arml2cc_enable",173,185
9,1,56,1,11,"arml2cc_disable@188-199@sys/arch/arm/cortex/arml2cc.c","sys/arch/arm/cortex/arml2cc.c","arml2cc_disable",188,199
6,2,49,3,6,"arml2cc_cache_op@202-208@sys/arch/arm/cortex/arml2cc.c","sys/arch/arm/cortex/arml2cc.c","arml2cc_cache_op",202,208
6,2,49,3,6,"arml2cc_cache_way_op@211-217@sys/arch/arm/cortex/arml2cc.c","sys/arch/arm/cortex/arml2cc.c","arml2cc_cache_way_op",211,217
4,1,24,1,4,"arml2cc_cache_sync@220-224@sys/arch/arm/cortex/arml2cc.c","sys/arch/arm/cortex/arml2cc.c","arml2cc_cache_sync",220,224
7,3,32,1,7,"arml2cc_sdcache_drain_writebuf@227-234@sys/arch/arm/cortex/arml2cc.c","sys/arch/arm/cortex/arml2cc.c","arml2cc_sdcache_drain_writebuf",227,234
13,2,71,3,15,"arml2cc_cache_range_op@237-252@sys/arch/arm/cortex/arml2cc.c","sys/arch/arm/cortex/arml2cc.c","arml2cc_cache_range_op",237,252
11,6,102,1,18,"arml2cc_sdcache_wbinv_all@255-273@sys/arch/arm/cortex/arml2cc.c","sys/arch/arm/cortex/arml2cc.c","arml2cc_sdcache_wbinv_all",255,273
10,5,81,3,16,"arml2cc_sdcache_wbinv_range@275-291@sys/arch/arm/cortex/arml2cc.c","sys/arch/arm/cortex/arml2cc.c","arml2cc_sdcache_wbinv_range",275,291
8,3,47,3,7,"arml2cc_sdcache_inv_range@294-301@sys/arch/arm/cortex/arml2cc.c","sys/arch/arm/cortex/arml2cc.c","arml2cc_sdcache_inv_range",294,301
8,3,47,3,7,"arml2cc_sdcache_wb_range@304-311@sys/arch/arm/cortex/arml2cc.c","sys/arch/arm/cortex/arml2cc.c","arml2cc_sdcache_wb_range",304,311
16,7,117,3,18,"cortexmatch@98-116@sys/arch/arm/cortex/cortex.c","sys/arch/arm/cortex/cortex.c","cortexmatch",98,116
5,1,32,3,5,"cortexattach@125-130@sys/arch/arm/cortex/cortex.c","sys/arch/arm/cortex/cortex.c","cortexattach",125,130
13,2,99,3,16,"cortexsearch@133-149@sys/arch/arm/cortex/cortex.c","sys/arch/arm/cortex/cortex.c","cortexsearch",133,149
7,2,42,2,8,"cortexprint@158-166@sys/arch/arm/cortex/cortex.c","sys/arch/arm/cortex/cortex.c","cortexprint",158,166
20,1,72,3,20,"_atomic_cas_ptr@45-65@sys/arch/arm/include/atomic.h","sys/arch/arm/include/atomic.h","_atomic_cas_ptr",45,65
15,1,58,2,15,"_atomic_swap_ptr@99-114@sys/arch/arm/include/atomic.h","sys/arch/arm/include/atomic.h","_atomic_swap_ptr",99,114
14,1,53,2,14,"atomic_setbits_int@257-271@sys/arch/arm/include/atomic.h","sys/arch/arm/include/atomic.h","atomic_setbits_int",257,271
14,1,54,2,14,"atomic_clearbits_int@278-292@sys/arch/arm/include/atomic.h","sys/arch/arm/include/atomic.h","atomic_clearbits_int",278,292
6,1,27,1,5,"curcpu@215-220@sys/arch/arm/include/cpu.h","sys/arch/arm/include/cpu.h","curcpu",215,220
12,1,47,2,13,"__set_cpsr_c@267-280@sys/arch/arm/include/cpufunc.h","sys/arch/arm/include/cpufunc.h","__set_cpsr_c",267,280
6,1,22,0,7,"__get_cpsr@283-290@sys/arch/arm/include/cpufunc.h","sys/arch/arm/include/cpufunc.h","__get_cpsr",283,290
6,1,30,1,7,"___swap16md@26-33@sys/arch/arm/include/endian.h","sys/arch/arm/include/endian.h","___swap16md",26,33
6,1,30,1,7,"___swap32md@37-44@sys/arch/arm/include/endian.h","sys/arch/arm/include/endian.h","___swap32md",37,44
7,1,39,1,8,"___swap64md@48-56@sys/arch/arm/include/endian.h","sys/arch/arm/include/endian.h","___swap64md",48,56
8,2,44,1,8,"vtopte@299-307@sys/arch/arm/include/pmap.h","sys/arch/arm/include/pmap.h","vtopte",299,307
11,5,61,2,13,"L1_S_PROT@560-573@sys/arch/arm/include/pmap.h","sys/arch/arm/include/pmap.h","L1_S_PROT",560,573
11,5,61,2,13,"L2_L_PROT@575-588@sys/arch/arm/include/pmap.h","sys/arch/arm/include/pmap.h","L2_L_PROT",575,588
11,5,61,2,13,"L2_S_PROT@590-603@sys/arch/arm/include/pmap.h","sys/arch/arm/include/pmap.h","L2_S_PROT",590,603
4,1,24,2,3,"l2pte_is_writeable@606-609@sys/arch/arm/include/pmap.h","sys/arch/arm/include/pmap.h","l2pte_is_writeable",606,609
4,1,20,1,3,"__arm_set_tcb@27-30@sys/arch/arm/include/tcb.h","sys/arch/arm/include/tcb.h","__arm_set_tcb",27,30
6,1,24,1,5,"__arm_read_tcb@47-52@sys/arch/arm/include/tcb.h","sys/arch/arm/include/tcb.h","__arm_read_tcb",47,52
4,1,22,3,3,"mainbus_match@85-88@sys/arch/arm/mainbus/mainbus.c","sys/arch/arm/mainbus/mainbus.c","mainbus_match",85,88
36,7,330,3,48,"mainbus_attach@95-143@sys/arch/arm/mainbus/mainbus.c","sys/arch/arm/mainbus/mainbus.c","mainbus_attach",95,143
51,11,481,3,59,"mainbus_attach_node@149-208@sys/arch/arm/mainbus/mainbus.c","sys/arch/arm/mainbus/mainbus.c","mainbus_attach_node",149,208
13,4,114,3,14,"mainbus_match_status@211-225@sys/arch/arm/mainbus/mainbus.c","sys/arch/arm/mainbus/mainbus.c","mainbus_match_status",211,225
16,3,124,2,19,"mainbus_attach_cpus@228-247@sys/arch/arm/mainbus/mainbus.c","sys/arch/arm/mainbus/mainbus.c","mainbus_attach_cpus",228,247
10,3,88,3,12,"mainbus_match_primary@250-262@sys/arch/arm/mainbus/mainbus.c","sys/arch/arm/mainbus/mainbus.c","mainbus_match_primary",250,262
10,3,88,3,12,"mainbus_match_secondary@265-277@sys/arch/arm/mainbus/mainbus.c","sys/arch/arm/mainbus/mainbus.c","mainbus_match_secondary",265,277
8,3,54,1,9,"mainbus_attach_framebuffer@280-289@sys/arch/arm/mainbus/mainbus.c","sys/arch/arm/mainbus/mainbus.c","mainbus_attach_framebuffer",280,289
7,1,46,2,8,"mainbus_legacy_found@295-303@sys/arch/arm/mainbus/mainbus.c","sys/arch/arm/mainbus/mainbus.c","mainbus_legacy_found",295,303
9,3,64,3,11,"simplebus_match@48-59@sys/arch/arm/simplebus/simplebus.c","sys/arch/arm/simplebus/simplebus.c","simplebus_match",48,59
36,6,339,3,43,"simplebus_attach@62-105@sys/arch/arm/simplebus/simplebus.c","sys/arch/arm/simplebus/simplebus.c","simplebus_attach",62,105
8,2,69,3,8,"simplebus_submatch@108-116@sys/arch/arm/simplebus/simplebus.c","sys/arch/arm/simplebus/simplebus.c","simplebus_submatch",108,116
55,14,523,2,65,"simplebus_attach_node@122-187@sys/arch/arm/simplebus/simplebus.c","sys/arch/arm/simplebus/simplebus.c","simplebus_attach_node",122,187
36,10,324,5,48,"simplebus_bs_map@193-241@sys/arch/arm/simplebus/simplebus.c","sys/arch/arm/simplebus/simplebus.c","simplebus_bs_map",193,241
6,1,30,2,5,"__mtx_init@37-42@sys/arch/arm64/arm64/arm64_mutex.c","sys/arch/arm64/arm64/arm64_mutex.c","__mtx_init",37,42
11,5,51,1,15,"mtx_enter@54-69@sys/arch/arm64/arm64/arm64_mutex.c","sys/arch/arm64/arm64/arm64_mutex.c","mtx_enter",54,69
20,8,125,1,27,"mtx_enter_try@72-99@sys/arch/arm64/arm64/arm64_mutex.c","sys/arch/arm64/arm64/arm64_mutex.c","mtx_enter_try",72,99
11,4,53,1,17,"mtx_leave@102-119@sys/arch/arm64/arm64/arm64_mutex.c","sys/arch/arm64/arm64/arm64_mutex.c","mtx_leave",102,119
9,1,54,1,10,"ast@35-45@sys/arch/arm64/arm64/ast.c","sys/arch/arm64/arm64/ast.c","ast",35,45
9,3,48,1,11,"unmap_startup@35-46@sys/arch/arm64/arm64/autoconf.c","sys/arch/arm64/arm64/autoconf.c","unmap_startup",35,46
9,1,39,1,11,"cpu_configure@49-60@sys/arch/arm64/arm64/autoconf.c","sys/arch/arm64/arm64/autoconf.c","cpu_configure",49,60
22,6,121,1,30,"diskconf@63-93@sys/arch/arm64/arm64/autoconf.c","sys/arch/arm64/arm64/autoconf.c","diskconf",63,93
3,1,13,2,2,"device_register@96-98@sys/arch/arm64/arm64/autoconf.c","sys/arch/arm64/arm64/autoconf.c","device_register",96,98
20,3,152,7,34,"_dmamap_create@75-109@sys/arch/arm64/arm64/bus_dma.c","sys/arch/arm64/arm64/bus_dma.c","_dmamap_create",75,109
4,1,19,2,3,"_dmamap_destroy@116-119@sys/arch/arm64/arm64/bus_dma.c","sys/arch/arm64/arm64/bus_dma.c","_dmamap_destroy",116,119
18,3,119,6,24,"_dmamap_load@126-150@sys/arch/arm64/arm64/bus_dma.c","sys/arch/arm64/arm64/bus_dma.c","_dmamap_load",126,150
27,8,192,4,36,"_dmamap_load_mbuf@156-192@sys/arch/arm64/arm64/bus_dma.c","sys/arch/arm64/arm64/bus_dma.c","_dmamap_load_mbuf",156,192
34,9,239,4,49,"_dmamap_load_uio@198-247@sys/arch/arm64/arm64/bus_dma.c","sys/arch/arm64/arm64/bus_dma.c","_dmamap_load_uio",198,247
61,15,441,6,83,"_dmamap_load_raw@254-337@sys/arch/arm64/arm64/bus_dma.c","sys/arch/arm64/arm64/bus_dma.c","_dmamap_load_raw",254,337
5,1,22,2,8,"_dmamap_unload@344-352@sys/arch/arm64/arm64/bus_dma.c","sys/arch/arm64/arm64/bus_dma.c","_dmamap_unload",344,352
17,6,69,3,24,"_dmamap_sync_segment@355-379@sys/arch/arm64/arm64/bus_dma.c","sys/arch/arm64/arm64/bus_dma.c","_dmamap_sync_segment",355,379
39,9,176,5,50,"_dmamap_sync@386-436@sys/arch/arm64/arm64/bus_dma.c","sys/arch/arm64/arm64/bus_dma.c","_dmamap_sync",386,436
7,1,61,8,6,"_dmamem_alloc@443-449@sys/arch/arm64/arm64/bus_dma.c","sys/arch/arm64/arm64/bus_dma.c","_dmamem_alloc",443,449
17,3,106,3,21,"_dmamem_free@456-477@sys/arch/arm64/arm64/bus_dma.c","sys/arch/arm64/arm64/bus_dma.c","_dmamem_free",456,477
36,9,257,6,39,"_dmamem_map@484-523@sys/arch/arm64/arm64/bus_dma.c","sys/arch/arm64/arm64/bus_dma.c","_dmamem_map",484,523
4,1,29,3,3,"_dmamem_unmap@530-533@sys/arch/arm64/arm64/bus_dma.c","sys/arch/arm64/arm64/bus_dma.c","_dmamem_unmap",530,533
22,7,143,6,27,"_dmamem_mmap@540-567@sys/arch/arm64/arm64/bus_dma.c","sys/arch/arm64/arm64/bus_dma.c","_dmamem_mmap",540,567
64,15,449,9,89,"_dmamap_load_buffer@580-669@sys/arch/arm64/arm64/bus_dma.c","sys/arch/arm64/arm64/bus_dma.c","_dmamap_load_buffer",580,669
41,9,272,10,57,"_dmamem_alloc_range@676-733@sys/arch/arm64/arm64/bus_dma.c","sys/arch/arm64/arm64/bus_dma.c","_dmamem_alloc_range",676,733
4,3,33,1,4,"iskmemdev@275-279@sys/arch/arm64/arm64/conf.c","sys/arch/arm64/arm64/conf.c","iskmemdev",275,279
4,2,24,1,4,"iszerodev@285-289@sys/arch/arm64/arm64/conf.c","sys/arch/arm64/arm64/conf.c","iszerodev",285,289
4,1,14,1,3,"getnulldev@292-295@sys/arch/arm64/arm64/conf.c","sys/arch/arm64/arm64/conf.c","getnulldev",292,295
14,3,55,1,17,"dev_rawpart@363-380@sys/arch/arm64/arm64/conf.c","sys/arch/arm64/arm64/conf.c","dev_rawpart",363,380
36,9,245,1,41,"cpu_identify@103-144@sys/arch/arm64/arm64/cpu.c","sys/arch/arm64/arm64/cpu.c","cpu_identify",103,144
9,3,65,3,10,"cpu_match@147-157@sys/arch/arm64/arm64/cpu.c","sys/arch/arm64/arm64/cpu.c","cpu_match",147,157
17,2,108,3,20,"cpu_attach@160-180@sys/arch/arm64/arm64/cpu.c","sys/arch/arm64/arm64/cpu.c","cpu_attach",160,180
4,1,15,2,3,"db_disasm@26-29@sys/arch/arm64/arm64/db_disasm.c","sys/arch/arm64/arm64/db_disasm.c","db_disasm",26,29
23,4,93,2,31,"kdb_trap@114-145@sys/arch/arm64/arm64/db_interface.c","sys/arch/arm64/arm64/db_interface.c","kdb_trap",114,145
11,5,74,1,12,"db_validate_address@154-166@sys/arch/arm64/arm64/db_interface.c","sys/arch/arm64/arm64/db_interface.c","db_validate_address",154,166
30,13,230,3,34,"db_read_bytes@172-206@sys/arch/arm64/arm64/db_interface.c","sys/arch/arm64/arm64/db_interface.c","db_read_bytes",172,206
4,1,16,3,4,"db_write_text@210-214@sys/arch/arm64/arm64/db_interface.c","sys/arch/arm64/arm64/db_interface.c","db_write_text",210,214
23,6,127,3,30,"db_write_bytes@221-251@sys/arch/arm64/arm64/db_interface.c","sys/arch/arm64/arm64/db_interface.c","db_write_bytes",221,251
4,1,11,1,3,"db_enter@254-257@sys/arch/arm64/arm64/db_interface.c","sys/arch/arm64/arm64/db_interface.c","db_enter",254,257
9,2,52,4,9,"db_trapper@264-273@sys/arch/arm64/arm64/db_interface.c","sys/arch/arm64/arm64/db_interface.c","db_trapper",264,273
4,1,11,1,10,"db_machine_init@279-289@sys/arch/arm64/arm64/db_interface.c","sys/arch/arm64/arm64/db_interface.c","db_machine_init",279,289
4,1,19,3,4,"db_branch_taken@292-296@sys/arch/arm64/arm64/db_interface.c","sys/arch/arm64/arm64/db_interface.c","db_branch_taken",292,296
79,20,544,5,87,"db_stack_trace_print@63-150@sys/arch/arm64/arm64/db_trace.c","sys/arch/arm64/arm64/db_trace.c","db_stack_trace_print",63,150
26,8,157,4,35,"readdisklabel@56-91@sys/arch/arm64/arm64/disksubr.c","sys/arch/arm64/arm64/disksubr.c","readdisklabel",56,91
34,4,262,3,40,"writedisklabel@97-137@sys/arch/arm64/arm64/disksubr.c","sys/arch/arm64/arm64/disksubr.c","writedisklabel",97,137
4,1,16,1,4,"arm_cpu_intr@57-61@sys/arch/arm64/arm64/intr.c","sys/arch/arm64/arm64/intr.c","arm_cpu_intr",57,61
4,1,13,1,3,"arm_dflt_intr@63-66@sys/arch/arm64/arm64/intr.c","sys/arch/arm64/arm64/intr.c","arm_dflt_intr",63,66
9,3,42,1,10,"arm_intr_get_parent@72-82@sys/arch/arm64/arm64/intr.c","sys/arch/arm64/arm64/intr.c","arm_intr_get_parent",72,82
9,3,42,1,10,"arm_intr_msi_get_parent@85-95@sys/arch/arm64/arm64/intr.c","sys/arch/arm64/arm64/intr.c","arm_intr_msi_get_parent",85,95
17,2,137,6,18,"arm_intr_prereg_establish_fdt@130-148@sys/arch/arm64/arm64/intr.c","sys/arch/arm64/arm64/intr.c","arm_intr_prereg_establish_fdt",130,148
10,4,75,1,12,"arm_intr_prereg_disestablish_fdt@151-163@sys/arch/arm64/arm64/intr.c","sys/arch/arm64/arm64/intr.c","arm_intr_prereg_disestablish_fdt",151,163
15,3,94,1,16,"arm_intr_init_fdt_recurse@166-182@sys/arch/arm64/arm64/intr.c","sys/arch/arm64/arm64/intr.c","arm_intr_init_fdt_recurse",166,182
6,2,23,1,6,"arm_intr_init_fdt@185-191@sys/arch/arm64/arm64/intr.c","sys/arch/arm64/arm64/intr.c","arm_intr_init_fdt",185,191
20,4,164,1,25,"arm_intr_register_fdt@197-222@sys/arch/arm64/arm64/intr.c","sys/arch/arm64/arm64/intr.c","arm_intr_register_fdt",197,222
5,1,44,5,4,"arm_intr_establish_fdt@230-234@sys/arch/arm64/arm64/intr.c","sys/arch/arm64/arm64/intr.c","arm_intr_establish_fdt",230,234
58,17,378,6,72,"arm_intr_establish_fdt_idx@237-309@sys/arch/arm64/arm64/intr.c","sys/arch/arm64/arm64/intr.c","arm_intr_establish_fdt_idx",237,309
56,15,443,8,66,"arm_intr_establish_fdt_imap@312-378@sys/arch/arm64/arm64/intr.c","sys/arch/arm64/arm64/intr.c","arm_intr_establish_fdt_imap",312,378
21,4,151,7,25,"arm_intr_establish_fdt_msi@381-406@sys/arch/arm64/arm64/intr.c","sys/arch/arm64/arm64/intr.c","arm_intr_establish_fdt_msi",381,406
7,1,46,1,7,"arm_intr_disestablish_fdt@409-416@sys/arch/arm64/arm64/intr.c","sys/arch/arm64/arm64/intr.c","arm_intr_disestablish_fdt",409,416
22,4,151,6,25,"arm_intr_parent_establish_fdt@424-449@sys/arch/arm64/arm64/intr.c","sys/arch/arm64/arm64/intr.c","arm_intr_parent_establish_fdt",424,449
7,1,46,1,7,"arm_intr_parent_disestablish_fdt@452-459@sys/arch/arm64/arm64/intr.c","sys/arch/arm64/arm64/intr.c","arm_intr_parent_disestablish_fdt",452,459
7,2,51,3,7,"arm_intr_route@462-469@sys/arch/arm64/arm64/intr.c","sys/arch/arm64/arm64/intr.c","arm_intr_route",462,469
10,2,44,1,13,"arm_dflt_splraise@472-485@sys/arch/arm64/arm64/intr.c","sys/arch/arm64/arm64/intr.c","arm_dflt_splraise",472,485
8,1,33,1,10,"arm_dflt_spllower@488-498@sys/arch/arm64/arm64/intr.c","sys/arch/arm64/arm64/intr.c","arm_dflt_spllower",488,498
7,2,38,1,7,"arm_dflt_splx@501-508@sys/arch/arm64/arm64/intr.c","sys/arch/arm64/arm64/intr.c","arm_dflt_splx",501,508
5,1,22,1,5,"arm_dflt_setipl@511-516@sys/arch/arm64/arm64/intr.c","sys/arch/arm64/arm64/intr.c","arm_dflt_setipl",511,516
14,2,80,1,27,"arm_do_pending_intr@519-546@sys/arch/arm64/arm64/intr.c","sys/arch/arm64/arm64/intr.c","arm_do_pending_intr",519,546
10,1,78,5,9,"arm_set_intr_handler@548-557@sys/arch/arm64/arm64/intr.c","sys/arch/arm64/arm64/intr.c","arm_set_intr_handler",548,557
19,7,111,1,20,"arm_init_smask@560-580@sys/arch/arm64/arm64/intr.c","sys/arch/arm64/arm64/intr.c","arm_init_smask",560,580
4,1,15,1,3,"splraise@588-591@sys/arch/arm64/arm64/intr.c","sys/arch/arm64/arm64/intr.c","splraise",588,591
4,1,15,1,3,"_spllower@595-598@sys/arch/arm64/arm64/intr.c","sys/arch/arm64/arm64/intr.c","_spllower",595,598
4,1,15,1,3,"spllower@600-603@sys/arch/arm64/arm64/intr.c","sys/arch/arm64/arm64/intr.c","spllower",600,603
4,1,14,1,3,"splx@606-609@sys/arch/arm64/arm64/intr.c","sys/arch/arm64/arm64/intr.c","splx",606,609
11,4,75,2,16,"arm_splassert_check@614-630@sys/arch/arm64/arm64/intr.c","sys/arch/arm64/arm64/intr.c","arm_splassert_check",614,630
10,2,72,4,10,"arm_clock_register@648-658@sys/arch/arm64/arm64/intr.c","sys/arch/arm64/arm64/intr.c","arm_clock_register",648,658
4,1,14,1,3,"delay@662-665@sys/arch/arm64/arm64/intr.c","sys/arch/arm64/arm64/intr.c","delay",662,665
6,2,25,1,6,"cpu_initclocks@668-674@sys/arch/arm64/arm64/intr.c","sys/arch/arm64/arm64/intr.c","cpu_initclocks",668,674
7,3,34,1,9,"arm_dflt_delay@677-686@sys/arch/arm64/arm64/intr.c","sys/arch/arm64/arm64/intr.c","arm_dflt_delay",677,686
10,4,45,1,12,"resettodr@696-708@sys/arch/arm64/arm64/intr.c","sys/arch/arm64/arm64/intr.c","resettodr",696,708
7,2,29,1,6,"setstatclockrate@711-717@sys/arch/arm64/arm64/intr.c","sys/arch/arm64/arm64/intr.c","setstatclockrate",711,717
4,1,13,1,3,"intr_barrier@720-723@sys/arch/arm64/arm64/intr.c","sys/arch/arm64/arm64/intr.c","intr_barrier",720,723
43,11,234,1,54,"inittodr@95-149@sys/arch/arm64/arm64/machdep.c","sys/arch/arm64/arm64/machdep.c","inittodr",95,149
36,11,204,1,43,"fdt_find_cons@152-195@sys/arch/arm64/arm64/machdep.c","sys/arch/arm64/arm64/machdep.c","fdt_find_cons",152,195
10,2,38,1,12,"consinit@202-214@sys/arch/arm64/arm64/machdep.c","sys/arch/arm64/arm64/machdep.c","consinit",202,214
3,1,5,0,2,"cpu_idle_enter@217-219@sys/arch/arm64/arm64/machdep.c","sys/arch/arm64/arm64/machdep.c","cpu_idle_enter",217,219
5,1,16,0,4,"cpu_idle_cycle@222-226@sys/arch/arm64/arm64/machdep.c","sys/arch/arm64/arm64/machdep.c","cpu_idle_cycle",222,226
3,1,5,0,2,"cpu_idle_leave@229-231@sys/arch/arm64/arm64/machdep.c","sys/arch/arm64/arm64/machdep.c","cpu_idle_leave",229,231
30,4,218,0,64,"cpu_startup@237-301@sys/arch/arm64/arm64/machdep.c","sys/arch/arm64/arm64/machdep.c","cpu_startup",237,301
10,2,58,7,13,"cpu_sysctl@308-321@sys/arch/arm64/arm64/machdep.c","sys/arch/arm64/arm64/machdep.c","cpu_sysctl",308,321
45,12,216,1,53,"boot@328-381@sys/arch/arm64/arm64/machdep.c","sys/arch/arm64/arm64/machdep.c","boot",328,381
15,2,111,4,19,"setregs@386-405@sys/arch/arm64/arm64/machdep.c","sys/arch/arm64/arm64/machdep.c","setregs",386,405
7,2,30,1,9,"need_resched@408-417@sys/arch/arm64/arm64/machdep.c","sys/arch/arm64/arm64/machdep.c","need_resched",408,417
33,4,285,1,55,"cpu_dump@437-492@sys/arch/arm64/arm64/machdep.c","sys/arch/arm64/arm64/machdep.c","cpu_dump",437,492
17,6,101,1,24,"dumpconf@503-527@sys/arch/arm64/arm64/machdep.c","sys/arch/arm64/arm64/machdep.c","dumpconf",503,527
90,24,509,1,125,"dumpsys@537-662@sys/arch/arm64/arm64/machdep.c","sys/arch/arm64/arm64/machdep.c","dumpsys",537,662
9,2,57,1,10,"cpu_dumpsize@677-687@sys/arch/arm64/arm64/machdep.c","sys/arch/arm64/arm64/machdep.c","cpu_dumpsize",677,687
4,1,8,0,3,"cpu_dump_mempagecnt@690-693@sys/arch/arm64/arm64/machdep.c","sys/arch/arm64/arm64/machdep.c","cpu_dump_mempagecnt",690,693
3,1,5,0,2,"install_coproc_handler@697-699@sys/arch/arm64/arm64/machdep.c","sys/arch/arm64/arm64/machdep.c","install_coproc_handler",697,699
19,2,106,1,29,"cache_setup@707-736@sys/arch/arm64/arm64/machdep.c","sys/arch/arm64/arm64/machdep.c","cache_setup",707,736
173,31,1235,1,256,"initarm@749-1005@sys/arch/arm64/arm64/machdep.c","sys/arch/arm64/arm64/machdep.c","initarm",749,1005
4,1,22,1,4,"collect_kernel_args@1011-1015@sys/arch/arm64/arm64/machdep.c","sys/arch/arm64/arm64/machdep.c","collect_kernel_args",1011,1015
52,15,222,1,66,"process_kernel_args@1017-1083@sys/arch/arm64/arm64/machdep.c","sys/arch/arm64/arm64/machdep.c","process_kernel_args",1017,1083
18,3,123,5,25,"pmap_bootstrap_bs_map@1090-1115@sys/arch/arm64/arm64/machdep.c","sys/arch/arm64/arm64/machdep.c","pmap_bootstrap_bs_map",1090,1115
12,2,87,1,11,"dumpregs@1120-1131@sys/arch/arm64/arm64/machdep.c","sys/arch/arm64/arm64/machdep.c","dumpregs",1120,1131
24,13,114,4,29,"mmopen@102-131@sys/arch/arm64/arm64/mem.c","sys/arch/arm64/arm64/mem.c","mmopen",102,131
6,3,36,4,7,"mmclose@134-141@sys/arch/arm64/arm64/mem.c","sys/arch/arm64/arm64/mem.c","mmclose",134,141
69,18,440,3,76,"mmrw@144-220@sys/arch/arm64/arm64/mem.c","sys/arch/arm64/arm64/mem.c","mmrw",144,220
10,4,66,3,21,"mmmmap@223-244@sys/arch/arm64/arm64/mem.c","sys/arch/arm64/arm64/mem.c","mmmmap",223,244
4,1,26,5,3,"mmioctl@247-250@sys/arch/arm64/arm64/mem.c","sys/arch/arm64/arm64/mem.c","mmioctl",247,250
3,1,7,1,2,"openpromattach@68-70@sys/arch/arm64/arm64/openprom.c","sys/arch/arm64/arm64/openprom.c","openpromattach",68,70
4,1,23,4,3,"openpromopen@73-76@sys/arch/arm64/arm64/openprom.c","sys/arch/arm64/arm64/openprom.c","openpromopen",73,76
4,1,23,4,3,"openpromclose@79-82@sys/arch/arm64/arm64/openprom.c","sys/arch/arm64/arm64/openprom.c","openpromclose",79,82
7,4,50,2,7,"openpromcheckid@89-96@sys/arch/arm64/arm64/openprom.c","sys/arch/arm64/arm64/openprom.c","openpromcheckid",89,96
11,2,81,3,13,"openpromgetstr@99-112@sys/arch/arm64/arm64/openprom.c","sys/arch/arm64/arm64/openprom.c","openpromgetstr",99,112
136,34,841,5,154,"openpromioctl@115-269@sys/arch/arm64/arm64/openprom.c","sys/arch/arm64/arm64/openprom.c","openpromioctl",115,269
11,2,70,2,11,"ttlb_flush@41-52@sys/arch/arm64/arm64/pmap.c","sys/arch/arm64/arm64/pmap.c","ttlb_flush",41,52
4,1,17,1,3,"VP_IDX0@161-164@sys/arch/arm64/arm64/pmap.c","sys/arch/arm64/arm64/pmap.c","VP_IDX0",161,164
4,1,17,1,3,"VP_IDX1@167-170@sys/arch/arm64/arm64/pmap.c","sys/arch/arm64/arm64/pmap.c","VP_IDX1",167,170
4,1,17,1,3,"VP_IDX2@173-176@sys/arch/arm64/arm64/pmap.c","sys/arch/arm64/arm64/pmap.c","VP_IDX2",173,176
4,1,17,1,3,"VP_IDX3@179-182@sys/arch/arm64/arm64/pmap.c","sys/arch/arm64/arm64/pmap.c","VP_IDX3",179,182
30,7,178,3,34,"pmap_vp_lookup@214-248@sys/arch/arm64/arm64/pmap.c","sys/arch/arm64/arm64/pmap.c","pmap_vp_lookup",214,248
26,5,149,2,30,"pmap_vp_remove@254-284@sys/arch/arm64/arm64/pmap.c","sys/arch/arm64/arm64/pmap.c","pmap_vp_remove",254,284
43,11,284,4,46,"pmap_vp_enter@300-346@sys/arch/arm64/arm64/pmap.c","sys/arch/arm64/arm64/pmap.c","pmap_vp_enter",300,346
11,1,72,3,13,"pmap_vp_page_alloc@349-362@sys/arch/arm64/arm64/pmap.c","sys/arch/arm64/arm64/pmap.c","pmap_vp_page_alloc",349,362
6,1,36,2,5,"pmap_vp_page_free@365-370@sys/arch/arm64/arm64/pmap.c","sys/arch/arm64/arm64/pmap.c","pmap_vp_page_free",365,370
4,1,18,1,3,"PTED_MANAGED@377-380@sys/arch/arm64/arm64/pmap.c","sys/arch/arm64/arm64/pmap.c","PTED_MANAGED",377,380
4,1,18,1,3,"PTED_WIRED@383-386@sys/arch/arm64/arm64/pmap.c","sys/arch/arm64/arm64/pmap.c","PTED_WIRED",383,386
4,1,18,1,3,"PTED_VALID@389-392@sys/arch/arm64/arm64/pmap.c","sys/arch/arm64/arm64/pmap.c","PTED_VALID",389,392
7,2,46,2,11,"pmap_enter_pv@423-434@sys/arch/arm64/arm64/pmap.c","sys/arch/arm64/arm64/pmap.c","pmap_enter_pv",423,434
4,1,16,1,3,"pmap_remove_pv@437-440@sys/arch/arm64/arm64/pmap.c","sys/arch/arm64/arm64/pmap.c","pmap_remove_pv",437,440
63,23,438,5,87,"pmap_enter@443-530@sys/arch/arm64/arm64/pmap.c","sys/arch/arm64/arm64/pmap.c","pmap_enter",443,530
16,5,93,3,19,"pmap_remove@537-556@sys/arch/arm64/arm64/pmap.c","sys/arch/arm64/arm64/pmap.c","pmap_remove",537,556
21,5,128,2,28,"pmap_remove_pted@562-590@sys/arch/arm64/arm64/pmap.c","sys/arch/arm64/arm64/pmap.c","pmap_remove_pted",562,590
20,4,129,5,36,"_pmap_kenter_pa@603-639@sys/arch/arm64/arm64/pmap.c","sys/arch/arm64/arm64/pmap.c","_pmap_kenter_pa",603,639
5,2,34,3,4,"pmap_kenter_pa@642-646@sys/arch/arm64/arm64/pmap.c","sys/arch/arm64/arm64/pmap.c","pmap_kenter_pa",642,646
4,1,29,4,3,"pmap_kenter_cache@649-652@sys/arch/arm64/arm64/pmap.c","sys/arch/arm64/arm64/pmap.c","pmap_kenter_cache",649,652
24,6,140,1,40,"pmap_kremove_pg@658-698@sys/arch/arm64/arm64/pmap.c","sys/arch/arm64/arm64/pmap.c","pmap_kremove_pg",658,698
5,2,33,2,4,"pmap_kremove@704-708@sys/arch/arm64/arm64/pmap.c","sys/arch/arm64/arm64/pmap.c","pmap_kremove",704,708
26,6,135,7,29,"pmap_fill_pte@711-740@sys/arch/arm64/arm64/pmap.c","sys/arch/arm64/arm64/pmap.c","pmap_fill_pte",711,740
3,1,7,1,9,"pmap_collect@749-758@sys/arch/arm64/arm64/pmap.c","sys/arch/arm64/arm64/pmap.c","pmap_collect",749,758
7,1,38,1,9,"pmap_zero_page@766-775@sys/arch/arm64/arm64/pmap.c","sys/arch/arm64/arm64/pmap.c","pmap_zero_page",766,775
10,1,77,2,12,"pmap_copy_page@782-794@sys/arch/arm64/arm64/pmap.c","sys/arch/arm64/arm64/pmap.c","pmap_copy_page",782,794
20,4,131,1,25,"pmap_pinit@797-822@sys/arch/arm64/arm64/pmap.c","sys/arch/arm64/arm64/pmap.c","pmap_pinit",797,822
11,2,51,1,11,"pmap_create@830-841@sys/arch/arm64/arm64/pmap.c","sys/arch/arm64/arm64/pmap.c","pmap_create",830,841
4,1,12,1,3,"pmap_reference@847-850@sys/arch/arm64/arm64/pmap.c","sys/arch/arm64/arm64/pmap.c","pmap_reference",847,850
10,2,43,1,14,"pmap_destroy@857-871@sys/arch/arm64/arm64/pmap.c","sys/arch/arm64/arm64/pmap.c","pmap_destroy",857,871
4,1,12,1,3,"pmap_release@878-881@sys/arch/arm64/arm64/pmap.c","sys/arch/arm64/arm64/pmap.c","pmap_release",878,881
28,7,181,2,31,"pmap_vp_destroy_l2_l3@884-915@sys/arch/arm64/arm64/pmap.c","sys/arch/arm64/arm64/pmap.c","pmap_vp_destroy_l2_l3",884,915
23,4,142,1,30,"pmap_vp_destroy@918-948@sys/arch/arm64/arm64/pmap.c","sys/arch/arm64/arm64/pmap.c","pmap_vp_destroy",918,948
46,12,267,3,59,"pmap_steal_memory@955-1014@sys/arch/arm64/arm64/pmap.c","sys/arch/arm64/arm64/pmap.c","pmap_steal_memory",955,1014
4,1,12,1,7,"VP_Lx@1019-1026@sys/arch/arm64/arm64/pmap.c","sys/arch/arm64/arm64/pmap.c","VP_Lx",1019,1026
112,17,808,6,161,"pmap_bootstrap@1044-1205@sys/arch/arm64/arm64/pmap.c","sys/arch/arm64/arm64/pmap.c","pmap_bootstrap",1044,1205
14,3,104,4,21,"pmap_set_l1@1208-1229@sys/arch/arm64/arm64/pmap.c","sys/arch/arm64/arm64/pmap.c","pmap_set_l1",1208,1229
20,4,138,4,27,"pmap_set_l2@1232-1259@sys/arch/arm64/arm64/pmap.c","sys/arch/arm64/arm64/pmap.c","pmap_set_l2",1232,1259
23,4,161,4,30,"pmap_set_l3@1262-1292@sys/arch/arm64/arm64/pmap.c","sys/arch/arm64/arm64/pmap.c","pmap_set_l3",1262,1292
9,3,53,1,9,"pmap_activate@1298-1307@sys/arch/arm64/arm64/pmap.c","sys/arch/arm64/arm64/pmap.c","pmap_activate",1298,1307
3,1,9,1,2,"pmap_deactivate@1313-1315@sys/arch/arm64/arm64/pmap.c","sys/arch/arm64/arm64/pmap.c","pmap_deactivate",1313,1315
12,4,76,3,16,"pmap_extract@1321-1337@sys/arch/arm64/arm64/pmap.c","sys/arch/arm64/arm64/pmap.c","pmap_extract",1321,1337
14,3,81,3,18,"pmap_page_ro@1340-1358@sys/arch/arm64/arm64/pmap.c","sys/arch/arm64/arm64/pmap.c","pmap_page_ro",1340,1358
19,3,126,2,23,"pmap_page_protect@1367-1390@sys/arch/arm64/arm64/pmap.c","sys/arch/arm64/arm64/pmap.c","pmap_page_protect",1367,1390
14,3,74,4,14,"pmap_protect@1393-1407@sys/arch/arm64/arm64/pmap.c","sys/arch/arm64/arm64/pmap.c","pmap_protect",1393,1407
17,1,126,1,25,"pmap_init@1410-1435@sys/arch/arm64/arm64/pmap.c","sys/arch/arm64/arm64/pmap.c","pmap_init",1410,1435
5,2,30,3,5,"pmap_proc_iflush@1438-1443@sys/arch/arm64/arm64/pmap.c","sys/arch/arm64/arm64/pmap.c","pmap_proc_iflush",1438,1443
10,2,59,1,13,"pmap_pte_insert@1446-1459@sys/arch/arm64/arm64/pmap.c","sys/arch/arm64/arm64/pmap.c","pmap_pte_insert",1446,1459
32,6,175,2,38,"pmap_pte_update@1462-1500@sys/arch/arm64/arm64/pmap.c","sys/arch/arm64/arm64/pmap.c","pmap_pte_update",1462,1500
29,6,203,2,32,"pmap_pte_remove@1503-1535@sys/arch/arm64/arm64/pmap.c","sys/arch/arm64/arm64/pmap.c","pmap_pte_remove",1503,1535
47,16,341,4,98,"pmap_fault_fixup@1543-1641@sys/arch/arm64/arm64/pmap.c","sys/arch/arm64/arm64/pmap.c","pmap_fault_fixup",1543,1641
3,1,6,1,2,"pmap_postinit@1644-1646@sys/arch/arm64/arm64/pmap.c","sys/arch/arm64/arm64/pmap.c","pmap_postinit",1644,1646
3,1,7,1,2,"pmap_update@1649-1651@sys/arch/arm64/arm64/pmap.c","sys/arch/arm64/arm64/pmap.c","pmap_update",1649,1651
4,1,22,1,3,"pmap_is_referenced@1659-1662@sys/arch/arm64/arm64/pmap.c","sys/arch/arm64/arm64/pmap.c","pmap_is_referenced",1659,1662
4,1,22,1,3,"pmap_is_modified@1665-1668@sys/arch/arm64/arm64/pmap.c","sys/arch/arm64/arm64/pmap.c","pmap_is_modified",1665,1668
17,2,112,1,21,"pmap_clear_modify@1671-1692@sys/arch/arm64/arm64/pmap.c","sys/arch/arm64/arm64/pmap.c","pmap_clear_modify",1671,1692
14,1,78,1,17,"pmap_clear_reference@1699-1716@sys/arch/arm64/arm64/pmap.c","sys/arch/arm64/arm64/pmap.c","pmap_clear_reference",1699,1716
4,1,19,5,4,"pmap_copy@1719-1723@sys/arch/arm64/arm64/pmap.c","sys/arch/arm64/arm64/pmap.c","pmap_copy",1719,1723
9,3,57,2,9,"pmap_unwire@1726-1735@sys/arch/arm64/arm64/pmap.c","sys/arch/arm64/arm64/pmap.c","pmap_unwire",1726,1735
3,1,9,1,3,"pmap_remove_holes@1738-1741@sys/arch/arm64/arm64/pmap.c","sys/arch/arm64/arm64/pmap.c","pmap_remove_holes",1738,1741
5,1,22,2,4,"pmap_virtual_space@1744-1748@sys/arch/arm64/arm64/pmap.c","sys/arch/arm64/arm64/pmap.c","pmap_virtual_space",1744,1748
9,1,57,3,24,"pmap_setup_avail@1751-1775@sys/arch/arm64/arm64/pmap.c","sys/arch/arm64/arm64/pmap.c","pmap_setup_avail",1751,1775
23,4,106,1,23,"pmap_avail_fixup@1778-1801@sys/arch/arm64/arm64/pmap.c","sys/arch/arm64/arm64/pmap.c","pmap_avail_fixup",1778,1801
69,15,383,2,80,"pmap_remove_avail@1805-1885@sys/arch/arm64/arm64/pmap.c","sys/arch/arm64/arm64/pmap.c","pmap_remove_avail",1805,1885
22,5,147,3,22,"pmap_steal_avail@1889-1911@sys/arch/arm64/arm64/pmap.c","sys/arch/arm64/arm64/pmap.c","pmap_steal_avail",1889,1911
25,9,146,1,30,"pmap_map_stolen@1914-1944@sys/arch/arm64/arm64/pmap.c","sys/arch/arm64/arm64/pmap.c","pmap_map_stolen",1914,1944
21,5,123,1,22,"pmap_physload_avail@1947-1969@sys/arch/arm64/arm64/pmap.c","sys/arch/arm64/arm64/pmap.c","pmap_physload_avail",1947,1969
39,6,297,1,45,"pmap_show_mapping@1972-2017@sys/arch/arm64/arm64/pmap.c","sys/arch/arm64/arm64/pmap.c","pmap_show_mapping",1972,2017
10,3,82,1,11,"pmap_allocate_asid@2023-2034@sys/arch/arm64/arm64/pmap.c","sys/arch/arm64/arm64/pmap.c","pmap_allocate_asid",2023,2034
9,1,68,1,10,"pmap_free_asid@2037-2047@sys/arch/arm64/arm64/pmap.c","sys/arch/arm64/arm64/pmap.c","pmap_free_asid",2037,2047
6,1,47,1,6,"pmap_setttb@2050-2056@sys/arch/arm64/arm64/pmap.c","sys/arch/arm64/arm64/pmap.c","pmap_setttb",2050,2056
11,1,105,2,12,"process_read_regs@54-66@sys/arch/arm64/arm64/process_machdep.c","sys/arch/arm64/arm64/process_machdep.c","process_read_regs",54,66
8,2,65,2,8,"process_read_fpregs@69-77@sys/arch/arm64/arm64/process_machdep.c","sys/arch/arm64/arm64/process_machdep.c","process_read_fpregs",69,77
4,1,19,2,3,"process_write_regs@82-85@sys/arch/arm64/arm64/process_machdep.c","sys/arch/arm64/arm64/process_machdep.c","process_write_regs",82,85
4,1,19,2,3,"process_write_fpregs@88-91@sys/arch/arm64/arm64/process_machdep.c","sys/arch/arm64/arm64/process_machdep.c","process_write_fpregs",88,91
6,2,24,2,5,"process_sstep@94-99@sys/arch/arm64/arm64/process_machdep.c","sys/arch/arm64/arm64/process_machdep.c","process_sstep",94,99
4,1,17,2,3,"process_set_pc@102-105@sys/arch/arm64/arm64/process_machdep.c","sys/arch/arm64/arm64/process_machdep.c","process_set_pc",102,105
4,1,18,1,3,"process_frame@82-85@sys/arch/arm64/arm64/sig_machdep.c","sys/arch/arm64/arm64/sig_machdep.c","process_frame",82,85
42,7,393,6,69,"sendsig@97-166@sys/arch/arm64/arm64/sig_machdep.c","sys/arch/arm64/arm64/sig_machdep.c","sendsig",97,166
33,7,278,3,50,"sys_sigreturn@180-230@sys/arch/arm64/arm64/sig_machdep.c","sys/arch/arm64/arm64/sig_machdep.c","sys_sigreturn",180,230
11,2,64,1,11,"softintr_init@61-72@sys/arch/arm64/arm64/softintr.c","sys/arch/arm64/arm64/softintr.c","softintr_init",61,72
22,3,131,1,24,"softintr_dispatch@80-104@sys/arch/arm64/arm64/softintr.c","sys/arch/arm64/arm64/softintr.c","softintr_dispatch",80,104
7,1,32,1,7,"softintr_biglock_wrap@108-115@sys/arch/arm64/arm64/softintr.c","sys/arch/arm64/arm64/softintr.c","softintr_biglock_wrap",108,115
35,9,174,4,44,"softintr_establish_flags@124-168@sys/arch/arm64/arm64/softintr.c","sys/arch/arm64/arm64/softintr.c","softintr_establish_flags",124,168
12,2,75,1,13,"softintr_disestablish@176-189@sys/arch/arm64/arm64/softintr.c","sys/arch/arm64/arm64/softintr.c","softintr_disestablish",176,189
4,1,20,1,4,"softintr@192-196@sys/arch/arm64/arm64/softintr.c","sys/arch/arm64/arm64/softintr.c","softintr",192,196
12,1,53,3,15,"sys_sysarch@56-71@sys/arch/arm64/arm64/sys_machdep.c","sys/arch/arm64/arm64/sys_machdep.c","sys_sysarch",56,71
63,11,395,1,84,"svc_handler@36-120@sys/arch/arm64/arm64/syscall.c","sys/arch/arm64/arm64/syscall.c","svc_handler",36,120
10,1,59,1,11,"child_return@123-134@sys/arch/arm64/arm64/syscall.c","sys/arch/arm64/arm64/syscall.c","child_return",123,134
27,6,207,2,33,"cpu_fetch_syscall_args@74-107@sys/arch/arm64/arm64/trap.c","sys/arch/arm64/arm64/trap.c","cpu_fetch_syscall_args",74,107
10,1,51,1,11,"svc_handler@112-123@sys/arch/arm64/arm64/trap.c","sys/arch/arm64/arm64/trap.c","svc_handler",112,123
64,15,373,4,90,"data_abort@129-219@sys/arch/arm64/arm64/trap.c","sys/arch/arm64/arm64/trap.c","data_abort",129,219
32,9,153,1,55,"do_el1h_sync@222-277@sys/arch/arm64/arm64/trap.c","sys/arch/arm64/arm64/trap.c","do_el1h_sync",222,277
45,8,224,1,52,"do_el0_sync@280-332@sys/arch/arm64/arm64/trap.c","sys/arch/arm64/arm64/trap.c","do_el0_sync",280,332
4,1,14,1,4,"do_el0_error@335-339@sys/arch/arm64/arm64/trap.c","sys/arch/arm64/arm64/trap.c","do_el0_error",335,339
12,2,59,1,11,"set_vfp_enable@27-38@sys/arch/arm64/arm64/vfp.c","sys/arch/arm64/arm64/vfp.c","set_vfp_enable",27,38
9,2,41,0,8,"get_vfp_enable@40-48@sys/arch/arm64/arm64/vfp.c","sys/arch/arm64/arm64/vfp.c","get_vfp_enable",40,48
7,2,24,1,11,"vfp_init@55-66@sys/arch/arm64/arm64/vfp.c","sys/arch/arm64/arm64/vfp.c","vfp_init",55,66
45,2,76,1,47,"vfp_store@69-116@sys/arch/arm64/arm64/vfp.c","sys/arch/arm64/arm64/vfp.c","vfp_store",69,116
23,9,138,1,40,"vfp_save@119-159@sys/arch/arm64/arm64/vfp.c","sys/arch/arm64/arm64/vfp.c","vfp_save",119,159
9,3,43,0,11,"vfp_enable@162-173@sys/arch/arm64/arm64/vfp.c","sys/arch/arm64/arm64/vfp.c","vfp_enable",162,173
51,1,125,1,66,"vfp_load@176-242@sys/arch/arm64/arm64/vfp.c","sys/arch/arm64/arm64/vfp.c","vfp_load",176,242
18,3,105,4,29,"vfp_fault@246-275@sys/arch/arm64/arm64/vfp.c","sys/arch/arm64/arm64/vfp.c","vfp_fault",246,275
8,3,46,1,7,"vfp_discard@278-285@sys/arch/arm64/arm64/vfp.c","sys/arch/arm64/arm64/vfp.c","vfp_discard",278,285
26,3,214,6,34,"cpu_fork@69-103@sys/arch/arm64/arm64/vm_machdep.c","sys/arch/arm64/arm64/vm_machdep.c","cpu_fork",69,103
7,2,36,1,8,"cpu_exit@112-120@sys/arch/arm64/arm64/vm_machdep.c","sys/arch/arm64/arm64/vm_machdep.c","cpu_exit",112,120
21,3,168,2,33,"vmapbuf@133-166@sys/arch/arm64/arm64/vm_machdep.c","sys/arch/arm64/arm64/vm_machdep.c","vmapbuf",133,166
14,2,111,2,14,"vunmapbuf@172-186@sys/arch/arm64/arm64/vm_machdep.c","sys/arch/arm64/arm64/vm_machdep.c","vunmapbuf",172,186
9,3,65,3,10,"agintc_match@194-204@sys/arch/arm64/dev/agintc.c","sys/arch/arm64/dev/agintc.c","agintc_match",194,204
4,1,12,1,3,"__isb@207-210@sys/arch/arm64/dev/agintc.c","sys/arch/arm64/dev/agintc.c","__isb",207,210
85,12,726,3,126,"agintc_attach@213-339@sys/arch/arm64/dev/agintc.c","sys/arch/arm64/dev/agintc.c","agintc_attach",213,339
46,10,361,1,54,"agintc_cpuinit@343-397@sys/arch/arm64/dev/agintc.c","sys/arch/arm64/dev/agintc.c","agintc_cpuinit",343,397
14,2,104,3,23,"agintc_set_priority@400-423@sys/arch/arm64/dev/agintc.c","sys/arch/arm64/dev/agintc.c","agintc_set_priority",400,423
14,2,80,1,23,"agintc_setipl@426-449@sys/arch/arm64/dev/agintc.c","sys/arch/arm64/dev/agintc.c","agintc_setipl",426,449
13,2,91,2,13,"agintc_intr_enable@452-465@sys/arch/arm64/dev/agintc.c","sys/arch/arm64/dev/agintc.c","agintc_intr_enable",452,465
12,2,92,2,12,"agintc_intr_disable@468-480@sys/arch/arm64/dev/agintc.c","sys/arch/arm64/dev/agintc.c","agintc_intr_disable",468,480
7,2,38,1,7,"agintc_calc_mask@483-490@sys/arch/arm64/dev/agintc.c","sys/arch/arm64/dev/agintc.c","agintc_calc_mask",483,490
28,8,191,2,36,"agintc_calc_irq@493-529@sys/arch/arm64/dev/agintc.c","sys/arch/arm64/dev/agintc.c","agintc_calc_irq",493,529
7,2,37,1,8,"agintc_splx@532-540@sys/arch/arm64/dev/agintc.c","sys/arch/arm64/dev/agintc.c","agintc_splx",532,540
7,1,33,1,7,"agintc_spllower@543-550@sys/arch/arm64/dev/agintc.c","sys/arch/arm64/dev/agintc.c","agintc_spllower",543,550
9,2,43,1,17,"agintc_splraise@553-570@sys/arch/arm64/dev/agintc.c","sys/arch/arm64/dev/agintc.c","agintc_splraise",553,570
7,1,33,1,7,"agintc_iack@573-580@sys/arch/arm64/dev/agintc.c","sys/arch/arm64/dev/agintc.c","agintc_iack",573,580
12,3,98,4,15,"agintc_route@583-598@sys/arch/arm64/dev/agintc.c","sys/arch/arm64/dev/agintc.c","agintc_route",583,598
44,9,236,1,55,"agintc_irq_handler@601-656@sys/arch/arm64/dev/agintc.c","sys/arch/arm64/dev/agintc.c","agintc_irq_handler",601,656
14,3,103,6,18,"agintc_intr_establish_fdt@659-677@sys/arch/arm64/dev/agintc.c","sys/arch/arm64/dev/agintc.c","agintc_intr_establish_fdt",659,677
24,5,181,5,33,"agintc_intr_establish@680-713@sys/arch/arm64/dev/agintc.c","sys/arch/arm64/dev/agintc.c","agintc_intr_establish",680,713
14,2,92,1,18,"agintc_intr_disestablish@716-734@sys/arch/arm64/dev/agintc.c","sys/arch/arm64/dev/agintc.c","agintc_intr_disestablish",716,734
5,1,27,1,4,"agintc_eoi@737-741@sys/arch/arm64/dev/agintc.c","sys/arch/arm64/dev/agintc.c","agintc_eoi",737,741
7,1,31,1,7,"agintc_r_ictlr@744-751@sys/arch/arm64/dev/agintc.c","sys/arch/arm64/dev/agintc.c","agintc_r_ictlr",744,751
10,4,62,1,11,"agintc_d_wait_rwp@754-765@sys/arch/arm64/dev/agintc.c","sys/arch/arm64/dev/agintc.c","agintc_d_wait_rwp",754,765
13,4,86,1,14,"agintc_r_wait_rwp@768-782@sys/arch/arm64/dev/agintc.c","sys/arch/arm64/dev/agintc.c","agintc_r_wait_rwp",768,782
5,1,40,2,5,"agintc_send_ipi@785-790@sys/arch/arm64/dev/agintc.c","sys/arch/arm64/dev/agintc.c","agintc_send_ipi",785,790
7,1,35,1,8,"agtimer_readcnt64@94-102@sys/arch/arm64/dev/agtimer.c","sys/arch/arm64/dev/agtimer.c","agtimer_readcnt64",94,102
6,1,25,1,7,"agtimer_get_freq@105-112@sys/arch/arm64/dev/agtimer.c","sys/arch/arm64/dev/agtimer.c","agtimer_get_freq",105,112
6,1,25,1,7,"agtimer_get_ctrl@115-122@sys/arch/arm64/dev/agtimer.c","sys/arch/arm64/dev/agtimer.c","agtimer_get_ctrl",115,122
6,1,34,1,6,"agtimer_set_ctrl@125-131@sys/arch/arm64/dev/agtimer.c","sys/arch/arm64/dev/agtimer.c","agtimer_set_ctrl",125,131
6,1,34,1,6,"agtimer_set_tval@134-140@sys/arch/arm64/dev/agtimer.c","sys/arch/arm64/dev/agtimer.c","agtimer_set_tval",134,140
6,2,50,3,6,"agtimer_match@143-149@sys/arch/arm64/dev/agtimer.c","sys/arch/arm64/dev/agtimer.c","agtimer_match",143,149
19,3,144,3,34,"agtimer_attach@152-186@sys/arch/arm64/dev/agtimer.c","sys/arch/arm64/dev/agtimer.c","agtimer_attach",152,186
4,1,14,1,3,"agtimer_get_timecount@189-192@sys/arch/arm64/dev/agtimer.c","sys/arch/arm64/dev/agtimer.c","agtimer_get_timecount",189,192
41,10,239,1,65,"agtimer_intr@195-260@sys/arch/arm64/dev/agtimer.c","sys/arch/arm64/dev/agtimer.c","agtimer_intr",195,260
11,2,56,1,13,"agtimer_set_clockrate@263-276@sys/arch/arm64/dev/agtimer.c","sys/arch/arm64/dev/agtimer.c","agtimer_set_clockrate",263,276
25,2,160,0,32,"agtimer_cpu_initclocks@279-311@sys/arch/arm64/dev/agtimer.c","sys/arch/arm64/dev/agtimer.c","agtimer_cpu_initclocks",279,311
26,7,146,1,28,"agtimer_delay@314-342@sys/arch/arm64/dev/agtimer.c","sys/arch/arm64/dev/agtimer.c","agtimer_delay",314,342
14,2,90,1,23,"agtimer_setstatclockrate@345-368@sys/arch/arm64/dev/agtimer.c","sys/arch/arm64/dev/agtimer.c","agtimer_setstatclockrate",345,368
14,1,88,1,15,"agtimer_startclock@371-386@sys/arch/arm64/dev/agtimer.c","sys/arch/arm64/dev/agtimer.c","agtimer_startclock",371,386
9,2,40,1,11,"agtimer_init@389-400@sys/arch/arm64/dev/agtimer.c","sys/arch/arm64/dev/agtimer.c","agtimer_init",389,400
9,3,65,3,10,"ampintc_match@207-217@sys/arch/arm64/dev/ampintc.c","sys/arch/arm64/dev/ampintc.c","ampintc_match",207,217
57,7,567,3,85,"ampintc_attach@220-305@sys/arch/arm64/dev/ampintc.c","sys/arch/arm64/dev/ampintc.c","ampintc_attach",220,305
7,1,49,2,13,"ampintc_set_priority@308-321@sys/arch/arm64/dev/ampintc.c","sys/arch/arm64/dev/ampintc.c","ampintc_set_priority",308,321
11,1,65,1,14,"ampintc_setipl@324-338@sys/arch/arm64/dev/ampintc.c","sys/arch/arm64/dev/ampintc.c","ampintc_setipl",324,338
8,2,58,1,11,"ampintc_intr_enable@341-352@sys/arch/arm64/dev/ampintc.c","sys/arch/arm64/dev/ampintc.c","ampintc_intr_enable",341,352
6,1,38,1,6,"ampintc_intr_disable@355-361@sys/arch/arm64/dev/ampintc.c","sys/arch/arm64/dev/ampintc.c","ampintc_intr_disable",355,361
12,2,84,2,14,"ampintc_intr_config@364-378@sys/arch/arm64/dev/ampintc.c","sys/arch/arm64/dev/ampintc.c","ampintc_intr_config",364,378
33,7,194,1,39,"ampintc_calc_mask@381-420@sys/arch/arm64/dev/ampintc.c","sys/arch/arm64/dev/ampintc.c","ampintc_calc_mask",381,420
7,2,37,1,8,"ampintc_splx@423-431@sys/arch/arm64/dev/ampintc.c","sys/arch/arm64/dev/ampintc.c","ampintc_splx",423,431
7,1,33,1,6,"ampintc_spllower@434-440@sys/arch/arm64/dev/ampintc.c","sys/arch/arm64/dev/ampintc.c","ampintc_spllower",434,440
10,2,45,1,19,"ampintc_splraise@443-462@sys/arch/arm64/dev/ampintc.c","sys/arch/arm64/dev/ampintc.c","ampintc_splraise",443,462
7,1,36,1,8,"ampintc_iack@466-474@sys/arch/arm64/dev/ampintc.c","sys/arch/arm64/dev/ampintc.c","ampintc_iack",466,474
5,1,29,1,5,"ampintc_eoi@477-482@sys/arch/arm64/dev/ampintc.c","sys/arch/arm64/dev/ampintc.c","ampintc_eoi",477,482
13,2,98,3,14,"ampintc_route@485-499@sys/arch/arm64/dev/ampintc.c","sys/arch/arm64/dev/ampintc.c","ampintc_route",485,499
37,9,200,1,49,"ampintc_irq_handler@502-551@sys/arch/arm64/dev/ampintc.c","sys/arch/arm64/dev/ampintc.c","ampintc_irq_handler",502,551
5,1,49,6,4,"ampintc_intr_establish_ext@554-558@sys/arch/arm64/dev/ampintc.c","sys/arch/arm64/dev/ampintc.c","ampintc_intr_establish_ext",554,558
19,4,133,6,25,"ampintc_intr_establish_fdt@561-586@sys/arch/arm64/dev/ampintc.c","sys/arch/arm64/dev/ampintc.c","ampintc_intr_establish_fdt",561,586
26,5,188,6,35,"ampintc_intr_establish@589-624@sys/arch/arm64/dev/ampintc.c","sys/arch/arm64/dev/ampintc.c","ampintc_intr_establish",589,624
15,3,105,1,21,"ampintc_intr_disestablish@627-648@sys/arch/arm64/dev/ampintc.c","sys/arch/arm64/dev/ampintc.c","ampintc_intr_disestablish",627,648
7,1,51,1,7,"ampintc_intr_string@651-658@sys/arch/arm64/dev/ampintc.c","sys/arch/arm64/dev/ampintc.c","ampintc_intr_string",651,658
5,1,34,3,5,"ampintc_msi_match@694-699@sys/arch/arm64/dev/ampintc.c","sys/arch/arm64/dev/ampintc.c","ampintc_msi_match",694,699
29,3,257,3,36,"ampintc_msi_attach@702-738@sys/arch/arm64/dev/ampintc.c","sys/arch/arm64/dev/ampintc.c","ampintc_msi_attach",702,738
20,4,157,7,23,"ampintc_intr_establish_msi@741-764@sys/arch/arm64/dev/ampintc.c","sys/arch/arm64/dev/ampintc.c","ampintc_intr_establish_msi",741,764
5,1,27,1,4,"ampintc_intr_disestablish_msi@767-771@sys/arch/arm64/dev/ampintc.c","sys/arch/arm64/dev/ampintc.c","ampintc_intr_disestablish_msi",767,771
4,1,26,3,3,"generic_space_read_1@86-89@sys/arch/arm64/dev/arm64_bus_space.c","sys/arch/arm64/dev/arm64_bus_space.c","generic_space_read_1",86,89
4,1,26,3,3,"generic_space_read_2@92-95@sys/arch/arm64/dev/arm64_bus_space.c","sys/arch/arm64/dev/arm64_bus_space.c","generic_space_read_2",92,95
4,1,26,3,3,"generic_space_read_4@98-101@sys/arch/arm64/dev/arm64_bus_space.c","sys/arch/arm64/dev/arm64_bus_space.c","generic_space_read_4",98,101
4,1,26,3,3,"generic_space_read_8@104-107@sys/arch/arm64/dev/arm64_bus_space.c","sys/arch/arm64/dev/arm64_bus_space.c","generic_space_read_8",104,107
5,1,30,4,4,"generic_space_write_1@110-114@sys/arch/arm64/dev/arm64_bus_space.c","sys/arch/arm64/dev/arm64_bus_space.c","generic_space_write_1",110,114
5,1,30,4,4,"generic_space_write_2@117-121@sys/arch/arm64/dev/arm64_bus_space.c","sys/arch/arm64/dev/arm64_bus_space.c","generic_space_write_2",117,121
5,1,30,4,4,"generic_space_write_4@124-128@sys/arch/arm64/dev/arm64_bus_space.c","sys/arch/arm64/dev/arm64_bus_space.c","generic_space_write_4",124,128
5,1,30,4,4,"generic_space_write_8@131-135@sys/arch/arm64/dev/arm64_bus_space.c","sys/arch/arm64/dev/arm64_bus_space.c","generic_space_write_8",131,135
10,2,64,5,9,"generic_space_read_raw_2@138-147@sys/arch/arm64/dev/arm64_bus_space.c","sys/arch/arm64/dev/arm64_bus_space.c","generic_space_read_raw_2",138,147
10,2,65,5,9,"generic_space_write_raw_2@150-159@sys/arch/arm64/dev/arm64_bus_space.c","sys/arch/arm64/dev/arm64_bus_space.c","generic_space_write_raw_2",150,159
10,2,64,5,9,"generic_space_read_raw_4@162-171@sys/arch/arm64/dev/arm64_bus_space.c","sys/arch/arm64/dev/arm64_bus_space.c","generic_space_read_raw_4",162,171
10,2,65,5,9,"generic_space_write_raw_4@174-183@sys/arch/arm64/dev/arm64_bus_space.c","sys/arch/arm64/dev/arm64_bus_space.c","generic_space_write_raw_4",174,183
10,2,64,5,9,"generic_space_read_raw_8@186-195@sys/arch/arm64/dev/arm64_bus_space.c","sys/arch/arm64/dev/arm64_bus_space.c","generic_space_read_raw_8",186,195
10,2,65,5,9,"generic_space_write_raw_8@198-207@sys/arch/arm64/dev/arm64_bus_space.c","sys/arch/arm64/dev/arm64_bus_space.c","generic_space_write_raw_8",198,207
19,4,149,5,23,"generic_space_map@210-233@sys/arch/arm64/dev/arm64_bus_space.c","sys/arch/arm64/dev/arm64_bus_space.c","generic_space_map",210,233
9,1,75,3,10,"generic_space_unmap@236-246@sys/arch/arm64/dev/arm64_bus_space.c","sys/arch/arm64/dev/arm64_bus_space.c","generic_space_unmap",236,246
6,1,30,5,5,"generic_space_region@249-254@sys/arch/arm64/dev/arm64_bus_space.c","sys/arch/arm64/dev/arm64_bus_space.c","generic_space_region",249,254
4,1,17,2,3,"generic_space_vaddr@257-260@sys/arch/arm64/dev/arm64_bus_space.c","sys/arch/arm64/dev/arm64_bus_space.c","generic_space_vaddr",257,260
4,1,30,3,3,"a4x_space_read_1@263-266@sys/arch/arm64/dev/arm64_bus_space.c","sys/arch/arm64/dev/arm64_bus_space.c","a4x_space_read_1",263,266
4,1,30,3,3,"a4x_space_read_2@269-272@sys/arch/arm64/dev/arm64_bus_space.c","sys/arch/arm64/dev/arm64_bus_space.c","a4x_space_read_2",269,272
4,1,30,3,3,"a4x_space_read_4@275-278@sys/arch/arm64/dev/arm64_bus_space.c","sys/arch/arm64/dev/arm64_bus_space.c","a4x_space_read_4",275,278
4,1,30,3,3,"a4x_space_read_8@281-284@sys/arch/arm64/dev/arm64_bus_space.c","sys/arch/arm64/dev/arm64_bus_space.c","a4x_space_read_8",281,284
5,1,34,4,4,"a4x_space_write_1@287-291@sys/arch/arm64/dev/arm64_bus_space.c","sys/arch/arm64/dev/arm64_bus_space.c","a4x_space_write_1",287,291
5,1,34,4,4,"a4x_space_write_2@294-298@sys/arch/arm64/dev/arm64_bus_space.c","sys/arch/arm64/dev/arm64_bus_space.c","a4x_space_write_2",294,298
5,1,34,4,4,"a4x_space_write_4@301-305@sys/arch/arm64/dev/arm64_bus_space.c","sys/arch/arm64/dev/arm64_bus_space.c","a4x_space_write_4",301,305
5,1,34,4,4,"a4x_space_write_8@308-312@sys/arch/arm64/dev/arm64_bus_space.c","sys/arch/arm64/dev/arm64_bus_space.c","a4x_space_write_8",308,312
10,2,68,5,9,"a4x_space_read_raw_2@315-324@sys/arch/arm64/dev/arm64_bus_space.c","sys/arch/arm64/dev/arm64_bus_space.c","a4x_space_read_raw_2",315,324
10,2,69,5,9,"a4x_space_write_raw_2@327-336@sys/arch/arm64/dev/arm64_bus_space.c","sys/arch/arm64/dev/arm64_bus_space.c","a4x_space_write_raw_2",327,336
10,2,68,5,9,"a4x_space_read_raw_4@339-348@sys/arch/arm64/dev/arm64_bus_space.c","sys/arch/arm64/dev/arm64_bus_space.c","a4x_space_read_raw_4",339,348
10,2,69,5,9,"a4x_space_write_raw_4@351-360@sys/arch/arm64/dev/arm64_bus_space.c","sys/arch/arm64/dev/arm64_bus_space.c","a4x_space_write_raw_4",351,360
10,2,68,5,9,"a4x_space_read_raw_8@363-372@sys/arch/arm64/dev/arm64_bus_space.c","sys/arch/arm64/dev/arm64_bus_space.c","a4x_space_read_raw_8",363,372
10,2,69,5,9,"a4x_space_write_raw_8@375-384@sys/arch/arm64/dev/arm64_bus_space.c","sys/arch/arm64/dev/arm64_bus_space.c","a4x_space_write_raw_8",375,384
6,2,50,3,6,"bcm_dwctwo_match@88-94@sys/arch/arm64/dev/bcm2835_dwctwo.c","sys/arch/arm64/dev/bcm2835_dwctwo.c","bcm_dwctwo_match",88,94
18,3,188,3,22,"bcm_dwctwo_attach@97-119@sys/arch/arm64/dev/bcm2835_dwctwo.c","sys/arch/arm64/dev/bcm2835_dwctwo.c","bcm_dwctwo_attach",97,119
12,2,88,1,14,"bcm_dwctwo_deferred@122-136@sys/arch/arm64/dev/bcm2835_dwctwo.c","sys/arch/arm64/dev/bcm2835_dwctwo.c","bcm_dwctwo_deferred",122,136
7,2,41,3,8,"bcm_intc_match@129-137@sys/arch/arm64/dev/bcm2836_intr.c","sys/arch/arm64/dev/bcm2836_intr.c","bcm_intc_match",129,137
56,9,472,3,81,"bcm_intc_attach@140-221@sys/arch/arm64/dev/bcm2836_intr.c","sys/arch/arm64/dev/bcm2836_intr.c","bcm_intc_attach",140,221
14,5,138,2,14,"bcm_intc_intr_enable@224-238@sys/arch/arm64/dev/bcm2836_intr.c","sys/arch/arm64/dev/bcm2836_intr.c","bcm_intc_intr_enable",224,238
14,5,138,2,14,"bcm_intc_intr_disable@241-255@sys/arch/arm64/dev/bcm2836_intr.c","sys/arch/arm64/dev/bcm2836_intr.c","bcm_intc_intr_disable",241,255
33,9,202,1,40,"bcm_intc_calc_mask@258-298@sys/arch/arm64/dev/bcm2836_intr.c","sys/arch/arm64/dev/bcm2836_intr.c","bcm_intc_calc_mask",258,298
7,2,37,1,8,"bcm_intc_splx@301-309@sys/arch/arm64/dev/bcm2836_intr.c","sys/arch/arm64/dev/bcm2836_intr.c","bcm_intc_splx",301,309
7,1,33,1,6,"bcm_intc_spllower@312-318@sys/arch/arm64/dev/bcm2836_intr.c","sys/arch/arm64/dev/bcm2836_intr.c","bcm_intc_spllower",312,318
10,2,45,1,19,"bcm_intc_splraise@321-340@sys/arch/arm64/dev/bcm2836_intr.c","sys/arch/arm64/dev/bcm2836_intr.c","bcm_intc_splraise",321,340
24,2,198,1,25,"bcm_intc_setipl@343-368@sys/arch/arm64/dev/bcm2836_intr.c","sys/arch/arm64/dev/bcm2836_intr.c","bcm_intc_setipl",343,368
52,18,312,1,57,"bcm_intc_get_next_irq@371-428@sys/arch/arm64/dev/bcm2836_intr.c","sys/arch/arm64/dev/bcm2836_intr.c","bcm_intc_get_next_irq",371,428
27,6,154,2,33,"bcm_intc_call_handler@431-464@sys/arch/arm64/dev/bcm2836_intr.c","sys/arch/arm64/dev/bcm2836_intr.c","bcm_intc_call_handler",431,464
6,2,35,1,6,"bcm_intc_irq_handler@467-473@sys/arch/arm64/dev/bcm2836_intr.c","sys/arch/arm64/dev/bcm2836_intr.c","bcm_intc_irq_handler",467,473
18,5,136,6,19,"bcm_intc_intr_establish_fdt@476-495@sys/arch/arm64/dev/bcm2836_intr.c","sys/arch/arm64/dev/bcm2836_intr.c","bcm_intc_intr_establish_fdt",476,495
7,1,59,6,7,"l1_intc_intr_establish_fdt@498-505@sys/arch/arm64/dev/bcm2836_intr.c","sys/arch/arm64/dev/bcm2836_intr.c","l1_intc_intr_establish_fdt",498,505
25,5,176,5,32,"bcm_intc_intr_establish@508-540@sys/arch/arm64/dev/bcm2836_intr.c","sys/arch/arm64/dev/bcm2836_intr.c","bcm_intc_intr_establish",508,540
13,2,85,1,13,"bcm_intc_intr_disestablish@543-556@sys/arch/arm64/dev/bcm2836_intr.c","sys/arch/arm64/dev/bcm2836_intr.c","bcm_intc_intr_disestablish",543,556
17,4,112,1,27,"com_fdt_init_cons@63-90@sys/arch/arm64/dev/com_fdt.c","sys/arch/arm64/dev/com_fdt.c","com_fdt_init_cons",63,90
8,4,63,3,8,"com_fdt_match@93-101@sys/arch/arm64/dev/com_fdt.c","sys/arch/arm64/dev/com_fdt.c","com_fdt_match",93,101
40,9,356,3,60,"com_fdt_attach@104-164@sys/arch/arm64/dev/com_fdt.c","sys/arch/arm64/dev/com_fdt.c","com_fdt_attach",104,164
6,1,34,1,7,"com_fdt_intr_designware@167-174@sys/arch/arm64/dev/com_fdt.c","sys/arch/arm64/dev/com_fdt.c","com_fdt_intr_designware",167,174
4,1,15,1,3,"com_fdt_cngetc@177-180@sys/arch/arm64/dev/com_fdt.c","sys/arch/arm64/dev/com_fdt.c","com_fdt_cngetc",177,180
4,1,19,2,3,"com_fdt_cnputc@183-186@sys/arch/arm64/dev/com_fdt.c","sys/arch/arm64/dev/com_fdt.c","com_fdt_cnputc",183,186
3,1,10,2,2,"com_fdt_cnpollc@189-191@sys/arch/arm64/dev/com_fdt.c","sys/arch/arm64/dev/com_fdt.c","com_fdt_cnpollc",189,191
4,1,22,3,3,"mainbus_match@87-90@sys/arch/arm64/dev/mainbus.c","sys/arch/arm64/dev/mainbus.c","mainbus_match",87,90
36,7,329,3,47,"mainbus_attach@96-143@sys/arch/arm64/dev/mainbus.c","sys/arch/arm64/dev/mainbus.c","mainbus_attach",96,143
51,11,481,3,59,"mainbus_attach_node@149-208@sys/arch/arm64/dev/mainbus.c","sys/arch/arm64/dev/mainbus.c","mainbus_attach_node",149,208
13,4,114,3,14,"mainbus_match_status@211-225@sys/arch/arm64/dev/mainbus.c","sys/arch/arm64/dev/mainbus.c","mainbus_match_status",211,225
16,3,124,2,19,"mainbus_attach_cpus@228-247@sys/arch/arm64/dev/mainbus.c","sys/arch/arm64/dev/mainbus.c","mainbus_attach_cpus",228,247
9,3,82,3,10,"mainbus_match_primary@250-260@sys/arch/arm64/dev/mainbus.c","sys/arch/arm64/dev/mainbus.c","mainbus_match_primary",250,260
9,3,82,3,10,"mainbus_match_secondary@263-273@sys/arch/arm64/dev/mainbus.c","sys/arch/arm64/dev/mainbus.c","mainbus_match_secondary",263,273
8,3,54,1,9,"mainbus_attach_framebuffer@276-285@sys/arch/arm64/dev/mainbus.c","sys/arch/arm64/dev/mainbus.c","mainbus_attach_framebuffer",276,285
5,1,34,3,5,"pciecam_match@118-123@sys/arch/arm64/dev/pciecam.c","sys/arch/arm64/dev/pciecam.c","pciecam_match",118,123
100,12,953,3,120,"pciecam_attach@126-246@sys/arch/arm64/dev/pciecam.c","sys/arch/arm64/dev/pciecam.c","pciecam_attach",126,246
4,1,19,3,3,"pciecam_attach_hook@249-252@sys/arch/arm64/dev/pciecam.c","sys/arch/arm64/dev/pciecam.c","pciecam_attach_hook",249,252
3,1,16,2,2,"pciecam_bus_maxdevs@255-257@sys/arch/arm64/dev/pciecam.c","sys/arch/arm64/dev/pciecam.c","pciecam_bus_maxdevs",255,257
4,1,39,4,3,"pciecam_make_tag@264-267@sys/arch/arm64/dev/pciecam.c","sys/arch/arm64/dev/pciecam.c","pciecam_make_tag",264,267
9,4,77,5,8,"pciecam_decompose_tag@270-278@sys/arch/arm64/dev/pciecam.c","sys/arch/arm64/dev/pciecam.c","pciecam_decompose_tag",270,278
4,1,14,2,3,"pciecam_conf_size@281-284@sys/arch/arm64/dev/pciecam.c","sys/arch/arm64/dev/pciecam.c","pciecam_conf_size",281,284
7,1,68,3,8,"pciecam_conf_read@287-295@sys/arch/arm64/dev/pciecam.c","sys/arch/arm64/dev/pciecam.c","pciecam_conf_read",287,295
7,1,72,4,8,"pciecam_conf_write@298-306@sys/arch/arm64/dev/pciecam.c","sys/arch/arm64/dev/pciecam.c","pciecam_conf_write",298,306
12,1,74,2,11,"pciecam_intr_map@316-327@sys/arch/arm64/dev/pciecam.c","sys/arch/arm64/dev/pciecam.c","pciecam_intr_map",316,327
16,2,108,2,18,"pciecam_intr_map_msi@330-348@sys/arch/arm64/dev/pciecam.c","sys/arch/arm64/dev/pciecam.c","pciecam_intr_map_msi",330,348
6,1,30,3,5,"pciecam_intr_map_msix@351-356@sys/arch/arm64/dev/pciecam.c","sys/arch/arm64/dev/pciecam.c","pciecam_intr_map_msix",351,356
7,2,35,2,8,"pciecam_intr_string@359-367@sys/arch/arm64/dev/pciecam.c","sys/arch/arm64/dev/pciecam.c","pciecam_intr_string",359,367
46,5,384,6,55,"pciecam_intr_establish@370-425@sys/arch/arm64/dev/pciecam.c","sys/arch/arm64/dev/pciecam.c","pciecam_intr_establish",370,425
3,1,12,2,3,"pciecam_intr_disestablish@428-431@sys/arch/arm64/dev/pciecam.c","sys/arch/arm64/dev/pciecam.c","pciecam_intr_disestablish",428,431
16,4,126,5,18,"pciecam_bs_map@437-455@sys/arch/arm64/dev/pciecam.c","sys/arch/arm64/dev/pciecam.c","pciecam_bs_map",437,455
10,3,57,1,11,"pluart_init_cons@205-216@sys/arch/arm64/dev/pluart.c","sys/arch/arm64/dev/pluart.c","pluart_init_cons",205,216
5,1,34,3,5,"pluartprobe@219-224@sys/arch/arm64/dev/pluart.c","sys/arch/arm64/dev/pluart.c","pluartprobe",219,224
36,7,315,3,45,"pluartattach@230-275@sys/arch/arm64/dev/pluart.c","sys/arch/arm64/dev/pluart.c","pluartattach",230,275
46,15,316,1,60,"pluart_intr@278-338@sys/arch/arm64/dev/pluart.c","sys/arch/arm64/dev/pluart.c","pluart_intr",278,338
39,12,217,2,73,"pluart_param@341-414@sys/arch/arm64/dev/pluart.c","sys/arch/arm64/dev/pluart.c","pluart_param",341,414
33,8,258,1,36,"pluart_start@417-453@sys/arch/arm64/dev/pluart.c","sys/arch/arm64/dev/pluart.c","pluart_start",417,453
3,1,9,1,2,"pluart_pwroff@456-458@sys/arch/arm64/dev/pluart.c","sys/arch/arm64/dev/pluart.c","pluart_pwroff",456,458
17,3,97,1,17,"pluart_diag@461-478@sys/arch/arm64/dev/pluart.c","sys/arch/arm64/dev/pluart.c","pluart_diag",461,478
3,1,8,1,6,"pluart_raisedtr@481-487@sys/arch/arm64/dev/pluart.c","sys/arch/arm64/dev/pluart.c","pluart_raisedtr",481,487
37,11,258,1,62,"pluart_softint@490-552@sys/arch/arm64/dev/pluart.c","sys/arch/arm64/dev/pluart.c","pluart_softint",490,552
105,23,779,4,137,"pluartopen@555-692@sys/arch/arm64/dev/pluart.c","sys/arch/arm64/dev/pluart.c","pluartopen",555,692
21,3,153,4,31,"pluartclose@695-726@sys/arch/arm64/dev/pluart.c","sys/arch/arm64/dev/pluart.c","pluartclose",695,726
8,2,58,3,9,"pluartread@729-738@sys/arch/arm64/dev/pluart.c","sys/arch/arm64/dev/pluart.c","pluartread",729,738
8,2,58,3,9,"pluartwrite@741-750@sys/arch/arm64/dev/pluart.c","sys/arch/arm64/dev/pluart.c","pluartwrite",741,750
46,16,217,5,51,"pluartioctl@753-804@sys/arch/arm64/dev/pluart.c","sys/arch/arm64/dev/pluart.c","pluartioctl",753,804
4,1,15,2,3,"pluartstop@807-810@sys/arch/arm64/dev/pluart.c","sys/arch/arm64/dev/pluart.c","pluartstop",807,810
12,3,61,1,11,"pluarttty@813-824@sys/arch/arm64/dev/pluart.c","sys/arch/arm64/dev/pluart.c","pluarttty",813,824
10,2,50,1,9,"pluart_sc@827-836@sys/arch/arm64/dev/pluart.c","sys/arch/arm64/dev/pluart.c","pluart_sc",827,836
5,1,26,1,4,"pluartcnprobe@841-845@sys/arch/arm64/dev/pluart.c","sys/arch/arm64/dev/pluart.c","pluartcnprobe",841,845
3,1,9,1,2,"pluartcninit@848-850@sys/arch/arm64/dev/pluart.c","sys/arch/arm64/dev/pluart.c","pluartcninit",848,850
18,2,116,4,23,"pluartcnattach@853-876@sys/arch/arm64/dev/pluart.c","sys/arch/arm64/dev/pluart.c","pluartcnattach",853,876
12,2,56,1,11,"pluartcngetc@879-890@sys/arch/arm64/dev/pluart.c","sys/arch/arm64/dev/pluart.c","pluartcngetc",879,890
10,2,56,2,9,"pluartcnputc@893-902@sys/arch/arm64/dev/pluart.c","sys/arch/arm64/dev/pluart.c","pluartcnputc",893,902
3,1,10,2,2,"pluartcnpollc@905-907@sys/arch/arm64/dev/pluart.c","sys/arch/arm64/dev/pluart.c","pluartcnpollc",905,907
9,3,64,3,11,"simplebus_match@51-62@sys/arch/arm64/dev/simplebus.c","sys/arch/arm64/dev/simplebus.c","simplebus_match",51,62
59,10,526,3,74,"simplebus_attach@65-139@sys/arch/arm64/dev/simplebus.c","sys/arch/arm64/dev/simplebus.c","simplebus_attach",65,139
8,2,69,3,8,"simplebus_submatch@142-150@sys/arch/arm64/dev/simplebus.c","sys/arch/arm64/dev/simplebus.c","simplebus_submatch",142,150
61,15,584,2,72,"simplebus_attach_node@156-228@sys/arch/arm64/dev/simplebus.c","sys/arch/arm64/dev/simplebus.c","simplebus_attach_node",156,228
36,10,320,5,48,"simplebus_bs_map@234-282@sys/arch/arm64/dev/simplebus.c","sys/arch/arm64/dev/simplebus.c","simplebus_bs_map",234,282
42,10,362,9,57,"simplebus_dmamap_load_buffer@285-342@sys/arch/arm64/dev/simplebus.c","sys/arch/arm64/dev/simplebus.c","simplebus_dmamap_load_buffer",285,342
13,1,53,2,13,"atomic_setbits_int@28-41@sys/arch/arm64/include/atomic.h","sys/arch/arm64/include/atomic.h","atomic_setbits_int",28,41
13,1,53,2,13,"atomic_clearbits_int@48-61@sys/arch/arm64/include/atomic.h","sys/arch/arm64/include/atomic.h","atomic_clearbits_int",48,61
8,2,63,6,8,"bus_space_copy_1@243-251@sys/arch/arm64/include/bus.h","sys/arch/arm64/include/bus.h","bus_space_copy_1",243,251
8,2,64,6,8,"bus_space_copy_2@255-263@sys/arch/arm64/include/bus.h","sys/arch/arm64/include/bus.h","bus_space_copy_2",255,263
8,2,64,6,8,"bus_space_copy_4@266-274@sys/arch/arm64/include/bus.h","sys/arch/arm64/include/bus.h","bus_space_copy_4",266,274
8,2,64,6,8,"bus_space_copy_8@277-285@sys/arch/arm64/include/bus.h","sys/arch/arm64/include/bus.h","bus_space_copy_8",277,285
5,1,28,5,4,"bus_space_barrier@297-301@sys/arch/arm64/include/bus.h","sys/arch/arm64/include/bus.h","bus_space_barrier",297,301
6,1,29,1,5,"curcpu@112-117@sys/arch/arm64/include/cpu.h","sys/arch/arm64/include/cpu.h","curcpu",112,117
6,1,22,0,6,"get_daif@204-210@sys/arch/arm64/include/cpu.h","sys/arch/arm64/include/cpu.h","get_daif",204,210
4,1,18,1,3,"restore_daif@213-216@sys/arch/arm64/include/cpu.h","sys/arch/arm64/include/cpu.h","restore_daif",213,216
4,1,11,0,3,"enable_irq_daif@219-222@sys/arch/arm64/include/cpu.h","sys/arch/arm64/include/cpu.h","enable_irq_daif",219,222
4,1,11,0,3,"disable_irq_daif@225-228@sys/arch/arm64/include/cpu.h","sys/arch/arm64/include/cpu.h","disable_irq_daif",225,228
7,1,28,0,6,"disable_irq_daif_ret@231-237@sys/arch/arm64/include/cpu.h","sys/arch/arm64/include/cpu.h","disable_irq_daif_ret",231,237
4,1,20,1,3,"__aarch64_set_tcb@27-30@sys/arch/arm64/include/tcb.h","sys/arch/arm64/include/tcb.h","__aarch64_set_tcb",27,30
6,1,24,1,5,"__aarch64_read_tcb@47-52@sys/arch/arm64/include/tcb.h","sys/arch/arm64/include/tcb.h","__aarch64_read_tcb",47,52
20,3,117,2,24,"efi_main@65-89@sys/arch/arm64/stand/efiboot/efiboot.c","sys/arch/arm64/stand/efiboot/efiboot.c","efi_main",65,89
5,1,26,1,4,"efi_cons_probe@95-99@sys/arch/arm64/stand/efiboot/efiboot.c","sys/arch/arm64/stand/efiboot/efiboot.c","efi_cons_probe",95,99
5,1,21,1,4,"efi_cons_init@102-106@sys/arch/arm64/stand/efiboot/efiboot.c","sys/arch/arm64/stand/efiboot/efiboot.c","efi_cons_init",102,106
23,8,129,1,34,"efi_cons_getc@109-143@sys/arch/arm64/stand/efiboot/efiboot.c","sys/arch/arm64/stand/efiboot/efiboot.c","efi_cons_getc",109,143
9,2,52,2,11,"efi_cons_putc@146-157@sys/arch/arm64/stand/efiboot/efiboot.c","sys/arch/arm64/stand/efiboot/efiboot.c","efi_cons_putc",146,157
8,2,41,1,8,"efi_heap_init@160-168@sys/arch/arm64/stand/efiboot/efiboot.c","sys/arch/arm64/stand/efiboot/efiboot.c","efi_heap_init",160,168
43,14,293,1,55,"efi_diskprobe@173-228@sys/arch/arm64/stand/efiboot/efiboot.c","sys/arch/arm64/stand/efiboot/efiboot.c","efi_diskprobe",173,228
9,3,58,2,10,"efi_device_path_depth@235-245@sys/arch/arm64/stand/efiboot/efiboot.c","sys/arch/arm64/stand/efiboot/efiboot.c","efi_device_path_depth",235,245
18,9,139,3,19,"efi_device_path_ncmp@248-267@sys/arch/arm64/stand/efiboot/efiboot.c","sys/arch/arm64/stand/efiboot/efiboot.c","efi_device_path_ncmp",248,267
72,19,534,1,85,"efi_framebuffer@270-355@sys/arch/arm64/stand/efiboot/efiboot.c","sys/arch/arm64/stand/efiboot/efiboot.c","efi_framebuffer",270,355
36,6,264,1,48,"efi_makebootargs@362-410@sys/arch/arm64/stand/efiboot/efiboot.c","sys/arch/arm64/stand/efiboot/efiboot.c","efi_makebootargs",362,410
20,2,125,1,23,"efi_updatefdt@413-436@sys/arch/arm64/stand/efiboot/efiboot.c","sys/arch/arm64/stand/efiboot/efiboot.c","efi_updatefdt",413,436
12,2,55,1,19,"machdep@441-460@sys/arch/arm64/stand/efiboot/efiboot.c","sys/arch/arm64/stand/efiboot/efiboot.c","machdep",441,460
15,4,73,1,17,"efi_cleanup@463-480@sys/arch/arm64/stand/efiboot/efiboot.c","sys/arch/arm64/stand/efiboot/efiboot.c","efi_cleanup",463,480
8,3,36,1,9,"_rtt@483-492@sys/arch/arm64/stand/efiboot/efiboot.c","sys/arch/arm64/stand/efiboot/efiboot.c","_rtt",483,492
4,1,14,2,3,"efi_timer@506-509@sys/arch/arm64/stand/efiboot/efiboot.c","sys/arch/arm64/stand/efiboot/efiboot.c","efi_timer",506,509
10,3,60,1,10,"efi_timer_init@512-522@sys/arch/arm64/stand/efiboot/efiboot.c","sys/arch/arm64/stand/efiboot/efiboot.c","efi_timer_init",512,522
4,1,13,1,3,"efi_timer_cleanup@525-528@sys/arch/arm64/stand/efiboot/efiboot.c","sys/arch/arm64/stand/efiboot/efiboot.c","efi_timer_cleanup",525,528
4,1,9,1,3,"getsecs@531-534@sys/arch/arm64/stand/efiboot/efiboot.c","sys/arch/arm64/stand/efiboot/efiboot.c","getsecs",531,534
4,1,20,2,3,"devboot@541-544@sys/arch/arm64/stand/efiboot/efiboot.c","sys/arch/arm64/stand/efiboot/efiboot.c","devboot",541,544
4,1,13,2,3,"cnspeed@547-550@sys/arch/arm64/stand/efiboot/efiboot.c","sys/arch/arm64/stand/efiboot/efiboot.c","cnspeed",547,550
4,1,10,1,3,"ttyname@553-556@sys/arch/arm64/stand/efiboot/efiboot.c","sys/arch/arm64/stand/efiboot/efiboot.c","ttyname",553,556
4,1,11,1,3,"ttydev@559-562@sys/arch/arm64/stand/efiboot/efiboot.c","sys/arch/arm64/stand/efiboot/efiboot.c","ttydev",559,562
42,15,321,5,59,"devparse@573-632@sys/arch/arm64/stand/efiboot/efiboot.c","sys/arch/arm64/stand/efiboot/efiboot.c","devparse",573,632
11,2,93,3,13,"devopen@635-648@sys/arch/arm64/stand/efiboot/efiboot.c","sys/arch/arm64/stand/efiboot/efiboot.c","devopen",635,648
24,3,140,1,25,"efi_memprobe_internal@651-676@sys/arch/arm64/stand/efiboot/efiboot.c","sys/arch/arm64/stand/efiboot/efiboot.c","efi_memprobe_internal",651,676
29,9,173,3,36,"efi_memprobe_find@684-720@sys/arch/arm64/stand/efiboot/efiboot.c","sys/arch/arm64/stand/efiboot/efiboot.c","efi_memprobe_find",684,720
7,2,33,1,6,"Xexit_efi@736-742@sys/arch/arm64/stand/efiboot/efiboot.c","sys/arch/arm64/stand/efiboot/efiboot.c","Xexit_efi",736,742
5,1,26,1,4,"Xpoweroff_efi@745-749@sys/arch/arm64/stand/efiboot/efiboot.c","sys/arch/arm64/stand/efiboot/efiboot.c","Xpoweroff_efi",745,749
32,7,195,5,37,"efid_io@58-95@sys/arch/arm64/stand/efiboot/efidev.c","sys/arch/arm64/stand/efiboot/efidev.c","efid_io",58,95
6,2,58,5,7,"efid_diskio@98-105@sys/arch/arm64/stand/efiboot/efidev.c","sys/arch/arm64/stand/efiboot/efidev.c","efid_diskio",98,105
34,9,251,1,50,"efi_getdisklabel@111-161@sys/arch/arm64/stand/efiboot/efidev.c","sys/arch/arm64/stand/efiboot/efidev.c","efi_getdisklabel",111,161
23,4,134,2,29,"efiopen@164-193@sys/arch/arm64/stand/efiboot/efidev.c","sys/arch/arm64/stand/efiboot/efidev.c","efiopen",164,193
16,3,119,6,19,"efistrategy@196-215@sys/arch/arm64/stand/efiboot/efidev.c","sys/arch/arm64/stand/efiboot/efidev.c","efistrategy",196,215
5,1,18,1,5,"eficlose@218-223@sys/arch/arm64/stand/efiboot/efidev.c","sys/arch/arm64/stand/efiboot/efidev.c","eficlose",218,223
4,1,19,3,3,"efiioctl@226-229@sys/arch/arm64/stand/efiboot/efidev.c","sys/arch/arm64/stand/efiboot/efidev.c","efiioctl",226,229
8,1,38,1,16,"cpu_get_dcache_line_size@43-59@sys/arch/arm64/stand/efiboot/exec.c","sys/arch/arm64/stand/efiboot/exec.c","cpu_get_dcache_line_size",43,59
11,2,71,2,17,"cpu_flush_dcache@62-79@sys/arch/arm64/stand/efiboot/exec.c","sys/arch/arm64/stand/efiboot/exec.c","cpu_flush_dcache",62,79
7,1,17,1,6,"cpu_inval_icache@82-88@sys/arch/arm64/stand/efiboot/exec.c","sys/arch/arm64/stand/efiboot/exec.c","cpu_inval_icache",82,88
28,6,208,2,36,"run_loadfile@91-127@sys/arch/arm64/stand/efiboot/exec.c","sys/arch/arm64/stand/efiboot/exec.c","run_loadfile",91,127
19,6,143,1,25,"fdt_check_head@39-64@sys/arch/arm64/stand/efiboot/fdt.c","sys/arch/arm64/stand/efiboot/fdt.c","fdt_check_head",39,64
21,4,186,1,25,"fdt_init@71-96@sys/arch/arm64/stand/efiboot/fdt.c","sys/arch/arm64/stand/efiboot/fdt.c","fdt_init",71,96
11,2,112,1,11,"fdt_finalize@99-110@sys/arch/arm64/stand/efiboot/fdt.c","sys/arch/arm64/stand/efiboot/fdt.c","fdt_finalize",99,110
8,3,42,1,9,"fdt_get_size@116-125@sys/arch/arm64/stand/efiboot/fdt.c","sys/arch/arm64/stand/efiboot/fdt.c","fdt_get_size",116,125
6,3,35,1,5,"fdt_get_str@131-136@sys/arch/arm64/stand/efiboot/fdt.c","sys/arch/arm64/stand/efiboot/fdt.c","fdt_get_str",131,136
15,3,127,1,16,"fdt_add_str@139-155@sys/arch/arm64/stand/efiboot/fdt.c","sys/arch/arm64/stand/efiboot/fdt.c","fdt_add_str",139,155
7,1,45,1,9,"skip_property@161-170@sys/arch/arm64/stand/efiboot/fdt.c","sys/arch/arm64/stand/efiboot/fdt.c","skip_property",161,170
7,2,30,1,6,"skip_props@173-179@sys/arch/arm64/stand/efiboot/fdt.c","sys/arch/arm64/stand/efiboot/fdt.c","skip_props",173,179
5,1,35,1,5,"skip_node_name@182-187@sys/arch/arm64/stand/efiboot/fdt.c","sys/arch/arm64/stand/efiboot/fdt.c","skip_node_name",182,187
22,5,142,3,26,"fdt_node_property@194-220@sys/arch/arm64/stand/efiboot/fdt.c","sys/arch/arm64/stand/efiboot/fdt.c","fdt_node_property",194,220
37,7,261,4,41,"fdt_node_set_property@223-264@sys/arch/arm64/stand/efiboot/fdt.c","sys/arch/arm64/stand/efiboot/fdt.c","fdt_node_set_property",223,264
23,6,203,4,28,"fdt_node_add_property@267-295@sys/arch/arm64/stand/efiboot/fdt.c","sys/arch/arm64/stand/efiboot/fdt.c","fdt_node_add_property",267,295
25,5,212,3,30,"fdt_node_add_node@298-328@sys/arch/arm64/stand/efiboot/fdt.c","sys/arch/arm64/stand/efiboot/fdt.c","fdt_node_add_node",298,328
10,2,55,1,14,"skip_node@335-349@sys/arch/arm64/stand/efiboot/fdt.c","sys/arch/arm64/stand/efiboot/fdt.c","skip_node",335,349
23,8,141,1,33,"fdt_next_node@357-390@sys/arch/arm64/stand/efiboot/fdt.c","sys/arch/arm64/stand/efiboot/fdt.c","fdt_next_node",357,390
11,4,92,4,13,"fdt_node_property_ints@397-410@sys/arch/arm64/stand/efiboot/fdt.c","sys/arch/arm64/stand/efiboot/fdt.c","fdt_node_property_ints",397,410
4,1,28,3,3,"fdt_node_property_int@416-419@sys/arch/arm64/stand/efiboot/fdt.c","sys/arch/arm64/stand/efiboot/fdt.c","fdt_node_property_int",416,419
13,4,71,1,18,"fdt_child_node@425-443@sys/arch/arm64/stand/efiboot/fdt.c","sys/arch/arm64/stand/efiboot/fdt.c","fdt_child_node",425,443
10,3,48,1,13,"fdt_node_name@449-462@sys/arch/arm64/stand/efiboot/fdt.c","sys/arch/arm64/stand/efiboot/fdt.c","fdt_node_name",449,462
29,9,155,1,35,"fdt_find_node@465-500@sys/arch/arm64/stand/efiboot/fdt.c","sys/arch/arm64/stand/efiboot/fdt.c","fdt_find_node",465,500
11,5,69,2,11,"fdt_parent_node_recurse@503-514@sys/arch/arm64/stand/efiboot/fdt.c","sys/arch/arm64/stand/efiboot/fdt.c","fdt_parent_node_recurse",503,514
9,3,42,1,11,"fdt_parent_node@517-528@sys/arch/arm64/stand/efiboot/fdt.c","sys/arch/arm64/stand/efiboot/fdt.c","fdt_parent_node",517,528
13,3,75,2,14,"fdt_node_is_compatible@531-545@sys/arch/arm64/stand/efiboot/fdt.c","sys/arch/arm64/stand/efiboot/fdt.c","fdt_node_is_compatible",531,545
37,14,295,2,46,"fdt_print_property@552-598@sys/arch/arm64/stand/efiboot/fdt.c","sys/arch/arm64/stand/efiboot/fdt.c","fdt_print_property",552,598
15,4,95,2,19,"fdt_print_node@601-620@sys/arch/arm64/stand/efiboot/fdt.c","sys/arch/arm64/stand/efiboot/fdt.c","fdt_print_node",601,620
7,2,49,2,7,"fdt_print_node_recurse@623-630@sys/arch/arm64/stand/efiboot/fdt.c","sys/arch/arm64/stand/efiboot/fdt.c","fdt_print_node_recurse",623,630
4,1,16,1,3,"fdt_print_tree@633-636@sys/arch/arm64/stand/efiboot/fdt.c","sys/arch/arm64/stand/efiboot/fdt.c","fdt_print_tree",633,636
6,2,27,1,5,"heap_init@24-29@sys/arch/arm64/stand/efiboot/heap.h","sys/arch/arm64/stand/efiboot/heap.h","heap_init",24,29
41,12,208,2,58,"self_reloc@68-126@sys/arch/arm64/stand/efiboot/self_reloc.c","sys/arch/arm64/stand/efiboot/self_reloc.c","self_reloc",68,126
8,2,60,3,10,"armv7_submatch@58-68@sys/arch/armv7/armv7/armv7.c","sys/arch/armv7/armv7/armv7.c","armv7_submatch",58,68
4,1,13,1,3,"armv7_set_devs@71-74@sys/arch/armv7/armv7/armv7.c","sys/arch/armv7/armv7/armv7.c","armv7_set_devs",71,74
11,5,76,2,13,"armv7_find_dev@77-90@sys/arch/armv7/armv7/armv7.c","sys/arch/armv7/armv7/armv7.c","armv7_find_dev",77,90
23,4,182,3,29,"armv7_attach@95-124@sys/arch/armv7/armv7/armv7.c","sys/arch/armv7/armv7/armv7.c","armv7_attach",95,124
37,10,180,1,57,"boot@233-290@sys/arch/armv7/armv7/armv7_machdep.c","sys/arch/armv7/armv7/armv7_machdep.c","boot",233,290
6,1,40,1,8,"read_ttb@294-302@sys/arch/armv7/armv7/armv7_machdep.c","sys/arch/armv7/armv7/armv7_machdep.c","read_ttb",294,302
19,3,136,5,26,"bootstrap_bs_map@314-340@sys/arch/armv7/armv7/armv7_machdep.c","sys/arch/armv7/armv7/armv7_machdep.c","bootstrap_bs_map",314,340
12,3,77,1,14,"copy_io_area_map@343-357@sys/arch/armv7/armv7/armv7_machdep.c","sys/arch/armv7/armv7/armv7_machdep.c","copy_io_area_map",343,357
200,36,1509,4,424,"initarm@372-796@sys/arch/armv7/armv7/armv7_machdep.c","sys/arch/armv7/armv7/armv7_machdep.c","initarm",372,796
46,13,203,1,60,"process_kernel_args@800-860@sys/arch/armv7/armv7/armv7_machdep.c","sys/arch/armv7/armv7/armv7_machdep.c","process_kernel_args",800,860
36,11,204,1,43,"fdt_find_cons@863-906@sys/arch/armv7/armv7/armv7_machdep.c","sys/arch/armv7/armv7/armv7_machdep.c","fdt_find_cons",863,906
8,2,28,1,10,"consinit@909-919@sys/arch/armv7/armv7/armv7_machdep.c","sys/arch/armv7/armv7/armv7_machdep.c","consinit",909,919
7,3,23,1,9,"board_startup@922-931@sys/arch/armv7/armv7/armv7_machdep.c","sys/arch/armv7/armv7/armv7_machdep.c","board_startup",922,931
3,1,13,2,2,"device_register@61-63@sys/arch/armv7/armv7/autoconf.c","sys/arch/armv7/armv7/autoconf.c","device_register",61,63
7,1,28,1,22,"cpu_configure@72-94@sys/arch/armv7/armv7/autoconf.c","sys/arch/armv7/armv7/autoconf.c","cpu_configure",72,94
20,5,107,1,34,"diskconf@102-136@sys/arch/armv7/armv7/autoconf.c","sys/arch/armv7/armv7/autoconf.c","diskconf",102,136
4,1,16,1,4,"arm_intr@64-68@sys/arch/armv7/armv7/intr.c","sys/arch/armv7/armv7/intr.c","arm_intr",64,68
4,1,13,1,3,"arm_dflt_intr@70-73@sys/arch/armv7/armv7/intr.c","sys/arch/armv7/armv7/intr.c","arm_dflt_intr",70,73
5,1,44,5,4,"arm_intr_establish@76-80@sys/arch/armv7/armv7/intr.c","sys/arch/armv7/armv7/intr.c","arm_intr_establish",76,80
4,1,15,1,3,"arm_intr_disestablish@81-84@sys/arch/armv7/armv7/intr.c","sys/arch/armv7/armv7/intr.c","arm_intr_disestablish",81,84
4,1,16,1,3,"arm_intr_string@85-88@sys/arch/armv7/armv7/intr.c","sys/arch/armv7/armv7/intr.c","arm_intr_string",85,88
9,3,42,1,10,"arm_intr_get_parent@94-104@sys/arch/armv7/armv7/intr.c","sys/arch/armv7/armv7/intr.c","arm_intr_get_parent",94,104
17,2,137,6,18,"arm_intr_prereg_establish_fdt@139-157@sys/arch/armv7/armv7/intr.c","sys/arch/armv7/armv7/intr.c","arm_intr_prereg_establish_fdt",139,157
10,4,75,1,12,"arm_intr_prereg_disestablish_fdt@160-172@sys/arch/armv7/armv7/intr.c","sys/arch/armv7/armv7/intr.c","arm_intr_prereg_disestablish_fdt",160,172
15,3,94,1,16,"arm_intr_init_fdt_recurse@175-191@sys/arch/armv7/armv7/intr.c","sys/arch/armv7/armv7/intr.c","arm_intr_init_fdt_recurse",175,191
6,2,23,1,6,"arm_intr_init_fdt@194-200@sys/arch/armv7/armv7/intr.c","sys/arch/armv7/armv7/intr.c","arm_intr_init_fdt",194,200
20,5,170,1,25,"arm_intr_register_fdt@206-231@sys/arch/armv7/armv7/intr.c","sys/arch/armv7/armv7/intr.c","arm_intr_register_fdt",206,231
5,1,44,5,4,"arm_intr_establish_fdt@239-243@sys/arch/armv7/armv7/intr.c","sys/arch/armv7/armv7/intr.c","arm_intr_establish_fdt",239,243
58,17,378,6,72,"arm_intr_establish_fdt_idx@246-318@sys/arch/armv7/armv7/intr.c","sys/arch/armv7/armv7/intr.c","arm_intr_establish_fdt_idx",246,318
7,1,46,1,7,"arm_intr_disestablish_fdt@321-328@sys/arch/armv7/armv7/intr.c","sys/arch/armv7/armv7/intr.c","arm_intr_disestablish_fdt",321,328
22,4,151,6,25,"arm_intr_parent_establish_fdt@336-361@sys/arch/armv7/armv7/intr.c","sys/arch/armv7/armv7/intr.c","arm_intr_parent_establish_fdt",336,361
7,1,46,1,7,"arm_intr_parent_disestablish_fdt@364-371@sys/arch/armv7/armv7/intr.c","sys/arch/armv7/armv7/intr.c","arm_intr_parent_disestablish_fdt",364,371
7,2,51,3,7,"arm_intr_route@374-381@sys/arch/armv7/armv7/intr.c","sys/arch/armv7/armv7/intr.c","arm_intr_route",374,381
10,2,44,1,13,"arm_dflt_splraise@384-397@sys/arch/armv7/armv7/intr.c","sys/arch/armv7/armv7/intr.c","arm_dflt_splraise",384,397
8,1,33,1,10,"arm_dflt_spllower@400-410@sys/arch/armv7/armv7/intr.c","sys/arch/armv7/armv7/intr.c","arm_dflt_spllower",400,410
7,2,38,1,7,"arm_dflt_splx@413-420@sys/arch/armv7/armv7/intr.c","sys/arch/armv7/armv7/intr.c","arm_dflt_splx",413,420
5,1,22,1,5,"arm_dflt_setipl@423-428@sys/arch/armv7/armv7/intr.c","sys/arch/armv7/armv7/intr.c","arm_dflt_setipl",423,428
5,1,33,5,4,"arm_dflt_intr_establish@430-434@sys/arch/armv7/armv7/intr.c","sys/arch/armv7/armv7/intr.c","arm_dflt_intr_establish",430,434
4,1,13,1,3,"arm_dflt_intr_disestablish@436-439@sys/arch/armv7/armv7/intr.c","sys/arch/armv7/armv7/intr.c","arm_dflt_intr_disestablish",436,439
4,1,13,1,3,"arm_dflt_intr_string@442-445@sys/arch/armv7/armv7/intr.c","sys/arch/armv7/armv7/intr.c","arm_dflt_intr_string",442,445
10,2,60,1,14,"arm_setsoftintr@448-462@sys/arch/armv7/armv7/intr.c","sys/arch/armv7/armv7/intr.c","arm_setsoftintr",448,462
14,2,81,1,27,"arm_do_pending_intr@465-492@sys/arch/armv7/armv7/intr.c","sys/arch/armv7/armv7/intr.c","arm_do_pending_intr",465,492
17,1,151,8,16,"arm_set_intr_handler@494-510@sys/arch/armv7/armv7/intr.c","sys/arch/armv7/armv7/intr.c","arm_set_intr_handler",494,510
19,7,111,1,20,"arm_init_smask@513-533@sys/arch/armv7/armv7/intr.c","sys/arch/armv7/armv7/intr.c","arm_init_smask",513,533
4,1,15,1,3,"splraise@541-544@sys/arch/armv7/armv7/intr.c","sys/arch/armv7/armv7/intr.c","splraise",541,544
4,1,15,1,3,"_spllower@548-551@sys/arch/armv7/armv7/intr.c","sys/arch/armv7/armv7/intr.c","_spllower",548,551
4,1,15,1,3,"spllower@553-556@sys/arch/armv7/armv7/intr.c","sys/arch/armv7/armv7/intr.c","spllower",553,556
4,1,14,1,3,"splx@559-562@sys/arch/armv7/armv7/intr.c","sys/arch/armv7/armv7/intr.c","splx",559,562
11,4,75,2,16,"arm_splassert_check@567-583@sys/arch/armv7/armv7/intr.c","sys/arch/armv7/armv7/intr.c","arm_splassert_check",567,583
10,2,72,4,10,"arm_clock_register@601-611@sys/arch/armv7/armv7/intr.c","sys/arch/armv7/armv7/intr.c","arm_clock_register",601,611
4,1,14,1,3,"delay@615-618@sys/arch/armv7/armv7/intr.c","sys/arch/armv7/armv7/intr.c","delay",615,618
6,2,25,1,6,"cpu_initclocks@621-627@sys/arch/armv7/armv7/intr.c","sys/arch/armv7/armv7/intr.c","cpu_initclocks",621,627
7,3,34,1,9,"arm_dflt_delay@630-639@sys/arch/armv7/armv7/intr.c","sys/arch/armv7/armv7/intr.c","arm_dflt_delay",630,639
43,11,234,1,54,"inittodr@650-704@sys/arch/armv7/armv7/intr.c","sys/arch/armv7/armv7/intr.c","inittodr",650,704
10,4,45,1,12,"resettodr@712-724@sys/arch/armv7/armv7/intr.c","sys/arch/armv7/armv7/intr.c","resettodr",712,724
7,2,29,1,6,"setstatclockrate@727-733@sys/arch/armv7/armv7/intr.c","sys/arch/armv7/armv7/intr.c","setstatclockrate",727,733
16,5,76,1,19,"platform_init@52-71@sys/arch/armv7/armv7/platform.c","sys/arch/armv7/armv7/platform.c","platform_init",52,71
8,3,54,5,7,"platform_smc_write@74-81@sys/arch/armv7/armv7/platform.c","sys/arch/armv7/armv7/platform.c","platform_smc_write",74,81
11,3,40,1,10,"platform_init_cons@84-94@sys/arch/armv7/armv7/platform.c","sys/arch/armv7/armv7/platform.c","platform_init_cons",84,94
7,3,32,1,6,"platform_init_mainbus@97-103@sys/arch/armv7/armv7/platform.c","sys/arch/armv7/armv7/platform.c","platform_init_mainbus",97,103
5,3,20,1,4,"platform_watchdog_reset@106-110@sys/arch/armv7/armv7/platform.c","sys/arch/armv7/armv7/platform.c","platform_watchdog_reset",106,110
5,3,20,1,4,"platform_powerdown@113-117@sys/arch/armv7/armv7/platform.c","sys/arch/armv7/armv7/platform.c","platform_powerdown",113,117
7,3,26,0,6,"platform_board_devs@120-126@sys/arch/armv7/armv7/platform.c","sys/arch/armv7/armv7/platform.c","platform_board_devs",120,126
6,2,50,3,6,"bcm_dwctwo_match@91-97@sys/arch/armv7/broadcom/bcm2835_dwctwo.c","sys/arch/armv7/broadcom/bcm2835_dwctwo.c","bcm_dwctwo_match",91,97
25,3,265,3,30,"bcm_dwctwo_attach@100-130@sys/arch/armv7/broadcom/bcm2835_dwctwo.c","sys/arch/armv7/broadcom/bcm2835_dwctwo.c","bcm_dwctwo_attach",100,130
12,2,88,1,14,"bcm_dwctwo_deferred@133-147@sys/arch/armv7/broadcom/bcm2835_dwctwo.c","sys/arch/armv7/broadcom/bcm2835_dwctwo.c","bcm_dwctwo_deferred",133,147
7,2,41,3,8,"bcm_intc_match@132-140@sys/arch/armv7/broadcom/bcm2836_intr.c","sys/arch/armv7/broadcom/bcm2836_intr.c","bcm_intc_match",132,140
58,9,479,3,83,"bcm_intc_attach@143-226@sys/arch/armv7/broadcom/bcm2836_intr.c","sys/arch/armv7/broadcom/bcm2836_intr.c","bcm_intc_attach",143,226
14,5,138,2,14,"bcm_intc_intr_enable@229-243@sys/arch/armv7/broadcom/bcm2836_intr.c","sys/arch/armv7/broadcom/bcm2836_intr.c","bcm_intc_intr_enable",229,243
14,5,138,2,14,"bcm_intc_intr_disable@246-260@sys/arch/armv7/broadcom/bcm2836_intr.c","sys/arch/armv7/broadcom/bcm2836_intr.c","bcm_intc_intr_disable",246,260
33,9,202,1,40,"bcm_intc_calc_mask@263-303@sys/arch/armv7/broadcom/bcm2836_intr.c","sys/arch/armv7/broadcom/bcm2836_intr.c","bcm_intc_calc_mask",263,303
7,2,37,1,8,"bcm_intc_splx@306-314@sys/arch/armv7/broadcom/bcm2836_intr.c","sys/arch/armv7/broadcom/bcm2836_intr.c","bcm_intc_splx",306,314
7,1,33,1,6,"bcm_intc_spllower@317-323@sys/arch/armv7/broadcom/bcm2836_intr.c","sys/arch/armv7/broadcom/bcm2836_intr.c","bcm_intc_spllower",317,323
10,2,45,1,19,"bcm_intc_splraise@326-345@sys/arch/armv7/broadcom/bcm2836_intr.c","sys/arch/armv7/broadcom/bcm2836_intr.c","bcm_intc_splraise",326,345
24,2,199,1,25,"bcm_intc_setipl@348-373@sys/arch/armv7/broadcom/bcm2836_intr.c","sys/arch/armv7/broadcom/bcm2836_intr.c","bcm_intc_setipl",348,373
52,18,312,1,57,"bcm_intc_get_next_irq@376-433@sys/arch/armv7/broadcom/bcm2836_intr.c","sys/arch/armv7/broadcom/bcm2836_intr.c","bcm_intc_get_next_irq",376,433
27,6,154,2,33,"bcm_intc_call_handler@436-469@sys/arch/armv7/broadcom/bcm2836_intr.c","sys/arch/armv7/broadcom/bcm2836_intr.c","bcm_intc_call_handler",436,469
6,2,35,1,6,"bcm_intc_irq_handler@472-478@sys/arch/armv7/broadcom/bcm2836_intr.c","sys/arch/armv7/broadcom/bcm2836_intr.c","bcm_intc_irq_handler",472,478
18,5,136,6,19,"bcm_intc_intr_establish_fdt@481-500@sys/arch/armv7/broadcom/bcm2836_intr.c","sys/arch/armv7/broadcom/bcm2836_intr.c","bcm_intc_intr_establish_fdt",481,500
7,1,59,6,7,"l1_intc_intr_establish_fdt@503-510@sys/arch/armv7/broadcom/bcm2836_intr.c","sys/arch/armv7/broadcom/bcm2836_intr.c","l1_intc_intr_establish_fdt",503,510
25,5,177,5,32,"bcm_intc_intr_establish@513-545@sys/arch/armv7/broadcom/bcm2836_intr.c","sys/arch/armv7/broadcom/bcm2836_intr.c","bcm_intc_intr_establish",513,545
13,2,86,1,12,"bcm_intc_intr_disestablish@548-560@sys/arch/armv7/broadcom/bcm2836_intr.c","sys/arch/armv7/broadcom/bcm2836_intr.c","bcm_intc_intr_disestablish",548,560
4,1,11,1,3,"bcm_intc_intr_string@563-566@sys/arch/armv7/broadcom/bcm2836_intr.c","sys/arch/armv7/broadcom/bcm2836_intr.c","bcm_intc_intr_string",563,566
18,4,116,1,28,"com_fdt_init_cons@67-95@sys/arch/armv7/dev/com_fdt.c","sys/arch/armv7/dev/com_fdt.c","com_fdt_init_cons",67,95
8,4,63,3,8,"com_fdt_match@98-106@sys/arch/armv7/dev/com_fdt.c","sys/arch/armv7/dev/com_fdt.c","com_fdt_match",98,106
39,9,344,3,59,"com_fdt_attach@109-168@sys/arch/armv7/dev/com_fdt.c","sys/arch/armv7/dev/com_fdt.c","com_fdt_attach",109,168
6,1,34,1,7,"com_fdt_intr_designware@171-178@sys/arch/armv7/dev/com_fdt.c","sys/arch/armv7/dev/com_fdt.c","com_fdt_intr_designware",171,178
4,1,15,1,3,"com_fdt_cngetc@181-184@sys/arch/armv7/dev/com_fdt.c","sys/arch/armv7/dev/com_fdt.c","com_fdt_cngetc",181,184
4,1,19,2,3,"com_fdt_cnputc@187-190@sys/arch/armv7/dev/com_fdt.c","sys/arch/armv7/dev/com_fdt.c","com_fdt_cnputc",187,190
3,1,10,2,2,"com_fdt_cnpollc@193-195@sys/arch/armv7/dev/com_fdt.c","sys/arch/armv7/dev/com_fdt.c","com_fdt_cnpollc",193,195
10,3,57,1,11,"pluart_init_cons@207-218@sys/arch/armv7/dev/pluart.c","sys/arch/armv7/dev/pluart.c","pluart_init_cons",207,218
5,1,34,3,5,"pluartprobe@221-226@sys/arch/armv7/dev/pluart.c","sys/arch/armv7/dev/pluart.c","pluartprobe",221,226
36,7,315,3,45,"pluartattach@232-277@sys/arch/armv7/dev/pluart.c","sys/arch/armv7/dev/pluart.c","pluartattach",232,277
46,15,316,1,60,"pluart_intr@280-340@sys/arch/armv7/dev/pluart.c","sys/arch/armv7/dev/pluart.c","pluart_intr",280,340
39,12,217,2,73,"pluart_param@343-416@sys/arch/armv7/dev/pluart.c","sys/arch/armv7/dev/pluart.c","pluart_param",343,416
33,8,258,1,36,"pluart_start@419-455@sys/arch/armv7/dev/pluart.c","sys/arch/armv7/dev/pluart.c","pluart_start",419,455
3,1,9,1,2,"pluart_pwroff@458-460@sys/arch/armv7/dev/pluart.c","sys/arch/armv7/dev/pluart.c","pluart_pwroff",458,460
17,3,97,1,17,"pluart_diag@463-480@sys/arch/armv7/dev/pluart.c","sys/arch/armv7/dev/pluart.c","pluart_diag",463,480
3,1,8,1,6,"pluart_raisedtr@483-489@sys/arch/armv7/dev/pluart.c","sys/arch/armv7/dev/pluart.c","pluart_raisedtr",483,489
37,11,258,1,62,"pluart_softint@492-554@sys/arch/armv7/dev/pluart.c","sys/arch/armv7/dev/pluart.c","pluart_softint",492,554
105,23,779,4,137,"pluartopen@557-694@sys/arch/armv7/dev/pluart.c","sys/arch/armv7/dev/pluart.c","pluartopen",557,694
21,3,153,4,31,"pluartclose@697-728@sys/arch/armv7/dev/pluart.c","sys/arch/armv7/dev/pluart.c","pluartclose",697,728
8,2,58,3,9,"pluartread@731-740@sys/arch/armv7/dev/pluart.c","sys/arch/armv7/dev/pluart.c","pluartread",731,740
8,2,58,3,9,"pluartwrite@743-752@sys/arch/armv7/dev/pluart.c","sys/arch/armv7/dev/pluart.c","pluartwrite",743,752
46,16,217,5,51,"pluartioctl@755-806@sys/arch/armv7/dev/pluart.c","sys/arch/armv7/dev/pluart.c","pluartioctl",755,806
4,1,15,2,3,"pluartstop@809-812@sys/arch/armv7/dev/pluart.c","sys/arch/armv7/dev/pluart.c","pluartstop",809,812
12,3,61,1,11,"pluarttty@815-826@sys/arch/armv7/dev/pluart.c","sys/arch/armv7/dev/pluart.c","pluarttty",815,826
10,2,50,1,9,"pluart_sc@829-838@sys/arch/armv7/dev/pluart.c","sys/arch/armv7/dev/pluart.c","pluart_sc",829,838
5,1,26,1,4,"pluartcnprobe@843-847@sys/arch/armv7/dev/pluart.c","sys/arch/armv7/dev/pluart.c","pluartcnprobe",843,847
3,1,9,1,2,"pluartcninit@850-852@sys/arch/armv7/dev/pluart.c","sys/arch/armv7/dev/pluart.c","pluartcninit",850,852
18,2,116,4,23,"pluartcnattach@855-878@sys/arch/armv7/dev/pluart.c","sys/arch/armv7/dev/pluart.c","pluartcnattach",855,878
12,2,56,1,11,"pluartcngetc@881-892@sys/arch/armv7/dev/pluart.c","sys/arch/armv7/dev/pluart.c","pluartcngetc",881,892
10,2,56,2,9,"pluartcnputc@895-904@sys/arch/armv7/dev/pluart.c","sys/arch/armv7/dev/pluart.c","pluartcnputc",895,904
3,1,10,2,2,"pluartcnpollc@907-909@sys/arch/armv7/dev/pluart.c","sys/arch/armv7/dev/pluart.c","pluartcnpollc",907,909
7,2,43,3,7,"cros_ec_match@54-61@sys/arch/armv7/exynos/crosec.c","sys/arch/armv7/exynos/crosec.c","cros_ec_match",54,61
16,3,94,3,19,"cros_ec_attach@64-83@sys/arch/armv7/exynos/crosec.c","sys/arch/armv7/exynos/crosec.c","cros_ec_attach",64,83
14,2,83,1,16,"cros_ec_check_version@86-102@sys/arch/armv7/exynos/crosec.c","sys/arch/armv7/exynos/crosec.c","cros_ec_check_version",86,102
62,9,426,7,73,"cros_ec_i2c_command@105-178@sys/arch/armv7/exynos/crosec.c","sys/arch/armv7/exynos/crosec.c","cros_ec_i2c_command",105,178
6,1,53,7,5,"cros_ec_send_command@181-186@sys/arch/armv7/exynos/crosec.c","sys/arch/armv7/exynos/crosec.c","cros_ec_send_command",181,186
15,4,94,7,16,"cros_ec_command@189-205@sys/arch/armv7/exynos/crosec.c","sys/arch/armv7/exynos/crosec.c","cros_ec_command",189,205
25,5,167,7,36,"cros_ec_command_inptr@208-244@sys/arch/armv7/exynos/crosec.c","sys/arch/armv7/exynos/crosec.c","cros_ec_command_inptr",208,244
7,2,44,2,7,"cros_ec_calc_checksum@247-254@sys/arch/armv7/exynos/crosec.c","sys/arch/armv7/exynos/crosec.c","cros_ec_calc_checksum",247,254
7,2,44,3,7,"cros_ec_scan_keyboard@257-264@sys/arch/armv7/exynos/crosec.c","sys/arch/armv7/exynos/crosec.c","cros_ec_scan_keyboard",257,264
7,2,50,2,7,"cros_ec_info@267-274@sys/arch/armv7/exynos/crosec.c","sys/arch/armv7/exynos/crosec.c","cros_ec_info",267,274
27,3,233,1,37,"cros_ec_init_keyboard@121-158@sys/arch/armv7/exynos/crosec_kbd.c","sys/arch/armv7/exynos/crosec_kbd.c","cros_ec_init_keyboard",121,158
6,1,48,1,5,"cros_ec_add_task@161-166@sys/arch/armv7/exynos/crosec_kbd.c","sys/arch/armv7/exynos/crosec_kbd.c","cros_ec_add_task",161,166
5,1,25,1,4,"cros_ec_poll_keystate@169-173@sys/arch/armv7/exynos/crosec_kbd.c","sys/arch/armv7/exynos/crosec_kbd.c","cros_ec_poll_keystate",169,173
29,10,270,1,31,"cros_ec_get_keystate@176-207@sys/arch/armv7/exynos/crosec_kbd.c","sys/arch/armv7/exynos/crosec_kbd.c","cros_ec_get_keystate",176,207
12,3,84,3,13,"cros_ec_keyboard_cngetc@210-223@sys/arch/armv7/exynos/crosec_kbd.c","sys/arch/armv7/exynos/crosec_kbd.c","cros_ec_keyboard_cngetc",210,223
3,1,11,2,2,"cros_ec_keyboard_cnpollc@226-228@sys/arch/armv7/exynos/crosec_kbd.c","sys/arch/armv7/exynos/crosec_kbd.c","cros_ec_keyboard_cnpollc",226,228
4,1,14,2,3,"cros_ec_keyboard_enable@231-234@sys/arch/armv7/exynos/crosec_kbd.c","sys/arch/armv7/exynos/crosec_kbd.c","cros_ec_keyboard_enable",231,234
3,1,11,2,2,"cros_ec_keyboard_set_leds@237-239@sys/arch/armv7/exynos/crosec_kbd.c","sys/arch/armv7/exynos/crosec_kbd.c","cros_ec_keyboard_set_leds",237,239
18,7,98,5,26,"cros_ec_keyboard_ioctl@242-268@sys/arch/armv7/exynos/crosec_kbd.c","sys/arch/armv7/exynos/crosec_kbd.c","cros_ec_keyboard_ioctl",242,268
6,2,45,3,6,"exclock_match@115-121@sys/arch/armv7/exynos/exclock.c","sys/arch/armv7/exynos/exclock.c","exclock_match",115,121
25,3,195,3,33,"exclock_attach@124-157@sys/arch/armv7/exynos/exclock.c","sys/arch/armv7/exynos/exclock.c","exclock_attach",124,157
6,1,32,2,6,"exynos5250_get_frequency@164-170@sys/arch/armv7/exynos/exclock.c","sys/arch/armv7/exynos/exclock.c","exynos5250_get_frequency",164,170
6,1,36,3,6,"exynos5250_set_frequency@173-179@sys/arch/armv7/exynos/exclock.c","sys/arch/armv7/exynos/exclock.c","exynos5250_set_frequency",173,179
5,1,32,3,5,"exynos5250_enable@182-187@sys/arch/armv7/exynos/exclock.c","sys/arch/armv7/exynos/exclock.c","exynos5250_enable",182,187
62,10,435,2,63,"exynos5420_get_frequency@212-275@sys/arch/armv7/exynos/exclock.c","sys/arch/armv7/exynos/exclock.c","exynos5420_get_frequency",212,275
6,1,36,3,6,"exynos5420_set_frequency@278-284@sys/arch/armv7/exynos/exclock.c","sys/arch/armv7/exynos/exclock.c","exynos5420_set_frequency",278,284
10,3,46,3,12,"exynos5420_enable@287-299@sys/arch/armv7/exynos/exclock.c","sys/arch/armv7/exynos/exclock.c","exynos5420_enable",287,299
5,1,22,1,4,"exclock_cpuspeed@302-306@sys/arch/armv7/exynos/exclock.c","sys/arch/armv7/exynos/exclock.c","exclock_cpuspeed",302,306
28,6,194,3,45,"exclock_decode_pll_clk@309-354@sys/arch/armv7/exynos/exclock.c","sys/arch/armv7/exynos/exclock.c","exclock_decode_pll_clk",309,354
54,11,229,1,62,"exclock_get_pll_clk@357-419@sys/arch/armv7/exynos/exclock.c","sys/arch/armv7/exynos/exclock.c","exclock_get_pll_clk",357,419
11,1,77,1,15,"exclock_get_armclk@422-437@sys/arch/armv7/exynos/exclock.c","sys/arch/armv7/exynos/exclock.c","exclock_get_armclk",422,437
12,1,88,1,13,"exclock_get_i2cclk@440-453@sys/arch/armv7/exynos/exclock.c","sys/arch/armv7/exynos/exclock.c","exclock_get_i2cclk",440,453
7,3,41,3,10,"exdisplay_match@105-115@sys/arch/armv7/exynos/exdisplay.c","sys/arch/armv7/exynos/exdisplay.c","exdisplay_match",105,115
40,7,315,3,54,"exdisplay_attach@118-172@sys/arch/armv7/exynos/exdisplay.c","sys/arch/armv7/exynos/exdisplay.c","exdisplay_attach",118,172
12,2,102,3,17,"exdisplay_cnattach@175-192@sys/arch/armv7/exynos/exdisplay.c","sys/arch/armv7/exynos/exdisplay.c","exdisplay_cnattach",175,192
25,2,175,2,30,"exdisplay_setup_rasops@195-225@sys/arch/armv7/exynos/exdisplay.c","sys/arch/armv7/exynos/exdisplay.c","exdisplay_setup_rasops",195,225
4,1,28,5,3,"exdisplay_wsioctl@228-231@sys/arch/armv7/exynos/exdisplay.c","sys/arch/armv7/exynos/exdisplay.c","exdisplay_wsioctl",228,231
4,1,20,3,3,"exdisplay_wsmmap@234-237@sys/arch/armv7/exynos/exdisplay.c","sys/arch/armv7/exynos/exdisplay.c","exdisplay_wsmmap",234,237
7,1,60,6,7,"exdisplay_alloc_screen@240-247@sys/arch/armv7/exynos/exdisplay.c","sys/arch/armv7/exynos/exdisplay.c","exdisplay_alloc_screen",240,247
6,1,36,2,6,"exdisplay_free_screen@250-256@sys/arch/armv7/exynos/exdisplay.c","sys/arch/armv7/exynos/exdisplay.c","exdisplay_free_screen",250,256
5,1,38,5,4,"exdisplay_show_screen@259-263@sys/arch/armv7/exynos/exdisplay.c","sys/arch/armv7/exynos/exdisplay.c","exdisplay_show_screen",259,263
3,1,12,2,2,"exdisplay_doswitch@266-268@sys/arch/armv7/exynos/exdisplay.c","sys/arch/armv7/exynos/exdisplay.c","exdisplay_doswitch",266,268
6,1,47,4,6,"exdisplay_getchar@271-277@sys/arch/armv7/exynos/exdisplay.c","sys/arch/armv7/exynos/exdisplay.c","exdisplay_getchar",271,277
6,1,43,3,6,"exdisplay_load_font@280-286@sys/arch/armv7/exynos/exdisplay.c","sys/arch/armv7/exynos/exdisplay.c","exdisplay_load_font",280,286
6,1,37,2,6,"exdisplay_list_font@289-295@sys/arch/armv7/exynos/exdisplay.c","sys/arch/armv7/exynos/exdisplay.c","exdisplay_list_font",289,295
3,1,14,3,2,"exdisplay_burner@298-300@sys/arch/armv7/exynos/exdisplay.c","sys/arch/armv7/exynos/exdisplay.c","exdisplay_burner",298,300
6,2,45,3,6,"exdog_match@74-80@sys/arch/armv7/exynos/exdog.c","sys/arch/armv7/exynos/exdog.c","exdog_match",74,80
13,3,105,3,16,"exdog_attach@83-99@sys/arch/armv7/exynos/exdog.c","sys/arch/armv7/exynos/exdog.c","exdog_attach",83,99
9,2,57,1,12,"exdog_stop@102-114@sys/arch/armv7/exynos/exdog.c","sys/arch/armv7/exynos/exdog.c","exdog_stop",102,114
16,2,107,1,25,"exdog_reset@117-142@sys/arch/armv7/exynos/exdog.c","sys/arch/armv7/exynos/exdog.c","exdog_reset",117,142
5,1,34,3,5,"exdwusb_match@46-51@sys/arch/armv7/exynos/exdwusb.c","sys/arch/armv7/exynos/exdwusb.c","exdwusb_match",46,51
6,1,51,3,6,"exdwusb_attach@54-60@sys/arch/armv7/exynos/exdwusb.c","sys/arch/armv7/exynos/exdwusb.c","exdwusb_attach",54,60
5,1,34,3,5,"exehci_match@105-110@sys/arch/armv7/exynos/exehci.c","sys/arch/armv7/exynos/exehci.c","exehci_match",105,110
63,10,476,3,78,"exehci_attach@113-191@sys/arch/armv7/exynos/exehci.c","sys/arch/armv7/exynos/exehci.c","exehci_attach",113,191
17,4,108,2,20,"exehci_detach@194-214@sys/arch/armv7/exynos/exehci.c","sys/arch/armv7/exynos/exehci.c","exehci_detach",194,214
67,6,404,1,88,"exehci_setup@217-305@sys/arch/armv7/exynos/exehci.c","sys/arch/armv7/exynos/exehci.c","exehci_setup",217,305
5,1,34,3,5,"exgpio_match@135-140@sys/arch/armv7/exynos/exgpio.c","sys/arch/armv7/exynos/exgpio.c","exgpio_match",135,140
40,8,323,3,48,"exgpio_attach@143-191@sys/arch/armv7/exynos/exgpio.c","sys/arch/armv7/exynos/exgpio.c","exgpio_attach",143,191
9,3,64,2,10,"exgpio_bank@194-204@sys/arch/armv7/exynos/exgpio.c","sys/arch/armv7/exynos/exgpio.c","exgpio_bank",194,204
60,9,478,2,72,"exgpio_pinctrl@207-279@sys/arch/armv7/exynos/exgpio.c","sys/arch/armv7/exynos/exgpio.c","exgpio_pinctrl",207,279
14,3,118,3,15,"exgpio_config_pin@282-297@sys/arch/armv7/exynos/exgpio.c","sys/arch/armv7/exynos/exgpio.c","exgpio_config_pin",282,297
16,3,102,2,17,"exgpio_get_pin@300-317@sys/arch/armv7/exynos/exgpio.c","sys/arch/armv7/exynos/exgpio.c","exgpio_get_pin",300,317
17,4,119,3,18,"exgpio_set_pin@320-338@sys/arch/armv7/exynos/exgpio.c","sys/arch/armv7/exynos/exgpio.c","exgpio_set_pin",320,338
5,1,34,3,5,"exiic_match@115-120@sys/arch/armv7/exynos/exiic.c","sys/arch/armv7/exynos/exiic.c","exiic_match",115,120
26,3,238,3,34,"exiic_attach@123-157@sys/arch/armv7/exynos/exiic.c","sys/arch/armv7/exynos/exiic.c","exiic_attach",123,157
25,5,216,3,29,"exiic_scan@160-189@sys/arch/armv7/exynos/exiic.c","sys/arch/armv7/exynos/exiic.c","exiic_scan",160,189
13,5,112,2,19,"exiic_setspeed@192-211@sys/arch/armv7/exynos/exiic.c","sys/arch/armv7/exynos/exiic.c","exiic_setspeed",192,211
13,2,66,1,17,"exiic_intr@215-232@sys/arch/armv7/exynos/exiic.c","sys/arch/armv7/exynos/exiic.c","exiic_intr",215,232
18,3,95,3,20,"exiic_wait_intr@235-255@sys/arch/armv7/exynos/exiic.c","sys/arch/armv7/exynos/exiic.c","exiic_wait_intr",235,255
12,3,78,4,11,"exiic_wait_state@259-270@sys/arch/armv7/exynos/exiic.c","sys/arch/armv7/exynos/exiic.c","exiic_wait_state",259,270
13,2,77,2,17,"exiic_i2c_acquire_bus@273-290@sys/arch/armv7/exynos/exiic.c","sys/arch/armv7/exynos/exiic.c","exiic_i2c_acquire_bus",273,290
5,1,29,2,5,"exiic_i2c_release_bus@293-298@sys/arch/armv7/exynos/exiic.c","sys/arch/armv7/exynos/exiic.c","exiic_i2c_release_bus",293,298
69,21,446,8,89,"exiic_i2c_exec@301-390@sys/arch/armv7/exynos/exiic.c","sys/arch/armv7/exynos/exiic.c","exiic_i2c_exec",301,390
4,1,18,1,3,"exiic_xfer_start@393-396@sys/arch/armv7/exynos/exiic.c","sys/arch/armv7/exynos/exiic.c","exiic_xfer_start",393,396
9,3,43,1,8,"exiic_xfer_wait@399-407@sys/arch/armv7/exynos/exiic.c","sys/arch/armv7/exynos/exiic.c","exiic_xfer_wait",399,407
6,1,42,2,6,"exiic_detach@410-416@sys/arch/armv7/exynos/exiic.c","sys/arch/armv7/exynos/exiic.c","exiic_detach",410,416
5,1,34,3,5,"exmct_match@60-65@sys/arch/armv7/exynos/exmct.c","sys/arch/armv7/exynos/exmct.c","exmct_match",60,65
27,4,223,3,38,"exmct_attach@68-106@sys/arch/armv7/exynos/exmct.c","sys/arch/armv7/exynos/exmct.c","exmct_attach",68,106
6,2,45,3,6,"expower_match@57-63@sys/arch/armv7/exynos/expower.c","sys/arch/armv7/exynos/expower.c","expower_match",57,63
12,2,115,3,15,"expower_attach@66-81@sys/arch/armv7/exynos/expower.c","sys/arch/armv7/exynos/expower.c","expower_attach",66,81
5,1,34,3,5,"exsysreg_match@66-71@sys/arch/armv7/exynos/exsysreg.c","sys/arch/armv7/exynos/exsysreg.c","exsysreg_match",66,71
11,2,95,3,14,"exsysreg_attach@74-88@sys/arch/armv7/exynos/exsysreg.c","sys/arch/armv7/exynos/exsysreg.c","exsysreg_attach",74,88
9,2,42,1,9,"exsysreg_usbhost_mode@91-100@sys/arch/armv7/exynos/exsysreg.c","sys/arch/armv7/exynos/exsysreg.c","exsysreg_usbhost_mode",91,100
19,6,115,1,23,"exuart_init_cons@133-156@sys/arch/armv7/exynos/exuart.c","sys/arch/armv7/exynos/exuart.c","exuart_init_cons",133,156
5,1,34,3,5,"exuartprobe@159-164@sys/arch/armv7/exynos/exuart.c","sys/arch/armv7/exynos/exuart.c","exuartprobe",159,164
39,7,342,3,50,"exuartattach@170-220@sys/arch/armv7/exynos/exuart.c","sys/arch/armv7/exynos/exuart.c","exuartattach",170,220
60,20,424,1,84,"exuart_intr@223-307@sys/arch/armv7/exynos/exuart.c","sys/arch/armv7/exynos/exuart.c","exuart_intr",223,307
61,15,396,2,86,"exuart_param@310-396@sys/arch/armv7/exynos/exuart.c","sys/arch/armv7/exynos/exuart.c","exuart_param",310,396
39,11,285,1,48,"exuart_start@399-447@sys/arch/armv7/exynos/exuart.c","sys/arch/armv7/exynos/exuart.c","exuart_start",399,447
3,1,9,1,2,"exuart_pwroff@450-452@sys/arch/armv7/exynos/exuart.c","sys/arch/armv7/exynos/exuart.c","exuart_pwroff",450,452
17,3,97,1,17,"exuart_diag@455-472@sys/arch/armv7/exynos/exuart.c","sys/arch/armv7/exynos/exuart.c","exuart_diag",455,472
3,1,8,1,6,"exuart_raisedtr@475-481@sys/arch/armv7/exynos/exuart.c","sys/arch/armv7/exynos/exuart.c","exuart_raisedtr",475,481
50,17,330,1,66,"exuart_softint@484-550@sys/arch/armv7/exynos/exuart.c","sys/arch/armv7/exynos/exuart.c","exuart_softint",484,550
108,23,812,4,141,"exuartopen@553-694@sys/arch/armv7/exynos/exuart.c","sys/arch/armv7/exynos/exuart.c","exuartopen",553,694
21,3,153,4,30,"exuartclose@697-727@sys/arch/armv7/exynos/exuart.c","sys/arch/armv7/exynos/exuart.c","exuartclose",697,727
8,2,58,3,9,"exuartread@730-739@sys/arch/armv7/exynos/exuart.c","sys/arch/armv7/exynos/exuart.c","exuartread",730,739
8,2,58,3,9,"exuartwrite@742-751@sys/arch/armv7/exynos/exuart.c","sys/arch/armv7/exynos/exuart.c","exuartwrite",742,751
56,24,346,5,89,"exuartioctl@754-843@sys/arch/armv7/exynos/exuart.c","sys/arch/armv7/exynos/exuart.c","exuartioctl",754,843
4,1,15,2,3,"exuartstop@846-849@sys/arch/armv7/exynos/exuart.c","sys/arch/armv7/exynos/exuart.c","exuartstop",846,849
12,3,61,1,11,"exuarttty@852-863@sys/arch/armv7/exynos/exuart.c","sys/arch/armv7/exynos/exuart.c","exuarttty",852,863
10,2,50,1,9,"exuart_sc@866-875@sys/arch/armv7/exynos/exuart.c","sys/arch/armv7/exynos/exuart.c","exuart_sc",866,875
5,1,26,1,4,"exuartcnprobe@880-884@sys/arch/armv7/exynos/exuart.c","sys/arch/armv7/exynos/exuart.c","exuartcnprobe",880,884
3,1,9,1,2,"exuartcninit@887-889@sys/arch/armv7/exynos/exuart.c","sys/arch/armv7/exynos/exuart.c","exuartcninit",887,889
16,2,96,4,19,"exuartcnattach@892-911@sys/arch/armv7/exynos/exuart.c","sys/arch/armv7/exynos/exuart.c","exuartcnattach",892,911
14,3,75,1,13,"exuartcngetc@914-927@sys/arch/armv7/exynos/exuart.c","sys/arch/armv7/exynos/exuart.c","exuartcngetc",914,927
10,2,49,2,9,"exuartcnputc@930-939@sys/arch/armv7/exynos/exuart.c","sys/arch/armv7/exynos/exuart.c","exuartcnputc",930,939
3,1,10,2,2,"exuartcnpollc@942-944@sys/arch/armv7/exynos/exuart.c","sys/arch/armv7/exynos/exuart.c","exuartcnpollc",942,944
7,2,47,3,7,"tps65090_match@96-103@sys/arch/armv7/exynos/tps65090.c","sys/arch/armv7/exynos/tps65090.c","tps65090_match",96,103
9,1,62,3,10,"tps65090_attach@106-116@sys/arch/armv7/exynos/tps65090.c","sys/arch/armv7/exynos/tps65090.c","tps65090_attach",106,116
12,6,62,1,14,"tps65090_fet_enable@123-137@sys/arch/armv7/exynos/tps65090.c","sys/arch/armv7/exynos/tps65090.c","tps65090_fet_enable",123,137
6,3,26,1,6,"tps65090_fet_disable@140-146@sys/arch/armv7/exynos/tps65090.c","sys/arch/armv7/exynos/tps65090.c","tps65090_fet_disable",140,146
19,5,110,2,26,"tps65090_fet_set@149-175@sys/arch/armv7/exynos/tps65090.c","sys/arch/armv7/exynos/tps65090.c","tps65090_fet_set",149,175
6,1,32,1,5,"tps65090_fet_get@178-183@sys/arch/armv7/exynos/tps65090.c","sys/arch/armv7/exynos/tps65090.c","tps65090_fet_get",178,183
6,1,27,0,5,"tps65090_get_charging@186-191@sys/arch/armv7/exynos/tps65090.c","sys/arch/armv7/exynos/tps65090.c","tps65090_get_charging",186,191
10,2,46,1,9,"tps65090_set_charging@194-203@sys/arch/armv7/exynos/tps65090.c","sys/arch/armv7/exynos/tps65090.c","tps65090_set_charging",194,203
9,1,61,2,10,"tps65090_read_reg@206-216@sys/arch/armv7/exynos/tps65090.c","sys/arch/armv7/exynos/tps65090.c","tps65090_read_reg",206,216
7,1,58,3,6,"tps65090_write_reg@219-225@sys/arch/armv7/exynos/tps65090.c","sys/arch/armv7/exynos/tps65090.c","tps65090_write_reg",219,225
5,1,34,3,5,"fec_match@271-276@sys/arch/armv7/imx/if_fec.c","sys/arch/armv7/imx/if_fec.c","fec_match",271,276
118,12,950,3,168,"fec_attach@279-447@sys/arch/armv7/imx/if_fec.c","sys/arch/armv7/imx/if_fec.c","fec_attach",279,447
95,9,1180,2,113,"fec_phy_init@450-563@sys/arch/armv7/imx/if_fec.c","sys/arch/armv7/imx/if_fec.c","fec_phy_init",450,563
12,3,98,1,16,"fec_init_rxd@566-582@sys/arch/armv7/imx/if_fec.c","sys/arch/armv7/imx/if_fec.c","fec_init_rxd",566,582
10,2,76,1,12,"fec_init_txd@585-597@sys/arch/armv7/imx/if_fec.c","sys/arch/armv7/imx/if_fec.c","fec_init_txd",585,597
49,4,423,1,88,"fec_init@600-688@sys/arch/armv7/imx/if_fec.c","sys/arch/armv7/imx/if_fec.c","fec_init",600,688
10,2,70,1,16,"fec_stop@691-707@sys/arch/armv7/imx/if_fec.c","sys/arch/armv7/imx/if_fec.c","fec_stop",691,707
28,4,217,1,33,"fec_iff@710-743@sys/arch/armv7/imx/if_fec.c","sys/arch/armv7/imx/if_fec.c","fec_iff",710,743
38,11,210,3,44,"fec_ioctl@746-790@sys/arch/armv7/imx/if_fec.c","sys/arch/armv7/imx/if_fec.c","fec_ioctl",746,790
21,8,134,1,28,"fec_start@793-821@sys/arch/armv7/imx/if_fec.c","sys/arch/armv7/imx/if_fec.c","fec_start",793,821
30,5,262,2,44,"fec_encap@824-868@sys/arch/armv7/imx/if_fec.c","sys/arch/armv7/imx/if_fec.c","fec_encap",824,868
13,3,66,1,15,"fec_newbuf@871-886@sys/arch/armv7/imx/if_fec.c","sys/arch/armv7/imx/if_fec.c","fec_newbuf",871,886
15,5,97,1,25,"fec_intr@892-917@sys/arch/armv7/imx/if_fec.c","sys/arch/armv7/imx/if_fec.c","fec_intr",892,917
41,4,333,1,54,"fec_recv@920-974@sys/arch/armv7/imx/if_fec.c","sys/arch/armv7/imx/if_fec.c","fec_recv",920,974
9,1,47,1,10,"fec_tick@977-987@sys/arch/armv7/imx/if_fec.c","sys/arch/armv7/imx/if_fec.c","fec_tick",977,987
12,2,107,3,16,"fec_miibus_readreg@995-1011@sys/arch/armv7/imx/if_fec.c","sys/arch/armv7/imx/if_fec.c","fec_miibus_readreg",995,1011
11,2,91,4,14,"fec_miibus_writereg@1014-1028@sys/arch/armv7/imx/if_fec.c","sys/arch/armv7/imx/if_fec.c","fec_miibus_writereg",1014,1028
20,4,104,1,21,"fec_miibus_statchg@1031-1052@sys/arch/armv7/imx/if_fec.c","sys/arch/armv7/imx/if_fec.c","fec_miibus_statchg",1031,1052
13,2,72,1,13,"fec_ifmedia_upd@1055-1068@sys/arch/armv7/imx/if_fec.c","sys/arch/armv7/imx/if_fec.c","fec_ifmedia_upd",1055,1068
8,1,54,2,9,"fec_ifmedia_sts@1071-1080@sys/arch/armv7/imx/if_fec.c","sys/arch/armv7/imx/if_fec.c","fec_ifmedia_sts",1071,1080
50,5,336,3,56,"fec_dma_malloc@1086-1142@sys/arch/armv7/imx/if_fec.c","sys/arch/armv7/imx/if_fec.c","fec_dma_malloc",1086,1142
15,3,116,2,15,"fec_dma_free@1145-1160@sys/arch/armv7/imx/if_fec.c","sys/arch/armv7/imx/if_fec.c","fec_dma_free",1145,1160
5,1,34,3,5,"imxahci_match@103-108@sys/arch/armv7/imx/imxahci.c","sys/arch/armv7/imx/imxahci.c","imxahci_match",103,108
42,8,375,3,61,"imxahci_attach@111-172@sys/arch/armv7/imx/imxahci.c","sys/arch/armv7/imx/imxahci.c","imxahci_attach",111,172
8,1,59,2,8,"imxahci_detach@175-183@sys/arch/armv7/imx/imxahci.c","sys/arch/armv7/imx/imxahci.c","imxahci_detach",175,183
6,1,47,2,6,"imxahci_activate@186-192@sys/arch/armv7/imx/imxahci.c","sys/arch/armv7/imx/imxahci.c","imxahci_activate",186,192
7,2,41,3,8,"imxanatop_match@47-55@sys/arch/armv7/imx/imxanatop.c","sys/arch/armv7/imx/imxanatop.c","imxanatop_match",47,55
18,3,134,3,22,"imxanatop_attach@58-80@sys/arch/armv7/imx/imxanatop.c","sys/arch/armv7/imx/imxanatop.c","imxanatop_attach",58,80
8,4,63,3,8,"imxccm_match@255-263@sys/arch/armv7/imx/imxccm.c","sys/arch/armv7/imx/imxccm.c","imxccm_match",255,263
29,3,226,3,35,"imxccm_attach@266-301@sys/arch/armv7/imx/imxccm.c","sys/arch/armv7/imx/imxccm.c","imxccm_attach",266,301
5,1,22,1,4,"imxccm_cpuspeed@304-308@sys/arch/armv7/imx/imxccm.c","sys/arch/armv7/imx/imxccm.c","imxccm_cpuspeed",304,308
24,5,126,2,24,"imxccm_decode_pll@311-335@sys/arch/armv7/imx/imxccm.c","sys/arch/armv7/imx/imxccm.c","imxccm_decode_pll",311,335
6,1,37,1,6,"imxccm_get_pll2_pfd@338-344@sys/arch/armv7/imx/imxccm.c","sys/arch/armv7/imx/imxccm.c","imxccm_get_pll2_pfd",338,344
6,1,37,1,6,"imxccm_get_pll3_pfd@347-353@sys/arch/armv7/imx/imxccm.c","sys/arch/armv7/imx/imxccm.c","imxccm_get_pll3_pfd",347,353
11,3,57,1,12,"imxccm_get_armclk@356-368@sys/arch/armv7/imx/imxccm.c","sys/arch/armv7/imx/imxccm.c","imxccm_get_armclk",356,368
21,4,99,1,27,"imxccm_armclk_set_parent@371-398@sys/arch/armv7/imx/imxccm.c","sys/arch/armv7/imx/imxccm.c","imxccm_armclk_set_parent",371,398
6,3,25,1,5,"imxccm_armclk_set_freq@401-406@sys/arch/armv7/imx/imxccm.c","sys/arch/armv7/imx/imxccm.c","imxccm_armclk_set_freq",401,406
16,3,116,1,19,"imxccm_get_usdhx@409-428@sys/arch/armv7/imx/imxccm.c","sys/arch/armv7/imx/imxccm.c","imxccm_get_usdhx",409,428
7,1,39,1,8,"imxccm_get_uartclk@431-439@sys/arch/armv7/imx/imxccm.c","sys/arch/armv7/imx/imxccm.c","imxccm_get_uartclk",431,439
30,9,137,1,31,"imxccm_get_periphclk@442-473@sys/arch/armv7/imx/imxccm.c","sys/arch/armv7/imx/imxccm.c","imxccm_get_periphclk",442,473
21,5,72,1,22,"imxccm_get_fecclk@476-498@sys/arch/armv7/imx/imxccm.c","sys/arch/armv7/imx/imxccm.c","imxccm_get_fecclk",476,498
8,1,43,1,8,"imxccm_get_ahbclk@501-509@sys/arch/armv7/imx/imxccm.c","sys/arch/armv7/imx/imxccm.c","imxccm_get_ahbclk",501,509
8,1,43,1,8,"imxccm_get_ipgclk@512-520@sys/arch/armv7/imx/imxccm.c","sys/arch/armv7/imx/imxccm.c","imxccm_get_ipgclk",512,520
13,3,66,1,15,"imxccm_get_ipg_perclk@523-538@sys/arch/armv7/imx/imxccm.c","sys/arch/armv7/imx/imxccm.c","imxccm_get_ipg_perclk",523,538
18,5,134,3,22,"imxccm_enable@541-563@sys/arch/armv7/imx/imxccm.c","sys/arch/armv7/imx/imxccm.c","imxccm_enable",541,563
41,17,201,2,45,"imxccm_get_frequency@566-611@sys/arch/armv7/imx/imxccm.c","sys/arch/armv7/imx/imxccm.c","imxccm_get_frequency",566,611
10,3,68,1,14,"imxccm_enable_pll_enet@614-628@sys/arch/armv7/imx/imxccm.c","sys/arch/armv7/imx/imxccm.c","imxccm_enable_pll_enet",614,628
7,1,35,1,8,"imxccm_enable_enet@631-639@sys/arch/armv7/imx/imxccm.c","sys/arch/armv7/imx/imxccm.c","imxccm_enable_enet",631,639
7,1,35,1,8,"imxccm_enable_sata@642-650@sys/arch/armv7/imx/imxccm.c","sys/arch/armv7/imx/imxccm.c","imxccm_enable_sata",642,650
12,1,59,1,14,"imxccm_enable_pcie@653-667@sys/arch/armv7/imx/imxccm.c","sys/arch/armv7/imx/imxccm.c","imxccm_enable_pcie",653,667
7,1,24,1,7,"imxccm_disable_usb1_chrg_detect@670-677@sys/arch/armv7/imx/imxccm.c","sys/arch/armv7/imx/imxccm.c","imxccm_disable_usb1_chrg_detect",670,677
7,1,24,1,7,"imxccm_disable_usb2_chrg_detect@680-687@sys/arch/armv7/imx/imxccm.c","sys/arch/armv7/imx/imxccm.c","imxccm_disable_usb2_chrg_detect",680,687
9,1,35,1,10,"imxccm_enable_pll_usb1@690-700@sys/arch/armv7/imx/imxccm.c","sys/arch/armv7/imx/imxccm.c","imxccm_enable_pll_usb1",690,700
9,1,35,1,10,"imxccm_enable_pll_usb2@703-713@sys/arch/armv7/imx/imxccm.c","sys/arch/armv7/imx/imxccm.c","imxccm_enable_pll_usb2",703,713
5,1,34,3,5,"imxdog_match@66-71@sys/arch/armv7/imx/imxdog.c","sys/arch/armv7/imx/imxdog.c","imxdog_match",66,71
14,3,107,3,17,"imxdog_attach@74-91@sys/arch/armv7/imx/imxdog.c","sys/arch/armv7/imx/imxdog.c","imxdog_attach",74,91
11,2,94,1,18,"imxdog_reset@94-112@sys/arch/armv7/imx/imxdog.c","sys/arch/armv7/imx/imxdog.c","imxdog_reset",94,112
5,1,34,3,5,"imxehci_match@95-100@sys/arch/armv7/imx/imxehci.c","sys/arch/armv7/imx/imxehci.c","imxehci_match",95,100
132,19,1057,3,183,"imxehci_attach@103-286@sys/arch/armv7/imx/imxehci.c","sys/arch/armv7/imx/imxehci.c","imxehci_attach",103,286
17,4,112,2,20,"imxehci_detach@289-309@sys/arch/armv7/imx/imxehci.c","sys/arch/armv7/imx/imxehci.c","imxehci_detach",289,309
6,2,43,3,6,"imxesdhc_match@281-287@sys/arch/armv7/imx/imxesdhc.c","sys/arch/armv7/imx/imxesdhc.c","imxesdhc_match",281,287
116,24,822,3,157,"imxesdhc_attach@290-447@sys/arch/armv7/imx/imxesdhc.c","sys/arch/armv7/imx/imxesdhc.c","imxesdhc_attach",290,447
14,3,86,1,17,"imxesdhc_clock_enable@450-467@sys/arch/armv7/imx/imxesdhc.c","sys/arch/armv7/imx/imxesdhc.c","imxesdhc_clock_enable",450,467
28,7,169,1,35,"imxesdhc_pwrseq_pre@470-505@sys/arch/armv7/imx/imxesdhc.c","sys/arch/armv7/imx/imxesdhc.c","imxesdhc_pwrseq_pre",470,505
22,6,132,1,27,"imxesdhc_pwrseq_post@508-535@sys/arch/armv7/imx/imxesdhc.c","sys/arch/armv7/imx/imxesdhc.c","imxesdhc_pwrseq_post",508,535
33,2,197,1,53,"imxesdhc_host_reset@542-595@sys/arch/armv7/imx/imxesdhc.c","sys/arch/armv7/imx/imxesdhc.c","imxesdhc_host_reset",542,595
5,1,19,1,5,"imxesdhc_host_ocr@598-603@sys/arch/armv7/imx/imxesdhc.c","sys/arch/armv7/imx/imxesdhc.c","imxesdhc_host_ocr",598,603
5,1,19,1,5,"imxesdhc_host_maxblklen@606-611@sys/arch/armv7/imx/imxesdhc.c","sys/arch/armv7/imx/imxesdhc.c","imxesdhc_host_maxblklen",606,611
7,2,38,1,8,"imxesdhc_card_detect@617-625@sys/arch/armv7/imx/imxesdhc.c","sys/arch/armv7/imx/imxesdhc.c","imxesdhc_card_detect",617,625
20,10,137,2,25,"imxesdhc_bus_power@632-657@sys/arch/armv7/imx/imxesdhc.c","sys/arch/armv7/imx/imxesdhc.c","imxesdhc_bus_power",632,657
35,9,248,3,48,"imxesdhc_bus_clock@664-712@sys/arch/armv7/imx/imxesdhc.c","sys/arch/armv7/imx/imxesdhc.c","imxesdhc_bus_clock",664,712
17,6,99,2,21,"imxesdhc_bus_width@715-736@sys/arch/armv7/imx/imxesdhc.c","sys/arch/armv7/imx/imxesdhc.c","imxesdhc_bus_width",715,736
12,2,67,2,13,"imxesdhc_card_intr_mask@739-752@sys/arch/armv7/imx/imxesdhc.c","sys/arch/armv7/imx/imxesdhc.c","imxesdhc_card_intr_mask",739,752
6,1,28,1,7,"imxesdhc_card_intr_ack@755-762@sys/arch/armv7/imx/imxesdhc.c","sys/arch/armv7/imx/imxesdhc.c","imxesdhc_card_intr_ack",755,762
16,3,113,3,17,"imxesdhc_wait_state@765-782@sys/arch/armv7/imx/imxesdhc.c","sys/arch/armv7/imx/imxesdhc.c","imxesdhc_wait_state",765,782
38,10,292,2,62,"imxesdhc_exec_command@785-847@sys/arch/armv7/imx/imxesdhc.c","sys/arch/armv7/imx/imxesdhc.c","imxesdhc_exec_command",785,847
97,25,705,2,132,"imxesdhc_start_command@850-982@sys/arch/armv7/imx/imxesdhc.c","sys/arch/armv7/imx/imxesdhc.c","imxesdhc_start_command",850,982
58,13,321,2,70,"imxesdhc_transfer_data@985-1055@sys/arch/armv7/imx/imxesdhc.c","sys/arch/armv7/imx/imxesdhc.c","imxesdhc_transfer_data",985,1055
15,4,90,3,14,"imxesdhc_read_data@1058-1072@sys/arch/armv7/imx/imxesdhc.c","sys/arch/armv7/imx/imxesdhc.c","imxesdhc_read_data",1058,1072
18,5,129,3,17,"imxesdhc_write_data@1075-1092@sys/arch/armv7/imx/imxesdhc.c","sys/arch/armv7/imx/imxesdhc.c","imxesdhc_write_data",1075,1092
19,4,126,2,25,"imxesdhc_soft_reset@1096-1121@sys/arch/armv7/imx/imxesdhc.c","sys/arch/armv7/imx/imxesdhc.c","imxesdhc_soft_reset",1096,1121
30,5,171,3,36,"imxesdhc_wait_intr@1124-1160@sys/arch/armv7/imx/imxesdhc.c","sys/arch/armv7/imx/imxesdhc.c","imxesdhc_wait_intr",1124,1160
28,5,187,1,48,"imxesdhc_intr@1166-1214@sys/arch/armv7/imx/imxesdhc.c","sys/arch/armv7/imx/imxesdhc.c","imxesdhc_intr",1166,1214
5,1,34,3,5,"imxgpc_match@43-48@sys/arch/armv7/imx/imxgpc.c","sys/arch/armv7/imx/imxgpc.c","imxgpc_match",43,48
11,1,87,3,12,"imxgpc_attach@51-63@sys/arch/armv7/imx/imxgpc.c","sys/arch/armv7/imx/imxgpc.c","imxgpc_attach",51,63
5,1,34,3,5,"imxgpio_match@118-123@sys/arch/armv7/imx/imxgpio.c","sys/arch/armv7/imx/imxgpio.c","imxgpio_match",118,123
32,3,274,3,42,"imxgpio_attach@126-168@sys/arch/armv7/imx/imxgpio.c","sys/arch/armv7/imx/imxgpio.c","imxgpio_attach",126,168
14,3,94,3,15,"imxgpio_config_pin@171-186@sys/arch/armv7/imx/imxgpio.c","sys/arch/armv7/imx/imxgpio.c","imxgpio_config_pin",171,186
14,2,90,2,14,"imxgpio_get_pin@189-203@sys/arch/armv7/imx/imxgpio.c","sys/arch/armv7/imx/imxgpio.c","imxgpio_get_pin",189,203
15,3,105,3,15,"imxgpio_set_pin@206-221@sys/arch/armv7/imx/imxgpio.c","sys/arch/armv7/imx/imxgpio.c","imxgpio_set_pin",206,221
5,1,33,1,6,"imxgpio_get_bit@224-230@sys/arch/armv7/imx/imxgpio.c","sys/arch/armv7/imx/imxgpio.c","imxgpio_get_bit",224,230
5,1,32,1,5,"imxgpio_set_bit@233-238@sys/arch/armv7/imx/imxgpio.c","sys/arch/armv7/imx/imxgpio.c","imxgpio_set_bit",233,238
5,1,32,1,5,"imxgpio_clear_bit@241-246@sys/arch/armv7/imx/imxgpio.c","sys/arch/armv7/imx/imxgpio.c","imxgpio_clear_bit",241,246
5,1,38,2,5,"imxgpio_set_dir@248-253@sys/arch/armv7/imx/imxgpio.c","sys/arch/armv7/imx/imxgpio.c","imxgpio_set_dir",248,253
6,1,44,2,7,"imxgpio_v6_get_bit@256-263@sys/arch/armv7/imx/imxgpio.c","sys/arch/armv7/imx/imxgpio.c","imxgpio_v6_get_bit",256,263
7,1,56,2,8,"imxgpio_v6_set_bit@266-274@sys/arch/armv7/imx/imxgpio.c","sys/arch/armv7/imx/imxgpio.c","imxgpio_v6_set_bit",266,274
7,1,56,2,8,"imxgpio_v6_clear_bit@277-285@sys/arch/armv7/imx/imxgpio.c","sys/arch/armv7/imx/imxgpio.c","imxgpio_v6_clear_bit",277,285
13,2,93,3,15,"imxgpio_v6_set_dir@288-303@sys/arch/armv7/imx/imxgpio.c","sys/arch/armv7/imx/imxgpio.c","imxgpio_v6_set_dir",288,303
13,2,71,2,15,"imxgpio_v6_get_dir@306-321@sys/arch/armv7/imx/imxgpio.c","sys/arch/armv7/imx/imxgpio.c","imxgpio_v6_get_dir",306,321
23,4,166,1,29,"imxgpio_intr@324-353@sys/arch/armv7/imx/imxgpio.c","sys/arch/armv7/imx/imxgpio.c","imxgpio_intr",324,353
61,11,429,6,75,"imxgpio_intr_establish@356-431@sys/arch/armv7/imx/imxgpio.c","sys/arch/armv7/imx/imxgpio.c","imxgpio_intr_establish",356,431
19,3,147,1,26,"imxgpio_intr_disestablish@434-460@sys/arch/armv7/imx/imxgpio.c","sys/arch/armv7/imx/imxgpio.c","imxgpio_intr_disestablish",434,460
31,10,207,1,38,"imxgpio_recalc_ipl@463-501@sys/arch/armv7/imx/imxgpio.c","sys/arch/armv7/imx/imxgpio.c","imxgpio_recalc_ipl",463,501
5,1,34,3,5,"imxiic_match@103-108@sys/arch/armv7/imx/imxiic.c","sys/arch/armv7/imx/imxiic.c","imxiic_match",103,108
33,4,285,3,48,"imxiic_attach@111-159@sys/arch/armv7/imx/imxiic.c","sys/arch/armv7/imx/imxiic.c","imxiic_attach",111,159
18,5,130,2,20,"imxiic_setspeed@162-182@sys/arch/armv7/imx/imxiic.c","sys/arch/armv7/imx/imxiic.c","imxiic_setspeed",162,182
13,2,73,1,17,"imxiic_intr@186-203@sys/arch/armv7/imx/imxiic.c","sys/arch/armv7/imx/imxiic.c","imxiic_intr",186,203
18,3,95,3,20,"imxiic_wait_intr@206-226@sys/arch/armv7/imx/imxiic.c","sys/arch/armv7/imx/imxiic.c","imxiic_wait_intr",206,226
12,3,75,3,11,"imxiic_wait_state@230-241@sys/arch/armv7/imx/imxiic.c","sys/arch/armv7/imx/imxiic.c","imxiic_wait_state",230,241
28,8,231,4,35,"imxiic_read@244-279@sys/arch/armv7/imx/imxiic.c","sys/arch/armv7/imx/imxiic.c","imxiic_read",244,279
28,9,235,6,31,"imxiic_write@282-313@sys/arch/armv7/imx/imxiic.c","sys/arch/armv7/imx/imxiic.c","imxiic_write",282,313
11,1,70,2,20,"imxiic_i2c_acquire_bus@316-336@sys/arch/armv7/imx/imxiic.c","sys/arch/armv7/imx/imxiic.c","imxiic_i2c_acquire_bus",316,336
6,1,35,2,7,"imxiic_i2c_release_bus@339-346@sys/arch/armv7/imx/imxiic.c","sys/arch/armv7/imx/imxiic.c","imxiic_i2c_release_bus",339,346
29,7,199,8,37,"imxiic_i2c_exec@349-386@sys/arch/armv7/imx/imxiic.c","sys/arch/armv7/imx/imxiic.c","imxiic_i2c_exec",349,386
10,1,78,2,11,"imxiic_detach@389-400@sys/arch/armv7/imx/imxiic.c","sys/arch/armv7/imx/imxiic.c","imxiic_detach",389,400
25,5,216,3,29,"imxiic_scan@403-432@sys/arch/armv7/imx/imxiic.c","sys/arch/armv7/imx/imxiic.c","imxiic_scan",403,432
9,5,72,3,9,"imxiomuxc_match@134-143@sys/arch/armv7/imx/imxiomuxc.c","sys/arch/armv7/imx/imxiomuxc.c","imxiomuxc_match",134,143
13,2,115,3,15,"imxiomuxc_attach@146-161@sys/arch/armv7/imx/imxiomuxc.c","sys/arch/armv7/imx/imxiomuxc.c","imxiomuxc_attach",146,161
53,8,417,2,69,"imxiomuxc_pinctrl@164-233@sys/arch/armv7/imx/imxiomuxc.c","sys/arch/armv7/imx/imxiomuxc.c","imxiomuxc_pinctrl",164,233
13,1,91,1,14,"imxiomuxc_enable_sata@236-250@sys/arch/armv7/imx/imxiomuxc.c","sys/arch/armv7/imx/imxiomuxc.c","imxiomuxc_enable_sata",236,250
17,1,141,1,18,"imxiomuxc_enable_pcie@253-271@sys/arch/armv7/imx/imxiomuxc.c","sys/arch/armv7/imx/imxiomuxc.c","imxiomuxc_enable_pcie",253,271
9,2,74,1,10,"imxiomuxc_pcie_refclk@274-284@sys/arch/armv7/imx/imxiomuxc.c","sys/arch/armv7/imx/imxiomuxc.c","imxiomuxc_pcie_refclk",274,284
9,2,74,1,10,"imxiomuxc_pcie_test_powerdown@287-297@sys/arch/armv7/imx/imxiomuxc.c","sys/arch/armv7/imx/imxiomuxc.c","imxiomuxc_pcie_test_powerdown",287,297
5,1,34,3,5,"imxtemp_match@110-115@sys/arch/armv7/imx/imxtemp.c","sys/arch/armv7/imx/imxtemp.c","imxtemp_match",110,115
13,2,92,3,15,"imxtemp_attach@118-133@sys/arch/armv7/imx/imxtemp.c","sys/arch/armv7/imx/imxtemp.c","imxtemp_attach",118,133
28,2,210,1,30,"imxtemp_calibration@136-166@sys/arch/armv7/imx/imxtemp.c","sys/arch/armv7/imx/imxtemp.c","imxtemp_calibration",136,166
8,1,62,2,18,"imxtemp_calc_temp@169-187@sys/arch/armv7/imx/imxtemp.c","sys/arch/armv7/imx/imxtemp.c","imxtemp_calc_temp",169,187
8,1,56,1,12,"imxtemp_refresh_sensors@190-202@sys/arch/armv7/imx/imxtemp.c","sys/arch/armv7/imx/imxtemp.c","imxtemp_refresh_sensors",190,202
17,2,109,1,21,"imxtemp_pickup_sensors@205-226@sys/arch/armv7/imx/imxtemp.c","sys/arch/armv7/imx/imxtemp.c","imxtemp_pickup_sensors",205,226
10,3,57,1,11,"imxuart_init_cons@136-147@sys/arch/armv7/imx/imxuart.c","sys/arch/armv7/imx/imxuart.c","imxuart_init_cons",136,147
5,1,34,3,5,"imxuart_match@150-155@sys/arch/armv7/imx/imxuart.c","sys/arch/armv7/imx/imxuart.c","imxuart_match",150,155
30,7,259,3,39,"imxuart_attach@158-197@sys/arch/armv7/imx/imxuart.c","sys/arch/armv7/imx/imxuart.c","imxuart_attach",158,197
41,11,291,1,50,"imxuart_intr@200-250@sys/arch/armv7/imx/imxuart.c","sys/arch/armv7/imx/imxuart.c","imxuart_intr",200,250
47,13,284,2,71,"imxuart_param@253-324@sys/arch/armv7/imx/imxuart.c","sys/arch/armv7/imx/imxuart.c","imxuart_param",253,324
45,12,321,1,52,"imxuart_start@327-379@sys/arch/armv7/imx/imxuart.c","sys/arch/armv7/imx/imxuart.c","imxuart_start",327,379
3,1,9,1,2,"imxuart_pwroff@382-384@sys/arch/armv7/imx/imxuart.c","sys/arch/armv7/imx/imxuart.c","imxuart_pwroff",382,384
17,3,97,1,17,"imxuart_diag@387-404@sys/arch/armv7/imx/imxuart.c","sys/arch/armv7/imx/imxuart.c","imxuart_diag",387,404
6,1,41,1,6,"imxuart_raisedtr@407-413@sys/arch/armv7/imx/imxuart.c","sys/arch/armv7/imx/imxuart.c","imxuart_raisedtr",407,413
46,14,321,1,56,"imxuart_softint@416-472@sys/arch/armv7/imx/imxuart.c","sys/arch/armv7/imx/imxuart.c","imxuart_softint",416,472
105,22,781,4,135,"imxuartopen@475-610@sys/arch/armv7/imx/imxuart.c","sys/arch/armv7/imx/imxuart.c","imxuartopen",475,610
25,3,189,4,31,"imxuartclose@613-644@sys/arch/armv7/imx/imxuart.c","sys/arch/armv7/imx/imxuart.c","imxuartclose",613,644
8,2,58,3,9,"imxuartread@647-656@sys/arch/armv7/imx/imxuart.c","sys/arch/armv7/imx/imxuart.c","imxuartread",647,656
8,2,58,3,9,"imxuartwrite@659-668@sys/arch/armv7/imx/imxuart.c","sys/arch/armv7/imx/imxuart.c","imxuartwrite",659,668
56,24,346,5,89,"imxuartioctl@671-760@sys/arch/armv7/imx/imxuart.c","sys/arch/armv7/imx/imxuart.c","imxuartioctl",671,760
4,1,15,2,3,"imxuartstop@763-766@sys/arch/armv7/imx/imxuart.c","sys/arch/armv7/imx/imxuart.c","imxuartstop",763,766
12,3,61,1,11,"imxuarttty@769-780@sys/arch/armv7/imx/imxuart.c","sys/arch/armv7/imx/imxuart.c","imxuarttty",769,780
10,2,50,1,9,"imxuart_sc@783-792@sys/arch/armv7/imx/imxuart.c","sys/arch/armv7/imx/imxuart.c","imxuart_sc",783,792
5,1,26,1,4,"imxuartcnprobe@797-801@sys/arch/armv7/imx/imxuart.c","sys/arch/armv7/imx/imxuart.c","imxuartcnprobe",797,801
3,1,9,1,2,"imxuartcninit@804-806@sys/arch/armv7/imx/imxuart.c","sys/arch/armv7/imx/imxuart.c","imxuartcninit",804,806
16,2,96,4,27,"imxuartcnattach@809-836@sys/arch/armv7/imx/imxuart.c","sys/arch/armv7/imx/imxuart.c","imxuartcnattach",809,836
12,2,56,1,11,"imxuartcngetc@839-850@sys/arch/armv7/imx/imxuart.c","sys/arch/armv7/imx/imxuart.c","imxuartcngetc",839,850
10,2,56,2,9,"imxuartcnputc@853-862@sys/arch/armv7/imx/imxuart.c","sys/arch/armv7/imx/imxuart.c","imxuartcnputc",853,862
3,1,10,2,2,"imxuartcnpollc@865-867@sys/arch/armv7/imx/imxuart.c","sys/arch/armv7/imx/imxuart.c","imxuartcnpollc",865,867
5,1,34,3,5,"mvacc_match@94-99@sys/arch/armv7/marvell/mvacc.c","sys/arch/armv7/marvell/mvacc.c","mvacc_match",94,99
17,2,151,3,20,"mvacc_attach@104-124@sys/arch/armv7/marvell/mvacc.c","sys/arch/armv7/marvell/mvacc.c","mvacc_attach",104,124
27,7,169,2,29,"mvacc_get_frequency@127-156@sys/arch/armv7/marvell/mvacc.c","sys/arch/armv7/marvell/mvacc.c","mvacc_get_frequency",127,156
6,1,36,3,6,"mvagc_match@60-66@sys/arch/armv7/marvell/mvagc.c","sys/arch/armv7/marvell/mvagc.c","mvagc_match",60,66
16,2,141,3,18,"mvagc_attach@69-87@sys/arch/armv7/marvell/mvagc.c","sys/arch/armv7/marvell/mvagc.c","mvagc_attach",69,87
5,1,29,2,5,"mvagc_gen_get_frequency@95-100@sys/arch/armv7/marvell/mvagc.c","sys/arch/armv7/marvell/mvagc.c","mvagc_gen_get_frequency",95,100
11,3,71,3,12,"mvagc_enable@103-115@sys/arch/armv7/marvell/mvagc.c","sys/arch/armv7/marvell/mvagc.c","mvagc_enable",103,115
22,4,166,1,25,"mvahci_wininit@73-98@sys/arch/armv7/marvell/mvahci.c","sys/arch/armv7/marvell/mvahci.c","mvahci_wininit",73,98
5,1,34,3,5,"mvahci_match@101-106@sys/arch/armv7/marvell/mvahci.c","sys/arch/armv7/marvell/mvahci.c","mvahci_match",101,106
31,5,222,3,41,"mvahci_attach@109-150@sys/arch/armv7/marvell/mvahci.c","sys/arch/armv7/marvell/mvahci.c","mvahci_attach",109,150
7,1,49,2,7,"mvahci_detach@153-160@sys/arch/armv7/marvell/mvahci.c","sys/arch/armv7/marvell/mvahci.c","mvahci_detach",153,160
5,1,37,2,5,"mvahci_activate@163-168@sys/arch/armv7/marvell/mvahci.c","sys/arch/armv7/marvell/mvahci.c","mvahci_activate",163,168
9,4,59,3,10,"mvmbus_match@101-111@sys/arch/armv7/marvell/mvmbus.c","sys/arch/armv7/marvell/mvmbus.c","mvmbus_match",101,111
36,9,321,3,54,"mvmbus_attach@114-168@sys/arch/armv7/marvell/mvmbus.c","sys/arch/armv7/marvell/mvmbus.c","mvmbus_attach",114,168
37,8,292,2,48,"mvmbus_parse_ranges@171-219@sys/arch/armv7/marvell/mvmbus.c","sys/arch/armv7/marvell/mvmbus.c","mvmbus_parse_ranges",171,219
6,2,32,2,10,"mvmbus_window_is_free@222-232@sys/arch/armv7/marvell/mvmbus.c","sys/arch/armv7/marvell/mvmbus.c","mvmbus_window_is_free",222,232
22,7,160,6,26,"mvmbus_alloc_window@235-261@sys/arch/armv7/marvell/mvmbus.c","sys/arch/armv7/marvell/mvmbus.c","mvmbus_alloc_window",235,261
27,3,206,7,28,"mvmbus_setup_window@264-292@sys/arch/armv7/marvell/mvmbus.c","sys/arch/armv7/marvell/mvmbus.c","mvmbus_setup_window",264,292
15,2,123,2,17,"mvmbus_disable_window@295-312@sys/arch/armv7/marvell/mvmbus.c","sys/arch/armv7/marvell/mvmbus.c","mvmbus_disable_window",295,312
12,5,94,3,14,"mvmbus_window_conflicts@315-329@sys/arch/armv7/marvell/mvmbus.c","sys/arch/armv7/marvell/mvmbus.c","mvmbus_window_conflicts",315,329
21,4,159,1,26,"mvmbus_parse_dram_info@332-358@sys/arch/armv7/marvell/mvmbus.c","sys/arch/armv7/marvell/mvmbus.c","mvmbus_parse_dram_info",332,358
5,1,34,3,5,"mpic_match@93-98@sys/arch/armv7/marvell/mvmpic.c","sys/arch/armv7/marvell/mvmpic.c","mpic_match",93,98
36,4,372,3,50,"mpic_attach@101-151@sys/arch/armv7/marvell/mvmpic.c","sys/arch/armv7/marvell/mvmpic.c","mpic_attach",101,151
6,1,63,3,5,"mpic_set_priority@154-159@sys/arch/armv7/marvell/mvmpic.c","sys/arch/armv7/marvell/mvmpic.c","mpic_set_priority",154,159
5,1,42,2,4,"mpic_intr_enable@162-166@sys/arch/armv7/marvell/mvmpic.c","sys/arch/armv7/marvell/mvmpic.c","mpic_intr_enable",162,166
5,1,42,2,4,"mpic_intr_disable@169-173@sys/arch/armv7/marvell/mvmpic.c","sys/arch/armv7/marvell/mvmpic.c","mpic_intr_disable",169,173
26,9,163,1,32,"mpic_calc_mask@176-208@sys/arch/armv7/marvell/mvmpic.c","sys/arch/armv7/marvell/mvmpic.c","mpic_calc_mask",176,208
20,5,123,1,24,"mpic_intr@211-235@sys/arch/armv7/marvell/mvmpic.c","sys/arch/armv7/marvell/mvmpic.c","mpic_intr",211,235
31,6,231,6,41,"mpic_intr_establish@238-279@sys/arch/armv7/marvell/mvmpic.c","sys/arch/armv7/marvell/mvmpic.c","mpic_intr_establish",238,279
16,3,112,1,23,"mpic_intr_disestablish@282-305@sys/arch/armv7/marvell/mvmpic.c","sys/arch/armv7/marvell/mvmpic.c","mpic_intr_disestablish",282,305
19,4,141,1,22,"mvpxa_wininit@78-100@sys/arch/armv7/marvell/mvpxa.c","sys/arch/armv7/marvell/mvpxa.c","mvpxa_wininit",78,100
5,1,34,3,5,"mvpxa_match@104-109@sys/arch/armv7/marvell/mvpxa.c","sys/arch/armv7/marvell/mvpxa.c","mvpxa_match",104,109
52,7,469,3,66,"mvpxa_attach@112-178@sys/arch/armv7/marvell/mvpxa.c","sys/arch/armv7/marvell/mvpxa.c","mvpxa_attach",112,178
6,1,34,3,6,"mvsysctrl_match@64-70@sys/arch/armv7/marvell/mvsysctrl.c","sys/arch/armv7/marvell/mvsysctrl.c","mvsysctrl_match",64,70
12,2,99,3,14,"mvsysctrl_attach@73-87@sys/arch/armv7/marvell/mvsysctrl.c","sys/arch/armv7/marvell/mvsysctrl.c","mvsysctrl_attach",73,87
8,2,38,1,9,"mvsysctrl_reset@90-99@sys/arch/armv7/marvell/mvsysctrl.c","sys/arch/armv7/marvell/mvsysctrl.c","mvsysctrl_reset",90,99
19,4,144,1,22,"mvxhci_wininit@75-97@sys/arch/armv7/marvell/mvxhci.c","sys/arch/armv7/marvell/mvxhci.c","mvxhci_wininit",75,97
6,2,43,3,6,"mvxhci_match@100-106@sys/arch/armv7/marvell/mvxhci.c","sys/arch/armv7/marvell/mvxhci.c","mvxhci_match",100,106
48,6,403,3,64,"mvxhci_attach@109-173@sys/arch/armv7/marvell/mvxhci.c","sys/arch/armv7/marvell/mvxhci.c","mvxhci_attach",109,173
4,1,11,1,3,"am335x_init@104-107@sys/arch/armv7/omap/am335x.c","sys/arch/armv7/omap/am335x.c","am335x_init",104,107
18,6,82,2,17,"sitara_cm_padconf_set_gpioflags@303-320@sys/arch/armv7/omap/am335x_cm_padconf.c","sys/arch/armv7/omap/am335x_cm_padconf.c","sitara_cm_padconf_set_gpioflags",303,320
28,7,106,2,27,"sitara_cm_padconf_get_gpioflags@323-350@sys/arch/armv7/omap/am335x_cm_padconf.c","sys/arch/armv7/omap/am335x_cm_padconf.c","sitara_cm_padconf_get_gpioflags",323,350
6,1,46,3,6,"preg@130-136@sys/arch/armv7/omap/amdisplay.c","sys/arch/armv7/omap/amdisplay.c","preg",130,136
23,2,249,1,27,"dumpregs@139-166@sys/arch/armv7/omap/amdisplay.c","sys/arch/armv7/omap/amdisplay.c","dumpregs",139,166
5,1,34,3,4,"amdisplay_match@170-174@sys/arch/armv7/omap/amdisplay.c","sys/arch/armv7/omap/amdisplay.c","amdisplay_match",170,174
136,10,1119,3,193,"amdisplay_attach@177-370@sys/arch/armv7/omap/amdisplay.c","sys/arch/armv7/omap/amdisplay.c","amdisplay_attach",177,370
15,3,141,2,19,"amdisplay_detach@373-392@sys/arch/armv7/omap/amdisplay.c","sys/arch/armv7/omap/amdisplay.c","amdisplay_detach",373,392
45,10,416,1,49,"amdisplay_intr@395-444@sys/arch/armv7/omap/amdisplay.c","sys/arch/armv7/omap/amdisplay.c","amdisplay_intr",395,444
26,5,223,1,34,"amdisplay_setup_dma@447-481@sys/arch/armv7/omap/amdisplay.c","sys/arch/armv7/omap/amdisplay.c","amdisplay_setup_dma",447,481
42,3,392,1,59,"amdisplay_conf_crt_timings@484-543@sys/arch/armv7/omap/amdisplay.c","sys/arch/armv7/omap/amdisplay.c","amdisplay_conf_crt_timings",484,543
21,5,121,1,22,"amdisplay_calc_freq@546-568@sys/arch/armv7/omap/amdisplay.c","sys/arch/armv7/omap/amdisplay.c","amdisplay_calc_freq",546,568
43,10,204,5,44,"amdisplay_ioctl@571-615@sys/arch/armv7/omap/amdisplay.c","sys/arch/armv7/omap/amdisplay.c","amdisplay_ioctl",571,615
9,3,72,3,10,"amdisplay_mmap@618-628@sys/arch/armv7/omap/amdisplay.c","sys/arch/armv7/omap/amdisplay.c","amdisplay_mmap",618,628
5,1,44,6,4,"amdisplay_alloc_screen@631-635@sys/arch/armv7/omap/amdisplay.c","sys/arch/armv7/omap/amdisplay.c","amdisplay_alloc_screen",631,635
47,5,385,3,62,"dmtimer_attach@144-206@sys/arch/armv7/omap/dmtimer.c","sys/arch/armv7/omap/dmtimer.c","dmtimer_attach",144,206
44,8,331,1,59,"dmtimer_intr@226-285@sys/arch/armv7/omap/dmtimer.c","sys/arch/armv7/omap/dmtimer.c","dmtimer_intr",226,285
25,1,242,0,35,"dmtimer_cpu_initclocks@294-329@sys/arch/armv7/omap/dmtimer.c","sys/arch/armv7/omap/dmtimer.c","dmtimer_cpu_initclocks",294,329
6,2,40,1,5,"dmtimer_wait@332-337@sys/arch/armv7/omap/dmtimer.c","sys/arch/armv7/omap/dmtimer.c","dmtimer_wait",332,337
33,10,223,1,37,"dmtimer_delay@340-377@sys/arch/armv7/omap/dmtimer.c","sys/arch/armv7/omap/dmtimer.c","dmtimer_delay",340,377
14,2,90,1,23,"dmtimer_setstatclockrate@380-403@sys/arch/armv7/omap/dmtimer.c","sys/arch/armv7/omap/dmtimer.c","dmtimer_setstatclockrate",380,403
5,1,35,1,5,"dmtimer_get_timecount@407-412@sys/arch/armv7/omap/dmtimer.c","sys/arch/armv7/omap/dmtimer.c","dmtimer_get_timecount",407,412
5,1,34,3,5,"edma_match@96-101@sys/arch/armv7/omap/edma.c","sys/arch/armv7/omap/edma.c","edma_match",96,101
36,5,287,3,57,"edma_attach@104-161@sys/arch/armv7/omap/edma.c","sys/arch/armv7/omap/edma.c","edma_attach",104,161
24,7,207,1,30,"edma_comp_intr@164-194@sys/arch/armv7/omap/edma.c","sys/arch/armv7/omap/edma.c","edma_comp_intr",164,194
16,4,129,3,18,"edma_intr_dma_en@197-215@sys/arch/armv7/omap/edma.c","sys/arch/armv7/omap/edma.c","edma_intr_dma_en",197,215
12,4,80,1,13,"edma_intr_dma_dis@218-231@sys/arch/armv7/omap/edma.c","sys/arch/armv7/omap/edma.c","edma_intr_dma_dis",218,231
19,6,178,1,24,"edma_trig_xfer_man@234-258@sys/arch/armv7/omap/edma.c","sys/arch/armv7/omap/edma.c","edma_trig_xfer_man",234,258
21,6,206,1,21,"edma_trig_xfer_by_dev@261-282@sys/arch/armv7/omap/edma.c","sys/arch/armv7/omap/edma.c","edma_trig_xfer_by_dev",261,282
5,1,36,2,4,"edma_param_write@285-289@sys/arch/armv7/omap/edma.c","sys/arch/armv7/omap/edma.c","edma_param_write",285,289
5,1,36,2,4,"edma_param_read@292-296@sys/arch/armv7/omap/edma.c","sys/arch/armv7/omap/edma.c","edma_param_read",292,296
33,4,244,3,38,"gptimer_attach@140-178@sys/arch/armv7/omap/gptimer.c","sys/arch/armv7/omap/gptimer.c","gptimer_attach",140,178
52,11,298,1,74,"gptimer_intr@199-273@sys/arch/armv7/omap/gptimer.c","sys/arch/armv7/omap/gptimer.c","gptimer_intr",199,273
30,1,187,0,41,"gptimer_cpu_initclocks@282-323@sys/arch/armv7/omap/gptimer.c","sys/arch/armv7/omap/gptimer.c","gptimer_cpu_initclocks",282,323
5,2,21,1,4,"gptimer_wait@326-330@sys/arch/armv7/omap/gptimer.c","sys/arch/armv7/omap/gptimer.c","gptimer_wait",326,330
24,4,128,1,34,"microtime@334-368@sys/arch/armv7/omap/gptimer.c","sys/arch/armv7/omap/gptimer.c","microtime",334,368
32,10,192,1,36,"gptimer_delay@372-408@sys/arch/armv7/omap/gptimer.c","sys/arch/armv7/omap/gptimer.c","gptimer_delay",372,408
13,2,66,1,22,"gptimer_setstatclockrate@411-433@sys/arch/armv7/omap/gptimer.c","sys/arch/armv7/omap/gptimer.c","gptimer_setstatclockrate",411,433
4,1,19,1,3,"gptimer_get_timecount@437-440@sys/arch/armv7/omap/gptimer.c","sys/arch/armv7/omap/gptimer.c","gptimer_get_timecount",437,440
4,1,27,2,3,"cpsw_txdesc_adjust@208-211@sys/arch/armv7/omap/if_cpsw.c","sys/arch/armv7/omap/if_cpsw.c","cpsw_txdesc_adjust",208,211
4,1,27,2,3,"cpsw_rxdesc_adjust@214-217@sys/arch/armv7/omap/if_cpsw.c","sys/arch/armv7/omap/if_cpsw.c","cpsw_rxdesc_adjust",214,217
5,1,46,3,4,"cpsw_set_txdesc_next@220-224@sys/arch/armv7/omap/if_cpsw.c","sys/arch/armv7/omap/if_cpsw.c","cpsw_set_txdesc_next",220,224
5,1,46,3,4,"cpsw_set_rxdesc_next@227-231@sys/arch/armv7/omap/if_cpsw.c","sys/arch/armv7/omap/if_cpsw.c","cpsw_set_rxdesc_next",227,231
7,1,53,3,6,"cpsw_get_txdesc@234-240@sys/arch/armv7/omap/if_cpsw.c","sys/arch/armv7/omap/if_cpsw.c","cpsw_get_txdesc",234,240
7,1,53,3,6,"cpsw_set_txdesc@243-249@sys/arch/armv7/omap/if_cpsw.c","sys/arch/armv7/omap/if_cpsw.c","cpsw_set_txdesc",243,249
7,1,53,3,6,"cpsw_get_rxdesc@252-258@sys/arch/armv7/omap/if_cpsw.c","sys/arch/armv7/omap/if_cpsw.c","cpsw_get_rxdesc",252,258
7,1,53,3,6,"cpsw_set_rxdesc@261-267@sys/arch/armv7/omap/if_cpsw.c","sys/arch/armv7/omap/if_cpsw.c","cpsw_set_rxdesc",261,267
5,1,33,2,4,"cpsw_txdesc_paddr@270-274@sys/arch/armv7/omap/if_cpsw.c","sys/arch/armv7/omap/if_cpsw.c","cpsw_txdesc_paddr",270,274
5,1,33,2,4,"cpsw_rxdesc_paddr@277-281@sys/arch/armv7/omap/if_cpsw.c","sys/arch/armv7/omap/if_cpsw.c","cpsw_rxdesc_paddr",277,281
26,7,182,1,36,"cpsw_mdio_init@284-320@sys/arch/armv7/omap/if_cpsw.c","sys/arch/armv7/omap/if_cpsw.c","cpsw_mdio_init",284,320
5,1,34,3,5,"cpsw_match@323-328@sys/arch/armv7/omap/if_cpsw.c","sys/arch/armv7/omap/if_cpsw.c","cpsw_match",323,328
121,13,1004,3,150,"cpsw_attach@331-481@sys/arch/armv7/omap/if_cpsw.c","sys/arch/armv7/omap/if_cpsw.c","cpsw_attach",331,481
7,2,43,1,8,"cpsw_mediachange@484-492@sys/arch/armv7/omap/if_cpsw.c","sys/arch/armv7/omap/if_cpsw.c","cpsw_mediachange",484,492
9,2,65,2,9,"cpsw_mediastatus@495-504@sys/arch/armv7/omap/if_cpsw.c","sys/arch/armv7/omap/if_cpsw.c","cpsw_mediastatus",495,504
102,22,686,1,125,"cpsw_start@507-632@sys/arch/armv7/omap/if_cpsw.c","sys/arch/armv7/omap/if_cpsw.c","cpsw_start",507,632
37,10,197,3,41,"cpsw_ioctl@635-676@sys/arch/armv7/omap/if_cpsw.c","sys/arch/armv7/omap/if_cpsw.c","cpsw_ioctl",635,676
7,1,33,1,7,"cpsw_watchdog@679-686@sys/arch/armv7/omap/if_cpsw.c","sys/arch/armv7/omap/if_cpsw.c","cpsw_watchdog",679,686
10,3,68,2,10,"cpsw_mii_wait@689-699@sys/arch/armv7/omap/if_cpsw.c","sys/arch/armv7/omap/if_cpsw.c","cpsw_mii_wait",689,699
16,4,136,3,19,"cpsw_mii_readreg@702-721@sys/arch/armv7/omap/if_cpsw.c","sys/arch/armv7/omap/if_cpsw.c","cpsw_mii_readreg",702,721
16,4,163,4,21,"cpsw_mii_writereg@724-745@sys/arch/armv7/omap/if_cpsw.c","sys/arch/armv7/omap/if_cpsw.c","cpsw_mii_writereg",724,745
4,1,11,1,3,"cpsw_mii_statchg@748-751@sys/arch/armv7/omap/if_cpsw.c","sys/arch/armv7/omap/if_cpsw.c","cpsw_mii_statchg",748,751
39,5,309,2,53,"cpsw_new_rxbuf@754-807@sys/arch/armv7/omap/if_cpsw.c","sys/arch/armv7/omap/if_cpsw.c","cpsw_new_rxbuf",754,807
85,9,1105,1,140,"cpsw_init@810-950@sys/arch/armv7/omap/if_cpsw.c","sys/arch/armv7/omap/if_cpsw.c","cpsw_init",810,950
52,19,539,1,77,"cpsw_stop@953-1030@sys/arch/armv7/omap/if_cpsw.c","sys/arch/armv7/omap/if_cpsw.c","cpsw_stop",953,1030
6,1,34,1,8,"cpsw_rxthintr@1033-1041@sys/arch/armv7/omap/if_cpsw.c","sys/arch/armv7/omap/if_cpsw.c","cpsw_rxthintr",1033,1041
69,10,435,1,88,"cpsw_rxintr@1044-1132@sys/arch/armv7/omap/if_cpsw.c","sys/arch/armv7/omap/if_cpsw.c","cpsw_rxintr",1044,1132
9,1,47,1,10,"cpsw_tick@1135-1145@sys/arch/armv7/omap/if_cpsw.c","sys/arch/armv7/omap/if_cpsw.c","cpsw_tick",1135,1145
72,16,558,1,92,"cpsw_txintr@1148-1240@sys/arch/armv7/omap/if_cpsw.c","sys/arch/armv7/omap/if_cpsw.c","cpsw_txintr",1148,1240
29,2,268,1,38,"cpsw_miscintr@1243-1281@sys/arch/armv7/omap/if_cpsw.c","sys/arch/armv7/omap/if_cpsw.c","cpsw_miscintr",1243,1281
23,7,194,2,27,"cpsw_get_port_config@1284-1311@sys/arch/armv7/omap/if_cpsw.c","sys/arch/armv7/omap/if_cpsw.c","cpsw_get_port_config",1284,1311
6,2,45,3,6,"intc_match@125-131@sys/arch/armv7/omap/intc.c","sys/arch/armv7/omap/intc.c","intc_match",125,131
40,6,281,3,60,"intc_attach@134-194@sys/arch/armv7/omap/intc.c","sys/arch/armv7/omap/intc.c","intc_attach",134,194
35,9,238,1,43,"intc_calc_mask@197-240@sys/arch/armv7/omap/intc.c","sys/arch/armv7/omap/intc.c","intc_calc_mask",197,240
7,2,41,1,7,"intc_splx@243-250@sys/arch/armv7/omap/intc.c","sys/arch/armv7/omap/intc.c","intc_splx",243,250
7,1,33,1,6,"intc_spllower@253-259@sys/arch/armv7/omap/intc.c","sys/arch/armv7/omap/intc.c","intc_spllower",253,259
10,2,45,1,19,"intc_splraise@262-281@sys/arch/armv7/omap/intc.c","sys/arch/armv7/omap/intc.c","intc_splraise",262,281
25,6,130,1,27,"intc_setipl@284-311@sys/arch/armv7/omap/intc.c","sys/arch/armv7/omap/intc.c","intc_setipl",284,311
10,3,62,1,9,"intc_intr_bootstrap@314-323@sys/arch/armv7/omap/intc.c","sys/arch/armv7/omap/intc.c","intc_intr_bootstrap",314,323
21,4,125,1,27,"intc_irq_handler@326-353@sys/arch/armv7/omap/intc.c","sys/arch/armv7/omap/intc.c","intc_irq_handler",326,353
24,5,168,5,31,"intc_intr_establish@356-387@sys/arch/armv7/omap/intc.c","sys/arch/armv7/omap/intc.c","intc_intr_establish",356,387
5,1,50,6,4,"intc_intr_establish_fdt@390-394@sys/arch/armv7/omap/intc.c","sys/arch/armv7/omap/intc.c","intc_intr_establish_fdt",390,394
12,2,77,1,11,"intc_intr_disestablish@397-408@sys/arch/armv7/omap/intc.c","sys/arch/armv7/omap/intc.c","intc_intr_disestablish",397,408
4,1,11,1,3,"intc_intr_string@411-414@sys/arch/armv7/omap/intc.c","sys/arch/armv7/omap/intc.c","intc_intr_string",411,414
6,1,30,1,5,"intc_tst@421-426@sys/arch/armv7/omap/intc.c","sys/arch/armv7/omap/intc.c","intc_tst",421,426
13,1,83,1,16,"intc_test@429-445@sys/arch/armv7/omap/intc.c","sys/arch/armv7/omap/intc.c","intc_test",429,445
6,1,30,1,9,"find_first_bit@44-53@sys/arch/armv7/omap/intc.h","sys/arch/armv7/omap/intc.h","find_first_bit",44,53
7,2,43,3,8,"nxphdmi_match@298-306@sys/arch/armv7/omap/nxphdmi.c","sys/arch/armv7/omap/nxphdmi.c","nxphdmi_match",298,306
66,6,512,3,84,"nxphdmi_attach@309-393@sys/arch/armv7/omap/nxphdmi.c","sys/arch/armv7/omap/nxphdmi.c","nxphdmi_attach",309,393
13,2,94,3,15,"nxphdmi_cec_read@396-411@sys/arch/armv7/omap/nxphdmi.c","sys/arch/armv7/omap/nxphdmi.c","nxphdmi_cec_read",396,411
15,2,105,3,17,"nxphdmi_cec_write@414-431@sys/arch/armv7/omap/nxphdmi.c","sys/arch/armv7/omap/nxphdmi.c","nxphdmi_cec_write",414,431
15,2,116,3,18,"nxphdmi_read@434-452@sys/arch/armv7/omap/nxphdmi.c","sys/arch/armv7/omap/nxphdmi.c","nxphdmi_read",434,452
16,2,134,3,19,"nxphdmi_write@455-474@sys/arch/armv7/omap/nxphdmi.c","sys/arch/armv7/omap/nxphdmi.c","nxphdmi_write",455,474
16,2,141,3,20,"nxphdmi_write2@477-497@sys/arch/armv7/omap/nxphdmi.c","sys/arch/armv7/omap/nxphdmi.c","nxphdmi_write2",477,497
9,1,53,3,10,"nxphdmi_set@500-510@sys/arch/armv7/omap/nxphdmi.c","sys/arch/armv7/omap/nxphdmi.c","nxphdmi_set",500,510
9,1,53,3,10,"nxphdmi_clear@513-523@sys/arch/armv7/omap/nxphdmi.c","sys/arch/armv7/omap/nxphdmi.c","nxphdmi_clear",513,523
17,3,118,2,20,"nxphdmi_set_page@526-546@sys/arch/armv7/omap/nxphdmi.c","sys/arch/armv7/omap/nxphdmi.c","nxphdmi_set_page",526,546
39,6,300,1,48,"nxphdmi_read_edid@549-597@sys/arch/armv7/omap/nxphdmi.c","sys/arch/armv7/omap/nxphdmi.c","nxphdmi_read_edid",549,597
11,1,71,1,15,"nxphdmi_reset@600-615@sys/arch/armv7/omap/nxphdmi.c","sys/arch/armv7/omap/nxphdmi.c","nxphdmi_reset",600,615
112,9,862,2,146,"nxphdmi_init_encoder@618-764@sys/arch/armv7/omap/nxphdmi.c","sys/arch/armv7/omap/nxphdmi.c","nxphdmi_init_encoder",618,764
10,3,68,2,12,"nxphdmi_get_edid@767-779@sys/arch/armv7/omap/nxphdmi.c","sys/arch/armv7/omap/nxphdmi.c","nxphdmi_get_edid",767,779
7,1,38,1,8,"nxphdmi_set_videomode@782-790@sys/arch/armv7/omap/nxphdmi.c","sys/arch/armv7/omap/nxphdmi.c","nxphdmi_set_videomode",782,790
13,4,74,1,14,"omap_board_devs@87-101@sys/arch/armv7/omap/omap.c","sys/arch/armv7/omap/omap.c","omap_board_devs",87,101
14,4,75,1,15,"omap_board_init@104-119@sys/arch/armv7/omap/omap.c","sys/arch/armv7/omap/omap.c","omap_board_init",104,119
10,3,85,3,12,"omap_match@122-134@sys/arch/armv7/omap/omap.c","sys/arch/armv7/omap/omap.c","omap_match",122,134
4,1,11,1,3,"omap3_init@92-95@sys/arch/armv7/omap/omap3.c","sys/arch/armv7/omap/omap3.c","omap3_init",92,95
4,1,11,1,3,"omap4_init@95-98@sys/arch/armv7/omap/omap4.c","sys/arch/armv7/omap/omap4.c","omap4_init",95,98
12,3,49,5,12,"omap_platform_smc_write@41-53@sys/arch/armv7/omap/omap_machdep.c","sys/arch/armv7/omap/omap_machdep.c","omap_platform_smc_write",41,53
5,1,23,1,4,"omap_platform_init_mainbus@56-60@sys/arch/armv7/omap/omap_machdep.c","sys/arch/armv7/omap/omap_machdep.c","omap_platform_init_mainbus",56,60
4,1,10,1,3,"omap_platform_watchdog_reset@63-66@sys/arch/armv7/omap/omap_machdep.c","sys/arch/armv7/omap/omap_machdep.c","omap_platform_watchdog_reset",63,66
3,1,6,1,3,"omap_platform_powerdown@69-72@sys/arch/armv7/omap/omap_machdep.c","sys/arch/armv7/omap/omap_machdep.c","omap_platform_powerdown",69,72
4,1,10,1,3,"omap_platform_board_init@75-78@sys/arch/armv7/omap/omap_machdep.c","sys/arch/armv7/omap/omap_machdep.c","omap_platform_board_init",75,78
9,2,40,1,10,"omap_platform_match@89-99@sys/arch/armv7/omap/omap_machdep.c","sys/arch/armv7/omap/omap_machdep.c","omap_platform_match",89,99
36,8,230,3,39,"omapid_attach@66-105@sys/arch/armv7/omap/omapid.c","sys/arch/armv7/omap/omapid.c","omapid_attach",66,105
4,1,22,3,4,"omdisplay_match@505-509@sys/arch/armv7/omap/omdisplay.c","sys/arch/armv7/omap/omdisplay.c","omdisplay_match",505,509
38,5,293,3,61,"omdisplay_attach@512-573@sys/arch/armv7/omap/omdisplay.c","sys/arch/armv7/omap/omdisplay.c","omdisplay_attach",512,573
45,17,234,5,54,"omdisplay_ioctl@577-631@sys/arch/armv7/omap/omdisplay.c","sys/arch/armv7/omap/omdisplay.c","omdisplay_ioctl",577,631
15,3,82,3,17,"omdisplay_burner@634-651@sys/arch/armv7/omap/omdisplay.c","sys/arch/armv7/omap/omdisplay.c","omdisplay_burner",634,651
16,3,110,5,21,"omdisplay_show_screen@654-675@sys/arch/armv7/omap/omdisplay.c","sys/arch/armv7/omap/omdisplay.c","omdisplay_show_screen",654,675
31,8,144,3,39,"omdisplay_param@683-722@sys/arch/armv7/omap/omdisplay.c","sys/arch/armv7/omap/omdisplay.c","omdisplay_param",683,722
7,2,34,1,7,"omdisplay_max_brightness@752-759@sys/arch/armv7/omap/omdisplay.c","sys/arch/armv7/omap/omdisplay.c","omdisplay_max_brightness",752,759
4,1,9,1,4,"omdisplay_get_brightness@762-766@sys/arch/armv7/omap/omdisplay.c","sys/arch/armv7/omap/omdisplay.c","omdisplay_get_brightness",762,766
13,6,61,1,15,"omdisplay_set_brightness@769-784@sys/arch/armv7/omap/omdisplay.c","sys/arch/armv7/omap/omdisplay.c","omdisplay_set_brightness",769,784
11,3,48,1,21,"omdisplay_set_brightness_internal@787-808@sys/arch/armv7/omap/omdisplay.c","sys/arch/armv7/omap/omdisplay.c","omdisplay_set_brightness_internal",787,808
4,1,9,1,4,"omdisplay_get_backlight@811-815@sys/arch/armv7/omap/omdisplay.c","sys/arch/armv7/omap/omdisplay.c","omdisplay_get_backlight",811,815
10,2,37,1,10,"omdisplay_set_backlight@818-828@sys/arch/armv7/omap/omdisplay.c","sys/arch/armv7/omap/omdisplay.c","omdisplay_set_backlight",818,828
10,2,36,1,10,"omdisplay_blank@831-841@sys/arch/armv7/omap/omdisplay.c","sys/arch/armv7/omap/omdisplay.c","omdisplay_blank",831,841
6,2,24,1,6,"omdisplay_suspend@844-850@sys/arch/armv7/omap/omdisplay.c","sys/arch/armv7/omap/omdisplay.c","omdisplay_suspend",844,850
7,2,33,1,7,"omdisplay_resume@853-860@sys/arch/armv7/omap/omdisplay.c","sys/arch/armv7/omap/omdisplay.c","omdisplay_resume",853,860
15,3,65,2,15,"omdisplay_activate@863-878@sys/arch/armv7/omap/omdisplay.c","sys/arch/armv7/omap/omdisplay.c","omdisplay_activate",863,878
177,14,1823,2,217,"omdisplay_initialize@881-1098@sys/arch/armv7/omap/omdisplay.c","sys/arch/armv7/omap/omdisplay.c","omdisplay_initialize",881,1098
32,4,229,2,39,"omdisplay_setup_rasops@1101-1140@sys/arch/armv7/omap/omdisplay.c","sys/arch/armv7/omap/omdisplay.c","omdisplay_setup_rasops",1101,1140
27,4,194,6,36,"omdisplay_alloc_screen@1144-1180@sys/arch/armv7/omap/omdisplay.c","sys/arch/armv7/omap/omdisplay.c","omdisplay_alloc_screen",1144,1180
84,22,548,3,107,"omdisplay_new_screen@1186-1293@sys/arch/armv7/omap/omdisplay.c","sys/arch/armv7/omap/omdisplay.c","omdisplay_new_screen",1186,1293
14,5,110,3,17,"omdisplay_mmap@1295-1312@sys/arch/armv7/omap/omdisplay.c","sys/arch/armv7/omap/omdisplay.c","omdisplay_mmap",1295,1312
18,5,126,2,26,"omdisplay_free_screen@1315-1341@sys/arch/armv7/omap/omdisplay.c","sys/arch/armv7/omap/omdisplay.c","omdisplay_free_screen",1315,1341
8,2,54,3,9,"omdisplay_load_font@1344-1353@sys/arch/armv7/omap/omdisplay.c","sys/arch/armv7/omap/omdisplay.c","omdisplay_load_font",1344,1353
8,2,48,2,9,"omdisplay_list_font@1356-1365@sys/arch/armv7/omap/omdisplay.c","sys/arch/armv7/omap/omdisplay.c","omdisplay_list_font",1356,1365
9,1,34,1,8,"omdisplay_start@1368-1376@sys/arch/armv7/omap/omdisplay.c","sys/arch/armv7/omap/omdisplay.c","omdisplay_start",1368,1376
6,1,41,1,7,"omdisplay_stop@1379-1386@sys/arch/armv7/omap/omdisplay.c","sys/arch/armv7/omap/omdisplay.c","omdisplay_stop",1379,1386
4,1,11,1,4,"omdisplay_intr@1389-1393@sys/arch/armv7/omap/omdisplay.c","sys/arch/armv7/omap/omdisplay.c","omdisplay_intr",1389,1393
5,1,34,3,5,"omdog_match@84-89@sys/arch/armv7/omap/omdog.c","sys/arch/armv7/omap/omdog.c","omdog_match",84,89
19,4,154,3,29,"omdog_attach@92-121@sys/arch/armv7/omap/omdog.c","sys/arch/armv7/omap/omdog.c","omdog_attach",92,121
9,2,33,2,11,"omdog_activate@124-135@sys/arch/armv7/omap/omdog.c","sys/arch/armv7/omap/omdog.c","omdog_activate",124,135
7,1,49,1,7,"omdog_start@138-145@sys/arch/armv7/omap/omdog.c","sys/arch/armv7/omap/omdog.c","omdog_start",138,145
7,1,49,1,7,"omdog_stop@148-155@sys/arch/armv7/omap/omdog.c","sys/arch/armv7/omap/omdog.c","omdog_stop",148,155
6,2,41,1,5,"omdog_sync@158-163@sys/arch/armv7/omap/omdog.c","sys/arch/armv7/omap/omdog.c","omdog_sync",158,163
21,6,147,2,31,"omdog_cb@166-197@sys/arch/armv7/omap/omdog.c","sys/arch/armv7/omap/omdog.c","omdog_cb",166,197
11,3,52,1,14,"omdog_reset@200-214@sys/arch/armv7/omap/omdog.c","sys/arch/armv7/omap/omdog.c","omdog_reset",200,214
5,1,34,3,5,"omehci_match@114-119@sys/arch/armv7/omap/omehci.c","sys/arch/armv7/omap/omehci.c","omehci_match",114,119
103,23,798,3,132,"omehci_attach@122-254@sys/arch/armv7/omap/omehci.c","sys/arch/armv7/omap/omehci.c","omehci_attach",122,254
124,40,873,1,185,"omehci_init@257-442@sys/arch/armv7/omap/omehci.c","sys/arch/armv7/omap/omehci.c","omehci_init",257,442
20,4,151,2,30,"omehci_soft_phy_reset@445-475@sys/arch/armv7/omap/omehci.c","sys/arch/armv7/omap/omehci.c","omehci_soft_phy_reset",445,475
17,4,112,2,22,"omehci_detach@478-500@sys/arch/armv7/omap/omehci.c","sys/arch/armv7/omap/omehci.c","omehci_detach",478,500
18,4,92,2,20,"omehci_activate@503-523@sys/arch/armv7/omap/omehci.c","sys/arch/armv7/omap/omehci.c","omehci_activate",503,523
11,1,49,0,15,"omehci_v4_early_init@526-541@sys/arch/armv7/omap/omehci.c","sys/arch/armv7/omap/omehci.c","omehci_v4_early_init",526,541
6,2,49,2,6,"omgpio_read4@219-225@sys/arch/armv7/omap/omgpio.c","sys/arch/armv7/omap/omgpio.c","omgpio_read4",219,225
6,2,55,3,6,"omgpio_write4@228-234@sys/arch/armv7/omap/omgpio.c","sys/arch/armv7/omap/omgpio.c","omgpio_write4",228,234
10,3,65,3,10,"omgpio_match@237-247@sys/arch/armv7/omap/omgpio.c","sys/arch/armv7/omap/omgpio.c","omgpio_match",237,247
108,12,915,3,125,"omgpio_attach@250-375@sys/arch/armv7/omap/omgpio.c","sys/arch/armv7/omap/omgpio.c","omgpio_attach",250,375
4,1,15,2,3,"omgpio_get_function@382-385@sys/arch/armv7/omap/omgpio.c","sys/arch/armv7/omap/omgpio.c","omgpio_get_function",382,385
3,1,12,2,2,"omgpio_set_function@388-390@sys/arch/armv7/omap/omgpio.c","sys/arch/armv7/omap/omgpio.c","omgpio_set_function",388,390
5,1,34,1,5,"omgpio_get_bit@394-399@sys/arch/armv7/omap/omgpio.c","sys/arch/armv7/omap/omgpio.c","omgpio_get_bit",394,399
5,1,35,1,5,"omgpio_set_bit@402-407@sys/arch/armv7/omap/omgpio.c","sys/arch/armv7/omap/omgpio.c","omgpio_set_bit",402,407
5,1,35,1,5,"omgpio_clear_bit@410-415@sys/arch/armv7/omap/omgpio.c","sys/arch/armv7/omap/omgpio.c","omgpio_clear_bit",410,415
5,1,39,2,5,"omgpio_set_dir@418-423@sys/arch/armv7/omap/omgpio.c","sys/arch/armv7/omap/omgpio.c","omgpio_set_dir",418,423
10,2,72,2,10,"omgpio_pin_read@426-436@sys/arch/armv7/omap/omgpio.c","sys/arch/armv7/omap/omgpio.c","omgpio_pin_read",426,436
10,2,64,3,10,"omgpio_pin_write@439-449@sys/arch/armv7/omap/omgpio.c","sys/arch/armv7/omap/omgpio.c","omgpio_pin_write",439,449
11,4,75,3,12,"omgpio_pin_ctl@452-464@sys/arch/armv7/omap/omgpio.c","sys/arch/armv7/omap/omgpio.c","omgpio_pin_ctl",452,464
14,2,89,3,16,"omgpio_pin_dir_write@467-483@sys/arch/armv7/omap/omgpio.c","sys/arch/armv7/omap/omgpio.c","omgpio_pin_dir_write",467,483
9,2,50,2,8,"omgpio_pin_dir_read@486-494@sys/arch/armv7/omap/omgpio.c","sys/arch/armv7/omap/omgpio.c","omgpio_pin_dir_read",486,494
5,1,47,2,5,"omgpio_clear_intr@498-503@sys/arch/armv7/omap/omgpio.c","sys/arch/armv7/omap/omgpio.c","omgpio_clear_intr",498,503
5,1,47,2,5,"omgpio_intr_mask@506-511@sys/arch/armv7/omap/omgpio.c","sys/arch/armv7/omap/omgpio.c","omgpio_intr_mask",506,511
5,1,47,2,5,"omgpio_intr_unmask@514-519@sys/arch/armv7/omap/omgpio.c","sys/arch/armv7/omap/omgpio.c","omgpio_intr_unmask",514,519
59,8,317,3,65,"omgpio_intr_level@522-587@sys/arch/armv7/omap/omgpio.c","sys/arch/armv7/omap/omgpio.c","omgpio_intr_level",522,587
30,3,231,7,45,"omgpio_intr_establish@590-635@sys/arch/armv7/omap/omgpio.c","sys/arch/armv7/omap/omgpio.c","omgpio_intr_establish",590,635
17,1,122,2,22,"omgpio_intr_disestablish@638-660@sys/arch/armv7/omap/omgpio.c","sys/arch/armv7/omap/omgpio.c","omgpio_intr_disestablish",638,660
24,4,137,1,27,"omgpio_irq@663-690@sys/arch/armv7/omap/omgpio.c","sys/arch/armv7/omap/omgpio.c","omgpio_irq",663,690
4,1,11,1,3,"omgpio_irq_dummy@693-696@sys/arch/armv7/omap/omgpio.c","sys/arch/armv7/omap/omgpio.c","omgpio_irq_dummy",693,696
38,16,253,1,48,"omgpio_recalc_interrupts@699-747@sys/arch/armv7/omap/omgpio.c","sys/arch/armv7/omap/omgpio.c","omgpio_recalc_interrupts",699,747
6,2,45,3,6,"ommmc_match@288-294@sys/arch/armv7/omap/ommmc.c","sys/arch/armv7/omap/ommmc.c","ommmc_match",288,294
105,32,762,3,164,"ommmc_attach@297-461@sys/arch/armv7/omap/ommmc.c","sys/arch/armv7/omap/ommmc.c","ommmc_attach",297,461
16,8,107,2,28,"ommmc_power@468-496@sys/arch/armv7/omap/ommmc.c","sys/arch/armv7/omap/ommmc.c","ommmc_power",468,496
5,1,23,1,6,"ommmc_shutdown@502-508@sys/arch/armv7/omap/ommmc.c","sys/arch/armv7/omap/ommmc.c","ommmc_shutdown",502,508
32,3,214,1,53,"ommmc_host_reset@515-568@sys/arch/armv7/omap/ommmc.c","sys/arch/armv7/omap/ommmc.c","ommmc_host_reset",515,568
5,1,21,1,4,"ommmc_host_ocr@571-575@sys/arch/armv7/omap/ommmc.c","sys/arch/armv7/omap/ommmc.c","ommmc_host_ocr",571,575
5,1,21,1,4,"ommmc_host_maxblklen@578-582@sys/arch/armv7/omap/ommmc.c","sys/arch/armv7/omap/ommmc.c","ommmc_host_maxblklen",578,582
6,2,32,1,5,"ommmc_card_detect@588-593@sys/arch/armv7/omap/ommmc.c","sys/arch/armv7/omap/ommmc.c","ommmc_card_detect",588,593
37,6,208,2,62,"ommmc_bus_power@600-662@sys/arch/armv7/omap/ommmc.c","sys/arch/armv7/omap/ommmc.c","ommmc_bus_power",600,662
11,3,66,2,13,"ommmc_clock_divisor@669-682@sys/arch/armv7/omap/ommmc.c","sys/arch/armv7/omap/ommmc.c","ommmc_clock_divisor",669,682
49,11,284,3,69,"ommmc_bus_clock@689-758@sys/arch/armv7/omap/ommmc.c","sys/arch/armv7/omap/ommmc.c","ommmc_bus_clock",689,758
18,7,111,2,23,"ommmc_bus_width@761-784@sys/arch/armv7/omap/ommmc.c","sys/arch/armv7/omap/ommmc.c","ommmc_bus_width",761,784
11,2,62,2,12,"ommmc_card_intr_mask@787-799@sys/arch/armv7/omap/ommmc.c","sys/arch/armv7/omap/ommmc.c","ommmc_card_intr_mask",787,799
5,1,23,1,5,"ommmc_card_intr_ack@802-807@sys/arch/armv7/omap/ommmc.c","sys/arch/armv7/omap/ommmc.c","ommmc_card_intr_ack",802,807
16,3,123,3,16,"ommmc_wait_state@810-826@sys/arch/armv7/omap/ommmc.c","sys/arch/armv7/omap/ommmc.c","ommmc_wait_state",810,826
39,11,378,2,68,"ommmc_exec_command@829-897@sys/arch/armv7/omap/ommmc.c","sys/arch/armv7/omap/ommmc.c","ommmc_exec_command",829,897
65,18,439,2,102,"ommmc_start_command@900-1002@sys/arch/armv7/omap/ommmc.c","sys/arch/armv7/omap/ommmc.c","ommmc_start_command",900,1002
37,9,238,2,45,"ommmc_transfer_data@1005-1050@sys/arch/armv7/omap/ommmc.c","sys/arch/armv7/omap/ommmc.c","ommmc_transfer_data",1005,1050
15,4,90,3,14,"ommmc_read_data@1053-1067@sys/arch/armv7/omap/ommmc.c","sys/arch/armv7/omap/ommmc.c","ommmc_read_data",1053,1067
18,5,129,3,17,"ommmc_write_data@1070-1087@sys/arch/armv7/omap/ommmc.c","sys/arch/armv7/omap/ommmc.c","ommmc_write_data",1070,1087
22,6,152,2,32,"ommmc_soft_reset@1091-1123@sys/arch/armv7/omap/ommmc.c","sys/arch/armv7/omap/ommmc.c","ommmc_soft_reset",1091,1123
26,4,150,3,31,"ommmc_wait_intr@1126-1157@sys/arch/armv7/omap/ommmc.c","sys/arch/armv7/omap/ommmc.c","ommmc_wait_intr",1126,1157
31,7,193,1,54,"ommmc_intr@1163-1217@sys/arch/armv7/omap/ommmc.c","sys/arch/armv7/omap/ommmc.c","ommmc_intr",1163,1217
3,1,9,1,2,"ommmc_dump_regs@1221-1223@sys/arch/armv7/omap/ommmc.c","sys/arch/armv7/omap/ommmc.c","ommmc_dump_regs",1221,1223
6,3,37,3,8,"omohci_match@118-126@sys/arch/armv7/omap/omohci.c","sys/arch/armv7/omap/omohci.c","omohci_match",118,126
79,12,705,3,98,"omohci_attach@129-227@sys/arch/armv7/omap/omohci.c","sys/arch/armv7/omap/omohci.c","omohci_attach",129,227
29,5,189,2,37,"omohci_detach@230-267@sys/arch/armv7/omap/omohci.c","sys/arch/armv7/omap/omohci.c","omohci_detach",230,267
20,5,118,2,25,"omohci_activate@271-296@sys/arch/armv7/omap/omohci.c","sys/arch/armv7/omap/omohci.c","omohci_activate",271,296
23,3,270,1,33,"omohci_enable@299-332@sys/arch/armv7/omap/omohci.c","sys/arch/armv7/omap/omohci.c","omohci_enable",299,332
11,2,107,1,16,"omohci_disable@335-351@sys/arch/armv7/omap/omohci.c","sys/arch/armv7/omap/omohci.c","omohci_disable",335,351
5,1,34,3,5,"ompinmux_match@51-56@sys/arch/armv7/omap/ompinmux.c","sys/arch/armv7/omap/ompinmux.c","ompinmux_match",51,56
13,2,119,3,16,"ompinmux_attach@59-75@sys/arch/armv7/omap/ompinmux.c","sys/arch/armv7/omap/ompinmux.c","ompinmux_attach",59,75
49,8,355,2,59,"ompinmux_pinctrl@78-137@sys/arch/armv7/omap/ompinmux.c","sys/arch/armv7/omap/ompinmux.c","ompinmux_pinctrl",78,137
20,4,157,3,31,"omusbtll_attach@106-137@sys/arch/armv7/omap/omusbtll.c","sys/arch/armv7/omap/omusbtll.c","omusbtll_attach",106,137
31,4,207,1,35,"omusbtll_init@140-175@sys/arch/armv7/omap/omusbtll.c","sys/arch/armv7/omap/omusbtll.c","omusbtll_init",140,175
5,1,34,3,5,"omwugen_match@43-48@sys/arch/armv7/omap/omwugen.c","sys/arch/armv7/omap/omwugen.c","omwugen_match",43,48
11,1,87,3,12,"omwugen_attach@51-63@sys/arch/armv7/omap/omwugen.c","sys/arch/armv7/omap/omwugen.c","omwugen_attach",51,63
44,11,372,3,51,"prcm_attach@121-172@sys/arch/armv7/omap/prcm.c","sys/arch/armv7/omap/prcm.c","prcm_attach",121,172
28,1,182,1,34,"prcm_v3_setup@175-209@sys/arch/armv7/omap/prcm.c","sys/arch/armv7/omap/prcm.c","prcm_v3_setup",175,209
7,2,47,2,8,"prcm_setclock@212-220@sys/arch/armv7/omap/prcm.c","sys/arch/armv7/omap/prcm.c","prcm_setclock",212,220
58,10,509,3,63,"prcm_am335x_setclock@223-286@sys/arch/armv7/omap/prcm.c","sys/arch/armv7/omap/prcm.c","prcm_am335x_setclock",223,286
17,4,168,3,17,"prcm_v3_setclock@289-306@sys/arch/armv7/omap/prcm.c","sys/arch/armv7/omap/prcm.c","prcm_v3_setclock",289,306
33,14,100,1,32,"prcm_v3_bit@309-341@sys/arch/armv7/omap/prcm.c","sys/arch/armv7/omap/prcm.c","prcm_v3_bit",309,341
43,19,130,1,42,"prcm_am335x_clkctrl@344-386@sys/arch/armv7/omap/prcm.c","sys/arch/armv7/omap/prcm.c","prcm_am335x_clkctrl",344,386
7,2,42,1,8,"prcm_enablemodule@389-397@sys/arch/armv7/omap/prcm.c","sys/arch/armv7/omap/prcm.c","prcm_enablemodule",389,397
12,2,81,2,15,"prcm_am335x_enablemodule@400-415@sys/arch/armv7/omap/prcm.c","sys/arch/armv7/omap/prcm.c","prcm_am335x_enablemodule",400,415
22,3,171,2,24,"prcm_v3_enablemodule@418-442@sys/arch/armv7/omap/prcm.c","sys/arch/armv7/omap/prcm.c","prcm_v3_enablemodule",418,442
36,24,116,2,37,"prcm_v4_enablemodule@445-482@sys/arch/armv7/omap/prcm.c","sys/arch/armv7/omap/prcm.c","prcm_v4_enablemodule",445,482
36,8,208,1,46,"prcm_v4_hsusbhost_activate@485-531@sys/arch/armv7/omap/prcm.c","sys/arch/armv7/omap/prcm.c","prcm_v4_hsusbhost_activate",485,531
21,4,126,2,27,"prcm_v4_hsusbhost_set_source@534-561@sys/arch/armv7/omap/prcm.c","sys/arch/armv7/omap/prcm.c","prcm_v4_hsusbhost_set_source",534,561
15,3,146,1,35,"prcm_setup_dpll5@572-607@sys/arch/armv7/omap/prcm.c","sys/arch/armv7/omap/prcm.c","prcm_setup_dpll5",572,607
11,3,57,1,12,"sitara_cm_padconf_from_name@115-127@sys/arch/armv7/omap/sitara_cm.c","sys/arch/armv7/omap/sitara_cm.c","sitara_cm_padconf_from_name",115,127
21,5,143,4,31,"sitara_cm_padconf_set_internal@144-175@sys/arch/armv7/omap/sitara_cm.c","sys/arch/armv7/omap/sitara_cm.c","sitara_cm_padconf_set_internal",144,175
12,3,66,3,15,"sitara_cm_padconf_set@192-207@sys/arch/armv7/omap/sitara_cm.c","sys/arch/armv7/omap/sitara_cm.c","sitara_cm_padconf_set",192,207
20,5,109,3,29,"sitara_cm_padconf_get@224-253@sys/arch/armv7/omap/sitara_cm.c","sys/arch/armv7/omap/sitara_cm.c","sitara_cm_padconf_get",224,253
20,5,116,2,29,"sitara_cm_padconf_set_gpiomode@270-299@sys/arch/armv7/omap/sitara_cm.c","sys/arch/armv7/omap/sitara_cm.c","sitara_cm_padconf_set_gpiomode",270,299
22,7,123,2,37,"sitara_cm_padconf_get_gpiomode@316-353@sys/arch/armv7/omap/sitara_cm.c","sys/arch/armv7/omap/sitara_cm.c","sitara_cm_padconf_get_gpiomode",316,353
7,2,36,2,7,"sitara_cm_reg_read_4@357-364@sys/arch/armv7/omap/sitara_cm.c","sys/arch/armv7/omap/sitara_cm.c","sitara_cm_reg_read_4",357,364
7,2,34,2,7,"sitara_cm_reg_write_4@367-374@sys/arch/armv7/omap/sitara_cm.c","sys/arch/armv7/omap/sitara_cm.c","sitara_cm_reg_write_4",367,374
21,5,166,3,26,"sitara_cm_attach@377-403@sys/arch/armv7/omap/sitara_cm.c","sys/arch/armv7/omap/sitara_cm.c","sitara_cm_attach",377,403
27,5,193,2,33,"sitara_cm_pinctrl@406-439@sys/arch/armv7/omap/sitara_cm.c","sys/arch/armv7/omap/sitara_cm.c","sitara_cm_pinctrl",406,439
5,1,34,3,5,"ti_iic_match@154-159@sys/arch/armv7/omap/ti_iic.c","sys/arch/armv7/omap/ti_iic.c","ti_iic_match",154,159
45,7,379,3,57,"ti_iic_attach@162-219@sys/arch/armv7/omap/ti_iic.c","sys/arch/armv7/omap/ti_iic.c","ti_iic_attach",162,219
16,3,108,1,20,"ti_iic_intr@222-242@sys/arch/armv7/omap/ti_iic.c","sys/arch/armv7/omap/ti_iic.c","ti_iic_intr",222,242
7,2,40,2,8,"ti_iic_acquire_bus@245-253@sys/arch/armv7/omap/ti_iic.c","sys/arch/armv7/omap/ti_iic.c","ti_iic_acquire_bus",245,253
7,2,34,2,8,"ti_iic_release_bus@256-264@sys/arch/armv7/omap/ti_iic.c","sys/arch/armv7/omap/ti_iic.c","ti_iic_release_bus",256,264
28,8,195,8,38,"ti_iic_exec@267-305@sys/arch/armv7/omap/ti_iic.c","sys/arch/armv7/omap/ti_iic.c","ti_iic_exec",267,305
32,4,207,1,49,"ti_iic_reset@308-357@sys/arch/armv7/omap/ti_iic.c","sys/arch/armv7/omap/ti_iic.c","ti_iic_reset",308,357
76,16,516,6,92,"ti_iic_op@360-452@sys/arch/armv7/omap/ti_iic.c","sys/arch/armv7/omap/ti_iic.c","ti_iic_op",360,452
19,5,98,2,19,"ti_iic_handle_intr@455-474@sys/arch/armv7/omap/ti_iic.c","sys/arch/armv7/omap/ti_iic.c","ti_iic_handle_intr",455,474
23,5,165,2,23,"ti_iic_do_read@476-499@sys/arch/armv7/omap/ti_iic.c","sys/arch/armv7/omap/ti_iic.c","ti_iic_do_read",476,499
23,5,165,2,24,"ti_iic_do_write@502-526@sys/arch/armv7/omap/ti_iic.c","sys/arch/armv7/omap/ti_iic.c","ti_iic_do_write",502,526
20,4,128,4,21,"ti_iic_wait@529-550@sys/arch/armv7/omap/ti_iic.c","sys/arch/armv7/omap/ti_iic.c","ti_iic_wait",529,550
14,3,74,2,13,"ti_iic_stat@553-566@sys/arch/armv7/omap/ti_iic.c","sys/arch/armv7/omap/ti_iic.c","ti_iic_stat",553,566
17,4,90,1,20,"ti_iic_flush@569-589@sys/arch/armv7/omap/ti_iic.c","sys/arch/armv7/omap/ti_iic.c","ti_iic_flush",569,589
25,5,216,3,29,"ti_iic_scan@592-621@sys/arch/armv7/omap/ti_iic.c","sys/arch/armv7/omap/ti_iic.c","ti_iic_scan",592,621
20,3,117,2,24,"efi_main@63-87@sys/arch/armv7/stand/efiboot/efiboot.c","sys/arch/armv7/stand/efiboot/efiboot.c","efi_main",63,87
5,1,26,1,4,"efi_cons_probe@93-97@sys/arch/armv7/stand/efiboot/efiboot.c","sys/arch/armv7/stand/efiboot/efiboot.c","efi_cons_probe",93,97
5,1,21,1,4,"efi_cons_init@100-104@sys/arch/armv7/stand/efiboot/efiboot.c","sys/arch/armv7/stand/efiboot/efiboot.c","efi_cons_init",100,104
23,8,129,1,34,"efi_cons_getc@107-141@sys/arch/armv7/stand/efiboot/efiboot.c","sys/arch/armv7/stand/efiboot/efiboot.c","efi_cons_getc",107,141
9,2,52,2,11,"efi_cons_putc@144-155@sys/arch/armv7/stand/efiboot/efiboot.c","sys/arch/armv7/stand/efiboot/efiboot.c","efi_cons_putc",144,155
8,2,41,1,8,"efi_heap_init@158-166@sys/arch/armv7/stand/efiboot/efiboot.c","sys/arch/armv7/stand/efiboot/efiboot.c","efi_heap_init",158,166
43,14,293,1,55,"efi_diskprobe@171-226@sys/arch/armv7/stand/efiboot/efiboot.c","sys/arch/armv7/stand/efiboot/efiboot.c","efi_diskprobe",171,226
9,3,58,2,10,"efi_device_path_depth@233-243@sys/arch/armv7/stand/efiboot/efiboot.c","sys/arch/armv7/stand/efiboot/efiboot.c","efi_device_path_depth",233,243
18,9,139,3,19,"efi_device_path_ncmp@246-265@sys/arch/armv7/stand/efiboot/efiboot.c","sys/arch/armv7/stand/efiboot/efiboot.c","efi_device_path_ncmp",246,265
42,8,317,2,54,"efi_makebootargs@288-342@sys/arch/armv7/stand/efiboot/efiboot.c","sys/arch/armv7/stand/efiboot/efiboot.c","efi_makebootargs",288,342
20,2,125,1,23,"efi_updatefdt@345-368@sys/arch/armv7/stand/efiboot/efiboot.c","sys/arch/armv7/stand/efiboot/efiboot.c","efi_updatefdt",345,368
19,4,92,1,27,"machdep@373-400@sys/arch/armv7/stand/efiboot/efiboot.c","sys/arch/armv7/stand/efiboot/efiboot.c","machdep",373,400
15,4,73,1,17,"efi_cleanup@403-420@sys/arch/armv7/stand/efiboot/efiboot.c","sys/arch/armv7/stand/efiboot/efiboot.c","efi_cleanup",403,420
9,4,42,1,18,"_rtt@423-441@sys/arch/armv7/stand/efiboot/efiboot.c","sys/arch/armv7/stand/efiboot/efiboot.c","_rtt",423,441
4,1,14,2,3,"efi_timer@455-458@sys/arch/armv7/stand/efiboot/efiboot.c","sys/arch/armv7/stand/efiboot/efiboot.c","efi_timer",455,458
10,3,60,1,10,"efi_timer_init@461-471@sys/arch/armv7/stand/efiboot/efiboot.c","sys/arch/armv7/stand/efiboot/efiboot.c","efi_timer_init",461,471
4,1,13,1,3,"efi_timer_cleanup@474-477@sys/arch/armv7/stand/efiboot/efiboot.c","sys/arch/armv7/stand/efiboot/efiboot.c","efi_timer_cleanup",474,477
4,1,9,1,3,"getsecs@480-483@sys/arch/armv7/stand/efiboot/efiboot.c","sys/arch/armv7/stand/efiboot/efiboot.c","getsecs",480,483
4,1,20,2,3,"devboot@490-493@sys/arch/armv7/stand/efiboot/efiboot.c","sys/arch/armv7/stand/efiboot/efiboot.c","devboot",490,493
4,1,13,2,3,"cnspeed@496-499@sys/arch/armv7/stand/efiboot/efiboot.c","sys/arch/armv7/stand/efiboot/efiboot.c","cnspeed",496,499
4,1,10,1,3,"ttyname@502-505@sys/arch/armv7/stand/efiboot/efiboot.c","sys/arch/armv7/stand/efiboot/efiboot.c","ttyname",502,505
4,1,11,1,3,"ttydev@508-511@sys/arch/armv7/stand/efiboot/efiboot.c","sys/arch/armv7/stand/efiboot/efiboot.c","ttydev",508,511
42,15,321,5,59,"devparse@522-581@sys/arch/armv7/stand/efiboot/efiboot.c","sys/arch/armv7/stand/efiboot/efiboot.c","devparse",522,581
11,2,93,3,13,"devopen@584-597@sys/arch/armv7/stand/efiboot/efiboot.c","sys/arch/armv7/stand/efiboot/efiboot.c","devopen",584,597
24,3,140,1,25,"efi_memprobe_internal@600-625@sys/arch/armv7/stand/efiboot/efiboot.c","sys/arch/armv7/stand/efiboot/efiboot.c","efi_memprobe_internal",600,625
7,2,33,1,6,"Xexit_efi@641-647@sys/arch/armv7/stand/efiboot/efiboot.c","sys/arch/armv7/stand/efiboot/efiboot.c","Xexit_efi",641,647
5,1,26,1,4,"Xpoweroff_efi@650-654@sys/arch/armv7/stand/efiboot/efiboot.c","sys/arch/armv7/stand/efiboot/efiboot.c","Xpoweroff_efi",650,654
32,7,195,5,37,"efid_io@58-95@sys/arch/armv7/stand/efiboot/efidev.c","sys/arch/armv7/stand/efiboot/efidev.c","efid_io",58,95
6,2,58,5,7,"efid_diskio@98-105@sys/arch/armv7/stand/efiboot/efidev.c","sys/arch/armv7/stand/efiboot/efidev.c","efid_diskio",98,105
34,9,252,1,50,"efi_getdisklabel@111-161@sys/arch/armv7/stand/efiboot/efidev.c","sys/arch/armv7/stand/efiboot/efidev.c","efi_getdisklabel",111,161
23,4,134,2,29,"efiopen@164-193@sys/arch/armv7/stand/efiboot/efidev.c","sys/arch/armv7/stand/efiboot/efidev.c","efiopen",164,193
16,3,119,6,19,"efistrategy@196-215@sys/arch/armv7/stand/efiboot/efidev.c","sys/arch/armv7/stand/efiboot/efidev.c","efistrategy",196,215
5,1,18,1,5,"eficlose@218-223@sys/arch/armv7/stand/efiboot/efidev.c","sys/arch/armv7/stand/efiboot/efidev.c","eficlose",218,223
4,1,19,3,3,"efiioctl@226-229@sys/arch/armv7/stand/efiboot/efidev.c","sys/arch/armv7/stand/efiboot/efidev.c","efiioctl",226,229
38,8,294,2,52,"run_loadfile@36-88@sys/arch/armv7/stand/efiboot/exec.c","sys/arch/armv7/stand/efiboot/exec.c","run_loadfile",36,88
19,6,143,1,25,"fdt_check_head@39-64@sys/arch/armv7/stand/efiboot/fdt.c","sys/arch/armv7/stand/efiboot/fdt.c","fdt_check_head",39,64
21,4,186,1,25,"fdt_init@71-96@sys/arch/armv7/stand/efiboot/fdt.c","sys/arch/armv7/stand/efiboot/fdt.c","fdt_init",71,96
11,2,112,1,11,"fdt_finalize@99-110@sys/arch/armv7/stand/efiboot/fdt.c","sys/arch/armv7/stand/efiboot/fdt.c","fdt_finalize",99,110
8,3,42,1,9,"fdt_get_size@116-125@sys/arch/armv7/stand/efiboot/fdt.c","sys/arch/armv7/stand/efiboot/fdt.c","fdt_get_size",116,125
6,3,35,1,5,"fdt_get_str@131-136@sys/arch/armv7/stand/efiboot/fdt.c","sys/arch/armv7/stand/efiboot/fdt.c","fdt_get_str",131,136
14,3,115,1,15,"fdt_add_str@139-154@sys/arch/armv7/stand/efiboot/fdt.c","sys/arch/armv7/stand/efiboot/fdt.c","fdt_add_str",139,154
7,1,45,1,9,"skip_property@160-169@sys/arch/armv7/stand/efiboot/fdt.c","sys/arch/armv7/stand/efiboot/fdt.c","skip_property",160,169
7,2,30,1,6,"skip_props@172-178@sys/arch/armv7/stand/efiboot/fdt.c","sys/arch/armv7/stand/efiboot/fdt.c","skip_props",172,178
5,1,35,1,5,"skip_node_name@181-186@sys/arch/armv7/stand/efiboot/fdt.c","sys/arch/armv7/stand/efiboot/fdt.c","skip_node_name",181,186
22,5,142,3,26,"fdt_node_property@193-219@sys/arch/armv7/stand/efiboot/fdt.c","sys/arch/armv7/stand/efiboot/fdt.c","fdt_node_property",193,219
37,7,261,4,41,"fdt_node_set_property@222-263@sys/arch/armv7/stand/efiboot/fdt.c","sys/arch/armv7/stand/efiboot/fdt.c","fdt_node_set_property",222,263
23,6,203,4,28,"fdt_node_add_property@266-294@sys/arch/armv7/stand/efiboot/fdt.c","sys/arch/armv7/stand/efiboot/fdt.c","fdt_node_add_property",266,294
10,2,55,1,14,"skip_node@301-315@sys/arch/armv7/stand/efiboot/fdt.c","sys/arch/armv7/stand/efiboot/fdt.c","skip_node",301,315
23,8,141,1,33,"fdt_next_node@323-356@sys/arch/armv7/stand/efiboot/fdt.c","sys/arch/armv7/stand/efiboot/fdt.c","fdt_next_node",323,356
13,4,71,1,18,"fdt_child_node@362-380@sys/arch/armv7/stand/efiboot/fdt.c","sys/arch/armv7/stand/efiboot/fdt.c","fdt_child_node",362,380
10,3,48,1,13,"fdt_node_name@386-399@sys/arch/armv7/stand/efiboot/fdt.c","sys/arch/armv7/stand/efiboot/fdt.c","fdt_node_name",386,399
29,9,155,1,35,"fdt_find_node@402-437@sys/arch/armv7/stand/efiboot/fdt.c","sys/arch/armv7/stand/efiboot/fdt.c","fdt_find_node",402,437
11,5,69,2,11,"fdt_parent_node_recurse@440-451@sys/arch/armv7/stand/efiboot/fdt.c","sys/arch/armv7/stand/efiboot/fdt.c","fdt_parent_node_recurse",440,451
9,3,42,1,11,"fdt_parent_node@454-465@sys/arch/armv7/stand/efiboot/fdt.c","sys/arch/armv7/stand/efiboot/fdt.c","fdt_parent_node",454,465
13,3,75,2,14,"fdt_node_is_compatible@468-482@sys/arch/armv7/stand/efiboot/fdt.c","sys/arch/armv7/stand/efiboot/fdt.c","fdt_node_is_compatible",468,482
37,14,295,2,46,"fdt_print_property@489-535@sys/arch/armv7/stand/efiboot/fdt.c","sys/arch/armv7/stand/efiboot/fdt.c","fdt_print_property",489,535
15,4,95,2,19,"fdt_print_node@538-557@sys/arch/armv7/stand/efiboot/fdt.c","sys/arch/armv7/stand/efiboot/fdt.c","fdt_print_node",538,557
7,2,49,2,7,"fdt_print_node_recurse@560-567@sys/arch/armv7/stand/efiboot/fdt.c","sys/arch/armv7/stand/efiboot/fdt.c","fdt_print_node_recurse",560,567
4,1,16,1,3,"fdt_print_tree@570-573@sys/arch/armv7/stand/efiboot/fdt.c","sys/arch/armv7/stand/efiboot/fdt.c","fdt_print_tree",570,573
6,2,27,1,5,"heap_init@24-29@sys/arch/armv7/stand/efiboot/heap.h","sys/arch/armv7/stand/efiboot/heap.h","heap_init",24,29
41,12,206,2,55,"self_reloc@67-122@sys/arch/armv7/stand/efiboot/self_reloc.c","sys/arch/armv7/stand/efiboot/self_reloc.c","self_reloc",67,122
5,1,34,3,5,"sxiahci_match@87-92@sys/arch/armv7/sunxi/sxiahci.c","sys/arch/armv7/sunxi/sxiahci.c","sxiahci_match",87,92
81,13,617,3,105,"sxiahci_attach@95-200@sys/arch/armv7/sunxi/sxiahci.c","sys/arch/armv7/sunxi/sxiahci.c","sxiahci_attach",95,200
8,1,59,2,8,"sxiahci_detach@203-211@sys/arch/armv7/sunxi/sxiahci.c","sys/arch/armv7/sunxi/sxiahci.c","sxiahci_detach",203,211
6,1,47,2,6,"sxiahci_activate@214-220@sys/arch/armv7/sunxi/sxiahci.c","sys/arch/armv7/sunxi/sxiahci.c","sxiahci_activate",214,220
9,1,51,2,11,"sxiahci_port_start@223-234@sys/arch/armv7/sunxi/sxiahci.c","sys/arch/armv7/sunxi/sxiahci.c","sxiahci_port_start",223,234
6,2,45,3,6,"sxidog_match@77-83@sys/arch/armv7/sunxi/sxidog.c","sys/arch/armv7/sunxi/sxidog.c","sxidog_match",77,83
20,4,149,3,27,"sxidog_attach@86-113@sys/arch/armv7/sunxi/sxidog.c","sys/arch/armv7/sunxi/sxidog.c","sxidog_attach",86,113
9,2,33,2,11,"sxidog_activate@116-127@sys/arch/armv7/sunxi/sxidog.c","sys/arch/armv7/sunxi/sxidog.c","sxidog_activate",116,127
28,9,180,2,34,"sxidog_callback@130-164@sys/arch/armv7/sunxi/sxidog.c","sys/arch/armv7/sunxi/sxidog.c","sxidog_callback",130,164
7,2,26,1,7,"sxidog_reset@167-174@sys/arch/armv7/sunxi/sxidog.c","sys/arch/armv7/sunxi/sxidog.c","sxidog_reset",167,174
5,1,34,3,5,"sxie_match@201-206@sys/arch/armv7/sunxi/sxie.c","sys/arch/armv7/sunxi/sxie.c","sxie_match",201,206
49,5,410,3,67,"sxie_attach@209-276@sys/arch/armv7/sunxi/sxie.c","sys/arch/armv7/sunxi/sxie.c","sxie_attach",209,276
33,5,323,1,46,"sxie_socware_init@279-325@sys/arch/armv7/sunxi/sxie.c","sys/arch/armv7/sunxi/sxie.c","sxie_socware_init",279,325
30,1,260,2,45,"sxie_setup_interface@328-373@sys/arch/armv7/sunxi/sxie.c","sys/arch/armv7/sunxi/sxie.c","sxie_setup_interface",328,373
24,1,217,1,43,"sxie_init@376-419@sys/arch/armv7/sunxi/sxie.c","sys/arch/armv7/sunxi/sxie.c","sxie_init",376,419
24,6,147,1,33,"sxie_intr@422-455@sys/arch/armv7/sunxi/sxie.c","sys/arch/armv7/sunxi/sxie.c","sxie_intr",422,455
45,10,310,1,62,"sxie_start@461-523@sys/arch/armv7/sunxi/sxie.c","sys/arch/armv7/sunxi/sxie.c","sxie_start",461,523
8,1,46,1,9,"sxie_stop@526-535@sys/arch/armv7/sunxi/sxie.c","sys/arch/armv7/sunxi/sxie.c","sxie_stop",526,535
7,1,37,1,7,"sxie_reset@538-545@sys/arch/armv7/sunxi/sxie.c","sys/arch/armv7/sunxi/sxie.c","sxie_reset",538,545
12,2,60,1,11,"sxie_watchdog@548-559@sys/arch/armv7/sunxi/sxie.c","sys/arch/armv7/sunxi/sxie.c","sxie_watchdog",548,559
49,9,295,1,61,"sxie_recv@565-626@sys/arch/armv7/sunxi/sxie.c","sys/arch/armv7/sunxi/sxie.c","sxie_recv",565,626
37,11,210,3,39,"sxie_ioctl@629-668@sys/arch/armv7/sunxi/sxie.c","sys/arch/armv7/sunxi/sxie.c","sxie_ioctl",629,668
3,1,14,2,3,"sxie_iff@671-674@sys/arch/armv7/sunxi/sxie.c","sys/arch/armv7/sunxi/sxie.c","sxie_iff",671,674
14,5,109,3,19,"sxie_miibus_readreg@680-699@sys/arch/armv7/sunxi/sxie.c","sys/arch/armv7/sunxi/sxie.c","sxie_miibus_readreg",680,699
14,5,111,4,19,"sxie_miibus_writereg@702-721@sys/arch/armv7/sunxi/sxie.c","sys/arch/armv7/sunxi/sxie.c","sxie_miibus_writereg",702,721
11,4,46,1,15,"sxie_miibus_statchg@724-739@sys/arch/armv7/sunxi/sxie.c","sys/arch/armv7/sunxi/sxie.c","sxie_miibus_statchg",724,739
11,2,63,1,12,"sxie_ifm_change@742-754@sys/arch/armv7/sunxi/sxie.c","sys/arch/armv7/sunxi/sxie.c","sxie_ifm_change",742,754
7,1,56,2,7,"sxie_ifm_status@757-764@sys/arch/armv7/sunxi/sxie.c","sys/arch/armv7/sunxi/sxie.c","sxie_ifm_status",757,764
5,1,34,3,5,"sxiintc_match@167-172@sys/arch/armv7/sunxi/sxiintc.c","sys/arch/armv7/sunxi/sxiintc.c","sxiintc_match",167,172
34,5,263,3,44,"sxiintc_attach@175-219@sys/arch/armv7/sunxi/sxiintc.c","sys/arch/armv7/sunxi/sxiintc.c","sxiintc_attach",175,219
32,9,215,1,40,"sxiintc_calc_masks@222-262@sys/arch/armv7/sunxi/sxiintc.c","sys/arch/armv7/sunxi/sxiintc.c","sxiintc_calc_masks",222,262
7,2,41,1,7,"sxiintc_splx@265-272@sys/arch/armv7/sunxi/sxiintc.c","sys/arch/armv7/sunxi/sxiintc.c","sxiintc_splx",265,272
7,1,33,1,6,"sxiintc_spllower@275-281@sys/arch/armv7/sunxi/sxiintc.c","sys/arch/armv7/sunxi/sxiintc.c","sxiintc_spllower",275,281
10,2,45,1,19,"sxiintc_splraise@284-303@sys/arch/armv7/sunxi/sxiintc.c","sys/arch/armv7/sunxi/sxiintc.c","sxiintc_splraise",284,303
15,4,88,1,20,"sxiintc_setipl@306-326@sys/arch/armv7/sunxi/sxiintc.c","sys/arch/armv7/sunxi/sxiintc.c","sxiintc_setipl",306,326
37,4,258,1,44,"sxiintc_irq_handler@329-373@sys/arch/armv7/sunxi/sxiintc.c","sys/arch/armv7/sunxi/sxiintc.c","sxiintc_irq_handler",329,373
29,5,223,5,37,"sxiintc_intr_establish@376-413@sys/arch/armv7/sunxi/sxiintc.c","sys/arch/armv7/sunxi/sxiintc.c","sxiintc_intr_establish",376,413
5,1,50,6,4,"sxiintc_intr_establish_fdt@416-420@sys/arch/armv7/sunxi/sxiintc.c","sys/arch/armv7/sunxi/sxiintc.c","sxiintc_intr_establish_fdt",416,420
19,2,128,1,25,"sxiintc_intr_disestablish@423-448@sys/arch/armv7/sunxi/sxiintc.c","sys/arch/armv7/sunxi/sxiintc.c","sxiintc_intr_disestablish",423,448
4,1,11,1,3,"sxiintc_intr_string@451-454@sys/arch/armv7/sunxi/sxiintc.c","sys/arch/armv7/sunxi/sxiintc.c","sxiintc_intr_string",451,454
11,4,73,3,12,"sxitimer_match@132-144@sys/arch/armv7/sunxi/sxitimer.c","sys/arch/armv7/sunxi/sxitimer.c","sxitimer_match",132,144
49,3,319,3,76,"sxitimer_attach@147-223@sys/arch/armv7/sunxi/sxitimer.c","sys/arch/armv7/sunxi/sxitimer.c","sxitimer_attach",147,223
29,1,215,1,38,"sxitimer_cpu_initclocks@232-270@sys/arch/armv7/sunxi/sxitimer.c","sys/arch/armv7/sunxi/sxitimer.c","sxitimer_cpu_initclocks",232,270
40,5,211,1,58,"sxitimer_tickintr@290-348@sys/arch/armv7/sunxi/sxitimer.c","sys/arch/armv7/sunxi/sxitimer.c","sxitimer_tickintr",290,348
38,5,217,1,55,"sxitimer_statintr@351-406@sys/arch/armv7/sunxi/sxitimer.c","sys/arch/armv7/sunxi/sxitimer.c","sxitimer_statintr",351,406
11,2,70,1,18,"sxitimer_readcnt64@409-427@sys/arch/armv7/sunxi/sxitimer.c","sys/arch/armv7/sunxi/sxitimer.c","sxitimer_readcnt64",409,427
5,1,19,1,4,"sxitimer_readcnt32@430-434@sys/arch/armv7/sunxi/sxitimer.c","sys/arch/armv7/sunxi/sxitimer.c","sxitimer_readcnt32",430,434
6,2,29,1,6,"sxitimer_sync@437-443@sys/arch/armv7/sunxi/sxitimer.c","sys/arch/armv7/sunxi/sxitimer.c","sxitimer_sync",437,443
8,2,42,1,9,"sxitimer_delay@446-455@sys/arch/armv7/sunxi/sxitimer.c","sys/arch/armv7/sunxi/sxitimer.c","sxitimer_delay",446,455
12,2,68,1,21,"sxitimer_setstatclockrate@458-479@sys/arch/armv7/sunxi/sxitimer.c","sys/arch/armv7/sunxi/sxitimer.c","sxitimer_setstatclockrate",458,479
4,1,19,1,3,"sxitimer_get_timecount@482-485@sys/arch/armv7/sunxi/sxitimer.c","sys/arch/armv7/sunxi/sxitimer.c","sxitimer_get_timecount",482,485
5,1,34,3,5,"sysreg_match@71-76@sys/arch/armv7/vexpress/sysreg.c","sys/arch/armv7/vexpress/sysreg.c","sysreg_match",71,76
17,2,143,3,20,"sysreg_attach@79-99@sys/arch/armv7/vexpress/sysreg.c","sys/arch/armv7/vexpress/sysreg.c","sysreg_attach",79,99
18,3,143,2,21,"sysconf_function@102-123@sys/arch/armv7/vexpress/sysreg.c","sys/arch/armv7/vexpress/sysreg.c","sysconf_function",102,123
7,2,28,1,8,"sysconf_reboot@126-134@sys/arch/armv7/vexpress/sysreg.c","sys/arch/armv7/vexpress/sysreg.c","sysconf_reboot",126,134
7,2,28,1,8,"sysconf_shutdown@137-145@sys/arch/armv7/vexpress/sysreg.c","sys/arch/armv7/vexpress/sysreg.c","sysconf_shutdown",137,145
6,1,50,3,5,"apic_write@85-90@sys/arch/hppa/dev/apic.c","sys/arch/hppa/dev/apic.c","apic_write",85,90
5,1,38,2,4,"apic_read@93-97@sys/arch/hppa/dev/apic.c","sys/arch/hppa/dev/apic.c","apic_read",93,97
15,3,102,1,20,"apic_attach@100-120@sys/arch/hppa/dev/apic.c","sys/arch/hppa/dev/apic.c","apic_attach",100,120
16,3,127,2,18,"apic_intr_map@123-141@sys/arch/hppa/dev/apic.c","sys/arch/hppa/dev/apic.c","apic_intr_map",123,141
7,1,42,2,8,"apic_intr_string@144-152@sys/arch/hppa/dev/apic.c","sys/arch/hppa/dev/apic.c","apic_intr_string",144,152
53,10,411,6,66,"apic_intr_establish@155-221@sys/arch/hppa/dev/apic.c","sys/arch/hppa/dev/apic.c","apic_intr_establish",155,221
3,1,12,2,2,"apic_intr_disestablish@224-226@sys/arch/hppa/dev/apic.c","sys/arch/hppa/dev/apic.c","apic_intr_disestablish",224,226
19,5,121,1,22,"apic_intr@229-251@sys/arch/hppa/dev/apic.c","sys/arch/hppa/dev/apic.c","apic_intr",229,251
21,5,159,1,30,"apic_get_int_tbl@257-287@sys/arch/hppa/dev/apic.c","sys/arch/hppa/dev/apic.c","apic_get_int_tbl",257,287
41,10,217,2,45,"apic_get_int_ent0@290-335@sys/arch/hppa/dev/apic.c","sys/arch/hppa/dev/apic.c","apic_get_int_ent0",290,335
17,3,185,1,18,"apic_dump@339-357@sys/arch/hppa/dev/apic.c","sys/arch/hppa/dev/apic.c","apic_dump",339,357
11,3,54,3,13,"aspmatch@138-151@sys/arch/hppa/dev/asp.c","sys/arch/hppa/dev/asp.c","aspmatch",138,151
44,3,391,3,57,"aspattach@154-211@sys/arch/hppa/dev/asp.c","sys/arch/hppa/dev/asp.c","aspattach",154,211
11,5,69,3,14,"astro_match@208-222@sys/arch/hppa/dev/astro.c","sys/arch/hppa/dev/astro.c","astro_match",208,222
67,6,562,3,108,"astro_attach@225-333@sys/arch/hppa/dev/astro.c","sys/arch/hppa/dev/astro.c","astro_attach",225,333
21,3,133,7,24,"iommu_dvmamap_create@336-360@sys/arch/hppa/dev/astro.c","sys/arch/hppa/dev/astro.c","iommu_dvmamap_create",336,360
10,3,59,2,16,"iommu_dvmamap_destroy@363-379@sys/arch/hppa/dev/astro.c","sys/arch/hppa/dev/astro.c","iommu_dvmamap_destroy",363,379
51,7,387,3,60,"iommu_iomap_load_map@382-442@sys/arch/hppa/dev/astro.c","sys/arch/hppa/dev/astro.c","iommu_iomap_load_map",382,442
10,2,74,6,11,"iommu_dvmamap_load@445-456@sys/arch/hppa/dev/astro.c","sys/arch/hppa/dev/astro.c","iommu_dvmamap_load",445,456
9,2,63,4,10,"iommu_dvmamap_load_mbuf@459-469@sys/arch/hppa/dev/astro.c","sys/arch/hppa/dev/astro.c","iommu_dvmamap_load_mbuf",459,469
6,1,47,4,7,"iommu_dvmamap_load_uio@472-479@sys/arch/hppa/dev/astro.c","sys/arch/hppa/dev/astro.c","iommu_dvmamap_load_uio",472,479
7,1,56,6,8,"iommu_dvmamap_load_raw@482-490@sys/arch/hppa/dev/astro.c","sys/arch/hppa/dev/astro.c","iommu_dvmamap_load_raw",482,490
20,3,154,2,25,"iommu_dvmamap_unload@493-518@sys/arch/hppa/dev/astro.c","sys/arch/hppa/dev/astro.c","iommu_dvmamap_unload",493,518
4,1,20,5,4,"iommu_dvmamap_sync@521-525@sys/arch/hppa/dev/astro.c","sys/arch/hppa/dev/astro.c","iommu_dvmamap_sync",521,525
8,1,62,8,8,"iommu_dvmamem_alloc@528-536@sys/arch/hppa/dev/astro.c","sys/arch/hppa/dev/astro.c","iommu_dvmamem_alloc",528,536
5,1,33,3,5,"iommu_dvmamem_free@539-544@sys/arch/hppa/dev/astro.c","sys/arch/hppa/dev/astro.c","iommu_dvmamem_free",539,544
6,1,52,6,6,"iommu_dvmamem_map@547-553@sys/arch/hppa/dev/astro.c","sys/arch/hppa/dev/astro.c","iommu_dvmamem_map",547,553
5,1,32,3,5,"iommu_dvmamem_unmap@556-561@sys/arch/hppa/dev/astro.c","sys/arch/hppa/dev/astro.c","iommu_dvmamem_unmap",556,561
6,1,51,6,6,"iommu_dvmamem_mmap@564-570@sys/arch/hppa/dev/astro.c","sys/arch/hppa/dev/astro.c","iommu_dvmamem_mmap",564,570
5,3,44,2,4,"iomap_compare@576-580@sys/arch/hppa/dev/astro.c","sys/arch/hppa/dev/astro.c","iomap_compare",576,580
14,3,95,1,19,"iommu_iomap_create@590-609@sys/arch/hppa/dev/astro.c","sys/arch/hppa/dev/astro.c","iommu_iomap_create",590,609
7,3,39,1,9,"iommu_iomap_destroy@615-624@sys/arch/hppa/dev/astro.c","sys/arch/hppa/dev/astro.c","iommu_iomap_destroy",615,624
21,4,140,3,30,"iommu_iomap_insert_page@630-660@sys/arch/hppa/dev/astro.c","sys/arch/hppa/dev/astro.c","iommu_iomap_insert_page",630,660
14,2,89,2,17,"iommu_iomap_translate@666-683@sys/arch/hppa/dev/astro.c","sys/arch/hppa/dev/astro.c","iommu_iomap_translate",666,683
5,1,27,1,4,"iommu_iomap_clear_pages@689-693@sys/arch/hppa/dev/astro.c","sys/arch/hppa/dev/astro.c","iommu_iomap_clear_pages",689,693
21,4,162,5,30,"iommu_enter@699-729@sys/arch/hppa/dev/astro.c","sys/arch/hppa/dev/astro.c","iommu_enter",699,729
19,5,130,2,28,"iommu_remove@735-763@sys/arch/hppa/dev/astro.c","sys/arch/hppa/dev/astro.c","iommu_remove",735,763
12,1,70,1,14,"cpu_initclocks@55-69@sys/arch/hppa/dev/clock.c","sys/arch/hppa/dev/clock.c","cpu_initclocks",55,69
29,9,187,1,57,"cpu_hardclock@72-129@sys/arch/hppa/dev/clock.c","sys/arch/hppa/dev/clock.c","cpu_hardclock",72,129
27,7,190,1,33,"inittodr@135-168@sys/arch/hppa/dev/clock.c","sys/arch/hppa/dev/clock.c","inittodr",135,168
11,3,60,0,17,"resettodr@174-191@sys/arch/hppa/dev/clock.c","sys/arch/hppa/dev/clock.c","resettodr",174,191
3,1,7,1,3,"setstatclockrate@194-197@sys/arch/hppa/dev/clock.c","sys/arch/hppa/dev/clock.c","setstatclockrate",194,197
6,1,24,1,6,"itmr_get_timecount@200-206@sys/arch/hppa/dev/clock.c","sys/arch/hppa/dev/clock.c","itmr_get_timecount",200,206
10,3,57,3,12,"com_dino_match@69-81@sys/arch/hppa/dev/com_dino.c","sys/arch/hppa/dev/com_dino.c","com_dino_match",69,81
26,4,200,3,32,"com_dino_attach@84-116@sys/arch/hppa/dev/com_dino.c","sys/arch/hppa/dev/com_dino.c","com_dino_attach",84,116
10,4,75,3,13,"com_ssio_match@42-55@sys/arch/hppa/dev/com_ssio.c","sys/arch/hppa/dev/com_ssio.c","com_ssio_match",42,55
22,4,169,3,25,"com_ssio_attach@58-83@sys/arch/hppa/dev/com_ssio.c","sys/arch/hppa/dev/com_ssio.c","com_ssio_attach",58,83
11,4,66,3,14,"cpumatch@67-81@sys/arch/hppa/dev/cpu.c","sys/arch/hppa/dev/cpu.c","cpumatch",67,81
80,13,566,3,99,"cpuattach@84-183@sys/arch/hppa/dev/cpu.c","sys/arch/hppa/dev/cpu.c","cpuattach",84,183
27,6,180,1,38,"cpu_boot_secondary_processors@187-225@sys/arch/hppa/dev/cpu.c","sys/arch/hppa/dev/cpu.c","cpu_boot_secondary_processors",187,225
9,1,56,1,12,"cpu_hw_init@228-240@sys/arch/hppa/dev/cpu.c","sys/arch/hppa/dev/cpu.c","cpu_hw_init",228,240
21,2,115,1,30,"cpu_hatch@243-273@sys/arch/hppa/dev/cpu.c","sys/arch/hppa/dev/cpu.c","cpu_hatch",243,273
5,2,24,1,4,"cpu_unidle@276-280@sys/arch/hppa/dev/cpu.c","sys/arch/hppa/dev/cpu.c","cpu_unidle",276,280
8,2,35,1,9,"need_resched@284-293@sys/arch/hppa/dev/cpu.c","sys/arch/hppa/dev/cpu.c","need_resched",284,293
13,4,73,3,18,"dinomatch@138-156@sys/arch/hppa/dev/dino.c","sys/arch/hppa/dev/dino.c","dinomatch",138,156
4,1,19,3,4,"dino_attach_hook@292-296@sys/arch/hppa/dev/dino.c","sys/arch/hppa/dev/dino.c","dino_attach_hook",292,296
4,1,16,2,3,"dino_maxdevs@299-302@sys/arch/hppa/dev/dino.c","sys/arch/hppa/dev/dino.c","dino_maxdevs",299,302
6,4,60,4,6,"dino_make_tag@305-311@sys/arch/hppa/dev/dino.c","sys/arch/hppa/dev/dino.c","dino_make_tag",305,311
9,4,71,5,8,"dino_decompose_tag@314-322@sys/arch/hppa/dev/dino.c","sys/arch/hppa/dev/dino.c","dino_decompose_tag",314,322
4,1,14,2,3,"dino_conf_size@325-328@sys/arch/hppa/dev/dino.c","sys/arch/hppa/dev/dino.c","dino_conf_size",325,328
13,1,77,3,18,"dino_conf_read@331-349@sys/arch/hppa/dev/dino.c","sys/arch/hppa/dev/dino.c","dino_conf_read",331,349
14,1,89,4,20,"dino_conf_write@352-372@sys/arch/hppa/dev/dino.c","sys/arch/hppa/dev/dino.c","dino_conf_write",352,372
11,2,70,2,15,"dino_intr_map@375-390@sys/arch/hppa/dev/dino.c","sys/arch/hppa/dev/dino.c","dino_intr_map",375,390
6,1,34,2,7,"dino_intr_string@393-400@sys/arch/hppa/dev/dino.c","sys/arch/hppa/dev/dino.c","dino_intr_string",393,400
16,5,140,6,19,"dino_intr_establish@403-422@sys/arch/hppa/dev/dino.c","sys/arch/hppa/dev/dino.c","dino_intr_establish",403,422
7,2,54,2,10,"dino_intr_disestablish@425-435@sys/arch/hppa/dev/dino.c","sys/arch/hppa/dev/dino.c","dino_intr_disestablish",425,435
11,3,69,5,13,"dino_iomap@438-451@sys/arch/hppa/dev/dino.c","sys/arch/hppa/dev/dino.c","dino_iomap",438,451
48,12,245,5,56,"dino_memmap@454-510@sys/arch/hppa/dev/dino.c","sys/arch/hppa/dev/dino.c","dino_memmap",454,510
6,1,33,5,5,"dino_subregion@513-518@sys/arch/hppa/dev/dino.c","sys/arch/hppa/dev/dino.c","dino_subregion",513,518
19,6,131,9,22,"dino_ioalloc@521-543@sys/arch/hppa/dev/dino.c","sys/arch/hppa/dev/dino.c","dino_ioalloc",521,543
20,4,142,9,24,"dino_memalloc@546-570@sys/arch/hppa/dev/dino.c","sys/arch/hppa/dev/dino.c","dino_memalloc",546,570
14,3,73,3,17,"dino_unmap@573-590@sys/arch/hppa/dev/dino.c","sys/arch/hppa/dev/dino.c","dino_unmap",573,590
4,1,23,3,4,"dino_free@593-597@sys/arch/hppa/dev/dino.c","sys/arch/hppa/dev/dino.c","dino_free",593,597
4,1,24,5,3,"dino_barrier@600-603@sys/arch/hppa/dev/dino.c","sys/arch/hppa/dev/dino.c","dino_barrier",600,603
42,6,272,3,46,"dino_alloc_parent@607-653@sys/arch/hppa/dev/dino.c","sys/arch/hppa/dev/dino.c","dino_alloc_parent",607,653
7,2,32,2,6,"dino_vaddr@657-663@sys/arch/hppa/dev/dino.c","sys/arch/hppa/dev/dino.c","dino_vaddr",657,663
14,2,88,3,14,"dino_r1@666-680@sys/arch/hppa/dev/dino.c","sys/arch/hppa/dev/dino.c","dino_r1",666,680
16,3,94,3,18,"dino_r2@683-701@sys/arch/hppa/dev/dino.c","sys/arch/hppa/dev/dino.c","dino_r2",683,701
14,2,77,3,16,"dino_r4@704-720@sys/arch/hppa/dev/dino.c","sys/arch/hppa/dev/dino.c","dino_r4",704,720
10,2,51,3,11,"dino_r8@723-734@sys/arch/hppa/dev/dino.c","sys/arch/hppa/dev/dino.c","dino_r8",723,734
12,2,84,4,12,"dino_w1@737-749@sys/arch/hppa/dev/dino.c","sys/arch/hppa/dev/dino.c","dino_w1",737,749
16,3,96,4,18,"dino_w2@752-770@sys/arch/hppa/dev/dino.c","sys/arch/hppa/dev/dino.c","dino_w2",752,770
13,2,76,4,13,"dino_w4@773-786@sys/arch/hppa/dev/dino.c","sys/arch/hppa/dev/dino.c","dino_w4",773,786
8,2,46,4,7,"dino_w8@789-796@sys/arch/hppa/dev/dino.c","sys/arch/hppa/dev/dino.c","dino_w8",789,796
15,3,101,5,17,"dino_rm_1@800-817@sys/arch/hppa/dev/dino.c","sys/arch/hppa/dev/dino.c","dino_rm_1",800,817
17,4,107,5,19,"dino_rm_2@820-839@sys/arch/hppa/dev/dino.c","sys/arch/hppa/dev/dino.c","dino_rm_2",820,839
15,3,98,5,17,"dino_rm_4@842-859@sys/arch/hppa/dev/dino.c","sys/arch/hppa/dev/dino.c","dino_rm_4",842,859
4,1,26,5,3,"dino_rm_8@862-865@sys/arch/hppa/dev/dino.c","sys/arch/hppa/dev/dino.c","dino_rm_8",862,865
15,3,102,5,17,"dino_wm_1@868-885@sys/arch/hppa/dev/dino.c","sys/arch/hppa/dev/dino.c","dino_wm_1",868,885
17,4,108,5,19,"dino_wm_2@888-907@sys/arch/hppa/dev/dino.c","sys/arch/hppa/dev/dino.c","dino_wm_2",888,907
15,3,99,5,17,"dino_wm_4@910-927@sys/arch/hppa/dev/dino.c","sys/arch/hppa/dev/dino.c","dino_wm_4",910,927
4,1,27,5,3,"dino_wm_8@930-933@sys/arch/hppa/dev/dino.c","sys/arch/hppa/dev/dino.c","dino_wm_8",930,933
15,3,98,5,17,"dino_sm_1@936-953@sys/arch/hppa/dev/dino.c","sys/arch/hppa/dev/dino.c","dino_sm_1",936,953
18,4,108,5,20,"dino_sm_2@956-976@sys/arch/hppa/dev/dino.c","sys/arch/hppa/dev/dino.c","dino_sm_2",956,976
16,3,99,5,18,"dino_sm_4@979-997@sys/arch/hppa/dev/dino.c","sys/arch/hppa/dev/dino.c","dino_sm_4",979,997
4,1,25,5,3,"dino_sm_8@1000-1003@sys/arch/hppa/dev/dino.c","sys/arch/hppa/dev/dino.c","dino_sm_8",1000,1003
19,4,117,5,21,"dino_rrm_2@1006-1027@sys/arch/hppa/dev/dino.c","sys/arch/hppa/dev/dino.c","dino_rrm_2",1006,1027
17,3,108,5,19,"dino_rrm_4@1030-1049@sys/arch/hppa/dev/dino.c","sys/arch/hppa/dev/dino.c","dino_rrm_4",1030,1049
5,1,26,5,4,"dino_rrm_8@1052-1056@sys/arch/hppa/dev/dino.c","sys/arch/hppa/dev/dino.c","dino_rrm_8",1052,1056
20,4,121,5,22,"dino_wrm_2@1059-1081@sys/arch/hppa/dev/dino.c","sys/arch/hppa/dev/dino.c","dino_wrm_2",1059,1081
18,3,112,5,20,"dino_wrm_4@1084-1104@sys/arch/hppa/dev/dino.c","sys/arch/hppa/dev/dino.c","dino_wrm_4",1084,1104
5,1,27,5,4,"dino_wrm_8@1107-1111@sys/arch/hppa/dev/dino.c","sys/arch/hppa/dev/dino.c","dino_wrm_8",1107,1111
18,4,122,5,19,"dino_rr_1@1114-1133@sys/arch/hppa/dev/dino.c","sys/arch/hppa/dev/dino.c","dino_rr_1",1114,1133
23,5,144,5,24,"dino_rr_2@1136-1160@sys/arch/hppa/dev/dino.c","sys/arch/hppa/dev/dino.c","dino_rr_2",1136,1160
20,4,124,5,21,"dino_rr_4@1163-1184@sys/arch/hppa/dev/dino.c","sys/arch/hppa/dev/dino.c","dino_rr_4",1163,1184
4,1,26,5,3,"dino_rr_8@1187-1190@sys/arch/hppa/dev/dino.c","sys/arch/hppa/dev/dino.c","dino_rr_8",1187,1190
18,4,123,5,19,"dino_wr_1@1193-1212@sys/arch/hppa/dev/dino.c","sys/arch/hppa/dev/dino.c","dino_wr_1",1193,1212
23,5,145,5,24,"dino_wr_2@1215-1239@sys/arch/hppa/dev/dino.c","sys/arch/hppa/dev/dino.c","dino_wr_2",1215,1239
20,4,125,5,21,"dino_wr_4@1242-1263@sys/arch/hppa/dev/dino.c","sys/arch/hppa/dev/dino.c","dino_wr_4",1242,1263
4,1,27,5,3,"dino_wr_8@1266-1269@sys/arch/hppa/dev/dino.c","sys/arch/hppa/dev/dino.c","dino_wr_8",1266,1269
22,5,139,5,23,"dino_rrr_2@1272-1295@sys/arch/hppa/dev/dino.c","sys/arch/hppa/dev/dino.c","dino_rrr_2",1272,1295
19,4,119,5,20,"dino_rrr_4@1298-1318@sys/arch/hppa/dev/dino.c","sys/arch/hppa/dev/dino.c","dino_rrr_4",1298,1318
5,1,26,5,4,"dino_rrr_8@1321-1325@sys/arch/hppa/dev/dino.c","sys/arch/hppa/dev/dino.c","dino_rrr_8",1321,1325
23,5,142,5,24,"dino_wrr_2@1328-1352@sys/arch/hppa/dev/dino.c","sys/arch/hppa/dev/dino.c","dino_wrr_2",1328,1352
20,4,122,5,21,"dino_wrr_4@1355-1376@sys/arch/hppa/dev/dino.c","sys/arch/hppa/dev/dino.c","dino_wrr_4",1355,1376
5,1,27,5,4,"dino_wrr_8@1379-1383@sys/arch/hppa/dev/dino.c","sys/arch/hppa/dev/dino.c","dino_wrr_8",1379,1383
18,4,117,5,19,"dino_sr_1@1386-1405@sys/arch/hppa/dev/dino.c","sys/arch/hppa/dev/dino.c","dino_sr_1",1386,1405
21,5,128,5,22,"dino_sr_2@1408-1430@sys/arch/hppa/dev/dino.c","sys/arch/hppa/dev/dino.c","dino_sr_2",1408,1430
18,4,108,5,19,"dino_sr_4@1433-1452@sys/arch/hppa/dev/dino.c","sys/arch/hppa/dev/dino.c","dino_sr_4",1433,1452
4,1,25,5,3,"dino_sr_8@1455-1458@sys/arch/hppa/dev/dino.c","sys/arch/hppa/dev/dino.c","dino_sr_8",1455,1458
6,2,48,6,5,"dino_cp_1@1461-1466@sys/arch/hppa/dev/dino.c","sys/arch/hppa/dev/dino.c","dino_cp_1",1461,1466
9,2,56,6,8,"dino_cp_2@1469-1477@sys/arch/hppa/dev/dino.c","sys/arch/hppa/dev/dino.c","dino_cp_2",1469,1477
9,2,56,6,8,"dino_cp_4@1480-1488@sys/arch/hppa/dev/dino.c","sys/arch/hppa/dev/dino.c","dino_cp_4",1480,1488
9,2,56,6,8,"dino_cp_8@1491-1499@sys/arch/hppa/dev/dino.c","sys/arch/hppa/dev/dino.c","dino_cp_8",1491,1499
7,1,56,7,9,"dino_dmamap_create@1523-1532@sys/arch/hppa/dev/dino.c","sys/arch/hppa/dev/dino.c","dino_dmamap_create",1523,1532
5,1,27,2,5,"dino_dmamap_destroy@1535-1540@sys/arch/hppa/dev/dino.c","sys/arch/hppa/dev/dino.c","dino_dmamap_destroy",1535,1540
6,1,53,6,6,"dino_dmamap_load@1543-1549@sys/arch/hppa/dev/dino.c","sys/arch/hppa/dev/dino.c","dino_dmamap_load",1543,1549
5,1,42,4,5,"dino_dmamap_load_mbuf@1552-1557@sys/arch/hppa/dev/dino.c","sys/arch/hppa/dev/dino.c","dino_dmamap_load_mbuf",1552,1557
5,1,42,4,5,"dino_dmamap_load_uio@1560-1565@sys/arch/hppa/dev/dino.c","sys/arch/hppa/dev/dino.c","dino_dmamap_load_uio",1560,1565
6,1,51,6,6,"dino_dmamap_load_raw@1568-1574@sys/arch/hppa/dev/dino.c","sys/arch/hppa/dev/dino.c","dino_dmamap_load_raw",1568,1574
5,1,27,2,5,"dino_dmamap_unload@1577-1582@sys/arch/hppa/dev/dino.c","sys/arch/hppa/dev/dino.c","dino_dmamap_unload",1577,1582
6,1,45,5,6,"dino_dmamap_sync@1585-1591@sys/arch/hppa/dev/dino.c","sys/arch/hppa/dev/dino.c","dino_dmamap_sync",1585,1591
8,1,62,8,8,"dino_dmamem_alloc@1594-1602@sys/arch/hppa/dev/dino.c","sys/arch/hppa/dev/dino.c","dino_dmamem_alloc",1594,1602
5,1,33,3,5,"dino_dmamem_free@1605-1610@sys/arch/hppa/dev/dino.c","sys/arch/hppa/dev/dino.c","dino_dmamem_free",1605,1610
6,1,52,6,6,"dino_dmamem_map@1613-1619@sys/arch/hppa/dev/dino.c","sys/arch/hppa/dev/dino.c","dino_dmamem_map",1613,1619
5,1,32,3,5,"dino_dmamem_unmap@1622-1627@sys/arch/hppa/dev/dino.c","sys/arch/hppa/dev/dino.c","dino_dmamem_unmap",1622,1627
6,1,51,6,6,"dino_dmamem_mmap@1630-1636@sys/arch/hppa/dev/dino.c","sys/arch/hppa/dev/dino.c","dino_dmamem_mmap",1630,1636
7,2,40,2,7,"dinoprint@1663-1670@sys/arch/hppa/dev/dino.c","sys/arch/hppa/dev/dino.c","dinoprint",1663,1670
110,16,808,3,139,"dinoattach@1673-1812@sys/arch/hppa/dev/dino.c","sys/arch/hppa/dev/dino.c","dinoattach",1673,1812
10,2,52,1,12,"dino_clear_pdc_mappings@1815-1827@sys/arch/hppa/dev/dino.c","sys/arch/hppa/dev/dino.c","dino_clear_pdc_mappings",1815,1827
10,6,78,3,12,"elroy_match@185-197@sys/arch/hppa/dev/elroy.c","sys/arch/hppa/dev/elroy.c","elroy_match",185,197
4,1,17,2,3,"elroy_write32@200-203@sys/arch/hppa/dev/elroy.c","sys/arch/hppa/dev/elroy.c","elroy_write32",200,203
4,1,13,1,3,"elroy_read32@206-209@sys/arch/hppa/dev/elroy.c","sys/arch/hppa/dev/elroy.c","elroy_read32",206,209
4,1,19,3,4,"elroy_attach_hook@212-216@sys/arch/hppa/dev/elroy.c","sys/arch/hppa/dev/elroy.c","elroy_attach_hook",212,216
4,1,16,2,3,"elroy_maxdevs@219-222@sys/arch/hppa/dev/elroy.c","sys/arch/hppa/dev/elroy.c","elroy_maxdevs",219,222
6,4,60,4,6,"elroy_make_tag@225-231@sys/arch/hppa/dev/elroy.c","sys/arch/hppa/dev/elroy.c","elroy_make_tag",225,231
9,4,71,5,8,"elroy_decompose_tag@234-242@sys/arch/hppa/dev/elroy.c","sys/arch/hppa/dev/elroy.c","elroy_decompose_tag",234,242
4,1,14,2,3,"elroy_conf_size@245-248@sys/arch/hppa/dev/elroy.c","sys/arch/hppa/dev/elroy.c","elroy_conf_size",245,248
27,3,229,3,32,"elroy_conf_read@251-283@sys/arch/hppa/dev/elroy.c","sys/arch/hppa/dev/elroy.c","elroy_conf_read",251,283
29,3,266,4,34,"elroy_conf_write@286-320@sys/arch/hppa/dev/elroy.c","sys/arch/hppa/dev/elroy.c","elroy_conf_write",286,320
10,2,66,5,12,"elroy_iomap@323-335@sys/arch/hppa/dev/elroy.c","sys/arch/hppa/dev/elroy.c","elroy_iomap",323,335
9,2,62,5,11,"elroy_memmap@338-349@sys/arch/hppa/dev/elroy.c","sys/arch/hppa/dev/elroy.c","elroy_memmap",338,349
6,1,33,5,5,"elroy_subregion@352-357@sys/arch/hppa/dev/elroy.c","sys/arch/hppa/dev/elroy.c","elroy_subregion",352,357
18,4,142,9,20,"elroy_ioalloc@360-380@sys/arch/hppa/dev/elroy.c","sys/arch/hppa/dev/elroy.c","elroy_ioalloc",360,380
10,2,76,9,12,"elroy_memalloc@383-395@sys/arch/hppa/dev/elroy.c","sys/arch/hppa/dev/elroy.c","elroy_memalloc",383,395
5,1,32,3,5,"elroy_unmap@398-403@sys/arch/hppa/dev/elroy.c","sys/arch/hppa/dev/elroy.c","elroy_unmap",398,403
4,1,23,3,4,"elroy_free@406-410@sys/arch/hppa/dev/elroy.c","sys/arch/hppa/dev/elroy.c","elroy_free",406,410
11,2,62,5,11,"elroy_barrier@413-424@sys/arch/hppa/dev/elroy.c","sys/arch/hppa/dev/elroy.c","elroy_barrier",413,424
43,7,277,3,51,"elroy_alloc_parent@428-479@sys/arch/hppa/dev/elroy.c","sys/arch/hppa/dev/elroy.c","elroy_alloc_parent",428,479
4,1,20,2,3,"elroy_vaddr@483-486@sys/arch/hppa/dev/elroy.c","sys/arch/hppa/dev/elroy.c","elroy_vaddr",483,486
5,1,27,3,4,"elroy_r1@489-493@sys/arch/hppa/dev/elroy.c","sys/arch/hppa/dev/elroy.c","elroy_r1",489,493
7,1,41,3,7,"elroy_r2@496-503@sys/arch/hppa/dev/elroy.c","sys/arch/hppa/dev/elroy.c","elroy_r2",496,503
7,1,39,3,7,"elroy_r4@506-513@sys/arch/hppa/dev/elroy.c","sys/arch/hppa/dev/elroy.c","elroy_r4",506,513
7,1,39,3,7,"elroy_r8@516-523@sys/arch/hppa/dev/elroy.c","sys/arch/hppa/dev/elroy.c","elroy_r8",516,523
5,1,31,4,4,"elroy_w1@526-530@sys/arch/hppa/dev/elroy.c","sys/arch/hppa/dev/elroy.c","elroy_w1",526,530
7,1,43,4,7,"elroy_w2@533-540@sys/arch/hppa/dev/elroy.c","sys/arch/hppa/dev/elroy.c","elroy_w2",533,540
6,1,38,4,5,"elroy_w4@543-548@sys/arch/hppa/dev/elroy.c","sys/arch/hppa/dev/elroy.c","elroy_w4",543,548
5,1,34,4,4,"elroy_w8@551-555@sys/arch/hppa/dev/elroy.c","sys/arch/hppa/dev/elroy.c","elroy_w8",551,555
8,2,51,5,8,"elroy_rm_1@559-567@sys/arch/hppa/dev/elroy.c","sys/arch/hppa/dev/elroy.c","elroy_rm_1",559,567
8,2,54,5,8,"elroy_rm_2@570-578@sys/arch/hppa/dev/elroy.c","sys/arch/hppa/dev/elroy.c","elroy_rm_2",570,578
8,2,54,5,8,"elroy_rm_4@581-589@sys/arch/hppa/dev/elroy.c","sys/arch/hppa/dev/elroy.c","elroy_rm_4",581,589
8,2,54,5,8,"elroy_rm_8@592-600@sys/arch/hppa/dev/elroy.c","sys/arch/hppa/dev/elroy.c","elroy_rm_8",592,600
8,2,52,5,8,"elroy_wm_1@603-611@sys/arch/hppa/dev/elroy.c","sys/arch/hppa/dev/elroy.c","elroy_wm_1",603,611
8,2,55,5,8,"elroy_wm_2@614-622@sys/arch/hppa/dev/elroy.c","sys/arch/hppa/dev/elroy.c","elroy_wm_2",614,622
8,2,55,5,8,"elroy_wm_4@625-633@sys/arch/hppa/dev/elroy.c","sys/arch/hppa/dev/elroy.c","elroy_wm_4",625,633
8,2,55,5,8,"elroy_wm_8@636-644@sys/arch/hppa/dev/elroy.c","sys/arch/hppa/dev/elroy.c","elroy_wm_8",636,644
8,2,48,5,8,"elroy_sm_1@647-655@sys/arch/hppa/dev/elroy.c","sys/arch/hppa/dev/elroy.c","elroy_sm_1",647,655
9,2,55,5,9,"elroy_sm_2@658-667@sys/arch/hppa/dev/elroy.c","sys/arch/hppa/dev/elroy.c","elroy_sm_2",658,667
9,2,55,5,9,"elroy_sm_4@670-679@sys/arch/hppa/dev/elroy.c","sys/arch/hppa/dev/elroy.c","elroy_sm_4",670,679
9,2,55,5,9,"elroy_sm_8@682-691@sys/arch/hppa/dev/elroy.c","sys/arch/hppa/dev/elroy.c","elroy_sm_8",682,691
10,2,64,5,10,"elroy_rrm_2@694-704@sys/arch/hppa/dev/elroy.c","sys/arch/hppa/dev/elroy.c","elroy_rrm_2",694,704
10,2,64,5,10,"elroy_rrm_4@707-717@sys/arch/hppa/dev/elroy.c","sys/arch/hppa/dev/elroy.c","elroy_rrm_4",707,717
10,2,64,5,10,"elroy_rrm_8@720-730@sys/arch/hppa/dev/elroy.c","sys/arch/hppa/dev/elroy.c","elroy_rrm_8",720,730
11,2,68,5,11,"elroy_wrm_2@733-744@sys/arch/hppa/dev/elroy.c","sys/arch/hppa/dev/elroy.c","elroy_wrm_2",733,744
11,2,68,5,11,"elroy_wrm_4@747-758@sys/arch/hppa/dev/elroy.c","sys/arch/hppa/dev/elroy.c","elroy_wrm_4",747,758
11,2,68,5,11,"elroy_wrm_8@761-772@sys/arch/hppa/dev/elroy.c","sys/arch/hppa/dev/elroy.c","elroy_wrm_8",761,772
8,2,52,5,8,"elroy_rr_1@775-783@sys/arch/hppa/dev/elroy.c","sys/arch/hppa/dev/elroy.c","elroy_rr_1",775,783
10,2,63,5,10,"elroy_rr_2@786-796@sys/arch/hppa/dev/elroy.c","sys/arch/hppa/dev/elroy.c","elroy_rr_2",786,796
10,2,63,5,10,"elroy_rr_4@799-809@sys/arch/hppa/dev/elroy.c","sys/arch/hppa/dev/elroy.c","elroy_rr_4",799,809
10,2,63,5,10,"elroy_rr_8@812-822@sys/arch/hppa/dev/elroy.c","sys/arch/hppa/dev/elroy.c","elroy_rr_8",812,822
8,2,53,5,8,"elroy_wr_1@825-833@sys/arch/hppa/dev/elroy.c","sys/arch/hppa/dev/elroy.c","elroy_wr_1",825,833
10,2,64,5,10,"elroy_wr_2@836-846@sys/arch/hppa/dev/elroy.c","sys/arch/hppa/dev/elroy.c","elroy_wr_2",836,846
10,2,64,5,10,"elroy_wr_4@849-859@sys/arch/hppa/dev/elroy.c","sys/arch/hppa/dev/elroy.c","elroy_wr_4",849,859
10,2,64,5,10,"elroy_wr_8@862-872@sys/arch/hppa/dev/elroy.c","sys/arch/hppa/dev/elroy.c","elroy_wr_8",862,872
10,2,65,5,10,"elroy_rrr_2@875-885@sys/arch/hppa/dev/elroy.c","sys/arch/hppa/dev/elroy.c","elroy_rrr_2",875,885
10,2,65,5,10,"elroy_rrr_4@888-898@sys/arch/hppa/dev/elroy.c","sys/arch/hppa/dev/elroy.c","elroy_rrr_4",888,898
10,2,65,5,10,"elroy_rrr_8@901-911@sys/arch/hppa/dev/elroy.c","sys/arch/hppa/dev/elroy.c","elroy_rrr_8",901,911
11,2,68,5,11,"elroy_wrr_2@914-925@sys/arch/hppa/dev/elroy.c","sys/arch/hppa/dev/elroy.c","elroy_wrr_2",914,925
11,2,68,5,11,"elroy_wrr_4@928-939@sys/arch/hppa/dev/elroy.c","sys/arch/hppa/dev/elroy.c","elroy_wrr_4",928,939
11,2,68,5,11,"elroy_wrr_8@942-953@sys/arch/hppa/dev/elroy.c","sys/arch/hppa/dev/elroy.c","elroy_wrr_8",942,953
8,2,49,5,8,"elroy_sr_1@956-964@sys/arch/hppa/dev/elroy.c","sys/arch/hppa/dev/elroy.c","elroy_sr_1",956,964
9,2,56,5,9,"elroy_sr_2@967-976@sys/arch/hppa/dev/elroy.c","sys/arch/hppa/dev/elroy.c","elroy_sr_2",967,976
9,2,56,5,9,"elroy_sr_4@979-988@sys/arch/hppa/dev/elroy.c","sys/arch/hppa/dev/elroy.c","elroy_sr_4",979,988
9,2,56,5,9,"elroy_sr_8@991-1000@sys/arch/hppa/dev/elroy.c","sys/arch/hppa/dev/elroy.c","elroy_sr_8",991,1000
6,2,48,6,5,"elroy_cp_1@1003-1008@sys/arch/hppa/dev/elroy.c","sys/arch/hppa/dev/elroy.c","elroy_cp_1",1003,1008
9,2,56,6,8,"elroy_cp_2@1011-1019@sys/arch/hppa/dev/elroy.c","sys/arch/hppa/dev/elroy.c","elroy_cp_2",1011,1019
9,2,56,6,8,"elroy_cp_4@1022-1030@sys/arch/hppa/dev/elroy.c","sys/arch/hppa/dev/elroy.c","elroy_cp_4",1022,1030
9,2,56,6,8,"elroy_cp_8@1033-1041@sys/arch/hppa/dev/elroy.c","sys/arch/hppa/dev/elroy.c","elroy_cp_8",1033,1041
7,1,56,7,9,"elroy_dmamap_create@1093-1102@sys/arch/hppa/dev/elroy.c","sys/arch/hppa/dev/elroy.c","elroy_dmamap_create",1093,1102
5,1,27,2,5,"elroy_dmamap_destroy@1105-1110@sys/arch/hppa/dev/elroy.c","sys/arch/hppa/dev/elroy.c","elroy_dmamap_destroy",1105,1110
6,1,53,6,6,"elroy_dmamap_load@1113-1119@sys/arch/hppa/dev/elroy.c","sys/arch/hppa/dev/elroy.c","elroy_dmamap_load",1113,1119
5,1,42,4,5,"elroy_dmamap_load_mbuf@1122-1127@sys/arch/hppa/dev/elroy.c","sys/arch/hppa/dev/elroy.c","elroy_dmamap_load_mbuf",1122,1127
5,1,42,4,5,"elroy_dmamap_load_uio@1130-1135@sys/arch/hppa/dev/elroy.c","sys/arch/hppa/dev/elroy.c","elroy_dmamap_load_uio",1130,1135
6,1,51,6,6,"elroy_dmamap_load_raw@1138-1144@sys/arch/hppa/dev/elroy.c","sys/arch/hppa/dev/elroy.c","elroy_dmamap_load_raw",1138,1144
5,1,27,2,5,"elroy_dmamap_unload@1147-1152@sys/arch/hppa/dev/elroy.c","sys/arch/hppa/dev/elroy.c","elroy_dmamap_unload",1147,1152
6,1,42,5,6,"elroy_dmamap_sync@1155-1161@sys/arch/hppa/dev/elroy.c","sys/arch/hppa/dev/elroy.c","elroy_dmamap_sync",1155,1161
8,1,62,8,8,"elroy_dmamem_alloc@1164-1172@sys/arch/hppa/dev/elroy.c","sys/arch/hppa/dev/elroy.c","elroy_dmamem_alloc",1164,1172
5,1,33,3,5,"elroy_dmamem_free@1175-1180@sys/arch/hppa/dev/elroy.c","sys/arch/hppa/dev/elroy.c","elroy_dmamem_free",1175,1180
6,1,52,6,6,"elroy_dmamem_map@1183-1189@sys/arch/hppa/dev/elroy.c","sys/arch/hppa/dev/elroy.c","elroy_dmamem_map",1183,1189
5,1,32,3,5,"elroy_dmamem_unmap@1192-1197@sys/arch/hppa/dev/elroy.c","sys/arch/hppa/dev/elroy.c","elroy_dmamem_unmap",1192,1197
6,1,51,6,6,"elroy_dmamem_mmap@1200-1206@sys/arch/hppa/dev/elroy.c","sys/arch/hppa/dev/elroy.c","elroy_dmamem_mmap",1200,1206
7,2,40,2,7,"elroy_print@1235-1242@sys/arch/hppa/dev/elroy.c","sys/arch/hppa/dev/elroy.c","elroy_print",1235,1242
89,15,712,3,106,"elroy_attach@1245-1351@sys/arch/hppa/dev/elroy.c","sys/arch/hppa/dev/elroy.c","elroy_attach",1245,1351
11,5,75,3,13,"gecko_match@51-64@sys/arch/hppa/dev/gecko.c","sys/arch/hppa/dev/gecko.c","gecko_match",51,64
19,3,141,3,24,"gecko_attach@67-91@sys/arch/hppa/dev/gecko.c","sys/arch/hppa/dev/gecko.c","gecko_attach",67,91
11,3,55,3,13,"lasimatch@89-102@sys/arch/hppa/dev/lasi.c","sys/arch/hppa/dev/lasi.c","lasimatch",89,102
93,32,635,3,111,"lasiattach@105-216@sys/arch/hppa/dev/lasi.c","sys/arch/hppa/dev/lasi.c","lasiattach",105,216
9,1,62,1,9,"lasi_gsc_attach@219-228@sys/arch/hppa/dev/lasi.c","sys/arch/hppa/dev/lasi.c","lasi_gsc_attach",219,228
18,5,74,1,19,"lasi_cold_hook@231-250@sys/arch/hppa/dev/lasi.c","sys/arch/hppa/dev/lasi.c","lasi_cold_hook",231,250
7,2,47,3,8,"lcd_match@65-73@sys/arch/hppa/dev/lcd.c","sys/arch/hppa/dev/lcd.c","lcd_match",65,73
28,4,223,3,34,"lcd_attach@76-110@sys/arch/hppa/dev/lcd.c","sys/arch/hppa/dev/lcd.c","lcd_attach",76,110
9,1,80,1,10,"lcd_mountroot@113-123@sys/arch/hppa/dev/lcd.c","sys/arch/hppa/dev/lcd.c","lcd_mountroot",113,123
7,2,45,2,6,"lcd_write@126-132@sys/arch/hppa/dev/lcd.c","sys/arch/hppa/dev/lcd.c","lcd_write",126,132
7,1,67,2,7,"lcd_blink@135-142@sys/arch/hppa/dev/lcd.c","sys/arch/hppa/dev/lcd.c","lcd_blink",135,142
10,2,58,1,11,"lcd_blink_finish@145-156@sys/arch/hppa/dev/lcd.c","sys/arch/hppa/dev/lcd.c","lcd_blink_finish",145,156
10,4,75,3,13,"lpt_ssio_match@38-51@sys/arch/hppa/dev/lpt_ssio.c","sys/arch/hppa/dev/lpt_ssio.c","lpt_ssio_match",38,51
14,2,103,3,16,"lpt_ssio_attach@54-70@sys/arch/hppa/dev/lpt_ssio.c","sys/arch/hppa/dev/lpt_ssio.c","lpt_ssio_attach",54,70
4,1,19,3,3,"mg_eisa_attach_hook@115-118@sys/arch/hppa/dev/mongoose.c","sys/arch/hppa/dev/mongoose.c","mg_eisa_attach_hook",115,118
5,1,23,3,4,"mg_intr_map@121-125@sys/arch/hppa/dev/mongoose.c","sys/arch/hppa/dev/mongoose.c","mg_intr_map",121,125
6,1,33,2,6,"mg_intr_string@128-134@sys/arch/hppa/dev/mongoose.c","sys/arch/hppa/dev/mongoose.c","mg_intr_string",128,134
4,1,19,3,4,"mg_isa_attach_hook@137-141@sys/arch/hppa/dev/mongoose.c","sys/arch/hppa/dev/mongoose.c","mg_isa_attach_hook",137,141
36,13,251,7,48,"mg_intr_establish@144-192@sys/arch/hppa/dev/mongoose.c","sys/arch/hppa/dev/mongoose.c","mg_intr_establish",144,192
15,4,91,2,18,"mg_intr_disestablish@195-213@sys/arch/hppa/dev/mongoose.c","sys/arch/hppa/dev/mongoose.c","mg_intr_disestablish",195,213
4,1,17,3,3,"mg_intr_check@216-219@sys/arch/hppa/dev/mongoose.c","sys/arch/hppa/dev/mongoose.c","mg_intr_check",216,219
11,1,65,1,12,"mg_intr@222-234@sys/arch/hppa/dev/mongoose.c","sys/arch/hppa/dev/mongoose.c","mg_intr",222,234
11,3,85,5,14,"mg_eisa_iomap@237-251@sys/arch/hppa/dev/mongoose.c","sys/arch/hppa/dev/mongoose.c","mg_eisa_iomap",237,251
5,1,25,5,5,"mg_eisa_memmap@254-259@sys/arch/hppa/dev/mongoose.c","sys/arch/hppa/dev/mongoose.c","mg_eisa_memmap",254,259
3,1,14,3,3,"mg_eisa_memunmap@262-265@sys/arch/hppa/dev/mongoose.c","sys/arch/hppa/dev/mongoose.c","mg_eisa_memunmap",262,265
4,1,24,5,3,"mg_isa_barrier@268-271@sys/arch/hppa/dev/mongoose.c","sys/arch/hppa/dev/mongoose.c","mg_isa_barrier",268,271
5,1,38,3,4,"mg_isa_r2@274-278@sys/arch/hppa/dev/mongoose.c","sys/arch/hppa/dev/mongoose.c","mg_isa_r2",274,278
5,1,38,3,4,"mg_isa_r4@281-285@sys/arch/hppa/dev/mongoose.c","sys/arch/hppa/dev/mongoose.c","mg_isa_r4",281,285
4,1,36,4,3,"mg_isa_w2@288-291@sys/arch/hppa/dev/mongoose.c","sys/arch/hppa/dev/mongoose.c","mg_isa_w2",288,291
4,1,36,4,3,"mg_isa_w4@294-297@sys/arch/hppa/dev/mongoose.c","sys/arch/hppa/dev/mongoose.c","mg_isa_w4",294,297
6,2,47,5,5,"mg_isa_rm_2@300-305@sys/arch/hppa/dev/mongoose.c","sys/arch/hppa/dev/mongoose.c","mg_isa_rm_2",300,305
6,2,47,5,5,"mg_isa_rm_4@308-313@sys/arch/hppa/dev/mongoose.c","sys/arch/hppa/dev/mongoose.c","mg_isa_rm_4",308,313
9,2,58,5,8,"mg_isa_wm_2@316-324@sys/arch/hppa/dev/mongoose.c","sys/arch/hppa/dev/mongoose.c","mg_isa_wm_2",316,324
9,2,58,5,8,"mg_isa_wm_4@327-335@sys/arch/hppa/dev/mongoose.c","sys/arch/hppa/dev/mongoose.c","mg_isa_wm_4",327,335
7,2,46,5,6,"mg_isa_sm_2@338-344@sys/arch/hppa/dev/mongoose.c","sys/arch/hppa/dev/mongoose.c","mg_isa_sm_2",338,344
7,2,46,5,6,"mg_isa_sm_4@347-353@sys/arch/hppa/dev/mongoose.c","sys/arch/hppa/dev/mongoose.c","mg_isa_sm_4",347,353
9,2,61,5,9,"mg_isa_rr_2@356-365@sys/arch/hppa/dev/mongoose.c","sys/arch/hppa/dev/mongoose.c","mg_isa_rr_2",356,365
9,2,61,5,9,"mg_isa_rr_4@368-377@sys/arch/hppa/dev/mongoose.c","sys/arch/hppa/dev/mongoose.c","mg_isa_rr_4",368,377
9,2,62,5,9,"mg_isa_wr_2@380-389@sys/arch/hppa/dev/mongoose.c","sys/arch/hppa/dev/mongoose.c","mg_isa_wr_2",380,389
9,2,62,5,9,"mg_isa_wr_4@392-401@sys/arch/hppa/dev/mongoose.c","sys/arch/hppa/dev/mongoose.c","mg_isa_wr_4",392,401
7,2,53,5,7,"mg_isa_sr_2@404-411@sys/arch/hppa/dev/mongoose.c","sys/arch/hppa/dev/mongoose.c","mg_isa_sr_2",404,411
7,2,53,5,7,"mg_isa_sr_4@414-421@sys/arch/hppa/dev/mongoose.c","sys/arch/hppa/dev/mongoose.c","mg_isa_sr_4",414,421
72,3,671,1,93,"mgattach_common@424-517@sys/arch/hppa/dev/mongoose.c","sys/arch/hppa/dev/mongoose.c","mgattach_common",424,517
9,2,44,2,10,"mgprint@520-530@sys/arch/hppa/dev/mongoose.c","sys/arch/hppa/dev/mongoose.c","mgprint",520,530
17,5,104,3,23,"mgmatch_gedoens@533-556@sys/arch/hppa/dev/mongoose.c","sys/arch/hppa/dev/mongoose.c","mgmatch_gedoens",533,556
29,4,214,3,34,"mgattach_gedoens@559-593@sys/arch/hppa/dev/mongoose.c","sys/arch/hppa/dev/mongoose.c","mgattach_gedoens",559,593
36,8,325,0,54,"pdc_init@102-156@sys/arch/hppa/dev/pdc.c","sys/arch/hppa/dev/pdc.c","pdc_init",102,156
11,3,61,3,13,"pdcmatch@159-172@sys/arch/hppa/dev/pdc.c","sys/arch/hppa/dev/pdc.c","pdcmatch",159,172
11,2,62,3,13,"pdcattach@175-188@sys/arch/hppa/dev/pdc.c","sys/arch/hppa/dev/pdc.c","pdcattach",175,188
41,9,271,4,47,"pdcopen@191-238@sys/arch/hppa/dev/pdc.c","sys/arch/hppa/dev/pdc.c","pdcopen",191,238
16,3,108,4,17,"pdcclose@241-258@sys/arch/hppa/dev/pdc.c","sys/arch/hppa/dev/pdc.c","pdcclose",241,258
13,3,91,3,14,"pdcread@261-275@sys/arch/hppa/dev/pdc.c","sys/arch/hppa/dev/pdc.c","pdcread",261,275
13,3,91,3,14,"pdcwrite@278-292@sys/arch/hppa/dev/pdc.c","sys/arch/hppa/dev/pdc.c","pdcwrite",278,292
22,5,143,5,24,"pdcioctl@295-319@sys/arch/hppa/dev/pdc.c","sys/arch/hppa/dev/pdc.c","pdcioctl",295,319
6,1,21,2,6,"pdcparam@322-328@sys/arch/hppa/dev/pdc.c","sys/arch/hppa/dev/pdc.c","pdcparam",322,328
16,3,88,1,16,"pdcstart@331-347@sys/arch/hppa/dev/pdc.c","sys/arch/hppa/dev/pdc.c","pdcstart",331,347
12,3,59,2,12,"pdcstop@350-362@sys/arch/hppa/dev/pdc.c","sys/arch/hppa/dev/pdc.c","pdcstop",350,362
12,3,78,1,12,"pdctimeout@365-377@sys/arch/hppa/dev/pdc.c","sys/arch/hppa/dev/pdc.c","pdctimeout",365,377
9,3,51,1,10,"pdctty@380-390@sys/arch/hppa/dev/pdc.c","sys/arch/hppa/dev/pdc.c","pdctty",380,390
15,3,96,2,19,"pdccnlookc@393-412@sys/arch/hppa/dev/pdc.c","sys/arch/hppa/dev/pdc.c","pdccnlookc",393,412
10,3,37,1,12,"pdccngetc@415-427@sys/arch/hppa/dev/pdc.c","sys/arch/hppa/dev/pdc.c","pdccngetc",415,427
14,3,83,2,17,"pdccnputc@430-447@sys/arch/hppa/dev/pdc.c","sys/arch/hppa/dev/pdc.c","pdccnputc",430,447
8,3,52,3,9,"phantomasmatch@56-65@sys/arch/hppa/dev/phantomas.c","sys/arch/hppa/dev/phantomas.c","phantomasmatch",56,65
8,1,57,3,9,"phantomasattach@68-77@sys/arch/hppa/dev/phantomas.c","sys/arch/hppa/dev/phantomas.c","phantomasattach",68,77
8,3,59,3,9,"powermatch@73-82@sys/arch/hppa/dev/power.c","sys/arch/hppa/dev/power.c","powermatch",73,82
29,8,163,3,33,"powerattach@85-118@sys/arch/hppa/dev/power.c","sys/arch/hppa/dev/power.c","powerattach",85,118
6,1,26,1,7,"power_intr@121-128@sys/arch/hppa/dev/power.c","sys/arch/hppa/dev/power.c","power_intr",121,128
7,2,42,1,7,"power_thread_create@131-138@sys/arch/hppa/dev/power.c","sys/arch/hppa/dev/power.c","power_thread_create",131,138
15,4,78,1,21,"power_thread_dr@141-162@sys/arch/hppa/dev/power.c","sys/arch/hppa/dev/power.c","power_thread_dr",141,162
12,3,70,1,14,"power_thread_reg@165-179@sys/arch/hppa/dev/power.c","sys/arch/hppa/dev/power.c","power_thread_reg",165,179
9,2,49,1,9,"power_cold_hook_reg@182-191@sys/arch/hppa/dev/power.c","sys/arch/hppa/dev/power.c","power_cold_hook_reg",182,191
8,3,48,3,9,"siop_sgc_match@62-71@sys/arch/hppa/dev/siop_sgc.c","sys/arch/hppa/dev/siop_sgc.c","siop_sgc_match",62,71
41,3,385,3,50,"siop_sgc_attach@74-124@sys/arch/hppa/dev/siop_sgc.c","sys/arch/hppa/dev/siop_sgc.c","siop_sgc_attach",74,124
8,1,74,1,8,"siop_sgc_reset@127-135@sys/arch/hppa/dev/siop_sgc.c","sys/arch/hppa/dev/siop_sgc.c","siop_sgc_reset",127,135
4,1,31,3,3,"siop_sgc_r1@138-141@sys/arch/hppa/dev/siop_sgc.c","sys/arch/hppa/dev/siop_sgc.c","siop_sgc_r1",138,141
10,2,70,3,10,"siop_sgc_r2@144-154@sys/arch/hppa/dev/siop_sgc.c","sys/arch/hppa/dev/siop_sgc.c","siop_sgc_r2",144,154
4,1,35,4,3,"siop_sgc_w1@157-160@sys/arch/hppa/dev/siop_sgc.c","sys/arch/hppa/dev/siop_sgc.c","siop_sgc_w1",157,160
4,1,35,4,3,"siop_sgc_w2@163-166@sys/arch/hppa/dev/siop_sgc.c","sys/arch/hppa/dev/siop_sgc.c","siop_sgc_w2",163,166
24,6,209,3,33,"ssio_match@133-166@sys/arch/hppa/dev/ssio.c","sys/arch/hppa/dev/ssio.c","ssio_match",133,166
82,9,724,3,132,"ssio_attach@169-301@sys/arch/hppa/dev/ssio.c","sys/arch/hppa/dev/ssio.c","ssio_attach",169,301
21,4,168,1,28,"ssio_intr@304-332@sys/arch/hppa/dev/ssio.c","sys/arch/hppa/dev/ssio.c","ssio_intr",304,332
11,4,81,5,13,"ssio_intr_establish@335-348@sys/arch/hppa/dev/ssio.c","sys/arch/hppa/dev/ssio.c","ssio_intr_establish",335,348
12,5,77,2,13,"ssio_print@351-364@sys/arch/hppa/dev/ssio.c","sys/arch/hppa/dev/ssio.c","ssio_print",351,364
27,6,157,2,45,"sti_pci_is_console@32-77@sys/arch/hppa/dev/sti_pci_machdep.c","sys/arch/hppa/dev/sti_pci_machdep.c","sti_pci_is_console",32,77
21,8,120,2,23,"sti_sgc_getrom@73-96@sys/arch/hppa/dev/sti_sgc.c","sys/arch/hppa/dev/sti_sgc.c","sti_sgc_getrom",73,96
60,19,439,3,84,"sti_sgc_probe@99-183@sys/arch/hppa/dev/sti_sgc.c","sys/arch/hppa/dev/sti_sgc.c","sti_sgc_probe",99,183
30,8,242,3,37,"sti_sgc_attach@186-223@sys/arch/hppa/dev/sti_sgc.c","sys/arch/hppa/dev/sti_sgc.c","sti_sgc_attach",186,223
14,5,75,3,18,"uturnmatch@66-84@sys/arch/hppa/dev/uturn.c","sys/arch/hppa/dev/uturn.c","uturnmatch",66,84
36,10,223,3,49,"uturnattach@87-136@sys/arch/hppa/dev/uturn.c","sys/arch/hppa/dev/uturn.c","uturnattach",87,136
13,4,67,3,15,"waxmatch@71-86@sys/arch/hppa/dev/wax.c","sys/arch/hppa/dev/wax.c","waxmatch",71,86
41,3,355,3,48,"waxattach@89-137@sys/arch/hppa/dev/wax.c","sys/arch/hppa/dev/wax.c","waxattach",89,137
9,4,58,3,10,"arcofi_gsc_match@46-56@sys/arch/hppa/gsc/arcofi_gsc.c","sys/arch/hppa/gsc/arcofi_gsc.c","arcofi_gsc_match",46,56
23,4,183,3,28,"arcofi_gsc_attach@59-87@sys/arch/hppa/gsc/arcofi_gsc.c","sys/arch/hppa/gsc/arcofi_gsc.c","arcofi_gsc_attach",59,87
12,5,75,3,14,"com_gsc_probe@59-73@sys/arch/hppa/gsc/com_gsc.c","sys/arch/hppa/gsc/com_gsc.c","com_gsc_probe",59,73
26,5,199,3,30,"com_gsc_attach@76-106@sys/arch/hppa/gsc/com_gsc.c","sys/arch/hppa/gsc/com_gsc.c","com_gsc_attach",76,106
16,4,106,3,19,"fdc_gsc_probe@53-72@sys/arch/hppa/gsc/fdc_gsc.c","sys/arch/hppa/gsc/fdc_gsc.c","fdc_gsc_probe",53,72
15,2,99,3,18,"fdc_gsc_attach@75-93@sys/arch/hppa/gsc/fdc_gsc.c","sys/arch/hppa/gsc/fdc_gsc.c","fdc_gsc_attach",75,93
8,1,41,3,8,"gscmatch@56-64@sys/arch/hppa/gsc/gscbus.c","sys/arch/hppa/gsc/gscbus.c","gscmatch",56,64
16,4,126,3,21,"gscattach@67-88@sys/arch/hppa/gsc/gscbus.c","sys/arch/hppa/gsc/gscbus.c","gscattach",67,88
9,2,44,2,9,"gscprint@91-100@sys/arch/hppa/gsc/gscbus.c","sys/arch/hppa/gsc/gscbus.c","gscprint",91,100
8,2,49,2,11,"gsc_intr_disestablish@127-138@sys/arch/hppa/gsc/gscbus.c","sys/arch/hppa/gsc/gscbus.c","gsc_intr_disestablish",127,138
17,6,128,3,22,"gsckbc_match@163-185@sys/arch/hppa/gsc/gsckbc.c","sys/arch/hppa/gsc/gsckbc.c","gsckbc_match",163,185
36,8,267,3,39,"probe_readtmo@206-245@sys/arch/hppa/gsc/gsckbc.c","sys/arch/hppa/gsc/gsckbc.c","probe_readtmo",206,245
9,3,53,3,10,"probe_readretry@248-258@sys/arch/hppa/gsc/gsckbc.c","sys/arch/hppa/gsc/gsckbc.c","probe_readretry",248,258
14,4,87,3,16,"probe_sendtmo@261-277@sys/arch/hppa/gsc/gsckbc.c","sys/arch/hppa/gsc/gsckbc.c","probe_sendtmo",261,277
20,6,98,3,22,"probe_sendack@280-302@sys/arch/hppa/gsc/gsckbc.c","sys/arch/hppa/gsc/gsckbc.c","probe_sendack",280,302
44,11,279,2,48,"probe_ident@305-353@sys/arch/hppa/gsc/gsckbc.c","sys/arch/hppa/gsc/gsckbc.c","probe_ident",305,353
50,11,377,3,65,"gsckbc_attach@356-421@sys/arch/hppa/gsc/gsckbc.c","sys/arch/hppa/gsc/gsckbc.c","gsckbc_attach",356,421
13,3,60,2,13,"pckbc_wait_output@428-441@sys/arch/hppa/gsc/gsckbc.c","sys/arch/hppa/gsc/gsckbc.c","pckbc_wait_output",428,441
11,2,61,3,10,"pckbc_send_cmd@444-454@sys/arch/hppa/gsc/gsckbc.c","sys/arch/hppa/gsc/gsckbc.c","pckbc_send_cmd",444,454
17,3,84,5,18,"pckbc_poll_data1@458-476@sys/arch/hppa/gsc/gsckbc.c","sys/arch/hppa/gsc/gsckbc.c","pckbc_poll_data1",458,476
7,1,35,3,6,"pckbc_send_devcmd@479-485@sys/arch/hppa/gsc/gsckbc.c","sys/arch/hppa/gsc/gsckbc.c","pckbc_send_devcmd",479,485
12,3,83,3,12,"pckbc_submatch@488-500@sys/arch/hppa/gsc/gsckbc.c","sys/arch/hppa/gsc/gsckbc.c","pckbc_submatch",488,500
20,4,130,2,21,"pckbc_attach_slot@503-524@sys/arch/hppa/gsc/gsckbc.c","sys/arch/hppa/gsc/gsckbc.c","pckbc_attach_slot",503,524
9,3,46,2,11,"pckbcprint@527-538@sys/arch/hppa/gsc/gsckbc.c","sys/arch/hppa/gsc/gsckbc.c","pckbcprint",527,538
11,2,71,1,11,"pckbc_init_slotdata@541-552@sys/arch/hppa/gsc/gsckbc.c","sys/arch/hppa/gsc/gsckbc.c","pckbc_init_slotdata",541,552
7,1,40,2,7,"pckbc_flush@555-562@sys/arch/hppa/gsc/gsckbc.c","sys/arch/hppa/gsc/gsckbc.c","pckbc_flush",555,562
14,5,95,2,16,"pckbc_poll_data@565-581@sys/arch/hppa/gsc/gsckbc.c","sys/arch/hppa/gsc/gsckbc.c","pckbc_poll_data",565,581
5,1,15,1,5,"pckbc_xt_translation@584-589@sys/arch/hppa/gsc/gsckbc.c","sys/arch/hppa/gsc/gsckbc.c","pckbc_xt_translation",584,589
6,1,19,3,6,"pckbc_slot_enable@592-598@sys/arch/hppa/gsc/gsckbc.c","sys/arch/hppa/gsc/gsckbc.c","pckbc_slot_enable",592,598
16,3,78,3,24,"pckbc_set_poll@601-625@sys/arch/hppa/gsc/gsckbc.c","sys/arch/hppa/gsc/gsckbc.c","pckbc_set_poll",601,625
58,19,306,3,70,"pckbc_poll_cmd1@632-702@sys/arch/hppa/gsc/gsckbc.c","sys/arch/hppa/gsc/gsckbc.c","pckbc_poll_cmd1",632,702
21,6,147,7,25,"pckbc_poll_cmd@706-731@sys/arch/hppa/gsc/gsckbc.c","sys/arch/hppa/gsc/gsckbc.c","pckbc_poll_cmd",706,731
14,5,96,1,18,"pckbc_cleanqueue@737-755@sys/arch/hppa/gsc/gsckbc.c","sys/arch/hppa/gsc/gsckbc.c","pckbc_cleanqueue",737,755
17,4,111,1,23,"pckbc_cleanup@762-785@sys/arch/hppa/gsc/gsckbc.c","sys/arch/hppa/gsc/gsckbc.c","pckbc_cleanup",762,785
27,6,166,2,30,"pckbc_start@792-822@sys/arch/hppa/gsc/gsckbc.c","sys/arch/hppa/gsc/gsckbc.c","pckbc_start",792,822
44,15,268,3,55,"pckbc_cmdresponse@830-885@sys/arch/hppa/gsc/gsckbc.c","sys/arch/hppa/gsc/gsckbc.c","pckbc_cmdresponse",830,885
52,15,364,7,65,"pckbc_enqueue_cmd@891-956@sys/arch/hppa/gsc/gsckbc.c","sys/arch/hppa/gsc/gsckbc.c","pckbc_enqueue_cmd",891,956
15,2,92,5,16,"pckbc_set_inputhandler@959-975@sys/arch/hppa/gsc/gsckbc.c","sys/arch/hppa/gsc/gsckbc.c","pckbc_set_inputhandler",959,975
31,9,211,1,43,"gsckbcintr@978-1021@sys/arch/hppa/gsc/gsckbc.c","sys/arch/hppa/gsc/gsckbc.c","gsckbcintr",978,1021
24,9,156,3,24,"harmony_match@124-148@sys/arch/hppa/gsc/harmony.c","sys/arch/hppa/gsc/harmony.c","harmony_match",124,148
90,10,757,3,106,"harmony_attach@151-257@sys/arch/hppa/gsc/harmony.c","sys/arch/hppa/gsc/harmony.c","harmony_attach",151,257
9,1,50,1,13,"harmony_reset_codec@260-273@sys/arch/hppa/gsc/harmony.c","sys/arch/hppa/gsc/harmony.c","harmony_reset_codec",260,273
6,1,30,1,6,"harmony_acc_tmo@276-282@sys/arch/hppa/gsc/harmony.c","sys/arch/hppa/gsc/harmony.c","harmony_acc_tmo",276,282
53,8,330,1,63,"harmony_intr@288-351@sys/arch/hppa/gsc/harmony.c","sys/arch/hppa/gsc/harmony.c","harmony_intr",288,351
5,1,27,1,4,"harmony_intr_enable@354-358@sys/arch/hppa/gsc/harmony.c","sys/arch/hppa/gsc/harmony.c","harmony_intr_enable",354,358
5,1,27,1,4,"harmony_intr_disable@361-365@sys/arch/hppa/gsc/harmony.c","sys/arch/hppa/gsc/harmony.c","harmony_intr_disable",361,365
8,2,40,2,8,"harmony_open@368-376@sys/arch/hppa/gsc/harmony.c","sys/arch/hppa/gsc/harmony.c","harmony_open",368,376
8,1,36,1,9,"harmony_close@379-388@sys/arch/hppa/gsc/harmony.c","sys/arch/hppa/gsc/harmony.c","harmony_close",379,388
49,11,256,5,54,"harmony_set_params@391-445@sys/arch/hppa/gsc/harmony.c","sys/arch/hppa/gsc/harmony.c","harmony_set_params",391,445
4,1,16,2,3,"harmony_round_blocksize@448-451@sys/arch/hppa/gsc/harmony.c","sys/arch/hppa/gsc/harmony.c","harmony_round_blocksize",448,451
54,15,317,1,68,"harmony_commit_settings@454-522@sys/arch/hppa/gsc/harmony.c","sys/arch/hppa/gsc/harmony.c","harmony_commit_settings",454,522
6,1,26,1,7,"harmony_halt_output@525-532@sys/arch/hppa/gsc/harmony.c","sys/arch/hppa/gsc/harmony.c","harmony_halt_output",525,532
6,1,26,1,7,"harmony_halt_input@535-542@sys/arch/hppa/gsc/harmony.c","sys/arch/hppa/gsc/harmony.c","harmony_halt_input",535,542
77,24,474,2,78,"harmony_set_port@545-623@sys/arch/hppa/gsc/harmony.c","sys/arch/hppa/gsc/harmony.c","harmony_set_port",545,623
71,22,415,2,71,"harmony_get_port@626-697@sys/arch/hppa/gsc/harmony.c","sys/arch/hppa/gsc/harmony.c","harmony_get_port",626,697
116,12,1140,2,117,"harmony_query_devinfo@700-817@sys/arch/hppa/gsc/harmony.c","sys/arch/hppa/gsc/harmony.c","harmony_query_devinfo",700,817
35,6,274,5,41,"harmony_allocm@820-861@sys/arch/hppa/gsc/harmony.c","sys/arch/hppa/gsc/harmony.c","harmony_allocm",820,861
16,3,145,3,16,"harmony_freem@864-880@sys/arch/hppa/gsc/harmony.c","sys/arch/hppa/gsc/harmony.c","harmony_freem",864,880
4,1,33,3,3,"harmony_round_buffersize@883-886@sys/arch/hppa/gsc/harmony.c","sys/arch/hppa/gsc/harmony.c","harmony_round_buffersize",883,886
4,1,13,1,3,"harmony_get_props@889-892@sys/arch/hppa/gsc/harmony.c","sys/arch/hppa/gsc/harmony.c","harmony_get_props",889,892
46,5,337,7,52,"harmony_trigger_output@895-947@sys/arch/hppa/gsc/harmony.c","sys/arch/hppa/gsc/harmony.c","harmony_trigger_output",895,947
32,5,216,1,35,"harmony_start_cp@950-985@sys/arch/hppa/gsc/harmony.c","sys/arch/hppa/gsc/harmony.c","harmony_start_cp",950,985
27,3,199,7,28,"harmony_trigger_input@988-1016@sys/arch/hppa/gsc/harmony.c","sys/arch/hppa/gsc/harmony.c","harmony_trigger_input",988,1016
28,9,220,2,32,"harmony_speed_bits@1039-1071@sys/arch/hppa/gsc/harmony.c","sys/arch/hppa/gsc/harmony.c","harmony_speed_bits",1039,1071
35,5,313,1,47,"harmony_set_gainctl@1074-1121@sys/arch/hppa/gsc/harmony.c","sys/arch/hppa/gsc/harmony.c","harmony_set_gainctl",1074,1121
28,9,256,1,33,"harmony_try_more@1124-1157@sys/arch/hppa/gsc/harmony.c","sys/arch/hppa/gsc/harmony.c","harmony_try_more",1124,1157
8,3,52,3,9,"hil_gsc_match@59-68@sys/arch/hppa/gsc/hil_gsc.c","sys/arch/hppa/gsc/hil_gsc.c","hil_gsc_match",59,68
18,3,167,3,22,"hil_gsc_attach@71-93@sys/arch/hppa/gsc/hil_gsc.c","sys/arch/hppa/gsc/hil_gsc.c","hil_gsc_attach",71,93
26,8,153,2,42,"ie_gsc_reset@99-141@sys/arch/hppa/gsc/if_ie_gsc.c","sys/arch/hppa/gsc/if_ie_gsc.c","ie_gsc_reset",99,141
9,1,54,1,9,"ie_gsc_attend@144-153@sys/arch/hppa/gsc/if_ie_gsc.c","sys/arch/hppa/gsc/if_ie_gsc.c","ie_gsc_attend",144,153
4,1,11,1,3,"ie_gsc_run@156-159@sys/arch/hppa/gsc/if_ie_gsc.c","sys/arch/hppa/gsc/if_ie_gsc.c","ie_gsc_run",156,159
32,6,181,2,32,"ie_gsc_port@162-194@sys/arch/hppa/gsc/if_ie_gsc.c","sys/arch/hppa/gsc/if_ie_gsc.c","ie_gsc_port",162,194
18,5,73,2,17,"ie_gsc_intrhook@198-215@sys/arch/hppa/gsc/if_ie_gsc.c","sys/arch/hppa/gsc/if_ie_gsc.c","ie_gsc_intrhook",198,215
8,1,49,2,8,"ie_gsc_read16@219-227@sys/arch/hppa/gsc/if_ie_gsc.c","sys/arch/hppa/gsc/if_ie_gsc.c","ie_gsc_read16",219,227
9,1,55,3,9,"ie_gsc_write16@230-239@sys/arch/hppa/gsc/if_ie_gsc.c","sys/arch/hppa/gsc/if_ie_gsc.c","ie_gsc_write16",230,239
11,1,90,3,11,"ie_gsc_write24@242-253@sys/arch/hppa/gsc/if_ie_gsc.c","sys/arch/hppa/gsc/if_ie_gsc.c","ie_gsc_write24",242,253
9,1,62,4,8,"ie_gsc_memcopyin@256-264@sys/arch/hppa/gsc/if_ie_gsc.c","sys/arch/hppa/gsc/if_ie_gsc.c","ie_gsc_memcopyin",256,264
9,1,63,4,8,"ie_gsc_memcopyout@267-275@sys/arch/hppa/gsc/if_ie_gsc.c","sys/arch/hppa/gsc/if_ie_gsc.c","ie_gsc_memcopyout",267,275
11,4,63,3,12,"ie_gsc_probe@278-290@sys/arch/hppa/gsc/if_ie_gsc.c","sys/arch/hppa/gsc/if_ie_gsc.c","ie_gsc_probe",278,290
77,14,593,3,103,"ie_gsc_attach@293-396@sys/arch/hppa/gsc/if_ie_gsc.c","sys/arch/hppa/gsc/if_ie_gsc.c","ie_gsc_attach",293,396
40,11,294,3,62,"lpt_gsc_probe@100-162@sys/arch/hppa/gsc/lpt_gsc.c","sys/arch/hppa/gsc/lpt_gsc.c","lpt_gsc_probe",100,162
18,2,129,3,22,"lpt_gsc_attach@165-187@sys/arch/hppa/gsc/lpt_gsc.c","sys/arch/hppa/gsc/lpt_gsc.c","lpt_gsc_attach",165,187
8,3,52,3,9,"mgmatch_gsc@53-62@sys/arch/hppa/gsc/mongoose_gsc.c","sys/arch/hppa/gsc/mongoose_gsc.c","mgmatch_gsc",53,62
26,4,213,3,30,"mgattach_gsc@65-95@sys/arch/hppa/gsc/mongoose_gsc.c","sys/arch/hppa/gsc/mongoose_gsc.c","mgattach_gsc",65,95
10,3,53,3,11,"oosiop_gsc_match@90-101@sys/arch/hppa/gsc/oosiop_gsc.c","sys/arch/hppa/gsc/oosiop_gsc.c","oosiop_gsc_match",90,101
34,5,240,3,49,"oosiop_gsc_attach@104-153@sys/arch/hppa/gsc/oosiop_gsc.c","sys/arch/hppa/gsc/oosiop_gsc.c","oosiop_gsc_attach",104,153
9,2,41,1,13,"oosiop_gsc_intr@159-172@sys/arch/hppa/gsc/oosiop_gsc.c","sys/arch/hppa/gsc/oosiop_gsc.c","oosiop_gsc_intr",159,172
10,3,53,3,11,"osiop_gsc_match@91-102@sys/arch/hppa/gsc/osiop_gsc.c","sys/arch/hppa/gsc/osiop_gsc.c","osiop_gsc_match",91,102
33,5,234,3,47,"osiop_gsc_attach@105-152@sys/arch/hppa/gsc/osiop_gsc.c","sys/arch/hppa/gsc/osiop_gsc.c","osiop_gsc_attach",105,152
18,4,113,1,35,"osiop_gsc_intr@158-193@sys/arch/hppa/gsc/osiop_gsc.c","sys/arch/hppa/gsc/osiop_gsc.c","osiop_gsc_intr",158,193
8,3,48,3,9,"siop_gsc_match@62-71@sys/arch/hppa/gsc/siop_gsc.c","sys/arch/hppa/gsc/siop_gsc.c","siop_gsc_match",62,71
35,2,339,3,46,"siop_gsc_attach@74-120@sys/arch/hppa/gsc/siop_gsc.c","sys/arch/hppa/gsc/siop_gsc.c","siop_gsc_attach",74,120
8,1,74,1,8,"siop_gsc_reset@123-131@sys/arch/hppa/gsc/siop_gsc.c","sys/arch/hppa/gsc/siop_gsc.c","siop_gsc_reset",123,131
4,1,31,3,3,"siop_gsc_r1@134-137@sys/arch/hppa/gsc/siop_gsc.c","sys/arch/hppa/gsc/siop_gsc.c","siop_gsc_r1",134,137
10,2,70,3,10,"siop_gsc_r2@140-150@sys/arch/hppa/gsc/siop_gsc.c","sys/arch/hppa/gsc/siop_gsc.c","siop_gsc_r2",140,150
4,1,35,4,3,"siop_gsc_w1@153-156@sys/arch/hppa/gsc/siop_gsc.c","sys/arch/hppa/gsc/siop_gsc.c","siop_gsc_w1",153,156
4,1,35,4,3,"siop_gsc_w2@159-162@sys/arch/hppa/gsc/siop_gsc.c","sys/arch/hppa/gsc/siop_gsc.c","siop_gsc_w2",159,162
27,5,196,1,35,"heartbeat@106-141@sys/arch/hppa/hppa/autoconf.c","sys/arch/hppa/hppa/autoconf.c","heartbeat",106,141
18,6,101,1,25,"dumpconf@152-177@sys/arch/hppa/hppa/autoconf.c","sys/arch/hppa/hppa/autoconf.c","dumpconf",152,177
13,5,135,2,16,"print_devpath@182-198@sys/arch/hppa/hppa/autoconf.c","sys/arch/hppa/hppa/autoconf.c","print_devpath",182,198
114,35,923,5,134,"pdc_scanbus@206-340@sys/arch/hppa/hppa/autoconf.c","sys/arch/hppa/hppa/autoconf.c","pdc_scanbus",206,340
13,5,89,2,14,"hppa_mod_info@347-361@sys/arch/hppa/hppa/autoconf.c","sys/arch/hppa/hppa/autoconf.c","hppa_mod_info",347,361
61,25,344,2,110,"device_register@364-474@sys/arch/hppa/hppa/autoconf.c","sys/arch/hppa/hppa/autoconf.c","device_register",364,474
13,4,65,1,17,"cpu_configure@481-498@sys/arch/hppa/hppa/autoconf.c","sys/arch/hppa/hppa/autoconf.c","cpu_configure",481,498
8,3,42,1,11,"diskconf@501-512@sys/arch/hppa/hppa/autoconf.c","sys/arch/hppa/hppa/autoconf.c","diskconf",501,512
5,2,26,1,4,"iszerodev@254-258@sys/arch/hppa/hppa/conf.c","sys/arch/hppa/hppa/conf.c","iszerodev",254,258
4,1,13,0,3,"getnulldev@261-264@sys/arch/hppa/hppa/conf.c","sys/arch/hppa/hppa/conf.c","getnulldev",261,264
5,2,26,1,4,"iskmemdev@270-274@sys/arch/hppa/hppa/conf.c","sys/arch/hppa/hppa/conf.c","iskmemdev",270,274
37,10,239,1,50,"iExInit@1232-1282@sys/arch/hppa/hppa/db_disasm.c","sys/arch/hppa/hppa/db_disasm.c","iExInit",1232,1282
9,1,55,3,8,"addDasm@1294-1302@sys/arch/hppa/hppa/db_disasm.c","sys/arch/hppa/hppa/db_disasm.c","addDasm",1294,1302
12,3,86,3,11,"unitDasm@1306-1317@sys/arch/hppa/hppa/db_disasm.c","sys/arch/hppa/hppa/db_disasm.c","unitDasm",1306,1317
13,2,91,3,12,"iaDasm@1321-1333@sys/arch/hppa/hppa/db_disasm.c","sys/arch/hppa/hppa/db_disasm.c","iaDasm",1321,1333
13,2,98,3,12,"shdDasm@1337-1349@sys/arch/hppa/hppa/db_disasm.c","sys/arch/hppa/hppa/db_disasm.c","shdDasm",1337,1349
9,1,62,3,8,"extrDasm@1353-1361@sys/arch/hppa/hppa/db_disasm.c","sys/arch/hppa/hppa/db_disasm.c","extrDasm",1353,1361
9,1,57,3,8,"vextrDasm@1366-1374@sys/arch/hppa/hppa/db_disasm.c","sys/arch/hppa/hppa/db_disasm.c","vextrDasm",1366,1374
9,1,64,3,8,"depDasm@1379-1387@sys/arch/hppa/hppa/db_disasm.c","sys/arch/hppa/hppa/db_disasm.c","depDasm",1379,1387
9,1,57,3,8,"vdepDasm@1392-1400@sys/arch/hppa/hppa/db_disasm.c","sys/arch/hppa/hppa/db_disasm.c","vdepDasm",1392,1400
9,1,64,3,8,"depiDasm@1405-1413@sys/arch/hppa/hppa/db_disasm.c","sys/arch/hppa/hppa/db_disasm.c","depiDasm",1405,1413
8,1,57,3,7,"vdepiDasm@1417-1424@sys/arch/hppa/hppa/db_disasm.c","sys/arch/hppa/hppa/db_disasm.c","vdepiDasm",1417,1424
24,17,150,1,23,"subDCond@1432-1455@sys/arch/hppa/hppa/db_disasm.c","sys/arch/hppa/hppa/db_disasm.c","subDCond",1432,1455
24,17,150,1,23,"addDCond@1464-1487@sys/arch/hppa/hppa/db_disasm.c","sys/arch/hppa/hppa/db_disasm.c","addDCond",1464,1487
20,13,118,1,19,"unitDCond@1490-1509@sys/arch/hppa/hppa/db_disasm.c","sys/arch/hppa/hppa/db_disasm.c","unitDCond",1490,1509
16,9,86,1,15,"edDCond@1512-1527@sys/arch/hppa/hppa/db_disasm.c","sys/arch/hppa/hppa/db_disasm.c","edDCond",1512,1527
24,6,178,3,25,"ldDasm@1538-1563@sys/arch/hppa/hppa/db_disasm.c","sys/arch/hppa/hppa/db_disasm.c","ldDasm",1538,1563
21,4,139,3,24,"stDasm@1567-1591@sys/arch/hppa/hppa/db_disasm.c","sys/arch/hppa/hppa/db_disasm.c","stDasm",1567,1591
31,12,217,3,32,"ldxDasm@1595-1627@sys/arch/hppa/hppa/db_disasm.c","sys/arch/hppa/hppa/db_disasm.c","ldxDasm",1595,1627
21,8,154,3,21,"stsDasm@1631-1652@sys/arch/hppa/hppa/db_disasm.c","sys/arch/hppa/hppa/db_disasm.c","stsDasm",1631,1652
22,8,157,3,21,"stbysDasm@1656-1677@sys/arch/hppa/hppa/db_disasm.c","sys/arch/hppa/hppa/db_disasm.c","stbysDasm",1656,1677
8,1,42,3,7,"limmDasm@1681-1688@sys/arch/hppa/hppa/db_disasm.c","sys/arch/hppa/hppa/db_disasm.c","limmDasm",1681,1688
17,6,109,3,20,"blDasm@1693-1713@sys/arch/hppa/hppa/db_disasm.c","sys/arch/hppa/hppa/db_disasm.c","blDasm",1693,1713
8,2,51,3,7,"brDasm@1717-1724@sys/arch/hppa/hppa/db_disasm.c","sys/arch/hppa/hppa/db_disasm.c","brDasm",1717,1724
8,2,51,3,7,"bvDasm@1728-1735@sys/arch/hppa/hppa/db_disasm.c","sys/arch/hppa/hppa/db_disasm.c","bvDasm",1728,1735
18,3,115,3,19,"beDasm@1739-1758@sys/arch/hppa/hppa/db_disasm.c","sys/arch/hppa/hppa/db_disasm.c","beDasm",1739,1758
16,4,131,3,16,"cbDasm@1763-1779@sys/arch/hppa/hppa/db_disasm.c","sys/arch/hppa/hppa/db_disasm.c","cbDasm",1763,1779
16,4,131,3,16,"cbiDasm@1783-1799@sys/arch/hppa/hppa/db_disasm.c","sys/arch/hppa/hppa/db_disasm.c","cbiDasm",1783,1799
16,3,117,3,16,"bbDasm@1803-1819@sys/arch/hppa/hppa/db_disasm.c","sys/arch/hppa/hppa/db_disasm.c","bbDasm",1803,1819
15,6,120,3,14,"ariDasm@1823-1837@sys/arch/hppa/hppa/db_disasm.c","sys/arch/hppa/hppa/db_disasm.c","ariDasm",1823,1837
29,12,274,3,29,"scDasm@1841-1870@sys/arch/hppa/hppa/db_disasm.c","sys/arch/hppa/hppa/db_disasm.c","scDasm",1841,1870
55,20,443,3,55,"mmgtDasm@1874-1929@sys/arch/hppa/hppa/db_disasm.c","sys/arch/hppa/hppa/db_disasm.c","mmgtDasm",1874,1929
8,1,42,3,7,"brkDasm@1933-1940@sys/arch/hppa/hppa/db_disasm.c","sys/arch/hppa/hppa/db_disasm.c","brkDasm",1933,1940
74,29,607,3,100,"floatDasm@1943-2043@sys/arch/hppa/hppa/db_disasm.c","sys/arch/hppa/hppa/db_disasm.c","floatDasm",1943,2043
74,29,591,3,78,"fcoprDasm@2046-2124@sys/arch/hppa/hppa/db_disasm.c","sys/arch/hppa/hppa/db_disasm.c","fcoprDasm",2046,2124
81,26,574,3,86,"coprDasm@2127-2213@sys/arch/hppa/hppa/db_disasm.c","sys/arch/hppa/hppa/db_disasm.c","coprDasm",2127,2213
30,13,209,3,33,"lpkDasm@2216-2249@sys/arch/hppa/hppa/db_disasm.c","sys/arch/hppa/hppa/db_disasm.c","lpkDasm",2216,2249
18,4,120,3,17,"diagDasm@2252-2269@sys/arch/hppa/hppa/db_disasm.c","sys/arch/hppa/hppa/db_disasm.c","diagDasm",2252,2269
15,2,125,3,14,"fmpysubDasm@2272-2286@sys/arch/hppa/hppa/db_disasm.c","sys/arch/hppa/hppa/db_disasm.c","fmpysubDasm",2272,2286
19,9,212,3,20,"fmpyaddDasm@2289-2309@sys/arch/hppa/hppa/db_disasm.c","sys/arch/hppa/hppa/db_disasm.c","fmpyaddDasm",2289,2309
43,17,286,2,48,"db_disasm@2312-2360@sys/arch/hppa/hppa/db_disasm.c","sys/arch/hppa/hppa/db_disasm.c","db_disasm",2312,2360
7,2,30,1,6,"db_enter@128-134@sys/arch/hppa/hppa/db_interface.c","sys/arch/hppa/hppa/db_interface.c","db_enter",128,134
6,2,38,3,6,"db_read_bytes@137-143@sys/arch/hppa/hppa/db_interface.c","sys/arch/hppa/hppa/db_interface.c","db_read_bytes",137,143
8,2,62,3,10,"db_write_bytes@146-156@sys/arch/hppa/hppa/db_interface.c","sys/arch/hppa/hppa/db_interface.c","db_write_bytes",146,156
10,3,54,2,9,"kdbprinttrap@163-172@sys/arch/hppa/hppa/db_interface.c","sys/arch/hppa/hppa/db_interface.c","kdbprinttrap",163,172
28,6,121,3,35,"db_ktrap@178-213@sys/arch/hppa/hppa/db_interface.c","sys/arch/hppa/hppa/db_interface.c","db_ktrap",178,213
4,1,12,1,3,"db_valid_breakpoint@220-223@sys/arch/hppa/hppa/db_interface.c","sys/arch/hppa/hppa/db_interface.c","db_valid_breakpoint",220,223
64,17,480,5,90,"db_stack_trace_print@226-316@sys/arch/hppa/hppa/db_interface.c","sys/arch/hppa/hppa/db_interface.c","db_stack_trace_print",226,316
16,4,108,1,20,"db_save_stack_trace@319-339@sys/arch/hppa/hppa/db_interface.c","sys/arch/hppa/hppa/db_interface.c","db_save_stack_trace",319,339
29,9,181,4,39,"readdisklabel@53-92@sys/arch/hppa/hppa/disksubr.c","sys/arch/hppa/hppa/disksubr.c","readdisklabel",53,92
99,23,714,5,124,"readliflabel@95-219@sys/arch/hppa/hppa/disksubr.c","sys/arch/hppa/hppa/disksubr.c","readliflabel",95,219
35,5,261,3,41,"writedisklabel@225-266@sys/arch/hppa/hppa/disksubr.c","sys/arch/hppa/hppa/disksubr.c","writedisklabel",225,266
4,1,16,1,3,"fpu_proc_flush@34-37@sys/arch/hppa/hppa/fpu.c","sys/arch/hppa/hppa/fpu.c","fpu_proc_flush",34,37
4,1,16,1,3,"fpu_proc_save@40-43@sys/arch/hppa/hppa/fpu.c","sys/arch/hppa/hppa/fpu.c","fpu_proc_save",40,43
23,9,159,2,40,"fpu_proc@46-86@sys/arch/hppa/hppa/fpu.c","sys/arch/hppa/hppa/fpu.c","fpu_proc",46,86
24,6,141,1,33,"fpu_cpu_save@93-126@sys/arch/hppa/hppa/fpu.c","sys/arch/hppa/hppa/fpu.c","fpu_cpu_save",93,126
40,14,212,2,50,"in_cksum@73-123@sys/arch/hppa/hppa/in_cksum.c","sys/arch/hppa/hppa/in_cksum.c","in_cksum",73,123
6,2,40,2,6,"splassert_check@79-85@sys/arch/hppa/hppa/intr.c","sys/arch/hppa/hppa/intr.c","splassert_check",79,85
36,5,260,1,46,"cpu_intr_init@89-135@sys/arch/hppa/hppa/intr.c","sys/arch/hppa/hppa/intr.c","cpu_intr_init",89,135
9,4,49,1,10,"cpu_intr_findirq@138-148@sys/arch/hppa/hppa/intr.c","sys/arch/hppa/hppa/intr.c","cpu_intr_findirq",138,148
33,6,236,6,37,"cpu_intr_map@151-188@sys/arch/hppa/hppa/intr.c","sys/arch/hppa/hppa/intr.c","cpu_intr_map",151,188
40,9,324,5,46,"cpu_intr_establish@191-237@sys/arch/hppa/hppa/intr.c","sys/arch/hppa/hppa/intr.c","cpu_intr_establish",191,237
49,17,328,1,69,"cpu_intr@240-309@sys/arch/hppa/hppa/intr.c","sys/arch/hppa/hppa/intr.c","cpu_intr",240,309
4,1,13,1,3,"intr_barrier@312-315@sys/arch/hppa/hppa/intr.c","sys/arch/hppa/hppa/intr.c","intr_barrier",312,315
32,7,219,3,37,"softintr_establish@318-355@sys/arch/hppa/hppa/intr.c","sys/arch/hppa/hppa/intr.c","softintr_establish",318,355
26,5,158,1,28,"softintr_disestablish@358-386@sys/arch/hppa/hppa/intr.c","sys/arch/hppa/hppa/intr.c","softintr_disestablish",358,386
5,1,36,1,5,"softintr_schedule@389-394@sys/arch/hppa/hppa/intr.c","sys/arch/hppa/hppa/intr.c","softintr_schedule",389,394
5,1,30,1,5,"hppa_ipi_init@45-50@sys/arch/hppa/hppa/ipi.c","sys/arch/hppa/hppa/ipi.c","hppa_ipi_init",45,50
17,3,95,1,20,"hppa_ipi_intr@53-73@sys/arch/hppa/hppa/ipi.c","sys/arch/hppa/hppa/ipi.c","hppa_ipi_intr",53,73
14,2,99,2,18,"hppa_ipi_send@76-94@sys/arch/hppa/hppa/ipi.c","sys/arch/hppa/hppa/ipi.c","hppa_ipi_send",76,94
11,4,57,1,12,"hppa_ipi_broadcast@97-109@sys/arch/hppa/hppa/ipi.c","sys/arch/hppa/hppa/ipi.c","hppa_ipi_broadcast",97,109
3,1,6,1,2,"hppa_ipi_nop@112-114@sys/arch/hppa/hppa/ipi.c","sys/arch/hppa/hppa/ipi.c","hppa_ipi_nop",112,114
7,2,28,1,8,"hppa_ipi_halt@117-125@sys/arch/hppa/hppa/ipi.c","sys/arch/hppa/hppa/ipi.c","hppa_ipi_halt",117,125
4,1,11,1,3,"hppa_ipi_fpu_save@128-131@sys/arch/hppa/hppa/ipi.c","sys/arch/hppa/hppa/ipi.c","hppa_ipi_fpu_save",128,131
4,1,11,1,3,"hppa_ipi_fpu_flush@134-137@sys/arch/hppa/hppa/ipi.c","sys/arch/hppa/hppa/ipi.c","hppa_ipi_fpu_flush",134,137
21,3,121,4,24,"__cpu_cas@32-56@sys/arch/hppa/hppa/lock_machdep.c","sys/arch/hppa/hppa/lock_machdep.c","__cpu_cas",32,56
9,1,57,1,8,"___mp_lock_init@59-67@sys/arch/hppa/hppa/lock_machdep.c","sys/arch/hppa/hppa/lock_machdep.c","___mp_lock_init",59,67
12,5,62,1,16,"__mp_lock_spin@79-95@sys/arch/hppa/hppa/lock_machdep.c","sys/arch/hppa/hppa/lock_machdep.c","__mp_lock_spin",79,95
22,6,140,1,39,"___mp_lock@98-137@sys/arch/hppa/hppa/lock_machdep.c","sys/arch/hppa/hppa/lock_machdep.c","___mp_lock",98,137
17,4,101,1,21,"___mp_unlock@140-161@sys/arch/hppa/hppa/lock_machdep.c","sys/arch/hppa/hppa/lock_machdep.c","___mp_unlock",140,161
19,6,120,1,28,"___mp_release_all@164-192@sys/arch/hppa/hppa/lock_machdep.c","sys/arch/hppa/hppa/lock_machdep.c","___mp_release_all",164,192
14,6,92,1,23,"___mp_release_all_but_one@195-218@sys/arch/hppa/hppa/lock_machdep.c","sys/arch/hppa/hppa/lock_machdep.c","___mp_release_all_but_one",195,218
5,2,24,2,4,"___mp_acquire_count@221-225@sys/arch/hppa/hppa/lock_machdep.c","sys/arch/hppa/hppa/lock_machdep.c","___mp_acquire_count",221,225
4,1,21,2,3,"__mp_lock_held@228-231@sys/arch/hppa/hppa/lock_machdep.c","sys/arch/hppa/hppa/lock_machdep.c","__mp_lock_held",228,231
5,1,22,1,5,"hppa_cpuspeed@263-268@sys/arch/hppa/hppa/machdep.c","sys/arch/hppa/hppa/machdep.c","hppa_cpuspeed",263,268
87,11,695,1,124,"hppa_init@271-395@sys/arch/hppa/hppa/machdep.c","sys/arch/hppa/hppa/machdep.c","hppa_init",271,395
151,45,966,0,208,"cpuid@398-606@sys/arch/hppa/hppa/machdep.c","sys/arch/hppa/hppa/machdep.c","cpuid",398,606
21,3,154,1,49,"cpu_startup@609-658@sys/arch/hppa/hppa/machdep.c","sys/arch/hppa/hppa/machdep.c","cpu_startup",609,658
18,4,96,1,18,"delay_init@666-684@sys/arch/hppa/hppa/machdep.c","sys/arch/hppa/hppa/machdep.c","delay_init",666,684
17,5,86,1,21,"delay@687-708@sys/arch/hppa/hppa/machdep.c","sys/arch/hppa/hppa/machdep.c","delay",687,708
10,4,61,5,10,"fall@711-721@sys/arch/hppa/hppa/machdep.c","sys/arch/hppa/hppa/machdep.c","fall",711,721
6,1,31,1,8,"ficacheall@724-732@sys/arch/hppa/hppa/machdep.c","sys/arch/hppa/hppa/machdep.c","ficacheall",724,732
6,1,31,1,5,"fdcacheall@735-740@sys/arch/hppa/hppa/machdep.c","sys/arch/hppa/hppa/machdep.c","fdcacheall",735,740
25,7,178,1,28,"ptlball@743-771@sys/arch/hppa/hppa/machdep.c","sys/arch/hppa/hppa/machdep.c","ptlball",743,771
5,1,34,2,4,"hpti_g@774-778@sys/arch/hppa/hppa/machdep.c","sys/arch/hppa/hppa/machdep.c","hpti_g",774,778
4,1,11,1,3,"pbtlb_g@781-784@sys/arch/hppa/hppa/machdep.c","sys/arch/hppa/hppa/machdep.c","pbtlb_g",781,784
9,3,71,6,11,"ibtlb_g@787-798@sys/arch/hppa/hppa/machdep.c","sys/arch/hppa/hppa/machdep.c","ibtlb_g",787,798
39,15,302,5,78,"btlb_insert@801-879@sys/arch/hppa/hppa/machdep.c","sys/arch/hppa/hppa/machdep.c","btlb_insert",801,879
53,12,282,1,78,"boot@884-962@sys/arch/hppa/hppa/machdep.c","sys/arch/hppa/hppa/machdep.c","boot",884,962
8,2,51,1,9,"cpu_dumpsize@972-981@sys/arch/hppa/hppa/machdep.c","sys/arch/hppa/hppa/machdep.c","cpu_dumpsize",972,981
5,1,15,1,5,"hpmc_dump@987-992@sys/arch/hppa/hppa/machdep.c","sys/arch/hppa/hppa/machdep.c","hpmc_dump",987,992
12,1,118,1,22,"cpu_dump@995-1017@sys/arch/hppa/hppa/machdep.c","sys/arch/hppa/hppa/machdep.c","cpu_dump",995,1017
47,16,329,1,61,"dumpsys@1025-1086@sys/arch/hppa/hppa/machdep.c","sys/arch/hppa/hppa/machdep.c","dumpsys",1025,1086
4,1,30,3,3,"kcopy@1090-1093@sys/arch/hppa/hppa/machdep.c","sys/arch/hppa/hppa/machdep.c","kcopy",1090,1093
4,1,36,4,3,"copystr@1096-1099@sys/arch/hppa/hppa/machdep.c","sys/arch/hppa/hppa/machdep.c","copystr",1096,1099
5,1,42,4,4,"copyinstr@1102-1106@sys/arch/hppa/hppa/machdep.c","sys/arch/hppa/hppa/machdep.c","copyinstr",1102,1106
5,1,42,4,4,"copyoutstr@1109-1113@sys/arch/hppa/hppa/machdep.c","sys/arch/hppa/hppa/machdep.c","copyoutstr",1109,1113
5,1,36,3,4,"copyin@1116-1120@sys/arch/hppa/hppa/machdep.c","sys/arch/hppa/hppa/machdep.c","copyin",1116,1120
5,1,36,3,4,"copyout@1123-1127@sys/arch/hppa/hppa/machdep.c","sys/arch/hppa/hppa/machdep.c","copyout",1123,1127
5,1,31,2,4,"copyin32@1130-1134@sys/arch/hppa/hppa/machdep.c","sys/arch/hppa/hppa/machdep.c","copyin32",1130,1134
10,2,82,3,11,"setstack@1141-1152@sys/arch/hppa/hppa/machdep.c","sys/arch/hppa/hppa/machdep.c","setstack",1141,1152
30,1,316,4,43,"setregs@1159-1202@sys/arch/hppa/hppa/machdep.c","sys/arch/hppa/hppa/machdep.c","setregs",1159,1202
82,9,805,6,94,"sendsig@1208-1302@sys/arch/hppa/hppa/machdep.c","sys/arch/hppa/hppa/machdep.c","sendsig",1208,1302
71,7,696,3,85,"sys_sigreturn@1305-1390@sys/arch/hppa/hppa/machdep.c","sys/arch/hppa/hppa/machdep.c","sys_sigreturn",1305,1390
5,1,21,1,4,"signotify@1393-1397@sys/arch/hppa/hppa/machdep.c","sys/arch/hppa/hppa/machdep.c","signotify",1393,1397
35,9,215,7,40,"cpu_sysctl@1403-1443@sys/arch/hppa/hppa/machdep.c","sys/arch/hppa/hppa/machdep.c","cpu_sysctl",1403,1443
3,1,6,1,5,"consinit@1451-1456@sys/arch/hppa/hppa/machdep.c","sys/arch/hppa/hppa/machdep.c","consinit",1451,1456
10,3,66,1,9,"blink_led_register@1466-1475@sys/arch/hppa/hppa/machdep.c","sys/arch/hppa/hppa/machdep.c","blink_led_register",1466,1475
16,3,117,1,26,"blink_led_timeout@1478-1504@sys/arch/hppa/hppa/machdep.c","sys/arch/hppa/hppa/machdep.c","blink_led_timeout",1478,1504
64,20,411,4,106,"mbus_add_mapping@163-269@sys/arch/hppa/hppa/mainbus.c","sys/arch/hppa/hppa/mainbus.c","mbus_add_mapping",163,269
15,4,97,5,17,"mbus_map@272-289@sys/arch/hppa/hppa/mainbus.c","sys/arch/hppa/hppa/mainbus.c","mbus_map",272,289
17,5,99,3,22,"mbus_unmap@292-314@sys/arch/hppa/hppa/mainbus.c","sys/arch/hppa/hppa/mainbus.c","mbus_unmap",292,314
21,6,150,9,24,"mbus_alloc@317-341@sys/arch/hppa/hppa/mainbus.c","sys/arch/hppa/hppa/mainbus.c","mbus_alloc",317,341
4,1,23,3,4,"mbus_free@344-348@sys/arch/hppa/hppa/mainbus.c","sys/arch/hppa/hppa/mainbus.c","mbus_free",344,348
6,1,33,5,5,"mbus_subregion@351-356@sys/arch/hppa/hppa/mainbus.c","sys/arch/hppa/hppa/mainbus.c","mbus_subregion",351,356
4,1,24,5,3,"mbus_barrier@359-362@sys/arch/hppa/hppa/mainbus.c","sys/arch/hppa/hppa/mainbus.c","mbus_barrier",359,362
4,1,20,2,3,"mbus_vaddr@365-368@sys/arch/hppa/hppa/mainbus.c","sys/arch/hppa/hppa/mainbus.c","mbus_vaddr",365,368
4,1,29,3,3,"mbus_r1@371-374@sys/arch/hppa/hppa/mainbus.c","sys/arch/hppa/hppa/mainbus.c","mbus_r1",371,374
4,1,29,3,3,"mbus_r2@377-380@sys/arch/hppa/hppa/mainbus.c","sys/arch/hppa/hppa/mainbus.c","mbus_r2",377,380
4,1,29,3,3,"mbus_r4@383-386@sys/arch/hppa/hppa/mainbus.c","sys/arch/hppa/hppa/mainbus.c","mbus_r4",383,386
4,1,29,3,3,"mbus_r8@389-392@sys/arch/hppa/hppa/mainbus.c","sys/arch/hppa/hppa/mainbus.c","mbus_r8",389,392
4,1,33,4,3,"mbus_w1@395-398@sys/arch/hppa/hppa/mainbus.c","sys/arch/hppa/hppa/mainbus.c","mbus_w1",395,398
4,1,33,4,3,"mbus_w2@401-404@sys/arch/hppa/hppa/mainbus.c","sys/arch/hppa/hppa/mainbus.c","mbus_w2",401,404
4,1,33,4,3,"mbus_w4@407-410@sys/arch/hppa/hppa/mainbus.c","sys/arch/hppa/hppa/mainbus.c","mbus_w4",407,410
4,1,33,4,3,"mbus_w8@413-416@sys/arch/hppa/hppa/mainbus.c","sys/arch/hppa/hppa/mainbus.c","mbus_w8",413,416
6,2,44,5,5,"mbus_rm_1@420-425@sys/arch/hppa/hppa/mainbus.c","sys/arch/hppa/hppa/mainbus.c","mbus_rm_1",420,425
6,2,44,5,5,"mbus_rm_2@428-433@sys/arch/hppa/hppa/mainbus.c","sys/arch/hppa/hppa/mainbus.c","mbus_rm_2",428,433
6,2,44,5,5,"mbus_rm_4@436-441@sys/arch/hppa/hppa/mainbus.c","sys/arch/hppa/hppa/mainbus.c","mbus_rm_4",436,441
6,2,44,5,5,"mbus_rm_8@444-449@sys/arch/hppa/hppa/mainbus.c","sys/arch/hppa/hppa/mainbus.c","mbus_rm_8",444,449
6,2,45,5,5,"mbus_wm_1@452-457@sys/arch/hppa/hppa/mainbus.c","sys/arch/hppa/hppa/mainbus.c","mbus_wm_1",452,457
6,2,45,5,5,"mbus_wm_2@460-465@sys/arch/hppa/hppa/mainbus.c","sys/arch/hppa/hppa/mainbus.c","mbus_wm_2",460,465
6,2,45,5,5,"mbus_wm_4@468-473@sys/arch/hppa/hppa/mainbus.c","sys/arch/hppa/hppa/mainbus.c","mbus_wm_4",468,473
6,2,45,5,5,"mbus_wm_8@476-481@sys/arch/hppa/hppa/mainbus.c","sys/arch/hppa/hppa/mainbus.c","mbus_wm_8",476,481
6,2,39,5,5,"mbus_sm_1@484-489@sys/arch/hppa/hppa/mainbus.c","sys/arch/hppa/hppa/mainbus.c","mbus_sm_1",484,489
6,2,39,5,5,"mbus_sm_2@492-497@sys/arch/hppa/hppa/mainbus.c","sys/arch/hppa/hppa/mainbus.c","mbus_sm_2",492,497
6,2,39,5,5,"mbus_sm_4@500-505@sys/arch/hppa/hppa/mainbus.c","sys/arch/hppa/hppa/mainbus.c","mbus_sm_4",500,505
6,2,39,5,5,"mbus_sm_8@508-513@sys/arch/hppa/hppa/mainbus.c","sys/arch/hppa/hppa/mainbus.c","mbus_sm_8",508,513
6,2,49,5,6,"mbus_rr_1@516-522@sys/arch/hppa/hppa/mainbus.c","sys/arch/hppa/hppa/mainbus.c","mbus_rr_1",516,522
6,2,49,5,6,"mbus_rr_2@525-531@sys/arch/hppa/hppa/mainbus.c","sys/arch/hppa/hppa/mainbus.c","mbus_rr_2",525,531
6,2,49,5,6,"mbus_rr_4@534-540@sys/arch/hppa/hppa/mainbus.c","sys/arch/hppa/hppa/mainbus.c","mbus_rr_4",534,540
6,2,49,5,6,"mbus_rr_8@543-549@sys/arch/hppa/hppa/mainbus.c","sys/arch/hppa/hppa/mainbus.c","mbus_rr_8",543,549
6,2,50,5,6,"mbus_wr_1@552-558@sys/arch/hppa/hppa/mainbus.c","sys/arch/hppa/hppa/mainbus.c","mbus_wr_1",552,558
6,2,50,5,6,"mbus_wr_2@561-567@sys/arch/hppa/hppa/mainbus.c","sys/arch/hppa/hppa/mainbus.c","mbus_wr_2",561,567
6,2,50,5,6,"mbus_wr_4@570-576@sys/arch/hppa/hppa/mainbus.c","sys/arch/hppa/hppa/mainbus.c","mbus_wr_4",570,576
6,2,50,5,6,"mbus_wr_8@579-585@sys/arch/hppa/hppa/mainbus.c","sys/arch/hppa/hppa/mainbus.c","mbus_wr_8",579,585
6,2,46,5,6,"mbus_sr_1@588-594@sys/arch/hppa/hppa/mainbus.c","sys/arch/hppa/hppa/mainbus.c","mbus_sr_1",588,594
6,2,46,5,6,"mbus_sr_2@597-603@sys/arch/hppa/hppa/mainbus.c","sys/arch/hppa/hppa/mainbus.c","mbus_sr_2",597,603
6,2,46,5,6,"mbus_sr_4@606-612@sys/arch/hppa/hppa/mainbus.c","sys/arch/hppa/hppa/mainbus.c","mbus_sr_4",606,612
6,2,46,5,6,"mbus_sr_8@615-621@sys/arch/hppa/hppa/mainbus.c","sys/arch/hppa/hppa/mainbus.c","mbus_sr_8",615,621
8,2,66,6,8,"mbus_cp_1@624-632@sys/arch/hppa/hppa/mainbus.c","sys/arch/hppa/hppa/mainbus.c","mbus_cp_1",624,632
8,2,66,6,8,"mbus_cp_2@635-643@sys/arch/hppa/hppa/mainbus.c","sys/arch/hppa/hppa/mainbus.c","mbus_cp_2",635,643
8,2,66,6,8,"mbus_cp_4@646-654@sys/arch/hppa/hppa/mainbus.c","sys/arch/hppa/hppa/mainbus.c","mbus_cp_4",646,654
8,2,66,6,8,"mbus_cp_8@657-665@sys/arch/hppa/hppa/mainbus.c","sys/arch/hppa/hppa/mainbus.c","mbus_cp_8",657,665
22,3,151,7,24,"mbus_dmamap_create@724-748@sys/arch/hppa/hppa/mainbus.c","sys/arch/hppa/hppa/mainbus.c","mbus_dmamap_create",724,748
5,1,23,2,4,"mbus_dmamap_unload@751-755@sys/arch/hppa/hppa/mainbus.c","sys/arch/hppa/hppa/mainbus.c","mbus_dmamap_unload",751,755
6,2,35,2,6,"mbus_dmamap_destroy@758-764@sys/arch/hppa/hppa/mainbus.c","sys/arch/hppa/hppa/mainbus.c","mbus_dmamap_destroy",758,764
53,13,378,9,76,"_bus_dmamap_load_buffer@773-849@sys/arch/hppa/hppa/mainbus.c","sys/arch/hppa/hppa/mainbus.c","_bus_dmamap_load_buffer",773,849
19,3,119,6,25,"mbus_dmamap_load@852-877@sys/arch/hppa/hppa/mainbus.c","sys/arch/hppa/hppa/mainbus.c","mbus_dmamap_load",852,877
28,8,192,4,34,"mbus_dmamap_load_mbuf@880-914@sys/arch/hppa/hppa/mainbus.c","sys/arch/hppa/hppa/mainbus.c","mbus_dmamap_load_mbuf",880,914
37,10,250,4,52,"mbus_dmamap_load_uio@917-969@sys/arch/hppa/hppa/mainbus.c","sys/arch/hppa/hppa/mainbus.c","mbus_dmamap_load_uio",917,969
21,7,172,6,26,"mbus_dmamap_load_raw@972-998@sys/arch/hppa/hppa/mainbus.c","sys/arch/hppa/hppa/mainbus.c","mbus_dmamap_load_raw",972,998
23,7,147,5,27,"mbus_dmamap_sync@1001-1028@sys/arch/hppa/hppa/mainbus.c","sys/arch/hppa/hppa/mainbus.c","mbus_dmamap_sync",1001,1028
24,5,183,8,30,"mbus_dmamem_alloc@1031-1061@sys/arch/hppa/hppa/mainbus.c","sys/arch/hppa/hppa/mainbus.c","mbus_dmamem_alloc",1031,1061
18,4,124,3,18,"mbus_dmamem_free@1064-1082@sys/arch/hppa/hppa/mainbus.c","sys/arch/hppa/hppa/mainbus.c","mbus_dmamem_free",1064,1082
6,1,41,6,5,"mbus_dmamem_map@1085-1090@sys/arch/hppa/hppa/mainbus.c","sys/arch/hppa/hppa/mainbus.c","mbus_dmamem_map",1085,1090
3,1,14,3,2,"mbus_dmamem_unmap@1093-1095@sys/arch/hppa/hppa/mainbus.c","sys/arch/hppa/hppa/mainbus.c","mbus_dmamem_unmap",1093,1095
5,1,29,6,4,"mbus_dmamem_mmap@1098-1102@sys/arch/hppa/hppa/mainbus.c","sys/arch/hppa/hppa/mainbus.c","mbus_dmamem_mmap",1098,1102
10,2,42,3,12,"mbmatch@1116-1128@sys/arch/hppa/hppa/mainbus.c","sys/arch/hppa/hppa/mainbus.c","mbmatch",1116,1128
83,28,602,3,107,"mbattach@1131-1238@sys/arch/hppa/hppa/mainbus.c","sys/arch/hppa/hppa/mainbus.c","mbattach",1131,1238
7,1,28,1,8,"cpu_gethpa@1244-1252@sys/arch/hppa/hppa/mainbus.c","sys/arch/hppa/hppa/mainbus.c","cpu_gethpa",1244,1252
18,6,115,2,19,"mbprint@1255-1274@sys/arch/hppa/hppa/mainbus.c","sys/arch/hppa/hppa/mainbus.c","mbprint",1255,1274
17,7,135,3,20,"mbsubmatch@1277-1297@sys/arch/hppa/hppa/mainbus.c","sys/arch/hppa/hppa/mainbus.c","mbsubmatch",1277,1297
8,3,48,3,9,"memmatch@158-167@sys/arch/hppa/hppa/mem.c","sys/arch/hppa/hppa/mem.c","memmatch",158,167
73,27,471,3,98,"memattach@170-268@sys/arch/hppa/hppa/mem.c","sys/arch/hppa/hppa/mem.c","memattach",170,268
7,2,35,1,8,"viper_setintrwnd@271-279@sys/arch/hppa/hppa/mem.c","sys/arch/hppa/hppa/mem.c","viper_setintrwnd",271,279
16,2,80,1,17,"viper_eisa_en@282-299@sys/arch/hppa/hppa/mem.c","sys/arch/hppa/hppa/mem.c","viper_eisa_en",282,299
17,7,72,4,17,"mmopen@302-319@sys/arch/hppa/hppa/mem.c","sys/arch/hppa/hppa/mem.c","mmopen",302,319
4,1,23,4,3,"mmclose@322-325@sys/arch/hppa/hppa/mem.c","sys/arch/hppa/hppa/mem.c","mmclose",322,325
58,16,344,3,73,"mmrw@328-401@sys/arch/hppa/hppa/mem.c","sys/arch/hppa/hppa/mem.c","mmrw",328,401
9,5,57,3,14,"mmmmap@404-418@sys/arch/hppa/hppa/mem.c","sys/arch/hppa/hppa/mem.c","mmmmap",404,418
4,1,26,5,3,"mmioctl@421-424@sys/arch/hppa/hppa/mem.c","sys/arch/hppa/hppa/mem.c","mmioctl",421,424
10,2,66,2,11,"__mtx_init@45-56@sys/arch/hppa/hppa/mutex.c","sys/arch/hppa/hppa/mutex.c","__mtx_init",45,56
5,2,19,1,4,"__mtx_enter@60-64@sys/arch/hppa/hppa/mutex.c","sys/arch/hppa/hppa/mutex.c","__mtx_enter",60,64
27,8,148,1,37,"__mtx_enter_try@67-104@sys/arch/hppa/hppa/mutex.c","sys/arch/hppa/hppa/mutex.c","__mtx_enter_try",67,104
10,5,66,1,17,"__mtx_enter@107-124@sys/arch/hppa/hppa/mutex.c","sys/arch/hppa/hppa/mutex.c","__mtx_enter",107,124
5,1,19,1,4,"__mtx_enter_try@127-131@sys/arch/hppa/hppa/mutex.c","sys/arch/hppa/hppa/mutex.c","__mtx_enter_try",127,131
13,5,68,1,21,"__mtx_leave@135-156@sys/arch/hppa/hppa/mutex.c","sys/arch/hppa/hppa/mutex.c","__mtx_leave",135,156
5,2,25,1,4,"pmap_lock@121-125@sys/arch/hppa/hppa/pmap.c","sys/arch/hppa/hppa/pmap.c","pmap_lock",121,125
5,2,25,1,4,"pmap_unlock@128-132@sys/arch/hppa/hppa/pmap.c","sys/arch/hppa/hppa/pmap.c","pmap_unlock",128,132
8,2,48,2,9,"pmap_pagealloc@135-144@sys/arch/hppa/hppa/pmap.c","sys/arch/hppa/hppa/pmap.c","pmap_pagealloc",135,144
5,1,48,2,4,"pmap_hash@151-155@sys/arch/hppa/hppa/pmap.c","sys/arch/hppa/hppa/pmap.c","pmap_hash",151,155
5,1,36,2,4,"pmap_vtag@158-162@sys/arch/hppa/hppa/pmap.c","sys/arch/hppa/hppa/pmap.c","pmap_vtag",158,162
8,3,44,2,10,"pmap_sdir_set@166-176@sys/arch/hppa/hppa/pmap.c","sys/arch/hppa/hppa/pmap.c","pmap_sdir_set",166,176
6,1,30,1,6,"pmap_sdir_get@179-185@sys/arch/hppa/hppa/pmap.c","sys/arch/hppa/hppa/pmap.c","pmap_sdir_get",179,185
4,1,27,2,3,"pmap_pde_get@188-191@sys/arch/hppa/hppa/pmap.c","sys/arch/hppa/hppa/pmap.c","pmap_pde_get",188,191
8,3,57,3,10,"pmap_pde_set@194-204@sys/arch/hppa/hppa/pmap.c","sys/arch/hppa/hppa/pmap.c","pmap_pde_set",194,204
30,4,195,3,34,"pmap_pde_alloc@207-241@sys/arch/hppa/hppa/pmap.c","sys/arch/hppa/hppa/pmap.c","pmap_pde_alloc",207,241
9,3,80,2,12,"pmap_pde_ptp@244-256@sys/arch/hppa/hppa/pmap.c","sys/arch/hppa/hppa/pmap.c","pmap_pde_ptp",244,256
23,6,156,3,27,"pmap_pde_release@259-286@sys/arch/hppa/hppa/pmap.c","sys/arch/hppa/hppa/pmap.c","pmap_pde_release",259,286
4,1,27,2,3,"pmap_pte_get@289-292@sys/arch/hppa/hppa/pmap.c","sys/arch/hppa/hppa/pmap.c","pmap_pte_get",289,292
10,4,72,3,14,"pmap_pte_set@295-309@sys/arch/hppa/hppa/pmap.c","sys/arch/hppa/hppa/pmap.c","pmap_pte_set",295,309
16,5,115,3,17,"pmap_pte_flush@312-329@sys/arch/hppa/hppa/pmap.c","sys/arch/hppa/hppa/pmap.c","pmap_pte_flush",312,329
7,2,48,2,8,"pmap_vp_find@332-340@sys/arch/hppa/hppa/pmap.c","sys/arch/hppa/hppa/pmap.c","pmap_vp_find",332,340
29,10,191,2,33,"pmap_dump_table@344-377@sys/arch/hppa/hppa/pmap.c","sys/arch/hppa/hppa/pmap.c","pmap_dump_table",344,377
10,3,65,1,10,"pmap_dump_pv@380-390@sys/arch/hppa/hppa/pmap.c","sys/arch/hppa/hppa/pmap.c","pmap_dump_pv",380,390
18,5,129,3,22,"pmap_check_alias@394-416@sys/arch/hppa/hppa/pmap.c","sys/arch/hppa/hppa/pmap.c","pmap_check_alias",394,416
8,1,50,1,11,"pmap_pv_alloc@419-430@sys/arch/hppa/hppa/pmap.c","sys/arch/hppa/hppa/pmap.c","pmap_pv_alloc",419,430
6,2,38,1,6,"pmap_pv_free@433-439@sys/arch/hppa/hppa/pmap.c","sys/arch/hppa/hppa/pmap.c","pmap_pv_free",433,439
13,1,104,5,12,"pmap_pv_enter@442-454@sys/arch/hppa/hppa/pmap.c","sys/arch/hppa/hppa/pmap.c","pmap_pv_enter",442,454
13,4,108,3,13,"pmap_pv_remove@457-470@sys/arch/hppa/hppa/pmap.c","sys/arch/hppa/hppa/pmap.c","pmap_pv_remove",457,470
112,18,862,1,156,"pmap_bootstrap@473-629@sys/arch/hppa/hppa/pmap.c","sys/arch/hppa/hppa/pmap.c","pmap_bootstrap",473,629
20,2,158,1,30,"pmap_init@632-662@sys/arch/hppa/hppa/pmap.c","sys/arch/hppa/hppa/pmap.c","pmap_init",632,662
5,1,24,2,4,"pmap_virtual_space@665-669@sys/arch/hppa/hppa/pmap.c","sys/arch/hppa/hppa/pmap.c","pmap_virtual_space",665,669
21,3,176,1,29,"pmap_create@672-701@sys/arch/hppa/hppa/pmap.c","sys/arch/hppa/hppa/pmap.c","pmap_create",672,701
17,2,118,1,22,"pmap_destroy@704-726@sys/arch/hppa/hppa/pmap.c","sys/arch/hppa/hppa/pmap.c","pmap_destroy",704,726
5,1,32,1,5,"pmap_reference@732-737@sys/arch/hppa/hppa/pmap.c","sys/arch/hppa/hppa/pmap.c","pmap_reference",732,737
4,1,22,1,4,"pmap_collect@740-744@sys/arch/hppa/hppa/pmap.c","sys/arch/hppa/hppa/pmap.c","pmap_collect",740,744
77,20,560,5,88,"pmap_enter@747-835@sys/arch/hppa/hppa/pmap.c","sys/arch/hppa/hppa/pmap.c","pmap_enter",747,835
49,12,332,3,60,"pmap_remove@838-898@sys/arch/hppa/hppa/pmap.c","sys/arch/hppa/hppa/pmap.c","pmap_remove",838,898
39,7,271,4,49,"pmap_write_protect@901-950@sys/arch/hppa/hppa/pmap.c","sys/arch/hppa/hppa/pmap.c","pmap_write_protect",901,950
34,4,242,1,42,"pmap_page_remove@953-995@sys/arch/hppa/hppa/pmap.c","sys/arch/hppa/hppa/pmap.c","pmap_page_remove",953,995
19,5,130,2,25,"pmap_unwire@998-1023@sys/arch/hppa/hppa/pmap.c","sys/arch/hppa/hppa/pmap.c","pmap_unwire",998,1023
33,6,227,3,39,"pmap_changebit@1026-1065@sys/arch/hppa/hppa/pmap.c","sys/arch/hppa/hppa/pmap.c","pmap_changebit",1026,1065
16,3,132,2,18,"pmap_testbit@1068-1086@sys/arch/hppa/hppa/pmap.c","sys/arch/hppa/hppa/pmap.c","pmap_testbit",1068,1086
12,3,78,3,14,"pmap_extract@1089-1103@sys/arch/hppa/hppa/pmap.c","sys/arch/hppa/hppa/pmap.c","pmap_extract",1089,1103
6,1,42,1,6,"pmap_activate@1106-1112@sys/arch/hppa/hppa/pmap.c","sys/arch/hppa/hppa/pmap.c","pmap_activate",1106,1112
3,1,9,1,3,"pmap_deactivate@1115-1118@sys/arch/hppa/hppa/pmap.c","sys/arch/hppa/hppa/pmap.c","pmap_deactivate",1115,1118
15,3,133,2,16,"pmap_flush_page@1121-1137@sys/arch/hppa/hppa/pmap.c","sys/arch/hppa/hppa/pmap.c","pmap_flush_page",1121,1137
9,1,64,1,10,"pmap_zero_page@1140-1150@sys/arch/hppa/hppa/pmap.c","sys/arch/hppa/hppa/pmap.c","pmap_zero_page",1140,1150
13,1,108,2,13,"pmap_copy_page@1153-1166@sys/arch/hppa/hppa/pmap.c","sys/arch/hppa/hppa/pmap.c","pmap_copy_page",1153,1166
28,7,217,3,33,"pmap_kenter_pa@1169-1202@sys/arch/hppa/hppa/pmap.c","sys/arch/hppa/hppa/pmap.c","pmap_kenter_pa",1169,1202
37,10,271,2,45,"pmap_kremove@1205-1250@sys/arch/hppa/hppa/pmap.c","sys/arch/hppa/hppa/pmap.c","pmap_kremove",1205,1250
8,1,58,3,8,"pmap_proc_iflush@1253-1261@sys/arch/hppa/hppa/pmap.c","sys/arch/hppa/hppa/pmap.c","pmap_proc_iflush",1253,1261
6,1,31,1,5,"pmap_unmap_direct@1264-1269@sys/arch/hppa/hppa/pmap.c","sys/arch/hppa/hppa/pmap.c","pmap_unmap_direct",1264,1269
52,1,500,2,57,"process_read_regs@40-97@sys/arch/hppa/hppa/process_machdep.c","sys/arch/hppa/hppa/process_machdep.c","process_read_regs",40,97
6,1,44,2,7,"process_read_fpregs@100-107@sys/arch/hppa/hppa/process_machdep.c","sys/arch/hppa/hppa/process_machdep.c","process_read_fpregs",100,107
39,1,399,2,42,"process_write_regs@112-154@sys/arch/hppa/hppa/process_machdep.c","sys/arch/hppa/hppa/process_machdep.c","process_write_regs",112,154
6,1,44,2,7,"process_write_fpregs@157-164@sys/arch/hppa/hppa/process_machdep.c","sys/arch/hppa/hppa/process_machdep.c","process_write_fpregs",157,164
6,1,50,2,6,"process_set_pc@169-175@sys/arch/hppa/hppa/process_machdep.c","sys/arch/hppa/hppa/process_machdep.c","process_set_pc",169,175
15,1,59,3,17,"sys_sysarch@41-58@sys/arch/hppa/hppa/sys_machdep.c","sys/arch/hppa/hppa/sys_machdep.c","sys_sysarch",41,58
6,4,40,1,5,"inst_store@51-56@sys/arch/hppa/hppa/trap.c","sys/arch/hppa/hppa/trap.c","inst_store",51,56
8,2,43,1,8,"ast@138-146@sys/arch/hppa/hppa/trap.c","sys/arch/hppa/hppa/trap.c","ast",138,146
374,140,2129,2,504,"trap@149-653@sys/arch/hppa/hppa/trap.c","sys/arch/hppa/hppa/trap.c","trap",149,653
11,1,63,1,17,"child_return@656-673@sys/arch/hppa/hppa/trap.c","sys/arch/hppa/hppa/trap.c","child_return",656,673
15,1,108,3,15,"ss_get_value@683-698@sys/arch/hppa/hppa/trap.c","sys/arch/hppa/hppa/trap.c","ss_get_value",683,698
15,1,108,3,15,"ss_put_value@701-716@sys/arch/hppa/hppa/trap.c","sys/arch/hppa/hppa/trap.c","ss_put_value",701,716
8,2,71,1,8,"ss_clear_breakpoints@719-727@sys/arch/hppa/hppa/trap.c","sys/arch/hppa/hppa/trap.c","ss_clear_breakpoints",719,727
30,8,250,2,46,"process_sstep@730-776@sys/arch/hppa/hppa/trap.c","sys/arch/hppa/hppa/trap.c","process_sstep",730,776
111,27,684,1,139,"syscall@786-925@sys/arch/hppa/hppa/trap.c","sys/arch/hppa/hppa/trap.c","syscall",786,925
50,17,234,2,68,"pcxs_unaligned@933-1001@sys/arch/hppa/hppa/trap.c","sys/arch/hppa/hppa/trap.c","pcxs_unaligned",933,1001
49,5,535,6,72,"cpu_fork@52-124@sys/arch/hppa/hppa/vm_machdep.c","sys/arch/hppa/hppa/vm_machdep.c","cpu_fork",52,124
8,1,46,1,10,"cpu_exit@127-137@sys/arch/hppa/hppa/vm_machdep.c","sys/arch/hppa/hppa/vm_machdep.c","cpu_exit",127,137
25,5,181,2,29,"vmapbuf@143-172@sys/arch/hppa/hppa/vm_machdep.c","sys/arch/hppa/hppa/vm_machdep.c","vmapbuf",143,172
14,3,103,2,16,"vunmapbuf@178-194@sys/arch/hppa/hppa/vm_machdep.c","sys/arch/hppa/hppa/vm_machdep.c","vunmapbuf",178,194
3,1,9,1,10,"wscnprobe@49-59@sys/arch/hppa/hppa/wscons_machdep.c","sys/arch/hppa/hppa/wscons_machdep.c","wscnprobe",49,59
3,1,9,1,2,"wscninit@62-64@sys/arch/hppa/hppa/wscons_machdep.c","sys/arch/hppa/hppa/wscons_machdep.c","wscninit",62,64
4,2,17,2,5,"wscnputc@67-72@sys/arch/hppa/hppa/wscons_machdep.c","sys/arch/hppa/hppa/wscons_machdep.c","wscnputc",67,72
5,2,20,1,7,"wscngetc@75-82@sys/arch/hppa/hppa/wscons_machdep.c","sys/arch/hppa/hppa/wscons_machdep.c","wscngetc",75,82
4,2,17,2,5,"wscnpollc@85-90@sys/arch/hppa/hppa/wscons_machdep.c","sys/arch/hppa/hppa/wscons_machdep.c","wscnpollc",85,90
4,1,13,1,3,"__cpu_simple_lock_init@16-19@sys/arch/hppa/include/atomic.h","sys/arch/hppa/include/atomic.h","__cpu_simple_lock_init",16,19
6,1,38,1,7,"__cpu_simple_lock_ldcws@22-29@sys/arch/hppa/include/atomic.h","sys/arch/hppa/include/atomic.h","__cpu_simple_lock_ldcws",22,29
4,1,18,1,3,"__cpu_simple_lock_try@32-35@sys/arch/hppa/include/atomic.h","sys/arch/hppa/include/atomic.h","__cpu_simple_lock_try",32,35
5,2,17,1,4,"__cpu_simple_lock@38-42@sys/arch/hppa/include/atomic.h","sys/arch/hppa/include/atomic.h","__cpu_simple_lock",38,42
4,1,13,1,3,"__cpu_simple_unlock@45-48@sys/arch/hppa/include/atomic.h","sys/arch/hppa/include/atomic.h","__cpu_simple_unlock",45,48
8,1,33,1,9,"atomic_enter@60-69@sys/arch/hppa/include/atomic.h","sys/arch/hppa/include/atomic.h","atomic_enter",60,69
5,1,20,1,4,"atomic_leave@72-76@sys/arch/hppa/include/atomic.h","sys/arch/hppa/include/atomic.h","atomic_leave",72,76
11,2,57,3,12,"_atomic_cas_uint@79-91@sys/arch/hppa/include/atomic.h","sys/arch/hppa/include/atomic.h","_atomic_cas_uint",79,91
11,2,57,3,12,"_atomic_cas_ulong@95-107@sys/arch/hppa/include/atomic.h","sys/arch/hppa/include/atomic.h","_atomic_cas_ulong",95,107
12,2,70,3,13,"_atomic_cas_ptr@111-124@sys/arch/hppa/include/atomic.h","sys/arch/hppa/include/atomic.h","_atomic_cas_ptr",111,124
10,1,47,2,11,"_atomic_swap_uint@128-139@sys/arch/hppa/include/atomic.h","sys/arch/hppa/include/atomic.h","_atomic_swap_uint",128,139
10,1,47,2,11,"_atomic_swap_ulong@143-154@sys/arch/hppa/include/atomic.h","sys/arch/hppa/include/atomic.h","_atomic_swap_ulong",143,154
11,1,60,2,12,"_atomic_swap_ptr@158-170@sys/arch/hppa/include/atomic.h","sys/arch/hppa/include/atomic.h","_atomic_swap_ptr",158,170
10,1,49,2,11,"_atomic_add_int_nv@174-185@sys/arch/hppa/include/atomic.h","sys/arch/hppa/include/atomic.h","_atomic_add_int_nv",174,185
10,1,49,2,11,"_atomic_add_long_nv@190-201@sys/arch/hppa/include/atomic.h","sys/arch/hppa/include/atomic.h","_atomic_add_long_nv",190,201
7,1,33,2,7,"atomic_setbits_int@206-213@sys/arch/hppa/include/atomic.h","sys/arch/hppa/include/atomic.h","atomic_setbits_int",206,213
7,1,33,2,7,"atomic_clearbits_int@216-223@sys/arch/hppa/include/atomic.h","sys/arch/hppa/include/atomic.h","atomic_clearbits_int",216,223
7,1,33,2,7,"atomic_setbits_long@226-233@sys/arch/hppa/include/atomic.h","sys/arch/hppa/include/atomic.h","atomic_setbits_long",226,233
7,1,33,2,7,"atomic_clearbits_long@236-243@sys/arch/hppa/include/atomic.h","sys/arch/hppa/include/atomic.h","atomic_clearbits_long",236,243
4,1,16,1,3,"__insn_barrier@253-256@sys/arch/hppa/include/atomic.h","sys/arch/hppa/include/atomic.h","__insn_barrier",253,256
6,1,25,1,7,"curcpu@130-137@sys/arch/hppa/include/cpu.h","sys/arch/hppa/include/cpu.h","curcpu",130,137
5,1,29,1,4,"ldsid@69-73@sys/arch/hppa/include/cpufunc.h","sys/arch/hppa/include/cpufunc.h","ldsid",69,73
6,1,30,1,5,"mtsm@92-97@sys/arch/hppa/include/cpufunc.h","sys/arch/hppa/include/cpufunc.h","mtsm",92,97
5,1,36,3,4,"iitlba@105-109@sys/arch/hppa/include/cpufunc.h","sys/arch/hppa/include/cpufunc.h","iitlba",105,109
5,1,36,3,4,"idtlba@112-116@sys/arch/hppa/include/cpufunc.h","sys/arch/hppa/include/cpufunc.h","idtlba",112,116
5,1,36,3,4,"iitlbp@119-123@sys/arch/hppa/include/cpufunc.h","sys/arch/hppa/include/cpufunc.h","iitlbp",119,123
5,1,36,3,4,"idtlbp@126-130@sys/arch/hppa/include/cpufunc.h","sys/arch/hppa/include/cpufunc.h","idtlbp",126,130
5,1,28,2,4,"pitlb@133-137@sys/arch/hppa/include/cpufunc.h","sys/arch/hppa/include/cpufunc.h","pitlb",133,137
5,1,28,2,4,"pdtlb@140-144@sys/arch/hppa/include/cpufunc.h","sys/arch/hppa/include/cpufunc.h","pdtlb",140,144
5,1,28,2,4,"pitlbe@147-151@sys/arch/hppa/include/cpufunc.h","sys/arch/hppa/include/cpufunc.h","pitlbe",147,151
5,1,28,2,4,"pdtlbe@154-158@sys/arch/hppa/include/cpufunc.h","sys/arch/hppa/include/cpufunc.h","pdtlbe",154,158
24,9,116,3,26,"ledctl@174-200@sys/arch/hppa/include/cpufunc.h","sys/arch/hppa/include/cpufunc.h","ledctl",174,200
5,3,32,1,4,"inst_call@51-55@sys/arch/hppa/include/db_machdep.h","sys/arch/hppa/include/db_machdep.h","inst_call",51,55
6,4,40,1,5,"inst_branch@56-61@sys/arch/hppa/include/db_machdep.h","sys/arch/hppa/include/db_machdep.h","inst_branch",56,61
4,2,24,1,3,"inst_return@62-65@sys/arch/hppa/include/db_machdep.h","sys/arch/hppa/include/db_machdep.h","inst_return",62,65
3,1,16,1,2,"inst_trap_return@66-68@sys/arch/hppa/include/db_machdep.h","sys/arch/hppa/include/db_machdep.h","inst_trap_return",66,68
3,1,17,2,2,"next_instr_address@78-80@sys/arch/hppa/include/db_machdep.h","sys/arch/hppa/include/db_machdep.h","next_instr_address",78,80
3,1,19,3,2,"branch_taken1@84-86@sys/arch/hppa/include/db_machdep.h","sys/arch/hppa/include/db_machdep.h","branch_taken1",84,86
10,1,58,1,11,"spllower@93-104@sys/arch/hppa/include/intr.h","sys/arch/hppa/include/intr.h","spllower",93,104
9,2,50,1,10,"splraise@107-117@sys/arch/hppa/include/intr.h","sys/arch/hppa/include/intr.h","splraise",107,117
4,1,15,1,3,"splx@120-123@sys/arch/hppa/include/intr.h","sys/arch/hppa/include/intr.h","splx",120,123
7,1,29,1,8,"hppa_intr_disable@126-134@sys/arch/hppa/include/intr.h","sys/arch/hppa/include/intr.h","hppa_intr_disable",126,134
4,1,18,1,3,"hppa_intr_enable@137-140@sys/arch/hppa/include/intr.h","sys/arch/hppa/include/intr.h","hppa_intr_enable",137,140
7,2,38,2,6,"pmap_prefer@96-102@sys/arch/hppa/include/pmap.h","sys/arch/hppa/include/pmap.h","pmap_prefer",96,102
5,2,38,2,4,"pmap_prot@131-135@sys/arch/hppa/include/pmap.h","sys/arch/hppa/include/pmap.h","pmap_prot",131,135
9,3,52,2,8,"pmap_page_protect@138-146@sys/arch/hppa/include/pmap.h","sys/arch/hppa/include/pmap.h","pmap_page_protect",138,146
9,3,61,4,8,"pmap_protect@149-157@sys/arch/hppa/include/pmap.h","sys/arch/hppa/include/pmap.h","pmap_protect",149,157
7,2,36,5,7,"md_space_map@25-32@sys/arch/hppa/include/rbus_machdep.h","sys/arch/hppa/include/rbus_machdep.h","md_space_map",25,32
6,1,23,1,5,"__hppa_get_tcb@36-41@sys/arch/hppa/include/tcb.h","sys/arch/hppa/include/tcb.h","__hppa_get_tcb",36,41
336,72,1582,4,478,"dbl_fadd@24-502@sys/arch/hppa/spmath/dfadd.c","sys/arch/hppa/spmath/dfadd.c","dbl_fadd",24,502
105,28,516,4,130,"dbl_fcmp@24-154@sys/arch/hppa/spmath/dfcmp.c","sys/arch/hppa/spmath/dfcmp.c","dbl_fcmp",24,154
263,80,1458,4,356,"dbl_fdiv@25-381@sys/arch/hppa/spmath/dfdiv.c","sys/arch/hppa/spmath/dfdiv.c","dbl_fdiv",25,381
246,73,1399,4,346,"dbl_fmpy@25-371@sys/arch/hppa/spmath/dfmpy.c","sys/arch/hppa/spmath/dfmpy.c","dbl_fmpy",25,371
147,36,908,4,247,"dbl_frem@24-271@sys/arch/hppa/spmath/dfrem.c","sys/arch/hppa/spmath/dfrem.c","dbl_frem",24,271
97,22,607,4,142,"dbl_fsqrt@26-168@sys/arch/hppa/spmath/dfsqrt.c","sys/arch/hppa/spmath/dfsqrt.c","dbl_fsqrt",26,168
334,72,1595,4,476,"dbl_fsub@24-500@sys/arch/hppa/spmath/dfsub.c","sys/arch/hppa/spmath/dfsub.c","dbl_fsub",24,500
41,12,185,3,61,"divsfm@20-81@sys/arch/hppa/spmath/divsfm.c","sys/arch/hppa/spmath/divsfm.c","divsfm",20,81
38,11,176,3,56,"divsfr@20-76@sys/arch/hppa/spmath/divsfr.c","sys/arch/hppa/spmath/divsfr.c","divsfr",20,76
44,12,191,3,63,"divsim@20-83@sys/arch/hppa/spmath/divsim.c","sys/arch/hppa/spmath/divsim.c","divsim",20,83
38,10,173,3,55,"divsir@20-75@sys/arch/hppa/spmath/divsir.c","sys/arch/hppa/spmath/divsir.c","divsir",20,75
15,3,64,3,19,"divufr@20-39@sys/arch/hppa/spmath/divufr.c","sys/arch/hppa/spmath/divufr.c","divufr",20,39
11,2,50,3,13,"divuir@20-33@sys/arch/hppa/spmath/divuir.c","sys/arch/hppa/spmath/divuir.c","divuir",20,33
50,7,271,4,79,"sgl_to_dbl_fcnvff@27-106@sys/arch/hppa/spmath/fcnvff.c","sys/arch/hppa/spmath/fcnvff.c","sgl_to_dbl_fcnvff",27,106
114,35,616,4,174,"dbl_to_sgl_fcnvff@113-287@sys/arch/hppa/spmath/fcnvff.c","sys/arch/hppa/spmath/fcnvff.c","dbl_to_sgl_fcnvff",113,287
76,30,403,4,91,"sgl_to_sgl_fcnvfx@27-118@sys/arch/hppa/spmath/fcnvfx.c","sys/arch/hppa/spmath/fcnvfx.c","sgl_to_sgl_fcnvfx",27,118
101,30,492,4,116,"sgl_to_dbl_fcnvfx@125-241@sys/arch/hppa/spmath/fcnvfx.c","sys/arch/hppa/spmath/fcnvfx.c","sgl_to_dbl_fcnvfx",125,241
96,37,525,4,114,"dbl_to_sgl_fcnvfx@248-362@sys/arch/hppa/spmath/fcnvfx.c","sys/arch/hppa/spmath/fcnvfx.c","dbl_to_sgl_fcnvfx",248,362
100,30,497,4,116,"dbl_to_dbl_fcnvfx@369-485@sys/arch/hppa/spmath/fcnvfx.c","sys/arch/hppa/spmath/fcnvfx.c","dbl_to_dbl_fcnvfx",369,485
43,13,245,4,56,"sgl_to_sgl_fcnvfxt@28-84@sys/arch/hppa/spmath/fcnvfxt.c","sys/arch/hppa/spmath/fcnvfxt.c","sgl_to_sgl_fcnvfxt",28,84
54,13,296,4,67,"sgl_to_dbl_fcnvfxt@91-158@sys/arch/hppa/spmath/fcnvfxt.c","sys/arch/hppa/spmath/fcnvfxt.c","sgl_to_dbl_fcnvfxt",91,158
44,12,260,4,57,"dbl_to_sgl_fcnvfxt@165-222@sys/arch/hppa/spmath/fcnvfxt.c","sys/arch/hppa/spmath/fcnvfxt.c","dbl_to_sgl_fcnvfxt",165,222
53,13,295,4,66,"dbl_to_dbl_fcnvfxt@229-295@sys/arch/hppa/spmath/fcnvfxt.c","sys/arch/hppa/spmath/fcnvfxt.c","dbl_to_dbl_fcnvfxt",229,295
48,11,244,4,63,"sgl_to_sgl_fcnvxf@26-89@sys/arch/hppa/spmath/fcnvxf.c","sys/arch/hppa/spmath/fcnvxf.c","sgl_to_sgl_fcnvxf",26,89
30,4,194,4,43,"sgl_to_dbl_fcnvxf@95-138@sys/arch/hppa/spmath/fcnvxf.c","sys/arch/hppa/spmath/fcnvxf.c","sgl_to_dbl_fcnvxf",95,138
66,14,336,4,97,"dbl_to_sgl_fcnvxf@144-241@sys/arch/hppa/spmath/fcnvxf.c","sys/arch/hppa/spmath/fcnvxf.c","dbl_to_sgl_fcnvxf",144,241
70,14,373,4,100,"dbl_to_dbl_fcnvxf@247-347@sys/arch/hppa/spmath/fcnvxf.c","sys/arch/hppa/spmath/fcnvxf.c","dbl_to_dbl_fcnvxf",247,347
74,26,421,4,95,"sgl_frnd@29-124@sys/arch/hppa/spmath/frnd.c","sys/arch/hppa/spmath/frnd.c","sgl_frnd",29,124
77,26,467,4,98,"dbl_frnd@132-230@sys/arch/hppa/spmath/frnd.c","sys/arch/hppa/spmath/frnd.c","dbl_frnd",132,230
6,1,32,4,5,"quad_frnd@234-239@sys/arch/hppa/spmath/frnd.c","sys/arch/hppa/spmath/frnd.c","quad_frnd",234,239
16,4,106,3,20,"mpyaccs@20-40@sys/arch/hppa/spmath/mpyaccs.c","sys/arch/hppa/spmath/mpyaccs.c","mpyaccs",20,40
15,3,95,3,19,"mpyaccu@20-39@sys/arch/hppa/spmath/mpyaccu.c","sys/arch/hppa/spmath/mpyaccu.c","mpyaccu",20,39
11,5,63,3,12,"mpys@20-32@sys/arch/hppa/spmath/mpys.c","sys/arch/hppa/spmath/mpys.c","mpys",20,32
7,1,35,3,6,"mpyscv@20-26@sys/arch/hppa/spmath/mpyscv.c","sys/arch/hppa/spmath/mpyscv.c","mpyscv",20,26
11,2,47,3,12,"mpyu@20-32@sys/arch/hppa/spmath/mpyu.c","sys/arch/hppa/spmath/mpyu.c","mpyu",20,32
7,1,36,3,6,"mpyucv@20-26@sys/arch/hppa/spmath/mpyucv.c","sys/arch/hppa/spmath/mpyucv.c","mpyucv",20,26
328,72,1396,4,469,"sgl_fadd@24-493@sys/arch/hppa/spmath/sfadd.c","sys/arch/hppa/spmath/sfadd.c","sgl_fadd",24,493
83,24,395,4,104,"sgl_fcmp@24-128@sys/arch/hppa/spmath/sfcmp.c","sys/arch/hppa/spmath/sfcmp.c","sgl_fcmp",24,128
252,78,1278,4,344,"sgl_fdiv@24-368@sys/arch/hppa/spmath/sfdiv.c","sys/arch/hppa/spmath/sfdiv.c","sgl_fdiv",24,368
227,73,1206,4,327,"sgl_fmpy@24-351@sys/arch/hppa/spmath/sfmpy.c","sys/arch/hppa/spmath/sfmpy.c","sgl_fmpy",24,351
140,35,748,4,239,"sgl_frem@24-263@sys/arch/hppa/spmath/sfrem.c","sys/arch/hppa/spmath/sfrem.c","sgl_frem",24,263
88,22,483,4,133,"sgl_fsqrt@26-159@sys/arch/hppa/spmath/sfsqrt.c","sys/arch/hppa/spmath/sfsqrt.c","sgl_fsqrt",26,159
330,72,1409,4,472,"sgl_fsub@24-496@sys/arch/hppa/spmath/sfsub.c","sys/arch/hppa/spmath/sfsub.c","sgl_fsub",24,496
8,1,62,2,11,"run_loadfile@41-52@sys/arch/hppa/stand/boot/exec.c","sys/arch/hppa/stand/boot/exec.c","run_loadfile",41,52
22,2,151,1,25,"boot@69-94@sys/arch/hppa/stand/cdboot/cdboot.c","sys/arch/hppa/stand/cdboot/cdboot.c","boot",69,94
4,1,20,4,3,"ELFNAME( exec)@33-36@sys/arch/hppa/stand/cdboot/elf64.c","sys/arch/hppa/stand/cdboot/elf64.c","ELFNAME( exec)",33,36
53,10,385,0,79,"print_console@166-245@sys/arch/hppa/stand/libsa/cmd_hppa.c","sys/arch/hppa/stand/libsa/cmd_hppa.c","print_console",166,245
46,11,278,3,60,"set_graphics@248-308@sys/arch/hppa/stand/libsa/cmd_hppa.c","sys/arch/hppa/stand/libsa/cmd_hppa.c","set_graphics",248,308
71,22,395,3,83,"set_serial@311-394@sys/arch/hppa/stand/libsa/cmd_hppa.c","sys/arch/hppa/stand/libsa/cmd_hppa.c","set_serial",311,394
25,10,189,1,35,"set_console@397-432@sys/arch/hppa/stand/libsa/cmd_hppa.c","sys/arch/hppa/stand/libsa/cmd_hppa.c","set_console",397,432
39,7,186,0,46,"Xconsole@435-481@sys/arch/hppa/stand/libsa/cmd_hppa.c","sys/arch/hppa/stand/libsa/cmd_hppa.c","Xconsole",435,481
42,7,242,0,49,"print_keyboard@488-537@sys/arch/hppa/stand/libsa/cmd_hppa.c","sys/arch/hppa/stand/libsa/cmd_hppa.c","print_keyboard",488,537
24,6,135,1,27,"set_keyboard@540-567@sys/arch/hppa/stand/libsa/cmd_hppa.c","sys/arch/hppa/stand/libsa/cmd_hppa.c","set_keyboard",540,567
39,7,186,0,46,"Xkeyboard@570-616@sys/arch/hppa/stand/libsa/cmd_hppa.c","sys/arch/hppa/stand/libsa/cmd_hppa.c","Xkeyboard",570,616
121,34,730,2,158,"bus_walk@628-786@sys/arch/hppa/stand/libsa/cmd_hppa.c","sys/arch/hppa/stand/libsa/cmd_hppa.c","bus_walk",628,786
59,18,381,3,84,"pci_bus_walk@808-892@sys/arch/hppa/stand/libsa/cmd_hppa.c","sys/arch/hppa/stand/libsa/cmd_hppa.c","pci_bus_walk",808,892
13,1,105,4,15,"dino_conf_read@895-910@sys/arch/hppa/stand/libsa/cmd_hppa.c","sys/arch/hppa/stand/libsa/cmd_hppa.c","dino_conf_read",895,910
27,3,279,4,32,"elroy_conf_read@913-945@sys/arch/hppa/stand/libsa/cmd_hppa.c","sys/arch/hppa/stand/libsa/cmd_hppa.c","elroy_conf_read",913,945
10,7,107,2,9,"path_match@951-960@sys/arch/hppa/stand/libsa/cmd_hppa.c","sys/arch/hppa/stand/libsa/cmd_hppa.c","path_match",951,960
10,1,99,2,9,"path_shift@966-975@sys/arch/hppa/stand/libsa/cmd_hppa.c","sys/arch/hppa/stand/libsa/cmd_hppa.c","path_shift",966,975
28,7,162,6,39,"register_device@978-1017@sys/arch/hppa/stand/libsa/cmd_hppa.c","sys/arch/hppa/stand/libsa/cmd_hppa.c","register_device",978,1017
7,2,47,2,8,"ctopen@62-70@sys/arch/hppa/stand/libsa/ct.c","sys/arch/hppa/stand/libsa/ct.c","ctopen",62,70
7,1,33,1,6,"ctclose@74-80@sys/arch/hppa/stand/libsa/ct.c","sys/arch/hppa/stand/libsa/ct.c","ctclose",74,80
42,15,321,3,55,"devopen@62-117@sys/arch/hppa/stand/libsa/dev_hppa.c","sys/arch/hppa/stand/libsa/dev_hppa.c","devopen",62,117
44,8,258,2,48,"devboot@120-168@sys/arch/hppa/stand/libsa/dev_hppa.c","sys/arch/hppa/stand/libsa/dev_hppa.c","devboot",120,168
8,1,41,1,7,"ttyname@173-180@sys/arch/hppa/stand/libsa/dev_hppa.c","sys/arch/hppa/stand/libsa/dev_hppa.c","ttyname",173,180
14,9,132,1,14,"ttydev@183-197@sys/arch/hppa/stand/libsa/dev_hppa.c","sys/arch/hppa/stand/libsa/dev_hppa.c","ttydev",183,197
9,3,60,2,10,"dk_disklabel@36-46@sys/arch/hppa/stand/libsa/dk.c","sys/arch/hppa/stand/libsa/dk.c","dk_disklabel",36,46
27,13,173,2,43,"dkopen@49-92@sys/arch/hppa/stand/libsa/dk.c","sys/arch/hppa/stand/libsa/dk.c","dkopen",49,92
7,1,33,1,6,"dkclose@95-101@sys/arch/hppa/stand/libsa/dk.c","sys/arch/hppa/stand/libsa/dk.c","dkclose",95,101
4,1,13,2,3,"cnspeed@72-75@sys/arch/hppa/stand/libsa/itecons.c","sys/arch/hppa/stand/libsa/itecons.c","cnspeed",72,75
20,5,162,1,21,"ite_probe@78-99@sys/arch/hppa/stand/libsa/itecons.c","sys/arch/hppa/stand/libsa/itecons.c","ite_probe",78,99
26,10,202,1,38,"ite_init@102-140@sys/arch/hppa/stand/libsa/itecons.c","sys/arch/hppa/stand/libsa/itecons.c","ite_init",102,140
10,2,57,2,11,"ite_putc@143-154@sys/arch/hppa/stand/libsa/itecons.c","sys/arch/hppa/stand/libsa/itecons.c","ite_putc",143,154
37,18,220,1,50,"ite_getc@161-211@sys/arch/hppa/stand/libsa/itecons.c","sys/arch/hppa/stand/libsa/itecons.c","ite_getc",161,211
5,1,14,2,5,"ite_pollc@214-219@sys/arch/hppa/stand/libsa/itecons.c","sys/arch/hppa/stand/libsa/itecons.c","ite_pollc",214,219
7,2,45,2,8,"lfopen@37-45@sys/arch/hppa/stand/libsa/lf.c","sys/arch/hppa/stand/libsa/lf.c","lfopen",37,45
6,1,31,1,5,"lfclose@48-53@sys/arch/hppa/stand/libsa/lf.c","sys/arch/hppa/stand/libsa/lf.c","lfclose",48,53
79,31,625,2,96,"lif_open@50-146@sys/arch/hppa/stand/libsa/lif.c","sys/arch/hppa/stand/libsa/lif.c","lif_open",50,146
7,1,33,1,6,"lif_close@149-155@sys/arch/hppa/stand/libsa/lif.c","sys/arch/hppa/stand/libsa/lif.c","lif_close",149,155
33,8,245,4,37,"lif_read@158-195@sys/arch/hppa/stand/libsa/lif.c","sys/arch/hppa/stand/libsa/lif.c","lif_read",158,195
8,1,31,4,7,"lif_write@198-205@sys/arch/hppa/stand/libsa/lif.c","sys/arch/hppa/stand/libsa/lif.c","lif_write",198,205
21,4,93,3,21,"lif_seek@208-229@sys/arch/hppa/stand/libsa/lif.c","sys/arch/hppa/stand/libsa/lif.c","lif_seek",208,229
11,2,71,2,11,"lif_stat@232-243@sys/arch/hppa/stand/libsa/lif.c","sys/arch/hppa/stand/libsa/lif.c","lif_stat",232,243
23,7,167,2,24,"lif_readdir@246-270@sys/arch/hppa/stand/libsa/lif.c","sys/arch/hppa/stand/libsa/lif.c","lif_readdir",246,270
34,6,267,0,41,"machdep@43-84@sys/arch/hppa/stand/libsa/machdep.c","sys/arch/hppa/stand/libsa/machdep.c","machdep",43,84
14,5,107,0,29,"pdc_init@91-120@sys/arch/hppa/stand/libsa/pdc.c","sys/arch/hppa/stand/libsa/pdc.c","pdc_init",91,120
99,40,681,6,133,"iodcstrategy@128-261@sys/arch/hppa/stand/libsa/pdc.c","sys/arch/hppa/stand/libsa/pdc.c","iodcstrategy",128,261
98,37,776,2,133,"pdc_findev@268-401@sys/arch/hppa/stand/libsa/pdc.c","sys/arch/hppa/stand/libsa/pdc.c","pdc_findev",268,401
10,4,61,5,10,"fall@404-414@sys/arch/hppa/stand/libsa/pdc.c","sys/arch/hppa/stand/libsa/pdc.c","fall",404,414
24,6,164,0,31,"fcacheall@424-455@sys/arch/hppa/stand/libsa/pdc.c","sys/arch/hppa/stand/libsa/pdc.c","fcacheall",424,455
15,7,83,0,20,"getsecs@36-56@sys/arch/hppa/stand/libsa/time.c","sys/arch/hppa/stand/libsa/time.c","getsecs",36,56
79,11,706,2,94,"main@82-176@sys/arch/hppa/stand/mkboot/mkboot.c","sys/arch/hppa/stand/mkboot/mkboot.c","main",82,176
103,29,911,2,128,"putfile@179-307@sys/arch/hppa/stand/mkboot/mkboot.c","sys/arch/hppa/stand/mkboot/mkboot.c","putfile",179,307
6,2,51,3,7,"cksum@310-317@sys/arch/hppa/stand/mkboot/mkboot.c","sys/arch/hppa/stand/mkboot/mkboot.c","cksum",310,317
8,1,25,1,7,"usage@320-327@sys/arch/hppa/stand/mkboot/mkboot.c","sys/arch/hppa/stand/mkboot/mkboot.c","usage",320,327
17,6,105,1,17,"lifname@330-347@sys/arch/hppa/stand/mkboot/mkboot.c","sys/arch/hppa/stand/mkboot/mkboot.c","lifname",330,347
19,1,190,2,19,"bcddate@351-370@sys/arch/hppa/stand/mkboot/mkboot.c","sys/arch/hppa/stand/mkboot/mkboot.c","bcddate",351,370
4,1,19,3,4,"eisa_attach_hook@103-107@sys/arch/i386/eisa/eisa_machdep.c","sys/arch/i386/eisa/eisa_machdep.c","eisa_attach_hook",103,107
4,1,12,1,6,"eisa_maxslots@110-116@sys/arch/i386/eisa/eisa_machdep.c","sys/arch/i386/eisa/eisa_machdep.c","eisa_maxslots",110,116
14,3,67,3,14,"eisa_intr_map@119-133@sys/arch/i386/eisa/eisa_machdep.c","sys/arch/i386/eisa/eisa_machdep.c","eisa_intr_map",119,133
8,4,59,2,10,"eisa_intr_string@136-146@sys/arch/i386/eisa/eisa_machdep.c","sys/arch/i386/eisa/eisa_machdep.c","eisa_intr_string",136,146
7,4,75,7,7,"eisa_intr_establish@149-156@sys/arch/i386/eisa/eisa_machdep.c","sys/arch/i386/eisa/eisa_machdep.c","eisa_intr_establish",149,156
4,1,21,2,3,"eisa_intr_disestablish@159-162@sys/arch/i386/eisa/eisa_machdep.c","sys/arch/i386/eisa/eisa_machdep.c","eisa_intr_disestablish",159,162
18,3,129,3,21,"acpi_map@77-98@sys/arch/i386/i386/acpi_machdep.c","sys/arch/i386/i386/acpi_machdep.c","acpi_map",77,98
5,1,33,1,4,"acpi_unmap@101-105@sys/arch/i386/i386/acpi_machdep.c","sys/arch/i386/i386/acpi_machdep.c","acpi_unmap",101,105
22,9,171,3,28,"acpi_scan@108-136@sys/arch/i386/i386/acpi_machdep.c","sys/arch/i386/i386/acpi_machdep.c","acpi_scan",108,136
31,9,178,3,47,"acpi_probe@139-186@sys/arch/i386/i386/acpi_machdep.c","sys/arch/i386/i386/acpi_machdep.c","acpi_probe",139,186
11,3,70,1,12,"acpi_acquire_glk@194-206@sys/arch/i386/i386/acpi_machdep.c","sys/arch/i386/i386/acpi_machdep.c","acpi_acquire_glk",194,206
9,2,56,1,10,"acpi_release_glk@214-224@sys/arch/i386/i386/acpi_machdep.c","sys/arch/i386/i386/acpi_machdep.c","acpi_release_glk",214,224
25,1,174,1,42,"acpi_attach_machdep@227-269@sys/arch/i386/i386/acpi_machdep.c","sys/arch/i386/i386/acpi_machdep.c","acpi_attach_machdep",227,269
6,2,24,2,8,"acpi_sleep_clocks@278-286@sys/arch/i386/i386/acpi_machdep.c","sys/arch/i386/i386/acpi_machdep.c","acpi_sleep_clocks",278,286
14,6,57,1,22,"acpi_resume_clocks@293-315@sys/arch/i386/i386/acpi_machdep.c","sys/arch/i386/i386/acpi_machdep.c","acpi_resume_clocks",293,315
33,9,216,2,66,"acpi_sleep_cpu@322-388@sys/arch/i386/i386/acpi_machdep.c","sys/arch/i386/i386/acpi_machdep.c","acpi_sleep_cpu",322,388
7,2,39,1,9,"acpi_resume_cpu@391-400@sys/arch/i386/i386/acpi_machdep.c","sys/arch/i386/i386/acpi_machdep.c","acpi_resume_cpu",391,400
14,4,71,1,20,"acpi_sleep_mp@404-424@sys/arch/i386/i386/acpi_machdep.c","sys/arch/i386/i386/acpi_machdep.c","acpi_sleep_mp",404,424
30,5,196,1,36,"acpi_resume_mp@427-463@sys/arch/i386/i386/acpi_machdep.c","sys/arch/i386/i386/acpi_machdep.c","acpi_resume_mp",427,463
6,2,38,4,5,"acpiapmopen@29-34@sys/arch/i386/i386/acpiapm.c","sys/arch/i386/i386/acpiapm.c","acpiapmopen",29,34
6,2,38,4,5,"acpiapmclose@37-42@sys/arch/i386/i386/acpiapm.c","sys/arch/i386/i386/acpiapm.c","acpiapmclose",37,42
6,2,43,5,5,"acpiapmioctl@45-50@sys/arch/i386/i386/acpiapm.c","sys/arch/i386/i386/acpiapm.c","acpiapmioctl",45,50
6,2,28,2,5,"acpiapmkqfilter@53-58@sys/arch/i386/i386/acpiapm.c","sys/arch/i386/i386/acpiapm.c","acpiapmkqfilter",53,58
10,2,56,2,12,"amd64_errata_testmsr@250-262@sys/arch/i386/i386/amd64errata.c","sys/arch/i386/i386/amd64errata.c","amd64_errata_testmsr",250,262
15,4,104,2,21,"amd64_errata_setmsr@265-286@sys/arch/i386/i386/amd64errata.c","sys/arch/i386/i386/amd64errata.c","amd64_errata_setmsr",265,286
76,31,487,1,107,"amd64_errata@289-396@sys/arch/i386/i386/amd64errata.c","sys/arch/i386/i386/amd64errata.c","amd64_errata",289,396
17,7,109,1,22,"amdmsr_probe@65-87@sys/arch/i386/i386/amdmsr.c","sys/arch/i386/i386/amdmsr.c","amdmsr_probe",65,87
5,1,44,3,5,"amdmsr_match@90-95@sys/arch/i386/i386/amdmsr.c","sys/arch/i386/i386/amdmsr.c","amdmsr_match",90,95
4,1,23,3,3,"amdmsr_attach@98-101@sys/arch/i386/i386/amdmsr.c","sys/arch/i386/i386/amdmsr.c","amdmsr_attach",98,101
12,7,71,4,16,"amdmsropen@104-120@sys/arch/i386/i386/amdmsr.c","sys/arch/i386/i386/amdmsr.c","amdmsropen",104,120
5,2,24,4,6,"amdmsrclose@123-129@sys/arch/i386/i386/amdmsr.c","sys/arch/i386/i386/amdmsr.c","amdmsrclose",123,129
15,3,79,5,15,"amdmsrioctl@132-147@sys/arch/i386/i386/amdmsr.c","sys/arch/i386/i386/amdmsr.c","amdmsrioctl",132,147
8,2,56,5,9,"apic_format_redir@43-52@sys/arch/i386/i386/apic.c","sys/arch/i386/i386/apic.c","apic_format_redir",43,52
7,1,37,1,7,"apm_get_event@179-186@sys/arch/i386/i386/apm.c","sys/arch/i386/i386/apm.c","apm_get_event",179,186
33,14,96,1,32,"apm_err_translate@189-221@sys/arch/i386/i386/apm.c","sys/arch/i386/i386/apm.c","apm_err_translate",189,221
8,1,42,2,8,"apm_perror@226-234@sys/arch/i386/i386/apm.c","sys/arch/i386/i386/apm.c","apm_perror",226,234
33,5,146,1,54,"apm_suspend@237-291@sys/arch/i386/i386/apm.c","sys/arch/i386/i386/apm.c","apm_suspend",237,291
5,1,27,2,8,"apm_resume@294-302@sys/arch/i386/i386/apm.c","sys/arch/i386/i386/apm.c","apm_resume",294,302
11,3,65,2,11,"apm_record_event@305-316@sys/arch/i386/i386/apm.c","sys/arch/i386/i386/apm.c","apm_record_event",305,316
116,36,558,2,119,"apm_handle_event@319-438@sys/arch/i386/i386/apm.c","sys/arch/i386/i386/apm.c","apm_handle_event",319,438
37,14,194,1,45,"apm_periodic_check@441-486@sys/arch/i386/i386/apm.c","sys/arch/i386/i386/apm.c","apm_periodic_check",441,486
9,4,60,1,9,"apm_powmgt_enable@489-498@sys/arch/i386/i386/apm.c","sys/arch/i386/i386/apm.c","apm_powmgt_enable",489,498
12,4,79,2,12,"apm_powmgt_engage@501-513@sys/arch/i386/i386/apm.c","sys/arch/i386/i386/apm.c","apm_powmgt_engage",501,513
12,4,79,2,15,"apm_devpowmgt_enable@517-532@sys/arch/i386/i386/apm.c","sys/arch/i386/i386/apm.c","apm_devpowmgt_enable",517,532
16,6,95,2,16,"apm_set_powstate@536-552@sys/arch/i386/i386/apm.c","sys/arch/i386/i386/apm.c","apm_set_powstate",536,552
13,4,85,1,16,"apm_cpu_slow@555-571@sys/arch/i386/i386/apm.c","sys/arch/i386/i386/apm.c","apm_cpu_slow",555,571
13,5,64,1,16,"apm_cpu_busy@574-590@sys/arch/i386/i386/apm.c","sys/arch/i386/i386/apm.c","apm_cpu_busy",574,590
17,5,104,1,27,"apm_cpu_idle@593-620@sys/arch/i386/i386/apm.c","sys/arch/i386/i386/apm.c","apm_cpu_idle",593,620
37,12,228,1,49,"apm_set_ver@623-672@sys/arch/i386/i386/apm.c","sys/arch/i386/i386/apm.c","apm_set_ver",623,672
13,4,88,1,14,"apm_disconnect@675-689@sys/arch/i386/i386/apm.c","sys/arch/i386/i386/apm.c","apm_disconnect",675,689
30,13,230,3,37,"apmprobe@692-729@sys/arch/i386/i386/apm.c","sys/arch/i386/i386/apm.c","apmprobe",692,729
108,16,817,3,137,"apmattach@732-869@sys/arch/i386/i386/apm.c","sys/arch/i386/i386/apm.c","apmattach",732,869
20,4,92,1,28,"apm_thread_create@872-900@sys/arch/i386/i386/apm.c","sys/arch/i386/i386/apm.c","apm_thread_create",872,900
10,2,58,1,10,"apm_thread@903-913@sys/arch/i386/i386/apm.c","sys/arch/i386/i386/apm.c","apm_thread",903,913
38,11,205,4,42,"apmopen@916-958@sys/arch/i386/i386/apm.c","sys/arch/i386/i386/apm.c","apmopen",916,958
20,6,122,4,23,"apmclose@961-984@sys/arch/i386/i386/apm.c","sys/arch/i386/i386/apm.c","apmclose",961,984
115,35,652,5,124,"apmioctl@987-1111@sys/arch/i386/i386/apm.c","sys/arch/i386/i386/apm.c","apmioctl",987,1111
7,1,53,1,7,"filt_apmrdetach@1114-1121@sys/arch/i386/i386/apm.c","sys/arch/i386/i386/apm.c","filt_apmrdetach",1114,1121
6,3,35,2,6,"filt_apmread@1124-1130@sys/arch/i386/i386/apm.c","sys/arch/i386/i386/apm.c","filt_apmread",1124,1130
19,5,118,2,23,"apmkqfilter@1133-1156@sys/arch/i386/i386/apm.c","sys/arch/i386/i386/apm.c","apmkqfilter",1133,1156
9,2,48,1,9,"unmap_startup@113-122@sys/arch/i386/i386/autoconf.c","sys/arch/i386/i386/autoconf.c","unmap_startup",113,122
32,12,166,1,76,"cpu_configure@128-204@sys/arch/i386/i386/autoconf.c","sys/arch/i386/i386/autoconf.c","cpu_configure",128,204
3,1,13,2,2,"device_register@207-209@sys/arch/i386/i386/autoconf.c","sys/arch/i386/i386/autoconf.c","device_register",207,209
40,9,261,1,49,"diskconf@217-266@sys/arch/i386/i386/autoconf.c","sys/arch/i386/i386/autoconf.c","diskconf",217,266
12,6,84,3,17,"biosprobe@143-160@sys/arch/i386/i386/bios.c","sys/arch/i386/i386/bios.c","biosprobe",143,160
223,73,1650,3,333,"biosattach@163-496@sys/arch/i386/i386/bios.c","sys/arch/i386/i386/bios.c","biosattach",163,496
85,33,506,1,122,"bios_getopt@499-621@sys/arch/i386/i386/bios.c","sys/arch/i386/i386/bios.c","bios_getopt",499,621
8,2,44,2,8,"bios_print@624-632@sys/arch/i386/i386/bios.c","sys/arch/i386/i386/bios.c","bios_print",624,632
45,8,313,3,58,"bios32_service@635-693@sys/arch/i386/i386/bios.c","sys/arch/i386/i386/bios.c","bios32_service",635,693
13,3,81,1,15,"bios32_cleanup@696-711@sys/arch/i386/i386/bios.c","sys/arch/i386/i386/bios.c","bios32_cleanup",696,711
8,2,50,4,10,"biosopen@714-724@sys/arch/i386/i386/bios.c","sys/arch/i386/i386/bios.c","biosopen",714,724
8,2,50,4,10,"biosclose@727-737@sys/arch/i386/i386/bios.c","sys/arch/i386/i386/bios.c","biosclose",727,737
12,2,64,5,15,"biosioctl@740-755@sys/arch/i386/i386/bios.c","sys/arch/i386/i386/bios.c","biosioctl",740,755
27,10,183,7,31,"bios_sysctl@758-789@sys/arch/i386/i386/bios.c","sys/arch/i386/i386/bios.c","bios_sysctl",758,789
19,7,89,1,21,"bios_getdiskinfo@792-813@sys/arch/i386/i386/bios.c","sys/arch/i386/i386/bios.c","bios_getdiskinfo",792,813
40,16,298,2,49,"smbios_find_table@825-874@sys/arch/i386/i386/bios.c","sys/arch/i386/i386/bios.c","smbios_find_table",825,874
19,7,131,4,20,"smbios_get_string@877-897@sys/arch/i386/i386/bios.c","sys/arch/i386/i386/bios.c","smbios_get_string",877,897
19,9,170,1,26,"fixstring@900-926@sys/arch/i386/i386/bios.c","sys/arch/i386/i386/bios.c","fixstring",900,926
106,35,821,1,124,"smbios_info@929-1053@sys/arch/i386/i386/bios.c","sys/arch/i386/i386/bios.c","smbios_info",929,1053
22,3,160,7,36,"_bus_dmamap_create@89-125@sys/arch/i386/i386/bus_dma.c","sys/arch/i386/i386/bus_dma.c","_bus_dmamap_create",89,125
7,1,45,2,7,"_bus_dmamap_destroy@132-139@sys/arch/i386/i386/bus_dma.c","sys/arch/i386/i386/bus_dma.c","_bus_dmamap_destroy",132,139
18,3,116,6,23,"_bus_dmamap_load@146-169@sys/arch/i386/i386/bus_dma.c","sys/arch/i386/i386/bus_dma.c","_bus_dmamap_load",146,169
28,8,189,4,36,"_bus_dmamap_load_mbuf@175-211@sys/arch/i386/i386/bus_dma.c","sys/arch/i386/i386/bus_dma.c","_bus_dmamap_load_mbuf",175,211
37,10,247,4,52,"_bus_dmamap_load_uio@217-269@sys/arch/i386/i386/bus_dma.c","sys/arch/i386/i386/bus_dma.c","_bus_dmamap_load_uio",217,269
54,15,381,6,76,"_bus_dmamap_load_raw@276-352@sys/arch/i386/i386/bus_dma.c","sys/arch/i386/i386/bus_dma.c","_bus_dmamap_load_raw",276,352
5,1,22,2,9,"_bus_dmamap_unload@359-368@sys/arch/i386/i386/bus_dma.c","sys/arch/i386/i386/bus_dma.c","_bus_dmamap_unload",359,368
5,1,29,5,5,"_bus_dmamap_sync@375-380@sys/arch/i386/i386/bus_dma.c","sys/arch/i386/i386/bus_dma.c","_bus_dmamap_sync",375,380
7,1,63,8,7,"_bus_dmamem_alloc@387-394@sys/arch/i386/i386/bus_dma.c","sys/arch/i386/i386/bus_dma.c","_bus_dmamem_alloc",387,394
17,3,108,3,21,"_bus_dmamem_free@401-422@sys/arch/i386/i386/bus_dma.c","sys/arch/i386/i386/bus_dma.c","_bus_dmamem_free",401,422
37,8,267,6,46,"_bus_dmamem_map@429-475@sys/arch/i386/i386/bus_dma.c","sys/arch/i386/i386/bus_dma.c","_bus_dmamem_map",429,475
6,3,43,3,9,"_bus_dmamem_unmap@482-491@sys/arch/i386/i386/bus_dma.c","sys/arch/i386/i386/bus_dma.c","_bus_dmamem_unmap",482,491
22,8,145,6,28,"_bus_dmamem_mmap@498-526@sys/arch/i386/i386/bus_dma.c","sys/arch/i386/i386/bus_dma.c","_bus_dmamem_mmap",498,526
54,13,363,9,78,"_bus_dmamap_load_buffer@538-616@sys/arch/i386/i386/bus_dma.c","sys/arch/i386/i386/bus_dma.c","_bus_dmamap_load_buffer",538,616
46,10,309,10,63,"_bus_dmamem_alloc_range@623-686@sys/arch/i386/i386/bus_dma.c","sys/arch/i386/i386/bus_dma.c","_bus_dmamem_alloc_range",623,686
4,1,20,2,3,"i386_bus_space_io_read_1@260-263@sys/arch/i386/i386/bus_space.c","sys/arch/i386/i386/bus_space.c","i386_bus_space_io_read_1",260,263
4,1,20,2,3,"i386_bus_space_io_read_2@266-269@sys/arch/i386/i386/bus_space.c","sys/arch/i386/i386/bus_space.c","i386_bus_space_io_read_2",266,269
4,1,20,2,3,"i386_bus_space_io_read_4@272-275@sys/arch/i386/i386/bus_space.c","sys/arch/i386/i386/bus_space.c","i386_bus_space_io_read_4",272,275
5,1,28,4,4,"i386_bus_space_io_read_multi_1@278-282@sys/arch/i386/i386/bus_space.c","sys/arch/i386/i386/bus_space.c","i386_bus_space_io_read_multi_1",278,282
5,1,28,4,4,"i386_bus_space_io_read_multi_2@285-289@sys/arch/i386/i386/bus_space.c","sys/arch/i386/i386/bus_space.c","i386_bus_space_io_read_multi_2",285,289
5,1,28,4,4,"i386_bus_space_io_read_multi_4@292-296@sys/arch/i386/i386/bus_space.c","sys/arch/i386/i386/bus_space.c","i386_bus_space_io_read_multi_4",292,296
14,1,65,4,14,"i386_bus_space_io_read_region_1@299-313@sys/arch/i386/i386/bus_space.c","sys/arch/i386/i386/bus_space.c","i386_bus_space_io_read_region_1",299,313
14,1,65,4,14,"i386_bus_space_io_read_region_2@316-330@sys/arch/i386/i386/bus_space.c","sys/arch/i386/i386/bus_space.c","i386_bus_space_io_read_region_2",316,330
14,1,65,4,14,"i386_bus_space_io_read_region_4@333-347@sys/arch/i386/i386/bus_space.c","sys/arch/i386/i386/bus_space.c","i386_bus_space_io_read_region_4",333,347
4,1,22,3,3,"i386_bus_space_io_write_1@350-353@sys/arch/i386/i386/bus_space.c","sys/arch/i386/i386/bus_space.c","i386_bus_space_io_write_1",350,353
4,1,22,3,3,"i386_bus_space_io_write_2@356-359@sys/arch/i386/i386/bus_space.c","sys/arch/i386/i386/bus_space.c","i386_bus_space_io_write_2",356,359
4,1,22,3,3,"i386_bus_space_io_write_4@362-365@sys/arch/i386/i386/bus_space.c","sys/arch/i386/i386/bus_space.c","i386_bus_space_io_write_4",362,365
5,1,29,4,4,"i386_bus_space_io_write_multi_1@368-372@sys/arch/i386/i386/bus_space.c","sys/arch/i386/i386/bus_space.c","i386_bus_space_io_write_multi_1",368,372
5,1,29,4,4,"i386_bus_space_io_write_multi_2@375-379@sys/arch/i386/i386/bus_space.c","sys/arch/i386/i386/bus_space.c","i386_bus_space_io_write_multi_2",375,379
5,1,29,4,4,"i386_bus_space_io_write_multi_4@382-386@sys/arch/i386/i386/bus_space.c","sys/arch/i386/i386/bus_space.c","i386_bus_space_io_write_multi_4",382,386
14,1,67,4,14,"i386_bus_space_io_write_region_1@389-403@sys/arch/i386/i386/bus_space.c","sys/arch/i386/i386/bus_space.c","i386_bus_space_io_write_region_1",389,403
14,1,67,4,14,"i386_bus_space_io_write_region_2@406-420@sys/arch/i386/i386/bus_space.c","sys/arch/i386/i386/bus_space.c","i386_bus_space_io_write_region_2",406,420
14,1,67,4,14,"i386_bus_space_io_write_region_4@423-437@sys/arch/i386/i386/bus_space.c","sys/arch/i386/i386/bus_space.c","i386_bus_space_io_write_region_4",423,437
10,1,47,4,10,"i386_bus_space_io_set_multi_1@440-450@sys/arch/i386/i386/bus_space.c","sys/arch/i386/i386/bus_space.c","i386_bus_space_io_set_multi_1",440,450
10,1,47,4,10,"i386_bus_space_io_set_multi_2@453-463@sys/arch/i386/i386/bus_space.c","sys/arch/i386/i386/bus_space.c","i386_bus_space_io_set_multi_2",453,463
10,1,47,4,10,"i386_bus_space_io_set_multi_4@466-476@sys/arch/i386/i386/bus_space.c","sys/arch/i386/i386/bus_space.c","i386_bus_space_io_set_multi_4",466,476
12,1,53,4,12,"i386_bus_space_io_set_region_1@479-491@sys/arch/i386/i386/bus_space.c","sys/arch/i386/i386/bus_space.c","i386_bus_space_io_set_region_1",479,491
12,1,53,4,12,"i386_bus_space_io_set_region_2@494-506@sys/arch/i386/i386/bus_space.c","sys/arch/i386/i386/bus_space.c","i386_bus_space_io_set_region_2",494,506
12,1,53,4,12,"i386_bus_space_io_set_region_4@509-521@sys/arch/i386/i386/bus_space.c","sys/arch/i386/i386/bus_space.c","i386_bus_space_io_set_region_4",509,521
17,1,71,5,17,"i386_bus_space_io_copy_1@524-541@sys/arch/i386/i386/bus_space.c","sys/arch/i386/i386/bus_space.c","i386_bus_space_io_copy_1",524,541
17,1,71,5,17,"i386_bus_space_io_copy_2@544-561@sys/arch/i386/i386/bus_space.c","sys/arch/i386/i386/bus_space.c","i386_bus_space_io_copy_2",544,561
17,1,71,5,17,"i386_bus_space_io_copy_4@564-581@sys/arch/i386/i386/bus_space.c","sys/arch/i386/i386/bus_space.c","i386_bus_space_io_copy_4",564,581
4,1,12,1,3,"i386_bus_space_io_vaddr@584-587@sys/arch/i386/i386/bus_space.c","sys/arch/i386/i386/bus_space.c","i386_bus_space_io_vaddr",584,587
4,1,22,4,4,"i386_bus_space_io_mmap@590-594@sys/arch/i386/i386/bus_space.c","sys/arch/i386/i386/bus_space.c","i386_bus_space_io_mmap",590,594
4,1,29,2,3,"i386_bus_space_mem_read_1@597-600@sys/arch/i386/i386/bus_space.c","sys/arch/i386/i386/bus_space.c","i386_bus_space_mem_read_1",597,600
4,1,29,2,3,"i386_bus_space_mem_read_2@603-606@sys/arch/i386/i386/bus_space.c","sys/arch/i386/i386/bus_space.c","i386_bus_space_mem_read_2",603,606
4,1,29,2,3,"i386_bus_space_mem_read_4@609-612@sys/arch/i386/i386/bus_space.c","sys/arch/i386/i386/bus_space.c","i386_bus_space_mem_read_4",609,612
12,1,59,4,11,"i386_bus_space_mem_read_multi_1@615-626@sys/arch/i386/i386/bus_space.c","sys/arch/i386/i386/bus_space.c","i386_bus_space_mem_read_multi_1",615,626
12,1,63,4,11,"i386_bus_space_mem_read_multi_2@629-640@sys/arch/i386/i386/bus_space.c","sys/arch/i386/i386/bus_space.c","i386_bus_space_mem_read_multi_2",629,640
12,1,59,4,11,"i386_bus_space_mem_read_multi_4@643-654@sys/arch/i386/i386/bus_space.c","sys/arch/i386/i386/bus_space.c","i386_bus_space_mem_read_multi_4",643,654
8,1,46,4,8,"i386_bus_space_mem_read_region_1@657-665@sys/arch/i386/i386/bus_space.c","sys/arch/i386/i386/bus_space.c","i386_bus_space_mem_read_region_1",657,665
8,1,46,4,8,"i386_bus_space_mem_read_region_2@668-676@sys/arch/i386/i386/bus_space.c","sys/arch/i386/i386/bus_space.c","i386_bus_space_mem_read_region_2",668,676
8,1,46,4,8,"i386_bus_space_mem_read_region_4@679-687@sys/arch/i386/i386/bus_space.c","sys/arch/i386/i386/bus_space.c","i386_bus_space_mem_read_region_4",679,687
4,1,34,3,3,"i386_bus_space_mem_write_1@690-693@sys/arch/i386/i386/bus_space.c","sys/arch/i386/i386/bus_space.c","i386_bus_space_mem_write_1",690,693
4,1,34,3,3,"i386_bus_space_mem_write_2@696-699@sys/arch/i386/i386/bus_space.c","sys/arch/i386/i386/bus_space.c","i386_bus_space_mem_write_2",696,699
4,1,34,3,3,"i386_bus_space_mem_write_4@702-705@sys/arch/i386/i386/bus_space.c","sys/arch/i386/i386/bus_space.c","i386_bus_space_mem_write_4",702,705
12,1,61,4,12,"i386_bus_space_mem_write_multi_1@708-720@sys/arch/i386/i386/bus_space.c","sys/arch/i386/i386/bus_space.c","i386_bus_space_mem_write_multi_1",708,720
12,1,61,4,12,"i386_bus_space_mem_write_multi_2@723-735@sys/arch/i386/i386/bus_space.c","sys/arch/i386/i386/bus_space.c","i386_bus_space_mem_write_multi_2",723,735
12,1,61,4,12,"i386_bus_space_mem_write_multi_4@738-750@sys/arch/i386/i386/bus_space.c","sys/arch/i386/i386/bus_space.c","i386_bus_space_mem_write_multi_4",738,750
8,1,48,4,8,"i386_bus_space_mem_write_region_1@753-761@sys/arch/i386/i386/bus_space.c","sys/arch/i386/i386/bus_space.c","i386_bus_space_mem_write_region_1",753,761
8,1,48,4,8,"i386_bus_space_mem_write_region_2@764-772@sys/arch/i386/i386/bus_space.c","sys/arch/i386/i386/bus_space.c","i386_bus_space_mem_write_region_2",764,772
8,1,48,4,8,"i386_bus_space_mem_write_region_4@775-783@sys/arch/i386/i386/bus_space.c","sys/arch/i386/i386/bus_space.c","i386_bus_space_mem_write_region_4",775,783
10,1,49,4,10,"i386_bus_space_mem_set_multi_1@786-796@sys/arch/i386/i386/bus_space.c","sys/arch/i386/i386/bus_space.c","i386_bus_space_mem_set_multi_1",786,796
10,1,49,4,10,"i386_bus_space_mem_set_multi_2@799-809@sys/arch/i386/i386/bus_space.c","sys/arch/i386/i386/bus_space.c","i386_bus_space_mem_set_multi_2",799,809
10,1,49,4,10,"i386_bus_space_mem_set_multi_4@812-822@sys/arch/i386/i386/bus_space.c","sys/arch/i386/i386/bus_space.c","i386_bus_space_mem_set_multi_4",812,822
11,1,54,4,11,"i386_bus_space_mem_set_region_1@825-836@sys/arch/i386/i386/bus_space.c","sys/arch/i386/i386/bus_space.c","i386_bus_space_mem_set_region_1",825,836
11,1,54,4,11,"i386_bus_space_mem_set_region_2@839-850@sys/arch/i386/i386/bus_space.c","sys/arch/i386/i386/bus_space.c","i386_bus_space_mem_set_region_2",839,850
11,1,54,4,11,"i386_bus_space_mem_set_region_4@853-864@sys/arch/i386/i386/bus_space.c","sys/arch/i386/i386/bus_space.c","i386_bus_space_mem_set_region_4",853,864
8,1,49,5,8,"i386_bus_space_mem_copy_1@867-875@sys/arch/i386/i386/bus_space.c","sys/arch/i386/i386/bus_space.c","i386_bus_space_mem_copy_1",867,875
8,1,49,5,8,"i386_bus_space_mem_copy_2@878-886@sys/arch/i386/i386/bus_space.c","sys/arch/i386/i386/bus_space.c","i386_bus_space_mem_copy_2",878,886
8,1,49,5,8,"i386_bus_space_mem_copy_4@889-897@sys/arch/i386/i386/bus_space.c","sys/arch/i386/i386/bus_space.c","i386_bus_space_mem_copy_4",889,897
4,1,16,1,3,"i386_bus_space_mem_vaddr@900-903@sys/arch/i386/i386/bus_space.c","sys/arch/i386/i386/bus_space.c","i386_bus_space_mem_vaddr",900,903
4,1,23,4,10,"i386_bus_space_mem_mmap@906-916@sys/arch/i386/i386/bus_space.c","sys/arch/i386/i386/bus_space.c","i386_bus_space_mem_mmap",906,916
38,9,180,2,51,"codepatch_fill_nop@39-90@sys/arch/i386/i386/codepatch.c","sys/arch/i386/i386/codepatch.c","codepatch_fill_nop",39,90
15,2,137,2,17,"codepatch_maprw@97-114@sys/arch/i386/i386/codepatch.c","sys/arch/i386/i386/codepatch.c","codepatch_maprw",97,114
7,2,43,1,6,"codepatch_unmaprw@117-123@sys/arch/i386/i386/codepatch.c","sys/arch/i386/i386/codepatch.c","codepatch_unmaprw",117,123
17,3,97,1,18,"codepatch_nop@127-145@sys/arch/i386/i386/codepatch.c","sys/arch/i386/i386/codepatch.c","codepatch_nop",127,145
22,4,146,3,24,"codepatch_replace@149-173@sys/arch/i386/i386/codepatch.c","sys/arch/i386/i386/codepatch.c","codepatch_replace",149,173
24,4,170,2,26,"codepatch_call@177-203@sys/arch/i386/i386/codepatch.c","sys/arch/i386/i386/codepatch.c","codepatch_call",177,203
4,3,33,1,3,"iskmemdev@324-327@sys/arch/i386/i386/conf.c","sys/arch/i386/i386/conf.c","iskmemdev",324,327
4,2,24,1,3,"iszerodev@333-336@sys/arch/i386/i386/conf.c","sys/arch/i386/i386/conf.c","iszerodev",333,336
4,1,14,1,3,"getnulldev@339-342@sys/arch/i386/i386/conf.c","sys/arch/i386/i386/conf.c","getnulldev",339,342
14,3,55,1,17,"dev_rawpart@409-426@sys/arch/i386/i386/conf.c","sys/arch/i386/i386/conf.c","dev_rawpart",409,426
4,1,10,1,3,"cpu_init_first@164-167@sys/arch/i386/i386/cpu.c","sys/arch/i386/i386/cpu.c","cpu_init_first",164,167
12,2,56,1,15,"replacesmap@186-201@sys/arch/i386/i386/cpu.c","sys/arch/i386/i386/cpu.c","replacesmap",186,201
10,3,65,3,12,"cpu_match@204-216@sys/arch/i386/i386/cpu.c","sys/arch/i386/i386/cpu.c","cpu_match",204,216
90,22,563,3,140,"cpu_attach@219-359@sys/arch/i386/i386/cpu.c","sys/arch/i386/i386/cpu.c","cpu_attach",219,359
30,11,170,1,75,"cpu_init@366-441@sys/arch/i386/i386/cpu.c","sys/arch/i386/i386/cpu.c","cpu_init",366,441
11,3,76,1,13,"cpu_init_vmm@444-457@sys/arch/i386/i386/cpu.c","sys/arch/i386/i386/cpu.c","cpu_init_vmm",444,457
13,2,99,1,23,"patinit@461-484@sys/arch/i386/i386/cpu.c","sys/arch/i386/i386/cpu.c","patinit",461,484
27,9,127,1,28,"rdrand@490-518@sys/arch/i386/i386/cpu.c","sys/arch/i386/i386/cpu.c","rdrand",490,518
11,3,53,2,12,"cpu_activate@521-533@sys/arch/i386/i386/cpu.c","sys/arch/i386/i386/cpu.c","cpu_activate",521,533
18,6,103,1,18,"cpu_boot_secondary_processors@537-555@sys/arch/i386/i386/cpu.c","sys/arch/i386/i386/cpu.c","cpu_boot_secondary_processors",537,555
15,5,73,1,15,"cpu_init_idle_pcbs@558-573@sys/arch/i386/i386/cpu.c","sys/arch/i386/i386/cpu.c","cpu_init_idle_pcbs",558,573
21,7,135,1,33,"cpu_boot_secondary@576-609@sys/arch/i386/i386/cpu.c","sys/arch/i386/i386/cpu.c","cpu_boot_secondary",576,609
27,4,151,1,36,"cpu_hatch@617-653@sys/arch/i386/i386/cpu.c","sys/arch/i386/i386/cpu.c","cpu_hatch",617,653
13,1,83,1,17,"cpu_copy_trampoline@656-673@sys/arch/i386/i386/cpu.c","sys/arch/i386/i386/cpu.c","cpu_copy_trampoline",656,673
15,1,159,3,14,"cpu_init_tss@679-693@sys/arch/i386/i386/cpu.c","sys/arch/i386/i386/cpu.c","cpu_init_tss",679,693
20,2,198,1,32,"cpu_set_tss_gates@705-737@sys/arch/i386/i386/cpu.c","sys/arch/i386/i386/cpu.c","cpu_set_tss_gates",705,737
25,4,156,1,47,"mp_cpu_start@742-789@sys/arch/i386/i386/cpu.c","sys/arch/i386/i386/cpu.c","mp_cpu_start",742,789
5,1,25,1,8,"mp_cpu_start_cleanup@792-800@sys/arch/i386/i386/cpu.c","sys/arch/i386/i386/cpu.c","mp_cpu_start_cleanup",792,800
15,5,104,1,30,"cpu_idle_mwait_cycle@805-835@sys/arch/i386/i386/cpu.c","sys/arch/i386/i386/cpu.c","cpu_idle_mwait_cycle",805,835
30,11,191,1,38,"cpu_init_mwait@838-876@sys/arch/i386/i386/cpu.c","sys/arch/i386/i386/cpu.c","cpu_init_mwait",838,876
72,13,419,4,75,"db_read_address@893-968@sys/arch/i386/i386/db_disasm.c","sys/arch/i386/i386/db_disasm.c","db_read_address",893,968
18,7,129,3,19,"db_print_address@971-990@sys/arch/i386/i386/db_disasm.c","sys/arch/i386/i386/db_disasm.c","db_print_address",971,990
75,19,441,5,83,"db_disasm_esc@997-1080@sys/arch/i386/i386/db_disasm.c","sys/arch/i386/i386/db_disasm.c","db_disasm_esc",997,1080
296,81,1655,2,316,"db_disasm@1088-1404@sys/arch/i386/i386/db_disasm.c","sys/arch/i386/i386/db_disasm.c","db_disasm",1088,1404
9,3,50,2,8,"kdbprinttrap@90-98@sys/arch/i386/i386/db_interface.c","sys/arch/i386/i386/db_interface.c","kdbprinttrap",90,98
65,16,393,3,86,"db_ktrap@104-190@sys/arch/i386/i386/db_interface.c","sys/arch/i386/i386/db_interface.c","db_ktrap",104,190
22,1,188,4,29,"db_sysregs_cmd@193-222@sys/arch/i386/i386/db_interface.c","sys/arch/i386/i386/db_interface.c","db_sysregs_cmd",193,222
31,9,149,4,31,"db_cpuinfo_cmd@226-257@sys/arch/i386/i386/db_interface.c","sys/arch/i386/i386/db_interface.c","db_cpuinfo_cmd",226,257
16,9,103,4,16,"db_startproc_cmd@260-276@sys/arch/i386/i386/db_interface.c","sys/arch/i386/i386/db_interface.c","db_startproc_cmd",260,276
17,9,105,4,17,"db_stopproc_cmd@279-296@sys/arch/i386/i386/db_interface.c","sys/arch/i386/i386/db_interface.c","db_stopproc_cmd",279,296
16,6,86,4,15,"db_ddbproc_cmd@299-314@sys/arch/i386/i386/db_interface.c","sys/arch/i386/i386/db_interface.c","db_ddbproc_cmd",299,314
9,5,47,1,13,"db_machine_init@342-355@sys/arch/i386/i386/db_interface.c","sys/arch/i386/i386/db_interface.c","db_machine_init",342,355
4,1,11,1,3,"db_enter@358-361@sys/arch/i386/i386/db_interface.c","sys/arch/i386/i386/db_interface.c","db_enter",358,361
7,2,41,3,7,"db_read_bytes@55-62@sys/arch/i386/i386/db_memrw.c","sys/arch/i386/i386/db_memrw.c","db_read_bytes",55,62
37,10,220,3,66,"db_write_text@69-135@sys/arch/i386/i386/db_memrw.c","sys/arch/i386/i386/db_memrw.c","db_write_text",69,135
13,4,72,3,15,"db_write_bytes@141-156@sys/arch/i386/i386/db_memrw.c","sys/arch/i386/i386/db_memrw.c","db_write_bytes",141,156
52,19,321,1,66,"db_enter_ddb@45-111@sys/arch/i386/i386/db_mp.c","sys/arch/i386/i386/db_mp.c","db_enter_ddb",45,111
8,3,45,1,7,"db_startcpu@114-121@sys/arch/i386/i386/db_mp.c","sys/arch/i386/i386/db_mp.c","db_startcpu",114,121
12,4,73,1,11,"db_stopcpu@124-135@sys/arch/i386/i386/db_mp.c","sys/arch/i386/i386/db_mp.c","db_stopcpu",124,135
4,1,13,1,3,"i386_ipi_db@138-141@sys/arch/i386/i386/db_mp.c","sys/arch/i386/i386/db_mp.c","i386_ipi_db",138,141
20,5,135,1,20,"db_i386_numargs@85-105@sys/arch/i386/i386/db_trace.c","sys/arch/i386/i386/db_trace.c","db_i386_numargs",85,105
33,6,202,5,36,"db_nextframe@118-154@sys/arch/i386/i386/db_trace.c","sys/arch/i386/i386/db_trace.c","db_nextframe",118,154
22,13,143,1,21,"db_is_trap@157-178@sys/arch/i386/i386/db_trace.c","sys/arch/i386/i386/db_trace.c","db_is_trap",157,178
120,36,764,5,145,"db_stack_trace_print@181-326@sys/arch/i386/i386/db_trace.c","sys/arch/i386/i386/db_trace.c","db_stack_trace_print",181,326
36,7,222,1,42,"db_save_stack_trace@329-371@sys/arch/i386/i386/db_trace.c","sys/arch/i386/i386/db_trace.c","db_save_stack_trace",329,371
9,2,87,1,10,"db_get_pc@374-384@sys/arch/i386/i386/db_trace.c","sys/arch/i386/i386/db_trace.c","db_get_pc",374,384
4,1,16,1,3,"db_get_probe_addr@387-390@sys/arch/i386/i386/db_trace.c","sys/arch/i386/i386/db_trace.c","db_get_probe_addr",387,390
43,13,306,4,56,"readdisklabel@65-121@sys/arch/i386/i386/disksubr.c","sys/arch/i386/i386/disksubr.c","readdisklabel",65,121
30,4,213,3,36,"writedisklabel@127-163@sys/arch/i386/i386/disksubr.c","sys/arch/i386/i386/disksubr.c","writedisklabel",127,163
110,36,790,1,177,"dkcsumattach@53-230@sys/arch/i386/i386/dkcsum.c","sys/arch/i386/i386/dkcsum.c","dkcsumattach",53,230
35,20,160,1,38,"esm_probe@168-206@sys/arch/i386/i386/esm.c","sys/arch/i386/i386/esm.c","esm_probe",168,206
7,3,54,3,8,"esm_match@209-217@sys/arch/i386/i386/esm.c","sys/arch/i386/i386/esm.c","esm_match",209,217
45,6,342,3,56,"esm_attach@220-276@sys/arch/i386/i386/esm.c","sys/arch/i386/i386/esm.c","esm_attach",220,276
9,2,33,2,9,"esm_activate@279-288@sys/arch/i386/i386/esm.c","sys/arch/i386/i386/esm.c","esm_activate",279,288
45,11,312,2,65,"esm_watchdog@291-356@sys/arch/i386/i386/esm.c","sys/arch/i386/i386/esm.c","esm_watchdog",291,356
109,27,659,1,126,"esm_refresh@359-485@sys/arch/i386/i386/esm.c","sys/arch/i386/i386/esm.c","esm_refresh",359,485
39,7,359,3,49,"esm_get_devmap@488-537@sys/arch/i386/i386/esm.c","sys/arch/i386/i386/esm.c","esm_get_devmap",488,537
112,28,424,2,128,"esm_devmap@699-827@sys/arch/i386/i386/esm.c","sys/arch/i386/i386/esm.c","esm_devmap",699,827
98,21,697,4,121,"esm_make_sensors@830-951@sys/arch/i386/i386/esm.c","sys/arch/i386/i386/esm.c","esm_make_sensors",830,951
26,2,218,3,31,"esm_thresholds@954-985@sys/arch/i386/i386/esm.c","sys/arch/i386/i386/esm.c","esm_thresholds",954,985
10,4,67,5,11,"esm_bmc_ready@988-999@sys/arch/i386/i386/esm.c","sys/arch/i386/i386/esm.c","esm_bmc_ready",988,999
36,8,232,7,50,"esm_cmd@1002-1052@sys/arch/i386/i386/esm.c","sys/arch/i386/i386/esm.c","esm_cmd",1002,1052
18,4,147,5,21,"esm_smb_cmd@1055-1076@sys/arch/i386/i386/esm.c","sys/arch/i386/i386/esm.c","esm_smb_cmd",1055,1076
4,1,21,1,3,"esm_val2temp@1079-1082@sys/arch/i386/i386/esm.c","sys/arch/i386/i386/esm.c","esm_val2temp",1079,1082
4,1,17,1,3,"esm_val2volts@1085-1088@sys/arch/i386/i386/esm.c","sys/arch/i386/i386/esm.c","esm_val2volts",1085,1088
4,1,17,1,3,"esm_val2amps@1091-1094@sys/arch/i386/i386/esm.c","sys/arch/i386/i386/esm.c","esm_val2amps",1091,1094
26,5,175,1,33,"est_acpi_init@971-1004@sys/arch/i386/i386/est.c","sys/arch/i386/i386/est.c","est_acpi_init",971,1004
34,6,221,2,39,"est_acpi_pss_changed@1007-1046@sys/arch/i386/i386/est.c","sys/arch/i386/i386/est.c","est_acpi_pss_changed",1007,1046
106,32,733,2,160,"est_init@1050-1210@sys/arch/i386/i386/est.c","sys/arch/i386/i386/est.c","est_init",1050,1210
16,3,103,1,19,"est_setperf@1213-1232@sys/arch/i386/i386/est.c","sys/arch/i386/i386/est.c","est_setperf",1213,1232
12,3,103,7,13,"setgdt@78-91@sys/arch/i386/i386/gdt.c","sys/arch/i386/i386/gdt.c","setgdt",78,91
22,3,163,1,24,"gdt_init@97-121@sys/arch/i386/i386/gdt.c","sys/arch/i386/i386/gdt.c","gdt_init",97,121
20,3,175,1,20,"gdt_alloc_cpu@128-148@sys/arch/i386/i386/gdt.c","sys/arch/i386/i386/gdt.c","gdt_alloc_cpu",128,148
6,1,33,1,6,"gdt_init_cpu@157-163@sys/arch/i386/i386/gdt.c","sys/arch/i386/i386/gdt.c","gdt_init_cpu",157,163
15,3,64,1,17,"gdt_get_slot@172-189@sys/arch/i386/i386/gdt.c","sys/arch/i386/i386/gdt.c","gdt_get_slot",172,189
8,1,41,1,10,"gdt_put_slot@195-205@sys/arch/i386/i386/gdt.c","sys/arch/i386/i386/gdt.c","gdt_put_slot",195,205
8,1,52,1,8,"tss_alloc@208-216@sys/arch/i386/i386/gdt.c","sys/arch/i386/i386/gdt.c","tss_alloc",208,216
4,1,15,1,4,"tss_free@219-223@sys/arch/i386/i386/gdt.c","sys/arch/i386/i386/gdt.c","tss_free",219,223
28,16,225,1,38,"get_hibernate_io_function@79-117@sys/arch/i386/i386/hibernate_machdep.c","sys/arch/i386/i386/hibernate_machdep.c","get_hibernate_io_function",79,117
62,12,525,1,82,"get_hibernate_info_md@123-205@sys/arch/i386/i386/hibernate_machdep.c","sys/arch/i386/i386/hibernate_machdep.c","get_hibernate_info_md",123,205
7,2,34,3,6,"hibernate_enter_resume_mapping@215-221@sys/arch/i386/i386/hibernate_machdep.c","sys/arch/i386/i386/hibernate_machdep.c","hibernate_enter_resume_mapping",215,221
7,1,44,2,7,"hibernate_enter_resume_4m_pde@227-234@sys/arch/i386/i386/hibernate_machdep.c","sys/arch/i386/i386/hibernate_machdep.c","hibernate_enter_resume_4m_pde",227,234
7,1,42,2,7,"hibernate_enter_resume_4k_pte@240-247@sys/arch/i386/i386/hibernate_machdep.c","sys/arch/i386/i386/hibernate_machdep.c","hibernate_enter_resume_4k_pte",240,247
7,1,39,1,7,"hibernate_enter_resume_4k_pde@253-260@sys/arch/i386/i386/hibernate_machdep.c","sys/arch/i386/i386/hibernate_machdep.c","hibernate_enter_resume_4k_pde",253,260
50,5,410,3,86,"hibernate_populate_resume_pt@269-355@sys/arch/i386/i386/hibernate_machdep.c","sys/arch/i386/i386/hibernate_machdep.c","hibernate_populate_resume_pt",269,355
7,3,42,2,7,"hibernate_inflate_skip@365-372@sys/arch/i386/i386/hibernate_machdep.c","sys/arch/i386/i386/hibernate_machdep.c","hibernate_inflate_skip",365,372
4,1,10,1,3,"hibernate_enable_intr_machdep@375-378@sys/arch/i386/i386/hibernate_machdep.c","sys/arch/i386/i386/hibernate_machdep.c","hibernate_enable_intr_machdep",375,378
4,1,10,1,3,"hibernate_disable_intr_machdep@381-384@sys/arch/i386/i386/hibernate_machdep.c","sys/arch/i386/i386/hibernate_machdep.c","hibernate_disable_intr_machdep",381,384
4,1,16,1,3,"hibernate_quiesce_cpus@393-396@sys/arch/i386/i386/hibernate_machdep.c","sys/arch/i386/i386/hibernate_machdep.c","hibernate_quiesce_cpus",393,396
6,3,29,1,5,"mtrr2mrt@110-115@sys/arch/i386/i386/i686_mem.c","sys/arch/i386/i386/i686_mem.c","mtrr2mrt",110,115
10,6,50,2,9,"mtrrconflict@121-130@sys/arch/i386/i386/i686_mem.c","sys/arch/i386/i386/i686_mem.c","mtrrconflict",121,130
10,4,78,2,10,"mem_range_match@136-146@sys/arch/i386/i386/i686_mem.c","sys/arch/i386/i386/i686_mem.c","mem_range_match",136,146
74,20,596,1,84,"mrfetch@154-238@sys/arch/i386/i386/i686_mem.c","sys/arch/i386/i386/i686_mem.c","mrfetch",154,238
12,4,60,1,13,"mtrrtype@244-257@sys/arch/i386/i386/i686_mem.c","sys/arch/i386/i386/i686_mem.c","mtrrtype",244,257
6,1,22,1,7,"mrt2mtrr@260-267@sys/arch/i386/i386/i686_mem.c","sys/arch/i386/i386/i686_mem.c","mrt2mtrr",260,267
7,2,27,1,8,"mrstore@276-284@sys/arch/i386/i386/i686_mem.c","sys/arch/i386/i386/i686_mem.c","mrstore",276,284
61,12,453,1,76,"mrstoreone@292-368@sys/arch/i386/i386/i686_mem.c","sys/arch/i386/i386/i686_mem.c","mrstoreone",292,368
9,4,82,2,9,"mtrrfixsearch@374-383@sys/arch/i386/i386/i686_mem.c","sys/arch/i386/i386/i686_mem.c","mtrrfixsearch",374,383
17,7,174,3,23,"mrsetlow@394-417@sys/arch/i386/i386/i686_mem.c","sys/arch/i386/i386/i686_mem.c","mrsetlow",394,417
35,12,249,3,50,"mrsetvariable@424-474@sys/arch/i386/i386/i686_mem.c","sys/arch/i386/i386/i686_mem.c","mrsetvariable",424,474
32,11,212,3,40,"mrset@480-520@sys/arch/i386/i386/i686_mem.c","sys/arch/i386/i386/i686_mem.c","mrset",480,520
57,12,431,1,80,"mrinit@527-607@sys/arch/i386/i386/i686_mem.c","sys/arch/i386/i386/i686_mem.c","mrinit",527,607
4,1,14,1,3,"mrinit_cpu@613-616@sys/arch/i386/i386/i686_mem.c","sys/arch/i386/i386/i686_mem.c","mrinit_cpu",613,616
6,1,22,1,5,"mrreload_cpu@619-624@sys/arch/i386/i386/i686_mem.c","sys/arch/i386/i386/i686_mem.c","mrreload_cpu",619,624
7,2,31,1,9,"ioapic_lock@119-128@sys/arch/i386/i386/ioapic.c","sys/arch/i386/i386/ioapic.c","ioapic_lock",119,128
5,2,27,2,6,"ioapic_unlock@131-137@sys/arch/i386/i386/ioapic.c","sys/arch/i386/i386/ioapic.c","ioapic_unlock",131,137
7,1,36,2,8,"ioapic_read_ul@143-151@sys/arch/i386/i386/ioapic.c","sys/arch/i386/i386/ioapic.c","ioapic_read_ul",143,151
5,1,33,3,4,"ioapic_write_ul@154-158@sys/arch/i386/i386/ioapic.c","sys/arch/i386/i386/ioapic.c","ioapic_write_ul",154,158
9,1,44,2,9,"ioapic_read@161-170@sys/arch/i386/i386/ioapic.c","sys/arch/i386/i386/ioapic.c","ioapic_read",161,170
7,1,41,3,7,"ioapic_write@173-180@sys/arch/i386/i386/ioapic.c","sys/arch/i386/i386/ioapic.c","ioapic_write",173,180
13,5,70,1,19,"ioapic_find@183-202@sys/arch/i386/i386/ioapic.c","sys/arch/i386/i386/ioapic.c","ioapic_find",183,202
10,4,56,1,11,"ioapic_find_bybase@209-220@sys/arch/i386/i386/ioapic.c","sys/arch/i386/i386/ioapic.c","ioapic_find_bybase",209,220
6,1,22,1,5,"ioapic_add@223-228@sys/arch/i386/i386/ioapic.c","sys/arch/i386/i386/ioapic.c","ioapic_add",223,228
6,1,59,3,6,"ioapic_print_redir@231-237@sys/arch/i386/i386/ioapic.c","sys/arch/i386/i386/ioapic.c","ioapic_print_redir",231,237
8,2,63,3,8,"ioapic_match@249-257@sys/arch/i386/i386/ioapic.c","sys/arch/i386/i386/ioapic.c","ioapic_match",249,257
13,2,82,1,15,"ioapic_set_id@261-276@sys/arch/i386/i386/ioapic.c","sys/arch/i386/i386/ioapic.c","ioapic_set_id",261,276
61,12,467,3,85,"ioapic_attach@282-367@sys/arch/i386/i386/ioapic.c","sys/arch/i386/i386/ioapic.c","ioapic_attach",282,367
11,2,65,2,13,"ioapic_activate@370-383@sys/arch/i386/i386/ioapic.c","sys/arch/i386/i386/ioapic.c","ioapic_activate",370,383
38,10,246,2,54,"apic_set_redir@410-464@sys/arch/i386/i386/ioapic.c","sys/arch/i386/i386/ioapic.c","apic_set_redir",410,464
31,8,216,4,64,"apic_vectorset@491-555@sys/arch/i386/i386/ioapic.c","sys/arch/i386/i386/ioapic.c","apic_vectorset",491,555
35,10,211,1,44,"ioapic_enable@562-606@sys/arch/i386/i386/ioapic.c","sys/arch/i386/i386/ioapic.c","ioapic_enable",562,606
13,2,78,2,13,"ioapic_hwmask@609-622@sys/arch/i386/i386/ioapic.c","sys/arch/i386/i386/ioapic.c","ioapic_hwmask",609,622
13,2,78,2,13,"ioapic_hwunmask@625-638@sys/arch/i386/i386/ioapic.c","sys/arch/i386/i386/ioapic.c","ioapic_hwunmask",625,638
66,20,445,6,96,"apic_intr_establish@661-757@sys/arch/i386/i386/ioapic.c","sys/arch/i386/i386/ioapic.c","apic_intr_establish",661,757
41,12,283,1,50,"apic_intr_disestablish@776-826@sys/arch/i386/i386/ioapic.c","sys/arch/i386/i386/ioapic.c","apic_intr_disestablish",776,826
10,2,51,1,10,"apic_stray@829-839@sys/arch/i386/i386/ioapic.c","sys/arch/i386/i386/ioapic.c","apic_stray",829,839
13,4,81,1,13,"ioapic_dump@845-858@sys/arch/i386/i386/ioapic.c","sys/arch/i386/i386/ioapic.c","ioapic_dump",845,858
3,1,9,1,2,"i386_ipi_nop@108-110@sys/arch/i386/i386/ipifuncs.c","sys/arch/i386/i386/ipifuncs.c","i386_ipi_nop",108,110
14,2,63,1,15,"i386_ipi_halt@113-128@sys/arch/i386/i386/ipifuncs.c","sys/arch/i386/i386/ipifuncs.c","i386_ipi_halt",113,128
5,2,26,1,4,"i386_ipi_flush_fpu@132-136@sys/arch/i386/i386/ipifuncs.c","sys/arch/i386/i386/ipifuncs.c","i386_ipi_flush_fpu",132,136
5,2,26,1,4,"i386_ipi_synch_fpu@139-143@sys/arch/i386/i386/ipifuncs.c","sys/arch/i386/i386/ipifuncs.c","i386_ipi_synch_fpu",139,143
5,2,27,1,4,"i386_ipi_reload_mtrr@148-152@sys/arch/i386/i386/ipifuncs.c","sys/arch/i386/i386/ipifuncs.c","i386_ipi_reload_mtrr",148,152
4,1,11,1,3,"i386_spurious@156-159@sys/arch/i386/i386/ipifuncs.c","sys/arch/i386/i386/ipifuncs.c","i386_spurious",156,159
8,2,48,2,11,"i386_send_ipi@162-173@sys/arch/i386/i386/ipifuncs.c","sys/arch/i386/i386/ipifuncs.c","i386_send_ipi",162,173
7,2,42,2,8,"i386_fast_ipi@176-184@sys/arch/i386/i386/ipifuncs.c","sys/arch/i386/i386/ipifuncs.c","i386_fast_ipi",176,184
17,4,86,1,18,"i386_broadcast_ipi@187-205@sys/arch/i386/i386/ipifuncs.c","sys/arch/i386/i386/ipifuncs.c","i386_broadcast_ipi",187,205
15,4,93,1,16,"i386_ipi_handler@208-224@sys/arch/i386/i386/ipifuncs.c","sys/arch/i386/i386/ipifuncs.c","i386_ipi_handler",208,224
4,1,14,1,3,"i386_ipi_start_vmm@228-231@sys/arch/i386/i386/ipifuncs.c","sys/arch/i386/i386/ipifuncs.c","i386_ipi_start_vmm",228,231
4,1,14,1,3,"i386_ipi_stop_vmm@234-237@sys/arch/i386/i386/ipifuncs.c","sys/arch/i386/i386/ipifuncs.c","i386_ipi_stop_vmm",234,237
10,2,60,1,12,"k1x_setperf@81-93@sys/arch/i386/i386/k1x-pstate.c","sys/arch/i386/i386/k1x-pstate.c","k1x_setperf",81,93
25,7,153,2,29,"k1x_transition@96-125@sys/arch/i386/i386/k1x-pstate.c","sys/arch/i386/i386/k1x-pstate.c","k1x_transition",96,125
21,4,152,3,21,"k1x_acpi_states@130-151@sys/arch/i386/i386/k1x-pstate.c","sys/arch/i386/i386/k1x-pstate.c","k1x_acpi_states",130,151
9,2,47,1,11,"k1x_acpi_init@154-165@sys/arch/i386/i386/k1x-pstate.c","sys/arch/i386/i386/k1x-pstate.c","k1x_acpi_init",154,165
27,6,154,1,32,"k1x_init@170-202@sys/arch/i386/i386/k1x-pstate.c","sys/arch/i386/i386/k1x-pstate.c","k1x_init",170,202
17,8,149,2,19,"k6_mrmake@76-95@sys/arch/i386/i386/k6_mem.c","sys/arch/i386/i386/k6_mem.c","k6_mrmake",76,95
24,5,201,1,27,"k6_mrinit@98-125@sys/arch/i386/i386/k6_mem.c","sys/arch/i386/i386/k6_mem.c","k6_mrinit",98,125
43,11,277,3,48,"k6_mrset@128-176@sys/arch/i386/i386/k6_mem.c","sys/arch/i386/i386/k6_mem.c","k6_mrset",128,176
17,2,103,1,18,"k6_mrinit_cpu@182-200@sys/arch/i386/i386/k6_mem.c","sys/arch/i386/i386/k6_mem.c","k6_mrinit_cpu",182,200
33,4,287,1,48,"kvm86_init@80-128@sys/arch/i386/i386/kvm86.c","sys/arch/i386/i386/kvm86.c","kvm86_init",80,128
9,1,79,1,8,"kvm86_prepare@142-150@sys/arch/i386/i386/kvm86.c","sys/arch/i386/i386/kvm86.c","kvm86_prepare",142,150
4,1,35,3,4,"kvm86_map@153-157@sys/arch/i386/i386/kvm86.c","sys/arch/i386/i386/kvm86.c","kvm86_map",153,157
7,2,44,1,10,"kvm86_mapbios@160-170@sys/arch/i386/i386/kvm86.c","sys/arch/i386/i386/kvm86.c","kvm86_mapbios",160,170
12,3,84,1,15,"kvm86_bios_addpage@173-188@sys/arch/i386/i386/kvm86.c","sys/arch/i386/i386/kvm86.c","kvm86_bios_addpage",173,188
5,1,35,2,5,"kvm86_bios_delpage@191-196@sys/arch/i386/i386/kvm86.c","sys/arch/i386/i386/kvm86.c","kvm86_bios_delpage",191,196
20,3,146,3,22,"kvm86_bios_read@199-221@sys/arch/i386/i386/kvm86.c","sys/arch/i386/i386/kvm86.c","kvm86_bios_read",199,221
21,2,131,2,25,"kvm86_bioscall@224-249@sys/arch/i386/i386/kvm86.c","sys/arch/i386/i386/kvm86.c","kvm86_bioscall",224,249
25,1,180,2,28,"kvm86_simplecall@252-280@sys/arch/i386/i386/kvm86.c","sys/arch/i386/i386/kvm86.c","kvm86_simplecall",252,280
56,10,417,1,70,"kvm86_gpfault@283-353@sys/arch/i386/i386/kvm86.c","sys/arch/i386/i386/kvm86.c","kvm86_gpfault",283,353
12,2,57,1,26,"lapic_map@70-96@sys/arch/i386/i386/lapic.c","sys/arch/i386/i386/lapic.c","lapic_map",70,96
4,1,15,1,3,"lapic_enable@102-105@sys/arch/i386/i386/lapic.c","sys/arch/i386/i386/lapic.c","lapic_enable",102,105
4,1,13,1,3,"lapic_disable@108-111@sys/arch/i386/i386/lapic.c","sys/arch/i386/i386/lapic.c","lapic_disable",108,111
6,1,27,1,5,"lapic_set_softvectors@114-119@sys/arch/i386/i386/lapic.c","sys/arch/i386/i386/lapic.c","lapic_set_softvectors",114,119
48,16,338,1,70,"lapic_set_lvt@122-192@sys/arch/i386/i386/lapic.c","sys/arch/i386/i386/lapic.c","lapic_set_lvt",122,192
15,4,95,1,23,"lapic_boot_init@198-221@sys/arch/i386/i386/lapic.c","sys/arch/i386/i386/lapic.c","lapic_boot_init",198,221
4,1,12,1,3,"lapic_gettick@224-227@sys/arch/i386/i386/lapic.c","sys/arch/i386/i386/lapic.c","lapic_gettick",224,227
6,1,25,1,7,"lapic_clockintr@242-249@sys/arch/i386/i386/lapic.c","sys/arch/i386/i386/lapic.c","lapic_clockintr",242,249
7,1,38,1,13,"lapic_startclock@252-265@sys/arch/i386/i386/lapic.c","sys/arch/i386/i386/lapic.c","lapic_startclock",252,265
5,1,14,1,5,"lapic_initclocks@268-273@sys/arch/i386/i386/lapic.c","sys/arch/i386/i386/lapic.c","lapic_initclocks",268,273
11,3,46,1,11,"wait_next_cycle@278-289@sys/arch/i386/i386/lapic.c","sys/arch/i386/i386/lapic.c","wait_next_cycle",278,289
41,5,289,1,85,"lapic_calibrate_timer@303-388@sys/arch/i386/i386/lapic.c","sys/arch/i386/i386/lapic.c","lapic_calibrate_timer",303,388
20,5,95,1,22,"lapic_delay@395-417@sys/arch/i386/i386/lapic.c","sys/arch/i386/i386/lapic.c","lapic_delay",395,417
10,5,50,1,14,"i82489_icr_wait@427-441@sys/arch/i386/i386/lapic.c","sys/arch/i386/i386/lapic.c","i82489_icr_wait",427,441
12,2,72,1,16,"i386_ipi_init@444-460@sys/arch/i386/i386/lapic.c","sys/arch/i386/i386/lapic.c","i386_ipi_init",444,460
12,2,72,3,17,"i386_ipi@463-480@sys/arch/i386/i386/lapic.c","sys/arch/i386/i386/lapic.c","i386_ipi",463,480
21,8,102,1,29,"vmm_enabled@273-302@sys/arch/i386/i386/vmm.c","sys/arch/i386/i386/vmm.c","vmm_enabled",273,302
7,2,53,3,7,"vmm_probe@305-312@sys/arch/i386/i386/vmm.c","sys/arch/i386/i386/vmm.c","vmm_probe",305,312
45,9,293,3,51,"vmm_attach@322-373@sys/arch/i386/i386/vmm.c","sys/arch/i386/i386/vmm.c","vmm_attach",322,373
8,3,45,4,12,"vmmopen@381-393@sys/arch/i386/i386/vmm.c","sys/arch/i386/i386/vmm.c","vmmopen",381,393
38,10,212,5,39,"vmmioctl@402-441@sys/arch/i386/i386/vmm.c","sys/arch/i386/i386/vmm.c","vmmioctl",402,441
18,10,69,2,20,"pledge_ioctl_vmm@450-470@sys/arch/i386/i386/vmm.c","sys/arch/i386/i386/vmm.c","pledge_ioctl_vmm",450,470
4,1,21,4,3,"vmmclose@478-481@sys/arch/i386/i386/vmm.c","sys/arch/i386/i386/vmm.c","vmmclose",478,481
40,7,236,1,52,"vm_resetcpu@498-550@sys/arch/i386/i386/vmm.c","sys/arch/i386/i386/vmm.c","vm_resetcpu",498,550
26,7,159,1,48,"vm_intr_pending@566-614@sys/arch/i386/i386/vmm.c","sys/arch/i386/i386/vmm.c","vm_intr_pending",566,614
34,10,231,2,40,"vm_rwregs@633-673@sys/arch/i386/i386/vmm.c","sys/arch/i386/i386/vmm.c","vm_rwregs",633,673
17,4,111,2,24,"vm_find@691-715@sys/arch/i386/i386/vmm.c","sys/arch/i386/i386/vmm.c","vm_find",691,715
29,9,160,1,40,"vmm_start@723-763@sys/arch/i386/i386/vmm.c","sys/arch/i386/i386/vmm.c","vmm_start",723,763
29,9,154,1,40,"vmm_stop@771-811@sys/arch/i386/i386/vmm.c","sys/arch/i386/i386/vmm.c","vmm_stop",771,811
37,9,188,1,53,"start_vmm_on_cpu@820-873@sys/arch/i386/i386/vmm.c","sys/arch/i386/i386/vmm.c","start_vmm_on_cpu",820,873
20,5,98,1,30,"stop_vmm_on_cpu@882-912@sys/arch/i386/i386/vmm.c","sys/arch/i386/i386/vmm.c","stop_vmm_on_cpu",882,912
35,18,268,1,56,"vm_create_check_mem_ranges@928-984@sys/arch/i386/i386/vmm.c","sys/arch/i386/i386/vmm.c","vm_create_check_mem_ranges",928,984
56,7,400,2,75,"vm_create@999-1074@sys/arch/i386/i386/vmm.c","sys/arch/i386/i386/vmm.c","vm_create",999,1074
46,7,305,2,62,"vm_impl_init_vmx@1090-1152@sys/arch/i386/i386/vmm.c","sys/arch/i386/i386/vmm.c","vm_impl_init_vmx",1090,1152
40,6,274,2,54,"vm_impl_init_svm@1168-1222@sys/arch/i386/i386/vmm.c","sys/arch/i386/i386/vmm.c","vm_impl_init_svm",1168,1222
11,5,65,2,10,"vm_impl_init@1230-1240@sys/arch/i386/i386/vmm.c","sys/arch/i386/i386/vmm.c","vm_impl_init",1230,1240
3,1,9,1,3,"vm_impl_deinit_vmx@1248-1251@sys/arch/i386/i386/vmm.c","sys/arch/i386/i386/vmm.c","vm_impl_deinit_vmx",1248,1251
3,1,9,1,3,"vm_impl_deinit_svm@1259-1262@sys/arch/i386/i386/vmm.c","sys/arch/i386/i386/vmm.c","vm_impl_deinit_svm",1259,1262
11,5,54,1,10,"vm_impl_deinit@1270-1280@sys/arch/i386/i386/vmm.c","sys/arch/i386/i386/vmm.c","vm_impl_deinit",1270,1280
14,5,66,1,20,"vcpu_reload_vmcs_vmx@1296-1316@sys/arch/i386/i386/vmm.c","sys/arch/i386/i386/vmm.c","vcpu_reload_vmcs_vmx",1296,1316
77,22,561,3,85,"vcpu_readregs_vmx@1333-1418@sys/arch/i386/i386/vmm.c","sys/arch/i386/i386/vmm.c","vcpu_readregs_vmx",1333,1418
5,1,22,3,4,"vcpu_readregs_svm@1426-1430@sys/arch/i386/i386/vmm.c","sys/arch/i386/i386/vmm.c","vcpu_readregs_svm",1426,1430
83,25,560,4,90,"vcpu_writeregs_vmx@1448-1538@sys/arch/i386/i386/vmm.c","sys/arch/i386/i386/vmm.c","vcpu_writeregs_vmx",1448,1538
74,4,846,3,78,"vcpu_writeregs_svm@1555-1633@sys/arch/i386/i386/vmm.c","sys/arch/i386/i386/vmm.c","vcpu_writeregs_svm",1555,1633
40,2,297,2,79,"vcpu_reset_regs_svm@1649-1728@sys/arch/i386/i386/vmm.c","sys/arch/i386/i386/vmm.c","vcpu_reset_regs_svm",1649,1728
19,6,146,2,29,"svm_setmsrbr@1740-1769@sys/arch/i386/i386/vmm.c","sys/arch/i386/i386/vmm.c","svm_setmsrbr",1740,1769
19,6,146,2,29,"svm_setmsrbw@1781-1810@sys/arch/i386/i386/vmm.c","sys/arch/i386/i386/vmm.c","svm_setmsrbw",1781,1810
5,1,26,2,4,"svm_setmsrbrw@1822-1826@sys/arch/i386/i386/vmm.c","sys/arch/i386/i386/vmm.c","svm_setmsrbrw",1822,1826
14,4,104,2,20,"vmx_setmsrbr@1838-1858@sys/arch/i386/i386/vmm.c","sys/arch/i386/i386/vmm.c","vmx_setmsrbr",1838,1858
14,4,106,2,20,"vmx_setmsrbw@1870-1890@sys/arch/i386/i386/vmm.c","sys/arch/i386/i386/vmm.c","vmx_setmsrbw",1870,1890
5,1,26,2,4,"vmx_setmsrbrw@1902-1906@sys/arch/i386/i386/vmm.c","sys/arch/i386/i386/vmm.c","vmx_setmsrbrw",1902,1906
278,50,1504,2,439,"vcpu_reset_regs_vmx@1922-2361@sys/arch/i386/i386/vmm.c","sys/arch/i386/i386/vmm.c","vcpu_reset_regs_vmx",1922,2361
138,31,819,1,187,"vcpu_init_vmx@2380-2567@sys/arch/i386/i386/vmm.c","sys/arch/i386/i386/vmm.c","vcpu_init_vmx",2380,2567
13,5,75,2,14,"vcpu_reset_regs@2584-2598@sys/arch/i386/i386/vmm.c","sys/arch/i386/i386/vmm.c","vcpu_reset_regs",2584,2598
75,14,485,1,102,"vcpu_init_svm@2617-2719@sys/arch/i386/i386/vmm.c","sys/arch/i386/i386/vmm.c","vcpu_init_svm",2617,2719
15,5,82,1,16,"vcpu_init@2727-2743@sys/arch/i386/i386/vmm.c","sys/arch/i386/i386/vmm.c","vcpu_init",2727,2743
15,5,109,1,14,"vcpu_deinit_vmx@2754-2768@sys/arch/i386/i386/vmm.c","sys/arch/i386/i386/vmm.c","vcpu_deinit_vmx",2754,2768
15,5,113,1,14,"vcpu_deinit_svm@2779-2793@sys/arch/i386/i386/vmm.c","sys/arch/i386/i386/vmm.c","vcpu_deinit_svm",2779,2793
11,5,54,1,10,"vcpu_deinit@2804-2814@sys/arch/i386/i386/vmm.c","sys/arch/i386/i386/vmm.c","vcpu_deinit",2804,2814
18,3,120,1,23,"vm_teardown@2822-2845@sys/arch/i386/i386/vmm.c","sys/arch/i386/i386/vmm.c","vm_teardown",2822,2845
50,13,205,4,53,"vcpu_vmx_check_cap@2859-2912@sys/arch/i386/i386/vmm.c","sys/arch/i386/i386/vmm.c","vcpu_vmx_check_cap",2859,2912
89,35,458,5,154,"vcpu_vmx_compute_ctrl@2939-3093@sys/arch/i386/i386/vmm.c","sys/arch/i386/i386/vmm.c","vcpu_vmx_compute_ctrl",2939,3093
52,6,366,1,55,"vm_get_info@3101-3156@sys/arch/i386/i386/vmm.c","sys/arch/i386/i386/vmm.c","vm_get_info",3101,3156
34,7,201,1,42,"vm_terminate@3164-3206@sys/arch/i386/i386/vmm.c","sys/arch/i386/i386/vmm.c","vm_terminate",3164,3206
69,19,424,1,102,"vm_run@3214-3316@sys/arch/i386/i386/vmm.c","sys/arch/i386/i386/vmm.c","vm_run",3214,3316
9,3,48,1,9,"vcpu_must_stop@3327-3336@sys/arch/i386/i386/vmm.c","sys/arch/i386/i386/vmm.c","vcpu_must_stop",3327,3336
227,52,1092,2,323,"vcpu_run_vmx@3353-3676@sys/arch/i386/i386/vmm.c","sys/arch/i386/i386/vmm.c","vcpu_run_vmx",3353,3676
15,2,81,1,18,"vmx_handle_intr@3686-3704@sys/arch/i386/i386/vmm.c","sys/arch/i386/i386/vmm.c","vmx_handle_intr",3686,3704
15,3,71,1,17,"vmx_handle_hlt@3712-3729@sys/arch/i386/i386/vmm.c","sys/arch/i386/i386/vmm.c","vmx_handle_hlt",3712,3729
10,3,54,2,10,"vmx_get_exit_info@3739-3749@sys/arch/i386/i386/vmm.c","sys/arch/i386/i386/vmm.c","vmx_get_exit_info",3739,3749
73,15,311,1,79,"vmx_handle_exit@3758-3837@sys/arch/i386/i386/vmm.c","sys/arch/i386/i386/vmm.c","vmx_handle_exit",3758,3837
18,6,116,2,27,"vmm_get_guest_memtype@3845-3872@sys/arch/i386/i386/vmm.c","sys/arch/i386/i386/vmm.c","vmm_get_guest_memtype",3845,3872
9,3,39,1,8,"vmm_get_guest_faulttype@3881-3889@sys/arch/i386/i386/vmm.c","sys/arch/i386/i386/vmm.c","vmm_get_guest_faulttype",3881,3889
8,2,36,1,8,"vmx_get_exit_qualification@3897-3905@sys/arch/i386/i386/vmm.c","sys/arch/i386/i386/vmm.c","vmx_get_exit_qualification",3897,3905
15,4,69,1,16,"vmx_get_guest_faulttype@3914-3930@sys/arch/i386/i386/vmm.c","sys/arch/i386/i386/vmm.c","vmx_get_guest_faulttype",3914,3930
4,1,12,1,4,"svm_get_guest_faulttype@3939-3943@sys/arch/i386/i386/vmm.c","sys/arch/i386/i386/vmm.c","svm_get_guest_faulttype",3939,3943
14,3,83,2,16,"vmx_fault_page@3952-3968@sys/arch/i386/i386/vmm.c","sys/arch/i386/i386/vmm.c","vmx_fault_page",3952,3968
27,4,141,1,31,"vmx_handle_np_fault@3977-4008@sys/arch/i386/i386/vmm.c","sys/arch/i386/i386/vmm.c","vmx_handle_np_fault",3977,4008
38,12,277,1,61,"vmx_handle_inout@4019-4080@sys/arch/i386/i386/vmm.c","sys/arch/i386/i386/vmm.c","vmx_handle_inout",4019,4080
38,7,192,1,45,"vmx_handle_cr@4088-4133@sys/arch/i386/i386/vmm.c","sys/arch/i386/i386/vmm.c","vmx_handle_cr",4088,4133
25,3,152,1,32,"vmx_handle_rdmsr@4151-4183@sys/arch/i386/i386/vmm.c","sys/arch/i386/i386/vmm.c","vmx_handle_rdmsr",4151,4183
21,3,126,1,27,"vmx_handle_wrmsr@4200-4227@sys/arch/i386/i386/vmm.c","sys/arch/i386/i386/vmm.c","vmx_handle_wrmsr",4200,4227
229,32,1164,1,236,"vmm_handle_cpuid@4242-4478@sys/arch/i386/i386/vmm.c","sys/arch/i386/i386/vmm.c","vmm_handle_cpuid",4242,4478
4,1,19,2,4,"vcpu_run_svm@4486-4490@sys/arch/i386/i386/vmm.c","sys/arch/i386/i386/vmm.c","vcpu_run_svm",4486,4490
67,61,378,1,66,"vmx_exit_reason_decode@4498-4564@sys/arch/i386/i386/vmm.c","sys/arch/i386/i386/vmm.c","vmx_exit_reason_decode",4498,4564
23,18,120,1,22,"vmx_instruction_error_decode@4572-4594@sys/arch/i386/i386/vmm.c","sys/arch/i386/i386/vmm.c","vmx_instruction_error_decode",4572,4594
11,6,48,1,10,"vcpu_state_decode@4602-4612@sys/arch/i386/i386/vmm.c","sys/arch/i386/i386/vmm.c","vcpu_state_decode",4602,4612
100,4,750,1,99,"dump_vcpu@4621-4720@sys/arch/i386/i386/vmm.c","sys/arch/i386/i386/vmm.c","dump_vcpu",4621,4720
25,8,149,2,36,"vmx_dump_vmcs_field@4732-4768@sys/arch/i386/i386/vmm.c","sys/arch/i386/i386/vmm.c","vmx_dump_vmcs_field",4732,4768
442,46,2383,1,505,"vmx_dump_vmcs@4776-5281@sys/arch/i386/i386/vmm.c","sys/arch/i386/i386/vmm.c","vmx_dump_vmcs",4776,5281
252,42,1436,1,298,"vmx_vcpu_dump_regs@5293-5591@sys/arch/i386/i386/vmm.c","sys/arch/i386/i386/vmm.c","vmx_vcpu_dump_regs",5293,5591
29,24,156,1,33,"msr_name_decode@5605-5638@sys/arch/i386/i386/vmm.c","sys/arch/i386/i386/vmm.c","msr_name_decode",5605,5638
59,25,400,1,65,"vmm_segment_desc_decode@5649-5714@sys/arch/i386/i386/vmm.c","sys/arch/i386/i386/vmm.c","vmm_segment_desc_decode",5649,5714
24,3,166,1,26,"vmm_decode_cr0@5717-5743@sys/arch/i386/i386/vmm.c","sys/arch/i386/i386/vmm.c","vmm_decode_cr0",5717,5743
15,3,94,1,17,"vmm_decode_cr3@5746-5763@sys/arch/i386/i386/vmm.c","sys/arch/i386/i386/vmm.c","vmm_decode_cr3",5746,5763
32,3,230,1,34,"vmm_decode_cr4@5766-5800@sys/arch/i386/i386/vmm.c","sys/arch/i386/i386/vmm.c","vmm_decode_cr4",5766,5800
16,3,102,1,18,"vmm_decode_apicbase_msr_value@5803-5821@sys/arch/i386/i386/vmm.c","sys/arch/i386/i386/vmm.c","vmm_decode_apicbase_msr_value",5803,5821
20,4,130,1,23,"vmm_decode_ia32_fc_value@5824-5847@sys/arch/i386/i386/vmm.c","sys/arch/i386/i386/vmm.c","vmm_decode_ia32_fc_value",5824,5847
19,4,119,1,22,"vmm_decode_mtrrcap_value@5850-5872@sys/arch/i386/i386/vmm.c","sys/arch/i386/i386/vmm.c","vmm_decode_mtrrcap_value",5850,5872
4,1,18,1,3,"vmm_decode_perf_status_value@5875-5878@sys/arch/i386/i386/vmm.c","sys/arch/i386/i386/vmm.c","vmm_decode_perf_status_value",5875,5878
5,2,33,1,4,"vmm_decode_perf_ctl_value@5880-5884@sys/arch/i386/i386/vmm.c","sys/arch/i386/i386/vmm.c","vmm_decode_perf_ctl_value",5880,5884
29,9,180,1,32,"vmm_decode_mtrrdeftype_value@5887-5919@sys/arch/i386/i386/vmm.c","sys/arch/i386/i386/vmm.c","vmm_decode_mtrrdeftype_value",5887,5919
17,3,111,1,19,"vmm_decode_efer_value@5922-5941@sys/arch/i386/i386/vmm.c","sys/arch/i386/i386/vmm.c","vmm_decode_efer_value",5922,5941
13,8,93,2,12,"vmm_decode_msr_value@5944-5956@sys/arch/i386/i386/vmm.c","sys/arch/i386/i386/vmm.c","vmm_decode_msr_value",5944,5956
6,1,28,1,6,"longrun_init@59-65@sys/arch/i386/i386/longrun.c","sys/arch/i386/i386/longrun.c","longrun_init",59,65
11,1,57,1,13,"longrun_update@75-88@sys/arch/i386/i386/longrun.c","sys/arch/i386/i386/longrun.c","longrun_update",75,88
21,2,149,1,26,"longrun_setperf@99-125@sys/arch/i386/i386/longrun.c","sys/arch/i386/i386/longrun.c","longrun_setperf",99,125
5,1,20,1,4,"cyrix_read_reg@323-327@sys/arch/i386/i386/machdep.c","sys/arch/i386/i386/machdep.c","cyrix_read_reg",323,327
5,1,24,2,4,"cyrix_write_reg@330-334@sys/arch/i386/i386/machdep.c","sys/arch/i386/i386/machdep.c","cyrix_write_reg",330,334
12,1,42,2,11,"cpuid@341-352@sys/arch/i386/i386/machdep.c","sys/arch/i386/i386/machdep.c","cpuid",341,352
39,4,295,1,71,"cpu_startup@358-429@sys/arch/i386/i386/machdep.c","sys/arch/i386/i386/machdep.c","cpu_startup",358,429
13,1,120,1,15,"i386_proc0_tss_init@435-450@sys/arch/i386/i386/machdep.c","sys/arch/i386/i386/machdep.c","i386_proc0_tss_init",435,450
7,1,51,1,7,"i386_init_pcb_tss@454-461@sys/arch/i386/i386/machdep.c","sys/arch/i386/i386/machdep.c","i386_init_pcb_tss",454,461
10,2,55,1,11,"winchip_cpu_setup@1078-1089@sys/arch/i386/i386/machdep.c","sys/arch/i386/i386/machdep.c","winchip_cpu_setup",1078,1089
10,3,50,1,9,"cyrix3_setperf_setup@1093-1102@sys/arch/i386/i386/machdep.c","sys/arch/i386/i386/machdep.c","cyrix3_setperf_setup",1093,1102
101,38,581,1,149,"cyrix3_cpu_setup@1106-1255@sys/arch/i386/i386/machdep.c","sys/arch/i386/i386/machdep.c","cyrix3_cpu_setup",1106,1255
18,4,94,1,19,"via_update_sensor@1259-1278@sys/arch/i386/i386/machdep.c","sys/arch/i386/i386/machdep.c","via_update_sensor",1259,1278
23,4,160,1,30,"cyrix6x86_cpu_setup@1282-1312@sys/arch/i386/i386/machdep.c","sys/arch/i386/i386/machdep.c","cyrix6x86_cpu_setup",1282,1312
12,2,57,1,12,"natsem6x86_cpu_setup@1315-1327@sys/arch/i386/i386/machdep.c","sys/arch/i386/i386/machdep.c","natsem6x86_cpu_setup",1315,1327
8,2,31,1,7,"intel586_cpu_setup@1330-1337@sys/arch/i386/i386/machdep.c","sys/arch/i386/i386/machdep.c","intel586_cpu_setup",1330,1337
4,1,13,1,3,"amd_family5_setperf_setup@1341-1344@sys/arch/i386/i386/machdep.c","sys/arch/i386/i386/machdep.c","amd_family5_setperf_setup",1341,1344
14,6,62,1,26,"amd_family5_setup@1348-1374@sys/arch/i386/i386/machdep.c","sys/arch/i386/i386/machdep.c","amd_family5_setup",1348,1374
14,4,60,1,14,"amd_family6_setperf_setup@1378-1392@sys/arch/i386/i386/machdep.c","sys/arch/i386/i386/machdep.c","amd_family6_setperf_setup",1378,1392
15,4,88,1,19,"amd_family6_setup@1396-1415@sys/arch/i386/i386/machdep.c","sys/arch/i386/i386/machdep.c","amd_family6_setup",1396,1415
25,10,168,1,35,"intelcore_update_sensor@1433-1468@sys/arch/i386/i386/machdep.c","sys/arch/i386/i386/machdep.c","intelcore_update_sensor",1433,1468
11,3,91,1,12,"intel686_cpusensors_setup@1471-1483@sys/arch/i386/i386/machdep.c","sys/arch/i386/i386/machdep.c","intel686_cpusensors_setup",1471,1483
14,4,99,1,14,"intel686_setperf_setup@1488-1502@sys/arch/i386/i386/machdep.c","sys/arch/i386/i386/machdep.c","intel686_setperf_setup",1488,1502
16,4,80,1,22,"intel686_common_cpu_setup@1506-1528@sys/arch/i386/i386/machdep.c","sys/arch/i386/i386/machdep.c","intel686_common_cpu_setup",1506,1528
20,8,139,1,33,"intel686_cpu_setup@1531-1564@sys/arch/i386/i386/machdep.c","sys/arch/i386/i386/machdep.c","intel686_cpu_setup",1531,1564
6,2,31,1,8,"intel686_p4_cpu_setup@1567-1575@sys/arch/i386/i386/machdep.c","sys/arch/i386/i386/machdep.c","intel686_p4_cpu_setup",1567,1575
4,2,13,1,5,"tm86_cpu_setup@1578-1583@sys/arch/i386/i386/machdep.c","sys/arch/i386/i386/machdep.c","tm86_cpu_setup",1578,1583
33,11,104,1,36,"intel686_cpu_name@1586-1622@sys/arch/i386/i386/machdep.c","sys/arch/i386/i386/machdep.c","intel686_cpu_name",1586,1622
13,3,45,2,13,"cyrix3_cpu_name@1625-1638@sys/arch/i386/i386/machdep.c","sys/arch/i386/i386/machdep.c","cyrix3_cpu_name",1625,1638
332,126,2258,1,418,"identifycpu@1664-2082@sys/arch/i386/i386/machdep.c","sys/arch/i386/i386/machdep.c","identifycpu",1664,2082
14,3,65,1,16,"tm86_cpu_name@2085-2101@sys/arch/i386/i386/machdep.c","sys/arch/i386/i386/machdep.c","tm86_cpu_name",2085,2101
21,5,75,1,21,"cyrix3_get_bus_clock@2105-2126@sys/arch/i386/i386/machdep.c","sys/arch/i386/i386/machdep.c","cyrix3_get_bus_clock",2105,2126
44,9,184,1,44,"p4_get_bus_clock@2129-2173@sys/arch/i386/i386/machdep.c","sys/arch/i386/i386/machdep.c","p4_get_bus_clock",2129,2173
115,35,417,1,120,"p3_get_bus_clock@2176-2296@sys/arch/i386/i386/machdep.c","sys/arch/i386/i386/machdep.c","p3_get_bus_clock",2176,2296
15,2,73,1,18,"p4_update_cpuspeed@2299-2317@sys/arch/i386/i386/machdep.c","sys/arch/i386/i386/machdep.c","p4_update_cpuspeed",2299,2317
20,3,138,1,23,"p3_update_cpuspeed@2320-2343@sys/arch/i386/i386/machdep.c","sys/arch/i386/i386/machdep.c","p3_update_cpuspeed",2320,2343
5,1,18,1,4,"pentium_cpuspeed@2346-2350@sys/arch/i386/i386/machdep.c","sys/arch/i386/i386/machdep.c","pentium_cpuspeed",2346,2350
78,12,709,6,109,"sendsig@2364-2473@sys/arch/i386/i386/machdep.c","sys/arch/i386/i386/machdep.c","sendsig",2364,2473
61,12,496,3,84,"sys_sigreturn@2486-2570@sys/arch/i386/i386/machdep.c","sys/arch/i386/i386/machdep.c","sys_sigreturn",2486,2570
14,4,67,1,19,"cpu_kick@2575-2594@sys/arch/i386/i386/machdep.c","sys/arch/i386/i386/machdep.c","cpu_kick",2575,2594
5,1,21,1,4,"signotify@2602-2606@sys/arch/i386/i386/machdep.c","sys/arch/i386/i386/machdep.c","signotify",2602,2606
9,4,52,1,13,"cpu_unidle@2610-2623@sys/arch/i386/i386/machdep.c","sys/arch/i386/i386/machdep.c","cpu_unidle",2610,2623
60,18,303,1,86,"boot@2630-2716@sys/arch/i386/i386/machdep.c","sys/arch/i386/i386/machdep.c","boot",2630,2716
18,8,143,1,23,"dumpconf@2726-2749@sys/arch/i386/i386/machdep.c","sys/arch/i386/i386/machdep.c","dumpconf",2726,2749
11,1,109,1,17,"cpu_dump@2755-2772@sys/arch/i386/i386/machdep.c","sys/arch/i386/i386/machdep.c","cpu_dump",2755,2772
5,1,18,1,5,"reserve_dumppages@2782-2787@sys/arch/i386/i386/machdep.c","sys/arch/i386/i386/machdep.c","reserve_dumppages",2782,2787
60,22,436,1,88,"dumpsys@2790-2878@sys/arch/i386/i386/machdep.c","sys/arch/i386/i386/machdep.c","dumpsys",2790,2878
37,3,362,4,59,"setregs@2884-2943@sys/arch/i386/i386/machdep.c","sys/arch/i386/i386/machdep.c","setregs",2884,2943
12,1,87,6,12,"setgate@2955-2967@sys/arch/i386/i386/machdep.c","sys/arch/i386/i386/machdep.c","setgate",2955,2967
11,1,57,1,10,"unsetgate@2970-2980@sys/arch/i386/i386/machdep.c","sys/arch/i386/i386/machdep.c","unsetgate",2970,2980
5,1,34,3,5,"setregion@2983-2988@sys/arch/i386/i386/machdep.c","sys/arch/i386/i386/machdep.c","setregion",2983,2988
14,1,106,7,14,"setsegment@2991-3005@sys/arch/i386/i386/machdep.c","sys/arch/i386/i386/machdep.c","setsegment",2991,3005
16,1,121,1,27,"fix_f00f@3019-3046@sys/arch/i386/i386/machdep.c","sys/arch/i386/i386/machdep.c","fix_f00f",3019,3046
6,1,36,1,5,"cpu_init_idt@3050-3055@sys/arch/i386/i386/machdep.c","sys/arch/i386/i386/machdep.c","cpu_init_idt",3050,3055
171,57,1685,1,308,"init386@3059-3367@sys/arch/i386/i386/machdep.c","sys/arch/i386/i386/machdep.c","init386",3059,3367
3,1,6,1,3,"consinit@3374-3377@sys/arch/i386/i386/machdep.c","sys/arch/i386/i386/machdep.c","consinit",3374,3377
19,3,125,1,38,"cpu_reset@3380-3418@sys/arch/i386/i386/machdep.c","sys/arch/i386/i386/machdep.c","cpu_reset",3380,3418
4,1,13,1,3,"cpu_initclocks@3421-3424@sys/arch/i386/i386/machdep.c","sys/arch/i386/i386/machdep.c","cpu_initclocks",3421,3424
8,2,35,1,9,"need_resched@3427-3436@sys/arch/i386/i386/machdep.c","sys/arch/i386/i386/machdep.c","need_resched",3427,3436
8,3,47,2,8,"idt_vec_alloc@3443-3451@sys/arch/i386/i386/machdep.c","sys/arch/i386/i386/machdep.c","idt_vec_alloc",3443,3451
4,1,35,2,3,"idt_vec_set@3454-3457@sys/arch/i386/i386/machdep.c","sys/arch/i386/i386/machdep.c","idt_vec_set",3454,3457
4,1,16,1,3,"idt_vec_free@3460-3463@sys/arch/i386/i386/machdep.c","sys/arch/i386/i386/machdep.c","idt_vec_free",3460,3463
77,30,545,7,87,"cpu_sysctl@3469-3556@sys/arch/i386/i386/machdep.c","sys/arch/i386/i386/machdep.c","cpu_sysctl",3469,3556
37,12,209,5,56,"bus_space_map@3559-3615@sys/arch/i386/i386/machdep.c","sys/arch/i386/i386/machdep.c","bus_space_map",3559,3615
9,2,52,5,16,"_bus_space_map@3618-3634@sys/arch/i386/i386/machdep.c","sys/arch/i386/i386/machdep.c","_bus_space_map",3618,3634
37,11,224,9,60,"bus_space_alloc@3637-3697@sys/arch/i386/i386/machdep.c","sys/arch/i386/i386/machdep.c","bus_space_alloc",3637,3697
27,8,179,4,36,"bus_mem_add_mapping@3700-3736@sys/arch/i386/i386/machdep.c","sys/arch/i386/i386/machdep.c","bus_mem_add_mapping",3700,3736
32,10,218,3,46,"bus_space_unmap@3739-3785@sys/arch/i386/i386/machdep.c","sys/arch/i386/i386/machdep.c","bus_space_unmap",3739,3785
26,8,173,4,40,"_bus_space_unmap@3788-3828@sys/arch/i386/i386/machdep.c","sys/arch/i386/i386/machdep.c","_bus_space_unmap",3788,3828
4,1,22,3,5,"bus_space_free@3831-3836@sys/arch/i386/i386/machdep.c","sys/arch/i386/i386/machdep.c","bus_space_free",3831,3836
6,1,32,5,5,"bus_space_subregion@3839-3844@sys/arch/i386/i386/machdep.c","sys/arch/i386/i386/machdep.c","bus_space_subregion",3839,3844
6,2,38,5,7,"bus_space_mmap@3847-3854@sys/arch/i386/i386/machdep.c","sys/arch/i386/i386/machdep.c","bus_space_mmap",3847,3854
7,4,55,2,6,"splassert_check@3858-3864@sys/arch/i386/i386/machdep.c","sys/arch/i386/i386/machdep.c","splassert_check",3858,3864
6,2,38,2,7,"copyin32@3868-3875@sys/arch/i386/i386/machdep.c","sys/arch/i386/i386/machdep.c","copyin32",3868,3875
6,1,37,1,6,"softintr@3889-3895@sys/arch/i386/i386/machdep.c","sys/arch/i386/i386/machdep.c","softintr",3889,3895
6,1,22,1,6,"splraise@3901-3907@sys/arch/i386/i386/machdep.c","sys/arch/i386/i386/machdep.c","splraise",3901,3907
4,1,12,1,3,"splx@3914-3917@sys/arch/i386/i386/machdep.c","sys/arch/i386/i386/machdep.c","splx",3914,3917
6,1,22,1,6,"spllower@3924-3930@sys/arch/i386/i386/machdep.c","sys/arch/i386/i386/machdep.c","spllower",3924,3930
15,7,84,2,20,"intr_handler@3933-3953@sys/arch/i386/i386/machdep.c","sys/arch/i386/i386/machdep.c","intr_handler",3933,3953
4,1,13,1,3,"intr_barrier@3956-3959@sys/arch/i386/i386/machdep.c","sys/arch/i386/i386/machdep.c","intr_barrier",3956,3959
56,13,363,1,91,"cpu_check_vmm_cap@3972-4063@sys/arch/i386/i386/machdep.c","sys/arch/i386/i386/machdep.c","cpu_check_vmm_cap",3972,4063
4,1,22,3,3,"mainbus_match@130-133@sys/arch/i386/i386/mainbus.c","sys/arch/i386/i386/mainbus.c","mainbus_match",130,133
92,28,672,3,144,"mainbus_attach@139-283@sys/arch/i386/i386/mainbus.c","sys/arch/i386/i386/mainbus.c","mainbus_attach",139,283
9,3,63,2,10,"mainbus_print@286-296@sys/arch/i386/i386/mainbus.c","sys/arch/i386/i386/mainbus.c","mainbus_print",286,296
24,13,114,4,29,"mmopen@77-106@sys/arch/i386/i386/mem.c","sys/arch/i386/i386/mem.c","mmopen",77,106
6,3,36,4,7,"mmclose@110-117@sys/arch/i386/i386/mem.c","sys/arch/i386/i386/mem.c","mmclose",110,117
71,18,452,3,81,"mmrw@121-202@sys/arch/i386/i386/mem.c","sys/arch/i386/i386/mem.c","mmrw",121,202
32,15,166,3,43,"mmmmap@205-248@sys/arch/i386/i386/mem.c","sys/arch/i386/i386/mem.c","mmmmap",205,248
9,4,55,5,10,"mmioctl@251-261@sys/arch/i386/i386/mem.c","sys/arch/i386/i386/mem.c","mmioctl",251,261
39,10,301,5,47,"mem_ioctl@271-318@sys/arch/i386/i386/mem.c","sys/arch/i386/i386/mem.c","mem_ioctl",271,318
11,3,70,2,12,"mem_range_attr_get@325-337@sys/arch/i386/i386/mem.c","sys/arch/i386/i386/mem.c","mem_range_attr_get",325,337
6,2,43,2,7,"mem_range_attr_set@340-347@sys/arch/i386/i386/mem.c","sys/arch/i386/i386/mem.c","mem_range_attr_set",340,347
8,1,33,1,8,"mp_setperf@37-45@sys/arch/i386/i386/mp_setperf.c","sys/arch/i386/i386/mp_setperf.c","mp_setperf",37,45
4,1,14,1,3,"i386_setperf_ipi@48-51@sys/arch/i386/i386/mp_setperf.c","sys/arch/i386/i386/mp_setperf.c","i386_setperf_ipi",48,51
8,2,29,1,8,"mp_setperf_init@54-62@sys/arch/i386/i386/mp_setperf.c","sys/arch/i386/i386/mp_setperf.c","mp_setperf_init",54,62
8,2,58,3,8,"mpbios_match@209-217@sys/arch/i386/i386/mpbios.c","sys/arch/i386/i386/mpbios.c","mpbios_match",209,217
4,1,23,3,3,"mpbios_attach@220-223@sys/arch/i386/i386/mpbios.c","sys/arch/i386/i386/mpbios.c","mpbios_attach",220,223
7,2,40,2,7,"mp_print@226-233@sys/arch/i386/i386/mpbios.c","sys/arch/i386/i386/mpbios.c","mp_print",226,233
8,2,68,3,9,"mp_match@236-245@sys/arch/i386/i386/mpbios.c","sys/arch/i386/i386/mpbios.c","mp_match",236,245
18,2,125,3,20,"mpbios_map@252-272@sys/arch/i386/i386/mpbios.c","sys/arch/i386/i386/mpbios.c","mpbios_map",252,272
5,1,33,1,4,"mpbios_unmap@275-279@sys/arch/i386/i386/mpbios.c","sys/arch/i386/i386/mpbios.c","mpbios_unmap",275,279
81,19,450,1,119,"mpbios_probe@285-404@sys/arch/i386/i386/mpbios.c","sys/arch/i386/i386/mpbios.c","mpbios_probe",285,404
9,2,49,2,10,"mpbios_cksum@412-422@sys/arch/i386/i386/mpbios.c","sys/arch/i386/i386/mpbios.c","mpbios_cksum",412,422
22,5,189,4,27,"mpbios_search@434-461@sys/arch/i386/i386/mpbios.c","sys/arch/i386/i386/mpbios.c","mpbios_search",434,461
97,26,543,1,131,"mpbios_scan@522-653@sys/arch/i386/i386/mpbios.c","sys/arch/i386/i386/mpbios.c","mpbios_scan",522,653
28,6,168,3,32,"mpbios_invent@656-688@sys/arch/i386/i386/mpbios.c","sys/arch/i386/i386/mpbios.c","mpbios_invent",656,688
24,6,157,2,45,"mpbios_cpu@691-736@sys/arch/i386/i386/mpbios.c","sys/arch/i386/i386/mpbios.c","mpbios_cpu",691,736
20,4,100,2,32,"mp_cfg_special_intr@745-777@sys/arch/i386/i386/mpbios.c","sys/arch/i386/i386/mpbios.c","mp_cfg_special_intr",745,777
33,8,152,2,35,"mp_cfg_pci_intr@782-817@sys/arch/i386/i386/mpbios.c","sys/arch/i386/i386/mpbios.c","mp_cfg_pci_intr",782,817
40,9,189,2,46,"mp_cfg_eisa_intr@820-866@sys/arch/i386/i386/mpbios.c","sys/arch/i386/i386/mpbios.c","mp_cfg_eisa_intr",820,866
33,8,152,2,35,"mp_cfg_isa_intr@870-905@sys/arch/i386/i386/mpbios.c","sys/arch/i386/i386/mpbios.c","mp_cfg_isa_intr",870,905
3,1,7,1,2,"mp_print_special_intr@909-911@sys/arch/i386/i386/mpbios.c","sys/arch/i386/i386/mpbios.c","mp_print_special_intr",909,911
4,1,29,1,3,"mp_print_pci_intr@914-917@sys/arch/i386/i386/mpbios.c","sys/arch/i386/i386/mpbios.c","mp_print_pci_intr",914,917
4,1,14,1,3,"mp_print_isa_intr@920-923@sys/arch/i386/i386/mpbios.c","sys/arch/i386/i386/mpbios.c","mp_print_isa_intr",920,923
4,1,14,1,3,"mp_print_eisa_intr@926-929@sys/arch/i386/i386/mpbios.c","sys/arch/i386/i386/mpbios.c","mp_print_eisa_intr",926,929
42,8,325,2,53,"mpbios_bus@940-993@sys/arch/i386/i386/mpbios.c","sys/arch/i386/i386/mpbios.c","mpbios_bus",940,993
15,3,124,2,18,"mpbios_ioapic@997-1015@sys/arch/i386/i386/mpbios.c","sys/arch/i386/i386/mpbios.c","mpbios_ioapic",997,1015
95,17,557,2,116,"mpbios_int@1018-1134@sys/arch/i386/i386/mpbios.c","sys/arch/i386/i386/mpbios.c","mpbios_int",1018,1134
9,4,58,1,10,"mpbios_icu_lookup@54-64@sys/arch/i386/i386/mpbios_intr_fixup.c","sys/arch/i386/i386/mpbios_intr_fixup.c","mpbios_icu_lookup",54,64
23,6,194,2,25,"nforce4_mpbios_fixup@85-110@sys/arch/i386/i386/mpbios_intr_fixup.c","sys/arch/i386/i386/mpbios_intr_fixup.c","nforce4_mpbios_fixup",85,110
13,3,99,2,14,"mcp04_mpbios_fixup@117-131@sys/arch/i386/i386/mpbios_intr_fixup.c","sys/arch/i386/i386/mpbios_intr_fixup.c","mcp04_mpbios_fixup",117,131
6,1,38,2,8,"via8237_mpbios_fixup@138-146@sys/arch/i386/i386/mpbios_intr_fixup.c","sys/arch/i386/i386/mpbios_intr_fixup.c","via8237_mpbios_fixup",138,146
24,7,194,4,30,"mpbios_pin_fixup@149-179@sys/arch/i386/i386/mpbios_intr_fixup.c","sys/arch/i386/i386/mpbios_intr_fixup.c","mpbios_pin_fixup",149,179
37,11,243,1,49,"mpbios_intr_fixup@182-231@sys/arch/i386/i386/mpbios_intr_fixup.c","sys/arch/i386/i386/mpbios_intr_fixup.c","mpbios_intr_fixup",182,231
22,13,167,1,27,"mem_range_attach@40-67@sys/arch/i386/i386/mtrr.c","sys/arch/i386/i386/mtrr.c","mem_range_attach",40,67
10,5,40,1,12,"nvramattach@58-70@sys/arch/i386/i386/nvram.c","sys/arch/i386/i386/nvram.c","nvramattach",58,70
8,4,57,4,11,"nvramopen@73-84@sys/arch/i386/i386/nvram.c","sys/arch/i386/i386/nvram.c","nvramopen",73,84
4,1,23,4,3,"nvramclose@87-90@sys/arch/i386/i386/nvram.c","sys/arch/i386/i386/nvram.c","nvramclose",87,90
21,8,165,3,33,"nvramread@93-126@sys/arch/i386/i386/nvram.c","sys/arch/i386/i386/nvram.c","nvramread",93,126
6,2,31,1,6,"nvram_get_byte@129-135@sys/arch/i386/i386/nvram.c","sys/arch/i386/i386/nvram.c","nvram_get_byte",129,135
13,3,84,1,18,"nvram_csum_valid@138-156@sys/arch/i386/i386/nvram.c","sys/arch/i386/i386/nvram.c","nvram_csum_valid",138,156
29,12,120,2,32,"p4tcc_init@69-101@sys/arch/i386/i386/p4tcc.c","sys/arch/i386/i386/p4tcc.c","p4tcc_init",69,101
5,1,24,1,5,"p4tcc_cpuspeed@104-109@sys/arch/i386/i386/p4tcc.c","sys/arch/i386/i386/p4tcc.c","p4tcc_cpuspeed",104,109
21,6,137,1,23,"p4tcc_setperf@112-135@sys/arch/i386/i386/p4tcc.c","sys/arch/i386/i386/p4tcc.c","p4tcc_setperf",112,135
12,1,86,1,12,"p5ctrrd@44-56@sys/arch/i386/i386/pctr.c","sys/arch/i386/i386/pctr.c","p5ctrrd",44,56
13,5,104,1,13,"pctrrd@59-72@sys/arch/i386/i386/pctr.c","sys/arch/i386/i386/pctr.c","pctrrd",59,72
23,6,117,1,27,"pctrattach@75-102@sys/arch/i386/i386/pctr.c","sys/arch/i386/i386/pctr.c","pctrattach",75,102
6,2,35,4,6,"pctropen@105-111@sys/arch/i386/i386/pctr.c","sys/arch/i386/i386/pctr.c","pctropen",105,111
4,1,23,4,4,"pctrclose@114-118@sys/arch/i386/i386/pctr.c","sys/arch/i386/i386/pctr.c","pctrclose",114,118
20,5,117,3,23,"p5ctrsel@121-144@sys/arch/i386/i386/pctr.c","sys/arch/i386/i386/pctr.c","p5ctrsel",121,144
24,6,132,3,27,"pctrsel@147-174@sys/arch/i386/i386/pctr.c","sys/arch/i386/i386/pctr.c","pctrsel",147,174
30,11,160,5,30,"pctrioctl@177-207@sys/arch/i386/i386/pctr.c","sys/arch/i386/i386/pctr.c","pctrioctl",177,207
5,3,34,1,4,"pmap_pte2flags@475-479@sys/arch/i386/i386/pmap.c","sys/arch/i386/i386/pmap.c","pmap_pte2flags",475,479
6,2,37,2,5,"pmap_sync_flags_pte_86@482-487@sys/arch/i386/i386/pmap.c","sys/arch/i386/i386/pmap.c","pmap_sync_flags_pte_86",482,487
5,1,14,1,4,"pmap_apte_flush@490-494@sys/arch/i386/i386/pmap.c","sys/arch/i386/i386/pmap.c","pmap_apte_flush",490,494
22,8,134,1,31,"pmap_map_ptes_86@504-535@sys/arch/i386/i386/pmap.c","sys/arch/i386/i386/pmap.c","pmap_map_ptes_86",504,535
11,4,58,1,14,"pmap_unmap_ptes_86@542-556@sys/arch/i386/i386/pmap.c","sys/arch/i386/i386/pmap.c","pmap_unmap_ptes_86",542,556
17,8,131,4,28,"pmap_exec_account@559-587@sys/arch/i386/i386/pmap.c","sys/arch/i386/i386/pmap.c","pmap_exec_account",559,587
24,6,166,3,46,"pmap_exec_fixup@597-643@sys/arch/i386/i386/pmap.c","sys/arch/i386/i386/pmap.c","pmap_exec_fixup",597,643
7,1,46,3,8,"pmap_pte_set_86@646-654@sys/arch/i386/i386/pmap.c","sys/arch/i386/i386/pmap.c","pmap_pte_set_86",646,654
7,1,46,3,7,"pmap_pte_setbits_86@657-664@sys/arch/i386/i386/pmap.c","sys/arch/i386/i386/pmap.c","pmap_pte_setbits_86",657,664
5,1,24,1,5,"pmap_pte_bits_86@667-672@sys/arch/i386/i386/pmap.c","sys/arch/i386/i386/pmap.c","pmap_pte_bits_86",667,672
5,1,24,1,5,"pmap_pte_paddr_86@675-680@sys/arch/i386/i386/pmap.c","sys/arch/i386/i386/pmap.c","pmap_pte_paddr_86",675,680
14,5,76,1,20,"pmap_tmpmap_pa@687-707@sys/arch/i386/i386/pmap.c","sys/arch/i386/i386/pmap.c","pmap_tmpmap_pa",687,707
16,6,77,1,28,"pmap_tmpunmap_pa@714-742@sys/arch/i386/i386/pmap.c","sys/arch/i386/i386/pmap.c","pmap_tmpunmap_pa",714,742
7,2,37,1,6,"vtophys@745-751@sys/arch/i386/i386/pmap.c","sys/arch/i386/i386/pmap.c","vtophys",745,751
9,1,86,4,28,"setcslimit@754-782@sys/arch/i386/i386/pmap.c","sys/arch/i386/i386/pmap.c","setcslimit",754,782
23,11,164,3,26,"pmap_kenter_pa@800-826@sys/arch/i386/i386/pmap.c","sys/arch/i386/i386/pmap.c","pmap_kenter_pa",800,826
13,4,79,2,16,"pmap_kremove@838-854@sys/arch/i386/i386/pmap.c","sys/arch/i386/i386/pmap.c","pmap_kremove",838,854
68,7,572,1,170,"pmap_bootstrap@875-1045@sys/arch/i386/i386/pmap.c","sys/arch/i386/i386/pmap.c","pmap_bootstrap",875,1045
13,2,74,1,19,"pmap_prealloc_lowmem_ptp@1052-1071@sys/arch/i386/i386/pmap.c","sys/arch/i386/i386/pmap.c","pmap_prealloc_lowmem_ptp",1052,1071
6,1,26,1,18,"pmap_init@1080-1098@sys/arch/i386/i386/pmap.c","sys/arch/i386/i386/pmap.c","pmap_init",1080,1098
8,2,64,3,9,"pmap_pv_page_alloc@1105-1114@sys/arch/i386/i386/pmap.c","sys/arch/i386/i386/pmap.c","pmap_pv_page_alloc",1105,1114
4,1,29,2,3,"pmap_pv_page_free@1117-1120@sys/arch/i386/i386/pmap.c","sys/arch/i386/i386/pmap.c","pmap_pv_page_free",1117,1120
11,1,83,5,10,"pmap_enter_pv@1140-1150@sys/arch/i386/i386/pmap.c","sys/arch/i386/i386/pmap.c","pmap_enter_pv",1140,1150
15,4,104,3,15,"pmap_remove_pv@1162-1177@sys/arch/i386/i386/pmap.c","sys/arch/i386/i386/pmap.c","pmap_remove_pv",1162,1177
15,2,113,3,17,"pmap_alloc_ptp_86@1193-1210@sys/arch/i386/i386/pmap.c","sys/arch/i386/i386/pmap.c","pmap_alloc_ptp_86",1193,1210
16,6,111,2,22,"pmap_get_ptp_86@1220-1242@sys/arch/i386/i386/pmap.c","sys/arch/i386/i386/pmap.c","pmap_get_ptp_86",1220,1242
12,3,119,4,19,"pmap_drop_ptp_86@1245-1264@sys/arch/i386/i386/pmap.c","sys/arch/i386/i386/pmap.c","pmap_drop_ptp_86",1245,1264
20,2,140,1,28,"pmap_create@1278-1306@sys/arch/i386/i386/pmap.c","sys/arch/i386/i386/pmap.c","pmap_create",1278,1306
17,2,168,1,30,"pmap_pinit_pd_86@1309-1339@sys/arch/i386/i386/pmap.c","sys/arch/i386/i386/pmap.c","pmap_pinit_pd_86",1309,1339
23,7,159,1,34,"pmap_destroy@1347-1381@sys/arch/i386/i386/pmap.c","sys/arch/i386/i386/pmap.c","pmap_destroy",1347,1381
4,1,19,1,3,"pmap_reference@1389-1392@sys/arch/i386/i386/pmap.c","sys/arch/i386/i386/pmap.c","pmap_reference",1389,1392
6,1,35,1,5,"pmap_activate@1395-1400@sys/arch/i386/i386/pmap.c","sys/arch/i386/i386/pmap.c","pmap_activate",1395,1400
22,5,173,2,29,"pmap_switch@1406-1435@sys/arch/i386/i386/pmap.c","sys/arch/i386/i386/pmap.c","pmap_switch",1406,1435
3,1,9,1,2,"pmap_deactivate@1438-1440@sys/arch/i386/i386/pmap.c","sys/arch/i386/i386/pmap.c","pmap_deactivate",1438,1440
15,4,105,3,15,"pmap_extract_86@1447-1462@sys/arch/i386/i386/pmap.c","sys/arch/i386/i386/pmap.c","pmap_extract_86",1447,1462
5,1,22,2,4,"pmap_virtual_space@1470-1474@sys/arch/i386/i386/pmap.c","sys/arch/i386/i386/pmap.c","pmap_virtual_space",1470,1474
4,1,17,1,3,"pmap_zero_page@1482-1485@sys/arch/i386/i386/pmap.c","sys/arch/i386/i386/pmap.c","pmap_zero_page",1482,1485
12,4,78,1,17,"pmap_zero_phys_86@1492-1509@sys/arch/i386/i386/pmap.c","sys/arch/i386/i386/pmap.c","pmap_zero_phys_86",1492,1509
13,4,85,1,19,"pmap_zero_page_uncached_86@1516-1535@sys/arch/i386/i386/pmap.c","sys/arch/i386/i386/pmap.c","pmap_zero_page_uncached_86",1516,1535
12,3,64,2,13,"pmap_flush_cache@1541-1554@sys/arch/i386/i386/pmap.c","sys/arch/i386/i386/pmap.c","pmap_flush_cache",1541,1554
20,5,110,1,28,"pmap_flush_page@1557-1585@sys/arch/i386/i386/pmap.c","sys/arch/i386/i386/pmap.c","pmap_flush_page",1557,1585
18,5,161,2,23,"pmap_copy_page_86@1592-1615@sys/arch/i386/i386/pmap.c","sys/arch/i386/i386/pmap.c","pmap_copy_page_86",1592,1615
38,15,244,7,69,"pmap_remove_ptes_86@1633-1702@sys/arch/i386/i386/pmap.c","sys/arch/i386/i386/pmap.c","pmap_remove_ptes_86",1633,1702
4,1,26,3,3,"pmap_remove@1711-1714@sys/arch/i386/i386/pmap.c","sys/arch/i386/i386/pmap.c","pmap_remove",1711,1714
61,18,387,4,102,"pmap_do_remove_86@1717-1819@sys/arch/i386/i386/pmap.c","sys/arch/i386/i386/pmap.c","pmap_do_remove_86",1717,1819
63,12,464,1,89,"pmap_page_remove_86@1828-1917@sys/arch/i386/i386/pmap.c","sys/arch/i386/i386/pmap.c","pmap_page_remove_86",1828,1917
25,5,183,2,30,"pmap_test_attrs_86@1931-1961@sys/arch/i386/i386/pmap.c","sys/arch/i386/i386/pmap.c","pmap_test_attrs_86",1931,1961
31,6,228,2,38,"pmap_clear_attrs_86@1970-2008@sys/arch/i386/i386/pmap.c","sys/arch/i386/i386/pmap.c","pmap_clear_attrs_86",1970,2008
48,13,307,4,73,"pmap_write_protect_86@2036-2109@sys/arch/i386/i386/pmap.c","sys/arch/i386/i386/pmap.c","pmap_write_protect_86",2036,2109
22,7,127,2,30,"pmap_unwire_86@2122-2152@sys/arch/i386/i386/pmap.c","sys/arch/i386/i386/pmap.c","pmap_unwire_86",2122,2152
5,1,20,1,9,"pmap_collect@2162-2171@sys/arch/i386/i386/pmap.c","sys/arch/i386/i386/pmap.c","pmap_collect",2162,2171
140,48,792,5,210,"pmap_enter_86@2191-2401@sys/arch/i386/i386/pmap.c","sys/arch/i386/i386/pmap.c","pmap_enter_86",2191,2401
32,6,198,1,60,"pmap_growkernel_86@2411-2471@sys/arch/i386/i386/pmap.c","sys/arch/i386/i386/pmap.c","pmap_growkernel_86",2411,2471
31,10,189,2,34,"pmap_tlb_shootpage@2502-2536@sys/arch/i386/i386/pmap.c","sys/arch/i386/i386/pmap.c","pmap_tlb_shootpage",2502,2536
34,11,213,3,37,"pmap_tlb_shootrange@2539-2576@sys/arch/i386/i386/pmap.c","sys/arch/i386/i386/pmap.c","pmap_tlb_shootrange",2539,2576
28,8,161,1,32,"pmap_tlb_shoottlb@2579-2611@sys/arch/i386/i386/pmap.c","sys/arch/i386/i386/pmap.c","pmap_tlb_shoottlb",2579,2611
31,10,183,1,36,"pmap_tlb_droppmap@2614-2650@sys/arch/i386/i386/pmap.c","sys/arch/i386/i386/pmap.c","pmap_tlb_droppmap",2614,2650
5,2,16,1,4,"pmap_tlb_shootwait@2653-2657@sys/arch/i386/i386/pmap.c","sys/arch/i386/i386/pmap.c","pmap_tlb_shootwait",2653,2657
5,2,24,2,5,"pmap_tlb_shootpage@2662-2667@sys/arch/i386/i386/pmap.c","sys/arch/i386/i386/pmap.c","pmap_tlb_shootpage",2662,2667
6,2,37,3,6,"pmap_tlb_shootrange@2670-2676@sys/arch/i386/i386/pmap.c","sys/arch/i386/i386/pmap.c","pmap_tlb_shootrange",2670,2676
4,1,10,1,3,"pmap_tlb_shoottlb@2679-2682@sys/arch/i386/i386/pmap.c","sys/arch/i386/i386/pmap.c","pmap_tlb_shoottlb",2679,2682
5,3,34,1,4,"pmap_pte2flags@475-479@sys/arch/i386/i386/pmapae.c","sys/arch/i386/i386/pmapae.c","pmap_pte2flags",475,479
6,2,37,2,5,"pmap_sync_flags_pte_pae@482-487@sys/arch/i386/i386/pmapae.c","sys/arch/i386/i386/pmapae.c","pmap_sync_flags_pte_pae",482,487
24,8,197,1,33,"pmap_map_ptes_pae@497-530@sys/arch/i386/i386/pmapae.c","sys/arch/i386/i386/pmapae.c","pmap_map_ptes_pae",497,530
14,4,81,1,17,"pmap_unmap_ptes_pae@537-554@sys/arch/i386/i386/pmapae.c","sys/arch/i386/i386/pmapae.c","pmap_unmap_ptes_pae",537,554
12,2,66,3,14,"pmap_pte_set_pae@557-571@sys/arch/i386/i386/pmapae.c","sys/arch/i386/i386/pmapae.c","pmap_pte_set_pae",557,571
7,1,51,3,7,"pmap_pte_setbits_pae@574-581@sys/arch/i386/i386/pmapae.c","sys/arch/i386/i386/pmapae.c","pmap_pte_setbits_pae",574,581
5,1,24,1,5,"pmap_pte_bits_pae@584-589@sys/arch/i386/i386/pmapae.c","sys/arch/i386/i386/pmapae.c","pmap_pte_bits_pae",584,589
5,1,24,1,5,"pmap_pte_paddr_pae@592-597@sys/arch/i386/i386/pmapae.c","sys/arch/i386/i386/pmapae.c","pmap_pte_paddr_pae",592,597
92,13,785,1,123,"pmap_bootstrap_pae@603-726@sys/arch/i386/i386/pmapae.c","sys/arch/i386/i386/pmapae.c","pmap_bootstrap_pae",603,726
15,2,113,3,17,"pmap_alloc_ptp_pae@747-764@sys/arch/i386/i386/pmapae.c","sys/arch/i386/i386/pmapae.c","pmap_alloc_ptp_pae",747,764
16,6,111,2,22,"pmap_get_ptp_pae@774-796@sys/arch/i386/i386/pmapae.c","sys/arch/i386/i386/pmapae.c","pmap_get_ptp_pae",774,796
12,3,119,4,19,"pmap_drop_ptp_pae@799-818@sys/arch/i386/i386/pmapae.c","sys/arch/i386/i386/pmapae.c","pmap_drop_ptp_pae",799,818
38,2,440,1,53,"pmap_pinit_pd_pae@824-877@sys/arch/i386/i386/pmapae.c","sys/arch/i386/i386/pmapae.c","pmap_pinit_pd_pae",824,877
15,4,105,3,15,"pmap_extract_pae@888-903@sys/arch/i386/i386/pmapae.c","sys/arch/i386/i386/pmapae.c","pmap_extract_pae",888,903
12,4,78,1,17,"pmap_zero_phys_pae@912-929@sys/arch/i386/i386/pmapae.c","sys/arch/i386/i386/pmapae.c","pmap_zero_phys_pae",912,929
13,4,85,1,19,"pmap_zero_page_uncached_pae@936-955@sys/arch/i386/i386/pmapae.c","sys/arch/i386/i386/pmapae.c","pmap_zero_page_uncached_pae",936,955
18,5,161,2,23,"pmap_copy_page_pae@962-985@sys/arch/i386/i386/pmapae.c","sys/arch/i386/i386/pmapae.c","pmap_copy_page_pae",962,985
38,15,244,7,69,"pmap_remove_ptes_pae@1003-1072@sys/arch/i386/i386/pmapae.c","sys/arch/i386/i386/pmapae.c","pmap_remove_ptes_pae",1003,1072
61,19,398,4,103,"pmap_do_remove_pae@1081-1184@sys/arch/i386/i386/pmapae.c","sys/arch/i386/i386/pmapae.c","pmap_do_remove_pae",1081,1184
63,12,466,1,89,"pmap_page_remove_pae@1193-1282@sys/arch/i386/i386/pmapae.c","sys/arch/i386/i386/pmapae.c","pmap_page_remove_pae",1193,1282
25,5,183,2,30,"pmap_test_attrs_pae@1298-1328@sys/arch/i386/i386/pmapae.c","sys/arch/i386/i386/pmapae.c","pmap_test_attrs_pae",1298,1328
32,6,234,2,39,"pmap_clear_attrs_pae@1336-1375@sys/arch/i386/i386/pmapae.c","sys/arch/i386/i386/pmapae.c","pmap_clear_attrs_pae",1336,1375
48,15,321,4,73,"pmap_write_protect_pae@1404-1477@sys/arch/i386/i386/pmapae.c","sys/arch/i386/i386/pmapae.c","pmap_write_protect_pae",1404,1477
23,7,135,2,30,"pmap_unwire_pae@1490-1520@sys/arch/i386/i386/pmapae.c","sys/arch/i386/i386/pmapae.c","pmap_unwire_pae",1490,1520
142,49,805,5,213,"pmap_enter_pae@1540-1753@sys/arch/i386/i386/pmapae.c","sys/arch/i386/i386/pmapae.c","pmap_enter_pae",1540,1753
33,6,202,1,61,"pmap_growkernel_pae@1763-1824@sys/arch/i386/i386/pmapae.c","sys/arch/i386/i386/pmapae.c","pmap_growkernel_pae",1763,1824
9,1,62,1,13,"pmap_prealloc_lowmem_ptp_pae@1831-1844@sys/arch/i386/i386/pmapae.c","sys/arch/i386/i386/pmapae.c","pmap_prealloc_lowmem_ptp_pae",1831,1844
10,4,62,1,13,"pmap_tmpmap_pa_pae@1851-1864@sys/arch/i386/i386/pmapae.c","sys/arch/i386/i386/pmapae.c","pmap_tmpmap_pa_pae",1851,1864
10,5,61,1,18,"pmap_tmpunmap_pa_pae@1871-1889@sys/arch/i386/i386/pmapae.c","sys/arch/i386/i386/pmapae.c","pmap_tmpunmap_pa_pae",1871,1889
4,1,26,1,3,"vtophys_pae@1892-1895@sys/arch/i386/i386/pmapae.c","sys/arch/i386/i386/pmapae.c","vtophys_pae",1892,1895
14,4,93,1,19,"pmap_flush_page_pae@1898-1917@sys/arch/i386/i386/pmapae.c","sys/arch/i386/i386/pmapae.c","pmap_flush_page_pae",1898,1917
51,8,361,2,59,"pmap_convert@1920-1979@sys/arch/i386/i386/pmapae.c","sys/arch/i386/i386/pmapae.c","pmap_convert",1920,1979
42,13,300,1,55,"k7_powernow_setperf@151-206@sys/arch/i386/i386/powernow-k7.c","sys/arch/i386/i386/powernow-k7.c","k7_powernow_setperf",151,206
25,6,193,3,30,"k7pnow_decode_pst@213-243@sys/arch/i386/i386/powernow-k7.c","sys/arch/i386/i386/powernow-k7.c","k7pnow_decode_pst",213,243
38,11,272,4,47,"k7pnow_states@246-293@sys/arch/i386/i386/powernow-k7.c","sys/arch/i386/i386/powernow-k7.c","k7pnow_states",246,293
29,7,214,4,31,"k7pnow_acpi_states@298-329@sys/arch/i386/i386/powernow-k7.c","sys/arch/i386/i386/powernow-k7.c","k7pnow_acpi_states",298,329
13,1,74,2,14,"k7pnow_acpi_pss_changed@332-346@sys/arch/i386/i386/powernow-k7.c","sys/arch/i386/i386/powernow-k7.c","k7pnow_acpi_pss_changed",332,346
19,3,117,2,27,"k7pnow_acpi_init@349-376@sys/arch/i386/i386/powernow-k7.c","sys/arch/i386/i386/powernow-k7.c","k7pnow_acpi_init",349,376
54,12,347,1,69,"k7_powernow_init@381-450@sys/arch/i386/i386/powernow-k7.c","sys/arch/i386/i386/powernow-k7.c","k7_powernow_init",381,450
11,3,49,1,12,"k8pnow_read_pending_wait@158-170@sys/arch/i386/i386/powernow-k8.c","sys/arch/i386/i386/powernow-k8.c","k8pnow_read_pending_wait",158,170
10,2,59,1,12,"k8_powernow_setperf@173-185@sys/arch/i386/i386/powernow-k8.c","sys/arch/i386/i386/powernow-k8.c","k8_powernow_setperf",173,185
65,20,446,2,91,"k8pnow_transition@188-279@sys/arch/i386/i386/powernow-k8.c","sys/arch/i386/i386/powernow-k8.c","k8pnow_transition",188,279
21,4,156,2,26,"k8pnow_decode_pst@286-312@sys/arch/i386/i386/powernow-k8.c","sys/arch/i386/i386/powernow-k8.c","k8pnow_decode_pst",286,312
36,8,261,4,41,"k8pnow_states@315-356@sys/arch/i386/i386/powernow-k8.c","sys/arch/i386/i386/powernow-k8.c","k8pnow_states",315,356
27,6,214,4,30,"k8pnow_acpi_states@361-391@sys/arch/i386/i386/powernow-k8.c","sys/arch/i386/i386/powernow-k8.c","k8pnow_acpi_states",361,391
18,1,116,2,20,"k8pnow_acpi_pss_changed@394-414@sys/arch/i386/i386/powernow-k8.c","sys/arch/i386/i386/powernow-k8.c","k8pnow_acpi_pss_changed",394,414
19,2,127,2,22,"k8pnow_acpi_init@417-439@sys/arch/i386/i386/powernow-k8.c","sys/arch/i386/i386/powernow-k8.c","k8pnow_acpi_init",417,439
52,12,314,1,70,"k8_powernow_init@444-514@sys/arch/i386/i386/powernow-k8.c","sys/arch/i386/i386/powernow-k8.c","k8_powernow_init",444,514
21,4,106,1,27,"k6_powernow_init@55-82@sys/arch/i386/i386/powernow.c","sys/arch/i386/i386/powernow.c","k6_powernow_init",55,82
15,1,93,1,19,"k6_powernow_setperf@85-104@sys/arch/i386/i386/powernow.c","sys/arch/i386/i386/powernow.c","k6_powernow_setperf",85,104
4,1,18,1,4,"process_frame@87-91@sys/arch/i386/i386/process_machdep.c","sys/arch/i386/i386/process_machdep.c","process_frame",87,91
4,1,21,1,4,"process_fpframe@94-98@sys/arch/i386/i386/process_machdep.c","sys/arch/i386/i386/process_machdep.c","process_fpframe",94,98
24,4,254,2,31,"process_xmm_to_s87@101-132@sys/arch/i386/i386/process_machdep.c","sys/arch/i386/i386/process_machdep.c","process_xmm_to_s87",101,132
9,1,62,1,8,"process_fninit_xmm@135-143@sys/arch/i386/i386/process_machdep.c","sys/arch/i386/i386/process_machdep.c","process_fninit_xmm",135,143
30,3,231,2,33,"process_read_regs@146-179@sys/arch/i386/i386/process_machdep.c","sys/arch/i386/i386/process_machdep.c","process_read_regs",146,179
24,5,175,2,31,"process_read_fpregs@182-213@sys/arch/i386/i386/process_machdep.c","sys/arch/i386/i386/process_machdep.c","process_read_fpregs",182,213
24,4,254,2,31,"process_s87_to_xmm@218-249@sys/arch/i386/i386/process_machdep.c","sys/arch/i386/i386/process_machdep.c","process_s87_to_xmm",218,249
33,5,266,2,40,"process_write_regs@252-292@sys/arch/i386/i386/process_machdep.c","sys/arch/i386/i386/process_machdep.c","process_write_regs",252,292
18,5,123,2,28,"process_write_fpregs@295-323@sys/arch/i386/i386/process_machdep.c","sys/arch/i386/i386/process_machdep.c","process_write_fpregs",295,323
14,4,93,2,19,"process_read_xmmregs@326-345@sys/arch/i386/i386/process_machdep.c","sys/arch/i386/i386/process_machdep.c","process_read_xmmregs",326,345
13,4,94,2,17,"process_write_xmmregs@348-365@sys/arch/i386/i386/process_machdep.c","sys/arch/i386/i386/process_machdep.c","process_write_xmmregs",348,365
9,2,44,2,10,"process_sstep@368-378@sys/arch/i386/i386/process_machdep.c","sys/arch/i386/i386/process_machdep.c","process_sstep",368,378
6,1,36,2,7,"process_set_pc@381-388@sys/arch/i386/i386/process_machdep.c","sys/arch/i386/i386/process_machdep.c","process_set_pc",381,388
11,2,67,2,13,"rbus_pccbb_parent_mem@54-67@sys/arch/i386/i386/rbus_machdep.c","sys/arch/i386/i386/rbus_machdep.c","rbus_pccbb_parent_mem",54,67
14,3,86,2,22,"rbus_pccbb_parent_io@70-92@sys/arch/i386/i386/rbus_machdep.c","sys/arch/i386/i386/rbus_machdep.c","rbus_pccbb_parent_io",70,92
4,1,19,3,3,"pccbb_attach_hook@95-98@sys/arch/i386/i386/rbus_machdep.c","sys/arch/i386/i386/rbus_machdep.c","pccbb_attach_hook",95,98
11,2,64,1,11,"softintr_init@58-69@sys/arch/i386/i386/softintr.c","sys/arch/i386/i386/softintr.c","softintr_init",58,69
20,3,117,1,23,"softintr_dispatch@77-100@sys/arch/i386/i386/softintr.c","sys/arch/i386/i386/softintr.c","softintr_dispatch",77,100
29,6,140,3,34,"softintr_establish@108-142@sys/arch/i386/i386/softintr.c","sys/arch/i386/i386/softintr.c","softintr_establish",108,142
12,2,79,1,13,"softintr_disestablish@150-163@sys/arch/i386/i386/softintr.c","sys/arch/i386/i386/softintr.c","softintr_disestablish",150,163
19,8,120,3,25,"i386_iopl@79-104@sys/arch/i386/i386/sys_machdep.c","sys/arch/i386/i386/sys_machdep.c","i386_iopl",79,104
6,1,41,2,5,"i386_get_threadbase@107-112@sys/arch/i386/i386/sys_machdep.c","sys/arch/i386/i386/sys_machdep.c","i386_get_threadbase",107,112
11,3,86,3,21,"i386_set_threadbase@115-136@sys/arch/i386/i386/sys_machdep.c","sys/arch/i386/i386/sys_machdep.c","i386_set_threadbase",115,136
46,10,263,3,60,"sys_sysarch@139-199@sys/arch/i386/i386/sys_machdep.c","sys/arch/i386/i386/sys_machdep.c","sys_sysarch",139,199
297,81,1752,1,388,"trap@114-502@sys/arch/i386/i386/trap.c","sys/arch/i386/i386/trap.c","trap",114,502
11,1,66,1,11,"ast@511-522@sys/arch/i386/i386/trap.c","sys/arch/i386/i386/trap.c","ast",511,522
78,20,459,1,112,"syscall@531-643@sys/arch/i386/i386/trap.c","sys/arch/i386/i386/trap.c","syscall",531,643
9,1,52,1,11,"child_return@646-657@sys/arch/i386/i386/trap.c","sys/arch/i386/i386/trap.c","child_return",646,657
22,3,147,1,25,"viac3_crypto_setup@103-128@sys/arch/i386/i386/via.c","sys/arch/i386/i386/via.c","viac3_crypto_setup",103,128
133,28,884,2,152,"viac3_crypto_newsession@131-283@sys/arch/i386/i386/via.c","sys/arch/i386/i386/via.c","viac3_crypto_newsession",131,283
28,6,203,1,31,"viac3_crypto_freesession@286-317@sys/arch/i386/i386/via.c","sys/arch/i386/i386/via.c","viac3_crypto_freesession",286,317
12,1,100,6,15,"viac3_cbc@320-335@sys/arch/i386/i386/via.c","sys/arch/i386/i386/via.c","viac3_cbc",320,335
10,2,58,4,11,"viac3_crypto_swauth@338-349@sys/arch/i386/i386/via.c","sys/arch/i386/i386/via.c","viac3_crypto_swauth",338,349
78,17,652,5,86,"viac3_crypto_encdec@352-438@sys/arch/i386/i386/via.c","sys/arch/i386/i386/via.c","viac3_crypto_encdec",352,438
49,16,258,1,53,"viac3_crypto_process@441-494@sys/arch/i386/i386/via.c","sys/arch/i386/i386/via.c","viac3_crypto_process",441,494
17,4,141,1,31,"viac3_rnd@524-555@sys/arch/i386/i386/via.c","sys/arch/i386/i386/via.c","viac3_rnd",524,555
11,1,64,2,12,"is_bitset@138-150@sys/arch/i386/i386/vm86.c","sys/arch/i386/i386/vm86.c","is_bitset",138,150
29,5,236,2,66,"fast_intxx@157-223@sys/arch/i386/i386/vm86.c","sys/arch/i386/i386/vm86.c","fast_intxx",157,223
11,3,66,2,19,"vm86_return@226-245@sys/arch/i386/i386/vm86.c","sys/arch/i386/i386/vm86.c","vm86_return",226,245
75,16,426,2,104,"vm86_gpfault@264-368@sys/arch/i386/i386/vm86.c","sys/arch/i386/i386/vm86.c","vm86_gpfault",264,368
47,8,257,3,64,"i386_vm86@371-435@sys/arch/i386/i386/vm86.c","sys/arch/i386/i386/vm86.c","i386_vm86",371,435
28,7,270,6,46,"cpu_fork@72-118@sys/arch/i386/i386/vm_machdep.c","sys/arch/i386/i386/vm_machdep.c","cpu_fork",72,118
7,3,42,1,10,"cpu_exit@124-134@sys/arch/i386/i386/vm_machdep.c","sys/arch/i386/i386/vm_machdep.c","cpu_exit",124,134
7,2,42,1,7,"kvtop@140-147@sys/arch/i386/i386/vm_machdep.c","sys/arch/i386/i386/vm_machdep.c","kvtop",140,147
21,3,155,2,33,"vmapbuf@153-186@sys/arch/i386/i386/vm_machdep.c","sys/arch/i386/i386/vm_machdep.c","vmapbuf",153,186
14,2,103,2,14,"vunmapbuf@193-207@sys/arch/i386/i386/vm_machdep.c","sys/arch/i386/i386/vm_machdep.c","vunmapbuf",193,207
13,4,70,1,17,"wscnprobe@81-98@sys/arch/i386/i386/wscons_machdep.c","sys/arch/i386/i386/wscons_machdep.c","wscnprobe",81,98
9,2,34,1,10,"wscninit@101-111@sys/arch/i386/i386/wscons_machdep.c","sys/arch/i386/i386/wscons_machdep.c","wscninit",101,111
4,1,17,2,3,"wscnputc@114-117@sys/arch/i386/i386/wscons_machdep.c","sys/arch/i386/i386/wscons_machdep.c","wscnputc",114,117
4,1,15,1,3,"wscngetc@120-123@sys/arch/i386/i386/wscons_machdep.c","sys/arch/i386/i386/wscons_machdep.c","wscngetc",120,123
4,1,17,2,3,"wscnpollc@126-129@sys/arch/i386/i386/wscons_machdep.c","sys/arch/i386/i386/wscons_machdep.c","wscnpollc",126,129
7,5,37,1,10,"wscn_video_init@135-145@sys/arch/i386/i386/wscons_machdep.c","sys/arch/i386/i386/wscons_machdep.c","wscn_video_init",135,145
11,8,50,1,17,"wscn_input_init@171-188@sys/arch/i386/i386/wscons_machdep.c","sys/arch/i386/i386/wscons_machdep.c","wscn_input_init",171,188
7,1,57,3,7,"_atomic_cas_uint@54-61@sys/arch/i386/include/atomic.h","sys/arch/i386/include/atomic.h","_atomic_cas_uint",54,61
7,1,57,3,7,"_atomic_cas_ulong@65-72@sys/arch/i386/include/atomic.h","sys/arch/i386/include/atomic.h","_atomic_cas_ulong",65,72
7,1,66,3,7,"_atomic_cas_ptr@76-83@sys/arch/i386/include/atomic.h","sys/arch/i386/include/atomic.h","_atomic_cas_ptr",76,83
7,1,47,2,7,"_atomic_swap_uint@87-94@sys/arch/i386/include/atomic.h","sys/arch/i386/include/atomic.h","_atomic_swap_uint",87,94
7,1,47,2,7,"_atomic_swap_ulong@99-106@sys/arch/i386/include/atomic.h","sys/arch/i386/include/atomic.h","_atomic_swap_ulong",99,106
7,1,56,2,7,"_atomic_swap_ptr@110-117@sys/arch/i386/include/atomic.h","sys/arch/i386/include/atomic.h","_atomic_swap_ptr",110,117
5,1,23,1,4,"_atomic_inc_int@121-125@sys/arch/i386/include/atomic.h","sys/arch/i386/include/atomic.h","_atomic_inc_int",121,125
5,1,23,1,4,"_atomic_inc_long@129-133@sys/arch/i386/include/atomic.h","sys/arch/i386/include/atomic.h","_atomic_inc_long",129,133
5,1,23,1,4,"_atomic_dec_int@137-141@sys/arch/i386/include/atomic.h","sys/arch/i386/include/atomic.h","_atomic_dec_int",137,141
5,1,23,1,4,"_atomic_dec_long@145-149@sys/arch/i386/include/atomic.h","sys/arch/i386/include/atomic.h","_atomic_dec_long",145,149
6,1,32,2,5,"_atomic_add_int@153-158@sys/arch/i386/include/atomic.h","sys/arch/i386/include/atomic.h","_atomic_add_int",153,158
6,1,32,2,5,"_atomic_add_long@162-167@sys/arch/i386/include/atomic.h","sys/arch/i386/include/atomic.h","_atomic_add_long",162,167
6,1,32,2,5,"_atomic_sub_int@171-176@sys/arch/i386/include/atomic.h","sys/arch/i386/include/atomic.h","_atomic_sub_int",171,176
6,1,32,2,5,"_atomic_sub_long@180-185@sys/arch/i386/include/atomic.h","sys/arch/i386/include/atomic.h","_atomic_sub_long",180,185
7,1,45,2,8,"_atomic_add_int_nv@190-198@sys/arch/i386/include/atomic.h","sys/arch/i386/include/atomic.h","_atomic_add_int_nv",190,198
7,1,45,2,8,"_atomic_add_long_nv@202-210@sys/arch/i386/include/atomic.h","sys/arch/i386/include/atomic.h","_atomic_add_long_nv",202,210
7,1,47,2,8,"_atomic_sub_int_nv@214-222@sys/arch/i386/include/atomic.h","sys/arch/i386/include/atomic.h","_atomic_sub_int_nv",214,222
7,1,47,2,8,"_atomic_sub_long_nv@226-234@sys/arch/i386/include/atomic.h","sys/arch/i386/include/atomic.h","_atomic_sub_long_nv",226,234
6,1,54,2,5,"i386_atomic_testset_uq@274-279@sys/arch/i386/include/atomic.h","sys/arch/i386/include/atomic.h","i386_atomic_testset_uq",274,279
5,1,37,2,4,"i386_atomic_testset_ul@282-286@sys/arch/i386/include/atomic.h","sys/arch/i386/include/atomic.h","i386_atomic_testset_ul",282,286
5,1,37,2,4,"i386_atomic_testset_i@289-293@sys/arch/i386/include/atomic.h","sys/arch/i386/include/atomic.h","i386_atomic_testset_i",289,293
4,1,31,2,3,"i386_atomic_setbits_l@296-299@sys/arch/i386/include/atomic.h","sys/arch/i386/include/atomic.h","i386_atomic_setbits_l",296,299
5,1,35,2,4,"i386_atomic_clearbits_l@302-306@sys/arch/i386/include/atomic.h","sys/arch/i386/include/atomic.h","i386_atomic_clearbits_l",302,306
8,1,48,1,9,"curcpu@246-255@sys/arch/i386/include/cpu.h","sys/arch/i386/include/cpu.h","curcpu",246,255
4,1,21,1,3,"invlpg@71-74@sys/arch/i386/include/cpufunc.h","sys/arch/i386/include/cpufunc.h","invlpg",71,74
4,1,22,1,3,"lidt@77-80@sys/arch/i386/include/cpufunc.h","sys/arch/i386/include/cpufunc.h","lidt",77,80
4,1,19,1,3,"lldt@83-86@sys/arch/i386/include/cpufunc.h","sys/arch/i386/include/cpufunc.h","lldt",83,86
4,1,19,1,3,"ltr@89-92@sys/arch/i386/include/cpufunc.h","sys/arch/i386/include/cpufunc.h","ltr",89,92
4,1,19,1,3,"lcr0@95-98@sys/arch/i386/include/cpufunc.h","sys/arch/i386/include/cpufunc.h","lcr0",95,98
6,1,23,1,5,"rcr0@101-106@sys/arch/i386/include/cpufunc.h","sys/arch/i386/include/cpufunc.h","rcr0",101,106
6,1,23,1,5,"rcr2@109-114@sys/arch/i386/include/cpufunc.h","sys/arch/i386/include/cpufunc.h","rcr2",109,114
4,1,19,1,3,"lcr3@117-120@sys/arch/i386/include/cpufunc.h","sys/arch/i386/include/cpufunc.h","lcr3",117,120
6,1,23,1,5,"rcr3@123-128@sys/arch/i386/include/cpufunc.h","sys/arch/i386/include/cpufunc.h","rcr3",123,128
4,1,19,1,3,"lcr4@131-134@sys/arch/i386/include/cpufunc.h","sys/arch/i386/include/cpufunc.h","lcr4",131,134
6,1,23,1,5,"rcr4@137-142@sys/arch/i386/include/cpufunc.h","sys/arch/i386/include/cpufunc.h","rcr4",137,142
6,1,32,1,5,"tlbflush@145-150@sys/arch/i386/include/cpufunc.h","sys/arch/i386/include/cpufunc.h","tlbflush",145,150
4,1,12,1,3,"disable_intr@160-163@sys/arch/i386/include/cpufunc.h","sys/arch/i386/include/cpufunc.h","disable_intr",160,163
4,1,12,1,3,"enable_intr@166-169@sys/arch/i386/include/cpufunc.h","sys/arch/i386/include/cpufunc.h","enable_intr",166,169
6,1,25,1,6,"read_eflags@172-178@sys/arch/i386/include/cpufunc.h","sys/arch/i386/include/cpufunc.h","read_eflags",172,178
4,1,19,1,3,"write_eflags@181-184@sys/arch/i386/include/cpufunc.h","sys/arch/i386/include/cpufunc.h","write_eflags",181,184
7,1,24,1,7,"intr_disable@187-194@sys/arch/i386/include/cpufunc.h","sys/arch/i386/include/cpufunc.h","intr_disable",187,194
4,1,12,1,3,"intr_restore@197-200@sys/arch/i386/include/cpufunc.h","sys/arch/i386/include/cpufunc.h","intr_restore",197,200
4,1,12,1,3,"wbinvd@203-206@sys/arch/i386/include/cpufunc.h","sys/arch/i386/include/cpufunc.h","wbinvd",203,206
4,1,24,1,3,"clflush@209-212@sys/arch/i386/include/cpufunc.h","sys/arch/i386/include/cpufunc.h","clflush",209,212
4,1,16,1,3,"mfence@215-218@sys/arch/i386/include/cpufunc.h","sys/arch/i386/include/cpufunc.h","mfence",215,218
6,1,25,1,6,"rdtsc@221-227@sys/arch/i386/include/cpufunc.h","sys/arch/i386/include/cpufunc.h","rdtsc",221,227
4,1,27,2,3,"wrmsr@230-233@sys/arch/i386/include/cpufunc.h","sys/arch/i386/include/cpufunc.h","wrmsr",230,233
6,1,31,1,6,"rdmsr@236-242@sys/arch/i386/include/cpufunc.h","sys/arch/i386/include/cpufunc.h","rdmsr",236,242
5,1,38,3,4,"monitor@245-249@sys/arch/i386/include/cpufunc.h","sys/arch/i386/include/cpufunc.h","monitor",245,249
4,1,27,2,3,"mwait@252-255@sys/arch/i386/include/cpufunc.h","sys/arch/i386/include/cpufunc.h","mwait",252,255
8,1,39,2,7,"rdmsr_locked@266-273@sys/arch/i386/include/cpufunc.h","sys/arch/i386/include/cpufunc.h","rdmsr_locked",266,273
6,1,35,3,5,"wrmsr_locked@276-281@sys/arch/i386/include/cpufunc.h","sys/arch/i386/include/cpufunc.h","wrmsr_locked",276,281
4,1,12,1,3,"breakpoint@285-288@sys/arch/i386/include/cpufunc.h","sys/arch/i386/include/cpufunc.h","breakpoint",285,288
5,1,29,1,4,"i82489_readreg@44-48@sys/arch/i386/include/i82489var.h","sys/arch/i386/include/i82489var.h","i82489_readreg",44,48
7,1,56,2,12,"i82489_writereg@51-63@sys/arch/i386/include/i82489var.h","sys/arch/i386/include/i82489var.h","i82489_writereg",51,63
6,1,29,1,5,"__inbc@61-66@sys/arch/i386/include/pio.h","sys/arch/i386/include/pio.h","__inbc",61,66
6,1,29,1,5,"__inb@69-74@sys/arch/i386/include/pio.h","sys/arch/i386/include/pio.h","__inb",69,74
5,1,39,3,4,"insb@77-81@sys/arch/i386/include/pio.h","sys/arch/i386/include/pio.h","insb",77,81
6,1,29,1,5,"__inwc@87-92@sys/arch/i386/include/pio.h","sys/arch/i386/include/pio.h","__inwc",87,92
6,1,29,1,5,"__inw@95-100@sys/arch/i386/include/pio.h","sys/arch/i386/include/pio.h","__inw",95,100
5,1,39,3,4,"insw@103-107@sys/arch/i386/include/pio.h","sys/arch/i386/include/pio.h","insw",103,107
6,1,29,1,5,"__inlc@113-118@sys/arch/i386/include/pio.h","sys/arch/i386/include/pio.h","__inlc",113,118
6,1,29,1,5,"__inl@121-126@sys/arch/i386/include/pio.h","sys/arch/i386/include/pio.h","__inl",121,126
5,1,39,3,4,"insl@129-133@sys/arch/i386/include/pio.h","sys/arch/i386/include/pio.h","insl",129,133
4,1,27,2,3,"__outbc@139-142@sys/arch/i386/include/pio.h","sys/arch/i386/include/pio.h","__outbc",139,142
4,1,27,2,3,"__outb@145-148@sys/arch/i386/include/pio.h","sys/arch/i386/include/pio.h","__outb",145,148
5,1,38,3,4,"outsb@151-155@sys/arch/i386/include/pio.h","sys/arch/i386/include/pio.h","outsb",151,155
4,1,27,2,3,"__outwc@161-164@sys/arch/i386/include/pio.h","sys/arch/i386/include/pio.h","__outwc",161,164
4,1,27,2,3,"__outw@167-170@sys/arch/i386/include/pio.h","sys/arch/i386/include/pio.h","__outw",167,170
5,1,38,3,4,"outsw@173-177@sys/arch/i386/include/pio.h","sys/arch/i386/include/pio.h","outsw",173,177
4,1,27,2,3,"__outlc@183-186@sys/arch/i386/include/pio.h","sys/arch/i386/include/pio.h","__outlc",183,186
4,1,27,2,3,"__outl@189-192@sys/arch/i386/include/pio.h","sys/arch/i386/include/pio.h","__outl",189,192
5,1,38,3,4,"outsl@195-199@sys/arch/i386/include/pio.h","sys/arch/i386/include/pio.h","outsl",195,199
10,3,54,2,9,"pmap_page_protect@390-399@sys/arch/i386/include/pmap.h","sys/arch/i386/include/pmap.h","pmap_page_protect",390,399
10,3,65,4,9,"pmap_protect@410-419@sys/arch/i386/include/pmap.h","sys/arch/i386/include/pmap.h","pmap_protect",410,419
4,1,16,1,3,"pmap_growkernel@427-430@sys/arch/i386/include/pmap.h","sys/arch/i386/include/pmap.h","pmap_growkernel",427,430
4,1,38,5,3,"pmap_enter@433-436@sys/arch/i386/include/pmap.h","sys/arch/i386/include/pmap.h","pmap_enter",433,436
4,1,29,3,3,"pmap_extract@439-442@sys/arch/i386/include/pmap.h","sys/arch/i386/include/pmap.h","pmap_extract",439,442
4,2,29,2,3,"pmap_is_active@453-456@sys/arch/i386/include/pmap.h","sys/arch/i386/include/pmap.h","pmap_is_active",453,456
4,1,21,1,3,"pmap_is_curpmap@459-462@sys/arch/i386/include/pmap.h","sys/arch/i386/include/pmap.h","pmap_is_curpmap",459,462
6,1,29,1,5,"__i386_read_tcb@38-43@sys/arch/i386/include/tcb.h","sys/arch/i386/include/tcb.h","__i386_read_tcb",38,43
7,1,35,1,10,"clr_vif@88-98@sys/arch/i386/include/vm86.h","sys/arch/i386/include/vm86.h","clr_vif",88,98
9,3,80,1,12,"set_vif@101-113@sys/arch/i386/include/vm86.h","sys/arch/i386/include/vm86.h","set_vif",101,113
11,3,110,2,14,"set_vflags@116-130@sys/arch/i386/include/vm86.h","sys/arch/i386/include/vm86.h","set_vflags",116,130
9,1,64,1,9,"get_vflags@133-142@sys/arch/i386/include/vm86.h","sys/arch/i386/include/vm86.h","get_vflags",133,142
10,2,94,2,12,"set_vflags_short@145-157@sys/arch/i386/include/vm86.h","sys/arch/i386/include/vm86.h","set_vflags_short",145,157
9,1,68,1,9,"get_vflags_short@160-169@sys/arch/i386/include/vm86.h","sys/arch/i386/include/vm86.h","get_vflags_short",160,169
22,7,103,2,26,"ahc_isa_irq@148-174@sys/arch/i386/isa/ahc_isa.c","sys/arch/i386/isa/ahc_isa.c","ahc_isa_irq",148,174
35,6,257,3,47,"ahc_isa_idstring@177-224@sys/arch/i386/isa/ahc_isa.c","sys/arch/i386/isa/ahc_isa.c","ahc_isa_idstring",177,224
33,9,191,2,51,"ahc_isa_match@227-278@sys/arch/i386/isa/ahc_isa.c","sys/arch/i386/isa/ahc_isa.c","ahc_isa_match",227,278
30,7,195,3,45,"ahc_isa_probe@286-331@sys/arch/i386/isa/ahc_isa.c","sys/arch/i386/isa/ahc_isa.c","ahc_isa_probe",286,331
85,14,555,3,146,"ahc_isa_attach@334-480@sys/arch/i386/isa/ahc_isa.c","sys/arch/i386/isa/ahc_isa.c","ahc_isa_attach",334,480
75,18,505,1,90,"aha2840_load_seeprom@486-576@sys/arch/i386/isa/ahc_isa.c","sys/arch/i386/isa/ahc_isa.c","aha2840_load_seeprom",486,576
12,1,59,2,12,"mc146818_read@142-154@sys/arch/i386/isa/clock.c","sys/arch/i386/isa/clock.c","mc146818_read",142,154
10,1,54,3,10,"mc146818_write@157-167@sys/arch/i386/isa/clock.c","sys/arch/i386/isa/clock.c","mc146818_write",157,167
11,2,60,1,13,"startclocks@170-183@sys/arch/i386/isa/clock.c","sys/arch/i386/isa/clock.c","startclocks",170,183
8,3,43,1,13,"rtcdrain@186-199@sys/arch/i386/isa/clock.c","sys/arch/i386/isa/clock.c","rtcdrain",186,199
14,3,56,1,15,"clockintr@202-217@sys/arch/i386/isa/clock.c","sys/arch/i386/isa/clock.c","clockintr",202,217
16,3,73,1,22,"rtcintr@220-242@sys/arch/i386/isa/clock.c","sys/arch/i386/isa/clock.c","rtcintr",220,242
48,12,310,1,70,"gettick@245-315@sys/arch/i386/isa/clock.c","sys/arch/i386/isa/clock.c","gettick",245,315
30,5,166,1,49,"i8254_delay@325-374@sys/arch/i386/isa/clock.c","sys/arch/i386/isa/clock.c","i8254_delay",325,374
28,6,201,1,37,"calibrate_cyclecounter_ctr@377-414@sys/arch/i386/isa/clock.c","sys/arch/i386/isa/clock.c","calibrate_cyclecounter_ctr",377,414
10,2,64,1,12,"calibrate_cyclecounter@417-429@sys/arch/i386/isa/clock.c","sys/arch/i386/isa/clock.c","calibrate_cyclecounter",417,429
9,1,54,1,11,"i8254_initclocks@432-443@sys/arch/i386/isa/clock.c","sys/arch/i386/isa/clock.c","i8254_initclocks",432,443
8,1,56,1,18,"rtcstart@446-464@sys/arch/i386/isa/clock.c","sys/arch/i386/isa/clock.c","rtcstart",446,464
4,1,15,1,3,"rtcstop@467-470@sys/arch/i386/isa/clock.c","sys/arch/i386/isa/clock.c","rtcstop",467,470
7,2,41,1,6,"rtcget@473-479@sys/arch/i386/isa/clock.c","sys/arch/i386/isa/clock.c","rtcget",473,479
4,1,15,1,3,"rtcput@482-485@sys/arch/i386/isa/clock.c","sys/arch/i386/isa/clock.c","rtcput",482,485
4,1,29,1,4,"hexdectodec@488-492@sys/arch/i386/isa/clock.c","sys/arch/i386/isa/clock.c","hexdectodec",488,492
4,1,38,1,4,"dectohexdec@495-499@sys/arch/i386/isa/clock.c","sys/arch/i386/isa/clock.c","dectohexdec",495,499
9,2,61,1,10,"cmoscheck@509-519@sys/arch/i386/isa/clock.c","sys/arch/i386/isa/clock.c","cmoscheck",509,519
35,13,195,1,44,"clock_expandyear@536-580@sys/arch/i386/isa/clock.c","sys/arch/i386/isa/clock.c","clock_expandyear",536,580
43,6,273,1,60,"inittodr@587-647@sys/arch/i386/isa/clock.c","sys/arch/i386/isa/clock.c","inittodr",587,647
32,5,215,1,39,"resettodr@653-692@sys/arch/i386/isa/clock.c","sys/arch/i386/isa/clock.c","resettodr",653,692
11,3,44,1,10,"setstatclockrate@695-705@sys/arch/i386/isa/clock.c","sys/arch/i386/isa/clock.c","setstatclockrate",695,705
4,1,12,1,3,"i8254_inittimecounter@708-711@sys/arch/i386/isa/clock.c","sys/arch/i386/isa/clock.c","i8254_inittimecounter",708,711
11,1,50,1,12,"i8254_inittimecounter_simple@718-730@sys/arch/i386/isa/clock.c","sys/arch/i386/isa/clock.c","i8254_inittimecounter_simple",718,730
7,1,47,1,7,"i8254_startclock@733-740@sys/arch/i386/isa/clock.c","sys/arch/i386/isa/clock.c","i8254_startclock",733,740
4,1,18,1,3,"i8254_simple_get_timecount@743-746@sys/arch/i386/isa/clock.c","sys/arch/i386/isa/clock.c","i8254_simple_get_timecount",743,746
20,2,108,1,24,"i8254_get_timecount@749-773@sys/arch/i386/isa/clock.c","sys/arch/i386/isa/clock.c","i8254_get_timecount",749,773
24,5,203,1,36,"isa_defaultirq@164-200@sys/arch/i386/isa/isa_machdep.c","sys/arch/i386/isa/isa_machdep.c","isa_defaultirq",164,200
5,1,18,1,5,"isa_nmi@207-212@sys/arch/i386/isa/isa_machdep.c","sys/arch/i386/isa/isa_machdep.c","isa_nmi",207,212
6,3,37,1,11,"isa_strayintr@220-231@sys/arch/i386/isa/isa_machdep.c","sys/arch/i386/isa/isa_machdep.c","isa_strayintr",220,231
64,20,478,1,87,"intr_calculatemasks@247-334@sys/arch/i386/isa/isa_machdep.c","sys/arch/i386/isa/isa_machdep.c","intr_calculatemasks",247,334
5,1,13,1,4,"fakeintr@337-341@sys/arch/i386/isa/isa_machdep.c","sys/arch/i386/isa/isa_machdep.c","fakeintr",337,341
39,14,230,4,67,"isa_intr_alloc@346-413@sys/arch/i386/isa/isa_machdep.c","sys/arch/i386/isa/isa_machdep.c","isa_intr_alloc",346,413
20,9,95,3,20,"isa_intr_check@422-442@sys/arch/i386/isa/isa_machdep.c","sys/arch/i386/isa/isa_machdep.c","isa_intr_check",422,442
78,24,491,7,113,"isa_intr_establish@449-562@sys/arch/i386/isa/isa_machdep.c","sys/arch/i386/isa/isa_machdep.c","isa_intr_establish",449,562
23,8,150,2,33,"isa_intr_disestablish@568-601@sys/arch/i386/isa/isa_machdep.c","sys/arch/i386/isa/isa_machdep.c","isa_intr_disestablish",568,601
8,2,36,3,12,"isa_attach_hook@604-616@sys/arch/i386/isa/isa_machdep.c","sys/arch/i386/isa/isa_machdep.c","isa_attach_hook",604,616
42,10,272,7,79,"_isa_bus_dmamap_create@643-722@sys/arch/i386/isa/isa_machdep.c","sys/arch/i386/isa/isa_machdep.c","_isa_bus_dmamap_create",643,722
8,2,50,2,12,"_isa_bus_dmamap_destroy@728-740@sys/arch/i386/isa/isa_machdep.c","sys/arch/i386/isa/isa_machdep.c","_isa_bus_dmamap_destroy",728,740
32,7,219,6,61,"_isa_bus_dmamap_load@746-807@sys/arch/i386/isa/isa_machdep.c","sys/arch/i386/isa/isa_machdep.c","_isa_bus_dmamap_load",746,807
5,1,23,4,5,"_isa_bus_dmamap_load_mbuf@813-818@sys/arch/i386/isa/isa_machdep.c","sys/arch/i386/isa/isa_machdep.c","_isa_bus_dmamap_load_mbuf",813,818
5,1,23,4,5,"_isa_bus_dmamap_load_uio@824-829@sys/arch/i386/isa/isa_machdep.c","sys/arch/i386/isa/isa_machdep.c","_isa_bus_dmamap_load_uio",824,829
5,1,28,6,5,"_isa_bus_dmamap_load_raw@836-841@sys/arch/i386/isa/isa_machdep.c","sys/arch/i386/isa/isa_machdep.c","_isa_bus_dmamap_load_raw",836,841
9,3,59,2,18,"_isa_bus_dmamap_unload@847-865@sys/arch/i386/isa/isa_machdep.c","sys/arch/i386/isa/isa_machdep.c","_isa_bus_dmamap_unload",847,865
25,13,196,5,41,"_isa_bus_dmamap_sync@871-912@sys/arch/i386/isa/isa_machdep.c","sys/arch/i386/isa/isa_machdep.c","_isa_bus_dmamap_sync",871,912
13,2,105,8,16,"_isa_bus_dmamem_alloc@918-934@sys/arch/i386/isa/isa_machdep.c","sys/arch/i386/isa/isa_machdep.c","_isa_bus_dmamem_alloc",918,934
35,9,195,5,54,"_isa_dma_check_buffer@946-1000@sys/arch/i386/isa/isa_machdep.c","sys/arch/i386/isa/isa_machdep.c","_isa_dma_check_buffer",946,1000
26,3,164,4,28,"_isa_dma_alloc_bouncebuf@1003-1031@sys/arch/i386/isa/isa_machdep.c","sys/arch/i386/isa/isa_machdep.c","_isa_dma_alloc_bouncebuf",1003,1031
12,1,68,2,13,"_isa_dma_free_bouncebuf@1034-1047@sys/arch/i386/isa/isa_machdep.c","sys/arch/i386/isa/isa_machdep.c","_isa_dma_free_bouncebuf",1034,1047
8,3,39,1,11,"isapnp_map@92-103@sys/arch/i386/isa/isapnp_machdep.c","sys/arch/i386/isa/isapnp_machdep.c","isapnp_map",92,103
3,1,9,1,4,"isapnp_unmap@109-113@sys/arch/i386/isa/isapnp_machdep.c","sys/arch/i386/isa/isapnp_machdep.c","isapnp_unmap",109,113
11,6,72,1,25,"isapnp_map_readport@122-147@sys/arch/i386/isa/isapnp_machdep.c","sys/arch/i386/isa/isapnp_machdep.c","isapnp_map_readport",122,147
3,1,9,1,4,"isapnp_unmap_readport@153-157@sys/arch/i386/isa/isapnp_machdep.c","sys/arch/i386/isa/isapnp_machdep.c","isapnp_unmap_readport",153,157
16,4,112,4,19,"joyopen@59-78@sys/arch/i386/isa/joy.c","sys/arch/i386/isa/joy.c","joyopen",59,78
8,1,58,4,8,"joyclose@81-89@sys/arch/i386/isa/joy.c","sys/arch/i386/isa/joy.c","joyclose",81,89
35,12,289,3,35,"joyread@92-127@sys/arch/i386/isa/joy.c","sys/arch/i386/isa/joy.c","joyread",92,127
33,9,197,5,33,"joyioctl@130-163@sys/arch/i386/isa/joy.c","sys/arch/i386/isa/joy.c","joyioctl",130,163
8,1,48,1,9,"joy_get_tick@166-175@sys/arch/i386/isa/joy.c","sys/arch/i386/isa/joy.c","joy_get_tick",166,175
11,2,70,3,14,"joy_isa_probe@60-74@sys/arch/i386/isa/joy_isa.c","sys/arch/i386/isa/joy_isa.c","joy_isa_probe",60,74
13,3,102,3,16,"joy_isa_attach@77-93@sys/arch/i386/isa/joy_isa.c","sys/arch/i386/isa/joy_isa.c","joy_isa_attach",77,93
4,1,22,3,3,"joy_isapnp_probe@60-63@sys/arch/i386/isa/joy_isapnp.c","sys/arch/i386/isa/joy_isapnp.c","joy_isapnp_probe",60,63
13,3,107,3,16,"joy_isapnp_attach@66-82@sys/arch/i386/isa/joy_isapnp.c","sys/arch/i386/isa/joy_isapnp.c","joy_isapnp_attach",66,82
29,5,194,3,39,"lmsprobe@79-118@sys/arch/i386/isa/lms.c","sys/arch/i386/isa/lms.c","lmsprobe",79,118
21,2,162,3,33,"lmsattach@121-154@sys/arch/i386/isa/lms.c","sys/arch/i386/isa/lms.c","lmsattach",121,154
10,2,54,1,14,"lms_enable@157-171@sys/arch/i386/isa/lms.c","sys/arch/i386/isa/lms.c","lms_enable",157,171
6,1,36,1,8,"lms_disable@174-182@sys/arch/i386/isa/lms.c","sys/arch/i386/isa/lms.c","lms_disable",174,182
10,3,58,5,12,"lms_ioctl@185-197@sys/arch/i386/isa/lms.c","sys/arch/i386/isa/lms.c","lms_ioctl",185,197
33,10,304,1,41,"lmsintr@200-241@sys/arch/i386/isa/lms.c","sys/arch/i386/isa/lms.c","lmsintr",200,241
21,4,130,3,31,"mmsprobe@76-107@sys/arch/i386/isa/mms.c","sys/arch/i386/isa/mms.c","mmsprobe",76,107
21,2,162,3,33,"mmsattach@110-143@sys/arch/i386/isa/mms.c","sys/arch/i386/isa/mms.c","mmsattach",110,143
10,2,63,1,14,"mms_enable@146-160@sys/arch/i386/isa/mms.c","sys/arch/i386/isa/mms.c","mms_enable",146,160
6,1,36,1,8,"mms_disable@163-171@sys/arch/i386/isa/mms.c","sys/arch/i386/isa/mms.c","mms_disable",163,171
10,3,58,5,12,"mms_ioctl@174-186@sys/arch/i386/isa/mms.c","sys/arch/i386/isa/mms.c","mms_ioctl",174,186
34,11,280,1,46,"mmsintr@189-235@sys/arch/i386/isa/mms.c","sys/arch/i386/isa/mms.c","mmsintr",189,235
8,2,36,1,9,"fpu_save@147-156@sys/arch/i386/isa/npx.c","sys/arch/i386/isa/npx.c","fpu_save",147,156
4,1,14,1,3,"npxdna_notset@159-162@sys/arch/i386/isa/npx.c","sys/arch/i386/isa/npx.c","npxdna_notset",159,162
35,5,168,1,66,"npxprobe1@197-263@sys/arch/i386/isa/npx.c","sys/arch/i386/isa/npx.c","npxprobe1",197,263
42,2,271,3,61,"npxprobe@272-333@sys/arch/i386/isa/npx.c","sys/arch/i386/isa/npx.c","npxprobe",272,333
20,5,126,1,20,"npxinit@350-370@sys/arch/i386/isa/npx.c","sys/arch/i386/isa/npx.c","npxinit",350,370
32,7,156,3,34,"npxattach@376-410@sys/arch/i386/isa/npx.c","sys/arch/i386/isa/npx.c","npxattach",376,410
48,11,344,1,124,"npxintr@428-552@sys/arch/i386/isa/npx.c","sys/arch/i386/isa/npx.c","npxintr",428,552
22,3,155,1,29,"npxtrap@555-584@sys/arch/i386/isa/npx.c","sys/arch/i386/isa/npx.c","npxtrap",555,584
18,3,80,1,19,"x86fpflags_to_siginfo@587-606@sys/arch/i386/isa/npx.c","sys/arch/i386/isa/npx.c","x86fpflags_to_siginfo",587,606
53,7,389,1,80,"npxdna_xmm@616-696@sys/arch/i386/isa/npx.c","sys/arch/i386/isa/npx.c","npxdna_xmm",616,696
51,7,372,1,83,"npxdna_s87@699-782@sys/arch/i386/isa/npx.c","sys/arch/i386/isa/npx.c","npxdna_s87",699,782
26,6,159,2,51,"npxsave_cpu@793-844@sys/arch/i386/isa/npx.c","sys/arch/i386/isa/npx.c","npxsave_cpu",793,844
26,8,186,2,33,"npxsave_proc@850-883@sys/arch/i386/isa/npx.c","sys/arch/i386/isa/npx.c","npxsave_proc",850,883
25,5,114,1,38,"fpu_kernel_enter@886-924@sys/arch/i386/isa/npx.c","sys/arch/i386/isa/npx.c","fpu_kernel_enter",886,924
4,1,10,1,4,"fpu_kernel_exit@927-931@sys/arch/i386/isa/npx.c","sys/arch/i386/isa/npx.c","fpu_kernel_exit",927,931
4,1,10,1,3,"agp_flush_cache@61-64@sys/arch/i386/pci/agp_machdep.c","sys/arch/i386/pci/agp_machdep.c","agp_flush_cache",61,64
4,1,17,2,3,"agp_flush_cache_range@67-70@sys/arch/i386/pci/agp_machdep.c","sys/arch/i386/pci/agp_machdep.c","agp_flush_cache_range",67,70
25,4,171,5,34,"agp_init_map@83-117@sys/arch/i386/pci/agp_machdep.c","sys/arch/i386/pci/agp_machdep.c","agp_init_map",83,117
8,2,67,1,7,"agp_destroy_map@120-127@sys/arch/i386/pci/agp_machdep.c","sys/arch/i386/pci/agp_machdep.c","agp_destroy_map",120,127
6,1,43,4,5,"agp_map_subregion@131-136@sys/arch/i386/pci/agp_machdep.c","sys/arch/i386/pci/agp_machdep.c","agp_map_subregion",131,136
5,1,31,3,4,"agp_unmap_subregion@139-143@sys/arch/i386/pci/agp_machdep.c","sys/arch/i386/pci/agp_machdep.c","agp_unmap_subregion",139,143
15,3,111,3,18,"agp_map_atomic@146-164@sys/arch/i386/pci/agp_machdep.c","sys/arch/i386/pci/agp_machdep.c","agp_map_atomic",146,164
6,1,40,2,6,"agp_unmap_atomic@167-173@sys/arch/i386/pci/agp_machdep.c","sys/arch/i386/pci/agp_machdep.c","agp_unmap_atomic",167,173
9,2,56,5,11,"ali1543_init@156-167@sys/arch/i386/pci/ali1543.c","sys/arch/i386/pci/ali1543.c","ali1543_init",156,167
8,2,42,3,9,"ali1543_getclink@170-179@sys/arch/i386/pci/ali1543.c","sys/arch/i386/pci/ali1543.c","ali1543_getclink",170,179
14,4,90,3,18,"ali1543_get_intr@182-200@sys/arch/i386/pci/ali1543.c","sys/arch/i386/pci/ali1543.c","ali1543_get_intr",182,200
17,5,145,3,19,"ali1543_set_intr@203-222@sys/arch/i386/pci/ali1543.c","sys/arch/i386/pci/ali1543.c","ali1543_set_intr",203,222
15,3,89,5,21,"amd756_init@104-125@sys/arch/i386/pci/amd756.c","sys/arch/i386/pci/amd756.c","amd756_init",104,125
7,2,42,3,7,"amd756_getclink@128-135@sys/arch/i386/pci/amd756.c","sys/arch/i386/pci/amd756.c","amd756_getclink",128,135
13,3,81,3,15,"amd756_get_intr@138-153@sys/arch/i386/pci/amd756.c","sys/arch/i386/pci/amd756.c","amd756_get_intr",138,153
14,3,98,3,16,"amd756_set_intr@156-172@sys/arch/i386/pci/amd756.c","sys/arch/i386/pci/amd756.c","amd756_set_intr",156,172
20,5,110,3,22,"amd756_get_trigger@175-197@sys/arch/i386/pci/amd756.c","sys/arch/i386/pci/amd756.c","amd756_get_trigger",175,197
21,5,127,3,23,"amd756_set_trigger@200-223@sys/arch/i386/pci/amd756.c","sys/arch/i386/pci/amd756.c","amd756_set_trigger",200,223
8,1,42,1,10,"amd756_pir_dump@227-237@sys/arch/i386/pci/amd756.c","sys/arch/i386/pci/amd756.c","amd756_pir_dump",227,237
8,3,54,3,9,"elansc_match@99-108@sys/arch/i386/pci/elan520.c","sys/arch/i386/pci/elan520.c","elansc_match",99,108
85,8,704,3,114,"elansc_attach@120-234@sys/arch/i386/pci/elan520.c","sys/arch/i386/pci/elan520.c","elansc_attach",120,234
9,2,33,2,9,"elansc_activate@237-246@sys/arch/i386/pci/elan520.c","sys/arch/i386/pci/elan520.c","elansc_activate",237,246
11,2,92,1,12,"elansc_tc_read@249-261@sys/arch/i386/pci/elan520.c","sys/arch/i386/pci/elan520.c","elansc_tc_read",249,261
24,2,163,3,34,"elansc_wdogctl@264-298@sys/arch/i386/pci/elan520.c","sys/arch/i386/pci/elan520.c","elansc_wdogctl",264,298
19,4,117,2,19,"elansc_wdogctl_cb@313-332@sys/arch/i386/pci/elan520.c","sys/arch/i386/pci/elan520.c","elansc_wdogctl_cb",313,332
8,1,50,1,8,"elansc_update_cpuspeed@335-343@sys/arch/i386/pci/elan520.c","sys/arch/i386/pci/elan520.c","elansc_update_cpuspeed",335,343
18,4,110,1,21,"elansc_setperf@346-367@sys/arch/i386/pci/elan520.c","sys/arch/i386/pci/elan520.c","elansc_setperf",346,367
5,1,18,1,4,"elansc_cpuspeed@370-374@sys/arch/i386/pci/elan520.c","sys/arch/i386/pci/elan520.c","elansc_cpuspeed",370,374
10,2,71,2,11,"elansc_gpio_pin_read@377-388@sys/arch/i386/pci/elan520.c","sys/arch/i386/pci/elan520.c","elansc_gpio_pin_read",377,388
14,4,108,3,15,"elansc_gpio_pin_write@391-406@sys/arch/i386/pci/elan520.c","sys/arch/i386/pci/elan520.c","elansc_gpio_pin_write",391,406
14,4,107,3,15,"elansc_gpio_pin_ctl@409-424@sys/arch/i386/pci/elan520.c","sys/arch/i386/pci/elan520.c","elansc_gpio_pin_ctl",409,424
9,4,65,3,9,"geodesc_match@72-81@sys/arch/i386/pci/geodesc.c","sys/arch/i386/pci/geodesc.c","geodesc_match",72,81
38,4,336,3,48,"geodesc_attach@86-134@sys/arch/i386/pci/geodesc.c","sys/arch/i386/pci/geodesc.c","geodesc_attach",86,134
9,2,33,2,11,"geodesc_activate@137-148@sys/arch/i386/pci/geodesc.c","sys/arch/i386/pci/geodesc.c","geodesc_activate",137,148
8,2,50,2,8,"geodesc_wdogctl_cb@152-160@sys/arch/i386/pci/geodesc.c","sys/arch/i386/pci/geodesc.c","geodesc_wdogctl_cb",152,160
5,1,34,1,5,"geodesc_get_timecount@164-169@sys/arch/i386/pci/geodesc.c","sys/arch/i386/pci/geodesc.c","geodesc_get_timecount",164,169
5,1,20,1,19,"sc1100_sysreset@172-191@sys/arch/i386/pci/geodesc.c","sys/arch/i386/pci/geodesc.c","sc1100_sysreset",172,191
8,3,54,3,9,"glxsb_match@213-222@sys/arch/i386/pci/glxsb.c","sys/arch/i386/pci/glxsb.c","glxsb_match",213,222
36,7,240,3,62,"glxsb_attach@225-287@sys/arch/i386/pci/glxsb.c","sys/arch/i386/pci/glxsb.c","glxsb_attach",225,287
15,4,68,2,16,"glxsb_activate@290-306@sys/arch/i386/pci/glxsb.c","sys/arch/i386/pci/glxsb.c","glxsb_activate",290,306
11,2,73,1,12,"glxsb_rnd@309-321@sys/arch/i386/pci/glxsb.c","sys/arch/i386/pci/glxsb.c","glxsb_rnd",309,321
22,3,145,1,29,"glxsb_crypto_setup@325-354@sys/arch/i386/pci/glxsb.c","sys/arch/i386/pci/glxsb.c","glxsb_crypto_setup",325,354
130,28,860,2,149,"glxsb_crypto_newsession@357-506@sys/arch/i386/pci/glxsb.c","sys/arch/i386/pci/glxsb.c","glxsb_crypto_newsession",357,506
36,8,257,1,38,"glxsb_crypto_freesession@509-547@sys/arch/i386/pci/glxsb.c","sys/arch/i386/pci/glxsb.c","glxsb_crypto_freesession",509,547
28,5,227,7,64,"glxsb_aes@553-617@sys/arch/i386/pci/glxsb.c","sys/arch/i386/pci/glxsb.c","glxsb_aes",553,617
10,2,58,4,11,"glxsb_crypto_swauth@620-631@sys/arch/i386/pci/glxsb.c","sys/arch/i386/pci/glxsb.c","glxsb_crypto_swauth",620,631
10,2,56,4,11,"glxsb_crypto_swenc@634-645@sys/arch/i386/pci/glxsb.c","sys/arch/i386/pci/glxsb.c","glxsb_crypto_swenc",634,645
99,22,726,5,123,"glxsb_crypto_encdec@648-771@sys/arch/i386/pci/glxsb.c","sys/arch/i386/pci/glxsb.c","glxsb_crypto_encdec",648,771
59,18,314,1,65,"glxsb_crypto_process@774-839@sys/arch/i386/pci/glxsb.c","sys/arch/i386/pci/glxsb.c","glxsb_crypto_process",774,839
44,5,310,3,55,"glxsb_dma_alloc@842-897@sys/arch/i386/pci/glxsb.c","sys/arch/i386/pci/glxsb.c","glxsb_dma_alloc",842,897
5,1,35,2,4,"glxsb_dma_pre_op@900-904@sys/arch/i386/pci/glxsb.c","sys/arch/i386/pci/glxsb.c","glxsb_dma_pre_op",900,904
5,1,35,2,4,"glxsb_dma_post_op@907-911@sys/arch/i386/pci/glxsb.c","sys/arch/i386/pci/glxsb.c","glxsb_dma_post_op",907,911
7,1,67,2,6,"glxsb_dma_free@914-920@sys/arch/i386/pci/glxsb.c","sys/arch/i386/pci/glxsb.c","glxsb_dma_free",914,920
11,5,79,3,13,"gscpcib_match@71-84@sys/arch/i386/pci/gscpcib.c","sys/arch/i386/pci/gscpcib.c","gscpcib_match",71,84
39,6,275,3,56,"gscpcib_attach@87-143@sys/arch/i386/pci/gscpcib.c","sys/arch/i386/pci/gscpcib.c","gscpcib_attach",87,143
4,1,27,2,3,"gscpcib_gpio_pin_select@147-150@sys/arch/i386/pci/gscpcib.c","sys/arch/i386/pci/gscpcib.c","gscpcib_gpio_pin_select",147,150
10,2,71,2,11,"gscpcib_gpio_pin_read@153-164@sys/arch/i386/pci/gscpcib.c","sys/arch/i386/pci/gscpcib.c","gscpcib_gpio_pin_read",153,164
14,4,108,3,15,"gscpcib_gpio_pin_write@167-182@sys/arch/i386/pci/gscpcib.c","sys/arch/i386/pci/gscpcib.c","gscpcib_gpio_pin_write",167,182
18,4,105,3,19,"gscpcib_gpio_pin_ctl@185-204@sys/arch/i386/pci/gscpcib.c","sys/arch/i386/pci/gscpcib.c","gscpcib_gpio_pin_ctl",185,204
8,3,54,3,9,"gscpm_match@76-85@sys/arch/i386/pci/gscpm.c","sys/arch/i386/pci/gscpm.c","gscpm_match",76,85
24,4,177,3,37,"gscpm_attach@88-125@sys/arch/i386/pci/gscpm.c","sys/arch/i386/pci/gscpm.c","gscpm_attach",88,125
5,1,34,1,5,"gscpm_get_timecount@128-133@sys/arch/i386/pci/gscpm.c","sys/arch/i386/pci/gscpm.c","gscpm_get_timecount",128,133
17,4,109,1,21,"gscpm_setperf@137-158@sys/arch/i386/pci/gscpm.c","sys/arch/i386/pci/gscpm.c","gscpm_setperf",137,158
7,2,54,3,6,"ichpcib_match@111-117@sys/arch/i386/pci/ichpcib.c","sys/arch/i386/pci/ichpcib.c","ichpcib_match",111,117
32,5,231,3,48,"ichpcib_attach@120-168@sys/arch/i386/pci/ichpcib.c","sys/arch/i386/pci/ichpcib.c","ichpcib_attach",120,168
50,21,316,1,70,"ichss_present@172-242@sys/arch/i386/pci/ichpcib.c","sys/arch/i386/pci/ichpcib.c","ichss_present",172,242
30,6,166,1,48,"ichss_setperf@245-293@sys/arch/i386/pci/ichpcib.c","sys/arch/i386/pci/ichpcib.c","ichss_setperf",245,293
14,3,97,1,15,"ichpcib_get_timecount@297-312@sys/arch/i386/pci/ichpcib.c","sys/arch/i386/pci/ichpcib.c","ichpcib_get_timecount",297,312
13,2,80,5,15,"opti82c558_init@121-136@sys/arch/i386/pci/opti82c558.c","sys/arch/i386/pci/opti82c558.c","opti82c558_init",121,136
8,2,42,3,9,"opti82c558_getclink@139-148@sys/arch/i386/pci/opti82c558.c","sys/arch/i386/pci/opti82c558.c","opti82c558_getclink",139,148
12,3,86,3,14,"opti82c558_get_intr@151-165@sys/arch/i386/pci/opti82c558.c","sys/arch/i386/pci/opti82c558.c","opti82c558_get_intr",151,165
14,3,109,3,16,"opti82c558_set_intr@168-184@sys/arch/i386/pci/opti82c558.c","sys/arch/i386/pci/opti82c558.c","opti82c558_set_intr",168,184
15,3,94,3,18,"opti82c558_get_trigger@187-205@sys/arch/i386/pci/opti82c558.c","sys/arch/i386/pci/opti82c558.c","opti82c558_get_trigger",187,205
17,4,121,3,20,"opti82c558_set_trigger@208-228@sys/arch/i386/pci/opti82c558.c","sys/arch/i386/pci/opti82c558.c","opti82c558_set_trigger",208,228
14,3,85,5,17,"opti82c700_init@109-126@sys/arch/i386/pci/opti82c700.c","sys/arch/i386/pci/opti82c700.c","opti82c700_init",109,126
26,9,140,3,32,"opti82c700_addr@129-161@sys/arch/i386/pci/opti82c700.c","sys/arch/i386/pci/opti82c700.c","opti82c700_addr",129,161
24,5,119,3,26,"opti82c700_getclink@164-190@sys/arch/i386/pci/opti82c700.c","sys/arch/i386/pci/opti82c700.c","opti82c700_getclink",164,190
13,3,93,3,16,"opti82c700_get_intr@193-209@sys/arch/i386/pci/opti82c700.c","sys/arch/i386/pci/opti82c700.c","opti82c700_get_intr",193,209
15,3,113,3,18,"opti82c700_set_intr@212-230@sys/arch/i386/pci/opti82c700.c","sys/arch/i386/pci/opti82c700.c","opti82c700_set_intr",212,230
33,7,229,3,43,"opti82c700_get_trigger@233-276@sys/arch/i386/pci/opti82c700.c","sys/arch/i386/pci/opti82c700.c","opti82c700_get_trigger",233,276
35,9,255,3,45,"opti82c700_set_trigger@279-324@sys/arch/i386/pci/opti82c700.c","sys/arch/i386/pci/opti82c700.c","opti82c700_set_trigger",279,324
17,5,114,3,22,"pchbmatch@148-170@sys/arch/i386/pci/pchb.c","sys/arch/i386/pci/pchb.c","pchbmatch",148,170
187,50,1100,3,245,"pchbattach@173-418@sys/arch/i386/pci/pchb.c","sys/arch/i386/pci/pchb.c","pchbattach",173,418
19,3,101,2,20,"pchbactivate@421-441@sys/arch/i386/pci/pchb.c","sys/arch/i386/pci/pchb.c","pchbactivate",421,441
8,2,49,2,8,"pchb_print@445-453@sys/arch/i386/pci/pchb.c","sys/arch/i386/pci/pchb.c","pchb_print",445,453
14,3,95,1,21,"pchb_rnd@460-481@sys/arch/i386/pci/pchb.c","sys/arch/i386/pci/pchb.c","pchb_rnd",460,481
25,4,190,3,26,"pchb_amd64ht_attach@484-510@sys/arch/i386/pci/pchb.c","sys/arch/i386/pci/pchb.c","pchb_amd64ht_attach",484,510
51,4,341,3,69,"pci_addr_fixup@81-150@sys/arch/i386/pci/pci_addr_fixup.c","sys/arch/i386/pci/pci_addr_fixup.c","pci_addr_fixup",81,150
7,2,39,3,6,"pciaddr_resource_reserve@153-159@sys/arch/i386/pci/pci_addr_fixup.c","sys/arch/i386/pci/pci_addr_fixup.c","pciaddr_resource_reserve",153,159
8,2,39,3,7,"pciaddr_resource_reserve_disabled@162-169@sys/arch/i386/pci/pci_addr_fixup.c","sys/arch/i386/pci/pci_addr_fixup.c","pciaddr_resource_reserve_disabled",162,169
7,2,39,3,6,"pciaddr_resource_allocate@172-178@sys/arch/i386/pci/pci_addr_fixup.c","sys/arch/i386/pci/pci_addr_fixup.c","pciaddr_resource_allocate",172,178
60,11,349,4,80,"pciaddr_resource_manage@181-261@sys/arch/i386/pci/pci_addr_fixup.c","sys/arch/i386/pci/pci_addr_fixup.c","pciaddr_resource_manage",181,261
35,9,250,8,43,"pciaddr_do_resource_allocate@264-307@sys/arch/i386/pci/pci_addr_fixup.c","sys/arch/i386/pci/pci_addr_fixup.c","pciaddr_do_resource_allocate",264,307
23,7,150,8,26,"pciaddr_do_resource_reserve@310-336@sys/arch/i386/pci/pci_addr_fixup.c","sys/arch/i386/pci/pci_addr_fixup.c","pciaddr_do_resource_reserve",310,336
25,8,170,8,29,"pciaddr_do_resource_reserve_disabled@339-368@sys/arch/i386/pci/pci_addr_fixup.c","sys/arch/i386/pci/pci_addr_fixup.c","pciaddr_do_resource_reserve_disabled",339,368
6,2,33,1,5,"pciaddr_ioaddr@371-376@sys/arch/i386/pci/pci_addr_fixup.c","sys/arch/i386/pci/pci_addr_fixup.c","pciaddr_ioaddr",371,376
9,1,68,2,9,"pciaddr_print_devid@379-388@sys/arch/i386/pci/pci_addr_fixup.c","sys/arch/i386/pci/pci_addr_fixup.c","pciaddr_print_devid",379,388
20,5,124,2,21,"pciaddr_device_is_agp@391-412@sys/arch/i386/pci/pci_addr_fixup.c","sys/arch/i386/pci/pci_addr_fixup.c","pciaddr_device_is_agp",391,412
84,22,491,2,103,"pci_bus_check@52-155@sys/arch/i386/pci/pci_bus_fixup.c","sys/arch/i386/pci/pci_bus_fixup.c","pci_bus_check",52,155
59,16,413,2,84,"pci_bus_assign@158-242@sys/arch/i386/pci/pci_bus_fixup.c","sys/arch/i386/pci/pci_bus_fixup.c","pci_bus_assign",158,242
10,3,53,2,11,"pci_bus_fixup@245-256@sys/arch/i386/pci/pci_bus_fixup.c","sys/arch/i386/pci/pci_bus_fixup.c","pci_bus_fixup",245,256
9,1,68,2,9,"pcibus_print_devid@259-268@sys/arch/i386/pci/pci_bus_fixup.c","sys/arch/i386/pci/pci_bus_fixup.c","pcibus_print_devid",259,268
10,4,60,1,11,"pciintr_icu_lookup@245-256@sys/arch/i386/pci/pci_intr_fixup.c","sys/arch/i386/pci/pci_intr_fixup.c","pciintr_icu_lookup",245,256
9,3,53,1,10,"pciintr_link_lookup@259-269@sys/arch/i386/pci/pci_intr_fixup.c","sys/arch/i386/pci/pci_intr_fixup.c","pciintr_link_lookup",259,269
39,8,268,3,60,"pciintr_link_alloc@272-332@sys/arch/i386/pci/pci_intr_fixup.c","sys/arch/i386/pci/pci_intr_fixup.c","pciintr_link_alloc",272,332
14,5,79,2,16,"pciintr_pir_lookup@335-351@sys/arch/i386/pci/pci_intr_fixup.c","sys/arch/i386/pci/pci_intr_fixup.c","pciintr_pir_lookup",335,351
12,4,77,2,13,"pciintr_bitmap_count_irq@354-367@sys/arch/i386/pci/pci_intr_fixup.c","sys/arch/i386/pci/pci_intr_fixup.c","pciintr_bitmap_count_irq",354,367
30,7,199,1,47,"pciintr_link_init@370-417@sys/arch/i386/pci/pci_intr_fixup.c","sys/arch/i386/pci/pci_intr_fixup.c","pciintr_link_init",370,417
20,6,115,1,24,"pciintr_guess_irq@424-448@sys/arch/i386/pci/pci_intr_fixup.c","sys/arch/i386/pci/pci_intr_fixup.c","pciintr_guess_irq",424,448
55,16,345,1,91,"pciintr_link_fixup@451-542@sys/arch/i386/pci/pci_intr_fixup.c","sys/arch/i386/pci/pci_intr_fixup.c","pciintr_link_fixup",451,542
50,18,308,2,64,"pci_intr_route_link@545-609@sys/arch/i386/pci/pci_intr_fixup.c","sys/arch/i386/pci/pci_intr_fixup.c","pci_intr_route_link",545,609
32,14,201,1,37,"pci_intr_post_fixup@612-649@sys/arch/i386/pci/pci_intr_fixup.c","sys/arch/i386/pci/pci_intr_fixup.c","pci_intr_post_fixup",612,649
54,17,391,3,78,"pci_intr_header_fixup@652-730@sys/arch/i386/pci/pci_intr_fixup.c","sys/arch/i386/pci/pci_intr_fixup.c","pci_intr_header_fixup",652,730
94,29,634,3,147,"pci_intr_fixup@733-880@sys/arch/i386/pci/pci_intr_fixup.c","sys/arch/i386/pci/pci_intr_fixup.c","pci_intr_fixup",733,880
78,40,345,3,124,"pci_attach_hook@195-319@sys/arch/i386/pci/pci_machdep.c","sys/arch/i386/pci/pci_machdep.c","pci_attach_hook",195,319
7,2,27,2,13,"pci_bus_maxdevs@322-335@sys/arch/i386/pci/pci_machdep.c","sys/arch/i386/pci/pci_machdep.c","pci_bus_maxdevs",322,335
22,9,148,4,25,"pci_make_tag@338-363@sys/arch/i386/pci/pci_machdep.c","sys/arch/i386/pci/pci_machdep.c","pci_make_tag",338,363
23,9,166,5,22,"pci_decompose_tag@366-388@sys/arch/i386/pci/pci_machdep.c","sys/arch/i386/pci/pci_machdep.c","pci_decompose_tag",366,388
10,4,49,2,11,"pci_conf_size@391-402@sys/arch/i386/pci/pci_machdep.c","sys/arch/i386/pci/pci_machdep.c","pci_conf_size",391,402
8,3,50,1,8,"pci_mcfg_map_bus@405-413@sys/arch/i386/pci/pci_machdep.c","sys/arch/i386/pci/pci_machdep.c","pci_mcfg_map_bus",405,413
33,7,200,3,36,"pci_conf_read@416-452@sys/arch/i386/pci/pci_machdep.c","sys/arch/i386/pci/pci_machdep.c","pci_conf_read",416,452
31,7,196,4,33,"pci_conf_write@455-488@sys/arch/i386/pci/pci_machdep.c","sys/arch/i386/pci/pci_machdep.c","pci_conf_write",455,488
54,17,317,1,105,"pci_mode_detect@491-596@sys/arch/i386/pci/pci_machdep.c","sys/arch/i386/pci/pci_machdep.c","pci_mode_detect",491,596
12,4,82,2,13,"pci_intr_map_msi@599-612@sys/arch/i386/pci/pci_machdep.c","sys/arch/i386/pci/pci_machdep.c","pci_intr_map_msi",599,612
83,31,511,2,122,"pci_intr_map@615-737@sys/arch/i386/pci/pci_machdep.c","sys/arch/i386/pci/pci_machdep.c","pci_intr_map",615,737
16,7,116,2,21,"pci_intr_string@740-761@sys/arch/i386/pci/pci_machdep.c","sys/arch/i386/pci/pci_machdep.c","pci_intr_string",740,761
60,17,509,6,78,"pci_intr_establish@772-850@sys/arch/i386/pci/pci_machdep.c","sys/arch/i386/pci/pci_machdep.c","pci_intr_establish",772,850
18,3,129,2,23,"pci_intr_disestablish@853-876@sys/arch/i386/pci/pci_machdep.c","sys/arch/i386/pci/pci_machdep.c","pci_intr_disestablish",853,876
37,11,223,1,54,"pci_init_extents@883-937@sys/arch/i386/pci/pci_machdep.c","sys/arch/i386/pci/pci_machdep.c","pci_init_extents",883,937
4,2,21,2,5,"pci_dev_postattach@947-952@sys/arch/i386/pci/pci_machdep.c","sys/arch/i386/pci/pci_machdep.c","pci_dev_postattach",947,952
5,2,26,2,7,"pci_min_powerstate@955-962@sys/arch/i386/pci/pci_machdep.c","sys/arch/i386/pci/pci_machdep.c","pci_min_powerstate",955,962
4,2,27,4,5,"pci_set_powerstate_md@965-970@sys/arch/i386/pci/pci_machdep.c","sys/arch/i386/pci/pci_machdep.c","pci_set_powerstate_md",965,970
31,12,146,3,36,"pcibmatch@65-101@sys/arch/i386/pci/pcib.c","sys/arch/i386/pci/pcib.c","pcibmatch",65,101
5,1,30,3,8,"pcibattach@104-112@sys/arch/i386/pci/pcib.c","sys/arch/i386/pci/pcib.c","pcibattach",104,112
11,3,65,1,19,"pcib_callback@115-134@sys/arch/i386/pci/pcib.c","sys/arch/i386/pci/pcib.c","pcib_callback",115,134
6,2,29,2,6,"pcib_print@137-143@sys/arch/i386/pci/pcib.c","sys/arch/i386/pci/pcib.c","pcib_print",137,143
16,3,123,3,19,"pcibiosprobe@142-161@sys/arch/i386/pci/pcibios.c","sys/arch/i386/pci/pcibios.c","pcibiosprobe",142,161
40,12,298,3,69,"pcibiosattach@164-233@sys/arch/i386/pci/pcibios.c","sys/arch/i386/pci/pcibios.c","pcibiosattach",164,233
76,14,475,1,103,"pcibios_pir_init@236-339@sys/arch/i386/pci/pcibios.c","sys/arch/i386/pci/pcibios.c","pcibios_pir_init",236,339
33,3,215,8,40,"pcibios_get_status@342-382@sys/arch/i386/pci/pcibios.c","sys/arch/i386/pci/pcibios.c","pcibios_get_status",342,382
34,2,189,4,39,"pcibios_get_intr_routing@385-424@sys/arch/i386/pci/pcibios.c","sys/arch/i386/pci/pcibios.c","pcibios_get_intr_routing",385,424
41,10,162,3,51,"pcibios_return_code@427-478@sys/arch/i386/pci/pcibios.c","sys/arch/i386/pci/pcibios.c","pcibios_return_code",427,478
12,4,71,1,12,"pcibios_print_exclirq@481-493@sys/arch/i386/pci/pcibios.c","sys/arch/i386/pci/pcibios.c","pcibios_print_exclirq",481,493
16,3,103,1,16,"pcibios_print_pir_table@496-512@sys/arch/i386/pci/pcibios.c","sys/arch/i386/pci/pcibios.c","pcibios_print_pir_table",496,512
37,11,271,4,49,"pci_device_foreach@515-564@sys/arch/i386/pci/pcibios.c","sys/arch/i386/pci/pcibios.c","pci_device_foreach",515,564
4,1,10,1,3,"pcic_pci_machdep_intr_est@45-48@sys/arch/i386/pci/pcic_pci_machdep.c","sys/arch/i386/pci/pcic_pci_machdep.c","pcic_pci_machdep_intr_est",45,48
9,2,85,2,8,"pcic_pci_machdep_pcic_intr_establish@51-59@sys/arch/i386/pci/pcic_pci_machdep.c","sys/arch/i386/pci/pcic_pci_machdep.c","pcic_pci_machdep_pcic_intr_establish",51,59
6,1,51,6,5,"pcic_pci_machdep_chip_intr_establish@62-67@sys/arch/i386/pci/pcic_pci_machdep.c","sys/arch/i386/pci/pcic_pci_machdep.c","pcic_pci_machdep_chip_intr_establish",62,67
4,1,18,2,3,"pcic_pci_machdep_chip_intr_disestablish@70-73@sys/arch/i386/pci/pcic_pci_machdep.c","sys/arch/i386/pci/pcic_pci_machdep.c","pcic_pci_machdep_chip_intr_disestablish",70,73
10,1,71,5,11,"pciide_machdep_compat_intr_establish@86-97@sys/arch/i386/pci/pciide_machdep.c","sys/arch/i386/pci/pciide_machdep.c","pciide_machdep_compat_intr_establish",86,97
4,1,18,2,3,"pciide_machdep_compat_intr_disestablish@100-103@sys/arch/i386/pci/pciide_machdep.c","sys/arch/i386/pci/pciide_machdep.c","pciide_machdep_compat_intr_disestablish",100,103
36,5,249,2,45,"gcsc_chip_map@106-151@sys/arch/i386/pci/pciide_machdep.c","sys/arch/i386/pci/pciide_machdep.c","gcsc_chip_map",106,151
34,10,211,1,49,"gcsc_setup_channel@154-203@sys/arch/i386/pci/pciide_machdep.c","sys/arch/i386/pci/pciide_machdep.c","gcsc_setup_channel",154,203
20,4,129,5,25,"piix_init@101-126@sys/arch/i386/pci/piix.c","sys/arch/i386/pci/piix.c","piix_init",101,126
21,6,136,3,27,"piix_getclink@129-156@sys/arch/i386/pci/piix.c","sys/arch/i386/pci/piix.c","piix_getclink",129,156
20,4,117,3,23,"piix_get_intr@159-182@sys/arch/i386/pci/piix.c","sys/arch/i386/pci/piix.c","piix_get_intr",159,182
19,4,131,3,22,"piix_set_intr@185-207@sys/arch/i386/pci/piix.c","sys/arch/i386/pci/piix.c","piix_set_intr",185,207
16,4,103,3,19,"piix_get_trigger@210-229@sys/arch/i386/pci/piix.c","sys/arch/i386/pci/piix.c","piix_get_trigger",210,229
17,4,120,3,20,"piix_set_trigger@232-252@sys/arch/i386/pci/piix.c","sys/arch/i386/pci/piix.c","piix_set_trigger",232,252
27,8,230,1,30,"piix_pir_dump@256-286@sys/arch/i386/pci/piix.c","sys/arch/i386/pci/piix.c","piix_pir_dump",256,286
19,3,135,1,23,"piixpcib_int15_gsic_call@139-162@sys/arch/i386/pci/piixpcib.c","sys/arch/i386/pci/piixpcib.c","piixpcib_int15_gsic_call",139,162
18,2,87,1,20,"piixpcib_set_ownership@165-185@sys/arch/i386/pci/piixpcib.c","sys/arch/i386/pci/piixpcib.c","piixpcib_set_ownership",165,185
27,5,124,1,38,"piixpcib_configure_speedstep@188-226@sys/arch/i386/pci/piixpcib.c","sys/arch/i386/pci/piixpcib.c","piixpcib_configure_speedstep",188,226
7,2,54,3,6,"piixpcib_match@229-235@sys/arch/i386/pci/piixpcib.c","sys/arch/i386/pci/piixpcib.c","piixpcib_match",229,235
12,3,71,3,17,"piixpcib_attach@238-255@sys/arch/i386/pci/piixpcib.c","sys/arch/i386/pci/piixpcib.c","piixpcib_attach",238,255
36,8,147,3,42,"piixpcib_getset_state@258-300@sys/arch/i386/pci/piixpcib.c","sys/arch/i386/pci/piixpcib.c","piixpcib_getset_state",258,300
32,11,145,1,68,"piixpcib_setperf@303-371@sys/arch/i386/pci/piixpcib.c","sys/arch/i386/pci/piixpcib.c","piixpcib_setperf",303,371
22,4,166,5,26,"osb4_init@68-94@sys/arch/i386/pci/rccosb4.c","sys/arch/i386/pci/rccosb4.c","osb4_init",68,94
10,3,51,3,10,"osb4_getclink@97-107@sys/arch/i386/pci/rccosb4.c","sys/arch/i386/pci/rccosb4.c","osb4_getclink",97,107
12,3,91,3,14,"osb4_get_intr@110-124@sys/arch/i386/pci/rccosb4.c","sys/arch/i386/pci/rccosb4.c","osb4_get_intr",110,124
10,3,85,3,12,"osb4_set_intr@127-139@sys/arch/i386/pci/rccosb4.c","sys/arch/i386/pci/rccosb4.c","osb4_set_intr",127,139
9,2,56,5,10,"sis85c503_init@91-101@sys/arch/i386/pci/sis85c503.c","sys/arch/i386/pci/sis85c503.c","sis85c503_init",91,101
13,5,67,3,17,"sis85c503_getclink@104-121@sys/arch/i386/pci/sis85c503.c","sys/arch/i386/pci/sis85c503.c","sis85c503_getclink",104,121
15,3,89,3,18,"sis85c503_get_intr@124-142@sys/arch/i386/pci/sis85c503.c","sys/arch/i386/pci/sis85c503.c","sis85c503_get_intr",124,142
17,3,117,3,19,"sis85c503_set_intr@145-164@sys/arch/i386/pci/sis85c503.c","sys/arch/i386/pci/sis85c503.c","sis85c503_set_intr",145,164
8,4,40,2,9,"vm86_emu_inb@61-70@sys/arch/i386/pci/vga_post.c","sys/arch/i386/pci/vga_post.c","vm86_emu_inb",61,70
6,3,31,2,6,"vm86_emu_inw@73-79@sys/arch/i386/pci/vga_post.c","sys/arch/i386/pci/vga_post.c","vm86_emu_inw",73,79
6,3,31,2,6,"vm86_emu_inl@82-88@sys/arch/i386/pci/vga_post.c","sys/arch/i386/pci/vga_post.c","vm86_emu_inl",82,88
8,4,42,3,9,"vm86_emu_outb@91-100@sys/arch/i386/pci/vga_post.c","sys/arch/i386/pci/vga_post.c","vm86_emu_outb",91,100
6,3,34,3,6,"vm86_emu_outw@103-109@sys/arch/i386/pci/vga_post.c","sys/arch/i386/pci/vga_post.c","vm86_emu_outw",103,109
6,3,34,3,6,"vm86_emu_outl@112-118@sys/arch/i386/pci/vga_post.c","sys/arch/i386/pci/vga_post.c","vm86_emu_outl",112,118
56,6,440,3,67,"vga_post_init@121-188@sys/arch/i386/pci/vga_post.c","sys/arch/i386/pci/vga_post.c","vga_post_init",121,188
11,1,100,1,15,"vga_post_call@191-206@sys/arch/i386/pci/vga_post.c","sys/arch/i386/pci/vga_post.c","vga_post_call",191,206
8,1,59,1,8,"vga_post_free@209-217@sys/arch/i386/pci/vga_post.c","sys/arch/i386/pci/vga_post.c","vga_post_free",209,217
7,2,21,1,7,"ddb_vgapost@221-228@sys/arch/i386/pci/vga_post.c","sys/arch/i386/pci/vga_post.c","ddb_vgapost",221,228
19,5,127,5,25,"via8231_init@136-161@sys/arch/i386/pci/via8231.c","sys/arch/i386/pci/via8231.c","via8231_init",136,161
10,5,80,3,12,"via8231_getclink@164-176@sys/arch/i386/pci/via8231.c","sys/arch/i386/pci/via8231.c","via8231_getclink",164,176
17,4,112,3,20,"via8231_get_intr@179-199@sys/arch/i386/pci/via8231.c","sys/arch/i386/pci/via8231.c","via8231_get_intr",179,199
19,5,140,3,24,"via8231_set_intr@202-226@sys/arch/i386/pci/via8231.c","sys/arch/i386/pci/via8231.c","via8231_set_intr",202,226
20,7,130,3,22,"via8231_get_trigger@229-251@sys/arch/i386/pci/via8231.c","sys/arch/i386/pci/via8231.c","via8231_get_trigger",229,251
36,11,205,3,41,"via8231_set_trigger@254-295@sys/arch/i386/pci/via8231.c","sys/arch/i386/pci/via8231.c","via8231_set_trigger",254,295
7,1,44,2,8,"via8231_pir_dump@299-307@sys/arch/i386/pci/via8231.c","sys/arch/i386/pci/via8231.c","via8231_pir_dump",299,307
14,2,88,5,20,"via82c586_init@116-136@sys/arch/i386/pci/via82c586.c","sys/arch/i386/pci/via82c586.c","via82c586_init",116,136
8,2,42,3,9,"via82c586_getclink@139-148@sys/arch/i386/pci/via82c586.c","sys/arch/i386/pci/via82c586.c","via82c586_getclink",139,148
13,3,83,3,15,"via82c586_get_intr@151-166@sys/arch/i386/pci/via82c586.c","sys/arch/i386/pci/via82c586.c","via82c586_get_intr",151,166
18,5,142,3,20,"via82c586_set_intr@169-189@sys/arch/i386/pci/via82c586.c","sys/arch/i386/pci/via82c586.c","via82c586_set_intr",169,189
26,8,163,3,28,"via82c586_get_trigger@192-220@sys/arch/i386/pci/via82c586.c","sys/arch/i386/pci/via82c586.c","via82c586_get_trigger",192,220
26,8,172,3,30,"via82c586_set_trigger@223-253@sys/arch/i386/pci/via82c586.c","sys/arch/i386/pci/via82c586.c","via82c586_set_trigger",223,253
20,5,88,1,23,"apm_check@67-90@sys/arch/i386/stand/libsa/apmprobe.c","sys/arch/i386/stand/libsa/apmprobe.c","apm_check",67,90
10,2,58,1,11,"apm_disconnect@93-104@sys/arch/i386/stand/libsa/apmprobe.c","sys/arch/i386/stand/libsa/apmprobe.c","apm_disconnect",93,104
41,6,253,1,51,"apm_connect@107-158@sys/arch/i386/stand/libsa/apmprobe.c","sys/arch/i386/stand/libsa/apmprobe.c","apm_connect",107,158
21,6,108,1,27,"apmprobe@163-190@sys/arch/i386/stand/libsa/apmprobe.c","sys/arch/i386/stand/libsa/apmprobe.c","apmprobe",163,190
7,3,42,1,8,"apmfixmem@196-204@sys/arch/i386/stand/libsa/apmprobe.c","sys/arch/i386/stand/libsa/apmprobe.c","apmfixmem",196,204
12,3,91,1,15,"pc_probe@50-65@sys/arch/i386/stand/libsa/bioscons.c","sys/arch/i386/stand/libsa/bioscons.c","pc_probe",50,65
3,1,9,1,2,"pc_init@68-70@sys/arch/i386/stand/libsa/bioscons.c","sys/arch/i386/stand/libsa/bioscons.c","pc_init",68,70
16,3,124,1,23,"pc_getc@73-96@sys/arch/i386/stand/libsa/bioscons.c","sys/arch/i386/stand/libsa/bioscons.c","pc_getc",73,96
7,1,43,1,8,"pc_getshifts@99-107@sys/arch/i386/stand/libsa/bioscons.c","sys/arch/i386/stand/libsa/bioscons.c","pc_getshifts",99,107
5,1,38,2,4,"pc_putc@110-114@sys/arch/i386/stand/libsa/bioscons.c","sys/arch/i386/stand/libsa/bioscons.c","pc_putc",110,114
11,2,82,1,14,"com_probe@119-133@sys/arch/i386/stand/libsa/bioscons.c","sys/arch/i386/stand/libsa/bioscons.c","com_probe",119,133
17,6,144,1,21,"com_init@139-160@sys/arch/i386/stand/libsa/bioscons.c","sys/arch/i386/stand/libsa/bioscons.c","com_init",139,160
9,4,75,1,11,"com_getc@163-174@sys/arch/i386/stand/libsa/bioscons.c","sys/arch/i386/stand/libsa/bioscons.c","com_getc",163,174
37,16,261,2,51,"comspeed@178-229@sys/arch/i386/stand/libsa/bioscons.c","sys/arch/i386/stand/libsa/bioscons.c","comspeed",178,229
7,3,55,2,8,"com_putc@232-240@sys/arch/i386/stand/libsa/bioscons.c","sys/arch/i386/stand/libsa/bioscons.c","com_putc",232,240
7,2,55,1,8,"biosdreset@77-85@sys/arch/i386/stand/libsa/biosdev.c","sys/arch/i386/stand/libsa/biosdev.c","biosdreset",77,85
52,22,359,2,90,"bios_getdiskinfo@93-183@sys/arch/i386/stand/libsa/biosdev.c","sys/arch/i386/stand/libsa/biosdev.c","bios_getdiskinfo",93,183
21,3,129,7,23,"CHS_rw@189-212@sys/arch/i386/stand/libsa/biosdev.c","sys/arch/i386/stand/libsa/biosdev.c","CHS_rw",189,212
19,5,183,5,26,"EDD_rw@215-241@sys/arch/i386/stand/libsa/biosdev.c","sys/arch/i386/stand/libsa/biosdev.c","EDD_rw",215,241
65,22,479,5,95,"biosd_io@247-342@sys/arch/i386/stand/libsa/biosdev.c","sys/arch/i386/stand/libsa/biosdev.c","biosd_io",247,342
4,1,39,5,3,"biosd_diskio@345-348@sys/arch/i386/stand/libsa/biosdev.c","sys/arch/i386/stand/libsa/biosdev.c","biosd_diskio",345,348
53,17,326,2,68,"findopenbsd@353-421@sys/arch/i386/stand/libsa/biosdev.c","sys/arch/i386/stand/libsa/biosdev.c","findopenbsd",353,421
24,10,153,2,35,"bios_getdisklabel@424-459@sys/arch/i386/stand/libsa/biosdev.c","sys/arch/i386/stand/libsa/biosdev.c","bios_getdisklabel",424,459
125,38,741,2,171,"biosopen@462-633@sys/arch/i386/stand/libsa/biosdev.c","sys/arch/i386/stand/libsa/biosdev.c","biosopen",462,633
7,4,36,1,8,"biosdisk_err@672-680@sys/arch/i386/stand/libsa/biosdev.c","sys/arch/i386/stand/libsa/biosdev.c","biosdisk_err",672,680
8,4,48,1,10,"biosdisk_errno@702-712@sys/arch/i386/stand/libsa/biosdev.c","sys/arch/i386/stand/libsa/biosdev.c","biosdisk_errno",702,712
24,8,184,6,35,"biosstrategy@715-750@sys/arch/i386/stand/libsa/biosdev.c","sys/arch/i386/stand/libsa/biosdev.c","biosstrategy",715,750
5,1,18,1,5,"biosclose@753-758@sys/arch/i386/stand/libsa/biosdev.c","sys/arch/i386/stand/libsa/biosdev.c","biosclose",753,758
4,1,19,3,3,"biosioctl@761-764@sys/arch/i386/stand/libsa/biosdev.c","sys/arch/i386/stand/libsa/biosdev.c","biosioctl",761,764
14,2,77,1,18,"getSYSCONFaddr@40-58@sys/arch/i386/stand/libsa/biosprobe.c","sys/arch/i386/stand/libsa/biosprobe.c","getSYSCONFaddr",40,58
17,3,85,1,22,"getEBDAaddr@61-83@sys/arch/i386/stand/libsa/biosprobe.c","sys/arch/i386/stand/libsa/biosprobe.c","getEBDAaddr",61,83
5,1,13,1,4,"Xdiskinfo@73-77@sys/arch/i386/stand/libsa/cmd_i386.c","sys/arch/i386/stand/libsa/cmd_i386.c","Xdiskinfo",73,77
5,1,11,1,4,"Xregs@81-85@sys/arch/i386/stand/libsa/cmd_i386.c","sys/arch/i386/stand/libsa/cmd_i386.c","Xregs",81,85
47,18,387,1,63,"Xboot@89-152@sys/arch/i386/stand/libsa/cmd_i386.c","sys/arch/i386/stand/libsa/cmd_i386.c","Xboot",89,152
55,16,253,1,66,"Xmemory@155-221@sys/arch/i386/stand/libsa/cmd_i386.c","sys/arch/i386/stand/libsa/cmd_i386.c","Xmemory",155,221
7,2,40,1,8,"Xcomaddr@224-232@sys/arch/i386/stand/libsa/cmd_i386.c","sys/arch/i386/stand/libsa/cmd_i386.c","Xcomaddr",224,232
13,1,45,2,13,"cpuid@36-49@sys/arch/i386/stand/libsa/cpuprobe.c","sys/arch/i386/stand/libsa/cpuprobe.c","cpuid",36,49
51,7,323,1,80,"cpuprobe@52-132@sys/arch/i386/stand/libsa/cpuprobe.c","sys/arch/i386/stand/libsa/cpuprobe.c","cpuprobe",52,132
10,2,49,1,12,"dump_cpuinfo@135-147@sys/arch/i386/stand/libsa/cpuprobe.c","sys/arch/i386/stand/libsa/cpuprobe.c","dump_cpuinfo",135,147
3,1,6,1,2,"debug_init@52-54@sys/arch/i386/stand/libsa/debug.c","sys/arch/i386/stand/libsa/debug.c","debug_init",52,54
18,3,162,2,28,"dump_regs@58-86@sys/arch/i386/stand/libsa/debug.c","sys/arch/i386/stand/libsa/debug.c","dump_regs",58,86
9,5,87,3,9,"dump_mem@89-98@sys/arch/i386/stand/libsa/debug.c","sys/arch/i386/stand/libsa/debug.c","dump_mem",89,98
12,5,92,2,12,"d_putc@104-116@sys/arch/i386/stand/libsa/debug.c","sys/arch/i386/stand/libsa/debug.c","d_putc",104,116
23,13,159,3,36,"devopen@62-98@sys/arch/i386/stand/libsa/dev_i386.c","sys/arch/i386/stand/libsa/dev_i386.c","devopen",62,98
38,12,247,2,52,"devboot@101-153@sys/arch/i386/stand/libsa/dev_i386.c","sys/arch/i386/stand/libsa/dev_i386.c","devboot",101,153
6,1,37,1,6,"ttyname@158-164@sys/arch/i386/stand/libsa/dev_i386.c","sys/arch/i386/stand/libsa/dev_i386.c","ttyname",158,164
13,9,124,1,13,"ttydev@167-180@sys/arch/i386/stand/libsa/dev_i386.c","sys/arch/i386/stand/libsa/dev_i386.c","ttydev",167,180
6,2,30,2,7,"cnspeed@183-190@sys/arch/i386/stand/libsa/dev_i386.c","sys/arch/i386/stand/libsa/dev_i386.c","cnspeed",183,190
6,1,32,1,5,"diskinfo_init@73-78@sys/arch/i386/stand/libsa/diskprobe.c","sys/arch/i386/stand/libsa/diskprobe.c","diskinfo_init",73,78
19,5,123,1,35,"floppyprobe@82-117@sys/arch/i386/stand/libsa/diskprobe.c","sys/arch/i386/stand/libsa/diskprobe.c","floppyprobe",82,117
47,10,302,1,61,"hardprobe@121-182@sys/arch/i386/stand/libsa/diskprobe.c","sys/arch/i386/stand/libsa/diskprobe.c","hardprobe",121,182
43,5,238,1,52,"efi_hardprobe@187-239@sys/arch/i386/stand/libsa/diskprobe.c","sys/arch/i386/stand/libsa/diskprobe.c","efi_hardprobe",187,239
27,8,185,1,48,"diskprobe@245-293@sys/arch/i386/stand/libsa/diskprobe.c","sys/arch/i386/stand/libsa/diskprobe.c","diskprobe",245,293
49,5,407,1,71,"cdprobe@297-368@sys/arch/i386/stand/libsa/diskprobe.c","sys/arch/i386/stand/libsa/diskprobe.c","cdprobe",297,368
8,3,49,1,9,"dklookup@374-383@sys/arch/i386/stand/libsa/diskprobe.c","sys/arch/i386/stand/libsa/diskprobe.c","dklookup",374,383
22,5,141,1,24,"dump_diskinfo@386-410@sys/arch/i386/stand/libsa/diskprobe.c","sys/arch/i386/stand/libsa/diskprobe.c","dump_diskinfo",386,410
8,2,32,1,9,"bios_dklookup@416-425@sys/arch/i386/stand/libsa/diskprobe.c","sys/arch/i386/stand/libsa/diskprobe.c","bios_dklookup",416,425
26,9,193,1,32,"disksum@434-466@sys/arch/i386/stand/libsa/diskprobe.c","sys/arch/i386/stand/libsa/diskprobe.c","disksum",434,466
4,2,23,1,3,"bootdev_has_hibernate@469-472@sys/arch/i386/stand/libsa/diskprobe.c","sys/arch/i386/stand/libsa/diskprobe.c","bootdev_has_hibernate",469,472
15,5,133,1,18,"check_hibernate@475-493@sys/arch/i386/stand/libsa/diskprobe.c","sys/arch/i386/stand/libsa/diskprobe.c","check_hibernate",475,493
55,14,430,2,89,"run_loadfile@57-146@sys/arch/i386/stand/libsa/exec_i386.c","sys/arch/i386/stand/libsa/exec_i386.c","run_loadfile",57,146
4,1,11,1,3,"gateA20on@48-51@sys/arch/i386/stand/libsa/gateA20.c","sys/arch/i386/stand/libsa/gateA20.c","gateA20on",48,51
27,11,192,1,33,"gateA20@58-91@sys/arch/i386/stand/libsa/gateA20.c","sys/arch/i386/stand/libsa/gateA20.c","gateA20",58,91
15,4,92,1,20,"machdep@48-68@sys/arch/i386/stand/libsa/machdep.c","sys/arch/i386/stand/libsa/machdep.c","machdep",48,68
5,1,26,1,8,"check_skip_conf@70-78@sys/arch/i386/stand/libsa/machdep.c","sys/arch/i386/stand/libsa/machdep.c","check_skip_conf",70,78
12,2,71,1,16,"checkA20@47-63@sys/arch/i386/stand/libsa/memprobe.c","sys/arch/i386/stand/libsa/memprobe.c","checkA20",47,63
23,7,163,1,27,"bios_E820@71-98@sys/arch/i386/stand/libsa/memprobe.c","sys/arch/i386/stand/libsa/memprobe.c","bios_E820",71,98
13,3,82,1,18,"bios_8800@107-125@sys/arch/i386/stand/libsa/memprobe.c","sys/arch/i386/stand/libsa/memprobe.c","bios_8800",107,125
10,2,64,1,14,"bios_int12@133-147@sys/arch/i386/stand/libsa/memprobe.c","sys/arch/i386/stand/libsa/memprobe.c","bios_int12",133,147
26,7,190,1,34,"addrprobe@170-204@sys/arch/i386/stand/libsa/memprobe.c","sys/arch/i386/stand/libsa/memprobe.c","addrprobe",170,204
12,4,71,1,21,"badprobe@217-238@sys/arch/i386/stand/libsa/memprobe.c","sys/arch/i386/stand/libsa/memprobe.c","badprobe",217,238
35,13,243,1,62,"memprobe@243-305@sys/arch/i386/stand/libsa/memprobe.c","sys/arch/i386/stand/libsa/memprobe.c","memprobe",243,305
16,4,111,1,19,"dump_biosmem@309-328@sys/arch/i386/stand/libsa/memprobe.c","sys/arch/i386/stand/libsa/memprobe.c","dump_biosmem",309,328
16,7,130,1,19,"mem_limit@331-350@sys/arch/i386/stand/libsa/memprobe.c","sys/arch/i386/stand/libsa/memprobe.c","mem_limit",331,350
30,11,242,2,34,"mem_delete@353-387@sys/arch/i386/stand/libsa/memprobe.c","sys/arch/i386/stand/libsa/memprobe.c","mem_delete",353,387
32,11,226,2,39,"mem_add@390-429@sys/arch/i386/stand/libsa/memprobe.c","sys/arch/i386/stand/libsa/memprobe.c","mem_add",390,429
8,2,45,1,8,"mem_pass@432-440@sys/arch/i386/stand/libsa/memprobe.c","sys/arch/i386/stand/libsa/memprobe.c","mem_pass",432,440
23,5,174,1,30,"pciprobe@38-68@sys/arch/i386/stand/libsa/pciprobe.c","sys/arch/i386/stand/libsa/pciprobe.c","pciprobe",38,68
20,3,133,3,25,"pxesendudp@125-150@sys/arch/i386/stand/libsa/pxe.c","sys/arch/i386/stand/libsa/pxe.c","pxesendudp",125,150
25,3,185,4,34,"pxereadudp@157-191@sys/arch/i386/stand/libsa/pxe.c","sys/arch/i386/stand/libsa/pxe.c","pxereadudp",157,191
22,5,122,1,36,"pxe_netif_open@205-241@sys/arch/i386/stand/libsa/pxe.c","sys/arch/i386/stand/libsa/pxe.c","pxe_netif_open",205,241
12,4,60,1,17,"pxe_netif_close@244-261@sys/arch/i386/stand/libsa/pxe.c","sys/arch/i386/stand/libsa/pxe.c","pxe_netif_close",244,261
5,2,15,1,7,"pxe_netif_shutdown@264-271@sys/arch/i386/stand/libsa/pxe.c","sys/arch/i386/stand/libsa/pxe.c","pxe_netif_shutdown",264,271
8,3,23,1,10,"pxesocktodesc@274-284@sys/arch/i386/stand/libsa/pxe.c","sys/arch/i386/stand/libsa/pxe.c","pxesocktodesc",274,284
8,3,28,1,7,"pxeprobe@299-306@sys/arch/i386/stand/libsa/pxe.c","sys/arch/i386/stand/libsa/pxe.c","pxeprobe",299,306
103,26,626,1,142,"pxe_init@309-451@sys/arch/i386/stand/libsa/pxe.c","sys/arch/i386/stand/libsa/pxe.c","pxe_init",309,451
30,8,228,1,46,"pxeinfo@454-500@sys/arch/i386/stand/libsa/pxe.c","sys/arch/i386/stand/libsa/pxe.c","pxeinfo",454,500
29,10,161,1,45,"pxe_shutdown@503-548@sys/arch/i386/stand/libsa/pxe.c","sys/arch/i386/stand/libsa/pxe.c","pxe_shutdown",503,548
12,2,69,1,12,"ps2probe@34-46@sys/arch/i386/stand/libsa/ps2probe.c","sys/arch/i386/stand/libsa/ps2probe.c","ps2probe",34,46
28,11,121,2,39,"net_open@69-108@sys/arch/i386/stand/libsa/pxe_net.c","sys/arch/i386/stand/libsa/pxe_net.c","net_open",69,108
19,8,83,1,26,"net_close@111-137@sys/arch/i386/stand/libsa/pxe_net.c","sys/arch/i386/stand/libsa/pxe_net.c","net_close",111,137
4,1,19,3,3,"net_ioctl@140-143@sys/arch/i386/stand/libsa/pxe_net.c","sys/arch/i386/stand/libsa/pxe_net.c","net_ioctl",140,143
5,1,28,6,4,"net_strategy@146-150@sys/arch/i386/stand/libsa/pxe_net.c","sys/arch/i386/stand/libsa/pxe_net.c","net_strategy",146,150
9,4,35,1,17,"net_getparams@160-177@sys/arch/i386/stand/libsa/pxe_net.c","sys/arch/i386/stand/libsa/pxe_net.c","net_getparams",160,177
8,3,60,2,12,"mp_checksum@51-63@sys/arch/i386/stand/libsa/smpprobe.c","sys/arch/i386/stand/libsa/smpprobe.c","mp_checksum",51,63
24,9,132,2,31,"mp_probefloat@67-98@sys/arch/i386/stand/libsa/smpprobe.c","sys/arch/i386/stand/libsa/smpprobe.c","mp_probefloat",67,98
23,6,186,1,35,"smpprobe@102-137@sys/arch/i386/stand/libsa/smpprobe.c","sys/arch/i386/stand/libsa/smpprobe.c","smpprobe",102,137
35,7,287,2,50,"srprobe_meta_opt_load@35-85@sys/arch/i386/stand/libsa/softraid_i386.c","sys/arch/i386/stand/libsa/softraid_i386.c","srprobe_meta_opt_load",35,85
26,4,209,1,31,"srprobe_keydisk_load@88-119@sys/arch/i386/stand/libsa/softraid_i386.c","sys/arch/i386/stand/libsa/softraid_i386.c","srprobe_keydisk_load",88,119
131,29,913,1,182,"srprobe@122-304@sys/arch/i386/stand/libsa/softraid_i386.c","sys/arch/i386/stand/libsa/softraid_i386.c","srprobe",122,304
55,13,420,6,74,"sr_strategy@307-381@sys/arch/i386/stand/libsa/softraid_i386.c","sys/arch/i386/stand/libsa/softraid_i386.c","sr_strategy",307,381
31,7,255,2,41,"sr_getdisklabel@384-425@sys/arch/i386/stand/libsa/softraid_i386.c","sys/arch/i386/stand/libsa/softraid_i386.c","sr_getdisklabel",384,425
4,1,26,1,3,"bcdtoint@43-46@sys/arch/i386/stand/libsa/time.c","sys/arch/i386/stand/libsa/time.c","bcdtoint",43,46
11,4,96,6,18,"compute@56-74@sys/arch/i386/stand/libsa/time.c","sys/arch/i386/stand/libsa/time.c","compute",56,74
20,2,115,2,20,"bios_time_date@77-97@sys/arch/i386/stand/libsa/time.c","sys/arch/i386/stand/libsa/time.c","bios_time_date",77,97
4,1,19,1,3,"biosdate@100-103@sys/arch/i386/stand/libsa/time.c","sys/arch/i386/stand/libsa/time.c","biosdate",100,103
4,1,19,1,3,"biostime@106-109@sys/arch/i386/stand/libsa/time.c","sys/arch/i386/stand/libsa/time.c","biostime",106,109
12,4,92,1,18,"getsecs@115-133@sys/arch/i386/stand/libsa/time.c","sys/arch/i386/stand/libsa/time.c","getsecs",115,133
7,2,35,1,12,"sleep@136-148@sys/arch/i386/stand/libsa/time.c","sys/arch/i386/stand/libsa/time.c","sleep",136,148
4,1,26,3,3,"sendudp@62-65@sys/arch/i386/stand/pxeboot/pxe_udp.c","sys/arch/i386/stand/pxeboot/pxe_udp.c","sendudp",62,65
4,1,31,4,3,"readudp@72-75@sys/arch/i386/stand/pxeboot/pxe_udp.c","sys/arch/i386/stand/pxeboot/pxe_udp.c","readudp",72,75
7,2,49,3,8,"obio_match@64-72@sys/arch/landisk/dev/obio.c","sys/arch/landisk/dev/obio.c","obio_match",64,72
9,1,67,3,11,"obio_attach@75-86@sys/arch/landisk/dev/obio.c","sys/arch/landisk/dev/obio.c","obio_attach",75,86
33,5,255,3,38,"obio_search@89-127@sys/arch/landisk/dev/obio.c","sys/arch/landisk/dev/obio.c","obio_search",89,127
43,12,316,2,46,"obio_print@130-176@sys/arch/landisk/dev/obio.c","sys/arch/landisk/dev/obio.c","obio_print",130,176
5,1,43,5,4,"obio_intr_establish@182-186@sys/arch/landisk/dev/obio.c","sys/arch/landisk/dev/obio.c","obio_intr_establish",182,186
4,1,13,1,3,"obio_intr_disestablish@192-195@sys/arch/landisk/dev/obio.c","sys/arch/landisk/dev/obio.c","obio_intr_disestablish",192,195
38,8,222,4,52,"obio_iomem_add_mapping@228-280@sys/arch/landisk/dev/obio.c","sys/arch/landisk/dev/obio.c","obio_iomem_add_mapping",228,280
13,3,92,5,18,"obio_iomem_map@283-301@sys/arch/landisk/dev/obio.c","sys/arch/landisk/dev/obio.c","obio_iomem_map",283,301
16,5,101,3,28,"obio_iomem_unmap@304-332@sys/arch/landisk/dev/obio.c","sys/arch/landisk/dev/obio.c","obio_iomem_unmap",304,332
6,1,33,5,6,"obio_iomem_subregion@335-341@sys/arch/landisk/dev/obio.c","sys/arch/landisk/dev/obio.c","obio_iomem_subregion",335,341
7,1,47,9,7,"obio_iomem_alloc@344-351@sys/arch/landisk/dev/obio.c","sys/arch/landisk/dev/obio.c","obio_iomem_alloc",344,351
4,1,23,3,3,"obio_iomem_free@354-357@sys/arch/landisk/dev/obio.c","sys/arch/landisk/dev/obio.c","obio_iomem_free",354,357
4,1,20,2,3,"obio_iomem_vaddr@360-363@sys/arch/landisk/dev/obio.c","sys/arch/landisk/dev/obio.c","obio_iomem_vaddr",360,363
4,1,27,3,3,"obio_iomem_read_1@562-565@sys/arch/landisk/dev/obio.c","sys/arch/landisk/dev/obio.c","obio_iomem_read_1",562,565
4,1,27,3,3,"obio_iomem_read_2@568-571@sys/arch/landisk/dev/obio.c","sys/arch/landisk/dev/obio.c","obio_iomem_read_2",568,571
4,1,27,3,3,"obio_iomem_read_4@574-577@sys/arch/landisk/dev/obio.c","sys/arch/landisk/dev/obio.c","obio_iomem_read_4",574,577
8,2,50,5,8,"obio_iomem_read_multi_1@580-588@sys/arch/landisk/dev/obio.c","sys/arch/landisk/dev/obio.c","obio_iomem_read_multi_1",580,588
8,2,50,5,8,"obio_iomem_read_multi_2@591-599@sys/arch/landisk/dev/obio.c","sys/arch/landisk/dev/obio.c","obio_iomem_read_multi_2",591,599
8,2,50,5,8,"obio_iomem_read_multi_4@602-610@sys/arch/landisk/dev/obio.c","sys/arch/landisk/dev/obio.c","obio_iomem_read_multi_4",602,610
10,2,62,5,10,"obio_iomem_read_raw_multi_2@613-623@sys/arch/landisk/dev/obio.c","sys/arch/landisk/dev/obio.c","obio_iomem_read_raw_multi_2",613,623
10,2,62,5,10,"obio_iomem_read_raw_multi_4@626-636@sys/arch/landisk/dev/obio.c","sys/arch/landisk/dev/obio.c","obio_iomem_read_raw_multi_4",626,636
8,2,51,5,8,"obio_iomem_read_region_1@639-647@sys/arch/landisk/dev/obio.c","sys/arch/landisk/dev/obio.c","obio_iomem_read_region_1",639,647
8,2,51,5,8,"obio_iomem_read_region_2@650-658@sys/arch/landisk/dev/obio.c","sys/arch/landisk/dev/obio.c","obio_iomem_read_region_2",650,658
8,2,51,5,8,"obio_iomem_read_region_4@661-669@sys/arch/landisk/dev/obio.c","sys/arch/landisk/dev/obio.c","obio_iomem_read_region_4",661,669
10,2,63,5,10,"obio_iomem_read_raw_region_2@672-682@sys/arch/landisk/dev/obio.c","sys/arch/landisk/dev/obio.c","obio_iomem_read_raw_region_2",672,682
10,2,63,5,10,"obio_iomem_read_raw_region_4@685-695@sys/arch/landisk/dev/obio.c","sys/arch/landisk/dev/obio.c","obio_iomem_read_raw_region_4",685,695
5,1,31,4,4,"obio_iomem_write_1@699-703@sys/arch/landisk/dev/obio.c","sys/arch/landisk/dev/obio.c","obio_iomem_write_1",699,703
5,1,31,4,4,"obio_iomem_write_2@706-710@sys/arch/landisk/dev/obio.c","sys/arch/landisk/dev/obio.c","obio_iomem_write_2",706,710
5,1,31,4,4,"obio_iomem_write_4@713-717@sys/arch/landisk/dev/obio.c","sys/arch/landisk/dev/obio.c","obio_iomem_write_4",713,717
8,2,51,5,8,"obio_iomem_write_multi_1@720-728@sys/arch/landisk/dev/obio.c","sys/arch/landisk/dev/obio.c","obio_iomem_write_multi_1",720,728
8,2,51,5,8,"obio_iomem_write_multi_2@731-739@sys/arch/landisk/dev/obio.c","sys/arch/landisk/dev/obio.c","obio_iomem_write_multi_2",731,739
8,2,51,5,8,"obio_iomem_write_multi_4@742-750@sys/arch/landisk/dev/obio.c","sys/arch/landisk/dev/obio.c","obio_iomem_write_multi_4",742,750
10,2,63,5,10,"obio_iomem_write_raw_multi_2@753-763@sys/arch/landisk/dev/obio.c","sys/arch/landisk/dev/obio.c","obio_iomem_write_raw_multi_2",753,763
10,2,63,5,10,"obio_iomem_write_raw_multi_4@766-776@sys/arch/landisk/dev/obio.c","sys/arch/landisk/dev/obio.c","obio_iomem_write_raw_multi_4",766,776
8,2,52,5,8,"obio_iomem_write_region_1@779-787@sys/arch/landisk/dev/obio.c","sys/arch/landisk/dev/obio.c","obio_iomem_write_region_1",779,787
8,2,52,5,8,"obio_iomem_write_region_2@790-798@sys/arch/landisk/dev/obio.c","sys/arch/landisk/dev/obio.c","obio_iomem_write_region_2",790,798
8,2,52,5,8,"obio_iomem_write_region_4@801-809@sys/arch/landisk/dev/obio.c","sys/arch/landisk/dev/obio.c","obio_iomem_write_region_4",801,809
10,2,64,5,10,"obio_iomem_write_raw_region_2@812-822@sys/arch/landisk/dev/obio.c","sys/arch/landisk/dev/obio.c","obio_iomem_write_raw_region_2",812,822
10,2,64,5,10,"obio_iomem_write_raw_region_4@825-835@sys/arch/landisk/dev/obio.c","sys/arch/landisk/dev/obio.c","obio_iomem_write_raw_region_4",825,835
8,2,47,5,8,"obio_iomem_set_multi_1@838-846@sys/arch/landisk/dev/obio.c","sys/arch/landisk/dev/obio.c","obio_iomem_set_multi_1",838,846
8,2,47,5,8,"obio_iomem_set_multi_2@849-857@sys/arch/landisk/dev/obio.c","sys/arch/landisk/dev/obio.c","obio_iomem_set_multi_2",849,857
8,2,47,5,8,"obio_iomem_set_multi_4@860-868@sys/arch/landisk/dev/obio.c","sys/arch/landisk/dev/obio.c","obio_iomem_set_multi_4",860,868
8,2,48,5,8,"obio_iomem_set_region_1@871-879@sys/arch/landisk/dev/obio.c","sys/arch/landisk/dev/obio.c","obio_iomem_set_region_1",871,879
8,2,48,5,8,"obio_iomem_set_region_2@882-890@sys/arch/landisk/dev/obio.c","sys/arch/landisk/dev/obio.c","obio_iomem_set_region_2",882,890
8,2,48,5,8,"obio_iomem_set_region_4@893-901@sys/arch/landisk/dev/obio.c","sys/arch/landisk/dev/obio.c","obio_iomem_set_region_4",893,901
17,4,106,6,17,"obio_iomem_copy_1@904-921@sys/arch/landisk/dev/obio.c","sys/arch/landisk/dev/obio.c","obio_iomem_copy_1",904,921
17,4,106,6,17,"obio_iomem_copy_2@924-941@sys/arch/landisk/dev/obio.c","sys/arch/landisk/dev/obio.c","obio_iomem_copy_2",924,941
17,4,106,6,17,"obio_iomem_copy_4@944-961@sys/arch/landisk/dev/obio.c","sys/arch/landisk/dev/obio.c","obio_iomem_copy_4",944,961
12,2,78,3,13,"power_match@57-70@sys/arch/landisk/dev/power.c","sys/arch/landisk/dev/power.c","power_match",57,70
12,2,76,3,14,"power_attach@73-87@sys/arch/landisk/dev/power.c","sys/arch/landisk/dev/power.c","power_attach",73,87
21,5,102,1,24,"power_intr@90-114@sys/arch/landisk/dev/power.c","sys/arch/landisk/dev/power.c","power_intr",90,114
30,5,171,1,38,"rs5c313_init@70-108@sys/arch/landisk/dev/rs5c313.c","sys/arch/landisk/dev/rs5c313.c","rs5c313_init",70,108
26,1,171,2,38,"rs5c313_read_reg@111-149@sys/arch/landisk/dev/rs5c313.c","sys/arch/landisk/dev/rs5c313.c","rs5c313_read_reg",111,149
20,1,150,3,28,"rs5c313_write_reg@152-180@sys/arch/landisk/dev/rs5c313.c","sys/arch/landisk/dev/rs5c313.c","rs5c313_write_reg",152,180
35,6,220,3,55,"rs5c313_gettime@183-238@sys/arch/landisk/dev/rs5c313.c","sys/arch/landisk/dev/rs5c313.c","rs5c313_gettime",183,238
34,4,221,2,52,"rs5c313_settime@241-293@sys/arch/landisk/dev/rs5c313.c","sys/arch/landisk/dev/rs5c313.c","rs5c313_settime",241,293
6,1,24,1,5,"rtc_begin@303-308@sys/arch/landisk/dev/rs5c313.c","sys/arch/landisk/dev/rs5c313.c","rtc_begin",303,308
8,2,36,2,7,"rtc_ce@314-321@sys/arch/landisk/dev/rs5c313.c","sys/arch/landisk/dev/rs5c313.c","rtc_ce",314,321
9,2,34,2,9,"rtc_clk@328-337@sys/arch/landisk/dev/rs5c313.c","sys/arch/landisk/dev/rs5c313.c","rtc_clk",328,337
9,2,34,2,9,"rtc_dir@344-353@sys/arch/landisk/dev/rs5c313.c","sys/arch/landisk/dev/rs5c313.c","rtc_dir",344,353
10,2,51,1,13,"rtc_read@359-372@sys/arch/landisk/dev/rs5c313.c","sys/arch/landisk/dev/rs5c313.c","rtc_read",359,372
13,2,58,2,15,"rtc_write@378-393@sys/arch/landisk/dev/rs5c313.c","sys/arch/landisk/dev/rs5c313.c","rtc_write",378,393
7,2,39,3,8,"rs5c313_landisk_match@409-417@sys/arch/landisk/dev/rs5c313.c","sys/arch/landisk/dev/rs5c313.c","rs5c313_landisk_match",409,417
11,2,70,3,13,"rs5c313_landisk_attach@420-433@sys/arch/landisk/dev/rs5c313.c","sys/arch/landisk/dev/rs5c313.c","rs5c313_landisk_attach",420,433
16,6,115,3,21,"wdc_obio_match@82-103@sys/arch/landisk/dev/wdc_obio.c","sys/arch/landisk/dev/wdc_obio.c","wdc_obio_match",82,103
35,4,263,3,41,"wdc_obio_attach@106-147@sys/arch/landisk/dev/wdc_obio.c","sys/arch/landisk/dev/wdc_obio.c","wdc_obio_attach",106,147
9,2,66,2,8,"wdc_obio_read_reg@150-158@sys/arch/landisk/dev/wdc_obio.c","sys/arch/landisk/dev/wdc_obio.c","wdc_obio_read_reg",150,158
9,2,67,3,8,"wdc_obio_write_reg@161-169@sys/arch/landisk/dev/wdc_obio.c","sys/arch/landisk/dev/wdc_obio.c","wdc_obio_write_reg",161,169
3,1,13,2,2,"device_register@45-47@sys/arch/landisk/landisk/autoconf.c","sys/arch/landisk/landisk/autoconf.c","device_register",45,47
10,2,42,1,13,"cpu_configure@50-63@sys/arch/landisk/landisk/autoconf.c","sys/arch/landisk/landisk/autoconf.c","cpu_configure",50,63
8,1,44,1,8,"diskconf@66-74@sys/arch/landisk/landisk/autoconf.c","sys/arch/landisk/landisk/autoconf.c","diskconf",66,74
25,3,188,7,43,"_bus_dmamap_create@84-127@sys/arch/landisk/landisk/bus_dma.c","sys/arch/landisk/landisk/bus_dma.c","_bus_dmamap_create",84,127
5,1,30,2,6,"_bus_dmamap_destroy@133-139@sys/arch/landisk/landisk/bus_dma.c","sys/arch/landisk/landisk/bus_dma.c","_bus_dmamap_destroy",133,139
42,10,308,5,59,"_bus_dmamap_load_paddr@142-201@sys/arch/landisk/landisk/bus_dma.c","sys/arch/landisk/landisk/bus_dma.c","_bus_dmamap_load_paddr",142,201
27,6,169,5,31,"_bus_dmamap_load_vaddr@204-235@sys/arch/landisk/landisk/bus_dma.c","sys/arch/landisk/landisk/bus_dma.c","_bus_dmamap_load_vaddr",204,235
17,4,122,6,22,"_bus_dmamap_load@241-263@sys/arch/landisk/landisk/bus_dma.c","sys/arch/landisk/landisk/bus_dma.c","_bus_dmamap_load",241,263
23,7,142,4,31,"_bus_dmamap_load_mbuf@269-300@sys/arch/landisk/landisk/bus_dma.c","sys/arch/landisk/landisk/bus_dma.c","_bus_dmamap_load_mbuf",269,300
5,1,23,4,5,"_bus_dmamap_load_uio@306-311@sys/arch/landisk/landisk/bus_dma.c","sys/arch/landisk/landisk/bus_dma.c","_bus_dmamap_load_uio",306,311
5,1,28,6,5,"_bus_dmamap_load_raw@318-323@sys/arch/landisk/landisk/bus_dma.c","sys/arch/landisk/landisk/bus_dma.c","_bus_dmamap_load_raw",318,323
6,1,33,2,7,"_bus_dmamap_unload@329-336@sys/arch/landisk/landisk/bus_dma.c","sys/arch/landisk/landisk/bus_dma.c","_bus_dmamap_unload",329,336
64,22,392,5,88,"_bus_dmamap_sync@342-430@sys/arch/landisk/landisk/bus_dma.c","sys/arch/landisk/landisk/bus_dma.c","_bus_dmamap_sync",342,430
40,6,300,8,57,"_bus_dmamem_alloc@436-493@sys/arch/landisk/landisk/bus_dma.c","sys/arch/landisk/landisk/bus_dma.c","_bus_dmamem_alloc",436,493
20,3,153,3,25,"_bus_dmamem_free@500-525@sys/arch/landisk/landisk/bus_dma.c","sys/arch/landisk/landisk/bus_dma.c","_bus_dmamem_free",500,525
37,8,298,6,46,"_bus_dmamem_map@529-575@sys/arch/landisk/landisk/bus_dma.c","sys/arch/landisk/landisk/bus_dma.c","_bus_dmamem_map",529,575
14,5,101,3,22,"_bus_dmamem_unmap@578-600@sys/arch/landisk/landisk/bus_dma.c","sys/arch/landisk/landisk/bus_dma.c","_bus_dmamem_unmap",578,600
5,1,32,6,6,"_bus_dmamem_mmap@603-609@sys/arch/landisk/landisk/bus_dma.c","sys/arch/landisk/landisk/bus_dma.c","_bus_dmamem_mmap",603,609
4,1,14,1,4,"machine_clock_init@42-46@sys/arch/landisk/landisk/clock_machdep.c","sys/arch/landisk/landisk/clock_machdep.c","machine_clock_init",42,46
3,1,8,1,3,"landisk_rtc_init@49-52@sys/arch/landisk/landisk/clock_machdep.c","sys/arch/landisk/landisk/clock_machdep.c","landisk_rtc_init",49,52
5,2,26,1,4,"iskmemdev@377-381@sys/arch/landisk/landisk/conf.c","sys/arch/landisk/landisk/conf.c","iskmemdev",377,381
5,2,26,1,4,"iszerodev@387-391@sys/arch/landisk/landisk/conf.c","sys/arch/landisk/landisk/conf.c","iszerodev",387,391
4,1,14,1,3,"getnulldev@428-431@sys/arch/landisk/landisk/conf.c","sys/arch/landisk/landisk/conf.c","getnulldev",428,431
8,2,24,1,9,"consinit@59-68@sys/arch/landisk/landisk/consinit.c","sys/arch/landisk/landisk/consinit.c","consinit",59,68
26,8,157,4,35,"readdisklabel@56-91@sys/arch/landisk/landisk/disksubr.c","sys/arch/landisk/landisk/disksubr.c","readdisklabel",56,91
30,4,213,3,36,"writedisklabel@97-133@sys/arch/landisk/landisk/disksubr.c","sys/arch/landisk/landisk/disksubr.c","writedisklabel",97,133
45,16,307,3,52,"intc_intr@70-122@sys/arch/landisk/landisk/intr.c","sys/arch/landisk/landisk/intr.c","intc_intr",70,122
4,1,13,1,3,"intr_init@125-128@sys/arch/landisk/landisk/intr.c","sys/arch/landisk/landisk/intr.c","intr_init",125,128
48,12,340,5,76,"extintr_establish@131-207@sys/arch/landisk/landisk/intr.c","sys/arch/landisk/landisk/intr.c","extintr_establish",131,207
25,7,174,1,40,"extintr_disestablish@210-250@sys/arch/landisk/landisk/intr.c","sys/arch/landisk/landisk/intr.c","extintr_disestablish",210,250
28,6,166,1,33,"extintr_enable@253-286@sys/arch/landisk/landisk/intr.c","sys/arch/landisk/landisk/intr.c","extintr_enable",253,286
28,6,167,1,33,"extintr_disable@289-322@sys/arch/landisk/landisk/intr.c","sys/arch/landisk/landisk/intr.c","extintr_disable",289,322
15,3,92,1,17,"extintr_disable_by_num@325-342@sys/arch/landisk/landisk/intr.c","sys/arch/landisk/landisk/intr.c","extintr_disable_by_num",325,342
4,1,11,1,3,"fakeintr@345-348@sys/arch/landisk/landisk/intr.c","sys/arch/landisk/landisk/intr.c","fakeintr",345,348
20,6,111,1,20,"extintr_intr_handler@351-371@sys/arch/landisk/landisk/intr.c","sys/arch/landisk/landisk/intr.c","extintr_intr_handler",351,371
11,2,65,2,16,"splassert_check@375-391@sys/arch/landisk/landisk/intr.c","sys/arch/landisk/landisk/intr.c","splassert_check",375,391
6,1,27,1,7,"cpu_startup@129-136@sys/arch/landisk/landisk/machdep.c","sys/arch/landisk/landisk/machdep.c","cpu_startup",129,136
31,6,180,2,50,"landisk_startup@142-192@sys/arch/landisk/landisk/machdep.c","sys/arch/landisk/landisk/machdep.c","landisk_startup",142,192
43,9,205,1,52,"boot@195-247@sys/arch/landisk/landisk/machdep.c","sys/arch/landisk/landisk/machdep.c","boot",195,247
9,2,40,1,10,"machine_reset@250-260@sys/arch/landisk/landisk/machdep.c","sys/arch/landisk/landisk/machdep.c","machine_reset",250,260
21,11,126,1,110,"InitializeBsc@270-380@sys/arch/landisk/landisk/machdep.c","sys/arch/landisk/landisk/machdep.c","InitializeBsc",270,380
22,3,196,2,30,"cpu_dump@387-417@sys/arch/landisk/landisk/machdep.c","sys/arch/landisk/landisk/machdep.c","cpu_dump",387,417
6,1,43,1,6,"cpu_dumpsize@423-429@sys/arch/landisk/landisk/machdep.c","sys/arch/landisk/landisk/machdep.c","cpu_dumpsize",423,429
16,2,112,1,17,"cpu_init_kcore_hdr@435-452@sys/arch/landisk/landisk/machdep.c","sys/arch/landisk/landisk/machdep.c","cpu_init_kcore_hdr",435,452
26,6,145,7,31,"cpu_sysctl@455-486@sys/arch/landisk/landisk/machdep.c","sys/arch/landisk/landisk/machdep.c","cpu_sysctl",455,486
16,2,96,1,18,"blink_led@489-507@sys/arch/landisk/landisk/machdep.c","sys/arch/landisk/landisk/machdep.c","blink_led",489,507
6,2,31,3,7,"mainbus_match@59-66@sys/arch/landisk/landisk/mainbus.c","sys/arch/landisk/landisk/mainbus.c","mainbus_match",59,66
25,3,194,3,38,"mainbus_attach@69-107@sys/arch/landisk/landisk/mainbus.c","sys/arch/landisk/landisk/mainbus.c","mainbus_attach",69,107
4,2,22,2,4,"mainbus_print@110-114@sys/arch/landisk/landisk/mainbus.c","sys/arch/landisk/landisk/mainbus.c","mainbus_print",110,114
5,1,15,1,5,"shpcic_get_bus_io_tag@58-63@sys/arch/landisk/landisk/shpcic_machdep.c","sys/arch/landisk/landisk/shpcic_machdep.c","shpcic_get_bus_io_tag",58,63
5,1,15,1,5,"shpcic_get_bus_mem_tag@66-71@sys/arch/landisk/landisk/shpcic_machdep.c","sys/arch/landisk/landisk/shpcic_machdep.c","shpcic_get_bus_mem_tag",66,71
5,1,15,1,5,"shpcic_get_bus_dma_tag@74-79@sys/arch/landisk/landisk/shpcic_machdep.c","sys/arch/landisk/landisk/shpcic_machdep.c","shpcic_get_bus_dma_tag",74,79
4,1,19,3,4,"landisk_pci_attach_hook@82-86@sys/arch/landisk/landisk/shpcic_machdep.c","sys/arch/landisk/landisk/shpcic_machdep.c","landisk_pci_attach_hook",82,86
27,9,163,2,35,"landisk_pci_intr_map@89-124@sys/arch/landisk/landisk/shpcic_machdep.c","sys/arch/landisk/landisk/shpcic_machdep.c","landisk_pci_intr_map",89,124
8,2,48,2,10,"landisk_pci_intr_string@127-137@sys/arch/landisk/landisk/shpcic_machdep.c","sys/arch/landisk/landisk/shpcic_machdep.c","landisk_pci_intr_string",127,137
7,2,60,6,7,"landisk_pci_intr_establish@140-147@sys/arch/landisk/landisk/shpcic_machdep.c","sys/arch/landisk/landisk/shpcic_machdep.c","landisk_pci_intr_establish",140,147
4,1,17,2,3,"landisk_pci_intr_disestablish@150-153@sys/arch/landisk/landisk/shpcic_machdep.c","sys/arch/landisk/landisk/shpcic_machdep.c","landisk_pci_intr_disestablish",150,153
9,5,88,6,9,"landisk_pci_conf_interrupt@157-166@sys/arch/landisk/landisk/shpcic_machdep.c","sys/arch/landisk/landisk/shpcic_machdep.c","landisk_pci_conf_interrupt",157,166
4,1,27,5,4,"landisk_pci_conf_hook@169-173@sys/arch/landisk/landisk/shpcic_machdep.c","sys/arch/landisk/landisk/shpcic_machdep.c","landisk_pci_conf_hook",169,173
9,1,44,1,10,"tick_init@93-103@sys/arch/landisk/stand/boot/delay.c","sys/arch/landisk/stand/boot/delay.c","tick_init",93,103
4,1,13,1,4,"tick_stop@106-110@sys/arch/landisk/stand/boot/delay.c","sys/arch/landisk/stand/boot/delay.c","tick_stop",106,110
4,1,14,1,4,"gettick@113-117@sys/arch/landisk/stand/boot/delay.c","sys/arch/landisk/stand/boot/delay.c","gettick",113,117
11,3,49,1,11,"delay@120-131@sys/arch/landisk/stand/boot/delay.c","sys/arch/landisk/stand/boot/delay.c","delay",120,131
5,1,14,1,4,"machdep@27-31@sys/arch/landisk/stand/boot/devs.c","sys/arch/landisk/stand/boot/devs.c","machdep",27,31
9,4,76,3,9,"devopen@34-43@sys/arch/landisk/stand/boot/devs.c","sys/arch/landisk/stand/boot/devs.c","devopen",34,43
7,1,36,2,6,"devboot@46-52@sys/arch/landisk/stand/boot/devs.c","sys/arch/landisk/stand/boot/devs.c","devboot",46,52
4,1,10,1,3,"ttyname@55-58@sys/arch/landisk/stand/boot/devs.c","sys/arch/landisk/stand/boot/devs.c","ttyname",55,58
4,1,11,1,3,"ttydev@61-64@sys/arch/landisk/stand/boot/devs.c","sys/arch/landisk/stand/boot/devs.c","ttydev",61,64
5,1,18,2,4,"cnspeed@67-71@sys/arch/landisk/stand/boot/devs.c","sys/arch/landisk/stand/boot/devs.c","cnspeed",67,71
8,1,57,2,9,"run_loadfile@74-83@sys/arch/landisk/stand/boot/devs.c","sys/arch/landisk/stand/boot/devs.c","run_loadfile",74,83
4,1,14,2,3,"blkdevopen@86-89@sys/arch/landisk/stand/boot/devs.c","sys/arch/landisk/stand/boot/devs.c","blkdevopen",86,89
13,6,85,6,17,"blkdevstrategy@92-109@sys/arch/landisk/stand/boot/devs.c","sys/arch/landisk/stand/boot/devs.c","blkdevstrategy",92,109
4,1,12,1,3,"blkdevclose@112-115@sys/arch/landisk/stand/boot/devs.c","sys/arch/landisk/stand/boot/devs.c","blkdevclose",112,115
6,1,21,1,6,"rtc_init@29-35@sys/arch/landisk/stand/boot/getsecs.c","sys/arch/landisk/stand/boot/getsecs.c","rtc_init",29,35
9,2,45,1,9,"rtc_ce@39-48@sys/arch/landisk/stand/boot/getsecs.c","sys/arch/landisk/stand/boot/getsecs.c","rtc_ce",39,48
9,2,29,1,9,"rtc_clk@51-60@sys/arch/landisk/stand/boot/getsecs.c","sys/arch/landisk/stand/boot/getsecs.c","rtc_clk",51,60
9,2,29,1,9,"rtc_dir@63-72@sys/arch/landisk/stand/boot/getsecs.c","sys/arch/landisk/stand/boot/getsecs.c","rtc_dir",63,72
11,2,39,1,12,"rtc_do@76-88@sys/arch/landisk/stand/boot/getsecs.c","sys/arch/landisk/stand/boot/getsecs.c","rtc_do",76,88
8,2,34,1,10,"rtc_di@92-102@sys/arch/landisk/stand/boot/getsecs.c","sys/arch/landisk/stand/boot/getsecs.c","rtc_di",92,102
29,1,154,1,33,"rtc_read@105-138@sys/arch/landisk/stand/boot/getsecs.c","sys/arch/landisk/stand/boot/getsecs.c","rtc_read",105,138
23,1,125,2,26,"rtc_write@141-167@sys/arch/landisk/stand/boot/getsecs.c","sys/arch/landisk/stand/boot/getsecs.c","rtc_write",141,167
24,5,160,1,36,"getsecs@170-206@sys/arch/landisk/stand/boot/getsecs.c","sys/arch/landisk/stand/boot/getsecs.c","getsecs",170,206
14,1,80,1,29,"scif_init@134-163@sys/arch/landisk/stand/boot/scifcons.c","sys/arch/landisk/stand/boot/scifcons.c","scif_init",134,163
4,1,15,1,3,"scif_cnprobe@166-169@sys/arch/landisk/stand/boot/scifcons.c","sys/arch/landisk/stand/boot/scifcons.c","scif_cnprobe",166,169
4,1,14,1,3,"scif_cninit@172-175@sys/arch/landisk/stand/boot/scifcons.c","sys/arch/landisk/stand/boot/scifcons.c","scif_cninit",172,175
35,9,202,1,40,"scif_cngetc@178-218@sys/arch/landisk/stand/boot/scifcons.c","sys/arch/landisk/stand/boot/scifcons.c","scif_cngetc",178,218
7,2,42,2,12,"scif_cnputc@221-233@sys/arch/landisk/stand/boot/scifcons.c","sys/arch/landisk/stand/boot/scifcons.c","scif_cnputc",221,233
27,11,175,1,41,"boot1@66-107@sys/arch/landisk/stand/xxboot/boot1.c","sys/arch/landisk/stand/xxboot/boot1.c","boot1",66,107
4,1,14,2,3,"blkdevopen@110-113@sys/arch/landisk/stand/xxboot/boot1.c","sys/arch/landisk/stand/xxboot/boot1.c","blkdevopen",110,113
4,1,12,1,3,"blkdevclose@115-118@sys/arch/landisk/stand/xxboot/boot1.c","sys/arch/landisk/stand/xxboot/boot1.c","blkdevclose",115,118
13,6,85,6,17,"blkdevstrategy@121-138@sys/arch/landisk/stand/xxboot/boot1.c","sys/arch/landisk/stand/xxboot/boot1.c","blkdevstrategy",121,138
4,1,10,1,4,"raise@142-146@sys/arch/landisk/stand/xxboot/boot1.c","sys/arch/landisk/stand/xxboot/boot1.c","raise",142,146
6,1,26,1,6,"twiddle@149-155@sys/arch/landisk/stand/xxboot/boot1.c","sys/arch/landisk/stand/xxboot/boot1.c","twiddle",149,155
7,1,48,3,6,"devopen@158-164@sys/arch/landisk/stand/xxboot/boot1.c","sys/arch/landisk/stand/xxboot/boot1.c","devopen",158,164
7,3,53,3,12,"apmmatch@121-133@sys/arch/loongson/dev/apm.c","sys/arch/loongson/dev/apm.c","apmmatch",121,133
5,1,27,3,6,"apmattach@136-142@sys/arch/loongson/dev/apm.c","sys/arch/loongson/dev/apm.c","apmattach",136,142
34,10,180,4,37,"apmopen@145-182@sys/arch/loongson/dev/apm.c","sys/arch/loongson/dev/apm.c","apmopen",145,182
18,6,106,4,21,"apmclose@185-206@sys/arch/loongson/dev/apm.c","sys/arch/loongson/dev/apm.c","apmclose",185,206
69,24,332,5,75,"apmioctl@209-284@sys/arch/loongson/dev/apm.c","sys/arch/loongson/dev/apm.c","apmioctl",209,284
5,1,37,1,5,"filt_apmrdetach@287-292@sys/arch/loongson/dev/apm.c","sys/arch/loongson/dev/apm.c","filt_apmrdetach",287,292
6,3,35,2,7,"filt_apmread@295-302@sys/arch/loongson/dev/apm.c","sys/arch/loongson/dev/apm.c","filt_apmread",295,302
17,5,102,2,21,"apmkqfilter@305-326@sys/arch/loongson/dev/apm.c","sys/arch/loongson/dev/apm.c","apmkqfilter",305,326
8,1,39,1,7,"apm_getdefaultinfo@329-336@sys/arch/loongson/dev/apm.c","sys/arch/loongson/dev/apm.c","apm_getdefaultinfo",329,336
4,1,19,1,3,"apm_setinfohook@339-342@sys/arch/loongson/dev/apm.c","sys/arch/loongson/dev/apm.c","apm_setinfohook",339,342
14,5,117,3,20,"apm_record_event@345-365@sys/arch/loongson/dev/apm.c","sys/arch/loongson/dev/apm.c","apm_record_event",345,365
42,8,192,1,66,"apm_suspend@368-434@sys/arch/loongson/dev/apm.c","sys/arch/loongson/dev/apm.c","apm_suspend",368,434
9,3,60,3,11,"bonito_match@204-215@sys/arch/loongson/dev/bonito.c","sys/arch/loongson/dev/bonito.c","bonito_match",204,215
95,12,659,3,142,"bonito_attach@218-360@sys/arch/loongson/dev/bonito.c","sys/arch/loongson/dev/bonito.c","bonito_attach",218,360
4,1,12,1,3,"bonito_pa_to_device@363-366@sys/arch/loongson/dev/bonito.c","sys/arch/loongson/dev/bonito.c","bonito_pa_to_device",363,366
4,1,12,1,3,"bonito_device_to_pa@369-372@sys/arch/loongson/dev/bonito.c","sys/arch/loongson/dev/bonito.c","bonito_device_to_pa",369,372
8,2,47,2,9,"bonito_print@375-384@sys/arch/loongson/dev/bonito.c","sys/arch/loongson/dev/bonito.c","bonito_print",375,384
26,7,200,6,41,"bonito_intr_establish@391-432@sys/arch/loongson/dev/bonito.c","sys/arch/loongson/dev/bonito.c","bonito_intr_establish",391,432
23,11,175,1,39,"bonito_intr_disestablish@435-474@sys/arch/loongson/dev/bonito.c","sys/arch/loongson/dev/bonito.c","bonito_intr_disestablish",435,474
11,3,57,1,13,"bonito_splx@481-494@sys/arch/loongson/dev/bonito.c","sys/arch/loongson/dev/bonito.c","bonito_splx",481,494
19,3,101,1,23,"bonito_setintrmask@497-520@sys/arch/loongson/dev/bonito.c","sys/arch/loongson/dev/bonito.c","bonito_setintrmask",497,520
25,6,192,0,45,"bonito_intr_makemasks@526-571@sys/arch/loongson/dev/bonito.c","sys/arch/loongson/dev/bonito.c","bonito_intr_makemasks",526,571
27,6,159,2,54,"bonito_intr_2e@578-632@sys/arch/loongson/dev/bonito.c","sys/arch/loongson/dev/bonito.c","bonito_intr_2e",578,632
24,5,134,2,44,"bonito_intr_2f@635-679@sys/arch/loongson/dev/bonito.c","sys/arch/loongson/dev/bonito.c","bonito_intr_2f",635,679
41,12,269,3,48,"bonito_intr_dispatch@682-730@sys/arch/loongson/dev/bonito.c","sys/arch/loongson/dev/bonito.c","bonito_intr_dispatch",682,730
10,2,65,3,11,"bonito_attach_hook@737-748@sys/arch/loongson/dev/bonito.c","sys/arch/loongson/dev/bonito.c","bonito_attach_hook",737,748
6,2,41,2,6,"bonito_bus_maxdevs@755-761@sys/arch/loongson/dev/bonito.c","sys/arch/loongson/dev/bonito.c","bonito_bus_maxdevs",755,761
4,1,39,4,3,"bonito_make_tag@764-767@sys/arch/loongson/dev/bonito.c","sys/arch/loongson/dev/bonito.c","bonito_make_tag",764,767
9,4,77,5,8,"bonito_decompose_tag@770-778@sys/arch/loongson/dev/bonito.c","sys/arch/loongson/dev/bonito.c","bonito_decompose_tag",770,778
17,3,112,5,19,"bonito_conf_addr@781-800@sys/arch/loongson/dev/bonito.c","sys/arch/loongson/dev/bonito.c","bonito_conf_addr",781,800
15,2,117,4,16,"bonito_pci_hook@811-827@sys/arch/loongson/dev/bonito.c","sys/arch/loongson/dev/bonito.c","bonito_pci_hook",811,827
4,1,14,2,3,"bonito_conf_size@830-833@sys/arch/loongson/dev/bonito.c","sys/arch/loongson/dev/bonito.c","bonito_conf_size",830,833
13,3,91,3,14,"bonito_conf_read@836-850@sys/arch/loongson/dev/bonito.c","sys/arch/loongson/dev/bonito.c","bonito_conf_read",836,850
30,3,194,3,41,"bonito_conf_read_internal@853-894@sys/arch/loongson/dev/bonito.c","sys/arch/loongson/dev/bonito.c","bonito_conf_read_internal",853,894
29,4,211,4,38,"bonito_conf_write@897-935@sys/arch/loongson/dev/bonito.c","sys/arch/loongson/dev/bonito.c","bonito_conf_write",897,935
24,7,183,2,31,"bonito_pci_intr_map@942-973@sys/arch/loongson/dev/bonito.c","sys/arch/loongson/dev/bonito.c","bonito_pci_intr_map",942,973
10,2,58,2,10,"bonito_pci_intr_string@976-986@sys/arch/loongson/dev/bonito.c","sys/arch/loongson/dev/bonito.c","bonito_pci_intr_string",976,986
5,1,48,6,4,"bonito_pci_intr_establish@989-993@sys/arch/loongson/dev/bonito.c","sys/arch/loongson/dev/bonito.c","bonito_pci_intr_establish",989,993
4,1,17,2,3,"bonito_pci_intr_disestablish@996-999@sys/arch/loongson/dev/bonito.c","sys/arch/loongson/dev/bonito.c","bonito_pci_intr_disestablish",996,999
18,7,111,5,21,"bonito_io_map@1013-1034@sys/arch/loongson/dev/bonito.c","sys/arch/loongson/dev/bonito.c","bonito_io_map",1013,1034
60,18,363,5,92,"bonito_mem_map@1046-1138@sys/arch/loongson/dev/bonito.c","sys/arch/loongson/dev/bonito.c","bonito_mem_map",1046,1138
52,12,286,2,66,"bonito_get_resource_extent@1145-1211@sys/arch/loongson/dev/bonito.c","sys/arch/loongson/dev/bonito.c","bonito_get_resource_extent",1145,1211
4,1,25,3,3,"bonito_make_tag_early@1221-1224@sys/arch/loongson/dev/bonito.c","sys/arch/loongson/dev/bonito.c","bonito_make_tag_early",1221,1224
4,1,22,2,3,"bonito_conf_read_early@1227-1230@sys/arch/loongson/dev/bonito.c","sys/arch/loongson/dev/bonito.c","bonito_conf_read_early",1227,1230
7,1,23,0,7,"bonito_early_setup@1233-1240@sys/arch/loongson/dev/bonito.c","sys/arch/loongson/dev/bonito.c","bonito_early_setup",1233,1240
7,2,45,3,8,"com_leioc_match@50-58@sys/arch/loongson/dev/com_leioc.c","sys/arch/loongson/dev/com_leioc.c","com_leioc_match",50,58
30,7,200,3,35,"com_leioc_attach@61-96@sys/arch/loongson/dev/com_leioc.c","sys/arch/loongson/dev/com_leioc.c","com_leioc_attach",61,96
5,1,16,1,11,"com_leioc_intr@99-110@sys/arch/loongson/dev/com_leioc.c","sys/arch/loongson/dev/com_leioc.c","com_leioc_intr",99,110
9,1,41,1,8,"leioc_cons_setup@113-121@sys/arch/loongson/dev/com_leioc.c","sys/arch/loongson/dev/com_leioc.c","leioc_cons_setup",113,121
17,8,83,1,24,"gdiumiic_bustype@103-127@sys/arch/loongson/dev/gdiumiic.c","sys/arch/loongson/dev/gdiumiic.c","gdiumiic_bustype",103,127
9,4,72,3,10,"gdiumiic_match@130-140@sys/arch/loongson/dev/gdiumiic.c","sys/arch/loongson/dev/gdiumiic.c","gdiumiic_match",130,140
79,16,548,3,96,"gdiumiic_attach@143-239@sys/arch/loongson/dev/gdiumiic.c","sys/arch/loongson/dev/gdiumiic.c","gdiumiic_attach",143,239
4,1,17,2,3,"gdiumiic_detach@242-245@sys/arch/loongson/dev/gdiumiic.c","sys/arch/loongson/dev/gdiumiic.c","gdiumiic_detach",242,245
7,3,48,2,8,"gdiumiic_i2c_acquire_bus@248-256@sys/arch/loongson/dev/gdiumiic.c","sys/arch/loongson/dev/gdiumiic.c","gdiumiic_i2c_acquire_bus",248,256
7,3,38,2,8,"gdiumiic_i2c_release_bus@259-267@sys/arch/loongson/dev/gdiumiic.c","sys/arch/loongson/dev/gdiumiic.c","gdiumiic_i2c_release_bus",259,267
4,1,24,2,3,"gdiumiic_i2c_send_start@270-273@sys/arch/loongson/dev/gdiumiic.c","sys/arch/loongson/dev/gdiumiic.c","gdiumiic_i2c_send_start",270,273
4,1,24,2,3,"gdiumiic_i2c_send_stop@276-279@sys/arch/loongson/dev/gdiumiic.c","sys/arch/loongson/dev/gdiumiic.c","gdiumiic_i2c_send_stop",276,279
4,1,29,3,3,"gdiumiic_i2c_initiate_xfer@282-285@sys/arch/loongson/dev/gdiumiic.c","sys/arch/loongson/dev/gdiumiic.c","gdiumiic_i2c_initiate_xfer",282,285
4,1,30,3,3,"gdiumiic_i2c_read_byte@288-291@sys/arch/loongson/dev/gdiumiic.c","sys/arch/loongson/dev/gdiumiic.c","gdiumiic_i2c_read_byte",288,291
4,1,29,3,3,"gdiumiic_i2c_write_byte@294-297@sys/arch/loongson/dev/gdiumiic.c","sys/arch/loongson/dev/gdiumiic.c","gdiumiic_i2c_write_byte",294,297
8,3,62,2,8,"gdiumiic_bb_set_bits@300-308@sys/arch/loongson/dev/gdiumiic.c","sys/arch/loongson/dev/gdiumiic.c","gdiumiic_bb_set_bits",300,308
14,6,100,2,16,"gdiumiic_bb_set_dir@311-327@sys/arch/loongson/dev/gdiumiic.c","sys/arch/loongson/dev/gdiumiic.c","gdiumiic_bb_set_dir",311,327
12,3,67,1,13,"gdiumiic_bb_read_bits@330-343@sys/arch/loongson/dev/gdiumiic.c","sys/arch/loongson/dev/gdiumiic.c","gdiumiic_bb_read_bits",330,343
24,1,169,3,27,"gdiumiic_sensors_scan@352-379@sys/arch/loongson/dev/gdiumiic.c","sys/arch/loongson/dev/gdiumiic.c","gdiumiic_sensors_scan",352,379
23,1,153,3,44,"glx_init@84-128@sys/arch/loongson/dev/glx.c","sys/arch/loongson/dev/glx.c","glx_init",84,128
13,3,86,1,16,"rdmsr@131-147@sys/arch/loongson/dev/glx.c","sys/arch/loongson/dev/glx.c","rdmsr",131,147
11,3,74,2,14,"wrmsr@150-164@sys/arch/loongson/dev/glx.c","sys/arch/loongson/dev/glx.c","wrmsr",150,164
35,13,164,5,42,"glx_pci_read_hook@167-209@sys/arch/loongson/dev/glx.c","sys/arch/loongson/dev/glx.c","glx_pci_read_hook",167,209
34,13,153,5,40,"glx_pci_write_hook@212-252@sys/arch/loongson/dev/glx.c","sys/arch/loongson/dev/glx.c","glx_pci_write_hook",212,252
20,6,108,0,21,"glx_get_status@255-276@sys/arch/loongson/dev/glx.c","sys/arch/loongson/dev/glx.c","glx_get_status",255,276
60,18,301,1,61,"glx_fn0_read@303-364@sys/arch/loongson/dev/glx.c","sys/arch/loongson/dev/glx.c","glx_fn0_read",303,364
53,17,312,2,54,"glx_fn0_write@367-421@sys/arch/loongson/dev/glx.c","sys/arch/loongson/dev/glx.c","glx_fn0_write",367,421
59,14,288,1,64,"glx_fn2_read@431-495@sys/arch/loongson/dev/glx.c","sys/arch/loongson/dev/glx.c","glx_fn2_read",431,495
43,10,205,2,46,"glx_fn2_write@498-544@sys/arch/loongson/dev/glx.c","sys/arch/loongson/dev/glx.c","glx_fn2_write",498,544
51,11,256,1,52,"glx_fn3_read@554-606@sys/arch/loongson/dev/glx.c","sys/arch/loongson/dev/glx.c","glx_fn3_read",554,606
38,7,191,2,38,"glx_fn3_write@609-647@sys/arch/loongson/dev/glx.c","sys/arch/loongson/dev/glx.c","glx_fn3_write",609,647
57,14,274,1,58,"glx_fn4_read@657-715@sys/arch/loongson/dev/glx.c","sys/arch/loongson/dev/glx.c","glx_fn4_read",657,715
49,8,243,2,50,"glx_fn4_write@718-768@sys/arch/loongson/dev/glx.c","sys/arch/loongson/dev/glx.c","glx_fn4_write",718,768
62,15,306,1,63,"glx_fn5_read@778-841@sys/arch/loongson/dev/glx.c","sys/arch/loongson/dev/glx.c","glx_fn5_read",778,841
49,8,243,2,50,"glx_fn5_write@844-894@sys/arch/loongson/dev/glx.c","sys/arch/loongson/dev/glx.c","glx_fn5_write",844,894
8,2,54,3,9,"glxclk_match@98-107@sys/arch/loongson/dev/glxclk.c","sys/arch/loongson/dev/glxclk.c","glxclk_match",98,107
78,6,514,3,150,"glxclk_attach@110-260@sys/arch/loongson/dev/glxclk.c","sys/arch/loongson/dev/glxclk.c","glxclk_attach",110,260
6,1,26,1,6,"glxclk_startclock@263-269@sys/arch/loongson/dev/glxclk.c","sys/arch/loongson/dev/glxclk.c","glxclk_startclock",263,269
15,2,82,1,19,"glxclk_intr@272-291@sys/arch/loongson/dev/glxclk.c","sys/arch/loongson/dev/glxclk.c","glxclk_intr",272,291
23,3,136,1,34,"glxclk_stat_intr@294-328@sys/arch/loongson/dev/glxclk.c","sys/arch/loongson/dev/glxclk.c","glxclk_stat_intr",294,328
9,4,58,3,11,"htb_match@154-165@sys/arch/loongson/dev/htb.c","sys/arch/loongson/dev/htb.c","htb_match",154,165
41,3,297,3,45,"htb_attach@168-213@sys/arch/loongson/dev/htb.c","sys/arch/loongson/dev/htb.c","htb_attach",168,213
8,2,47,2,9,"htb_print@216-225@sys/arch/loongson/dev/htb.c","sys/arch/loongson/dev/htb.c","htb_print",216,225
9,2,60,3,9,"htb_attach_hook@228-237@sys/arch/loongson/dev/htb.c","sys/arch/loongson/dev/htb.c","htb_attach_hook",228,237
4,1,14,2,3,"htb_bus_maxdevs@240-243@sys/arch/loongson/dev/htb.c","sys/arch/loongson/dev/htb.c","htb_bus_maxdevs",240,243
4,1,39,4,3,"htb_make_tag@246-249@sys/arch/loongson/dev/htb.c","sys/arch/loongson/dev/htb.c","htb_make_tag",246,249
9,4,77,5,8,"htb_decompose_tag@252-260@sys/arch/loongson/dev/htb.c","sys/arch/loongson/dev/htb.c","htb_decompose_tag",252,260
5,1,28,5,4,"htb_conf_addr@263-267@sys/arch/loongson/dev/htb.c","sys/arch/loongson/dev/htb.c","htb_conf_addr",263,267
4,1,14,2,3,"htb_conf_size@270-273@sys/arch/loongson/dev/htb.c","sys/arch/loongson/dev/htb.c","htb_conf_size",270,273
4,1,25,3,3,"htb_conf_read@276-279@sys/arch/loongson/dev/htb.c","sys/arch/loongson/dev/htb.c","htb_conf_read",276,279
4,1,29,4,3,"htb_conf_write@282-285@sys/arch/loongson/dev/htb.c","sys/arch/loongson/dev/htb.c","htb_conf_write",282,285
11,2,56,2,11,"htb_cfg_space_addr@288-299@sys/arch/loongson/dev/htb.c","sys/arch/loongson/dev/htb.c","htb_cfg_space_addr",288,299
24,6,156,2,29,"htb_pci_intr_map@306-335@sys/arch/loongson/dev/htb.c","sys/arch/loongson/dev/htb.c","htb_pci_intr_map",306,335
6,1,35,2,6,"htb_pci_intr_string@338-344@sys/arch/loongson/dev/htb.c","sys/arch/loongson/dev/htb.c","htb_pci_intr_string",338,344
5,1,46,6,4,"htb_pci_intr_establish@347-351@sys/arch/loongson/dev/htb.c","sys/arch/loongson/dev/htb.c","htb_pci_intr_establish",347,351
4,1,17,2,3,"htb_pci_intr_disestablish@354-357@sys/arch/loongson/dev/htb.c","sys/arch/loongson/dev/htb.c","htb_pci_intr_disestablish",354,357
4,1,12,1,3,"htb_pa_to_device@360-363@sys/arch/loongson/dev/htb.c","sys/arch/loongson/dev/htb.c","htb_pa_to_device",360,363
4,1,12,1,3,"htb_device_to_pa@366-369@sys/arch/loongson/dev/htb.c","sys/arch/loongson/dev/htb.c","htb_device_to_pa",366,369
21,8,122,5,23,"htb_io_map@376-399@sys/arch/loongson/dev/htb.c","sys/arch/loongson/dev/htb.c","htb_io_map",376,399
8,3,49,5,8,"htb_mem_map@402-410@sys/arch/loongson/dev/htb.c","sys/arch/loongson/dev/htb.c","htb_mem_map",402,410
5,1,24,5,4,"htb_mem_mmap@413-417@sys/arch/loongson/dev/htb.c","sys/arch/loongson/dev/htb.c","htb_mem_mmap",413,417
7,1,24,1,7,"htb_early_setup@424-431@sys/arch/loongson/dev/htb.c","sys/arch/loongson/dev/htb.c","htb_early_setup",424,431
4,1,25,3,3,"htb_make_tag_early@434-437@sys/arch/loongson/dev/htb.c","sys/arch/loongson/dev/htb.c","htb_make_tag_early",434,437
4,1,20,2,3,"htb_conf_read_early@440-443@sys/arch/loongson/dev/htb.c","sys/arch/loongson/dev/htb.c","htb_conf_read_early",440,443
17,9,136,3,24,"ykbec_match@131-155@sys/arch/loongson/dev/kb3310.c","sys/arch/loongson/dev/kb3310.c","ykbec_match",131,155
34,10,272,3,51,"ykbec_attach@158-209@sys/arch/loongson/dev/kb3310.c","sys/arch/loongson/dev/kb3310.c","ykbec_attach",158,209
9,1,88,3,9,"ykbec_write@212-221@sys/arch/loongson/dev/kb3310.c","sys/arch/loongson/dev/kb3310.c","ykbec_write",212,221
9,1,84,2,9,"ykbec_read@224-233@sys/arch/loongson/dev/kb3310.c","sys/arch/loongson/dev/kb3310.c","ykbec_read",224,233
6,1,41,2,6,"ykbec_read16@236-242@sys/arch/loongson/dev/kb3310.c","sys/arch/loongson/dev/kb3310.c","ykbec_read16",236,242
14,2,89,1,15,"ykbec_print_bat_info@323-338@sys/arch/loongson/dev/kb3310.c","sys/arch/loongson/dev/kb3310.c","ykbec_print_bat_info",323,338
77,16,612,1,98,"ykbec_refresh@342-440@sys/arch/loongson/dev/kb3310.c","sys/arch/loongson/dev/kb3310.c","ykbec_refresh",342,440
5,1,26,1,4,"ykbec_apminfo@444-448@sys/arch/loongson/dev/kb3310.c","sys/arch/loongson/dev/kb3310.c","ykbec_apminfo",444,448
23,1,148,0,41,"ykbec_suspend@451-492@sys/arch/loongson/dev/kb3310.c","sys/arch/loongson/dev/kb3310.c","ykbec_suspend",451,492
15,1,92,0,22,"ykbec_resume@495-517@sys/arch/loongson/dev/kb3310.c","sys/arch/loongson/dev/kb3310.c","ykbec_resume",495,517
21,5,141,5,23,"ykbec_bell@522-545@sys/arch/loongson/dev/kb3310.c","sys/arch/loongson/dev/kb3310.c","ykbec_bell",522,545
9,1,50,1,9,"ykbec_bell_stop@548-557@sys/arch/loongson/dev/kb3310.c","sys/arch/loongson/dev/kb3310.c","ykbec_bell_stop",548,557
9,4,58,3,11,"leioc_match@56-67@sys/arch/loongson/dev/leioc.c","sys/arch/loongson/dev/leioc.c","leioc_match",56,67
11,1,72,3,12,"leioc_attach@70-82@sys/arch/loongson/dev/leioc.c","sys/arch/loongson/dev/leioc.c","leioc_attach",70,82
6,1,57,3,6,"m41t8xclock_match@56-62@sys/arch/loongson/dev/m41t8xclock.c","sys/arch/loongson/dev/m41t8xclock.c","m41t8xclock_match",56,62
11,1,81,3,13,"m41t8xclock_attach@65-78@sys/arch/loongson/dev/m41t8xclock.c","sys/arch/loongson/dev/m41t8xclock.c","m41t8xclock_attach",65,78
24,3,222,3,25,"m41t8xclock_get@81-106@sys/arch/loongson/dev/m41t8xclock.c","sys/arch/loongson/dev/m41t8xclock.c","m41t8xclock_get",81,106
32,5,285,2,35,"m41t8xclock_set@109-144@sys/arch/loongson/dev/m41t8xclock.c","sys/arch/loongson/dev/m41t8xclock.c","m41t8xclock_set",109,144
7,2,37,3,8,"mainbus_match@48-56@sys/arch/loongson/dev/mainbus.c","sys/arch/loongson/dev/mainbus.c","mainbus_match",48,56
23,4,194,3,32,"mainbus_attach@59-91@sys/arch/loongson/dev/mainbus.c","sys/arch/loongson/dev/mainbus.c","mainbus_attach",59,91
4,2,22,2,3,"mainbus_print@94-97@sys/arch/loongson/dev/mainbus.c","sys/arch/loongson/dev/mainbus.c","mainbus_print",94,97
12,1,70,2,16,"mcclock_attach@57-73@sys/arch/loongson/dev/mcclock.c","sys/arch/loongson/dev/mcclock.c","mcclock_attach",57,73
19,1,123,3,20,"mcclock_get@79-99@sys/arch/loongson/dev/mcclock.c","sys/arch/loongson/dev/mcclock.c","mcclock_get",79,99
21,1,138,2,23,"mcclock_set@105-128@sys/arch/loongson/dev/mcclock.c","sys/arch/loongson/dev/mcclock.c","mcclock_set",105,128
18,8,129,3,23,"mcclock_isa_match@66-89@sys/arch/loongson/dev/mcclock_isa.c","sys/arch/loongson/dev/mcclock_isa.c","mcclock_isa_match",66,89
12,2,89,3,13,"mcclock_isa_attach@92-105@sys/arch/loongson/dev/mcclock_isa.c","sys/arch/loongson/dev/mcclock_isa.c","mcclock_isa_attach",92,105
10,1,68,3,10,"mcclock_isa_write@108-118@sys/arch/loongson/dev/mcclock_isa.c","sys/arch/loongson/dev/mcclock_isa.c","mcclock_isa_write",108,118
10,1,63,2,10,"mcclock_isa_read@121-131@sys/arch/loongson/dev/mcclock_isa.c","sys/arch/loongson/dev/mcclock_isa.c","mcclock_isa_read",121,131
7,2,61,3,7,"ohci_voyager_match@81-88@sys/arch/loongson/dev/ohci_voyager.c","sys/arch/loongson/dev/ohci_voyager.c","ohci_voyager_match",81,88
49,6,412,3,66,"ohci_voyager_attach@91-157@sys/arch/loongson/dev/ohci_voyager.c","sys/arch/loongson/dev/ohci_voyager.c","ohci_voyager_attach",91,157
18,2,125,1,23,"ohci_voyager_attach_deferred@160-183@sys/arch/loongson/dev/ohci_voyager.c","sys/arch/loongson/dev/ohci_voyager.c","ohci_voyager_attach_deferred",160,183
31,12,146,3,36,"pcibmatch@74-110@sys/arch/loongson/dev/pcib.c","sys/arch/loongson/dev/pcib.c","pcibmatch",74,110
14,2,115,3,29,"pcibattach@113-142@sys/arch/loongson/dev/pcib.c","sys/arch/loongson/dev/pcib.c","pcibattach",113,142
5,1,38,1,5,"pcib_callback@145-150@sys/arch/loongson/dev/pcib.c","sys/arch/loongson/dev/pcib.c","pcib_callback",145,150
13,3,88,4,18,"pcib_isa_attach@153-171@sys/arch/loongson/dev/pcib.c","sys/arch/loongson/dev/pcib.c","pcib_isa_attach",153,171
6,2,29,2,6,"pcib_print@174-180@sys/arch/loongson/dev/pcib.c","sys/arch/loongson/dev/pcib.c","pcib_print",174,180
5,1,37,3,5,"radeonfb_match@174-179@sys/arch/loongson/dev/radeonfb.c","sys/arch/loongson/dev/radeonfb.c","radeonfb_match",174,179
53,7,349,3,66,"radeonfb_attach@182-248@sys/arch/loongson/dev/radeonfb.c","sys/arch/loongson/dev/radeonfb.c","radeonfb_attach",182,248
13,2,103,6,15,"radeonfb_alloc_screen@255-270@sys/arch/loongson/dev/radeonfb.c","sys/arch/loongson/dev/radeonfb.c","radeonfb_alloc_screen",255,270
5,1,29,2,5,"radeonfb_free_screen@273-278@sys/arch/loongson/dev/radeonfb.c","sys/arch/loongson/dev/radeonfb.c","radeonfb_free_screen",273,278
43,11,262,5,52,"radeonfb_ioctl@281-333@sys/arch/loongson/dev/radeonfb.c","sys/arch/loongson/dev/radeonfb.c","radeonfb_ioctl",281,333
5,1,36,5,4,"radeonfb_show_screen@336-340@sys/arch/loongson/dev/radeonfb.c","sys/arch/loongson/dev/radeonfb.c","radeonfb_show_screen",336,340
35,14,250,3,50,"radeonfb_mmap@343-393@sys/arch/loongson/dev/radeonfb.c","sys/arch/loongson/dev/radeonfb.c","radeonfb_mmap",343,393
6,1,51,3,6,"radeonfb_load_font@396-402@sys/arch/loongson/dev/radeonfb.c","sys/arch/loongson/dev/radeonfb.c","radeonfb_load_font",396,402
6,1,45,2,6,"radeonfb_list_font@405-411@sys/arch/loongson/dev/radeonfb.c","sys/arch/loongson/dev/radeonfb.c","radeonfb_list_font",405,411
13,1,108,5,15,"radeonfb_copycols@418-433@sys/arch/loongson/dev/radeonfb.c","sys/arch/loongson/dev/radeonfb.c","radeonfb_copycols",418,433
13,1,119,5,16,"radeonfb_erasecols@436-452@sys/arch/loongson/dev/radeonfb.c","sys/arch/loongson/dev/radeonfb.c","radeonfb_erasecols",436,452
11,1,91,4,13,"radeonfb_copyrows@455-468@sys/arch/loongson/dev/radeonfb.c","sys/arch/loongson/dev/radeonfb.c","radeonfb_copyrows",455,468
20,3,163,4,22,"radeonfb_eraserows@471-493@sys/arch/loongson/dev/radeonfb.c","sys/arch/loongson/dev/radeonfb.c","radeonfb_eraserows",471,493
10,3,58,2,10,"radeonfb_wait_fifo@496-506@sys/arch/loongson/dev/radeonfb.c","sys/arch/loongson/dev/radeonfb.c","radeonfb_wait_fifo",496,506
19,5,120,1,22,"radeonfb_wait@509-531@sys/arch/loongson/dev/radeonfb.c","sys/arch/loongson/dev/radeonfb.c","radeonfb_wait",509,531
42,3,256,7,47,"radeonfb_copyrect@534-581@sys/arch/loongson/dev/radeonfb.c","sys/arch/loongson/dev/radeonfb.c","radeonfb_copyrect",534,581
26,1,185,6,30,"radeonfb_fillrect@584-614@sys/arch/loongson/dev/radeonfb.c","sys/arch/loongson/dev/radeonfb.c","radeonfb_fillrect",584,614
42,2,355,1,56,"radeonfb_setup@621-677@sys/arch/loongson/dev/radeonfb.c","sys/arch/loongson/dev/radeonfb.c","radeonfb_setup",621,677
37,7,226,4,43,"radeonfb_cnattach@686-729@sys/arch/loongson/dev/radeonfb.c","sys/arch/loongson/dev/radeonfb.c","radeonfb_cnattach",686,729
8,2,57,2,9,"sisfb_crtc_read@139-148@sys/arch/loongson/dev/sisfb.c","sys/arch/loongson/dev/sisfb.c","sisfb_crtc_read",139,148
6,2,54,3,7,"sisfb_crtc_write@151-158@sys/arch/loongson/dev/sisfb.c","sys/arch/loongson/dev/sisfb.c","sisfb_crtc_write",151,158
8,2,57,2,9,"sisfb_seq_read@161-170@sys/arch/loongson/dev/sisfb.c","sys/arch/loongson/dev/sisfb.c","sisfb_seq_read",161,170
6,2,54,3,7,"sisfb_seq_write@173-180@sys/arch/loongson/dev/sisfb.c","sys/arch/loongson/dev/sisfb.c","sisfb_seq_write",173,180
5,1,42,3,5,"sisfb_match@183-188@sys/arch/loongson/dev/sisfb.c","sys/arch/loongson/dev/sisfb.c","sisfb_match",183,188
61,7,421,3,72,"sisfb_attach@191-263@sys/arch/loongson/dev/sisfb.c","sys/arch/loongson/dev/sisfb.c","sisfb_attach",191,263
13,2,103,6,15,"sisfb_alloc_screen@270-285@sys/arch/loongson/dev/sisfb.c","sys/arch/loongson/dev/sisfb.c","sisfb_alloc_screen",270,285
5,1,29,2,5,"sisfb_free_screen@288-293@sys/arch/loongson/dev/sisfb.c","sys/arch/loongson/dev/sisfb.c","sisfb_free_screen",288,293
41,9,244,5,42,"sisfb_ioctl@296-338@sys/arch/loongson/dev/sisfb.c","sys/arch/loongson/dev/sisfb.c","sisfb_ioctl",296,338
5,1,36,5,4,"sisfb_show_screen@341-345@sys/arch/loongson/dev/sisfb.c","sys/arch/loongson/dev/sisfb.c","sisfb_show_screen",341,345
12,5,104,3,20,"sisfb_mmap@348-368@sys/arch/loongson/dev/sisfb.c","sys/arch/loongson/dev/sisfb.c","sisfb_mmap",348,368
6,1,51,3,6,"sisfb_load_font@371-377@sys/arch/loongson/dev/sisfb.c","sys/arch/loongson/dev/sisfb.c","sisfb_load_font",371,377
6,1,45,2,6,"sisfb_list_font@380-386@sys/arch/loongson/dev/sisfb.c","sys/arch/loongson/dev/sisfb.c","sisfb_list_font",380,386
87,15,602,1,110,"sisfb_setup@393-503@sys/arch/loongson/dev/sisfb.c","sys/arch/loongson/dev/sisfb.c","sisfb_setup",393,503
10,2,111,3,10,"sisfb_loadcmap@510-520@sys/arch/loongson/dev/sisfb.c","sys/arch/loongson/dev/sisfb.c","sisfb_loadcmap",510,520
31,9,237,2,36,"sisfb_getcmap@523-559@sys/arch/loongson/dev/sisfb.c","sys/arch/loongson/dev/sisfb.c","sisfb_getcmap",523,559
31,9,237,2,36,"sisfb_putcmap@562-598@sys/arch/loongson/dev/sisfb.c","sys/arch/loongson/dev/sisfb.c","sisfb_putcmap",562,598
45,9,287,4,52,"sisfb_cnattach@607-659@sys/arch/loongson/dev/sisfb.c","sys/arch/loongson/dev/sisfb.c","sisfb_cnattach",607,659
5,1,42,3,5,"smfb_pci_match@158-163@sys/arch/loongson/dev/smfb.c","sys/arch/loongson/dev/smfb.c","smfb_pci_match",158,163
6,1,57,3,6,"smfb_voyager_match@166-172@sys/arch/loongson/dev/smfb.c","sys/arch/loongson/dev/smfb.c","smfb_voyager_match",166,172
13,2,99,3,14,"smfb_pci_attach@175-189@sys/arch/loongson/dev/smfb.c","sys/arch/loongson/dev/smfb.c","smfb_pci_attach",175,189
7,1,65,3,7,"smfb_voyager_attach@192-199@sys/arch/loongson/dev/smfb.c","sys/arch/loongson/dev/smfb.c","smfb_voyager_attach",192,199
29,3,226,6,34,"smfb_attach_common@202-236@sys/arch/loongson/dev/smfb.c","sys/arch/loongson/dev/smfb.c","smfb_attach_common",202,236
13,2,103,6,15,"smfb_alloc_screen@243-258@sys/arch/loongson/dev/smfb.c","sys/arch/loongson/dev/smfb.c","smfb_alloc_screen",243,258
5,1,29,2,5,"smfb_free_screen@261-266@sys/arch/loongson/dev/smfb.c","sys/arch/loongson/dev/smfb.c","smfb_free_screen",261,266
24,4,140,5,25,"smfb_ioctl@269-294@sys/arch/loongson/dev/smfb.c","sys/arch/loongson/dev/smfb.c","smfb_ioctl",269,294
5,1,36,5,4,"smfb_show_screen@297-301@sys/arch/loongson/dev/smfb.c","sys/arch/loongson/dev/smfb.c","smfb_show_screen",297,301
10,4,85,3,12,"smfb_mmap@304-316@sys/arch/loongson/dev/smfb.c","sys/arch/loongson/dev/smfb.c","smfb_mmap",304,316
6,1,51,3,6,"smfb_load_font@319-325@sys/arch/loongson/dev/smfb.c","sys/arch/loongson/dev/smfb.c","smfb_load_font",319,325
6,1,45,2,6,"smfb_list_font@328-334@sys/arch/loongson/dev/smfb.c","sys/arch/loongson/dev/smfb.c","smfb_list_font",328,334
31,4,200,3,35,"smfb_burner@337-372@sys/arch/loongson/dev/smfb.c","sys/arch/loongson/dev/smfb.c","smfb_burner",337,372
87,15,620,5,102,"smfb_setup@379-481@sys/arch/loongson/dev/smfb.c","sys/arch/loongson/dev/smfb.c","smfb_setup",379,481
20,4,162,7,23,"smfb_copyrect@484-507@sys/arch/loongson/dev/smfb.c","sys/arch/loongson/dev/smfb.c","smfb_copyrect",484,507
13,1,115,6,15,"smfb_fillrect@510-525@sys/arch/loongson/dev/smfb.c","sys/arch/loongson/dev/smfb.c","smfb_fillrect",510,525
12,1,94,4,14,"smfb_copyrows@528-542@sys/arch/loongson/dev/smfb.c","sys/arch/loongson/dev/smfb.c","smfb_copyrows",528,542
13,1,107,5,15,"smfb_copycols@545-560@sys/arch/loongson/dev/smfb.c","sys/arch/loongson/dev/smfb.c","smfb_copycols",545,560
14,1,115,5,17,"smfb_erasecols@563-580@sys/arch/loongson/dev/smfb.c","sys/arch/loongson/dev/smfb.c","smfb_erasecols",563,580
21,3,163,4,23,"smfb_eraserows@583-606@sys/arch/loongson/dev/smfb.c","sys/arch/loongson/dev/smfb.c","smfb_eraserows",583,606
21,5,101,1,22,"smfb_wait@609-631@sys/arch/loongson/dev/smfb.c","sys/arch/loongson/dev/smfb.c","smfb_wait",609,631
11,4,72,2,12,"smfb_wait_panel_vsync@637-649@sys/arch/loongson/dev/smfb.c","sys/arch/loongson/dev/smfb.c","smfb_wait_panel_vsync",637,649
5,1,45,2,4,"smfb_vgats_read@656-660@sys/arch/loongson/dev/smfb.c","sys/arch/loongson/dev/smfb.c","smfb_vgats_read",656,660
5,1,49,3,4,"smfb_vgats_write@663-667@sys/arch/loongson/dev/smfb.c","sys/arch/loongson/dev/smfb.c","smfb_vgats_write",663,667
45,9,266,4,52,"smfb_cnattach@676-728@sys/arch/loongson/dev/smfb.c","sys/arch/loongson/dev/smfb.c","smfb_cnattach",676,728
13,3,61,2,14,"smfb_activate@731-745@sys/arch/loongson/dev/smfb.c","sys/arch/loongson/dev/smfb.c","smfb_activate",731,745
6,1,57,3,6,"stsec_match@131-137@sys/arch/loongson/dev/stsec.c","sys/arch/loongson/dev/stsec.c","stsec_match",131,137
49,8,352,3,74,"stsec_attach@140-214@sys/arch/loongson/dev/stsec.c","sys/arch/loongson/dev/stsec.c","stsec_attach",140,214
13,2,96,3,14,"stsec_read@217-231@sys/arch/loongson/dev/stsec.c","sys/arch/loongson/dev/stsec.c","stsec_read",217,231
12,1,96,3,12,"stsec_write@234-246@sys/arch/loongson/dev/stsec.c","sys/arch/loongson/dev/stsec.c","stsec_write",234,246
71,20,510,1,93,"stsec_sensors_update@249-342@sys/arch/loongson/dev/stsec.c","sys/arch/loongson/dev/stsec.c","stsec_sensors_update",249,342
5,1,26,1,4,"stsec_apminfo@346-350@sys/arch/loongson/dev/stsec.c","sys/arch/loongson/dev/stsec.c","stsec_apminfo",346,350
5,1,42,3,5,"voyager_match@85-90@sys/arch/loongson/dev/voyager.c","sys/arch/loongson/dev/voyager.c","voyager_match",85,90
46,6,339,3,68,"voyager_attach@93-161@sys/arch/loongson/dev/voyager.c","sys/arch/loongson/dev/voyager.c","voyager_attach",93,161
7,2,45,2,8,"voyager_print@164-172@sys/arch/loongson/dev/voyager.c","sys/arch/loongson/dev/voyager.c","voyager_print",164,172
19,3,159,3,26,"voyager_search@175-201@sys/arch/loongson/dev/voyager.c","sys/arch/loongson/dev/voyager.c","voyager_search",175,201
21,6,169,1,24,"voyager_intr@208-232@sys/arch/loongson/dev/voyager.c","sys/arch/loongson/dev/voyager.c","voyager_intr",208,232
30,7,257,6,40,"voyager_intr_establish@235-275@sys/arch/loongson/dev/voyager.c","sys/arch/loongson/dev/voyager.c","voyager_intr_establish",235,275
8,1,48,1,8,"voyager_intr_string@278-286@sys/arch/loongson/dev/voyager.c","sys/arch/loongson/dev/voyager.c","voyager_intr_string",278,286
15,3,85,2,16,"voyager_gpio_pin_read@303-319@sys/arch/loongson/dev/voyager.c","sys/arch/loongson/dev/voyager.c","voyager_gpio_pin_read",303,319
20,3,123,3,20,"voyager_gpio_pin_write@322-342@sys/arch/loongson/dev/voyager.c","sys/arch/loongson/dev/voyager.c","voyager_gpio_pin_write",322,342
20,3,128,3,20,"voyager_gpio_pin_ctl@345-365@sys/arch/loongson/dev/voyager.c","sys/arch/loongson/dev/voyager.c","voyager_gpio_pin_ctl",345,365
43,5,332,1,49,"voyager_attach_gpio@368-417@sys/arch/loongson/dev/voyager.c","sys/arch/loongson/dev/voyager.c","voyager_attach_gpio",368,417
8,2,63,6,8,"bus_space_copy_1@246-254@sys/arch/loongson/include/bus.h","sys/arch/loongson/include/bus.h","bus_space_copy_1",246,254
8,2,64,6,8,"bus_space_copy_2@258-266@sys/arch/loongson/include/bus.h","sys/arch/loongson/include/bus.h","bus_space_copy_2",258,266
8,2,64,6,8,"bus_space_copy_4@269-277@sys/arch/loongson/include/bus.h","sys/arch/loongson/include/bus.h","bus_space_copy_4",269,277
8,2,64,6,8,"bus_space_copy_8@280-288@sys/arch/loongson/include/bus.h","sys/arch/loongson/include/bus.h","bus_space_copy_8",280,288
5,1,28,5,4,"bus_space_barrier@332-336@sys/arch/loongson/include/bus.h","sys/arch/loongson/include/bus.h","bus_space_barrier",332,336
9,1,39,1,11,"cpu_configure@38-49@sys/arch/loongson/loongson/autoconf.c","sys/arch/loongson/loongson/autoconf.c","cpu_configure",38,49
29,7,166,1,34,"parsepmonbp@52-86@sys/arch/loongson/loongson/autoconf.c","sys/arch/loongson/loongson/autoconf.c","parsepmonbp",52,86
10,4,52,1,14,"diskconf@89-103@sys/arch/loongson/loongson/autoconf.c","sys/arch/loongson/loongson/autoconf.c","diskconf",89,103
6,2,33,2,6,"device_register@106-112@sys/arch/loongson/loongson/autoconf.c","sys/arch/loongson/loongson/autoconf.c","device_register",106,112
20,3,152,7,34,"_dmamap_create@77-111@sys/arch/loongson/loongson/bus_dma.c","sys/arch/loongson/loongson/bus_dma.c","_dmamap_create",77,111
4,1,19,2,3,"_dmamap_destroy@118-121@sys/arch/loongson/loongson/bus_dma.c","sys/arch/loongson/loongson/bus_dma.c","_dmamap_destroy",118,121
18,3,119,6,24,"_dmamap_load@128-152@sys/arch/loongson/loongson/bus_dma.c","sys/arch/loongson/loongson/bus_dma.c","_dmamap_load",128,152
27,8,192,4,36,"_dmamap_load_mbuf@158-194@sys/arch/loongson/loongson/bus_dma.c","sys/arch/loongson/loongson/bus_dma.c","_dmamap_load_mbuf",158,194
34,9,239,4,49,"_dmamap_load_uio@200-249@sys/arch/loongson/loongson/bus_dma.c","sys/arch/loongson/loongson/bus_dma.c","_dmamap_load_uio",200,249
23,8,185,6,28,"_dmamap_load_raw@256-284@sys/arch/loongson/loongson/bus_dma.c","sys/arch/loongson/loongson/bus_dma.c","_dmamap_load_raw",256,284
5,1,22,2,8,"_dmamap_unload@291-299@sys/arch/loongson/loongson/bus_dma.c","sys/arch/loongson/loongson/bus_dma.c","_dmamap_unload",291,299
58,16,275,5,73,"_dmamap_sync@306-379@sys/arch/loongson/loongson/bus_dma.c","sys/arch/loongson/loongson/bus_dma.c","_dmamap_sync",306,379
7,1,61,8,6,"_dmamem_alloc@386-392@sys/arch/loongson/loongson/bus_dma.c","sys/arch/loongson/loongson/bus_dma.c","_dmamem_alloc",386,392
17,3,114,3,21,"_dmamem_free@399-420@sys/arch/loongson/loongson/bus_dma.c","sys/arch/loongson/loongson/bus_dma.c","_dmamem_free",399,420
53,13,383,6,72,"_dmamem_map@427-499@sys/arch/loongson/loongson/bus_dma.c","sys/arch/loongson/loongson/bus_dma.c","_dmamem_map",427,499
6,2,41,3,6,"_dmamem_unmap@506-512@sys/arch/loongson/loongson/bus_dma.c","sys/arch/loongson/loongson/bus_dma.c","_dmamem_unmap",506,512
20,7,135,6,25,"_dmamem_mmap@519-544@sys/arch/loongson/loongson/bus_dma.c","sys/arch/loongson/loongson/bus_dma.c","_dmamem_mmap",519,544
66,15,466,9,91,"_dmamap_load_buffer@557-648@sys/arch/loongson/loongson/bus_dma.c","sys/arch/loongson/loongson/bus_dma.c","_dmamap_load_buffer",557,648
43,9,292,10,59,"_dmamem_alloc_range@655-714@sys/arch/loongson/loongson/bus_dma.c","sys/arch/loongson/loongson/bus_dma.c","_dmamem_alloc_range",655,714
4,1,26,3,3,"generic_space_read_1@39-42@sys/arch/loongson/loongson/bus_space.c","sys/arch/loongson/loongson/bus_space.c","generic_space_read_1",39,42
4,1,26,3,3,"generic_space_read_2@45-48@sys/arch/loongson/loongson/bus_space.c","sys/arch/loongson/loongson/bus_space.c","generic_space_read_2",45,48
4,1,26,3,3,"generic_space_read_4@51-54@sys/arch/loongson/loongson/bus_space.c","sys/arch/loongson/loongson/bus_space.c","generic_space_read_4",51,54
4,1,26,3,3,"generic_space_read_8@57-60@sys/arch/loongson/loongson/bus_space.c","sys/arch/loongson/loongson/bus_space.c","generic_space_read_8",57,60
5,1,30,4,4,"generic_space_write_1@63-67@sys/arch/loongson/loongson/bus_space.c","sys/arch/loongson/loongson/bus_space.c","generic_space_write_1",63,67
5,1,30,4,4,"generic_space_write_2@70-74@sys/arch/loongson/loongson/bus_space.c","sys/arch/loongson/loongson/bus_space.c","generic_space_write_2",70,74
5,1,30,4,4,"generic_space_write_4@77-81@sys/arch/loongson/loongson/bus_space.c","sys/arch/loongson/loongson/bus_space.c","generic_space_write_4",77,81
5,1,30,4,4,"generic_space_write_8@84-88@sys/arch/loongson/loongson/bus_space.c","sys/arch/loongson/loongson/bus_space.c","generic_space_write_8",84,88
10,2,64,5,9,"generic_space_read_raw_2@91-100@sys/arch/loongson/loongson/bus_space.c","sys/arch/loongson/loongson/bus_space.c","generic_space_read_raw_2",91,100
10,2,65,5,9,"generic_space_write_raw_2@103-112@sys/arch/loongson/loongson/bus_space.c","sys/arch/loongson/loongson/bus_space.c","generic_space_write_raw_2",103,112
10,2,64,5,9,"generic_space_read_raw_4@115-124@sys/arch/loongson/loongson/bus_space.c","sys/arch/loongson/loongson/bus_space.c","generic_space_read_raw_4",115,124
10,2,65,5,9,"generic_space_write_raw_4@127-136@sys/arch/loongson/loongson/bus_space.c","sys/arch/loongson/loongson/bus_space.c","generic_space_write_raw_4",127,136
10,2,64,5,9,"generic_space_read_raw_8@139-148@sys/arch/loongson/loongson/bus_space.c","sys/arch/loongson/loongson/bus_space.c","generic_space_read_raw_8",139,148
10,2,65,5,9,"generic_space_write_raw_8@151-160@sys/arch/loongson/loongson/bus_space.c","sys/arch/loongson/loongson/bus_space.c","generic_space_write_raw_8",151,160
6,1,32,5,5,"generic_space_map@163-168@sys/arch/loongson/loongson/bus_space.c","sys/arch/loongson/loongson/bus_space.c","generic_space_map",163,168
3,1,13,3,2,"generic_space_unmap@171-173@sys/arch/loongson/loongson/bus_space.c","sys/arch/loongson/loongson/bus_space.c","generic_space_unmap",171,173
6,1,30,5,5,"generic_space_region@176-181@sys/arch/loongson/loongson/bus_space.c","sys/arch/loongson/loongson/bus_space.c","generic_space_region",176,181
4,1,17,2,3,"generic_space_vaddr@184-187@sys/arch/loongson/loongson/bus_space.c","sys/arch/loongson/loongson/bus_space.c","generic_space_vaddr",184,187
5,1,26,5,4,"generic_space_mmap@190-194@sys/arch/loongson/loongson/bus_space.c","sys/arch/loongson/loongson/bus_space.c","generic_space_mmap",190,194
7,4,44,1,7,"iskmemdev@247-254@sys/arch/loongson/loongson/conf.c","sys/arch/loongson/loongson/conf.c","iskmemdev",247,254
5,2,26,1,4,"iszerodev@260-264@sys/arch/loongson/loongson/conf.c","sys/arch/loongson/loongson/conf.c","iszerodev",260,264
4,1,15,0,3,"getnulldev@267-270@sys/arch/loongson/loongson/conf.c","sys/arch/loongson/loongson/conf.c","getnulldev",267,270
26,8,157,4,35,"readdisklabel@56-91@sys/arch/loongson/loongson/disksubr.c","sys/arch/loongson/loongson/disksubr.c","readdisklabel",56,91
30,4,213,3,36,"writedisklabel@97-133@sys/arch/loongson/loongson/disksubr.c","sys/arch/loongson/loongson/disksubr.c","writedisklabel",97,133
43,14,328,1,73,"gdium_attach_hook@77-150@sys/arch/loongson/loongson/gdium_machdep.c","sys/arch/loongson/loongson/gdium_machdep.c","gdium_attach_hook",77,150
25,8,108,3,30,"gdium_intr_map@153-183@sys/arch/loongson/loongson/gdium_machdep.c","sys/arch/loongson/loongson/gdium_machdep.c","gdium_intr_map",153,183
51,20,217,2,54,"gdium_device_register@209-263@sys/arch/loongson/loongson/gdium_machdep.c","sys/arch/loongson/loongson/gdium_machdep.c","gdium_device_register",209,263
5,1,19,0,4,"gdium_powerdown@266-270@sys/arch/loongson/loongson/gdium_machdep.c","sys/arch/loongson/loongson/gdium_machdep.c","gdium_powerdown",266,270
5,1,19,0,4,"gdium_reset@273-277@sys/arch/loongson/loongson/gdium_machdep.c","sys/arch/loongson/loongson/gdium_machdep.c","gdium_reset",273,277
4,1,9,0,3,"gdium_setup@280-283@sys/arch/loongson/loongson/gdium_machdep.c","sys/arch/loongson/loongson/gdium_machdep.c","gdium_setup",280,283
17,4,92,1,23,"generic2e_pci_attach_hook@156-179@sys/arch/loongson/loongson/generic2e_machdep.c","sys/arch/loongson/loongson/generic2e_machdep.c","generic2e_pci_attach_hook",156,179
25,8,90,3,26,"generic2e_intr_map@182-208@sys/arch/loongson/loongson/generic2e_machdep.c","sys/arch/loongson/loongson/generic2e_machdep.c","generic2e_intr_map",182,208
6,1,37,3,5,"generic2e_isa_attach_hook@215-220@sys/arch/loongson/loongson/generic2e_machdep.c","sys/arch/loongson/loongson/generic2e_machdep.c","generic2e_isa_attach_hook",215,220
6,1,54,7,6,"generic2e_isa_intr_establish@223-229@sys/arch/loongson/loongson/generic2e_machdep.c","sys/arch/loongson/loongson/generic2e_machdep.c","generic2e_isa_intr_establish",223,229
4,1,17,2,4,"generic2e_isa_intr_disestablish@232-236@sys/arch/loongson/loongson/generic2e_machdep.c","sys/arch/loongson/loongson/generic2e_machdep.c","generic2e_isa_intr_disestablish",232,236
59,14,351,2,85,"generic2e_isa_intr@239-324@sys/arch/loongson/loongson/generic2e_machdep.c","sys/arch/loongson/loongson/generic2e_machdep.c","generic2e_isa_intr",239,324
6,1,24,0,5,"generic2e_reset@331-336@sys/arch/loongson/loongson/generic2e_machdep.c","sys/arch/loongson/loongson/generic2e_machdep.c","generic2e_reset",331,336
15,4,65,1,19,"generic2e_setup@339-358@sys/arch/loongson/loongson/generic2e_machdep.c","sys/arch/loongson/loongson/generic2e_machdep.c","generic2e_setup",339,358
25,10,146,2,37,"generic2e_device_register@361-398@sys/arch/loongson/loongson/generic2e_machdep.c","sys/arch/loongson/loongson/generic2e_machdep.c","generic2e_device_register",361,398
80,1,705,2,120,"via686sb_setup@473-593@sys/arch/loongson/loongson/generic2e_machdep.c","sys/arch/loongson/loongson/generic2e_machdep.c","via686sb_setup",473,593
5,2,16,1,4,"generic3a_powerdown@173-177@sys/arch/loongson/loongson/generic3a_machdep.c","sys/arch/loongson/loongson/generic3a_machdep.c","generic3a_powerdown",173,177
5,2,16,1,4,"generic3a_reset@180-184@sys/arch/loongson/loongson/generic3a_machdep.c","sys/arch/loongson/loongson/generic3a_machdep.c","generic3a_reset",180,184
20,5,126,1,29,"generic3a_setup@187-216@sys/arch/loongson/loongson/generic3a_machdep.c","sys/arch/loongson/loongson/generic3a_machdep.c","generic3a_setup",187,216
25,11,146,2,39,"generic3a_device_register@219-258@sys/arch/loongson/loongson/generic3a_machdep.c","sys/arch/loongson/loongson/generic3a_machdep.c","generic3a_device_register",219,258
21,5,150,2,24,"generic3a_config_secondary_cpus@263-287@sys/arch/loongson/loongson/generic3a_machdep.c","sys/arch/loongson/loongson/generic3a_machdep.c","generic3a_config_secondary_cpus",263,287
15,3,85,1,30,"generic3a_boot_secondary_cpu@290-320@sys/arch/loongson/loongson/generic3a_machdep.c","sys/arch/loongson/loongson/generic3a_machdep.c","generic3a_boot_secondary_cpu",290,320
8,2,54,2,12,"generic3a_ipi_establish@323-335@sys/arch/loongson/loongson/generic3a_machdep.c","sys/arch/loongson/loongson/generic3a_machdep.c","generic3a_ipi_establish",323,335
4,1,19,1,3,"generic3a_ipi_set@338-341@sys/arch/loongson/loongson/generic3a_machdep.c","sys/arch/loongson/loongson/generic3a_machdep.c","generic3a_ipi_set",338,341
4,1,19,1,3,"generic3a_ipi_clear@344-347@sys/arch/loongson/loongson/generic3a_machdep.c","sys/arch/loongson/loongson/generic3a_machdep.c","generic3a_ipi_clear",344,347
9,2,61,2,14,"generic3a_ipi_intr@350-364@sys/arch/loongson/loongson/generic3a_machdep.c","sys/arch/loongson/loongson/generic3a_machdep.c","generic3a_ipi_intr",350,364
16,4,97,1,17,"rs780e_pci_attach_hook@373-390@sys/arch/loongson/loongson/generic3a_machdep.c","sys/arch/loongson/loongson/generic3a_machdep.c","rs780e_pci_attach_hook",373,390
5,1,14,1,5,"rs780e_setup@393-398@sys/arch/loongson/loongson/generic3a_machdep.c","sys/arch/loongson/loongson/generic3a_machdep.c","rs780e_setup",393,398
24,1,223,2,50,"rs780sb_setup@401-451@sys/arch/loongson/loongson/generic3a_machdep.c","sys/arch/loongson/loongson/generic3a_machdep.c","rs780sb_setup",401,451
4,1,19,3,3,"rs780e_isa_attach_hook@454-457@sys/arch/loongson/loongson/generic3a_machdep.c","sys/arch/loongson/loongson/generic3a_machdep.c","rs780e_isa_attach_hook",454,457
5,1,49,7,4,"rs780e_isa_intr_establish@460-464@sys/arch/loongson/loongson/generic3a_machdep.c","sys/arch/loongson/loongson/generic3a_machdep.c","rs780e_isa_intr_establish",460,464
4,1,17,2,3,"rs780e_isa_intr_disestablish@467-470@sys/arch/loongson/loongson/generic3a_machdep.c","sys/arch/loongson/loongson/generic3a_machdep.c","rs780e_isa_intr_disestablish",467,470
11,2,72,1,11,"rs780e_eoi@473-484@sys/arch/loongson/loongson/generic3a_machdep.c","sys/arch/loongson/loongson/generic3a_machdep.c","rs780e_eoi",473,484
10,1,64,1,12,"rs780e_set_imask@487-499@sys/arch/loongson/loongson/generic3a_machdep.c","sys/arch/loongson/loongson/generic3a_machdep.c","rs780e_set_imask",487,499
4,1,19,1,3,"rs780e_irq_mask@502-505@sys/arch/loongson/loongson/generic3a_machdep.c","sys/arch/loongson/loongson/generic3a_machdep.c","rs780e_irq_mask",502,505
4,1,19,1,3,"rs780e_irq_unmask@508-511@sys/arch/loongson/loongson/generic3a_machdep.c","sys/arch/loongson/loongson/generic3a_machdep.c","rs780e_irq_unmask",508,511
4,1,15,1,3,"rs780e_get_timecount@514-517@sys/arch/loongson/loongson/generic3a_machdep.c","sys/arch/loongson/loongson/generic3a_machdep.c","rs780e_get_timecount",514,517
25,16,199,1,35,"get_hibernate_io_function@61-96@sys/arch/loongson/loongson/hibernate_machdep.c","sys/arch/loongson/loongson/hibernate_machdep.c","get_hibernate_io_function",61,96
16,3,118,1,20,"get_hibernate_info_md@102-122@sys/arch/loongson/loongson/hibernate_machdep.c","sys/arch/loongson/loongson/hibernate_machdep.c","get_hibernate_info_md",102,122
3,1,13,3,3,"hibernate_enter_resume_mapping@128-131@sys/arch/loongson/loongson/hibernate_machdep.c","sys/arch/loongson/loongson/hibernate_machdep.c","hibernate_enter_resume_mapping",128,131
4,1,15,3,4,"hibernate_populate_resume_pt@140-144@sys/arch/loongson/loongson/hibernate_machdep.c","sys/arch/loongson/loongson/hibernate_machdep.c","hibernate_populate_resume_pt",140,144
7,3,42,2,7,"hibernate_inflate_skip@154-161@sys/arch/loongson/loongson/hibernate_machdep.c","sys/arch/loongson/loongson/hibernate_machdep.c","hibernate_inflate_skip",154,161
4,1,10,1,3,"hibernate_enable_intr_machdep@164-167@sys/arch/loongson/loongson/hibernate_machdep.c","sys/arch/loongson/loongson/hibernate_machdep.c","hibernate_enable_intr_machdep",164,167
4,1,10,1,3,"hibernate_disable_intr_machdep@170-173@sys/arch/loongson/loongson/hibernate_machdep.c","sys/arch/loongson/loongson/hibernate_machdep.c","hibernate_disable_intr_machdep",170,173
4,1,13,1,3,"hibernate_flush@176-179@sys/arch/loongson/loongson/hibernate_machdep.c","sys/arch/loongson/loongson/hibernate_machdep.c","hibernate_flush",176,179
12,3,84,1,20,"loongson_set_isa_imr@49-69@sys/arch/loongson/loongson/isa_machdep.c","sys/arch/loongson/loongson/isa_machdep.c","loongson_set_isa_imr",49,69
10,2,61,1,9,"loongson_isa_specific_eoi@72-81@sys/arch/loongson/loongson/isa_machdep.c","sys/arch/loongson/loongson/isa_machdep.c","loongson_isa_specific_eoi",72,81
11,3,57,1,13,"loongson_isa_splx@84-97@sys/arch/loongson/loongson/isa_machdep.c","sys/arch/loongson/loongson/isa_machdep.c","loongson_isa_splx",84,97
10,1,46,1,11,"loongson_isa_setintrmask@100-111@sys/arch/loongson/loongson/isa_machdep.c","sys/arch/loongson/loongson/isa_machdep.c","loongson_isa_setintrmask",100,111
6,1,28,3,6,"loongson_generic_isa_attach_hook@114-120@sys/arch/loongson/loongson/isa_machdep.c","sys/arch/loongson/loongson/isa_machdep.c","loongson_generic_isa_attach_hook",114,120
19,3,150,2,23,"loongson2e_setup@79-102@sys/arch/loongson/loongson/loongson2_machdep.c","sys/arch/loongson/loongson/loongson2_machdep.c","loongson2e_setup",79,102
36,4,272,2,109,"loongson2f_setup@109-218@sys/arch/loongson/loongson/loongson2_machdep.c","sys/arch/loongson/loongson/loongson2_machdep.c","loongson2f_setup",109,218
17,1,119,6,19,"loongson2f_setup_window@225-244@sys/arch/loongson/loongson/loongson2_machdep.c","sys/arch/loongson/loongson/loongson2_machdep.c","loongson2f_setup_window",225,244
18,8,135,3,26,"is_memory_range@252-278@sys/arch/loongson/loongson/loongson2_machdep.c","sys/arch/loongson/loongson/loongson2_machdep.c","is_memory_range",252,278
8,1,50,1,9,"loongson2f_cpuspeed@281-290@sys/arch/loongson/loongson/loongson2_machdep.c","sys/arch/loongson/loongson/loongson2_machdep.c","loongson2f_cpuspeed",281,290
11,2,66,1,15,"loongson2f_setperf@293-308@sys/arch/loongson/loongson/loongson2_machdep.c","sys/arch/loongson/loongson/loongson2_machdep.c","loongson2f_setperf",293,308
16,2,65,1,18,"next_irq@56-74@sys/arch/loongson/loongson/loongson3_intr.c","sys/arch/loongson/loongson/loongson3_intr.c","next_irq",56,74
10,1,35,2,9,"setipl@77-86@sys/arch/loongson/loongson/loongson3_intr.c","sys/arch/loongson/loongson/loongson3_intr.c","setipl",77,86
30,7,222,1,45,"loongson3_intr_init@89-134@sys/arch/loongson/loongson/loongson3_intr.c","sys/arch/loongson/loongson/loongson3_intr.c","loongson3_intr_init",89,134
10,1,75,1,9,"loongson3_prop_imask@137-146@sys/arch/loongson/loongson/loongson3_intr.c","sys/arch/loongson/loongson/loongson3_intr.c","loongson3_prop_imask",137,146
37,10,282,1,42,"loongson3_update_imask@149-191@sys/arch/loongson/loongson/loongson3_intr.c","sys/arch/loongson/loongson/loongson3_intr.c","loongson3_update_imask",149,191
16,5,97,3,16,"loongson3_intr_insert@194-210@sys/arch/loongson/loongson/loongson3_intr.c","sys/arch/loongson/loongson/loongson3_intr.c","loongson3_intr_insert",194,210
17,5,95,2,17,"loongson3_intr_remove@213-230@sys/arch/loongson/loongson/loongson3_intr.c","sys/arch/loongson/loongson/loongson3_intr.c","loongson3_intr_remove",213,230
30,5,214,5,39,"loongson3_intr_establish@233-272@sys/arch/loongson/loongson/loongson3_intr.c","sys/arch/loongson/loongson/loongson3_intr.c","loongson3_intr_establish",233,272
13,1,73,1,15,"loongson3_intr_disestablish@275-290@sys/arch/loongson/loongson/loongson3_intr.c","sys/arch/loongson/loongson/loongson3_intr.c","loongson3_intr_disestablish",275,290
30,4,206,5,39,"loongson3_ht_intr_establish@293-332@sys/arch/loongson/loongson/loongson3_intr.c","sys/arch/loongson/loongson/loongson3_intr.c","loongson3_ht_intr_establish",293,332
18,2,105,1,22,"loongson3_ht_intr_disestablish@335-357@sys/arch/loongson/loongson/loongson3_intr.c","sys/arch/loongson/loongson/loongson3_intr.c","loongson3_ht_intr_disestablish",335,357
10,4,61,1,12,"loongson3_splx@360-372@sys/arch/loongson/loongson/loongson3_intr.c","sys/arch/loongson/loongson/loongson3_intr.c","loongson3_splx",360,372
54,16,322,2,70,"loongson3_intr@375-445@sys/arch/loongson/loongson/loongson3_intr.c","sys/arch/loongson/loongson/loongson3_intr.c","loongson3_intr",375,445
56,17,349,2,77,"loongson3_ht_intr@448-525@sys/arch/loongson/loongson/loongson3_intr.c","sys/arch/loongson/loongson/loongson3_intr.c","loongson3_ht_intr",448,525
4,1,14,1,3,"loongson3_register_ht_pic@528-531@sys/arch/loongson/loongson/loongson3_intr.c","sys/arch/loongson/loongson/loongson3_intr.c","loongson3_register_ht_pic",528,531
15,4,123,2,22,"loongson3a_setup@53-75@sys/arch/loongson/loongson/loongson3_machdep.c","sys/arch/loongson/loongson/loongson3_machdep.c","loongson3a_setup",53,75
75,24,372,2,119,"loongson_identify@228-347@sys/arch/loongson/loongson/machdep.c","sys/arch/loongson/loongson/machdep.c","loongson_identify",228,347
40,11,278,1,53,"loongson_efi_setup@353-406@sys/arch/loongson/loongson/machdep.c","sys/arch/loongson/loongson/machdep.c","loongson_efi_setup",353,406
59,18,267,1,89,"loongson_envp_setup@412-501@sys/arch/loongson/loongson/machdep.c","sys/arch/loongson/loongson/machdep.c","loongson_envp_setup",412,501
207,59,1289,5,368,"mips_init@509-877@sys/arch/loongson/loongson/machdep.c","sys/arch/loongson/loongson/machdep.c","mips_init",509,877
49,17,225,1,69,"dobootopts@883-952@sys/arch/loongson/loongson/machdep.c","sys/arch/loongson/loongson/machdep.c","dobootopts",883,952
9,2,31,0,9,"consinit@960-969@sys/arch/loongson/loongson/machdep.c","sys/arch/loongson/loongson/machdep.c","consinit",960,969
19,3,137,0,40,"cpu_startup@976-1016@sys/arch/loongson/loongson/machdep.c","sys/arch/loongson/loongson/machdep.c","cpu_startup",976,1016
21,6,111,7,23,"cpu_sysctl@1022-1045@sys/arch/loongson/loongson/machdep.c","sys/arch/loongson/loongson/machdep.c","cpu_sysctl",1022,1045
52,13,278,1,60,"boot@1050-1110@sys/arch/loongson/loongson/machdep.c","sys/arch/loongson/loongson/machdep.c","boot",1050,1110
16,7,123,1,22,"dumpconf@1117-1139@sys/arch/loongson/loongson/machdep.c","sys/arch/loongson/loongson/machdep.c","dumpconf",1117,1139
3,1,5,0,3,"dumpsys@1142-1145@sys/arch/loongson/loongson/machdep.c","sys/arch/loongson/loongson/machdep.c","dumpsys",1142,1145
50,21,247,2,59,"atoi@1151-1210@sys/arch/loongson/loongson/machdep.c","sys/arch/loongson/loongson/machdep.c","atoi",1151,1210
20,4,100,1,33,"pmoncngetc@1217-1250@sys/arch/loongson/loongson/machdep.c","sys/arch/loongson/loongson/machdep.c","pmoncngetc",1217,1250
7,2,29,2,6,"pmoncnputc@1253-1259@sys/arch/loongson/loongson/machdep.c","sys/arch/loongson/loongson/machdep.c","pmoncnputc",1253,1259
27,4,135,1,50,"hw_cpu_hatch@1264-1314@sys/arch/loongson/loongson/machdep.c","sys/arch/loongson/loongson/machdep.c","hw_cpu_hatch",1264,1314
4,1,16,1,3,"hw_cpu_boot_secondary@1317-1320@sys/arch/loongson/loongson/machdep.c","sys/arch/loongson/loongson/machdep.c","hw_cpu_boot_secondary",1317,1320
7,2,39,2,6,"hw_ipi_intr_establish@1323-1329@sys/arch/loongson/loongson/machdep.c","sys/arch/loongson/loongson/machdep.c","hw_ipi_intr_establish",1323,1329
4,1,14,1,3,"hw_ipi_intr_set@1332-1335@sys/arch/loongson/loongson/machdep.c","sys/arch/loongson/loongson/machdep.c","hw_ipi_intr_set",1332,1335
5,2,22,1,4,"hw_ipi_intr_clear@1338-1342@sys/arch/loongson/loongson/machdep.c","sys/arch/loongson/loongson/machdep.c","hw_ipi_intr_clear",1338,1342
13,2,88,5,14,"pciide_machdep_compat_intr_establish@58-72@sys/arch/loongson/loongson/pciide_machdep.c","sys/arch/loongson/loongson/pciide_machdep.c","pciide_machdep_compat_intr_establish",58,72
5,2,28,2,4,"pciide_machdep_compat_intr_disestablish@75-79@sys/arch/loongson/loongson/pciide_machdep.c","sys/arch/loongson/loongson/pciide_machdep.c","pciide_machdep_compat_intr_disestablish",75,79
32,8,164,5,77,"pmon_init@33-110@sys/arch/loongson/loongson/pmon.c","sys/arch/loongson/loongson/pmon.c","pmon_init",33,110
6,3,35,1,6,"pmon_getarg@113-119@sys/arch/loongson/loongson/pmon.c","sys/arch/loongson/loongson/pmon.c","pmon_getarg",113,119
4,1,8,0,3,"pmon_getenvtype@122-125@sys/arch/loongson/loongson/pmon.c","sys/arch/loongson/loongson/pmon.c","pmon_getenvtype",122,125
26,8,141,1,47,"pmon_getenv@128-175@sys/arch/loongson/loongson/pmon.c","sys/arch/loongson/loongson/pmon.c","pmon_getenv",128,175
7,2,33,1,8,"pmon_get_env_reset@178-186@sys/arch/loongson/loongson/pmon.c","sys/arch/loongson/loongson/pmon.c","pmon_get_env_reset",178,186
7,2,35,1,8,"pmon_get_env_smbios@189-197@sys/arch/loongson/loongson/pmon.c","sys/arch/loongson/loongson/pmon.c","pmon_get_env_smbios",189,197
9,2,63,1,10,"pmon_get_env_mem@200-210@sys/arch/loongson/loongson/pmon.c","sys/arch/loongson/loongson/pmon.c","pmon_get_env_mem",200,210
9,2,63,1,10,"pmon_get_env_cpu@213-223@sys/arch/loongson/loongson/pmon.c","sys/arch/loongson/loongson/pmon.c","pmon_get_env_cpu",213,223
9,2,63,1,10,"pmon_get_env_sys@226-236@sys/arch/loongson/loongson/pmon.c","sys/arch/loongson/loongson/pmon.c","pmon_get_env_sys",226,236
9,2,63,1,10,"pmon_get_env_irq@239-249@sys/arch/loongson/loongson/pmon.c","sys/arch/loongson/loongson/pmon.c","pmon_get_env_irq",239,249
9,2,63,1,10,"pmon_get_env_iface@252-262@sys/arch/loongson/loongson/pmon.c","sys/arch/loongson/loongson/pmon.c","pmon_get_env_iface",252,262
9,2,63,1,10,"pmon_get_env_special@265-275@sys/arch/loongson/loongson/pmon.c","sys/arch/loongson/loongson/pmon.c","pmon_get_env_special",265,275
9,2,63,1,10,"pmon_get_env_device@278-288@sys/arch/loongson/loongson/pmon.c","sys/arch/loongson/loongson/pmon.c","pmon_get_env_device",278,288
34,12,205,1,52,"wscnprobe@93-145@sys/arch/loongson/loongson/wscons_machdep.c","sys/arch/loongson/loongson/wscons_machdep.c","wscnprobe",93,145
56,28,335,1,105,"wscninit@148-253@sys/arch/loongson/loongson/wscons_machdep.c","sys/arch/loongson/loongson/wscons_machdep.c","wscninit",148,253
4,2,17,2,5,"wscnputc@256-261@sys/arch/loongson/loongson/wscons_machdep.c","sys/arch/loongson/loongson/wscons_machdep.c","wscnputc",256,261
10,3,41,1,15,"wscngetc@264-279@sys/arch/loongson/loongson/wscons_machdep.c","sys/arch/loongson/loongson/wscons_machdep.c","wscngetc",264,279
4,2,17,2,5,"wscnpollc@282-287@sys/arch/loongson/loongson/wscons_machdep.c","sys/arch/loongson/loongson/wscons_machdep.c","wscnpollc",282,287
15,3,84,1,20,"lemote_pci_attach_hook@241-261@sys/arch/loongson/loongson/yeeloong_machdep.c","sys/arch/loongson/loongson/yeeloong_machdep.c","lemote_pci_attach_hook",241,261
30,12,115,3,33,"lemote_intr_map@264-297@sys/arch/loongson/loongson/yeeloong_machdep.c","sys/arch/loongson/loongson/yeeloong_machdep.c","lemote_intr_map",264,297
8,1,59,3,10,"lemote_isa_attach_hook@304-314@sys/arch/loongson/loongson/yeeloong_machdep.c","sys/arch/loongson/loongson/yeeloong_machdep.c","lemote_isa_attach_hook",304,314
6,1,54,7,5,"lemote_isa_intr_establish@317-322@sys/arch/loongson/loongson/yeeloong_machdep.c","sys/arch/loongson/loongson/yeeloong_machdep.c","lemote_isa_intr_establish",317,322
4,1,17,2,3,"lemote_isa_intr_disestablish@325-328@sys/arch/loongson/loongson/yeeloong_machdep.c","sys/arch/loongson/loongson/yeeloong_machdep.c","lemote_isa_intr_disestablish",325,328
70,17,417,2,99,"lemote_isa_intr@342-441@sys/arch/loongson/loongson/yeeloong_machdep.c","sys/arch/loongson/loongson/yeeloong_machdep.c","lemote_isa_intr",342,441
8,1,55,0,9,"lemote_get_isa_imr@444-453@sys/arch/loongson/loongson/yeeloong_machdep.c","sys/arch/loongson/loongson/yeeloong_machdep.c","lemote_get_isa_imr",444,453
7,1,42,0,8,"lemote_get_isa_isr@456-464@sys/arch/loongson/loongson/yeeloong_machdep.c","sys/arch/loongson/loongson/yeeloong_machdep.c","lemote_get_isa_isr",456,464
7,1,49,0,9,"fuloong_powerdown@471-480@sys/arch/loongson/loongson/yeeloong_machdep.c","sys/arch/loongson/loongson/yeeloong_machdep.c","fuloong_powerdown",471,480
5,1,19,0,4,"yeeloong_powerdown@483-487@sys/arch/loongson/loongson/yeeloong_machdep.c","sys/arch/loongson/loongson/yeeloong_machdep.c","yeeloong_powerdown",483,487
5,1,22,0,4,"lemote_reset@490-494@sys/arch/loongson/loongson/yeeloong_machdep.c","sys/arch/loongson/loongson/yeeloong_machdep.c","lemote_reset",490,494
18,4,87,1,23,"fuloong_setup@497-520@sys/arch/loongson/loongson/yeeloong_machdep.c","sys/arch/loongson/loongson/yeeloong_machdep.c","fuloong_setup",497,520
5,1,14,1,5,"yeeloong_setup@523-528@sys/arch/loongson/loongson/yeeloong_machdep.c","sys/arch/loongson/loongson/yeeloong_machdep.c","yeeloong_setup",523,528
4,1,10,1,3,"ebenton_setup@531-534@sys/arch/loongson/loongson/yeeloong_machdep.c","sys/arch/loongson/loongson/yeeloong_machdep.c","ebenton_setup",531,534
25,10,146,2,37,"lemote_device_register@537-574@sys/arch/loongson/loongson/yeeloong_machdep.c","sys/arch/loongson/loongson/yeeloong_machdep.c","lemote_device_register",537,574
4,1,15,1,3,"pmon_cnprobe@30-33@sys/arch/loongson/stand/boot/cons.c","sys/arch/loongson/stand/boot/cons.c","pmon_cnprobe",30,33
3,1,9,1,2,"pmon_cninit@36-38@sys/arch/loongson/stand/boot/cons.c","sys/arch/loongson/stand/boot/cons.c","pmon_cninit",36,38
23,5,118,1,36,"pmon_cngetc@41-77@sys/arch/loongson/stand/boot/cons.c","sys/arch/loongson/stand/boot/cons.c","pmon_cngetc",41,77
7,2,29,2,6,"pmon_cnputc@80-86@sys/arch/loongson/stand/boot/cons.c","sys/arch/loongson/stand/boot/cons.c","pmon_cnputc",80,86
27,7,165,6,32,"pmon_iostrategy@69-101@sys/arch/loongson/stand/boot/dev.c","sys/arch/loongson/stand/boot/dev.c","pmon_iostrategy",69,101
33,5,197,2,48,"pmon_ioopen@104-152@sys/arch/loongson/stand/boot/dev.c","sys/arch/loongson/stand/boot/dev.c","pmon_ioopen",104,152
13,2,70,1,14,"pmon_ioclose@155-169@sys/arch/loongson/stand/boot/dev.c","sys/arch/loongson/stand/boot/dev.c","pmon_ioclose",155,169
31,7,215,1,44,"pmon_getdisklabel@175-219@sys/arch/loongson/stand/boot/dev.c","sys/arch/loongson/stand/boot/dev.c","pmon_getdisklabel",175,219
42,15,321,5,59,"devparse@43-102@sys/arch/loongson/stand/boot/devopen.c","sys/arch/loongson/stand/boot/devopen.c","devparse",43,102
13,3,114,3,16,"devopen@105-121@sys/arch/loongson/stand/boot/devopen.c","sys/arch/loongson/stand/boot/devopen.c","devopen",105,121
35,8,222,2,44,"run_loadfile@31-75@sys/arch/loongson/stand/boot/exec.c","sys/arch/loongson/stand/boot/exec.c","run_loadfile",31,75
4,1,13,2,3,"cnspeed@62-65@sys/arch/loongson/stand/boot/machdep.c","sys/arch/loongson/stand/boot/machdep.c","cnspeed",62,65
4,1,10,1,3,"ttyname@68-71@sys/arch/loongson/stand/boot/machdep.c","sys/arch/loongson/stand/boot/machdep.c","ttyname",68,71
4,1,11,1,4,"ttydev@74-78@sys/arch/loongson/stand/boot/machdep.c","sys/arch/loongson/stand/boot/machdep.c","ttydev",74,78
52,16,305,2,83,"devboot@88-171@sys/arch/loongson/stand/boot/machdep.c","sys/arch/loongson/stand/boot/machdep.c","devboot",88,171
4,1,8,0,3,"getsecs@178-181@sys/arch/loongson/stand/boot/machdep.c","sys/arch/loongson/stand/boot/machdep.c","getsecs",178,181
14,4,56,0,21,"machdep@188-209@sys/arch/loongson/stand/boot/machdep.c","sys/arch/loongson/stand/boot/machdep.c","machdep",188,209
15,6,84,0,28,"main@212-240@sys/arch/loongson/stand/boot/machdep.c","sys/arch/loongson/stand/boot/machdep.c","main",212,240
11,1,23,0,11,"gdium_abort@243-254@sys/arch/loongson/stand/boot/machdep.c","sys/arch/loongson/stand/boot/machdep.c","gdium_abort",243,254
5,1,28,6,5,"rd_iostrategy@31-36@sys/arch/loongson/stand/boot/rd.c","sys/arch/loongson/stand/boot/rd.c","rd_iostrategy",31,36
4,1,14,2,3,"rd_ioopen@39-42@sys/arch/loongson/stand/boot/rd.c","sys/arch/loongson/stand/boot/rd.c","rd_ioopen",39,42
4,1,12,1,3,"rd_ioclose@45-48@sys/arch/loongson/stand/boot/rd.c","sys/arch/loongson/stand/boot/rd.c","rd_ioclose",45,48
10,6,66,0,11,"rd_isvalid@51-62@sys/arch/loongson/stand/boot/rd.c","sys/arch/loongson/stand/boot/rd.c","rd_isvalid",51,62
4,1,19,0,3,"rd_invalidate@65-68@sys/arch/loongson/stand/boot/rd.c","sys/arch/loongson/stand/boot/rd.c","rd_invalidate",65,68
11,3,52,2,11,"rdfs_open@74-85@sys/arch/loongson/stand/boot/rd.c","sys/arch/loongson/stand/boot/rd.c","rdfs_open",74,85
4,1,12,1,3,"rdfs_close@88-91@sys/arch/loongson/stand/boot/rd.c","sys/arch/loongson/stand/boot/rd.c","rdfs_close",88,91
9,2,57,4,9,"rdfs_read@94-103@sys/arch/loongson/stand/boot/rd.c","sys/arch/loongson/stand/boot/rd.c","rdfs_read",94,103
4,1,23,4,3,"rdfs_write@106-109@sys/arch/loongson/stand/boot/rd.c","sys/arch/loongson/stand/boot/rd.c","rdfs_write",106,109
15,3,52,3,15,"rdfs_seek@112-127@sys/arch/loongson/stand/boot/rd.c","sys/arch/loongson/stand/boot/rd.c","rdfs_seek",112,127
4,1,17,2,3,"rdfs_stat@130-133@sys/arch/loongson/stand/boot/rd.c","sys/arch/loongson/stand/boot/rd.c","rdfs_stat",130,133
4,1,16,2,3,"rdfs_readdir@137-140@sys/arch/loongson/stand/boot/rd.c","sys/arch/loongson/stand/boot/rd.c","rdfs_readdir",137,140
9,4,60,3,11,"cbus_match@82-93@sys/arch/luna88k/cbus/cbus.c","sys/arch/luna88k/cbus/cbus.c","cbus_match",82,93
20,3,174,3,26,"cbus_attach@96-122@sys/arch/luna88k/cbus/cbus.c","sys/arch/luna88k/cbus/cbus.c","cbus_attach",96,122
9,3,56,2,10,"cbus_print@125-135@sys/arch/luna88k/cbus/cbus.c","sys/arch/luna88k/cbus/cbus.c","cbus_print",125,135
28,8,189,5,38,"cbus_isrlink@141-179@sys/arch/luna88k/cbus/cbus.c","sys/arch/luna88k/cbus/cbus.c","cbus_isrlink",141,179
26,8,181,2,38,"cbus_isrunlink@185-223@sys/arch/luna88k/cbus/cbus.c","sys/arch/luna88k/cbus/cbus.c","cbus_isrunlink",185,223
32,11,187,1,40,"cbus_isrdispatch@229-269@sys/arch/luna88k/cbus/cbus.c","sys/arch/luna88k/cbus/cbus.c","cbus_isrdispatch",229,269
9,3,46,1,10,"cbus_intr_registered@275-285@sys/arch/luna88k/cbus/cbus.c","sys/arch/luna88k/cbus/cbus.c","cbus_intr_registered",275,285
18,5,115,1,33,"cbus_intr@315-348@sys/arch/luna88k/cbus/cbus.c","sys/arch/luna88k/cbus/cbus.c","cbus_intr",315,348
33,8,233,3,48,"pcic_cbus_probe@172-220@sys/arch/luna88k/cbus/i82365_cbus.c","sys/arch/luna88k/cbus/i82365_cbus.c","pcic_cbus_probe",172,220
70,9,471,3,96,"pcic_cbus_attach@223-319@sys/arch/luna88k/cbus/i82365_cbus.c","sys/arch/luna88k/cbus/i82365_cbus.c","pcic_cbus_attach",223,319
35,7,282,6,51,"pcic_cbus_chip_intr_establish@322-373@sys/arch/luna88k/cbus/i82365_cbus.c","sys/arch/luna88k/cbus/i82365_cbus.c","pcic_cbus_chip_intr_establish",322,373
22,3,154,2,31,"pcic_cbus_chip_intr_disestablish@376-407@sys/arch/luna88k/cbus/i82365_cbus.c","sys/arch/luna88k/cbus/i82365_cbus.c","pcic_cbus_chip_intr_disestablish",376,407
12,2,77,2,12,"pcic_cbus_chip_intr_string@410-422@sys/arch/luna88k/cbus/i82365_cbus.c","sys/arch/luna88k/cbus/i82365_cbus.c","pcic_cbus_chip_intr_string",410,422
14,5,82,1,16,"pcic_cbus_intlevel_find@429-445@sys/arch/luna88k/cbus/i82365_cbus.c","sys/arch/luna88k/cbus/i82365_cbus.c","pcic_cbus_intlevel_find",429,445
49,10,357,5,74,"pcic_cbus_chip_io_alloc@451-525@sys/arch/luna88k/cbus/i82365_cbus.c","sys/arch/luna88k/cbus/i82365_cbus.c","pcic_cbus_chip_io_alloc",451,525
8,1,42,2,8,"pcic_cbus_chip_io_free@528-536@sys/arch/luna88k/cbus/i82365_cbus.c","sys/arch/luna88k/cbus/i82365_cbus.c","pcic_cbus_chip_io_free",528,536
8,1,65,3,7,"nec86_ym_read@105-112@sys/arch/luna88k/cbus/nec86.c","sys/arch/luna88k/cbus/nec86.c","nec86_ym_read",105,112
8,1,63,3,7,"nec86_ym_write@115-122@sys/arch/luna88k/cbus/nec86.c","sys/arch/luna88k/cbus/nec86.c","nec86_ym_write",115,122
21,9,96,3,30,"nec86_probesubr@128-158@sys/arch/luna88k/cbus/nec86.c","sys/arch/luna88k/cbus/nec86.c","nec86_probesubr",128,158
61,9,330,1,75,"nec86_attachsubr@168-243@sys/arch/luna88k/cbus/nec86.c","sys/arch/luna88k/cbus/nec86.c","nec86_attachsubr",168,243
25,1,184,1,34,"nec86hw_attach@126-160@sys/arch/luna88k/cbus/nec86hw.c","sys/arch/luna88k/cbus/nec86hw.c","nec86hw_attach",126,160
19,3,115,2,28,"nec86hw_open@167-195@sys/arch/luna88k/cbus/nec86hw.c","sys/arch/luna88k/cbus/nec86hw.c","nec86hw_open",167,195
9,1,57,1,11,"nec86hw_close@198-209@sys/arch/luna88k/cbus/nec86hw.c","sys/arch/luna88k/cbus/nec86hw.c","nec86hw_close",198,209
24,4,194,5,25,"nec86hw_set_params@212-237@sys/arch/luna88k/cbus/nec86hw.c","sys/arch/luna88k/cbus/nec86hw.c","nec86hw_set_params",212,237
9,3,46,2,10,"nec86hw_round_blocksize@240-250@sys/arch/luna88k/cbus/nec86hw.c","sys/arch/luna88k/cbus/nec86hw.c","nec86hw_round_blocksize",240,250
9,2,49,2,12,"nec86hw_set_out_port@253-265@sys/arch/luna88k/cbus/nec86hw.c","sys/arch/luna88k/cbus/nec86hw.c","nec86hw_set_out_port",253,265
6,1,33,1,7,"nec86hw_get_out_port@268-275@sys/arch/luna88k/cbus/nec86hw.c","sys/arch/luna88k/cbus/nec86hw.c","nec86hw_get_out_port",268,275
9,2,49,2,12,"nec86hw_set_in_port@278-290@sys/arch/luna88k/cbus/nec86hw.c","sys/arch/luna88k/cbus/nec86hw.c","nec86hw_set_in_port",278,290
6,1,33,1,7,"nec86hw_get_in_port@293-300@sys/arch/luna88k/cbus/nec86hw.c","sys/arch/luna88k/cbus/nec86hw.c","nec86hw_get_in_port",293,300
18,5,105,1,26,"nec86hw_commit_settings@303-329@sys/arch/luna88k/cbus/nec86hw.c","sys/arch/luna88k/cbus/nec86hw.c","nec86hw_commit_settings",303,329
5,1,21,2,6,"nec86hw_setfd@332-338@sys/arch/luna88k/cbus/nec86hw.c","sys/arch/luna88k/cbus/nec86hw.c","nec86hw_setfd",332,338
5,1,22,2,6,"nec86hw_mixer_set_port@341-347@sys/arch/luna88k/cbus/nec86hw.c","sys/arch/luna88k/cbus/nec86hw.c","nec86hw_mixer_set_port",341,347
5,1,22,2,6,"nec86hw_mixer_get_port@350-356@sys/arch/luna88k/cbus/nec86hw.c","sys/arch/luna88k/cbus/nec86hw.c","nec86hw_mixer_get_port",350,356
5,1,22,2,6,"nec86hw_mixer_query_devinfo@359-365@sys/arch/luna88k/cbus/nec86hw.c","sys/arch/luna88k/cbus/nec86hw.c","nec86hw_mixer_query_devinfo",359,365
25,2,183,2,44,"nec86hw_set_output_block@368-412@sys/arch/luna88k/cbus/nec86hw.c","sys/arch/luna88k/cbus/nec86hw.c","nec86hw_set_output_block",368,412
18,1,150,2,27,"nec86hw_set_input_block@415-442@sys/arch/luna88k/cbus/nec86hw.c","sys/arch/luna88k/cbus/nec86hw.c","nec86hw_set_input_block",415,442
15,1,94,3,18,"nec86hw_pdma_init_output@445-463@sys/arch/luna88k/cbus/nec86hw.c","sys/arch/luna88k/cbus/nec86hw.c","nec86hw_pdma_init_output",445,463
15,1,94,3,18,"nec86hw_pdma_init_input@466-484@sys/arch/luna88k/cbus/nec86hw.c","sys/arch/luna88k/cbus/nec86hw.c","nec86hw_pdma_init_input",466,484
33,5,215,5,54,"nec86hw_pdma_output@487-541@sys/arch/luna88k/cbus/nec86hw.c","sys/arch/luna88k/cbus/nec86hw.c","nec86hw_pdma_output",487,541
29,4,196,5,39,"nec86hw_pdma_input@544-583@sys/arch/luna88k/cbus/nec86hw.c","sys/arch/luna88k/cbus/nec86hw.c","nec86hw_pdma_input",544,583
9,1,49,1,12,"nec86hw_halt_pdma@586-598@sys/arch/luna88k/cbus/nec86hw.c","sys/arch/luna88k/cbus/nec86hw.c","nec86hw_halt_pdma",586,598
9,1,49,1,12,"nec86hw_cont_pdma@601-613@sys/arch/luna88k/cbus/nec86hw.c","sys/arch/luna88k/cbus/nec86hw.c","nec86hw_cont_pdma",601,613
20,3,101,2,22,"nec86hw_speaker_ctl@616-638@sys/arch/luna88k/cbus/nec86hw.c","sys/arch/luna88k/cbus/nec86hw.c","nec86hw_speaker_ctl",616,638
16,5,103,2,18,"nec86hw_rate_bits@641-659@sys/arch/luna88k/cbus/nec86hw.c","sys/arch/luna88k/cbus/nec86hw.c","nec86hw_rate_bits",641,659
7,2,30,1,8,"nec86hw_round_watermark@662-670@sys/arch/luna88k/cbus/nec86hw.c","sys/arch/luna88k/cbus/nec86hw.c","nec86hw_round_watermark",662,670
12,2,55,1,14,"nec86hw_reset@677-691@sys/arch/luna88k/cbus/nec86hw.c","sys/arch/luna88k/cbus/nec86hw.c","nec86hw_reset",677,691
9,1,52,1,9,"nec86hw_set_mode_playing@697-706@sys/arch/luna88k/cbus/nec86hw.c","sys/arch/luna88k/cbus/nec86hw.c","nec86hw_set_mode_playing",697,706
9,1,52,1,9,"nec86hw_set_mode_recording@709-718@sys/arch/luna88k/cbus/nec86hw.c","sys/arch/luna88k/cbus/nec86hw.c","nec86hw_set_mode_recording",709,718
8,1,50,3,8,"nec86hw_set_volume@724-732@sys/arch/luna88k/cbus/nec86hw.c","sys/arch/luna88k/cbus/nec86hw.c","nec86hw_set_volume",724,732
9,1,52,1,10,"nec86hw_start_fifo@738-748@sys/arch/luna88k/cbus/nec86hw.c","sys/arch/luna88k/cbus/nec86hw.c","nec86hw_start_fifo",738,748
9,1,52,1,10,"nec86hw_stop_fifo@751-761@sys/arch/luna88k/cbus/nec86hw.c","sys/arch/luna88k/cbus/nec86hw.c","nec86hw_stop_fifo",751,761
9,1,52,1,9,"nec86hw_enable_fifointr@764-773@sys/arch/luna88k/cbus/nec86hw.c","sys/arch/luna88k/cbus/nec86hw.c","nec86hw_enable_fifointr",764,773
9,1,52,1,9,"nec86hw_disable_fifointr@776-785@sys/arch/luna88k/cbus/nec86hw.c","sys/arch/luna88k/cbus/nec86hw.c","nec86hw_disable_fifointr",776,785
8,1,44,1,9,"nec86hw_seeif_intrflg@788-797@sys/arch/luna88k/cbus/nec86hw.c","sys/arch/luna88k/cbus/nec86hw.c","nec86hw_seeif_intrflg",788,797
11,1,67,1,11,"nec86hw_clear_intrflg@800-811@sys/arch/luna88k/cbus/nec86hw.c","sys/arch/luna88k/cbus/nec86hw.c","nec86hw_clear_intrflg",800,811
11,1,67,1,11,"nec86hw_reset_fifo@814-825@sys/arch/luna88k/cbus/nec86hw.c","sys/arch/luna88k/cbus/nec86hw.c","nec86hw_reset_fifo",814,825
10,5,74,2,21,"nec86hw_set_watermark@828-849@sys/arch/luna88k/cbus/nec86hw.c","sys/arch/luna88k/cbus/nec86hw.c","nec86hw_set_watermark",828,849
11,2,65,2,11,"nec86hw_set_precision_real@852-863@sys/arch/luna88k/cbus/nec86hw.c","sys/arch/luna88k/cbus/nec86hw.c","nec86hw_set_precision_real",852,863
10,1,61,2,10,"nec86hw_set_rate_real@866-876@sys/arch/luna88k/cbus/nec86hw.c","sys/arch/luna88k/cbus/nec86hw.c","nec86hw_set_rate_real",866,876
23,3,141,1,36,"nec86hw_output_chunk@882-918@sys/arch/luna88k/cbus/nec86hw.c","sys/arch/luna88k/cbus/nec86hw.c","nec86hw_output_chunk",882,918
15,2,93,2,17,"nec86fifo_output_mono_8_direct@924-941@sys/arch/luna88k/cbus/nec86hw.c","sys/arch/luna88k/cbus/nec86hw.c","nec86fifo_output_mono_8_direct",924,941
19,3,173,2,24,"nec86fifo_output_mono_16_direct@944-968@sys/arch/luna88k/cbus/nec86hw.c","sys/arch/luna88k/cbus/nec86hw.c","nec86fifo_output_mono_16_direct",944,968
12,2,91,2,15,"nec86fifo_output_stereo_8_direct@971-986@sys/arch/luna88k/cbus/nec86hw.c","sys/arch/luna88k/cbus/nec86hw.c","nec86fifo_output_stereo_8_direct",971,986
22,3,185,2,31,"nec86fifo_output_stereo_16_direct@989-1020@sys/arch/luna88k/cbus/nec86hw.c","sys/arch/luna88k/cbus/nec86hw.c","nec86fifo_output_stereo_16_direct",989,1020
34,3,219,2,45,"nec86fifo_output_mono_8_resamp@1026-1071@sys/arch/luna88k/cbus/nec86hw.c","sys/arch/luna88k/cbus/nec86hw.c","nec86fifo_output_mono_8_resamp",1026,1071
38,3,264,2,50,"nec86fifo_output_mono_16_resamp@1074-1124@sys/arch/luna88k/cbus/nec86hw.c","sys/arch/luna88k/cbus/nec86hw.c","nec86fifo_output_mono_16_resamp",1074,1124
19,2,123,1,24,"nec86hw_input_chunk@1130-1154@sys/arch/luna88k/cbus/nec86hw.c","sys/arch/luna88k/cbus/nec86hw.c","nec86hw_input_chunk",1130,1154
13,2,96,2,17,"nec86fifo_input_mono_8_direct@1160-1177@sys/arch/luna88k/cbus/nec86hw.c","sys/arch/luna88k/cbus/nec86hw.c","nec86fifo_input_mono_8_direct",1160,1177
19,3,178,2,29,"nec86fifo_input_mono_16_direct@1180-1209@sys/arch/luna88k/cbus/nec86hw.c","sys/arch/luna88k/cbus/nec86hw.c","nec86fifo_input_mono_16_direct",1180,1209
11,2,82,2,13,"nec86fifo_input_stereo_8_direct@1212-1225@sys/arch/luna88k/cbus/nec86hw.c","sys/arch/luna88k/cbus/nec86hw.c","nec86fifo_input_stereo_8_direct",1212,1225
21,3,180,2,24,"nec86fifo_input_stereo_16_direct@1228-1252@sys/arch/luna88k/cbus/nec86hw.c","sys/arch/luna88k/cbus/nec86hw.c","nec86fifo_input_stereo_16_direct",1228,1252
9,2,65,2,10,"nec86fifo_padding@1258-1268@sys/arch/luna88k/cbus/nec86hw.c","sys/arch/luna88k/cbus/nec86hw.c","nec86fifo_padding",1258,1268
43,8,221,1,53,"nec86hw_intr@1274-1327@sys/arch/luna88k/cbus/nec86hw.c","sys/arch/luna88k/cbus/nec86hw.c","nec86hw_intr",1274,1327
4,1,11,1,3,"nec86_get_props@1330-1333@sys/arch/luna88k/cbus/nec86hw.c","sys/arch/luna88k/cbus/nec86hw.c","nec86_get_props",1330,1333
7,2,43,3,8,"necsb_match@74-82@sys/arch/luna88k/cbus/necsb.c","sys/arch/luna88k/cbus/necsb.c","necsb_match",74,82
24,5,177,3,34,"necsb_attach@85-119@sys/arch/luna88k/cbus/necsb.c","sys/arch/luna88k/cbus/necsb.c","necsb_attach",85,119
7,2,43,3,8,"pcex_match@68-76@sys/arch/luna88k/cbus/pcex.c","sys/arch/luna88k/cbus/pcex.c","pcex_match",68,76
9,2,62,3,10,"pcex_attach@79-89@sys/arch/luna88k/cbus/pcex.c","sys/arch/luna88k/cbus/pcex.c","pcex_attach",79,89
10,3,41,4,9,"pcexopen@92-101@sys/arch/luna88k/cbus/pcex.c","sys/arch/luna88k/cbus/pcex.c","pcexopen",92,101
4,1,23,4,3,"pcexclose@104-107@sys/arch/luna88k/cbus/pcex.c","sys/arch/luna88k/cbus/pcex.c","pcexclose",104,107
17,7,87,3,18,"pcexmmap@110-128@sys/arch/luna88k/cbus/pcex.c","sys/arch/luna88k/cbus/pcex.c","pcexmmap",110,128
20,6,110,5,25,"pcexioctl@131-156@sys/arch/luna88k/cbus/pcex.c","sys/arch/luna88k/cbus/pcex.c","pcexioctl",131,156
11,3,72,2,12,"pcex_set_int@159-171@sys/arch/luna88k/cbus/pcex.c","sys/arch/luna88k/cbus/pcex.c","pcex_set_int",159,171
10,3,54,2,11,"pcex_reset_int@174-185@sys/arch/luna88k/cbus/pcex.c","sys/arch/luna88k/cbus/pcex.c","pcex_reset_int",174,185
13,5,75,2,17,"pcex_wait_int@188-205@sys/arch/luna88k/cbus/pcex.c","sys/arch/luna88k/cbus/pcex.c","pcex_wait_int",188,205
6,2,23,1,9,"pcex_intr@208-217@sys/arch/luna88k/cbus/pcex.c","sys/arch/luna88k/cbus/pcex.c","pcex_intr",208,217
6,1,44,3,6,"lewrcsr@92-98@sys/arch/luna88k/dev/if_le.c","sys/arch/luna88k/dev/if_le.c","lewrcsr",92,98
8,1,49,2,8,"lerdcsr@101-109@sys/arch/luna88k/dev/if_le.c","sys/arch/luna88k/dev/if_le.c","lerdcsr",101,109
7,2,47,3,8,"le_match@112-120@sys/arch/luna88k/dev/if_le.c","sys/arch/luna88k/dev/if_le.c","le_match",112,120
24,1,195,3,30,"le_attach@123-153@sys/arch/luna88k/dev/if_le.c","sys/arch/luna88k/dev/if_le.c","le_attach",123,153
41,9,363,1,49,"myetheraddr@170-219@sys/arch/luna88k/dev/if_le.c","sys/arch/luna88k/dev/if_le.c","myetheraddr",170,219
9,3,60,3,9,"lcd_match@110-119@sys/arch/luna88k/dev/lcd.c","sys/arch/luna88k/dev/lcd.c","lcd_match",110,119
5,1,27,3,6,"lcd_attach@122-128@sys/arch/luna88k/dev/lcd.c","sys/arch/luna88k/dev/lcd.c","lcd_attach",122,128
13,4,78,4,14,"lcdopen@135-149@sys/arch/luna88k/dev/lcd.c","sys/arch/luna88k/dev/lcd.c","lcdopen",135,149
8,1,49,4,9,"lcdclose@152-161@sys/arch/luna88k/dev/lcd.c","sys/arch/luna88k/dev/lcd.c","lcdclose",152,161
16,4,91,3,20,"lcdwrite@164-184@sys/arch/luna88k/dev/lcd.c","sys/arch/luna88k/dev/lcd.c","lcdwrite",164,184
66,25,254,5,75,"lcdioctl@187-262@sys/arch/luna88k/dev/lcd.c","sys/arch/luna88k/dev/lcd.c","lcdioctl",187,262
16,2,93,0,18,"lcdbusywait@268-286@sys/arch/luna88k/dev/lcd.c","sys/arch/luna88k/dev/lcd.c","lcdbusywait",268,286
12,1,69,1,14,"lcdput@289-303@sys/arch/luna88k/dev/lcd.c","sys/arch/luna88k/dev/lcd.c","lcdput",289,303
12,1,69,1,14,"lcdctrl@306-320@sys/arch/luna88k/dev/lcd.c","sys/arch/luna88k/dev/lcd.c","lcdctrl",306,320
6,2,29,1,6,"lcdshow@323-329@sys/arch/luna88k/dev/lcd.c","sys/arch/luna88k/dev/lcd.c","lcdshow",323,329
12,1,60,0,13,"greeting@332-345@sys/arch/luna88k/dev/lcd.c","sys/arch/luna88k/dev/lcd.c","greeting",332,345
11,5,77,3,14,"omfbmatch@173-187@sys/arch/luna88k/dev/lunafb.c","sys/arch/luna88k/dev/lunafb.c","omfbmatch",173,187
22,2,150,3,24,"omfbattach@190-214@sys/arch/luna88k/dev/lunafb.c","sys/arch/luna88k/dev/lunafb.c","omfbattach",190,214
11,1,75,1,11,"omfb_cnattach@217-228@sys/arch/luna88k/dev/lunafb.c","sys/arch/luna88k/dev/lunafb.c","omfb_cnattach",217,228
39,15,209,5,50,"omfbioctl@231-281@sys/arch/luna88k/dev/lunafb.c","sys/arch/luna88k/dev/lunafb.c","omfbioctl",231,281
13,7,113,3,17,"omfbmmap@289-306@sys/arch/luna88k/dev/lunafb.c","sys/arch/luna88k/dev/lunafb.c","omfbmmap",289,306
21,7,177,2,26,"omgetcmap@309-335@sys/arch/luna88k/dev/lunafb.c","sys/arch/luna88k/dev/lunafb.c","omgetcmap",309,335
43,11,429,2,49,"omsetcmap@338-387@sys/arch/luna88k/dev/lunafb.c","sys/arch/luna88k/dev/lunafb.c","omsetcmap",338,387
57,8,395,2,78,"omfb_getdevconfig@390-468@sys/arch/luna88k/dev/lunafb.c","sys/arch/luna88k/dev/lunafb.c","omfb_getdevconfig",390,468
14,2,104,6,15,"omfb_alloc_screen@471-486@sys/arch/luna88k/dev/lunafb.c","sys/arch/luna88k/dev/lunafb.c","omfb_alloc_screen",471,486
5,1,24,2,5,"omfb_free_screen@489-494@sys/arch/luna88k/dev/lunafb.c","sys/arch/luna88k/dev/lunafb.c","omfb_free_screen",489,494
5,1,36,5,4,"omfb_show_screen@497-501@sys/arch/luna88k/dev/lunafb.c","sys/arch/luna88k/dev/lunafb.c","omfb_show_screen",497,501
6,1,46,3,6,"omfb_load_font@504-510@sys/arch/luna88k/dev/lunafb.c","sys/arch/luna88k/dev/lunafb.c","omfb_load_font",504,510
6,1,40,2,6,"omfb_list_font@513-519@sys/arch/luna88k/dev/lunafb.c","sys/arch/luna88k/dev/lunafb.c","omfb_list_font",513,519
33,10,186,2,39,"omfb_set_gfxmode@526-565@sys/arch/luna88k/dev/lunafb.c","sys/arch/luna88k/dev/lunafb.c","omfb_set_gfxmode",526,565
9,2,86,1,9,"omfb_clear_framebuffer@571-580@sys/arch/luna88k/dev/lunafb.c","sys/arch/luna88k/dev/lunafb.c","omfb_clear_framebuffer",571,580
54,12,454,1,71,"omfb_set_default_cmap@598-669@sys/arch/luna88k/dev/lunafb.c","sys/arch/luna88k/dev/lunafb.c","omfb_set_default_cmap",598,669
7,2,38,3,7,"wsmatch@150-157@sys/arch/luna88k/dev/lunaws.c","sys/arch/luna88k/dev/lunaws.c","wsmatch",150,157
37,2,341,3,46,"wsattach@160-206@sys/arch/luna88k/dev/lunaws.c","sys/arch/luna88k/dev/lunaws.c","wsattach",160,206
7,2,61,3,7,"ws_submatch_kbd@209-216@sys/arch/luna88k/dev/lunaws.c","sys/arch/luna88k/dev/lunaws.c","ws_submatch_kbd",209,216
7,2,61,3,7,"ws_submatch_mouse@221-228@sys/arch/luna88k/dev/lunaws.c","sys/arch/luna88k/dev/lunaws.c","ws_submatch_mouse",221,228
22,5,131,1,23,"wsintr@234-257@sys/arch/luna88k/dev/lunaws.c","sys/arch/luna88k/dev/lunaws.c","wsintr",234,257
31,10,223,1,42,"wssoftintr@260-302@sys/arch/luna88k/dev/lunaws.c","sys/arch/luna88k/dev/lunaws.c","wssoftintr",260,302
25,7,145,2,31,"omkbd_input@305-336@sys/arch/luna88k/dev/lunaws.c","sys/arch/luna88k/dev/lunaws.c","omkbd_input",305,336
5,2,39,4,4,"omkbd_decode@339-343@sys/arch/luna88k/dev/lunaws.c","sys/arch/luna88k/dev/lunaws.c","omkbd_decode",339,343
6,1,40,3,6,"ws_cngetc@346-352@sys/arch/luna88k/dev/lunaws.c","sys/arch/luna88k/dev/lunaws.c","ws_cngetc",346,352
3,1,11,2,2,"ws_cnpollc@355-357@sys/arch/luna88k/dev/lunaws.c","sys/arch/luna88k/dev/lunaws.c","ws_cnpollc",355,357
5,1,21,0,7,"ws_cnattach@360-367@sys/arch/luna88k/dev/lunaws.c","sys/arch/luna88k/dev/lunaws.c","ws_cnattach",360,367
4,1,14,2,3,"omkbd_enable@370-373@sys/arch/luna88k/dev/lunaws.c","sys/arch/luna88k/dev/lunaws.c","omkbd_enable",370,373
7,2,51,2,8,"omkbd_set_leds@376-384@sys/arch/luna88k/dev/lunaws.c","sys/arch/luna88k/dev/lunaws.c","omkbd_set_leds",376,384
20,9,103,5,24,"omkbd_ioctl@387-411@sys/arch/luna88k/dev/lunaws.c","sys/arch/luna88k/dev/lunaws.c","omkbd_ioctl",387,411
7,1,34,1,7,"omms_enable@416-423@sys/arch/luna88k/dev/lunaws.c","sys/arch/luna88k/dev/lunaws.c","omms_enable",416,423
9,2,47,5,10,"omms_ioctl@427-437@sys/arch/luna88k/dev/lunaws.c","sys/arch/luna88k/dev/lunaws.c","omms_ioctl",427,437
6,1,31,1,6,"omms_disable@440-446@sys/arch/luna88k/dev/lunaws.c","sys/arch/luna88k/dev/lunaws.c","omms_disable",440,446
18,2,148,2,40,"spc_attach@193-233@sys/arch/luna88k/dev/mb89352.c","sys/arch/luna88k/dev/mb89352.c","spc_attach",193,233
21,1,186,1,24,"spc_reset@242-266@sys/arch/luna88k/dev/mb89352.c","sys/arch/luna88k/dev/mb89352.c","spc_reset",242,266
10,1,80,1,10,"spc_scsi_reset@273-283@sys/arch/luna88k/dev/mb89352.c","sys/arch/luna88k/dev/mb89352.c","spc_scsi_reset",273,283
51,8,390,1,63,"spc_init@289-352@sys/arch/luna88k/dev/mb89352.c","sys/arch/luna88k/dev/mb89352.c","spc_init",289,352
10,1,67,2,11,"spc_acb_free@355-366@sys/arch/luna88k/dev/mb89352.c","sys/arch/luna88k/dev/mb89352.c","spc_acb_free",355,366
12,2,72,1,14,"spc_acb_alloc@369-383@sys/arch/luna88k/dev/mb89352.c","sys/arch/luna88k/dev/mb89352.c","spc_acb_alloc",369,383
40,6,280,1,56,"spc_scsi_cmd@412-468@sys/arch/luna88k/dev/mb89352.c","sys/arch/luna88k/dev/mb89352.c","spc_scsi_cmd",412,468
15,4,88,3,19,"spc_poll@474-493@sys/arch/luna88k/dev/mb89352.c","sys/arch/luna88k/dev/mb89352.c","spc_poll",474,493
9,2,58,2,9,"spc_sched_msgout@500-509@sys/arch/luna88k/dev/mb89352.c","sys/arch/luna88k/dev/mb89352.c","spc_sched_msgout",500,509
11,3,87,2,13,"spc_setsync@515-528@sys/arch/luna88k/dev/mb89352.c","sys/arch/luna88k/dev/mb89352.c","spc_setsync",515,528
19,2,170,2,37,"spc_select@535-572@sys/arch/luna88k/dev/mb89352.c","sys/arch/luna88k/dev/mb89352.c","spc_select",535,572
50,7,325,2,70,"spc_reselect@575-645@sys/arch/luna88k/dev/mb89352.c","sys/arch/luna88k/dev/mb89352.c","spc_reselect",575,645
24,3,160,1,30,"spc_sched@654-684@sys/arch/luna88k/dev/mb89352.c","sys/arch/luna88k/dev/mb89352.c","spc_sched",654,684
27,4,223,2,28,"spc_sense@687-715@sys/arch/luna88k/dev/mb89352.c","sys/arch/luna88k/dev/mb89352.c","spc_sense",687,715
51,14,309,2,71,"spc_done@721-792@sys/arch/luna88k/dev/mb89352.c","sys/arch/luna88k/dev/mb89352.c","spc_done",721,792
8,2,54,2,8,"spc_dequeue@795-803@sys/arch/luna88k/dev/mb89352.c","sys/arch/luna88k/dev/mb89352.c","spc_dequeue",795,803
206,57,1277,1,291,"spc_msgin@815-1106@sys/arch/luna88k/dev/mb89352.c","sys/arch/luna88k/dev/mb89352.c","spc_msgin",815,1106
123,33,805,1,205,"spc_msgout@1112-1317@sys/arch/luna88k/dev/mb89352.c","sys/arch/luna88k/dev/mb89352.c","spc_msgout",1112,1317
84,26,566,3,114,"spc_dataout_pio@1328-1442@sys/arch/luna88k/dev/mb89352.c","sys/arch/luna88k/dev/mb89352.c","spc_dataout_pio",1328,1442
75,28,500,3,110,"spc_datain_pio@1454-1564@sys/arch/luna88k/dev/mb89352.c","sys/arch/luna88k/dev/mb89352.c","spc_datain_pio",1454,1564
253,60,1609,1,381,"spc_intr@1575-1956@sys/arch/luna88k/dev/mb89352.c","sys/arch/luna88k/dev/mb89352.c","spc_intr",1575,1956
14,4,86,2,20,"spc_abort@1959-1979@sys/arch/luna88k/dev/mb89352.c","sys/arch/luna88k/dev/mb89352.c","spc_abort",1959,1979
19,2,104,1,25,"spc_timeout@1982-2007@sys/arch/luna88k/dev/mb89352.c","sys/arch/luna88k/dev/mb89352.c","spc_timeout",1982,2007
16,4,103,1,16,"spc_show_scsi_cmd@2016-2032@sys/arch/luna88k/dev/mb89352.c","sys/arch/luna88k/dev/mb89352.c","spc_show_scsi_cmd",2016,2032
7,1,45,1,7,"spc_print_acb@2035-2042@sys/arch/luna88k/dev/mb89352.c","sys/arch/luna88k/dev/mb89352.c","spc_print_acb",2035,2042
14,2,84,0,14,"spc_print_active_acb@2045-2059@sys/arch/luna88k/dev/mb89352.c","sys/arch/luna88k/dev/mb89352.c","spc_print_active_acb",2045,2059
26,2,189,1,29,"spc_dump89352@2062-2091@sys/arch/luna88k/dev/mb89352.c","sys/arch/luna88k/dev/mb89352.c","spc_dump89352",2062,2091
15,2,120,1,15,"spc_dump_driver@2094-2109@sys/arch/luna88k/dev/mb89352.c","sys/arch/luna88k/dev/mb89352.c","spc_dump_driver",2094,2109
52,7,482,5,58,"om1_putchar@95-153@sys/arch/luna88k/dev/omrasops.c","sys/arch/luna88k/dev/omrasops.c","om1_putchar",95,153
107,14,917,5,127,"om4_putchar@160-287@sys/arch/luna88k/dev/omrasops.c","sys/arch/luna88k/dev/omrasops.c","om4_putchar",160,287
14,2,146,5,21,"om_erasecols@290-311@sys/arch/luna88k/dev/omrasops.c","sys/arch/luna88k/dev/omrasops.c","om_erasecols",290,311
21,4,187,4,23,"om_eraserows@314-337@sys/arch/luna88k/dev/omrasops.c","sys/arch/luna88k/dev/omrasops.c","om_eraserows",314,337
11,1,89,4,13,"om_copyrows@340-353@sys/arch/luna88k/dev/omrasops.c","sys/arch/luna88k/dev/omrasops.c","om_copyrows",340,353
12,1,106,5,14,"om_copycols@356-370@sys/arch/luna88k/dev/omrasops.c","sys/arch/luna88k/dev/omrasops.c","om_copycols",356,370
47,6,348,4,55,"om1_cursor@377-432@sys/arch/luna88k/dev/omrasops.c","sys/arch/luna88k/dev/omrasops.c","om1_cursor",377,432
51,6,370,4,72,"om4_cursor@439-511@sys/arch/luna88k/dev/omrasops.c","sys/arch/luna88k/dev/omrasops.c","om4_cursor",439,511
8,1,39,1,7,"setup_omrasops1@518-525@sys/arch/luna88k/dev/omrasops.c","sys/arch/luna88k/dev/omrasops.c","setup_omrasops1",518,525
9,1,47,1,13,"setup_omrasops4@528-541@sys/arch/luna88k/dev/omrasops.c","sys/arch/luna88k/dev/omrasops.c","setup_omrasops4",528,541
129,23,759,9,159,"om1_windowmove@102-261@sys/arch/luna88k/dev/omrasops1.c","sys/arch/luna88k/dev/omrasops1.c","om1_windowmove",102,261
183,23,1338,9,213,"om4_windowmove@267-480@sys/arch/luna88k/dev/omrasops1.c","sys/arch/luna88k/dev/omrasops1.c","om4_windowmove",267,480
9,3,60,3,9,"sio_match@61-70@sys/arch/luna88k/dev/sio.c","sys/arch/luna88k/dev/sio.c","sio_match",61,70
18,2,137,3,20,"sio_attach@73-93@sys/arch/luna88k/dev/sio.c","sys/arch/luna88k/dev/sio.c","sio_attach",73,93
9,3,54,2,11,"sio_print@96-107@sys/arch/luna88k/dev/sio.c","sys/arch/luna88k/dev/sio.c","sio_print",96,107
7,1,62,1,11,"xsiointr@110-121@sys/arch/luna88k/dev/sio.c","sys/arch/luna88k/dev/sio.c","xsiointr",110,121
3,1,8,1,2,"nullintr@124-126@sys/arch/luna88k/dev/sio.c","sys/arch/luna88k/dev/sio.c","nullintr",124,126
7,2,38,3,7,"siotty_match@117-124@sys/arch/luna88k/dev/siotty.c","sys/arch/luna88k/dev/siotty.c","siotty_match",117,124
47,5,415,3,52,"siotty_attach@127-179@sys/arch/luna88k/dev/siotty.c","sys/arch/luna88k/dev/siotty.c","siotty_attach",127,179
47,9,252,1,49,"siottyintr@184-233@sys/arch/luna88k/dev/siotty.c","sys/arch/luna88k/dev/siotty.c","siottyintr",184,233
15,3,70,1,16,"siottysoft@236-252@sys/arch/luna88k/dev/siotty.c","sys/arch/luna88k/dev/siotty.c","siottysoft",236,252
33,7,199,2,37,"siotty_rxsoft@255-292@sys/arch/luna88k/dev/siotty.c","sys/arch/luna88k/dev/siotty.c","siotty_rxsoft",255,292
9,2,77,2,9,"siotty_txsoft@295-304@sys/arch/luna88k/dev/siotty.c","sys/arch/luna88k/dev/siotty.c","siotty_txsoft",295,304
24,3,149,1,28,"siostart@307-335@sys/arch/luna88k/dev/siotty.c","sys/arch/luna88k/dev/siotty.c","siostart",307,335
10,2,55,2,13,"siostop@338-351@sys/arch/luna88k/dev/siotty.c","sys/arch/luna88k/dev/siotty.c","siostop",338,351
44,13,343,2,55,"sioparam@354-409@sys/arch/luna88k/dev/siotty.c","sys/arch/luna88k/dev/siotty.c","sioparam",354,409
41,12,203,3,42,"siomctl@412-454@sys/arch/luna88k/dev/siotty.c","sys/arch/luna88k/dev/siotty.c","siomctl",412,454
41,11,293,4,51,"sioopen@459-510@sys/arch/luna88k/dev/siotty.c","sys/arch/luna88k/dev/siotty.c","sioopen",459,510
16,5,134,4,20,"sioclose@513-533@sys/arch/luna88k/dev/siotty.c","sys/arch/luna88k/dev/siotty.c","sioclose",513,533
6,1,59,3,6,"sioread@536-542@sys/arch/luna88k/dev/siotty.c","sys/arch/luna88k/dev/siotty.c","sioread",536,542
6,1,59,3,6,"siowrite@545-551@sys/arch/luna88k/dev/siotty.c","sys/arch/luna88k/dev/siotty.c","siowrite",545,551
50,14,308,5,53,"sioioctl@554-607@sys/arch/luna88k/dev/siotty.c","sys/arch/luna88k/dev/siotty.c","sioioctl",554,607
5,1,27,1,5,"siotty@611-616@sys/arch/luna88k/dev/siotty.c","sys/arch/luna88k/dev/siotty.c","siotty",611,616
6,2,33,3,5,"setsioreg@621-626@sys/arch/luna88k/dev/siotty.c","sys/arch/luna88k/dev/siotty.c","setsioreg",621,626
8,1,36,1,8,"getsiocsr@629-637@sys/arch/luna88k/dev/siotty.c","sys/arch/luna88k/dev/siotty.c","getsiocsr",629,637
15,1,128,1,20,"syscnattach@657-677@sys/arch/luna88k/dev/siotty.c","sys/arch/luna88k/dev/siotty.c","syscnattach",657,677
12,2,69,1,13,"syscngetc@680-693@sys/arch/luna88k/dev/siotty.c","sys/arch/luna88k/dev/siotty.c","syscngetc",680,693
12,2,73,2,12,"syscnputc@696-708@sys/arch/luna88k/dev/siotty.c","sys/arch/luna88k/dev/siotty.c","syscnputc",696,708
9,4,60,3,12,"spc_mainbus_match@79-91@sys/arch/luna88k/dev/spc.c","sys/arch/luna88k/dev/spc.c","spc_mainbus_match",79,91
14,1,103,3,17,"spc_mainbus_attach@94-111@sys/arch/luna88k/dev/spc.c","sys/arch/luna88k/dev/spc.c","spc_mainbus_attach",94,111
7,2,43,3,7,"clock_match@89-96@sys/arch/luna88k/dev/timekeeper.c","sys/arch/luna88k/dev/timekeeper.c","clock_match",89,96
25,3,180,3,27,"clock_attach@101-128@sys/arch/luna88k/dev/timekeeper.c","sys/arch/luna88k/dev/timekeeper.c","clock_attach",101,128
22,3,237,3,31,"mkclock_get@137-168@sys/arch/luna88k/dev/timekeeper.c","sys/arch/luna88k/dev/timekeeper.c","mkclock_get",137,168
23,2,273,2,30,"mkclock_set@174-204@sys/arch/luna88k/dev/timekeeper.c","sys/arch/luna88k/dev/timekeeper.c","mkclock_set",174,204
31,5,238,3,42,"dsclock_get@226-268@sys/arch/luna88k/dev/timekeeper.c","sys/arch/luna88k/dev/timekeeper.c","dsclock_get",226,268
26,2,202,2,35,"dsclock_set@274-309@sys/arch/luna88k/dev/timekeeper.c","sys/arch/luna88k/dev/timekeeper.c","dsclock_set",274,309
6,1,46,2,7,"put_pio0c@108-115@sys/arch/luna88k/dev/xp.c","sys/arch/luna88k/dev/xp.c","put_pio0c",108,115
12,4,65,3,16,"xp_match@118-134@sys/arch/luna88k/dev/xp.c","sys/arch/luna88k/dev/xp.c","xp_match",118,134
8,1,52,3,9,"xp_attach@137-146@sys/arch/luna88k/dev/xp.c","sys/arch/luna88k/dev/xp.c","xp_attach",137,146
16,4,91,4,19,"xpopen@149-168@sys/arch/luna88k/dev/xp.c","sys/arch/luna88k/dev/xp.c","xpopen",149,168
12,2,73,4,14,"xpclose@171-185@sys/arch/luna88k/dev/xp.c","sys/arch/luna88k/dev/xp.c","xpclose",171,185
40,7,233,5,45,"xpioctl@188-233@sys/arch/luna88k/dev/xp.c","sys/arch/luna88k/dev/xp.c","xpioctl",188,233
14,3,78,3,17,"xpmmap@236-253@sys/arch/luna88k/dev/xp.c","sys/arch/luna88k/dev/xp.c","xpmmap",236,253
6,1,39,5,6,"bus_space_map@102-108@sys/arch/luna88k/include/bus.h","sys/arch/luna88k/include/bus.h","bus_space_map",102,108
4,1,15,3,4,"bus_space_unmap@118-122@sys/arch/luna88k/include/bus.h","sys/arch/luna88k/include/bus.h","bus_space_unmap",118,122
6,1,30,5,5,"bus_space_subregion@133-138@sys/arch/luna88k/include/bus.h","sys/arch/luna88k/include/bus.h","bus_space_subregion",133,138
6,1,38,9,5,"bus_space_alloc@150-155@sys/arch/luna88k/include/bus.h","sys/arch/luna88k/include/bus.h","bus_space_alloc",150,155
4,1,18,3,3,"bus_space_free@165-168@sys/arch/luna88k/include/bus.h","sys/arch/luna88k/include/bus.h","bus_space_free",165,168
6,2,43,5,5,"bus_space_read_multi_1@211-216@sys/arch/luna88k/include/bus.h","sys/arch/luna88k/include/bus.h","bus_space_read_multi_1",211,216
6,2,43,5,5,"bus_space_read_multi_2@219-224@sys/arch/luna88k/include/bus.h","sys/arch/luna88k/include/bus.h","bus_space_read_multi_2",219,224
6,2,43,5,5,"bus_space_read_multi_4@227-232@sys/arch/luna88k/include/bus.h","sys/arch/luna88k/include/bus.h","bus_space_read_multi_4",227,232
10,2,57,5,9,"bus_space_read_raw_multi_2@239-248@sys/arch/luna88k/include/bus.h","sys/arch/luna88k/include/bus.h","bus_space_read_raw_multi_2",239,248
10,2,57,5,9,"bus_space_read_raw_multi_4@251-260@sys/arch/luna88k/include/bus.h","sys/arch/luna88k/include/bus.h","bus_space_read_raw_multi_4",251,260
6,2,44,5,5,"bus_space_read_region_1@273-278@sys/arch/luna88k/include/bus.h","sys/arch/luna88k/include/bus.h","bus_space_read_region_1",273,278
8,2,49,5,7,"bus_space_read_region_2@281-288@sys/arch/luna88k/include/bus.h","sys/arch/luna88k/include/bus.h","bus_space_read_region_2",281,288
8,2,49,5,7,"bus_space_read_region_4@291-298@sys/arch/luna88k/include/bus.h","sys/arch/luna88k/include/bus.h","bus_space_read_region_4",291,298
6,2,43,5,5,"bus_space_write_multi_1@344-349@sys/arch/luna88k/include/bus.h","sys/arch/luna88k/include/bus.h","bus_space_write_multi_1",344,349
6,2,43,5,5,"bus_space_write_multi_2@352-357@sys/arch/luna88k/include/bus.h","sys/arch/luna88k/include/bus.h","bus_space_write_multi_2",352,357
6,2,43,5,5,"bus_space_write_multi_4@360-365@sys/arch/luna88k/include/bus.h","sys/arch/luna88k/include/bus.h","bus_space_write_multi_4",360,365
9,2,57,5,8,"bus_space_write_raw_multi_2@373-381@sys/arch/luna88k/include/bus.h","sys/arch/luna88k/include/bus.h","bus_space_write_raw_multi_2",373,381
9,2,57,5,8,"bus_space_write_raw_multi_4@384-392@sys/arch/luna88k/include/bus.h","sys/arch/luna88k/include/bus.h","bus_space_write_raw_multi_4",384,392
6,2,44,5,5,"bus_space_write_region_1@404-409@sys/arch/luna88k/include/bus.h","sys/arch/luna88k/include/bus.h","bus_space_write_region_1",404,409
8,2,49,5,7,"bus_space_write_region_2@412-419@sys/arch/luna88k/include/bus.h","sys/arch/luna88k/include/bus.h","bus_space_write_region_2",412,419
8,2,49,5,7,"bus_space_write_region_4@422-429@sys/arch/luna88k/include/bus.h","sys/arch/luna88k/include/bus.h","bus_space_write_region_4",422,429
6,2,40,5,5,"bus_space_set_multi_1@446-451@sys/arch/luna88k/include/bus.h","sys/arch/luna88k/include/bus.h","bus_space_set_multi_1",446,451
6,2,40,5,5,"bus_space_set_multi_2@454-459@sys/arch/luna88k/include/bus.h","sys/arch/luna88k/include/bus.h","bus_space_set_multi_2",454,459
6,2,40,5,5,"bus_space_set_multi_4@462-467@sys/arch/luna88k/include/bus.h","sys/arch/luna88k/include/bus.h","bus_space_set_multi_4",462,467
6,2,41,5,5,"bus_space_set_region_1@484-489@sys/arch/luna88k/include/bus.h","sys/arch/luna88k/include/bus.h","bus_space_set_region_1",484,489
8,2,46,5,7,"bus_space_set_region_2@492-499@sys/arch/luna88k/include/bus.h","sys/arch/luna88k/include/bus.h","bus_space_set_region_2",492,499
8,2,46,5,7,"bus_space_set_region_4@502-509@sys/arch/luna88k/include/bus.h","sys/arch/luna88k/include/bus.h","bus_space_set_region_4",502,509
11,2,51,0,20,"cpu_configure@74-94@sys/arch/luna88k/luna88k/autoconf.c","sys/arch/luna88k/luna88k/autoconf.c","cpu_configure",74,94
7,2,34,1,6,"diskconf@97-103@sys/arch/luna88k/luna88k/autoconf.c","sys/arch/luna88k/luna88k/autoconf.c","diskconf",97,103
30,9,216,1,37,"get_autoboot_device@118-155@sys/arch/luna88k/luna88k/autoconf.c","sys/arch/luna88k/luna88k/autoconf.c","get_autoboot_device",118,155
16,6,114,2,20,"device_register@158-178@sys/arch/luna88k/luna88k/autoconf.c","sys/arch/luna88k/luna88k/autoconf.c","device_register",158,178
9,2,43,3,11,"clockattach@67-78@sys/arch/luna88k/luna88k/clock.c","sys/arch/luna88k/luna88k/clock.c","clockattach",67,78
9,3,38,0,12,"cpu_initclocks@108-120@sys/arch/luna88k/luna88k/clock.c","sys/arch/luna88k/luna88k/clock.c","cpu_initclocks",108,120
3,1,7,1,3,"setstatclockrate@128-131@sys/arch/luna88k/luna88k/clock.c","sys/arch/luna88k/luna88k/clock.c","setstatclockrate",128,131
41,15,254,1,55,"inittodr@139-194@sys/arch/luna88k/luna88k/clock.c","sys/arch/luna88k/luna88k/clock.c","inittodr",139,194
8,2,37,0,8,"resettodr@204-212@sys/arch/luna88k/luna88k/clock.c","sys/arch/luna88k/luna88k/clock.c","resettodr",204,212
10,4,55,1,13,"clockintr@218-231@sys/arch/luna88k/luna88k/clock.c","sys/arch/luna88k/luna88k/clock.c","clockintr",218,231
4,1,17,1,3,"clock_get_tc@234-237@sys/arch/luna88k/luna88k/clock.c","sys/arch/luna88k/luna88k/clock.c","clock_get_tc",234,237
5,2,26,1,5,"iskmemdev@182-187@sys/arch/luna88k/luna88k/conf.c","sys/arch/luna88k/luna88k/conf.c","iskmemdev",182,187
5,2,26,1,5,"iszerodev@193-198@sys/arch/luna88k/luna88k/conf.c","sys/arch/luna88k/luna88k/conf.c","iszerodev",193,198
4,1,13,0,3,"getnulldev@201-204@sys/arch/luna88k/luna88k/conf.c","sys/arch/luna88k/luna88k/conf.c","getnulldev",201,204
39,11,238,4,51,"readdisklabel@104-155@sys/arch/luna88k/luna88k/disksubr.c","sys/arch/luna88k/luna88k/disksubr.c","readdisklabel",104,155
23,3,154,3,28,"writedisklabel@161-189@sys/arch/luna88k/luna88k/disksubr.c","sys/arch/luna88k/luna88k/disksubr.c","writedisklabel",161,189
10,2,65,2,11,"sun_extended_sum@224-235@sys/arch/luna88k/luna88k/disksubr.c","sys/arch/luna88k/luna88k/disksubr.c","sun_extended_sum",224,235
89,20,711,2,125,"disklabel_om_to_bsd@243-368@sys/arch/luna88k/luna88k/disksubr.c","sys/arch/luna88k/luna88k/disksubr.c","disklabel_om_to_bsd",243,368
57,11,463,2,67,"disklabel_bsd_to_om@376-443@sys/arch/luna88k/luna88k/disksubr.c","sys/arch/luna88k/luna88k/disksubr.c","disklabel_bsd_to_om",376,443
7,2,32,0,8,"isrinit@52-60@sys/arch/luna88k/luna88k/isr.c","sys/arch/luna88k/luna88k/isr.c","isrinit",52,60
30,8,217,5,68,"isrlink_autovec@67-135@sys/arch/luna88k/luna88k/isr.c","sys/arch/luna88k/luna88k/isr.c","isrlink_autovec",67,135
33,14,187,1,46,"isrdispatch_autovec@142-188@sys/arch/luna88k/luna88k/isr.c","sys/arch/luna88k/luna88k/isr.c","isrdispatch_autovec",142,188
32,6,256,0,47,"m8820x_setup_board_config@99-146@sys/arch/luna88k/luna88k/m8820x.c","sys/arch/luna88k/luna88k/m8820x.c","m8820x_setup_board_config",99,146
24,7,142,0,32,"m8820x_cpu_number@156-188@sys/arch/luna88k/luna88k/m8820x.c","sys/arch/luna88k/luna88k/m8820x.c","m8820x_cpu_number",156,188
13,4,47,0,18,"consinit@234-252@sys/arch/luna88k/luna88k/machdep.c","sys/arch/luna88k/luna88k/machdep.c","consinit",234,252
21,5,138,0,35,"size_memory@260-295@sys/arch/luna88k/luna88k/machdep.c","sys/arch/luna88k/luna88k/machdep.c","size_memory",260,295
11,3,30,0,10,"getcpuspeed@298-308@sys/arch/luna88k/luna88k/machdep.c","sys/arch/luna88k/luna88k/machdep.c","getcpuspeed",298,308
7,2,31,0,6,"identifycpu@311-317@sys/arch/luna88k/luna88k/machdep.c","sys/arch/luna88k/luna88k/machdep.c","identifycpu",311,317
48,12,258,0,96,"cpu_startup@320-416@sys/arch/luna88k/luna88k/machdep.c","sys/arch/luna88k/luna88k/machdep.c","cpu_startup",320,416
38,11,184,1,50,"boot@419-469@sys/arch/luna88k/luna88k/machdep.c","sys/arch/luna88k/luna88k/machdep.c","boot",419,469
19,7,148,1,29,"dumpconf@484-513@sys/arch/luna88k/luna88k/machdep.c","sys/arch/luna88k/luna88k/machdep.c","dumpconf",484,513
82,17,452,0,103,"dumpsys@521-624@sys/arch/luna88k/luna88k/machdep.c","sys/arch/luna88k/luna88k/machdep.c","dumpsys",521,624
10,5,57,0,28,"cpu_setup_secondary_processors@630-658@sys/arch/luna88k/luna88k/machdep.c","sys/arch/luna88k/luna88k/machdep.c","cpu_setup_secondary_processors",630,658
28,1,106,1,45,"luna88k_set_cpu_number@661-706@sys/arch/luna88k/luna88k/machdep.c","sys/arch/luna88k/luna88k/machdep.c","luna88k_set_cpu_number",661,706
4,1,11,0,3,"cpu_boot_secondary_processors@714-717@sys/arch/luna88k/luna88k/machdep.c","sys/arch/luna88k/luna88k/machdep.c","cpu_boot_secondary_processors",714,717
19,3,104,0,39,"secondary_pre_main@726-765@sys/arch/luna88k/luna88k/machdep.c","sys/arch/luna88k/luna88k/machdep.c","secondary_pre_main",726,765
21,1,122,0,33,"secondary_main@775-808@sys/arch/luna88k/luna88k/machdep.c","sys/arch/luna88k/luna88k/machdep.c","secondary_main",775,808
50,15,282,1,87,"luna88k_ext_int@817-904@sys/arch/luna88k/luna88k/machdep.c","sys/arch/luna88k/luna88k/machdep.c","luna88k_ext_int",817,904
9,2,35,3,13,"sys_sysarch@907-920@sys/arch/luna88k/luna88k/machdep.c","sys/arch/luna88k/luna88k/machdep.c","sys_sysarch",907,920
20,5,116,7,23,"cpu_sysctl@927-950@sys/arch/luna88k/luna88k/machdep.c","sys/arch/luna88k/luna88k/machdep.c","cpu_sysctl",927,950
8,1,62,2,17,"luna88k_vector_init@953-970@sys/arch/luna88k/luna88k/machdep.c","sys/arch/luna88k/luna88k/machdep.c","luna88k_vector_init",953,970
42,4,268,0,84,"luna88k_bootstrap@977-1061@sys/arch/luna88k/luna88k/machdep.c","sys/arch/luna88k/luna88k/machdep.c","luna88k_bootstrap",977,1061
6,1,28,1,5,"romttycnprobe@1073-1078@sys/arch/luna88k/luna88k/machdep.c","sys/arch/luna88k/luna88k/machdep.c","romttycnprobe",1073,1078
4,1,11,1,4,"romttycninit@1081-1085@sys/arch/luna88k/luna88k/machdep.c","sys/arch/luna88k/luna88k/machdep.c","romttycninit",1081,1085
11,2,45,1,11,"romttycngetc@1088-1099@sys/arch/luna88k/luna88k/machdep.c","sys/arch/luna88k/luna88k/machdep.c","romttycngetc",1088,1099
9,1,33,2,9,"romttycnputc@1102-1111@sys/arch/luna88k/luna88k/machdep.c","sys/arch/luna88k/luna88k/machdep.c","romttycnputc",1102,1111
7,1,47,1,7,"powerdown@1132-1139@sys/arch/luna88k/luna88k/machdep.c","sys/arch/luna88k/luna88k/machdep.c","powerdown",1132,1139
11,2,79,1,11,"get_fuse_rom_data@1144-1155@sys/arch/luna88k/luna88k/machdep.c","sys/arch/luna88k/luna88k/machdep.c","get_fuse_rom_data",1144,1155
30,7,265,1,35,"get_nvram_data@1160-1195@sys/arch/luna88k/luna88k/machdep.c","sys/arch/luna88k/luna88k/machdep.c","get_nvram_data",1160,1195
14,3,70,1,16,"nvram_by_symbol@1198-1214@sys/arch/luna88k/luna88k/machdep.c","sys/arch/luna88k/luna88k/machdep.c","nvram_by_symbol",1198,1214
10,3,56,1,19,"setlevel@1217-1236@sys/arch/luna88k/luna88k/machdep.c","sys/arch/luna88k/luna88k/machdep.c","setlevel",1217,1236
4,1,16,1,3,"getipl@1239-1242@sys/arch/luna88k/luna88k/machdep.c","sys/arch/luna88k/luna88k/machdep.c","getipl",1239,1242
12,1,60,1,14,"setipl@1245-1259@sys/arch/luna88k/luna88k/machdep.c","sys/arch/luna88k/luna88k/machdep.c","setipl",1245,1259
13,2,69,1,15,"splraise@1262-1277@sys/arch/luna88k/luna88k/machdep.c","sys/arch/luna88k/luna88k/machdep.c","splraise",1262,1277
8,2,53,2,9,"m88k_send_ipi@1281-1290@sys/arch/luna88k/luna88k/machdep.c","sys/arch/luna88k/luna88k/machdep.c","m88k_send_ipi",1281,1290
16,5,96,1,30,"luna88k_ipi_handler@1301-1331@sys/arch/luna88k/luna88k/machdep.c","sys/arch/luna88k/luna88k/machdep.c","luna88k_ipi_handler",1301,1331
12,3,60,1,13,"m88k_broadcast_ipi@1334-1347@sys/arch/luna88k/luna88k/machdep.c","sys/arch/luna88k/luna88k/machdep.c","m88k_broadcast_ipi",1334,1347
9,2,44,3,10,"mainbus_match@76-86@sys/arch/luna88k/luna88k/mainbus.c","sys/arch/luna88k/luna88k/mainbus.c","mainbus_match",76,86
14,4,103,3,26,"mainbus_attach@89-115@sys/arch/luna88k/luna88k/mainbus.c","sys/arch/luna88k/luna88k/mainbus.c","mainbus_attach",89,115
9,2,44,2,10,"mainbus_print@118-128@sys/arch/luna88k/luna88k/mainbus.c","sys/arch/luna88k/luna88k/mainbus.c","mainbus_print",118,128
4,1,8,0,3,"pmap_table_build@105-108@sys/arch/luna88k/luna88k/pmap_table.c","sys/arch/luna88k/luna88k/pmap_table.c","pmap_table_build",105,108
9,2,61,2,9,"print_countdown@36-45@sys/arch/luna88k/stand/boot/awaitkey.c","sys/arch/luna88k/stand/boot/awaitkey.c","print_countdown",36,45
28,9,129,3,32,"awaitkey@55-87@sys/arch/luna88k/stand/boot/awaitkey.c","sys/arch/luna88k/stand/boot/awaitkey.c","awaitkey",55,87
4,1,30,1,4,"bcdtobin@12-16@sys/arch/luna88k/stand/boot/bcd.c","sys/arch/luna88k/stand/boot/bcd.c","bcdtobin",12,16
4,1,32,1,4,"bintobcd@19-23@sys/arch/luna88k/stand/boot/bcd.c","sys/arch/luna88k/stand/boot/bcd.c","bintobcd",19,23
13,3,57,1,17,"bmccnprobe@89-106@sys/arch/luna88k/stand/boot/bmc.c","sys/arch/luna88k/stand/boot/bmc.c","bmccnprobe",89,106
5,1,17,1,4,"bmccninit@109-113@sys/arch/luna88k/stand/boot/bmc.c","sys/arch/luna88k/stand/boot/bmc.c","bmccninit",109,113
10,2,41,1,15,"bmccngetc@116-131@sys/arch/luna88k/stand/boot/bmc.c","sys/arch/luna88k/stand/boot/bmc.c","bmccngetc",116,131
4,1,15,2,3,"bmccnputc@134-137@sys/arch/luna88k/stand/boot/bmc.c","sys/arch/luna88k/stand/boot/bmc.c","bmccnputc",134,137
14,2,60,1,16,"bmd_escape@170-186@sys/arch/luna88k/stand/boot/bmd.c","sys/arch/luna88k/stand/boot/bmd.c","bmd_escape",170,186
36,9,191,1,47,"bmd_escape_0@189-236@sys/arch/luna88k/stand/boot/bmd.c","sys/arch/luna88k/stand/boot/bmd.c","bmd_escape_0",189,236
29,5,207,1,34,"bmd_escape_1@239-273@sys/arch/luna88k/stand/boot/bmd.c","sys/arch/luna88k/stand/boot/bmd.c","bmd_escape_1",239,273
37,2,319,1,51,"bmdinit@281-332@sys/arch/luna88k/stand/boot/bmd.c","sys/arch/luna88k/stand/boot/bmd.c","bmdinit",281,332
9,1,58,2,11,"bmdadjust@335-346@sys/arch/luna88k/stand/boot/bmd.c","sys/arch/luna88k/stand/boot/bmd.c","bmdadjust",335,346
79,16,452,1,93,"bmdputc@349-442@sys/arch/luna88k/stand/boot/bmd.c","sys/arch/luna88k/stand/boot/bmd.c","bmdputc",349,442
11,1,73,1,13,"bmdclear@445-458@sys/arch/luna88k/stand/boot/bmd.c","sys/arch/luna88k/stand/boot/bmd.c","bmdclear",445,458
53,9,583,5,59,"bmd_draw_char@466-525@sys/arch/luna88k/stand/boot/bmd.c","sys/arch/luna88k/stand/boot/bmd.c","bmd_draw_char",466,525
47,9,539,4,52,"bmd_reverse_char@528-580@sys/arch/luna88k/stand/boot/bmd.c","sys/arch/luna88k/stand/boot/bmd.c","bmd_reverse_char",528,580
5,1,33,4,5,"bmd_erase_char@583-588@sys/arch/luna88k/stand/boot/bmd.c","sys/arch/luna88k/stand/boot/bmd.c","bmd_erase_char",583,588
10,3,55,1,11,"bmd_erase_screen@596-607@sys/arch/luna88k/stand/boot/bmd.c","sys/arch/luna88k/stand/boot/bmd.c","bmd_erase_screen",596,607
20,5,167,6,23,"bmd_scroll_screen@610-633@sys/arch/luna88k/stand/boot/bmd.c","sys/arch/luna88k/stand/boot/bmd.c","bmd_scroll_screen",610,633
31,13,201,4,36,"get_boot_device@106-142@sys/arch/luna88k/stand/boot/boot.c","sys/arch/luna88k/stand/boot/boot.c","get_boot_device",106,142
10,2,48,2,12,"boot@146-158@sys/arch/luna88k/stand/boot/boot.c","sys/arch/luna88k/stand/boot/boot.c","boot",146,158
42,10,298,1,58,"bootunix@161-219@sys/arch/luna88k/stand/boot/boot.c","sys/arch/luna88k/stand/boot/boot.c","bootunix",161,219
20,7,135,3,20,"loadrandom@222-242@sys/arch/luna88k/stand/boot/boot.c","sys/arch/luna88k/stand/boot/boot.c","loadrandom",222,242
42,13,196,2,55,"net_open@84-139@sys/arch/luna88k/stand/boot/dev_net.c","sys/arch/luna88k/stand/boot/dev_net.c","net_open",84,139
19,8,83,1,27,"net_close@142-169@sys/arch/luna88k/stand/boot/dev_net.c","sys/arch/luna88k/stand/boot/dev_net.c","net_close",142,169
4,1,19,3,4,"net_ioctl@172-176@sys/arch/luna88k/stand/boot/dev_net.c","sys/arch/luna88k/stand/boot/dev_net.c","net_ioctl",172,176
5,1,28,6,5,"net_strategy@179-184@sys/arch/luna88k/stand/boot/dev_net.c","sys/arch/luna88k/stand/boot/dev_net.c","net_strategy",179,184
47,22,239,1,84,"net_getparams@203-287@sys/arch/luna88k/stand/boot/dev_net.c","sys/arch/luna88k/stand/boot/dev_net.c","net_getparams",203,287
27,8,206,3,39,"devopen@83-122@sys/arch/luna88k/stand/boot/devopen.c","sys/arch/luna88k/stand/boot/devopen.c","devopen",83,122
55,27,397,5,71,"make_device@125-196@sys/arch/luna88k/stand/boot/devopen.c","sys/arch/luna88k/stand/boot/devopen.c","make_device",125,196
6,1,22,0,5,"get_vbr@43-48@sys/arch/luna88k/stand/boot/fault.c","sys/arch/luna88k/stand/boot/fault.c","get_vbr",43,48
4,1,18,1,3,"set_vbr@51-54@sys/arch/luna88k/stand/boot/fault.c","sys/arch/luna88k/stand/boot/fault.c","set_vbr",51,54
6,1,23,1,7,"libsa_fault_handler@63-70@sys/arch/luna88k/stand/boot/fault.c","sys/arch/luna88k/stand/boot/fault.c","libsa_fault_handler",63,70
4,1,24,1,3,"br@73-76@sys/arch/luna88k/stand/boot/fault.c","sys/arch/luna88k/stand/boot/fault.c","br",73,76
16,2,98,0,19,"libsa_fault_init@79-98@sys/arch/luna88k/stand/boot/fault.c","sys/arch/luna88k/stand/boot/fault.c","libsa_fault_init",79,98
42,8,191,2,47,"badaddr@101-148@sys/arch/luna88k/stand/boot/fault.c","sys/arch/luna88k/stand/boot/fault.c","badaddr",101,148
43,11,194,2,50,"getline@83-133@sys/arch/luna88k/stand/boot/getline.c","sys/arch/luna88k/stand/boot/getline.c","getline",83,133
33,4,225,1,40,"getsecs@43-83@sys/arch/luna88k/stand/boot/getsecs.c","sys/arch/luna88k/stand/boot/getsecs.c","getsecs",43,83
16,3,97,1,21,"leinit@100-121@sys/arch/luna88k/stand/boot/if_le.c","sys/arch/luna88k/stand/boot/if_le.c","leinit",100,121
14,6,85,2,18,"le_match@124-142@sys/arch/luna88k/stand/boot/if_le.c","sys/arch/luna88k/stand/boot/if_le.c","le_match",124,142
4,1,16,2,6,"le_probe@145-151@sys/arch/luna88k/stand/boot/if_le.c","sys/arch/luna88k/stand/boot/if_le.c","le_probe",145,151
13,2,92,2,19,"le_init@154-173@sys/arch/luna88k/stand/boot/if_le.c","sys/arch/luna88k/stand/boot/if_le.c","le_init",154,173
15,3,102,4,16,"le_get@176-192@sys/arch/luna88k/stand/boot/if_le.c","sys/arch/luna88k/stand/boot/if_le.c","le_get",176,192
12,3,109,3,15,"le_put@195-210@sys/arch/luna88k/stand/boot/if_le.c","sys/arch/luna88k/stand/boot/if_le.c","le_put",195,210
7,2,46,1,9,"le_end@213-222@sys/arch/luna88k/stand/boot/if_le.c","sys/arch/luna88k/stand/boot/if_le.c","le_end",213,222
41,9,365,1,49,"myetheraddr@225-274@sys/arch/luna88k/stand/boot/if_le.c","sys/arch/luna88k/stand/boot/if_le.c","myetheraddr",225,274
59,14,356,1,86,"main@156-242@sys/arch/luna88k/stand/boot/init_main.c","sys/arch/luna88k/stand/boot/init_main.c","main",156,242
9,3,47,1,10,"get_plane_numbers@245-255@sys/arch/luna88k/stand/boot/init_main.c","sys/arch/luna88k/stand/boot/init_main.c","get_plane_numbers",245,255
11,2,79,1,11,"get_fuse_rom_data@260-271@sys/arch/luna88k/stand/boot/init_main.c","sys/arch/luna88k/stand/boot/init_main.c","get_fuse_rom_data",260,271
30,7,265,1,35,"get_nvram_data@276-311@sys/arch/luna88k/stand/boot/init_main.c","sys/arch/luna88k/stand/boot/init_main.c","get_nvram_data",276,311
14,3,71,1,16,"nvram_by_symbol@314-330@sys/arch/luna88k/stand/boot/init_main.c","sys/arch/luna88k/stand/boot/init_main.c","nvram_by_symbol",314,330
5,2,23,1,5,"_rtt@333-338@sys/arch/luna88k/stand/boot/init_main.c","sys/arch/luna88k/stand/boot/init_main.c","_rtt",333,338
35,12,174,1,48,"kbd_decode@219-267@sys/arch/luna88k/stand/boot/kbd.c","sys/arch/luna88k/stand/boot/kbd.c","kbd_decode",219,267
17,3,98,4,19,"lance_attach@76-95@sys/arch/luna88k/stand/boot/lance.c","sys/arch/luna88k/stand/boot/lance.c","lance_attach",76,95
10,3,43,1,13,"lance_cookie@98-111@sys/arch/luna88k/stand/boot/lance.c","sys/arch/luna88k/stand/boot/lance.c","lance_cookie",98,111
7,3,35,1,8,"lance_eaddr@114-122@sys/arch/luna88k/stand/boot/lance.c","sys/arch/luna88k/stand/boot/lance.c","lance_eaddr",114,122
10,3,45,1,13,"lance_init@125-138@sys/arch/luna88k/stand/boot/lance.c","sys/arch/luna88k/stand/boot/lance.c","lance_init",125,138
35,8,249,3,41,"lance_get@141-182@sys/arch/luna88k/stand/boot/lance.c","sys/arch/luna88k/stand/boot/lance.c","lance_get",141,182
44,9,290,3,57,"lance_put@185-242@sys/arch/luna88k/stand/boot/lance.c","sys/arch/luna88k/stand/boot/lance.c","lance_put",185,242
8,1,39,1,9,"lance_end@245-254@sys/arch/luna88k/stand/boot/lance.c","sys/arch/luna88k/stand/boot/lance.c","lance_end",245,254
16,1,98,1,23,"lance_set_initblock@257-280@sys/arch/luna88k/stand/boot/lance.c","sys/arch/luna88k/stand/boot/lance.c","lance_set_initblock",257,280
23,3,119,1,29,"lance_do_initialize@283-312@sys/arch/luna88k/stand/boot/lance.c","sys/arch/luna88k/stand/boot/lance.c","lance_do_initialize",283,312
38,4,417,1,51,"lance_setup@315-366@sys/arch/luna88k/stand/boot/lance.c","sys/arch/luna88k/stand/boot/lance.c","lance_setup",315,366
4,1,18,2,3,"exit_program@86-89@sys/arch/luna88k/stand/boot/parse.c","sys/arch/luna88k/stand/boot/parse.c","exit_program",86,89
5,1,21,2,5,"cmd_help@100-105@sys/arch/luna88k/stand/boot/parse.c","sys/arch/luna88k/stand/boot/parse.c","cmd_help",100,105
11,3,88,2,12,"parse@123-135@sys/arch/luna88k/stand/boot/parse.c","sys/arch/luna88k/stand/boot/parse.c","parse",123,135
16,6,100,3,17,"getargs@144-161@sys/arch/luna88k/stand/boot/parse.c","sys/arch/luna88k/stand/boot/parse.c","getargs",144,161
12,4,53,1,13,"getchar@38-51@sys/arch/luna88k/stand/boot/prf.c","sys/arch/luna88k/stand/boot/prf.c","getchar",38,51
12,4,55,1,14,"tgetchar@54-68@sys/arch/luna88k/stand/boot/prf.c","sys/arch/luna88k/stand/boot/prf.c","tgetchar",54,68
6,2,23,1,5,"putchar@71-76@sys/arch/luna88k/stand/boot/prf.c","sys/arch/luna88k/stand/boot/prf.c","putchar",71,76
30,5,160,2,36,"scinit@103-139@sys/arch/luna88k/stand/boot/sc.c","sys/arch/luna88k/stand/boot/sc.c","scinit",103,139
22,5,125,1,44,"screset@142-186@sys/arch/luna88k/stand/boot/sc.c","sys/arch/luna88k/stand/boot/sc.c","screset",142,186
10,1,65,2,13,"issue_select@194-207@sys/arch/luna88k/stand/boot/sc.c","sys/arch/luna88k/stand/boot/sc.c","issue_select",194,207
8,1,72,4,7,"ixfer_start@222-229@sys/arch/luna88k/stand/boot/sc.c","sys/arch/luna88k/stand/boot/sc.c","ixfer_start",222,229
9,3,51,3,8,"ixfer_out@232-240@sys/arch/luna88k/stand/boot/sc.c","sys/arch/luna88k/stand/boot/sc.c","ixfer_out",232,240
9,3,51,3,8,"ixfer_in@243-251@sys/arch/luna88k/stand/boot/sc.c","sys/arch/luna88k/stand/boot/sc.c","ixfer_in",243,251
23,4,164,7,30,"scrun@259-289@sys/arch/luna88k/stand/boot/sc.c","sys/arch/luna88k/stand/boot/sc.c","scrun",259,289
15,1,84,1,18,"scfinish@292-310@sys/arch/luna88k/stand/boot/sc.c","sys/arch/luna88k/stand/boot/sc.c","scfinish",292,310
39,14,290,2,57,"scabort@313-370@sys/arch/luna88k/stand/boot/sc.c","sys/arch/luna88k/stand/boot/sc.c","scabort",313,370
24,9,154,3,35,"scsi_test_unit_rdy@378-413@sys/arch/luna88k/stand/boot/sc.c","sys/arch/luna88k/stand/boot/sc.c","scsi_test_unit_rdy",378,413
25,9,160,5,36,"scsi_request_sense@416-452@sys/arch/luna88k/stand/boot/sc.c","sys/arch/luna88k/stand/boot/sc.c","scsi_request_sense",416,452
25,9,177,6,36,"scsi_immed_command@455-491@sys/arch/luna88k/stand/boot/sc.c","sys/arch/luna88k/stand/boot/sc.c","scsi_immed_command",455,491
101,25,626,1,123,"scintr@498-621@sys/arch/luna88k/stand/boot/sc.c","sys/arch/luna88k/stand/boot/sc.c","scintr",498,621
68,25,504,1,83,"sdident@120-203@sys/arch/luna88k/stand/boot/sd.c","sys/arch/luna88k/stand/boot/sd.c","sdident",120,203
33,6,233,2,48,"sdinit@206-254@sys/arch/luna88k/stand/boot/sd.c","sys/arch/luna88k/stand/boot/sd.c","sdinit",206,254
17,4,102,2,20,"sdopen@257-277@sys/arch/luna88k/stand/boot/sd.c","sys/arch/luna88k/stand/boot/sd.c","sdopen",257,277
7,1,36,1,8,"sdclose@280-288@sys/arch/luna88k/stand/boot/sd.c","sys/arch/luna88k/stand/boot/sd.c","sdclose",280,288
34,6,308,6,43,"sdstrategy@301-344@sys/arch/luna88k/stand/boot/sd.c","sys/arch/luna88k/stand/boot/sd.c","sdstrategy",301,344
7,3,33,1,7,"_siointr@94-101@sys/arch/luna88k/stand/boot/sio.c","sys/arch/luna88k/stand/boot/sio.c","_siointr",94,101
20,6,135,1,25,"siointr@104-129@sys/arch/luna88k/stand/boot/sio.c","sys/arch/luna88k/stand/boot/sio.c","siointr",104,129
11,2,71,1,16,"siocnprobe@137-153@sys/arch/luna88k/stand/boot/sio.c","sys/arch/luna88k/stand/boot/sio.c","siocnprobe",137,153
6,1,24,1,6,"siocninit@156-162@sys/arch/luna88k/stand/boot/sio.c","sys/arch/luna88k/stand/boot/sio.c","siocninit",156,162
9,2,40,1,11,"siocngetc@165-176@sys/arch/luna88k/stand/boot/sio.c","sys/arch/luna88k/stand/boot/sio.c","siocngetc",165,176
11,4,90,2,16,"siocnputc@179-195@sys/arch/luna88k/stand/boot/sio.c","sys/arch/luna88k/stand/boot/sio.c","siocnputc",179,195
21,1,220,1,25,"sioinit@200-225@sys/arch/luna88k/stand/boot/sio.c","sys/arch/luna88k/stand/boot/sio.c","sioinit",200,225
15,4,98,2,16,"sioreg@228-244@sys/arch/luna88k/stand/boot/sio.c","sys/arch/luna88k/stand/boot/sio.c","sioreg",228,244
10,2,65,2,11,"sun_extended_sum@94-105@sys/arch/luna88k/stand/boot/ufs_disksubr.c","sys/arch/luna88k/stand/boot/ufs_disksubr.c","sun_extended_sum",94,105
106,25,823,3,142,"readdisklabel@116-258@sys/arch/luna88k/stand/boot/ufs_disksubr.c","sys/arch/luna88k/stand/boot/ufs_disksubr.c","readdisklabel",116,258
5,1,22,1,4,"set_psr@46-50@sys/arch/m88k/include/asm_macro.h","sys/arch/m88k/include/asm_macro.h","set_psr",46,50
6,1,25,1,5,"get_psr@55-60@sys/arch/m88k/include/asm_macro.h","sys/arch/m88k/include/asm_macro.h","get_psr",55,60
5,1,28,1,4,"ff1@65-69@sys/arch/m88k/include/asm_macro.h","sys/arch/m88k/include/asm_macro.h","ff1",65,69
6,1,25,1,5,"get_cpu_pid@71-76@sys/arch/m88k/include/asm_macro.h","sys/arch/m88k/include/asm_macro.h","get_cpu_pid",71,76
8,1,40,2,8,"atomic_setbits_int@31-39@sys/arch/m88k/include/atomic.h","sys/arch/m88k/include/atomic.h","atomic_setbits_int",31,39
8,1,40,2,8,"atomic_clearbits_int@42-50@sys/arch/m88k/include/atomic.h","sys/arch/m88k/include/atomic.h","atomic_clearbits_int",42,50
11,1,52,2,12,"atomic_add_int_nv_sp@53-65@sys/arch/m88k/include/atomic.h","sys/arch/m88k/include/atomic.h","atomic_add_int_nv_sp",53,65
11,1,52,2,12,"atomic_sub_int_nv_sp@68-80@sys/arch/m88k/include/atomic.h","sys/arch/m88k/include/atomic.h","atomic_sub_int_nv_sp",68,80
12,2,61,3,13,"atomic_cas_uint_sp@83-96@sys/arch/m88k/include/atomic.h","sys/arch/m88k/include/atomic.h","atomic_cas_uint_sp",83,96
11,1,51,2,12,"atomic_swap_uint_sp@99-111@sys/arch/m88k/include/atomic.h","sys/arch/m88k/include/atomic.h","atomic_swap_uint_sp",99,111
8,1,42,1,8,"atomic_clear_int@121-129@sys/arch/m88k/include/atomic.h","sys/arch/m88k/include/atomic.h","atomic_clear_int",121,129
4,1,15,1,4,"__sync_synchronize@148-152@sys/arch/m88k/include/atomic.h","sys/arch/m88k/include/atomic.h","__sync_synchronize",148,152
6,1,25,1,6,"curcpu@195-201@sys/arch/m88k/include/cpu.h","sys/arch/m88k/include/cpu.h","curcpu",195,201
6,2,39,1,5,"countLeadingZeros32@79-84@sys/arch/m88k/include/ieeefp.h","sys/arch/m88k/include/ieeefp.h","countLeadingZeros32",79,84
4,1,13,1,3,"__cpu_simple_lock_init@39-42@sys/arch/m88k/include/lock.h","sys/arch/m88k/include/lock.h","__cpu_simple_lock_init",39,42
7,1,42,1,13,"__cpu_simple_lock_try@45-58@sys/arch/m88k/include/lock.h","sys/arch/m88k/include/lock.h","__cpu_simple_lock_try",45,58
9,4,34,1,8,"__cpu_simple_lock@61-69@sys/arch/m88k/include/lock.h","sys/arch/m88k/include/lock.h","__cpu_simple_lock",61,69
4,1,13,1,3,"__cpu_simple_unlock@72-75@sys/arch/m88k/include/lock.h","sys/arch/m88k/include/lock.h","__cpu_simple_unlock",72,75
5,1,25,1,4,"m88100_rewind_insn@73-77@sys/arch/m88k/include/m88100.h","sys/arch/m88k/include/m88100.h","m88100_rewind_insn",73,77
8,1,40,1,8,"invalidate_pte@185-193@sys/arch/m88k/include/mmu.h","sys/arch/m88k/include/mmu.h","invalidate_pte",185,193
6,1,29,1,5,"__mp_lock_init@44-49@sys/arch/m88k/include/mplock.h","sys/arch/m88k/include/mplock.h","__mp_lock_init",44,49
5,2,22,2,4,"__mp_acquire_count@57-61@sys/arch/m88k/include/mplock.h","sys/arch/m88k/include/mplock.h","__mp_acquire_count",57,61
4,1,21,2,3,"__mp_lock_held@64-67@sys/arch/m88k/include/mplock.h","sys/arch/m88k/include/mplock.h","__mp_lock_held",64,67
6,1,23,1,5,"__m88k_get_tcb@59-64@sys/arch/m88k/include/tcb.h","sys/arch/m88k/include/tcb.h","__m88k_get_tcb",59,64
12,4,60,2,12,"printcmp@266-278@sys/arch/m88k/m88k/db_disasm.c","sys/arch/m88k/m88k/db_disasm.c","printcmp",266,278
23,7,129,3,24,"cregname@281-305@sys/arch/m88k/m88k/db_disasm.c","sys/arch/m88k/m88k/db_disasm.c","cregname",281,305
10,2,76,3,11,"symofset@308-319@sys/arch/m88k/m88k/db_disasm.c","sys/arch/m88k/m88k/db_disasm.c","symofset",308,319
20,5,111,4,21,"oimmed@323-344@sys/arch/m88k/m88k/db_disasm.c","sys/arch/m88k/m88k/db_disasm.c","oimmed",323,344
26,7,196,4,30,"ctrlregs@348-378@sys/arch/m88k/m88k/db_disasm.c","sys/arch/m88k/m88k/db_disasm.c","ctrlregs",348,378
76,23,474,4,82,"sindou@382-464@sys/arch/m88k/m88k/db_disasm.c","sys/arch/m88k/m88k/db_disasm.c","sindou",382,464
11,2,70,4,12,"jump@467-479@sys/arch/m88k/m88k/db_disasm.c","sys/arch/m88k/m88k/db_disasm.c","jump",467,479
27,7,162,4,28,"instset@483-511@sys/arch/m88k/m88k/db_disasm.c","sys/arch/m88k/m88k/db_disasm.c","instset",483,511
12,2,77,4,13,"obranch@515-528@sys/arch/m88k/m88k/db_disasm.c","sys/arch/m88k/m88k/db_disasm.c","obranch",515,528
22,5,162,4,27,"brcond@532-559@sys/arch/m88k/m88k/db_disasm.c","sys/arch/m88k/m88k/db_disasm.c","brcond",532,559
16,4,124,4,19,"otrap@563-582@sys/arch/m88k/m88k/db_disasm.c","sys/arch/m88k/m88k/db_disasm.c","otrap",563,582
12,2,106,4,13,"obit@586-599@sys/arch/m88k/m88k/db_disasm.c","sys/arch/m88k/m88k/db_disasm.c","obit",586,599
8,1,67,4,9,"bitman@603-612@sys/arch/m88k/m88k/db_disasm.c","sys/arch/m88k/m88k/db_disasm.c","bitman",603,612
47,11,244,4,51,"immem@616-667@sys/arch/m88k/m88k/db_disasm.c","sys/arch/m88k/m88k/db_disasm.c","immem",616,667
64,23,381,4,70,"nimmem@671-741@sys/arch/m88k/m88k/db_disasm.c","sys/arch/m88k/m88k/db_disasm.c","nimmem",671,741
11,2,92,4,13,"lognim@745-758@sys/arch/m88k/m88k/db_disasm.c","sys/arch/m88k/m88k/db_disasm.c","lognim",745,758
26,7,155,4,29,"onimmed@762-791@sys/arch/m88k/m88k/db_disasm.c","sys/arch/m88k/m88k/db_disasm.c","onimmed",762,791
40,9,252,4,45,"pinst@795-840@sys/arch/m88k/m88k/db_disasm.c","sys/arch/m88k/m88k/db_disasm.c","pinst",795,840
20,6,112,3,24,"m88k_print_instruction@1045-1069@sys/arch/m88k/m88k/db_disasm.c","sys/arch/m88k/m88k/db_disasm.c","m88k_print_instruction",1045,1069
10,3,53,2,11,"db_disasm@1072-1083@sys/arch/m88k/m88k/db_disasm.c","sys/arch/m88k/m88k/db_disasm.c","db_disasm",1072,1083
59,19,513,4,62,"m88k_dmx_print@105-167@sys/arch/m88k/m88k/db_interface.c","sys/arch/m88k/m88k/db_interface.c","m88k_dmx_print",105,167
152,46,1171,4,186,"m88k_db_print_frame@171-357@sys/arch/m88k/m88k/db_interface.c","sys/arch/m88k/m88k/db_interface.c","m88k_db_print_frame",171,357
8,1,40,4,7,"m88k_db_registers@360-367@sys/arch/m88k/m88k/db_interface.c","sys/arch/m88k/m88k/db_interface.c","m88k_db_registers",360,367
31,9,140,2,43,"m88k_db_trap@375-418@sys/arch/m88k/m88k/db_interface.c","sys/arch/m88k/m88k/db_interface.c","m88k_db_trap",375,418
9,3,45,1,8,"kdbprinttrap@427-435@sys/arch/m88k/m88k/db_interface.c","sys/arch/m88k/m88k/db_interface.c","kdbprinttrap",427,435
5,1,13,1,5,"db_enter@438-443@sys/arch/m88k/m88k/db_interface.c","sys/arch/m88k/m88k/db_interface.c","db_enter",438,443
11,3,47,2,17,"ddb_break_trap@454-471@sys/arch/m88k/m88k/db_interface.c","sys/arch/m88k/m88k/db_interface.c","ddb_break_trap",454,471
7,1,30,2,7,"ddb_entry_trap@475-482@sys/arch/m88k/m88k/db_interface.c","sys/arch/m88k/m88k/db_interface.c","ddb_entry_trap",475,482
8,2,43,3,9,"db_read_bytes@488-497@sys/arch/m88k/m88k/db_interface.c","sys/arch/m88k/m88k/db_interface.c","db_read_bytes",488,497
40,14,276,3,43,"db_write_bytes@503-546@sys/arch/m88k/m88k/db_interface.c","sys/arch/m88k/m88k/db_interface.c","db_write_bytes",503,546
16,3,84,4,17,"m88k_db_where@550-567@sys/arch/m88k/m88k/db_interface.c","sys/arch/m88k/m88k/db_interface.c","m88k_db_where",550,567
17,4,94,4,19,"m88k_db_frame_search@579-598@sys/arch/m88k/m88k/db_interface.c","sys/arch/m88k/m88k/db_interface.c","m88k_db_frame_search",579,598
42,10,237,4,44,"m88k_db_cpu_cmd@603-647@sys/arch/m88k/m88k/db_interface.c","sys/arch/m88k/m88k/db_interface.c","m88k_db_cpu_cmd",603,647
5,2,16,0,6,"db_machine_init@670-676@sys/arch/m88k/m88k/db_interface.c","sys/arch/m88k/m88k/db_interface.c","db_machine_init",670,676
15,8,63,1,16,"inst_branch_or_call@65-81@sys/arch/m88k/m88k/db_sstep.c","sys/arch/m88k/m88k/db_sstep.c","inst_branch_or_call",65,81
22,9,125,3,33,"branch_taken@91-124@sys/arch/m88k/m88k/db_sstep.c","sys/arch/m88k/m88k/db_sstep.c","branch_taken",91,124
18,8,104,1,40,"db_set_single_step@129-169@sys/arch/m88k/m88k/db_sstep.c","sys/arch/m88k/m88k/db_sstep.c","db_set_single_step",129,169
17,7,66,1,20,"db_clear_single_step@172-192@sys/arch/m88k/m88k/db_sstep.c","sys/arch/m88k/m88k/db_sstep.c","db_clear_single_step",172,192
7,2,38,2,7,"br_dest@49-56@sys/arch/m88k/m88k/db_trace.c","sys/arch/m88k/m88k/db_trace.c","br_dest",49,56
43,3,358,1,44,"m88k_instruction_info@119-163@sys/arch/m88k/m88k/db_trace.c","sys/arch/m88k/m88k/db_trace.c","m88k_instruction_info",119,163
18,6,82,1,19,"hex_value_needs_0x@166-185@sys/arch/m88k/m88k/db_trace.c","sys/arch/m88k/m88k/db_trace.c","hex_value_needs_0x",166,185
33,18,220,2,49,"frame_is_sane@195-244@sys/arch/m88k/m88k/db_trace.c","sys/arch/m88k/m88k/db_trace.c","frame_is_sane",195,244
27,19,123,1,26,"m88k_exception_name@247-273@sys/arch/m88k/m88k/db_trace.c","sys/arch/m88k/m88k/db_trace.c","m88k_exception_name",247,273
13,2,66,2,13,"db_trace_get_val@280-293@sys/arch/m88k/m88k/db_trace.c","sys/arch/m88k/m88k/db_trace.c","db_trace_get_val",280,293
9,2,46,2,9,"save_reg@309-318@sys/arch/m88k/m88k/db_trace.c","sys/arch/m88k/m88k/db_trace.c","save_reg",309,318
24,8,117,1,28,"print_args@334-362@sys/arch/m88k/m88k/db_trace.c","sys/arch/m88k/m88k/db_trace.c","print_args",334,362
30,11,191,2,43,"is_jump_source_ok@390-433@sys/arch/m88k/m88k/db_trace.c","sys/arch/m88k/m88k/db_trace.c","is_jump_source_ok",390,433
143,43,826,3,224,"stack_decode@459-683@sys/arch/m88k/m88k/db_trace.c","sys/arch/m88k/m88k/db_trace.c","stack_decode",459,683
61,15,438,2,114,"db_stack_trace_cmd2@686-800@sys/arch/m88k/m88k/db_trace.c","sys/arch/m88k/m88k/db_trace.c","db_stack_trace_cmd2",686,800
91,32,539,5,123,"db_stack_trace_print@809-932@sys/arch/m88k/m88k/db_trace.c","sys/arch/m88k/m88k/db_trace.c","db_stack_trace_print",809,932
51,15,251,5,51,"fpu_store@76-127@sys/arch/m88k/m88k/fpu.c","sys/arch/m88k/m88k/fpu.c","fpu_store",76,127
4,1,26,3,3,"fpu_precision@135-138@sys/arch/m88k/m88k/fpu.c","sys/arch/m88k/m88k/fpu.c","fpu_precision",135,138
125,46,678,6,160,"fpu_compare@147-307@sys/arch/m88k/m88k/fpu.c","sys/arch/m88k/m88k/fpu.c","fpu_compare",147,307
34,9,157,4,35,"in_cksum_internal@50-85@sys/arch/m88k/m88k/in_cksum.c","sys/arch/m88k/m88k/in_cksum.c","in_cksum_internal",50,85
4,1,26,2,3,"in_cksum@88-91@sys/arch/m88k/m88k/in_cksum.c","sys/arch/m88k/m88k/in_cksum.c","in_cksum",88,91
23,5,220,4,28,"in4_cksum@94-122@sys/arch/m88k/m88k/in_cksum.c","sys/arch/m88k/m88k/in_cksum.c","in4_cksum",94,122
17,3,95,1,27,"m88100_fpu_precise_exception@52-79@sys/arch/m88k/m88k/m88100_fp.c","sys/arch/m88k/m88k/m88100_fp.c","m88100_fpu_precise_exception",52,79
9,1,58,2,10,"m88100_fpu_parse_single@87-97@sys/arch/m88k/m88k/m88100_fp.c","sys/arch/m88k/m88k/m88100_fp.c","m88100_fpu_parse_single",87,97
37,12,204,5,37,"m88100_fpu_fetch@107-144@sys/arch/m88k/m88k/m88100_fp.c","sys/arch/m88k/m88k/m88100_fp.c","m88100_fpu_fetch",107,144
136,48,933,1,184,"m88100_fpu_emulate@151-335@sys/arch/m88k/m88k/m88100_fp.c","sys/arch/m88k/m88k/m88100_fp.c","m88100_fpu_emulate",151,335
49,8,332,1,84,"m88100_fpu_imprecise_exception@346-430@sys/arch/m88k/m88k/m88100_fp.c","sys/arch/m88k/m88k/m88100_fp.c","m88100_fpu_imprecise_exception",346,430
34,14,215,3,35,"m88100_fpu_checksig@436-471@sys/arch/m88k/m88k/m88100_fp.c","sys/arch/m88k/m88k/m88100_fp.c","m88100_fpu_checksig",436,471
9,2,84,1,10,"dae_print@86-96@sys/arch/m88k/m88k/m88100_machdep.c","sys/arch/m88k/m88k/m88100_machdep.c","dae_print",86,96
47,11,220,4,50,"dae_print_one@99-149@sys/arch/m88k/m88k/m88100_machdep.c","sys/arch/m88k/m88k/m88100_machdep.c","dae_print_one",99,149
13,2,96,1,15,"data_access_emulation@152-167@sys/arch/m88k/m88k/m88100_machdep.c","sys/arch/m88k/m88k/m88100_machdep.c","data_access_emulation",152,167
109,30,613,5,135,"dae_process@170-305@sys/arch/m88k/m88k/m88100_machdep.c","sys/arch/m88k/m88k/m88100_machdep.c","dae_process",170,305
11,3,114,0,21,"m88100_apply_patches@313-334@sys/arch/m88k/m88k/m88100_machdep.c","sys/arch/m88k/m88k/m88100_machdep.c","m88100_apply_patches",313,334
5,1,21,1,8,"m88100_smp_setup@338-346@sys/arch/m88k/m88k/m88100_machdep.c","sys/arch/m88k/m88k/m88100_machdep.c","m88100_smp_setup",338,346
8,1,36,2,9,"m88100_mp_atomic_begin@349-358@sys/arch/m88k/m88k/m88100_machdep.c","sys/arch/m88k/m88k/m88100_machdep.c","m88100_mp_atomic_begin",349,358
5,1,24,3,4,"m88100_mp_atomic_end@361-365@sys/arch/m88k/m88k/m88100_machdep.c","sys/arch/m88k/m88k/m88100_machdep.c","m88100_mp_atomic_end",361,365
69,17,387,1,106,"m88110_fpu_exception@67-173@sys/arch/m88k/m88k/m88110_fp.c","sys/arch/m88k/m88k/m88110_fp.c","m88110_fpu_exception",67,173
35,12,196,5,35,"m88110_fpu_fetch@183-218@sys/arch/m88k/m88k/m88110_fp.c","sys/arch/m88k/m88k/m88110_fp.c","m88110_fpu_fetch",183,218
170,65,1174,2,225,"m88110_fpu_emulate@225-450@sys/arch/m88k/m88k/m88110_fp.c","sys/arch/m88k/m88k/m88110_fp.c","m88110_fpu_emulate",225,450
12,4,79,3,19,"m8820x_cmmu_set_reg@189-208@sys/arch/m88k/m88k/m8820x_machdep.c","sys/arch/m88k/m88k/m8820x_machdep.c","m8820x_cmmu_set_reg",189,208
14,5,93,4,21,"m8820x_cmmu_set_reg_if_mode@211-232@sys/arch/m88k/m88k/m8820x_machdep.c","sys/arch/m88k/m88k/m8820x_machdep.c","m8820x_cmmu_set_reg_if_mode",211,232
13,4,88,3,20,"m8820x_cmmu_set_cmd@235-255@sys/arch/m88k/m88k/m8820x_machdep.c","sys/arch/m88k/m88k/m8820x_machdep.c","m8820x_cmmu_set_cmd",235,255
15,5,102,4,22,"m8820x_cmmu_set_cmd_if_mode@258-280@sys/arch/m88k/m88k/m8820x_machdep.c","sys/arch/m88k/m88k/m8820x_machdep.c","m8820x_cmmu_set_cmd_if_mode",258,280
17,6,114,3,24,"m8820x_cmmu_set_cmd_if_addr@284-308@sys/arch/m88k/m88k/m8820x_machdep.c","sys/arch/m88k/m88k/m8820x_machdep.c","m8820x_cmmu_set_cmd_if_addr",284,308
15,6,92,1,24,"m8820x_cmmu_wait@319-343@sys/arch/m88k/m88k/m8820x_machdep.c","sys/arch/m88k/m88k/m8820x_machdep.c","m8820x_cmmu_wait",319,343
4,1,27,3,3,"m8820x_dbatc_set@351-354@sys/arch/m88k/m88k/m8820x_machdep.c","sys/arch/m88k/m88k/m8820x_machdep.c","m8820x_dbatc_set",351,354
4,1,27,3,3,"m8820x_ibatc_set@358-361@sys/arch/m88k/m88k/m8820x_machdep.c","sys/arch/m88k/m88k/m8820x_machdep.c","m8820x_ibatc_set",358,361
52,14,336,2,67,"m8820x_batc_setup@364-431@sys/arch/m88k/m88k/m8820x_machdep.c","sys/arch/m88k/m88k/m8820x_machdep.c","m8820x_batc_setup",364,431
41,13,249,1,52,"m8820x_cpu_configuration_print@439-491@sys/arch/m88k/m88k/m8820x_machdep.c","sys/arch/m88k/m88k/m8820x_machdep.c","m8820x_cpu_configuration_print",439,491
54,18,328,2,70,"m8820x_cmmu_configuration_print@494-564@sys/arch/m88k/m88k/m8820x_machdep.c","sys/arch/m88k/m88k/m8820x_machdep.c","m8820x_cmmu_configuration_print",494,564
8,2,28,0,10,"m8820x_init@570-580@sys/arch/m88k/m88k/m8820x_machdep.c","sys/arch/m88k/m88k/m8820x_machdep.c","m8820x_init",570,580
65,11,509,1,115,"m8820x_initialize_cpu@586-701@sys/arch/m88k/m88k/m8820x_machdep.c","sys/arch/m88k/m88k/m8820x_machdep.c","m8820x_initialize_cpu",586,701
15,4,82,0,19,"m8820x_shutdown@707-726@sys/arch/m88k/m88k/m8820x_machdep.c","sys/arch/m88k/m88k/m8820x_machdep.c","m8820x_shutdown",707,726
16,7,91,0,27,"m8820x_apr_cmode@737-764@sys/arch/m88k/m88k/m8820x_machdep.c","sys/arch/m88k/m88k/m8820x_machdep.c","m8820x_apr_cmode",737,764
14,6,71,0,21,"m8820x_pte_cmode@773-794@sys/arch/m88k/m88k/m8820x_machdep.c","sys/arch/m88k/m88k/m8820x_machdep.c","m8820x_pte_cmode",773,794
7,1,27,1,9,"m8820x_set_sapr@797-806@sys/arch/m88k/m88k/m8820x_machdep.c","sys/arch/m88k/m88k/m8820x_machdep.c","m8820x_set_sapr",797,806
11,1,48,1,13,"m8820x_set_uapr@809-822@sys/arch/m88k/m88k/m8820x_machdep.c","sys/arch/m88k/m88k/m8820x_machdep.c","m8820x_set_uapr",809,822
10,1,47,3,10,"m8820x_tlbis@829-839@sys/arch/m88k/m88k/m8820x_machdep.c","sys/arch/m88k/m88k/m8820x_machdep.c","m8820x_tlbis",829,839
10,1,47,3,10,"m8820x_tlbiu@842-852@sys/arch/m88k/m88k/m8820x_machdep.c","sys/arch/m88k/m88k/m8820x_machdep.c","m8820x_tlbiu",842,852
10,1,41,1,10,"m8820x_tlbia@855-865@sys/arch/m88k/m88k/m8820x_machdep.c","sys/arch/m88k/m88k/m8820x_machdep.c","m8820x_tlbia",855,865
24,4,128,3,27,"m8820x_cache_wbinv@887-914@sys/arch/m88k/m88k/m8820x_machdep.c","sys/arch/m88k/m88k/m8820x_machdep.c","m8820x_cache_wbinv",887,914
26,4,132,3,29,"m8820x_dcache_wb@920-949@sys/arch/m88k/m88k/m8820x_machdep.c","sys/arch/m88k/m88k/m8820x_machdep.c","m8820x_dcache_wb",920,949
26,4,132,3,29,"m8820x_icache_inv@955-984@sys/arch/m88k/m88k/m8820x_machdep.c","sys/arch/m88k/m88k/m8820x_machdep.c","m8820x_icache_inv",955,984
10,2,46,3,9,"m8820x_cmmu_wb_locked@990-999@sys/arch/m88k/m88k/m8820x_machdep.c","sys/arch/m88k/m88k/m8820x_machdep.c","m8820x_cmmu_wb_locked",990,999
7,2,38,3,6,"m8820x_cmmu_wbinv_locked@1005-1011@sys/arch/m88k/m88k/m8820x_machdep.c","sys/arch/m88k/m88k/m8820x_machdep.c","m8820x_cmmu_wbinv_locked",1005,1011
7,2,38,3,6,"m8820x_cmmu_inv_locked@1017-1023@sys/arch/m88k/m88k/m8820x_machdep.c","sys/arch/m88k/m88k/m8820x_machdep.c","m8820x_cmmu_inv_locked",1017,1023
76,21,477,3,118,"m8820x_dma_cachectl@1034-1152@sys/arch/m88k/m88k/m8820x_machdep.c","sys/arch/m88k/m88k/m8820x_machdep.c","m8820x_dma_cachectl",1034,1152
3,1,13,3,3,"m8820x_dma_cachectl_local@1156-1159@sys/arch/m88k/m88k/m8820x_machdep.c","sys/arch/m88k/m88k/m8820x_machdep.c","m8820x_dma_cachectl_local",1156,1159
10,3,48,0,11,"m8820x_enable_other_cmmu_cache@1172-1183@sys/arch/m88k/m88k/m8820x_machdep.c","sys/arch/m88k/m88k/m8820x_machdep.c","m8820x_enable_other_cmmu_cache",1172,1183
31,10,198,4,91,"setregs@115-206@sys/arch/m88k/m88k/m88k_machdep.c","sys/arch/m88k/m88k/m88k_machdep.c","setregs",115,206
20,5,102,4,23,"copystr@209-232@sys/arch/m88k/m88k/m88k_machdep.c","sys/arch/m88k/m88k/m88k_machdep.c","copystr",209,232
48,12,489,1,55,"regdump@237-292@sys/arch/m88k/m88k/m88k_machdep.c","sys/arch/m88k/m88k/m88k_machdep.c","regdump",237,292
10,2,52,1,14,"set_cpu_number@299-313@sys/arch/m88k/m88k/m88k_machdep.c","sys/arch/m88k/m88k/m88k_machdep.c","set_cpu_number",299,313
5,1,21,1,4,"signotify@320-324@sys/arch/m88k/m88k/m88k_machdep.c","sys/arch/m88k/m88k/m88k_machdep.c","signotify",320,324
5,2,26,1,4,"cpu_unidle@328-332@sys/arch/m88k/m88k/m88k_machdep.c","sys/arch/m88k/m88k/m88k_machdep.c","cpu_unidle",328,332
9,3,45,1,10,"need_resched@340-350@sys/arch/m88k/m88k/m88k_machdep.c","sys/arch/m88k/m88k/m88k_machdep.c","need_resched",340,350
10,5,66,1,16,"dosoftint@360-376@sys/arch/m88k/m88k/m88k_machdep.c","sys/arch/m88k/m88k/m88k_machdep.c","dosoftint",360,376
12,2,57,0,17,"spl0@379-396@sys/arch/m88k/m88k/m88k_machdep.c","sys/arch/m88k/m88k/m88k_machdep.c","spl0",379,396
50,11,312,3,71,"vector_init@432-503@sys/arch/m88k/m88k/m88k_machdep.c","sys/arch/m88k/m88k/m88k_machdep.c","vector_init",432,503
20,5,107,0,24,"atomic_init@515-539@sys/arch/m88k/m88k/m88k_machdep.c","sys/arch/m88k/m88k/m88k_machdep.c","atomic_init",515,539
22,4,127,0,30,"cpu_emergency_disable@551-581@sys/arch/m88k/m88k/m88k_machdep.c","sys/arch/m88k/m88k/m88k_machdep.c","cpu_emergency_disable",551,581
17,7,72,4,17,"mmopen@59-76@sys/arch/m88k/m88k/mem.c","sys/arch/m88k/m88k/mem.c","mmopen",59,76
4,1,23,4,4,"mmclose@79-83@sys/arch/m88k/m88k/mem.c","sys/arch/m88k/m88k/mem.c","mmclose",79,83
60,19,354,3,70,"mmrw@86-156@sys/arch/m88k/m88k/mem.c","sys/arch/m88k/m88k/mem.c","mmrw",86,156
4,1,19,3,3,"mmmmap@159-162@sys/arch/m88k/m88k/mem.c","sys/arch/m88k/m88k/mem.c","mmmmap",159,162
4,1,26,5,3,"mmioctl@165-168@sys/arch/m88k/m88k/mem.c","sys/arch/m88k/m88k/mem.c","mmioctl",165,168
12,5,62,1,16,"__mp_lock_spin@45-61@sys/arch/m88k/m88k/mplock.c","sys/arch/m88k/m88k/mplock.c","__mp_lock_spin",45,61
20,4,127,1,34,"__mp_lock@64-98@sys/arch/m88k/m88k/mplock.c","sys/arch/m88k/m88k/mplock.c","__mp_lock",64,98
16,4,103,1,19,"__mp_unlock@101-120@sys/arch/m88k/m88k/mplock.c","sys/arch/m88k/m88k/mplock.c","__mp_unlock",101,120
17,3,108,1,21,"__mp_release_all@123-144@sys/arch/m88k/m88k/mplock.c","sys/arch/m88k/m88k/mplock.c","__mp_release_all",123,144
16,3,102,1,20,"__mp_release_all_but_one@147-167@sys/arch/m88k/m88k/mplock.c","sys/arch/m88k/m88k/mplock.c","__mp_release_all_but_one",147,167
4,1,17,1,3,"pg_to_pvh@172-175@sys/arch/m88k/m88k/pmap.c","sys/arch/m88k/m88k/pmap.c","pg_to_pvh",172,175
4,1,28,2,3,"sdt_pte@194-197@sys/arch/m88k/m88k/pmap.c","sys/arch/m88k/m88k/pmap.c","sdt_pte",194,197
8,2,42,2,9,"pmap_pte@205-214@sys/arch/m88k/m88k/pmap.c","sys/arch/m88k/m88k/pmap.c","pmap_pte",205,214
14,3,64,3,14,"pmap_extract@223-237@sys/arch/m88k/m88k/pmap.c","sys/arch/m88k/m88k/pmap.c","pmap_extract",223,237
69,20,375,4,105,"pmap_translation_info@248-353@sys/arch/m88k/m88k/pmap.c","sys/arch/m88k/m88k/pmap.c","pmap_translation_info",248,353
14,5,79,3,19,"tlb_flush@368-387@sys/arch/m88k/m88k/pmap.c","sys/arch/m88k/m88k/pmap.c","tlb_flush",368,387
10,3,54,2,15,"tlb_kflush@395-410@sys/arch/m88k/m88k/pmap.c","sys/arch/m88k/m88k/pmap.c","tlb_kflush",395,410
15,3,93,1,16,"pmap_activate@417-433@sys/arch/m88k/m88k/pmap.c","sys/arch/m88k/m88k/pmap.c","pmap_activate",417,433
5,1,24,1,5,"pmap_deactivate@440-445@sys/arch/m88k/m88k/pmap.c","sys/arch/m88k/m88k/pmap.c","pmap_deactivate",440,445
28,6,184,2,30,"pmap_expand_kmap@461-491@sys/arch/m88k/m88k/pmap.c","sys/arch/m88k/m88k/pmap.c","pmap_expand_kmap",461,491
20,4,126,3,24,"pmap_expand@503-527@sys/arch/m88k/m88k/pmap.c","sys/arch/m88k/m88k/pmap.c","pmap_expand",503,527
18,5,128,3,25,"pmap_steal_memory@540-565@sys/arch/m88k/m88k/pmap.c","sys/arch/m88k/m88k/pmap.c","pmap_steal_memory",540,565
61,20,423,5,81,"pmap_map@577-658@sys/arch/m88k/m88k/pmap.c","sys/arch/m88k/m88k/pmap.c","pmap_map",577,658
95,18,845,2,161,"pmap_bootstrap@665-826@sys/arch/m88k/m88k/pmap.c","sys/arch/m88k/m88k/pmap.c","pmap_bootstrap",665,826
7,2,40,1,11,"pmap_bootstrap_cpu@833-844@sys/arch/m88k/m88k/pmap.c","sys/arch/m88k/m88k/pmap.c","pmap_bootstrap_cpu",833,844
7,2,27,0,6,"pmap_unmap_firmware@851-857@sys/arch/m88k/m88k/pmap.c","sys/arch/m88k/m88k/pmap.c","pmap_unmap_firmware",851,857
7,1,59,1,6,"pmap_init@865-871@sys/arch/m88k/m88k/pmap.c","sys/arch/m88k/m88k/pmap.c","pmap_init",865,871
20,3,120,1,26,"pmap_create@882-908@sys/arch/m88k/m88k/pmap.c","sys/arch/m88k/m88k/pmap.c","pmap_create",882,908
20,4,134,1,20,"pmap_destroy@915-935@sys/arch/m88k/m88k/pmap.c","sys/arch/m88k/m88k/pmap.c","pmap_destroy",915,935
4,1,12,1,3,"pmap_reference@942-945@sys/arch/m88k/m88k/pmap.c","sys/arch/m88k/m88k/pmap.c","pmap_reference",942,945
29,6,198,1,33,"pmap_collect@952-985@sys/arch/m88k/m88k/pmap.c","sys/arch/m88k/m88k/pmap.c","pmap_collect",952,985
91,28,586,5,145,"pmap_enter@999-1144@sys/arch/m88k/m88k/pmap.c","sys/arch/m88k/m88k/pmap.c","pmap_enter",999,1144
18,6,135,3,33,"pmap_kenter_pa@1151-1184@sys/arch/m88k/m88k/pmap.c","sys/arch/m88k/m88k/pmap.c","pmap_kenter_pa",1151,1184
50,13,327,5,87,"pmap_remove_pte@1193-1280@sys/arch/m88k/m88k/pmap.c","sys/arch/m88k/m88k/pmap.c","pmap_remove_pte",1193,1280
26,7,150,3,33,"pmap_remove_range@1287-1320@sys/arch/m88k/m88k/pmap.c","sys/arch/m88k/m88k/pmap.c","pmap_remove_range",1287,1320
9,1,44,3,9,"pmap_remove@1327-1336@sys/arch/m88k/m88k/pmap.c","sys/arch/m88k/m88k/pmap.c","pmap_remove",1327,1336
33,8,197,2,45,"pmap_kremove@1343-1388@sys/arch/m88k/m88k/pmap.c","sys/arch/m88k/m88k/pmap.c","pmap_kremove",1343,1388
22,4,130,1,32,"pmap_remove_page@1395-1427@sys/arch/m88k/m88k/pmap.c","sys/arch/m88k/m88k/pmap.c","pmap_remove_page",1395,1427
36,8,208,4,50,"pmap_protect@1434-1484@sys/arch/m88k/m88k/pmap.c","sys/arch/m88k/m88k/pmap.c","pmap_protect",1434,1484
9,2,44,2,9,"pmap_unwire@1491-1500@sys/arch/m88k/m88k/pmap.c","sys/arch/m88k/m88k/pmap.c","pmap_unwire",1491,1500
10,2,81,2,11,"pmap_copy_page@1511-1522@sys/arch/m88k/m88k/pmap.c","sys/arch/m88k/m88k/pmap.c","pmap_copy_page",1511,1522
8,2,59,1,9,"pmap_zero_page@1529-1538@sys/arch/m88k/m88k/pmap.c","sys/arch/m88k/m88k/pmap.c","pmap_zero_page",1529,1538
32,8,216,3,56,"pmap_changebit@1547-1603@sys/arch/m88k/m88k/pmap.c","sys/arch/m88k/m88k/pmap.c","pmap_changebit",1547,1603
35,9,235,2,47,"pmap_testbit@1613-1660@sys/arch/m88k/m88k/pmap.c","sys/arch/m88k/m88k/pmap.c","pmap_testbit",1613,1660
39,10,250,2,62,"pmap_unsetbit@1670-1732@sys/arch/m88k/m88k/pmap.c","sys/arch/m88k/m88k/pmap.c","pmap_unsetbit",1670,1732
11,4,60,1,19,"pmap_is_modified@1741-1760@sys/arch/m88k/m88k/pmap.c","sys/arch/m88k/m88k/pmap.c","pmap_is_modified",1741,1760
4,1,17,1,3,"pmap_is_referenced@1769-1772@sys/arch/m88k/m88k/pmap.c","sys/arch/m88k/m88k/pmap.c","pmap_is_referenced",1769,1772
7,3,47,2,6,"pmap_page_protect@1779-1785@sys/arch/m88k/m88k/pmap.c","sys/arch/m88k/m88k/pmap.c","pmap_page_protect",1779,1785
10,5,50,1,17,"pmap_clean_page@1796-1813@sys/arch/m88k/m88k/pmap.c","sys/arch/m88k/m88k/pmap.c","pmap_clean_page",1796,1813
23,6,135,3,30,"pmap_proc_iflush@1820-1850@sys/arch/m88k/m88k/pmap.c","sys/arch/m88k/m88k/pmap.c","pmap_proc_iflush",1820,1850
22,7,128,2,33,"pmap_set_modify@1862-1895@sys/arch/m88k/m88k/pmap.c","sys/arch/m88k/m88k/pmap.c","pmap_set_modify",1862,1895
36,14,257,3,54,"pmap_cache_ctrl@1904-1958@sys/arch/m88k/m88k/pmap.c","sys/arch/m88k/m88k/pmap.c","pmap_cache_ctrl",1904,1958
31,8,193,1,41,"pmap_page_uncache@1966-2007@sys/arch/m88k/m88k/pmap.c","sys/arch/m88k/m88k/pmap.c","pmap_page_uncache",1966,2007
7,1,45,2,6,"process_read_regs@73-79@sys/arch/m88k/m88k/process_machdep.c","sys/arch/m88k/m88k/process_machdep.c","process_read_regs",73,79
11,1,77,2,12,"process_write_regs@84-96@sys/arch/m88k/m88k/process_machdep.c","sys/arch/m88k/m88k/process_machdep.c","process_write_regs",84,96
10,1,53,2,10,"process_set_pc@101-111@sys/arch/m88k/m88k/process_machdep.c","sys/arch/m88k/m88k/process_machdep.c","process_set_pc",101,111
49,16,484,6,82,"sendsig@107-189@sys/arch/m88k/m88k/sig_machdep.c","sys/arch/m88k/m88k/sig_machdep.c","sendsig",107,189
37,11,318,3,78,"sys_sigreturn@199-277@sys/arch/m88k/m88k/sig_machdep.c","sys/arch/m88k/m88k/sig_machdep.c","sys_sigreturn",199,277
30,13,169,3,34,"local_stack_frame@286-320@sys/arch/m88k/m88k/sig_machdep.c","sys/arch/m88k/m88k/sig_machdep.c","local_stack_frame",286,320
11,2,61,1,11,"softintr_init@54-65@sys/arch/m88k/m88k/softintr.c","sys/arch/m88k/m88k/softintr.c","softintr_init",54,65
18,3,109,1,22,"softintr_dispatch@73-95@sys/arch/m88k/m88k/softintr.c","sys/arch/m88k/m88k/softintr.c","softintr_dispatch",73,95
31,8,145,3,34,"softintr_establish@101-135@sys/arch/m88k/m88k/softintr.c","sys/arch/m88k/m88k/softintr.c","softintr_establish",101,135
12,2,79,1,13,"softintr_disestablish@141-154@sys/arch/m88k/m88k/softintr.c","sys/arch/m88k/m88k/softintr.c","softintr_disestablish",141,154
12,2,86,1,12,"softintr_schedule@160-172@sys/arch/m88k/m88k/softintr.c","sys/arch/m88k/m88k/softintr.c","softintr_schedule",160,172
23,8,121,2,30,"printtrap@119-149@sys/arch/m88k/m88k/trap.c","sys/arch/m88k/m88k/trap.c","printtrap",119,149
10,3,57,2,11,"panictrap@152-163@sys/arch/m88k/m88k/trap.c","sys/arch/m88k/m88k/trap.c","panictrap",152,163
7,1,33,1,7,"interrupt@169-176@sys/arch/m88k/m88k/trap.c","sys/arch/m88k/m88k/trap.c","interrupt",169,176
4,1,15,1,3,"nmi@183-186@sys/arch/m88k/m88k/trap.c","sys/arch/m88k/m88k/trap.c","nmi",183,186
4,1,14,1,3,"nmi_wrapup@192-195@sys/arch/m88k/m88k/trap.c","sys/arch/m88k/m88k/trap.c","nmi_wrapup",192,195
9,1,54,1,10,"ast@202-212@sys/arch/m88k/m88k/trap.c","sys/arch/m88k/m88k/trap.c","ast",202,212
266,63,1456,2,383,"m88100_trap@216-599@sys/arch/m88k/m88k/trap.c","sys/arch/m88k/m88k/trap.c","m88100_trap",216,599
318,92,1725,2,519,"m88110_trap@604-1123@sys/arch/m88k/m88k/trap.c","sys/arch/m88k/m88k/trap.c","m88110_trap",604,1123
9,3,55,1,11,"error_fatal@1127-1138@sys/arch/m88k/m88k/trap.c","sys/arch/m88k/m88k/trap.c","error_fatal",1127,1138
70,12,473,2,117,"m88100_syscall@1142-1259@sys/arch/m88k/m88k/trap.c","sys/arch/m88k/m88k/trap.c","m88100_syscall",1142,1259
67,12,431,2,117,"m88110_syscall@1265-1382@sys/arch/m88k/m88k/trap.c","sys/arch/m88k/m88k/trap.c","m88110_syscall",1265,1382
22,6,130,1,31,"child_return@1390-1421@sys/arch/m88k/m88k/trap.c","sys/arch/m88k/m88k/trap.c","child_return",1390,1421
15,1,108,3,15,"ss_get_value@1439-1454@sys/arch/m88k/m88k/trap.c","sys/arch/m88k/m88k/trap.c","ss_get_value",1439,1454
15,1,108,3,15,"ss_put_value@1457-1472@sys/arch/m88k/m88k/trap.c","sys/arch/m88k/m88k/trap.c","ss_put_value",1457,1472
24,10,136,3,41,"ss_branch_taken@1485-1526@sys/arch/m88k/m88k/trap.c","sys/arch/m88k/m88k/trap.c","ss_branch_taken",1485,1526
15,8,63,1,16,"ss_inst_branch_or_call@1529-1545@sys/arch/m88k/m88k/trap.c","sys/arch/m88k/m88k/trap.c","ss_inst_branch_or_call",1529,1545
12,3,87,4,17,"ss_put_breakpoint@1548-1565@sys/arch/m88k/m88k/trap.c","sys/arch/m88k/m88k/trap.c","ss_put_breakpoint",1548,1565
33,11,261,2,49,"process_sstep@1568-1617@sys/arch/m88k/m88k/trap.c","sys/arch/m88k/m88k/trap.c","process_sstep",1568,1617
9,2,46,2,14,"splassert_check@1623-1637@sys/arch/m88k/m88k/trap.c","sys/arch/m88k/m88k/trap.c","splassert_check",1623,1637
74,20,483,2,93,"double_reg_fixup@1653-1746@sys/arch/m88k/m88k/trap.c","sys/arch/m88k/m88k/trap.c","double_reg_fixup",1653,1746
30,11,184,1,41,"cache_flush@1749-1790@sys/arch/m88k/m88k/trap.c","sys/arch/m88k/m88k/trap.c","cache_flush",1749,1790
25,6,234,6,43,"cpu_fork@73-116@sys/arch/m88k/m88k/vm_machdep.c","sys/arch/m88k/m88k/vm_machdep.c","cpu_fork",73,116
5,1,19,1,4,"cpu_exit@122-126@sys/arch/m88k/m88k/vm_machdep.c","sys/arch/m88k/m88k/vm_machdep.c","cpu_exit",122,126
28,5,210,2,33,"vmapbuf@132-165@sys/arch/m88k/m88k/vm_machdep.c","sys/arch/m88k/m88k/vm_machdep.c","vmapbuf",132,165
16,3,115,2,19,"vunmapbuf@172-191@sys/arch/m88k/m88k/vm_machdep.c","sys/arch/m88k/m88k/vm_machdep.c","vunmapbuf",172,191
10,4,62,3,12,"abtn_match@79-91@sys/arch/macppc/dev/abtn.c","sys/arch/macppc/dev/abtn.c","abtn_match",79,91
13,1,97,3,16,"abtn_attach@94-110@sys/arch/macppc/dev/abtn.c","sys/arch/macppc/dev/abtn.c","abtn_attach",94,110
41,17,164,3,53,"abtn_adbcomplete@113-166@sys/arch/macppc/dev/abtn.c","sys/arch/macppc/dev/abtn.c","abtn_adbcomplete",113,166
21,5,100,1,21,"print_single@255-276@sys/arch/macppc/dev/adb.c","sys/arch/macppc/dev/adb.c","print_single",255,276
22,4,91,1,23,"adb_cuda_tickle@280-303@sys/arch/macppc/dev/adb.c","sys/arch/macppc/dev/adb.c","adb_cuda_tickle",280,303
142,35,684,1,219,"adb_intr_cuda@313-532@sys/arch/macppc/dev/adb.c","sys/arch/macppc/dev/adb.c","adb_intr_cuda",313,532
59,21,330,5,83,"send_adb_cuda@536-619@sys/arch/macppc/dev/adb.c","sys/arch/macppc/dev/adb.c","send_adb_cuda",536,619
12,3,35,1,12,"adb_intr@627-639@sys/arch/macppc/dev/adb.c","sys/arch/macppc/dev/adb.c","adb_intr",627,639
66,21,418,1,99,"adb_pass_up@667-766@sys/arch/macppc/dev/adb.c","sys/arch/macppc/dev/adb.c","adb_pass_up",667,766
35,9,209,1,60,"adb_soft_intr@775-835@sys/arch/macppc/dev/adb.c","sys/arch/macppc/dev/adb.c","adb_soft_intr",775,835
24,5,127,4,27,"adb_op@852-879@sys/arch/macppc/dev/adb.c","sys/arch/macppc/dev/adb.c","adb_op",852,879
35,4,175,1,49,"adb_hw_setup@888-937@sys/arch/macppc/dev/adb.c","sys/arch/macppc/dev/adb.c","adb_hw_setup",888,937
144,49,932,1,226,"adb_reinit@944-1170@sys/arch/macppc/dev/adb.c","sys/arch/macppc/dev/adb.c","adb_reinit",944,1170
15,7,81,1,18,"adb_cmd_result@1183-1201@sys/arch/macppc/dev/adb.c","sys/arch/macppc/dev/adb.c","adb_cmd_result",1183,1201
17,7,101,2,35,"adb_op_sync@1212-1247@sys/arch/macppc/dev/adb.c","sys/arch/macppc/dev/adb.c","adb_op_sync",1212,1247
4,1,22,3,3,"adb_op_comprout@1257-1260@sys/arch/macppc/dev/adb.c","sys/arch/macppc/dev/adb.c","adb_op_comprout",1257,1260
10,3,51,1,12,"count_adbs@1263-1275@sys/arch/macppc/dev/adb.c","sys/arch/macppc/dev/adb.c","count_adbs",1263,1275
15,6,147,3,19,"get_ind_adb_info@1278-1297@sys/arch/macppc/dev/adb.c","sys/arch/macppc/dev/adb.c","get_ind_adb_info",1278,1297
18,6,150,2,21,"get_adb_info@1300-1321@sys/arch/macppc/dev/adb.c","sys/arch/macppc/dev/adb.c","get_adb_info",1300,1321
17,6,127,2,21,"set_adb_info@1324-1345@sys/arch/macppc/dev/adb.c","sys/arch/macppc/dev/adb.c","set_adb_info",1324,1345
41,7,200,1,47,"adb_read_date_time@1350-1397@sys/arch/macppc/dev/adb.c","sys/arch/macppc/dev/adb.c","adb_read_date_time",1350,1397
31,5,188,1,37,"adb_set_date_time@1402-1439@sys/arch/macppc/dev/adb.c","sys/arch/macppc/dev/adb.c","adb_set_date_time",1402,1439
25,6,117,1,33,"adb_poweroff@1443-1476@sys/arch/macppc/dev/adb.c","sys/arch/macppc/dev/adb.c","adb_poweroff",1443,1476
6,2,36,0,5,"setsoftadb@1479-1484@sys/arch/macppc/dev/adb.c","sys/arch/macppc/dev/adb.c","setsoftadb",1479,1484
15,3,83,0,16,"adb_cuda_autopoll@1487-1503@sys/arch/macppc/dev/adb.c","sys/arch/macppc/dev/adb.c","adb_cuda_autopoll",1487,1503
15,3,83,0,17,"adb_cuda_fileserver_mode@1506-1523@sys/arch/macppc/dev/adb.c","sys/arch/macppc/dev/adb.c","adb_cuda_fileserver_mode",1506,1523
20,6,95,0,22,"adb_restart@1526-1548@sys/arch/macppc/dev/adb.c","sys/arch/macppc/dev/adb.c","adb_restart",1526,1548
13,5,81,3,17,"adbmatch@1562-1579@sys/arch/macppc/dev/adb.c","sys/arch/macppc/dev/adb.c","adbmatch",1562,1579
72,18,507,3,103,"adbattach@1582-1685@sys/arch/macppc/dev/adb.c","sys/arch/macppc/dev/adb.c","adbattach",1582,1685
4,1,10,0,3,"akbd_is_console@63-66@sys/arch/macppc/dev/akbd_machdep.c","sys/arch/macppc/dev/akbd_machdep.c","akbd_is_console",63,66
6,1,23,0,5,"akbd_cnattach@69-74@sys/arch/macppc/dev/akbd_machdep.c","sys/arch/macppc/dev/akbd_machdep.c","akbd_cnattach",69,74
20,3,109,3,25,"akbd_cngetc@77-102@sys/arch/macppc/dev/akbd_machdep.c","sys/arch/macppc/dev/akbd_machdep.c","akbd_cngetc",77,102
3,1,11,2,2,"akbd_cnpollc@105-107@sys/arch/macppc/dev/akbd_machdep.c","sys/arch/macppc/dev/akbd_machdep.c","akbd_cnpollc",105,107
20,7,157,3,24,"aoa_match@94-118@sys/arch/macppc/dev/aoa.c","sys/arch/macppc/dev/aoa.c","aoa_match",94,118
7,1,52,3,8,"aoa_attach@121-129@sys/arch/macppc/dev/aoa.c","sys/arch/macppc/dev/aoa.c","aoa_attach",121,129
6,1,39,1,6,"aoa_defer@132-138@sys/arch/macppc/dev/aoa.c","sys/arch/macppc/dev/aoa.c","aoa_defer",132,138
3,1,15,3,3,"aoa_set_volume@141-144@sys/arch/macppc/dev/aoa.c","sys/arch/macppc/dev/aoa.c","aoa_set_volume",141,144
7,2,47,3,8,"apmmatch@111-119@sys/arch/macppc/dev/apm.c","sys/arch/macppc/dev/apm.c","apmmatch",111,119
7,1,58,3,8,"apmattach@122-130@sys/arch/macppc/dev/apm.c","sys/arch/macppc/dev/apm.c","apmattach",122,130
34,10,180,4,37,"apmopen@133-170@sys/arch/macppc/dev/apm.c","sys/arch/macppc/dev/apm.c","apmopen",133,170
18,6,106,4,21,"apmclose@173-194@sys/arch/macppc/dev/apm.c","sys/arch/macppc/dev/apm.c","apmclose",173,194
87,26,486,5,100,"apmioctl@197-297@sys/arch/macppc/dev/apm.c","sys/arch/macppc/dev/apm.c","apmioctl",197,297
5,1,37,1,5,"filt_apmrdetach@300-305@sys/arch/macppc/dev/apm.c","sys/arch/macppc/dev/apm.c","filt_apmrdetach",300,305
6,3,35,2,7,"filt_apmread@308-315@sys/arch/macppc/dev/apm.c","sys/arch/macppc/dev/apm.c","filt_apmread",308,315
17,5,102,2,21,"apmkqfilter@318-339@sys/arch/macppc/dev/apm.c","sys/arch/macppc/dev/apm.c","apmkqfilter",318,339
7,2,47,3,7,"asms_match@81-88@sys/arch/macppc/dev/asms.c","sys/arch/macppc/dev/asms.c","asms_match",81,88
155,21,1243,3,183,"asms_attach@91-274@sys/arch/macppc/dev/asms.c","sys/arch/macppc/dev/asms.c","asms_attach",91,274
20,4,177,1,24,"asms_refresh@277-301@sys/arch/macppc/dev/asms.c","sys/arch/macppc/dev/asms.c","asms_refresh",277,301
12,6,88,3,22,"awacs_match@224-246@sys/arch/macppc/dev/awacs.c","sys/arch/macppc/dev/awacs.c","awacs_match",224,246
73,6,644,3,95,"awacs_attach@249-344@sys/arch/macppc/dev/awacs.c","sys/arch/macppc/dev/awacs.c","awacs_attach",249,344
5,1,28,2,5,"awacs_read_reg@347-352@sys/arch/macppc/dev/awacs.c","sys/arch/macppc/dev/awacs.c","awacs_read_reg",347,352
5,1,32,3,5,"awacs_write_reg@355-360@sys/arch/macppc/dev/awacs.c","sys/arch/macppc/dev/awacs.c","awacs_write_reg",355,360
5,2,33,2,4,"awacs_write_codec@363-367@sys/arch/macppc/dev/awacs.c","sys/arch/macppc/dev/awacs.c","awacs_write_codec",363,367
26,5,155,1,33,"awacs_intr@370-403@sys/arch/macppc/dev/awacs.c","sys/arch/macppc/dev/awacs.c","awacs_intr",370,403
23,6,140,1,26,"awacs_tx_intr@406-432@sys/arch/macppc/dev/awacs.c","sys/arch/macppc/dev/awacs.c","awacs_tx_intr",406,432
23,6,140,1,27,"awacs_rx_intr@434-461@sys/arch/macppc/dev/awacs.c","sys/arch/macppc/dev/awacs.c","awacs_rx_intr",434,461
4,1,14,2,3,"awacs_open@464-467@sys/arch/macppc/dev/awacs.c","sys/arch/macppc/dev/awacs.c","awacs_open",464,467
8,1,37,1,10,"awacs_close@473-483@sys/arch/macppc/dev/awacs.c","sys/arch/macppc/dev/awacs.c","awacs_close",473,483
36,11,234,5,47,"awacs_set_params@486-533@sys/arch/macppc/dev/awacs.c","sys/arch/macppc/dev/awacs.c","awacs_set_params",486,533
6,2,34,2,5,"awacs_round_blocksize@536-541@sys/arch/macppc/dev/awacs.c","sys/arch/macppc/dev/awacs.c","awacs_round_blocksize",536,541
11,1,57,1,11,"awacs_halt_output@544-555@sys/arch/macppc/dev/awacs.c","sys/arch/macppc/dev/awacs.c","awacs_halt_output",544,555
9,1,44,1,9,"awacs_halt_input@558-567@sys/arch/macppc/dev/awacs.c","sys/arch/macppc/dev/awacs.c","awacs_halt_input",558,567
57,13,362,2,67,"awacs_set_port@583-650@sys/arch/macppc/dev/awacs.c","sys/arch/macppc/dev/awacs.c","awacs_set_port",583,650
44,6,350,2,51,"awacs_get_port@653-704@sys/arch/macppc/dev/awacs.c","sys/arch/macppc/dev/awacs.c","awacs_get_port",653,704
83,9,798,2,92,"awacs_query_devinfo@707-799@sys/arch/macppc/dev/awacs.c","sys/arch/macppc/dev/awacs.c","awacs_query_devinfo",707,799
7,2,45,3,6,"awacs_round_buffersize@802-808@sys/arch/macppc/dev/awacs.c","sys/arch/macppc/dev/awacs.c","awacs_round_buffersize",802,808
51,8,445,5,60,"awacs_allocm@811-871@sys/arch/macppc/dev/awacs.c","sys/arch/macppc/dev/awacs.c","awacs_allocm",811,871
4,1,11,1,3,"awacs_get_props@874-877@sys/arch/macppc/dev/awacs.c","sys/arch/macppc/dev/awacs.c","awacs_get_props",874,877
32,6,266,7,40,"awacs_trigger_output@880-920@sys/arch/macppc/dev/awacs.c","sys/arch/macppc/dev/awacs.c","awacs_trigger_output",880,920
32,6,266,7,40,"awacs_trigger_input@923-963@sys/arch/macppc/dev/awacs.c","sys/arch/macppc/dev/awacs.c","awacs_trigger_input",923,963
9,1,78,3,10,"awacs_set_speaker_volume@966-976@sys/arch/macppc/dev/awacs.c","sys/arch/macppc/dev/awacs.c","awacs_set_speaker_volume",966,976
9,1,78,3,10,"awacs_set_ext_volume@979-989@sys/arch/macppc/dev/awacs.c","sys/arch/macppc/dev/awacs.c","awacs_set_ext_volume",979,989
26,9,228,2,31,"awacs_set_rate@992-1023@sys/arch/macppc/dev/awacs.c","sys/arch/macppc/dev/awacs.c","awacs_set_rate",992,1023
16,5,125,3,20,"daca_match@105-125@sys/arch/macppc/dev/daca.c","sys/arch/macppc/dev/daca.c","daca_match",105,125
7,1,52,3,8,"daca_attach@130-138@sys/arch/macppc/dev/daca.c","sys/arch/macppc/dev/daca.c","daca_attach",130,138
15,4,116,1,19,"daca_defer@141-160@sys/arch/macppc/dev/daca.c","sys/arch/macppc/dev/daca.c","daca_defer",141,160
5,1,31,1,4,"daca_init@163-167@sys/arch/macppc/dev/daca.c","sys/arch/macppc/dev/daca.c","daca_init",163,167
10,1,65,3,11,"daca_set_volume@170-181@sys/arch/macppc/dev/daca.c","sys/arch/macppc/dev/daca.c","daca_set_volume",170,181
20,2,121,2,25,"dbdma_start@38-63@sys/arch/macppc/dev/dbdma.c","sys/arch/macppc/dev/dbdma.c","dbdma_start",38,63
7,2,43,1,7,"dbdma_stop@66-73@sys/arch/macppc/dev/dbdma.c","sys/arch/macppc/dev/dbdma.c","dbdma_stop",66,73
5,2,36,1,6,"dbdma_flush@76-82@sys/arch/macppc/dev/dbdma.c","sys/arch/macppc/dev/dbdma.c","dbdma_flush",76,82
11,2,46,1,12,"dbdma_reset@85-97@sys/arch/macppc/dev/dbdma.c","sys/arch/macppc/dev/dbdma.c","dbdma_reset",85,97
6,1,30,1,5,"dbdma_continue@100-105@sys/arch/macppc/dev/dbdma.c","sys/arch/macppc/dev/dbdma.c","dbdma_continue",100,105
5,2,34,1,6,"dbdma_pause@108-114@sys/arch/macppc/dev/dbdma.c","sys/arch/macppc/dev/dbdma.c","dbdma_pause",108,114
26,6,240,2,28,"dbdma_alloc@117-145@sys/arch/macppc/dev/dbdma.c","sys/arch/macppc/dev/dbdma.c","dbdma_alloc",117,145
10,4,80,1,9,"dbdma_free@148-157@sys/arch/macppc/dev/dbdma.c","sys/arch/macppc/dev/dbdma.c","dbdma_free",148,157
8,1,41,2,7,"dbdma_st32@139-146@sys/arch/macppc/dev/dbdma.h","sys/arch/macppc/dev/dbdma.h","dbdma_st32",139,146
8,1,41,2,7,"dbdma_st16@149-156@sys/arch/macppc/dev/dbdma.h","sys/arch/macppc/dev/dbdma.h","dbdma_st16",149,156
9,1,39,1,10,"dbdma_ld32@159-169@sys/arch/macppc/dev/dbdma.h","sys/arch/macppc/dev/dbdma.h","dbdma_ld32",159,169
9,1,39,1,10,"dbdma_ld16@172-182@sys/arch/macppc/dev/dbdma.h","sys/arch/macppc/dev/dbdma.h","dbdma_ld16",172,182
11,4,74,3,13,"dfs_match@51-64@sys/arch/macppc/dev/dfs.c","sys/arch/macppc/dev/dfs.c","dfs_match",51,64
26,5,188,3,35,"dfs_attach@67-102@sys/arch/macppc/dev/dfs.c","sys/arch/macppc/dev/dfs.c","dfs_attach",67,102
29,7,148,1,30,"dfs_setperf@105-135@sys/arch/macppc/dev/dfs.c","sys/arch/macppc/dev/dfs.c","dfs_setperf",105,135
25,4,100,1,28,"dfs_scale_frequency@138-166@sys/arch/macppc/dev/dfs.c","sys/arch/macppc/dev/dfs.c","dfs_scale_frequency",138,166
11,4,65,3,13,"espmatch@165-178@sys/arch/macppc/dev/esp.c","sys/arch/macppc/dev/esp.c","espmatch",165,178
40,3,340,3,76,"espattach@184-260@sys/arch/macppc/dev/esp.c","sys/arch/macppc/dev/esp.c","espattach",184,260
15,2,69,2,15,"esp_activate@263-278@sys/arch/macppc/dev/esp.c","sys/arch/macppc/dev/esp.c","esp_activate",263,278
5,1,38,2,5,"esp_read_reg@285-290@sys/arch/macppc/dev/esp.c","sys/arch/macppc/dev/esp.c","esp_read_reg",285,290
6,1,47,3,6,"esp_write_reg@293-299@sys/arch/macppc/dev/esp.c","sys/arch/macppc/dev/esp.c","esp_write_reg",293,299
4,1,19,1,3,"esp_dma_isintr@302-305@sys/arch/macppc/dev/esp.c","sys/arch/macppc/dev/esp.c","esp_dma_isintr",302,305
6,1,34,1,6,"esp_dma_reset@308-314@sys/arch/macppc/dev/esp.c","sys/arch/macppc/dev/esp.c","esp_dma_reset",308,314
5,1,29,1,5,"esp_dma_intr@317-322@sys/arch/macppc/dev/esp.c","sys/arch/macppc/dev/esp.c","esp_dma_intr",317,322
27,7,226,5,32,"esp_dma_setup@325-357@sys/arch/macppc/dev/esp.c","sys/arch/macppc/dev/esp.c","esp_dma_setup",325,357
6,1,38,1,6,"esp_dma_go@360-366@sys/arch/macppc/dev/esp.c","sys/arch/macppc/dev/esp.c","esp_dma_go",360,366
7,1,45,1,7,"esp_dma_stop@369-376@sys/arch/macppc/dev/esp.c","sys/arch/macppc/dev/esp.c","esp_dma_stop",369,376
5,1,28,1,5,"esp_dma_isactive@379-384@sys/arch/macppc/dev/esp.c","sys/arch/macppc/dev/esp.c","esp_dma_isactive",379,384
44,11,332,1,68,"espdmaintr@395-463@sys/arch/macppc/dev/esp.c","sys/arch/macppc/dev/esp.c","espdmaintr",395,463
45,5,471,3,59,"i2s_attach@68-127@sys/arch/macppc/dev/i2s.c","sys/arch/macppc/dev/i2s.c","i2s_attach",68,127
27,6,157,1,32,"i2s_intr@130-162@sys/arch/macppc/dev/i2s.c","sys/arch/macppc/dev/i2s.c","i2s_intr",130,162
27,6,157,1,32,"i2s_iintr@165-197@sys/arch/macppc/dev/i2s.c","sys/arch/macppc/dev/i2s.c","i2s_iintr",165,197
6,1,18,2,5,"i2s_open@200-205@sys/arch/macppc/dev/i2s.c","sys/arch/macppc/dev/i2s.c","i2s_open",200,205
9,1,39,1,10,"i2s_close@211-221@sys/arch/macppc/dev/i2s.c","sys/arch/macppc/dev/i2s.c","i2s_close",211,221
42,14,265,5,52,"i2s_set_params@224-276@sys/arch/macppc/dev/i2s.c","sys/arch/macppc/dev/i2s.c","i2s_set_params",224,276
8,2,30,2,7,"i2s_round_blocksize@279-286@sys/arch/macppc/dev/i2s.c","sys/arch/macppc/dev/i2s.c","i2s_round_blocksize",279,286
8,1,34,1,8,"i2s_halt_output@289-297@sys/arch/macppc/dev/i2s.c","sys/arch/macppc/dev/i2s.c","i2s_halt_output",289,297
8,1,34,1,8,"i2s_halt_input@300-308@sys/arch/macppc/dev/i2s.c","sys/arch/macppc/dev/i2s.c","i2s_halt_input",300,308
72,26,499,2,90,"i2s_set_port@324-414@sys/arch/macppc/dev/i2s.c","sys/arch/macppc/dev/i2s.c","i2s_set_port",324,414
37,10,240,2,47,"i2s_get_port@417-464@sys/arch/macppc/dev/i2s.c","sys/arch/macppc/dev/i2s.c","i2s_get_port",417,464
107,14,1025,2,117,"i2s_query_devinfo@467-584@sys/arch/macppc/dev/i2s.c","sys/arch/macppc/dev/i2s.c","i2s_query_devinfo",467,584
9,2,33,3,8,"i2s_round_buffersize@587-595@sys/arch/macppc/dev/i2s.c","sys/arch/macppc/dev/i2s.c","i2s_round_buffersize",587,595
5,1,13,1,4,"i2s_get_props@598-602@sys/arch/macppc/dev/i2s.c","sys/arch/macppc/dev/i2s.c","i2s_get_props",598,602
7,2,59,2,8,"for@631-639@sys/arch/macppc/dev/i2s.c","sys/arch/macppc/dev/i2s.c","for",631,639
7,2,59,0,8,"for@677-685@sys/arch/macppc/dev/i2s.c","sys/arch/macppc/dev/i2s.c","for",677,685
78,12,376,0,100,"i2s_set_rate@705-805@sys/arch/macppc/dev/i2s.c","sys/arch/macppc/dev/i2s.c","i2s_set_rate",705,805
9,3,71,0,12,"i2s_mute@808-820@sys/arch/macppc/dev/i2s.c","sys/arch/macppc/dev/i2s.c","i2s_mute",808,820
41,9,272,0,47,"i2s_cint@823-870@sys/arch/macppc/dev/i2s.c","sys/arch/macppc/dev/i2s.c","i2s_cint",823,870
18,6,168,0,20,"i2s_gpio_offset@873-893@sys/arch/macppc/dev/i2s.c","sys/arch/macppc/dev/i2s.c","i2s_gpio_offset",873,893
62,14,575,0,79,"i2s_gpio_init@896-975@sys/arch/macppc/dev/i2s.c","sys/arch/macppc/dev/i2s.c","i2s_gpio_init",896,975
51,8,445,0,60,"i2s_allocm@978-1038@sys/arch/macppc/dev/i2s.c","sys/arch/macppc/dev/i2s.c","i2s_allocm",978,1038
12,2,78,0,15,"deq_reset@1043-1058@sys/arch/macppc/dev/i2s.c","sys/arch/macppc/dev/i2s.c","deq_reset",1043,1058
4,1,22,2,3,"bmac_read_reg@140-143@sys/arch/macppc/dev/if_bm.c","sys/arch/macppc/dev/if_bm.c","bmac_read_reg",140,143
4,1,26,3,3,"bmac_write_reg@146-149@sys/arch/macppc/dev/if_bm.c","sys/arch/macppc/dev/if_bm.c","bmac_write_reg",146,149
5,1,33,3,4,"bmac_set_bits@152-156@sys/arch/macppc/dev/if_bm.c","sys/arch/macppc/dev/if_bm.c","bmac_set_bits",152,156
4,1,31,3,3,"bmac_reset_bits@159-162@sys/arch/macppc/dev/if_bm.c","sys/arch/macppc/dev/if_bm.c","bmac_reset_bits",159,162
11,5,84,3,13,"bmac_match@165-178@sys/arch/macppc/dev/if_bm.c","sys/arch/macppc/dev/if_bm.c","bmac_match",165,178
93,9,835,3,113,"bmac_attach@181-294@sys/arch/macppc/dev/if_bm.c","sys/arch/macppc/dev/if_bm.c","bmac_attach",181,294
21,1,111,1,31,"bmac_reset_chip@300-331@sys/arch/macppc/dev/if_bm.c","sys/arch/macppc/dev/if_bm.c","bmac_reset_chip",300,331
71,6,601,1,103,"bmac_init@334-437@sys/arch/macppc/dev/if_bm.c","sys/arch/macppc/dev/if_bm.c","bmac_init",334,437
20,2,159,1,24,"bmac_init_dma@440-464@sys/arch/macppc/dev/if_bm.c","sys/arch/macppc/dev/if_bm.c","bmac_init_dma",440,464
17,5,94,1,26,"bmac_intr@467-493@sys/arch/macppc/dev/if_bm.c","sys/arch/macppc/dev/if_bm.c","bmac_intr",467,493
52,12,343,1,68,"bmac_rint@496-564@sys/arch/macppc/dev/if_bm.c","sys/arch/macppc/dev/if_bm.c","bmac_rint",496,564
7,1,28,1,7,"bmac_reset@567-574@sys/arch/macppc/dev/if_bm.c","sys/arch/macppc/dev/if_bm.c","bmac_reset",567,574
16,1,104,1,25,"bmac_stop@577-602@sys/arch/macppc/dev/if_bm.c","sys/arch/macppc/dev/if_bm.c","bmac_stop",577,602
21,8,138,1,33,"bmac_start@605-638@sys/arch/macppc/dev/if_bm.c","sys/arch/macppc/dev/if_bm.c","bmac_start",605,638
10,1,75,3,11,"bmac_transmit_packet@641-652@sys/arch/macppc/dev/if_bm.c","sys/arch/macppc/dev/if_bm.c","bmac_transmit_packet",641,652
19,4,114,3,20,"bmac_put@655-675@sys/arch/macppc/dev/if_bm.c","sys/arch/macppc/dev/if_bm.c","bmac_put",655,675
39,7,217,3,41,"bmac_get@678-719@sys/arch/macppc/dev/if_bm.c","sys/arch/macppc/dev/if_bm.c","bmac_get",678,719
9,1,55,1,11,"bmac_watchdog@722-733@sys/arch/macppc/dev/if_bm.c","sys/arch/macppc/dev/if_bm.c","bmac_watchdog",722,733
44,13,256,3,65,"bmac_ioctl@736-801@sys/arch/macppc/dev/if_bm.c","sys/arch/macppc/dev/if_bm.c","bmac_ioctl",736,801
5,1,27,1,5,"bmac_mediachange@804-809@sys/arch/macppc/dev/if_bm.c","sys/arch/macppc/dev/if_bm.c","bmac_mediachange",804,809
7,1,51,2,8,"bmac_mediastatus@812-820@sys/arch/macppc/dev/if_bm.c","sys/arch/macppc/dev/if_bm.c","bmac_mediastatus",812,820
38,5,283,1,56,"bmac_setladrf@826-882@sys/arch/macppc/dev/if_bm.c","sys/arch/macppc/dev/if_bm.c","bmac_setladrf",826,882
4,1,28,3,3,"bmac_mii_readreg@885-888@sys/arch/macppc/dev/if_bm.c","sys/arch/macppc/dev/if_bm.c","bmac_mii_readreg",885,888
4,1,32,4,3,"bmac_mii_writereg@891-894@sys/arch/macppc/dev/if_bm.c","sys/arch/macppc/dev/if_bm.c","bmac_mii_writereg",891,894
5,1,28,1,5,"bmac_mbo_read@897-902@sys/arch/macppc/dev/if_bm.c","sys/arch/macppc/dev/if_bm.c","bmac_mbo_read",897,902
5,1,32,2,5,"bmac_mbo_write@905-910@sys/arch/macppc/dev/if_bm.c","sys/arch/macppc/dev/if_bm.c","bmac_mbo_write",905,910
13,3,81,1,17,"bmac_mii_statchg@913-930@sys/arch/macppc/dev/if_bm.c","sys/arch/macppc/dev/if_bm.c","bmac_mii_statchg",913,930
9,1,47,1,10,"bmac_mii_tick@933-943@sys/arch/macppc/dev/if_bm.c","sys/arch/macppc/dev/if_bm.c","bmac_mii_tick",933,943
11,4,75,3,16,"mc_match@331-347@sys/arch/macppc/dev/if_mc.c","sys/arch/macppc/dev/if_mc.c","mc_match",331,347
108,11,887,3,133,"mc_attach@350-483@sys/arch/macppc/dev/if_mc.c","sys/arch/macppc/dev/if_mc.c","mc_attach",350,483
34,10,200,3,51,"mc_ioctl@486-537@sys/arch/macppc/dev/if_mc.c","sys/arch/macppc/dev/if_mc.c","mc_ioctl",486,537
18,8,112,1,31,"mc_start@543-574@sys/arch/macppc/dev/if_mc.c","sys/arch/macppc/dev/if_mc.c","mc_start",543,574
5,1,19,1,4,"mc_reset@581-585@sys/arch/macppc/dev/if_mc.c","sys/arch/macppc/dev/if_mc.c","mc_reset",581,585
39,6,307,1,62,"mc_init@588-650@sys/arch/macppc/dev/if_mc.c","sys/arch/macppc/dev/if_mc.c","mc_init",588,650
13,1,74,1,16,"mc_stop@658-674@sys/arch/macppc/dev/if_mc.c","sys/arch/macppc/dev/if_mc.c","mc_stop",658,674
6,1,28,1,6,"mc_watchdog@682-688@sys/arch/macppc/dev/if_mc.c","sys/arch/macppc/dev/if_mc.c","mc_watchdog",682,688
25,9,151,1,42,"mc_intr@691-733@sys/arch/macppc/dev/if_mc.c","sys/arch/macppc/dev/if_mc.c","mc_intr",691,733
36,8,215,1,43,"mc_tint@736-779@sys/arch/macppc/dev/if_mc.c","sys/arch/macppc/dev/if_mc.c","mc_tint",736,779
28,10,190,1,44,"mc_rint@782-826@sys/arch/macppc/dev/if_mc.c","sys/arch/macppc/dev/if_mc.c","mc_rint",782,826
26,5,184,2,34,"maceput@831-865@sys/arch/macppc/dev/if_mc.c","sys/arch/macppc/dev/if_mc.c","maceput",831,865
20,5,124,3,24,"mace_read@868-892@sys/arch/macppc/dev/if_mc.c","sys/arch/macppc/dev/if_mc.c","mace_read",868,892
39,7,217,3,42,"mace_get@901-943@sys/arch/macppc/dev/if_mc.c","sys/arch/macppc/dev/if_mc.c","mace_get",901,943
10,1,74,2,11,"mc_putpacket@946-957@sys/arch/macppc/dev/if_mc.c","sys/arch/macppc/dev/if_mc.c","mc_putpacket",946,957
43,5,311,1,56,"mc_dmaintr@963-1019@sys/arch/macppc/dev/if_mc.c","sys/arch/macppc/dev/if_mc.c","mc_dmaintr",963,1019
23,2,169,1,30,"mc_reset_rxdma@1022-1052@sys/arch/macppc/dev/if_mc.c","sys/arch/macppc/dev/if_mc.c","mc_reset_rxdma",1022,1052
18,1,145,1,24,"mc_reset_txdma@1055-1079@sys/arch/macppc/dev/if_mc.c","sys/arch/macppc/dev/if_mc.c","mc_reset_txdma",1055,1079
23,3,180,2,37,"mace_calcladrf@1086-1123@sys/arch/macppc/dev/if_mc.c","sys/arch/macppc/dev/if_mc.c","mace_calcladrf",1086,1123
10,4,64,3,10,"wi_obio_match@92-102@sys/arch/macppc/dev/if_wi_obio.c","sys/arch/macppc/dev/if_wi_obio.c","wi_obio_match",92,102
22,2,195,3,30,"wi_obio_attach@105-135@sys/arch/macppc/dev/if_wi_obio.c","sys/arch/macppc/dev/if_wi_obio.c","wi_obio_attach",105,135
12,1,70,2,18,"wi_obio_detach@138-156@sys/arch/macppc/dev/if_wi_obio.c","sys/arch/macppc/dev/if_wi_obio.c","wi_obio_detach",138,156
20,3,104,2,20,"wi_obio_activate@159-179@sys/arch/macppc/dev/if_wi_obio.c","sys/arch/macppc/dev/if_wi_obio.c","wi_obio_activate",159,179
31,1,206,1,40,"wi_obio_enable@184-224@sys/arch/macppc/dev/if_wi_obio.c","sys/arch/macppc/dev/if_wi_obio.c","wi_obio_enable",184,224
11,1,60,1,12,"wi_obio_disable@227-239@sys/arch/macppc/dev/if_wi_obio.c","sys/arch/macppc/dev/if_wi_obio.c","wi_obio_disable",227,239
8,3,53,3,9,"kiic_match@71-80@sys/arch/macppc/dev/kiic.c","sys/arch/macppc/dev/kiic.c","kiic_match",71,80
50,7,410,3,60,"kiic_attach@83-143@sys/arch/macppc/dev/kiic.c","sys/arch/macppc/dev/kiic.c","kiic_attach",83,143
5,1,32,2,5,"kiic_readreg@146-151@sys/arch/macppc/dev/kiic.c","sys/arch/macppc/dev/kiic.c","kiic_readreg",146,151
7,1,45,3,7,"kiic_writereg@154-161@sys/arch/macppc/dev/kiic.c","sys/arch/macppc/dev/kiic.c","kiic_writereg",154,161
13,2,70,3,13,"kiic_setmode@164-177@sys/arch/macppc/dev/kiic.c","sys/arch/macppc/dev/kiic.c","kiic_setmode",164,177
9,1,52,2,9,"kiic_setspeed@180-189@sys/arch/macppc/dev/kiic.c","sys/arch/macppc/dev/kiic.c","kiic_setspeed",180,189
52,14,307,1,64,"kiic_intr@192-256@sys/arch/macppc/dev/kiic.c","sys/arch/macppc/dev/kiic.c","kiic_intr",192,256
14,4,69,2,13,"kiic_poll@259-272@sys/arch/macppc/dev/kiic.c","sys/arch/macppc/dev/kiic.c","kiic_poll",259,272
24,5,178,5,32,"kiic_start@275-307@sys/arch/macppc/dev/kiic.c","sys/arch/macppc/dev/kiic.c","kiic_start",275,307
5,1,42,5,4,"kiic_read@310-314@sys/arch/macppc/dev/kiic.c","sys/arch/macppc/dev/kiic.c","kiic_read",310,314
5,1,47,5,4,"kiic_write@317-321@sys/arch/macppc/dev/kiic.c","sys/arch/macppc/dev/kiic.c","kiic_write",317,321
5,1,31,2,5,"kiic_i2c_acquire_bus@324-329@sys/arch/macppc/dev/kiic.c","sys/arch/macppc/dev/kiic.c","kiic_i2c_acquire_bus",324,329
5,1,29,2,5,"kiic_i2c_release_bus@332-337@sys/arch/macppc/dev/kiic.c","sys/arch/macppc/dev/kiic.c","kiic_i2c_release_bus",332,337
25,10,193,8,33,"kiic_i2c_exec@340-373@sys/arch/macppc/dev/kiic.c","sys/arch/macppc/dev/kiic.c","kiic_i2c_exec",340,373
9,3,54,3,11,"macgpio_match@74-85@sys/arch/macppc/dev/macgpio.c","sys/arch/macppc/dev/macgpio.c","macgpio_match",74,85
32,5,262,3,38,"macgpio_attach@88-126@sys/arch/macppc/dev/macgpio.c","sys/arch/macppc/dev/macgpio.c","macgpio_attach",88,126
9,3,58,2,10,"macgpio_print@129-139@sys/arch/macppc/dev/macgpio.c","sys/arch/macppc/dev/macgpio.c","macgpio_print",129,139
9,3,54,3,11,"macgpio_gpio_match@142-153@sys/arch/macppc/dev/macgpio.c","sys/arch/macppc/dev/macgpio.c","macgpio_gpio_match",142,153
9,1,90,3,11,"macgpio_gpio_attach@156-167@sys/arch/macppc/dev/macgpio.c","sys/arch/macppc/dev/macgpio.c","macgpio_gpio_attach",156,167
7,3,39,1,10,"gpio_intr@175-185@sys/arch/macppc/dev/macgpio.c","sys/arch/macppc/dev/macgpio.c","gpio_intr",175,185
32,13,254,3,35,"maciic_scan@30-65@sys/arch/macppc/dev/maci2c.c","sys/arch/macppc/dev/maci2c.c","maciic_scan",30,65
13,4,94,3,22,"macintr_match@100-122@sys/arch/macppc/dev/macintr.c","sys/arch/macppc/dev/macintr.c","macintr_match",100,122
13,2,62,1,15,"macintr_splraise@137-152@sys/arch/macppc/dev/macintr.c","sys/arch/macppc/dev/macintr.c","macintr_splraise",137,152
7,1,31,1,8,"macintr_spllower@155-163@sys/arch/macppc/dev/macintr.c","sys/arch/macppc/dev/macintr.c","macintr_spllower",155,163
13,3,72,1,13,"macintr_splx@166-179@sys/arch/macppc/dev/macintr.c","sys/arch/macppc/dev/macintr.c","macintr_splx",166,179
27,2,174,3,34,"macintr_attach@182-216@sys/arch/macppc/dev/macintr.c","sys/arch/macppc/dev/macintr.c","macintr_attach",182,216
20,3,105,0,21,"macintr_collect_preconf_intr@219-240@sys/arch/macppc/dev/macintr.c","sys/arch/macppc/dev/macintr.c","macintr_collect_preconf_intr",219,240
7,3,24,1,9,"macintr_prog_button@248-257@sys/arch/macppc/dev/macintr.c","sys/arch/macppc/dev/macintr.c","macintr_prog_button",248,257
9,2,52,1,10,"macintr_setipl@261-271@sys/arch/macppc/dev/macintr.c","sys/arch/macppc/dev/macintr.c","macintr_setipl",261,271
47,13,302,7,61,"macintr_establish@277-338@sys/arch/macppc/dev/macintr.c","sys/arch/macppc/dev/macintr.c","macintr_establish",277,338
22,3,141,2,31,"macintr_disestablish@344-375@sys/arch/macppc/dev/macintr.c","sys/arch/macppc/dev/macintr.c","macintr_disestablish",344,375
42,14,302,0,52,"macintr_calc_mask@384-436@sys/arch/macppc/dev/macintr.c","sys/arch/macppc/dev/macintr.c","macintr_calc_mask",384,436
29,5,161,0,34,"mac_ext_intr@442-476@sys/arch/macppc/dev/macintr.c","sys/arch/macppc/dev/macintr.c","mac_ext_intr",442,476
13,3,61,1,13,"macintr_eoi@479-492@sys/arch/macppc/dev/macintr.c","sys/arch/macppc/dev/macintr.c","macintr_eoi",479,492
24,5,123,0,26,"macintr_read_irq@495-521@sys/arch/macppc/dev/macintr.c","sys/arch/macppc/dev/macintr.c","macintr_read_irq",495,521
11,4,61,3,12,"mediabay_match@89-101@sys/arch/macppc/dev/mediabay.c","sys/arch/macppc/dev/mediabay.c","mediabay_match",89,101
26,4,205,3,32,"mediabay_attach@107-139@sys/arch/macppc/dev/mediabay.c","sys/arch/macppc/dev/mediabay.c","mediabay_attach",107,139
46,5,324,1,53,"mediabay_attach_content@142-195@sys/arch/macppc/dev/mediabay.c","sys/arch/macppc/dev/mediabay.c","mediabay_attach_content",142,195
9,3,51,2,10,"mediabay_print@198-208@sys/arch/macppc/dev/mediabay.c","sys/arch/macppc/dev/mediabay.c","mediabay_print",198,208
7,1,28,1,7,"mediabay_intr@211-218@sys/arch/macppc/dev/mediabay.c","sys/arch/macppc/dev/mediabay.c","mediabay_intr",211,218
7,1,35,1,7,"mediabay_create_kthread@221-228@sys/arch/macppc/dev/mediabay.c","sys/arch/macppc/dev/mediabay.c","mediabay_create_kthread",221,228
38,6,201,1,46,"mediabay_kthread@231-277@sys/arch/macppc/dev/mediabay.c","sys/arch/macppc/dev/mediabay.c","mediabay_kthread",231,277
12,3,89,3,14,"mesh_match@278-292@sys/arch/macppc/dev/mesh.c","sys/arch/macppc/dev/mesh.c","mesh_match",278,292
68,7,566,3,83,"mesh_attach@295-378@sys/arch/macppc/dev/mesh.c","sys/arch/macppc/dev/mesh.c","mesh_attach",295,378
16,2,81,2,17,"mesh_activate@381-398@sys/arch/macppc/dev/mesh.c","sys/arch/macppc/dev/mesh.c","mesh_activate",381,398
4,1,22,2,3,"mesh_read_reg@409-412@sys/arch/macppc/dev/mesh.c","sys/arch/macppc/dev/mesh.c","mesh_read_reg",409,412
4,1,26,3,3,"mesh_set_reg@415-418@sys/arch/macppc/dev/mesh.c","sys/arch/macppc/dev/mesh.c","mesh_set_reg",415,418
105,22,575,1,129,"mesh_intr@434-563@sys/arch/macppc/dev/mesh.c","sys/arch/macppc/dev/mesh.c","mesh_intr",434,563
23,7,143,4,29,"mesh_error@566-595@sys/arch/macppc/dev/mesh.c","sys/arch/macppc/dev/mesh.c","mesh_error",566,595
18,2,151,2,32,"mesh_select@598-630@sys/arch/macppc/dev/mesh.c","sys/arch/macppc/dev/mesh.c","mesh_select",598,630
15,2,102,2,16,"mesh_identify@633-649@sys/arch/macppc/dev/mesh.c","sys/arch/macppc/dev/mesh.c","mesh_identify",633,649
19,5,149,2,25,"mesh_command@652-677@sys/arch/macppc/dev/mesh.c","sys/arch/macppc/dev/mesh.c","mesh_command",652,677
22,6,189,2,26,"mesh_dma_setup@680-706@sys/arch/macppc/dev/mesh.c","sys/arch/macppc/dev/mesh.c","mesh_dma_setup",680,706
18,4,119,2,22,"mesh_dataio@709-731@sys/arch/macppc/dev/mesh.c","sys/arch/macppc/dev/mesh.c","mesh_dataio",709,731
18,3,130,2,20,"mesh_status@734-754@sys/arch/macppc/dev/mesh.c","sys/arch/macppc/dev/mesh.c","mesh_status",734,754
93,18,586,2,111,"mesh_msgin@757-868@sys/arch/macppc/dev/mesh.c","sys/arch/macppc/dev/mesh.c","mesh_msgin",757,868
40,7,306,2,48,"mesh_msgout@871-919@sys/arch/macppc/dev/mesh.c","sys/arch/macppc/dev/mesh.c","mesh_msgout",871,919
9,1,51,1,13,"mesh_bus_reset@922-935@sys/arch/macppc/dev/mesh.c","sys/arch/macppc/dev/mesh.c","mesh_bus_reset",922,935
24,4,190,1,45,"mesh_reset@938-983@sys/arch/macppc/dev/mesh.c","sys/arch/macppc/dev/mesh.c","mesh_reset",938,983
7,2,43,2,11,"mesh_stp@986-997@sys/arch/macppc/dev/mesh.c","sys/arch/macppc/dev/mesh.c","mesh_stp",986,997
20,6,130,2,22,"mesh_setsync@1000-1022@sys/arch/macppc/dev/mesh.c","sys/arch/macppc/dev/mesh.c","mesh_setsync",1000,1022
11,2,65,1,12,"mesh_scb_alloc@1025-1037@sys/arch/macppc/dev/mesh.c","sys/arch/macppc/dev/mesh.c","mesh_scb_alloc",1025,1037
8,1,54,2,8,"mesh_scb_free@1040-1048@sys/arch/macppc/dev/mesh.c","sys/arch/macppc/dev/mesh.c","mesh_scb_free",1040,1048
36,6,229,1,42,"mesh_scsi_cmd@1051-1093@sys/arch/macppc/dev/mesh.c","sys/arch/macppc/dev/mesh.c","mesh_scsi_cmd",1051,1093
12,2,64,1,12,"mesh_sched@1096-1108@sys/arch/macppc/dev/mesh.c","sys/arch/macppc/dev/mesh.c","mesh_sched",1096,1108
15,4,76,1,17,"mesh_poll@1111-1128@sys/arch/macppc/dev/mesh.c","sys/arch/macppc/dev/mesh.c","mesh_poll",1111,1128
20,4,130,2,28,"mesh_done@1131-1159@sys/arch/macppc/dev/mesh.c","sys/arch/macppc/dev/mesh.c","mesh_done",1131,1159
23,2,161,1,28,"mesh_timeout@1162-1190@sys/arch/macppc/dev/mesh.c","sys/arch/macppc/dev/mesh.c","mesh_timeout",1162,1190
6,2,37,2,6,"mesh_minphys@1193-1199@sys/arch/macppc/dev/mesh.c","sys/arch/macppc/dev/mesh.c","mesh_minphys",1193,1199
18,8,143,3,29,"onyx_match@109-138@sys/arch/macppc/dev/onyx.c","sys/arch/macppc/dev/onyx.c","onyx_match",109,138
7,1,52,3,8,"onyx_attach@141-149@sys/arch/macppc/dev/onyx.c","sys/arch/macppc/dev/onyx.c","onyx_attach",141,149
16,4,125,1,20,"onyx_defer@152-172@sys/arch/macppc/dev/onyx.c","sys/arch/macppc/dev/onyx.c","onyx_defer",152,172
13,1,95,3,14,"onyx_set_volume@175-189@sys/arch/macppc/dev/onyx.c","sys/arch/macppc/dev/onyx.c","onyx_set_volume",175,189
9,2,42,1,9,"openpic_read@149-158@sys/arch/macppc/dev/openpic.c","sys/arch/macppc/dev/openpic.c","openpic_read",149,158
9,2,47,2,9,"openpic_write@161-170@sys/arch/macppc/dev/openpic.c","sys/arch/macppc/dev/openpic.c","openpic_write",161,170
4,1,18,1,3,"openpic_read_irq@173-176@sys/arch/macppc/dev/openpic.c","sys/arch/macppc/dev/openpic.c","openpic_read_irq",173,176
4,1,17,1,3,"openpic_eoi@179-182@sys/arch/macppc/dev/openpic.c","sys/arch/macppc/dev/openpic.c","openpic_eoi",179,182
19,6,141,3,24,"openpic_match@185-209@sys/arch/macppc/dev/openpic.c","sys/arch/macppc/dev/openpic.c","openpic_match",185,209
77,15,540,3,124,"openpic_attach@212-336@sys/arch/macppc/dev/openpic.c","sys/arch/macppc/dev/openpic.c","openpic_attach",212,336
6,1,31,1,6,"openpic_setipl@340-346@sys/arch/macppc/dev/openpic.c","sys/arch/macppc/dev/openpic.c","openpic_setipl",340,346
13,2,62,1,15,"openpic_splraise@349-364@sys/arch/macppc/dev/openpic.c","sys/arch/macppc/dev/openpic.c","openpic_splraise",349,364
7,1,31,1,8,"openpic_spllower@367-375@sys/arch/macppc/dev/openpic.c","sys/arch/macppc/dev/openpic.c","openpic_spllower",367,375
13,3,72,1,13,"openpic_splx@378-391@sys/arch/macppc/dev/openpic.c","sys/arch/macppc/dev/openpic.c","openpic_splx",378,391
14,2,105,0,13,"openpic_collect_preconf_intr@394-407@sys/arch/macppc/dev/openpic.c","sys/arch/macppc/dev/openpic.c","openpic_collect_preconf_intr",394,407
45,13,288,7,60,"openpic_intr_establish@413-473@sys/arch/macppc/dev/openpic.c","sys/arch/macppc/dev/openpic.c","openpic_intr_establish",413,473
19,3,123,2,27,"openpic_intr_disestablish@479-506@sys/arch/macppc/dev/openpic.c","sys/arch/macppc/dev/openpic.c","openpic_intr_disestablish",479,506
33,7,207,0,42,"openpic_calc_mask@516-558@sys/arch/macppc/dev/openpic.c","sys/arch/macppc/dev/openpic.c","openpic_calc_mask",516,558
4,1,15,2,3,"openpic_gen_acknowledge_irq@561-564@sys/arch/macppc/dev/openpic.c","sys/arch/macppc/dev/openpic.c","openpic_gen_acknowledge_irq",561,564
12,2,56,3,13,"openpic_gen_enable_irq@567-580@sys/arch/macppc/dev/openpic.c","sys/arch/macppc/dev/openpic.c","openpic_gen_enable_irq",567,580
7,1,37,2,7,"openpic_gen_disable_irq@583-590@sys/arch/macppc/dev/openpic.c","sys/arch/macppc/dev/openpic.c","openpic_gen_disable_irq",583,590
4,1,20,2,3,"openpic_set_priority@593-596@sys/arch/macppc/dev/openpic.c","sys/arch/macppc/dev/openpic.c","openpic_set_priority",593,596
63,16,388,1,77,"openpic_ext_intr@602-679@sys/arch/macppc/dev/openpic.c","sys/arch/macppc/dev/openpic.c","openpic_ext_intr",602,679
19,7,94,3,27,"openpic_ext_intr_handler@682-709@sys/arch/macppc/dev/openpic.c","sys/arch/macppc/dev/openpic.c","openpic_ext_intr_handler",682,709
4,1,21,2,3,"openpic_acknowledge_irq@712-715@sys/arch/macppc/dev/openpic.c","sys/arch/macppc/dev/openpic.c","openpic_acknowledge_irq",712,715
4,1,26,3,3,"openpic_enable_irq@718-721@sys/arch/macppc/dev/openpic.c","sys/arch/macppc/dev/openpic.c","openpic_enable_irq",718,721
4,1,21,2,3,"openpic_disable_irq@724-727@sys/arch/macppc/dev/openpic.c","sys/arch/macppc/dev/openpic.c","openpic_disable_irq",724,727
14,3,70,2,14,"openpic_send_ipi@731-745@sys/arch/macppc/dev/openpic.c","sys/arch/macppc/dev/openpic.c","openpic_send_ipi",731,745
4,2,10,1,5,"openpic_ipi_ddb@748-753@sys/arch/macppc/dev/openpic.c","sys/arch/macppc/dev/openpic.c","openpic_ipi_ddb",748,753
5,1,22,2,4,"openpic_cpc945_acknowledge_irq@762-766@sys/arch/macppc/dev/openpic.c","sys/arch/macppc/dev/openpic.c","openpic_cpc945_acknowledge_irq",762,766
12,2,69,3,13,"openpic_cpc945_enable_irq@769-782@sys/arch/macppc/dev/openpic.c","sys/arch/macppc/dev/openpic.c","openpic_cpc945_enable_irq",769,782
5,1,24,2,4,"openpic_cpc945_disable_irq@785-789@sys/arch/macppc/dev/openpic.c","sys/arch/macppc/dev/openpic.c","openpic_cpc945_disable_irq",785,789
11,3,79,3,13,"pgs_match@53-66@sys/arch/macppc/dev/pgs.c","sys/arch/macppc/dev/pgs.c","pgs_match",53,66
12,1,108,3,15,"pgs_attach@69-84@sys/arch/macppc/dev/pgs.c","sys/arch/macppc/dev/pgs.c","pgs_attach",69,84
7,3,24,1,10,"pgs_intr@87-97@sys/arch/macppc/dev/pgs.c","sys/arch/macppc/dev/pgs.c","pgs_intr",87,97
7,2,47,3,8,"piic_match@56-64@sys/arch/macppc/dev/piic.c","sys/arch/macppc/dev/piic.c","piic_match",56,64
18,1,144,3,21,"piic_attach@67-88@sys/arch/macppc/dev/piic.c","sys/arch/macppc/dev/piic.c","piic_attach",67,88
5,1,31,2,5,"piic_i2c_acquire_bus@91-96@sys/arch/macppc/dev/piic.c","sys/arch/macppc/dev/piic.c","piic_i2c_acquire_bus",91,96
5,1,26,2,5,"piic_i2c_release_bus@99-104@sys/arch/macppc/dev/piic.c","sys/arch/macppc/dev/piic.c","piic_i2c_release_bus",99,104
40,11,324,8,49,"piic_i2c_exec@107-156@sys/arch/macppc/dev/piic.c","sys/arch/macppc/dev/piic.c","piic_i2c_exec",107,156
12,2,68,4,12,"pm_printerr@195-207@sys/arch/macppc/dev/pm_direct.c","sys/arch/macppc/dev/pm_direct.c","pm_printerr",195,207
9,4,36,1,10,"pm_wait_busy@214-224@sys/arch/macppc/dev/pm_direct.c","sys/arch/macppc/dev/pm_direct.c","pm_wait_busy",214,224
9,4,36,1,10,"pm_wait_free@231-241@sys/arch/macppc/dev/pm_direct.c","sys/arch/macppc/dev/pm_direct.c","pm_wait_free",231,241
25,3,123,1,33,"pm_receive@251-284@sys/arch/macppc/dev/pm_direct.c","sys/arch/macppc/dev/pm_direct.c","pm_receive",251,284
21,3,112,1,25,"pm_send@290-315@sys/arch/macppc/dev/pm_direct.c","sys/arch/macppc/dev/pm_direct.c","pm_send",290,315
70,16,410,1,92,"pmgrop@323-415@sys/arch/macppc/dev/pm_direct.c","sys/arch/macppc/dev/pm_direct.c","pmgrop",323,415
44,15,196,0,52,"pm_intr@422-474@sys/arch/macppc/dev/pm_direct.c","sys/arch/macppc/dev/pm_direct.c","pm_intr",422,474
100,22,636,4,140,"pm_adb_op@480-620@sys/arch/macppc/dev/pm_direct.c","sys/arch/macppc/dev/pm_direct.c","pm_adb_op",480,620
21,2,149,1,24,"pm_adb_get_TALK_result@624-648@sys/arch/macppc/dev/pm_direct.c","sys/arch/macppc/dev/pm_direct.c","pm_adb_get_TALK_result",624,648
12,2,98,1,13,"pm_adb_get_ADB_data@652-665@sys/arch/macppc/dev/pm_direct.c","sys/arch/macppc/dev/pm_direct.c","pm_adb_get_ADB_data",652,665
9,1,42,0,9,"pm_adb_restart@668-677@sys/arch/macppc/dev/pm_direct.c","sys/arch/macppc/dev/pm_direct.c","pm_adb_restart",668,677
11,1,65,0,11,"pm_adb_poweroff@680-691@sys/arch/macppc/dev/pm_direct.c","sys/arch/macppc/dev/pm_direct.c","pm_adb_poweroff",680,691
12,1,71,1,13,"pm_read_date_time@694-707@sys/arch/macppc/dev/pm_direct.c","sys/arch/macppc/dev/pm_direct.c","pm_read_date_time",694,707
10,1,63,1,10,"pm_set_date_time@710-720@sys/arch/macppc/dev/pm_direct.c","sys/arch/macppc/dev/pm_direct.c","pm_set_date_time",710,720
11,3,63,1,12,"pm_eject_pcmcia@724-736@sys/arch/macppc/dev/pm_direct.c","sys/arch/macppc/dev/pm_direct.c","pm_eject_pcmcia",724,736
32,4,276,2,36,"pm_battery_info@746-782@sys/arch/macppc/dev/pm_direct.c","sys/arch/macppc/dev/pm_direct.c","pm_battery_info",746,782
21,2,138,1,22,"pmu_fileserver_mode@785-807@sys/arch/macppc/dev/pm_direct.c","sys/arch/macppc/dev/pm_direct.c","pmu_fileserver_mode",785,807
7,2,47,3,7,"smu_match@180-187@sys/arch/macppc/dev/smu.c","sys/arch/macppc/dev/smu.c","smu_match",180,187
228,44,2098,3,308,"smu_attach@193-501@sys/arch/macppc/dev/smu.c","sys/arch/macppc/dev/smu.c","smu_attach",193,501
5,1,16,1,4,"smu_intr@504-508@sys/arch/macppc/dev/smu.c","sys/arch/macppc/dev/smu.c","smu_intr",504,508
20,4,180,2,29,"smu_do_cmd@511-540@sys/arch/macppc/dev/smu.c","sys/arch/macppc/dev/smu.c","smu_do_cmd",511,540
26,2,211,1,31,"smu_time_read@543-574@sys/arch/macppc/dev/smu.c","sys/arch/macppc/dev/smu.c","smu_time_read",543,574
22,1,199,1,26,"smu_time_write@577-603@sys/arch/macppc/dev/smu.c","sys/arch/macppc/dev/smu.c","smu_time_write",577,603
31,3,252,4,34,"smu_get_datablock@607-641@sys/arch/macppc/dev/smu.c","sys/arch/macppc/dev/smu.c","smu_get_datablock",607,641
12,2,82,2,17,"smu_firmware_probe@644-661@sys/arch/macppc/dev/smu.c","sys/arch/macppc/dev/smu.c","smu_firmware_probe",644,661
20,2,199,3,26,"smu_fan_set_rpm@664-690@sys/arch/macppc/dev/smu.c","sys/arch/macppc/dev/smu.c","smu_fan_set_rpm",664,690
20,2,199,3,20,"smu_fan_set_pwm@693-713@sys/arch/macppc/dev/smu.c","sys/arch/macppc/dev/smu.c","smu_fan_set_pwm",693,713
25,4,196,3,26,"smu_fan_read_rpm@716-742@sys/arch/macppc/dev/smu.c","sys/arch/macppc/dev/smu.c","smu_fan_read_rpm",716,742
35,5,281,4,45,"smu_fan_read_pwm@745-790@sys/arch/macppc/dev/smu.c","sys/arch/macppc/dev/smu.c","smu_fan_read_pwm",745,790
23,4,141,2,24,"smu_fan_refresh@793-817@sys/arch/macppc/dev/smu.c","sys/arch/macppc/dev/smu.c","smu_fan_refresh",793,817
55,7,287,3,67,"smu_sensor_refresh@820-887@sys/arch/macppc/dev/smu.c","sys/arch/macppc/dev/smu.c","smu_sensor_refresh",820,887
11,3,92,1,11,"smu_refresh_sensors@890-901@sys/arch/macppc/dev/smu.c","sys/arch/macppc/dev/smu.c","smu_refresh_sensors",890,901
8,1,57,2,9,"smu_fan_set_rpm_thermal@907-916@sys/arch/macppc/dev/smu.c","sys/arch/macppc/dev/smu.c","smu_fan_set_rpm_thermal",907,916
8,1,57,2,9,"smu_fan_set_pwm_thermal@919-928@sys/arch/macppc/dev/smu.c","sys/arch/macppc/dev/smu.c","smu_fan_set_pwm_thermal",919,928
9,1,56,1,10,"smu_sensor_refresh_thermal@931-941@sys/arch/macppc/dev/smu.c","sys/arch/macppc/dev/smu.c","smu_sensor_refresh_thermal",931,941
7,2,42,2,8,"smu_i2c_acquire_bus@944-952@sys/arch/macppc/dev/smu.c","sys/arch/macppc/dev/smu.c","smu_i2c_acquire_bus",944,952
7,2,34,2,8,"smu_i2c_release_bus@955-963@sys/arch/macppc/dev/smu.c","sys/arch/macppc/dev/smu.c","smu_i2c_release_bus",955,963
46,13,372,8,55,"smu_i2c_exec@966-1021@sys/arch/macppc/dev/smu.c","sys/arch/macppc/dev/smu.c","smu_i2c_exec",966,1021
14,1,106,1,17,"smu_slew_voltage@1024-1041@sys/arch/macppc/dev/smu.c","sys/arch/macppc/dev/smu.c","smu_slew_voltage",1024,1041
19,6,150,3,24,"snapper_match@429-453@sys/arch/macppc/dev/snapper.c","sys/arch/macppc/dev/snapper.c","snapper_match",429,453
10,1,70,3,11,"snapper_attach@456-467@sys/arch/macppc/dev/snapper.c","sys/arch/macppc/dev/snapper.c","snapper_attach",456,467
15,4,116,1,20,"snapper_defer@470-490@sys/arch/macppc/dev/snapper.c","sys/arch/macppc/dev/snapper.c","snapper_defer",470,490
24,3,200,3,28,"snapper_set_volume@493-521@sys/arch/macppc/dev/snapper.c","sys/arch/macppc/dev/snapper.c","snapper_set_volume",493,521
10,5,75,2,10,"snapper_set_treble@524-534@sys/arch/macppc/dev/snapper.c","sys/arch/macppc/dev/snapper.c","snapper_set_treble",524,534
10,5,75,2,10,"snapper_set_bass@537-547@sys/arch/macppc/dev/snapper.c","sys/arch/macppc/dev/snapper.c","snapper_set_bass",537,547
13,3,61,2,13,"snapper_set_input@550-563@sys/arch/macppc/dev/snapper.c","sys/arch/macppc/dev/snapper.c","snapper_set_input",550,563
10,2,70,3,12,"tas3004_write@639-651@sys/arch/macppc/dev/snapper.c","sys/arch/macppc/dev/snapper.c","tas3004_write",639,651
36,1,346,1,37,"tas3004_init@657-694@sys/arch/macppc/dev/snapper.c","sys/arch/macppc/dev/snapper.c","tas3004_init",657,694
12,3,81,1,25,"snapper_init@697-722@sys/arch/macppc/dev/snapper.c","sys/arch/macppc/dev/snapper.c","snapper_init",697,722
7,2,43,3,8,"sysbutton_match@49-57@sys/arch/macppc/dev/sysbutton.c","sys/arch/macppc/dev/sysbutton.c","sysbutton_match",49,57
12,1,108,3,15,"sysbutton_attach@60-75@sys/arch/macppc/dev/sysbutton.c","sys/arch/macppc/dev/sysbutton.c","sysbutton_attach",60,75
6,3,19,1,13,"sysbutton_intr@78-91@sys/arch/macppc/dev/sysbutton.c","sys/arch/macppc/dev/sysbutton.c","sysbutton_intr",78,91
7,2,24,1,7,"thermal_thread_init@70-77@sys/arch/macppc/dev/thermal.c","sys/arch/macppc/dev/thermal.c","thermal_thread_init",70,77
8,2,33,1,7,"thermal_thread_create@80-87@sys/arch/macppc/dev/thermal.c","sys/arch/macppc/dev/thermal.c","thermal_thread_create",80,87
8,2,35,1,7,"thermal_thread_loop@90-97@sys/arch/macppc/dev/thermal.c","sys/arch/macppc/dev/thermal.c","thermal_thread_loop",90,97
79,11,465,1,93,"thermal_manage_fans@100-193@sys/arch/macppc/dev/thermal.c","sys/arch/macppc/dev/thermal.c","thermal_manage_fans",100,193
9,1,51,1,11,"thermal_fan_register@196-207@sys/arch/macppc/dev/thermal.c","sys/arch/macppc/dev/thermal.c","thermal_fan_register",196,207
11,1,63,1,13,"thermal_sensor_register@210-223@sys/arch/macppc/dev/thermal.c","sys/arch/macppc/dev/thermal.c","thermal_sensor_register",210,223
16,5,125,3,20,"tumbler_match@250-270@sys/arch/macppc/dev/tumbler.c","sys/arch/macppc/dev/tumbler.c","tumbler_match",250,270
9,1,64,3,10,"tumbler_attach@273-283@sys/arch/macppc/dev/tumbler.c","sys/arch/macppc/dev/tumbler.c","tumbler_attach",273,283
15,4,116,1,19,"tumbler_defer@286-305@sys/arch/macppc/dev/tumbler.c","sys/arch/macppc/dev/tumbler.c","tumbler_defer",286,305
15,1,106,3,18,"tumbler_set_volume@308-326@sys/arch/macppc/dev/tumbler.c","sys/arch/macppc/dev/tumbler.c","tumbler_set_volume",308,326
10,5,75,2,10,"tumbler_set_treble@329-339@sys/arch/macppc/dev/tumbler.c","sys/arch/macppc/dev/tumbler.c","tumbler_set_treble",329,339
10,5,75,2,10,"tumbler_set_bass@342-352@sys/arch/macppc/dev/tumbler.c","sys/arch/macppc/dev/tumbler.c","tumbler_set_bass",342,352
10,2,70,3,12,"tas3001_write@407-419@sys/arch/macppc/dev/tumbler.c","sys/arch/macppc/dev/tumbler.c","tas3001_write",407,419
27,1,247,1,29,"tas3001_init@425-454@sys/arch/macppc/dev/tumbler.c","sys/arch/macppc/dev/tumbler.c","tas3001_init",425,454
8,3,49,1,19,"tumbler_init@457-476@sys/arch/macppc/dev/tumbler.c","sys/arch/macppc/dev/tumbler.c","tumbler_init",457,476
7,2,47,3,8,"memcmatch@86-94@sys/arch/macppc/dev/uni_n.c","sys/arch/macppc/dev/uni_n.c","memcmatch",86,94
22,5,207,3,29,"memcattach@97-126@sys/arch/macppc/dev/uni_n.c","sys/arch/macppc/dev/uni_n.c","memcattach",97,126
34,6,258,2,38,"memc_attach_children@129-167@sys/arch/macppc/dev/uni_n.c","sys/arch/macppc/dev/uni_n.c","memc_attach_children",129,167
9,3,58,2,9,"memc_print@170-179@sys/arch/macppc/dev/uni_n.c","sys/arch/macppc/dev/uni_n.c","memc_print",170,179
8,1,46,1,8,"memc_sleep@182-190@sys/arch/macppc/dev/uni_n.c","sys/arch/macppc/dev/uni_n.c","memc_sleep",182,190
8,1,46,1,8,"memc_resume@193-201@sys/arch/macppc/dev/uni_n.c","sys/arch/macppc/dev/uni_n.c","memc_resume",193,201
4,1,22,2,3,"memc_read@204-207@sys/arch/macppc/dev/uni_n.c","sys/arch/macppc/dev/uni_n.c","memc_read",204,207
4,1,26,3,3,"memc_write@210-213@sys/arch/macppc/dev/uni_n.c","sys/arch/macppc/dev/uni_n.c","memc_write",210,213
5,1,33,3,4,"memc_enable@216-220@sys/arch/macppc/dev/uni_n.c","sys/arch/macppc/dev/uni_n.c","memc_enable",216,220
5,1,35,3,4,"memc_disable@223-227@sys/arch/macppc/dev/uni_n.c","sys/arch/macppc/dev/uni_n.c","memc_disable",223,227
5,1,35,3,5,"via_reg_and@72-77@sys/arch/macppc/dev/viareg.h","sys/arch/macppc/dev/viareg.h","via_reg_and",72,77
5,1,35,3,5,"via_reg_or@80-85@sys/arch/macppc/dev/viareg.h","sys/arch/macppc/dev/viareg.h","via_reg_or",80,85
5,1,35,3,5,"via_reg_xor@88-93@sys/arch/macppc/dev/viareg.h","sys/arch/macppc/dev/viareg.h","via_reg_xor",88,93
5,1,26,2,5,"read_via_reg@96-101@sys/arch/macppc/dev/viareg.h","sys/arch/macppc/dev/viareg.h","read_via_reg",96,101
5,1,30,3,5,"write_via_reg@104-109@sys/arch/macppc/dev/viareg.h","sys/arch/macppc/dev/viareg.h","write_via_reg",104,109
17,7,133,3,21,"wdc_obio_probe@106-127@sys/arch/macppc/dev/wdc_obio.c","sys/arch/macppc/dev/wdc_obio.c","wdc_obio_probe",106,127
87,13,655,3,100,"wdc_obio_attach@130-230@sys/arch/macppc/dev/wdc_obio.c","sys/arch/macppc/dev/wdc_obio.c","wdc_obio_attach",130,230
17,3,134,2,21,"wdc_obio_detach@233-254@sys/arch/macppc/dev/wdc_obio.c","sys/arch/macppc/dev/wdc_obio.c","wdc_obio_detach",233,254
55,17,383,1,62,"wdc_obio_adjust_timing@326-388@sys/arch/macppc/dev/wdc_obio.c","sys/arch/macppc/dev/wdc_obio.c","wdc_obio_adjust_timing",326,388
67,21,478,1,78,"wdc_obio_ata4_adjust_timing@391-469@sys/arch/macppc/dev/wdc_obio.c","sys/arch/macppc/dev/wdc_obio.c","wdc_obio_ata4_adjust_timing",391,469
56,20,389,1,61,"wdc_obio_ata6_adjust_timing@472-533@sys/arch/macppc/dev/wdc_obio.c","sys/arch/macppc/dev/wdc_obio.c","wdc_obio_ata6_adjust_timing",472,533
24,6,198,6,29,"wdc_obio_dma_init@536-565@sys/arch/macppc/dev/wdc_obio.c","sys/arch/macppc/dev/wdc_obio.c","wdc_obio_dma_init",536,565
5,1,32,3,5,"wdc_obio_dma_start@568-573@sys/arch/macppc/dev/wdc_obio.c","sys/arch/macppc/dev/wdc_obio.c","wdc_obio_dma_start",568,573
7,1,45,4,7,"wdc_obio_dma_finish@576-583@sys/arch/macppc/dev/wdc_obio.c","sys/arch/macppc/dev/wdc_obio.c","wdc_obio_dma_finish",576,583
12,4,81,2,14,"wdc_obio_read_reg@591-605@sys/arch/macppc/dev/wdc_obio.c","sys/arch/macppc/dev/wdc_obio.c","wdc_obio_read_reg",591,605
12,4,82,3,14,"wdc_obio_write_reg@609-623@sys/arch/macppc/dev/wdc_obio.c","sys/arch/macppc/dev/wdc_obio.c","wdc_obio_write_reg",609,623
24,9,184,3,30,"xlights_match@72-102@sys/arch/macppc/dev/xlights.c","sys/arch/macppc/dev/xlights.c","xlights_match",72,102
85,13,697,3,102,"xlights_attach@105-207@sys/arch/macppc/dev/xlights.c","sys/arch/macppc/dev/xlights.c","xlights_attach",105,207
5,1,35,1,5,"xlights_deferred@210-215@sys/arch/macppc/dev/xlights.c","sys/arch/macppc/dev/xlights.c","xlights_deferred",210,215
40,8,243,1,47,"xlights_theosDOT@230-277@sys/arch/macppc/dev/xlights.c","sys/arch/macppc/dev/xlights.c","xlights_theosDOT",230,277
14,1,103,1,17,"xlights_startdma@280-297@sys/arch/macppc/dev/xlights.c","sys/arch/macppc/dev/xlights.c","xlights_startdma",280,297
8,1,48,1,8,"xlights_timeout@300-308@sys/arch/macppc/dev/xlights.c","sys/arch/macppc/dev/xlights.c","xlights_timeout",300,308
15,2,82,1,15,"xlights_intr@311-326@sys/arch/macppc/dev/xlights.c","sys/arch/macppc/dev/xlights.c","xlights_intr",311,326
12,4,72,3,15,"zs_match@169-184@sys/arch/macppc/dev/zs.c","sys/arch/macppc/dev/zs.c","zs_match",169,184
116,17,975,3,179,"zs_attach@193-372@sys/arch/macppc/dev/zs.c","sys/arch/macppc/dev/zs.c","zs_attach",193,372
9,3,54,2,11,"zs_print@375-386@sys/arch/macppc/dev/zs.c","sys/arch/macppc/dev/zs.c","zs_print",375,386
8,1,34,3,7,"zsmdioctl@389-396@sys/arch/macppc/dev/zs.c","sys/arch/macppc/dev/zs.c","zsmdioctl",389,396
7,4,45,1,14,"zsmd_setclock@399-413@sys/arch/macppc/dev/zs.c","sys/arch/macppc/dev/zs.c","zsmd_setclock",399,413
20,5,100,1,22,"zshard@422-444@sys/arch/macppc/dev/zs.c","sys/arch/macppc/dev/zs.c","zshard",422,444
15,4,72,1,22,"zssoft@450-472@sys/arch/macppc/dev/zs.c","sys/arch/macppc/dev/zs.c","zssoft",450,472
21,4,103,1,23,"zs_txdma_int@476-499@sys/arch/macppc/dev/zs.c","sys/arch/macppc/dev/zs.c","zs_txdma_int",476,499
18,1,122,3,21,"zs_dma_setup@502-523@sys/arch/macppc/dev/zs.c","sys/arch/macppc/dev/zs.c","zs_dma_setup",502,523
8,1,45,1,8,"zs_get_speed@531-539@sys/arch/macppc/dev/zs.c","sys/arch/macppc/dev/zs.c","zs_get_speed",531,539
100,25,732,2,138,"zs_set_speed@559-697@sys/arch/macppc/dev/zs.c","sys/arch/macppc/dev/zs.c","zs_set_speed",559,697
38,11,232,2,77,"zs_set_modes@700-777@sys/arch/macppc/dev/zs.c","sys/arch/macppc/dev/zs.c","zs_set_modes",700,777
11,1,48,2,11,"zs_read_reg@789-800@sys/arch/macppc/dev/zs.c","sys/arch/macppc/dev/zs.c","zs_read_reg",789,800
9,1,46,3,8,"zs_write_reg@803-811@sys/arch/macppc/dev/zs.c","sys/arch/macppc/dev/zs.c","zs_write_reg",803,811
9,1,34,1,10,"zs_read_csr@814-824@sys/arch/macppc/dev/zs.c","sys/arch/macppc/dev/zs.c","zs_read_csr",814,824
7,1,29,2,7,"zs_write_csr@827-834@sys/arch/macppc/dev/zs.c","sys/arch/macppc/dev/zs.c","zs_write_csr",827,834
8,1,30,1,8,"zs_read_data@837-845@sys/arch/macppc/dev/zs.c","sys/arch/macppc/dev/zs.c","zs_read_data",837,845
7,1,29,2,6,"zs_write_data@848-854@sys/arch/macppc/dev/zs.c","sys/arch/macppc/dev/zs.c","zs_write_data",848,854
7,1,27,1,6,"zs_enable@864-870@sys/arch/macppc/dev/zs.c","sys/arch/macppc/dev/zs.c","zs_enable",864,870
6,1,22,1,5,"zs_disable@873-878@sys/arch/macppc/dev/zs.c","sys/arch/macppc/dev/zs.c","zs_disable",873,878
14,2,79,1,17,"zs_getc@919-936@sys/arch/macppc/dev/zs.c","sys/arch/macppc/dev/zs.c","zs_getc",919,936
17,4,104,2,19,"zs_putc@942-961@sys/arch/macppc/dev/zs.c","sys/arch/macppc/dev/zs.c","zs_putc",942,961
14,2,60,1,14,"zscngetc@968-982@sys/arch/macppc/dev/zs.c","sys/arch/macppc/dev/zs.c","zscngetc",968,982
12,2,54,2,12,"zscnputc@988-1000@sys/arch/macppc/dev/zs.c","sys/arch/macppc/dev/zs.c","zscnputc",988,1000
31,11,239,1,40,"zscnprobe@1003-1043@sys/arch/macppc/dev/zs.c","sys/arch/macppc/dev/zs.c","zscnprobe",1003,1043
26,6,195,1,32,"zscninit@1047-1079@sys/arch/macppc/dev/zs.c","sys/arch/macppc/dev/zs.c","zscninit",1047,1079
14,4,55,1,20,"zs_abort@1082-1102@sys/arch/macppc/dev/zs.c","sys/arch/macppc/dev/zs.c","zs_abort",1082,1102
9,3,25,2,17,"zscnpollc@1106-1123@sys/arch/macppc/dev/zs.c","sys/arch/macppc/dev/zs.c","zscnpollc",1106,1123
8,2,52,5,8,"bus_space_read_region_1@194-202@sys/arch/macppc/include/bus.h","sys/arch/macppc/include/bus.h","bus_space_read_region_1",194,202
9,2,64,5,9,"bus_space_read_region_2@205-214@sys/arch/macppc/include/bus.h","sys/arch/macppc/include/bus.h","bus_space_read_region_2",205,214
9,2,64,5,9,"bus_space_read_region_4@217-226@sys/arch/macppc/include/bus.h","sys/arch/macppc/include/bus.h","bus_space_read_region_4",217,226
8,2,54,5,8,"bus_space_write_region_1@243-251@sys/arch/macppc/include/bus.h","sys/arch/macppc/include/bus.h","bus_space_write_region_1",243,251
9,2,65,5,9,"bus_space_write_region_2@254-263@sys/arch/macppc/include/bus.h","sys/arch/macppc/include/bus.h","bus_space_write_region_2",254,263
9,2,65,5,9,"bus_space_write_region_4@266-275@sys/arch/macppc/include/bus.h","sys/arch/macppc/include/bus.h","bus_space_write_region_4",266,275
10,2,70,5,11,"bus_space_read_raw_region_2@291-302@sys/arch/macppc/include/bus.h","sys/arch/macppc/include/bus.h","bus_space_read_raw_region_2",291,302
10,2,70,5,11,"bus_space_read_raw_region_4@305-316@sys/arch/macppc/include/bus.h","sys/arch/macppc/include/bus.h","bus_space_read_raw_region_4",305,316
10,2,72,5,11,"bus_space_write_raw_region_2@334-345@sys/arch/macppc/include/bus.h","sys/arch/macppc/include/bus.h","bus_space_write_raw_region_2",334,345
10,2,72,5,11,"bus_space_write_raw_region_4@348-359@sys/arch/macppc/include/bus.h","sys/arch/macppc/include/bus.h","bus_space_write_raw_region_4",348,359
8,2,49,5,8,"bus_space_set_multi_1@382-390@sys/arch/macppc/include/bus.h","sys/arch/macppc/include/bus.h","bus_space_set_multi_1",382,390
9,2,60,5,9,"bus_space_set_multi_2@393-402@sys/arch/macppc/include/bus.h","sys/arch/macppc/include/bus.h","bus_space_set_multi_2",393,402
9,2,60,5,9,"bus_space_set_multi_4@405-414@sys/arch/macppc/include/bus.h","sys/arch/macppc/include/bus.h","bus_space_set_multi_4",405,414
9,2,43,0,10,"cpu_configure@96-106@sys/arch/macppc/macppc/autoconf.c","sys/arch/macppc/macppc/autoconf.c","cpu_configure",96,106
40,4,285,1,41,"findtype@121-162@sys/arch/macppc/macppc/autoconf.c","sys/arch/macppc/macppc/autoconf.c","findtype",121,162
34,11,192,1,36,"parseofwbp@172-208@sys/arch/macppc/macppc/autoconf.c","sys/arch/macppc/macppc/autoconf.c","parseofwbp",172,208
17,6,94,1,17,"getpno@211-228@sys/arch/macppc/macppc/autoconf.c","sys/arch/macppc/macppc/autoconf.c","getpno",211,228
29,13,162,2,36,"device_register@231-267@sys/arch/macppc/macppc/autoconf.c","sys/arch/macppc/macppc/autoconf.c","device_register",231,267
8,3,39,1,11,"diskconf@270-281@sys/arch/macppc/macppc/autoconf.c","sys/arch/macppc/macppc/autoconf.c","diskconf",270,281
52,14,305,1,70,"inittodr@85-155@sys/arch/macppc/macppc/clock.c","sys/arch/macppc/macppc/clock.c","inittodr",85,155
14,4,66,1,16,"resettodr@161-177@sys/arch/macppc/macppc/clock.c","sys/arch/macppc/macppc/clock.c","resettodr",161,177
44,9,247,1,80,"decr_intr@180-260@sys/arch/macppc/macppc/clock.c","sys/arch/macppc/macppc/clock.c","decr_intr",180,260
46,9,255,0,60,"cpu_initclocks@265-325@sys/arch/macppc/macppc/clock.c","sys/arch/macppc/macppc/clock.c","cpu_initclocks",265,325
10,1,60,0,17,"cpu_startclock@328-345@sys/arch/macppc/macppc/clock.c","sys/arch/macppc/macppc/clock.c","cpu_startclock",328,345
8,2,39,1,8,"delay@351-359@sys/arch/macppc/macppc/clock.c","sys/arch/macppc/macppc/clock.c","delay",351,359
13,2,64,1,21,"setstatclockrate@365-386@sys/arch/macppc/macppc/clock.c","sys/arch/macppc/macppc/clock.c","setstatclockrate",365,386
4,1,14,1,3,"tb_get_timecount@389-392@sys/arch/macppc/macppc/clock.c","sys/arch/macppc/macppc/clock.c","tb_get_timecount",389,392
4,2,22,1,3,"iskmemdev@244-247@sys/arch/macppc/macppc/conf.c","sys/arch/macppc/macppc/conf.c","iskmemdev",244,247
4,2,22,1,3,"iszerodev@253-256@sys/arch/macppc/macppc/conf.c","sys/arch/macppc/macppc/conf.c","iszerodev",253,256
4,1,13,0,3,"getnulldev@259-262@sys/arch/macppc/macppc/conf.c","sys/arch/macppc/macppc/conf.c","getnulldev",259,262
10,3,71,3,13,"cpumatch@93-106@sys/arch/macppc/macppc/cpu.c","sys/arch/macppc/macppc/cpu.c","cpumatch",93,106
5,1,18,1,5,"ppc_cpuspeed@112