97,46,770,2,144,"main@51-195@usr.bin/apply/apply.c","usr.bin/apply/apply.c","main",51,195
36,8,250,1,37,"mysystem@203-240@usr.bin/apply/apply.c","usr.bin/apply/apply.c","mysystem",203,240
6,1,21,1,5,"usage@243-248@usr.bin/apply/apply.c","usr.bin/apply/apply.c","usage",243,248
34,8,159,2,35,"main@38-73@usr.bin/arch/arch.c","usr.bin/arch/arch.c","main",38,73
8,2,30,1,7,"usage@76-83@usr.bin/arch/arch.c","usr.bin/arch/arch.c","usage",76,83
10,2,47,2,12,"fatal@101-113@usr.bin/at/at.c","usr.bin/at/at.c","fatal",101,113
10,2,47,2,12,"fatalx@119-131@usr.bin/at/at.c","usr.bin/at/at.c","fatalx",119,131
6,2,24,1,7,"sigc@135-142@usr.bin/at/at.c","usr.bin/at/at.c","sigc",135,142
12,6,91,3,12,"strtot@145-157@usr.bin/at/at.c","usr.bin/at/at.c","strtot",145,157
13,3,87,2,18,"newjob@160-178@usr.bin/at/at.c","usr.bin/at/at.c","newjob",160,178
121,44,907,3,187,"writefile@185-372@usr.bin/at/at.c","usr.bin/at/at.c","writefile",185,372
6,1,55,2,6,"byctime@376-382@usr.bin/at/at.c","usr.bin/at/at.c","byctime",376,382
8,2,74,2,8,"byjobno@386-394@usr.bin/at/at.c","usr.bin/at/at.c","byjobno",386,394
26,5,212,3,27,"print_job@397-424@usr.bin/at/at.c","usr.bin/at/at.c","print_job",397,424
126,50,910,4,157,"list_jobs@434-591@usr.bin/at/at.c","usr.bin/at/at.c","list_jobs",434,591
9,4,54,1,9,"rmok@594-603@usr.bin/at/at.c","usr.bin/at/at.c","rmok",594,603
116,48,804,3,134,"process_jobs@611-745@usr.bin/at/at.c","usr.bin/at/at.c","process_jobs",611,745
68,23,407,1,75,"ttime@753-828@usr.bin/at/at.c","usr.bin/at/at.c","ttime",753,828
25,6,82,1,25,"usage@831-856@usr.bin/at/at.c","usr.bin/at/at.c","usage",831,856
171,56,874,2,214,"main@859-1073@usr.bin/at/at.c","usr.bin/at/at.c","main",859,1073
11,3,81,1,13,"parse_token@156-169@usr.bin/at/parsetime.c","usr.bin/at/parsetime.c","parse_token",156,169
14,3,74,2,14,"init_scanner@176-190@usr.bin/at/parsetime.c","usr.bin/at/parsetime.c","init_scanner",176,190
44,14,289,1,63,"token@196-259@usr.bin/at/parsetime.c","usr.bin/at/parsetime.c","token",196,259
4,2,22,1,3,"plonk@266-269@usr.bin/at/parsetime.c","usr.bin/at/parsetime.c","plonk",266,269
8,2,33,1,7,"expect@276-283@usr.bin/at/parsetime.c","usr.bin/at/parsetime.c","expect",276,283
24,6,119,2,31,"dateadd@292-323@usr.bin/at/parsetime.c","usr.bin/at/parsetime.c","dateadd",292,323
39,12,183,1,44,"plus@333-377@usr.bin/at/parsetime.c","usr.bin/at/parsetime.c","plus",333,377
48,18,259,1,65,"tod@385-450@usr.bin/at/parsetime.c","usr.bin/at/parsetime.c","tod",385,450
21,11,144,4,30,"assign_date@457-487@usr.bin/at/parsetime.c","usr.bin/at/parsetime.c","assign_date",457,487
85,42,499,1,111,"month@500-611@usr.bin/at/parsetime.c","usr.bin/at/parsetime.c","month",500,611
63,21,333,2,93,"parsetime@615-708@usr.bin/at/parsetime.c","usr.bin/at/parsetime.c","parsetime",615,708
8,1,40,1,7,"abuf_log@32-39@usr.bin/aucat/abuf.c","usr.bin/aucat/abuf.c","abuf_log",32,39
7,1,40,2,6,"abuf_init@43-49@usr.bin/aucat/abuf.c","usr.bin/aucat/abuf.c","abuf_init",43,49
12,4,61,1,13,"abuf_done@52-65@usr.bin/aucat/abuf.c","usr.bin/aucat/abuf.c","abuf_done",52,65
9,2,54,2,9,"abuf_rgetblk@71-80@usr.bin/aucat/abuf.c","usr.bin/aucat/abuf.c","abuf_rgetblk",71,80
13,5,75,2,14,"abuf_rdiscard@86-100@usr.bin/aucat/abuf.c","usr.bin/aucat/abuf.c","abuf_rdiscard",86,100
10,4,57,2,11,"abuf_wcommit@106-117@usr.bin/aucat/abuf.c","usr.bin/aucat/abuf.c","abuf_wcommit",106,117
13,3,84,2,13,"abuf_wgetblk@123-136@usr.bin/aucat/abuf.c","usr.bin/aucat/abuf.c","abuf_wgetblk",123,136
4,1,26,1,3,"le16_get@158-161@usr.bin/aucat/afile.c","usr.bin/aucat/afile.c","le16_get",158,161
5,1,33,2,4,"le16_set@164-168@usr.bin/aucat/afile.c","usr.bin/aucat/afile.c","le16_set",164,168
7,1,46,1,6,"le32_get@171-177@usr.bin/aucat/afile.c","usr.bin/aucat/afile.c","le32_get",171,177
7,1,57,2,6,"le32_set@180-186@usr.bin/aucat/afile.c","usr.bin/aucat/afile.c","le32_set",180,186
4,1,26,1,3,"be16_get@189-192@usr.bin/aucat/afile.c","usr.bin/aucat/afile.c","be16_get",189,192
5,1,33,2,4,"be16_set@195-199@usr.bin/aucat/afile.c","usr.bin/aucat/afile.c","be16_set",195,199
7,1,46,1,6,"be32_get@202-208@usr.bin/aucat/afile.c","usr.bin/aucat/afile.c","be32_get",202,208
7,1,57,2,6,"be32_set@211-217@usr.bin/aucat/afile.c","usr.bin/aucat/afile.c","be32_set",211,217
14,3,83,3,13,"afile_readhdr@220-233@usr.bin/aucat/afile.c","usr.bin/aucat/afile.c","afile_readhdr",220,233
15,3,91,3,14,"afile_writehdr@236-250@usr.bin/aucat/afile.c","usr.bin/aucat/afile.c","afile_writehdr",236,250
35,10,213,1,34,"afile_checkpar@253-287@usr.bin/aucat/afile.c","usr.bin/aucat/afile.c","afile_checkpar",253,287
65,12,411,2,65,"afile_wav_readfmt@290-355@usr.bin/aucat/afile.c","usr.bin/aucat/afile.c","afile_wav_readfmt",290,355
55,14,369,1,61,"afile_wav_readhdr@358-419@usr.bin/aucat/afile.c","usr.bin/aucat/afile.c","afile_wav_readhdr",358,419
19,1,250,1,19,"afile_wav_writehdr@425-444@usr.bin/aucat/afile.c","usr.bin/aucat/afile.c","afile_wav_writehdr",425,444
58,11,444,4,58,"afile_aiff_readcomm@447-505@usr.bin/aucat/afile.c","usr.bin/aucat/afile.c","afile_aiff_readcomm",447,505
19,3,116,3,19,"afile_aiff_readdata@508-527@usr.bin/aucat/afile.c","usr.bin/aucat/afile.c","afile_aiff_readdata",508,527
67,16,470,1,79,"afile_aiff_readhdr@530-609@usr.bin/aucat/afile.c","usr.bin/aucat/afile.c","afile_aiff_readhdr",530,609
30,2,316,1,36,"afile_aiff_writehdr@615-651@usr.bin/aucat/afile.c","usr.bin/aucat/afile.c","afile_aiff_writehdr",615,651
64,11,382,1,64,"afile_au_readhdr@654-718@usr.bin/aucat/afile.c","usr.bin/aucat/afile.c","afile_au_readhdr",654,718
32,6,186,1,34,"afile_au_writehdr@724-758@usr.bin/aucat/afile.c","usr.bin/aucat/afile.c","afile_au_writehdr",724,758
25,7,128,3,27,"afile_read@761-788@usr.bin/aucat/afile.c","usr.bin/aucat/afile.c","afile_read",761,788
27,8,146,3,29,"afile_write@791-820@usr.bin/aucat/afile.c","usr.bin/aucat/afile.c","afile_write",791,820
18,6,107,2,21,"afile_seek@823-844@usr.bin/aucat/afile.c","usr.bin/aucat/afile.c","afile_seek",823,844
12,5,67,1,11,"afile_close@847-858@usr.bin/aucat/afile.c","usr.bin/aucat/afile.c","afile_close",847,858
121,32,863,7,123,"afile_open@861-984@usr.bin/aucat/afile.c","usr.bin/aucat/afile.c","afile_open",861,984
11,4,58,1,14,"slot_log@143-157@usr.bin/aucat/aucat.c","usr.bin/aucat/aucat.c","slot_log",143,157
18,4,97,1,18,"slot_flush@160-178@usr.bin/aucat/aucat.c","usr.bin/aucat/aucat.c","slot_flush",160,178
20,6,105,1,22,"slot_fill@181-203@usr.bin/aucat/aucat.c","usr.bin/aucat/aucat.c","slot_fill",181,203
59,12,365,10,59,"slot_new@206-265@usr.bin/aucat/aucat.c","usr.bin/aucat/aucat.c","slot_new",206,265
91,23,661,1,106,"slot_init@268-374@usr.bin/aucat/aucat.c","usr.bin/aucat/aucat.c","slot_init",268,374
26,8,145,2,37,"slot_start@377-414@usr.bin/aucat/aucat.c","usr.bin/aucat/aucat.c","slot_start",377,414
14,6,78,1,15,"slot_stop@417-432@usr.bin/aucat/aucat.c","usr.bin/aucat/aucat.c","slot_stop",417,432
21,7,124,1,23,"slot_del@435-458@usr.bin/aucat/aucat.c","usr.bin/aucat/aucat.c","slot_del",435,458
11,3,67,3,11,"slot_getcnt@461-472@usr.bin/aucat/aucat.c","usr.bin/aucat/aucat.c","slot_getcnt",461,472
23,4,205,5,25,"play_filt_resamp@475-500@usr.bin/aucat/aucat.c","usr.bin/aucat/aucat.c","play_filt_resamp",475,500
23,6,147,5,23,"play_filt_dec@503-526@usr.bin/aucat/aucat.c","usr.bin/aucat/aucat.c","play_filt_dec",503,526
32,6,198,2,32,"slot_mix_badd@534-566@usr.bin/aucat/aucat.c","usr.bin/aucat/aucat.c","slot_mix_badd",534,566
23,5,211,5,25,"rec_filt_resamp@569-594@usr.bin/aucat/aucat.c","usr.bin/aucat/aucat.c","rec_filt_resamp",569,594
8,3,68,5,8,"rec_filt_enc@597-605@usr.bin/aucat/aucat.c","usr.bin/aucat/aucat.c","rec_filt_enc",597,605
27,6,178,3,28,"slot_sub_bcopy@612-640@usr.bin/aucat/aucat.c","usr.bin/aucat/aucat.c","slot_sub_bcopy",612,640
93,26,569,4,95,"dev_open@643-738@usr.bin/aucat/aucat.c","usr.bin/aucat/aucat.c","dev_open",643,738
10,4,42,1,9,"dev_close@741-750@usr.bin/aucat/aucat.c","usr.bin/aucat/aucat.c","dev_close",741,750
15,4,83,1,17,"dev_master@753-770@usr.bin/aucat/aucat.c","usr.bin/aucat/aucat.c","dev_master",753,770
19,5,101,2,21,"dev_slotvol@773-794@usr.bin/aucat/aucat.c","usr.bin/aucat/aucat.c","dev_slotvol",773,794
16,7,90,1,18,"dev_mmcstart@800-818@usr.bin/aucat/aucat.c","usr.bin/aucat/aucat.c","dev_mmcstart",800,818
15,6,74,1,17,"dev_mmcstop@824-841@usr.bin/aucat/aucat.c","usr.bin/aucat/aucat.c","dev_mmcstop",824,841
31,4,181,6,31,"dev_mmcloc@847-878@usr.bin/aucat/aucat.c","usr.bin/aucat/aucat.c","dev_mmcloc",847,878
62,21,336,2,62,"dev_imsg@881-943@usr.bin/aucat/aucat.c","usr.bin/aucat/aucat.c","dev_imsg",881,943
39,13,234,2,41,"midi_in@949-990@usr.bin/aucat/aucat.c","usr.bin/aucat/aucat.c","midi_in",949,990
23,9,151,3,25,"slot_list_mix@993-1018@usr.bin/aucat/aucat.c","usr.bin/aucat/aucat.c","slot_list_mix",993,1018
13,4,82,3,13,"slot_list_copy@1021-1034@usr.bin/aucat/aucat.c","usr.bin/aucat/aucat.c","slot_list_copy",1021,1034
14,7,107,1,14,"slot_list_iodo@1037-1051@usr.bin/aucat/aucat.c","usr.bin/aucat/aucat.c","slot_list_iodo",1037,1051
37,9,230,1,37,"offline@1054-1091@usr.bin/aucat/aucat.c","usr.bin/aucat/aucat.c","offline",1054,1091
45,10,231,1,47,"playrec_cycle@1094-1141@usr.bin/aucat/aucat.c","usr.bin/aucat/aucat.c","playrec_cycle",1094,1141
6,2,20,1,5,"sigint@1144-1149@usr.bin/aucat/aucat.c","usr.bin/aucat/aucat.c","sigint",1144,1149
87,23,513,4,90,"playrec@1152-1242@usr.bin/aucat/aucat.c","usr.bin/aucat/aucat.c","playrec",1152,1242
14,3,67,2,13,"opt_onoff@1245-1258@usr.bin/aucat/aucat.c","usr.bin/aucat/aucat.c","opt_onoff",1245,1258
11,3,56,2,11,"opt_enc@1261-1272@usr.bin/aucat/aucat.c","usr.bin/aucat/aucat.c","opt_enc",1261,1272
26,6,130,2,25,"opt_hdr@1275-1300@usr.bin/aucat/aucat.c","usr.bin/aucat/aucat.c","opt_hdr",1275,1300
21,8,130,3,21,"opt_ch@1303-1324@usr.bin/aucat/aucat.c","usr.bin/aucat/aucat.c","opt_ch",1303,1324
15,2,80,4,15,"opt_num@1327-1342@usr.bin/aucat/aucat.c","usr.bin/aucat/aucat.c","opt_num",1327,1342
11,2,55,2,11,"opt_pos@1345-1356@usr.bin/aucat/aucat.c","usr.bin/aucat/aucat.c","opt_pos",1345,1356
117,37,563,2,118,"main@1359-1477@usr.bin/aucat/aucat.c","usr.bin/aucat/aucat.c","main",1359,1477
23,9,177,2,23,"aparams_enctostr@115-138@usr.bin/aucat/dsp.c","usr.bin/aucat/dsp.c","aparams_enctostr",115,138
59,25,398,2,84,"aparams_strtoenc@146-230@usr.bin/aucat/dsp.c","usr.bin/aucat/dsp.c","aparams_strtoenc",146,230
8,1,42,1,7,"aparams_init@237-244@usr.bin/aucat/dsp.c","usr.bin/aucat/dsp.c","aparams_init",237,244
6,1,27,1,6,"aparams_log@250-256@usr.bin/aucat/dsp.c","usr.bin/aucat/dsp.c","aparams_log",250,256
6,6,56,1,5,"aparams_native@262-267@usr.bin/aucat/dsp.c","usr.bin/aucat/dsp.c","aparams_native",262,267
12,2,105,3,12,"resamp_getcnt@274-286@usr.bin/aucat/dsp.c","usr.bin/aucat/dsp.c","resamp_getcnt",274,286
73,12,374,5,86,"resamp_do@298-384@usr.bin/aucat/dsp.c","usr.bin/aucat/dsp.c","resamp_do",298,384
10,2,41,2,10,"uint_gcd@387-397@usr.bin/aucat/dsp.c","usr.bin/aucat/dsp.c","uint_gcd",387,397
26,6,152,4,36,"resamp_init@403-439@usr.bin/aucat/dsp.c","usr.bin/aucat/dsp.c","resamp_init",403,439
38,5,215,4,53,"enc_do@445-498@usr.bin/aucat/dsp.c","usr.bin/aucat/dsp.c","enc_do",445,498
33,5,186,3,44,"enc_sil_do@504-548@usr.bin/aucat/dsp.c","usr.bin/aucat/dsp.c","enc_sil_do",504,548
31,6,189,3,32,"enc_init@554-586@usr.bin/aucat/dsp.c","usr.bin/aucat/dsp.c","enc_init",554,586
38,5,210,4,49,"dec_do@592-641@usr.bin/aucat/dsp.c","usr.bin/aucat/dsp.c","dec_do",592,641
14,3,106,1,24,"f32_to_adata@648-672@usr.bin/aucat/dsp.c","usr.bin/aucat/dsp.c","f32_to_adata",648,672
29,5,165,4,40,"dec_do_float@678-718@usr.bin/aucat/dsp.c","usr.bin/aucat/dsp.c","dec_do_float",678,718
18,5,120,5,20,"dec_do_ulaw@724-744@usr.bin/aucat/dsp.c","usr.bin/aucat/dsp.c","dec_do_ulaw",724,744
31,6,188,3,32,"dec_init@750-782@usr.bin/aucat/dsp.c","usr.bin/aucat/dsp.c","dec_init",750,782
34,7,209,5,40,"cmap_add@788-828@usr.bin/aucat/dsp.c","usr.bin/aucat/dsp.c","cmap_add",788,828
29,5,175,5,35,"cmap_copy@834-869@usr.bin/aucat/dsp.c","usr.bin/aucat/dsp.c","cmap_copy",834,869
42,11,242,9,46,"cmap_init@876-922@usr.bin/aucat/dsp.c","usr.bin/aucat/dsp.c","cmap_init",876,922
12,1,40,2,12,"fp24_mul@46-58@usr.bin/aucat/dsp.h","usr.bin/aucat/dsp.h","fp24_mul",46,58
11,1,46,3,11,"fp24_muldiv@61-72@usr.bin/aucat/dsp.h","usr.bin/aucat/dsp.h","fp24_muldiv",61,72
7,2,27,1,6,"log_flush@51-57@usr.bin/aucat/utils.c","usr.bin/aucat/utils.c","log_flush",51,57
10,4,48,1,10,"log_puts@63-73@usr.bin/aucat/utils.c","usr.bin/aucat/utils.c","log_puts",63,73
17,5,111,1,17,"log_putx@79-96@usr.bin/aucat/utils.c","usr.bin/aucat/utils.c","log_putx",79,96
14,4,90,1,14,"log_putu@102-116@usr.bin/aucat/utils.c","usr.bin/aucat/utils.c","log_putu",102,116
8,2,30,1,7,"log_puti@122-129@usr.bin/aucat/utils.c","usr.bin/aucat/utils.c","log_puti",122,129
6,1,27,1,5,"panic@135-140@usr.bin/aucat/utils.c","usr.bin/aucat/utils.c","panic",135,140
12,2,48,1,12,"xmalloc@146-158@usr.bin/aucat/utils.c","usr.bin/aucat/utils.c","xmalloc",146,158
8,3,30,1,9,"xfree@164-173@usr.bin/aucat/utils.c","usr.bin/aucat/utils.c","xfree",164,173
9,1,43,1,9,"xstrdup@179-188@usr.bin/aucat/utils.c","usr.bin/aucat/utils.c","xstrdup",179,188
49,26,357,2,61,"strtoenc@75-136@usr.bin/audioctl/audioctl.c","usr.bin/audioctl/audioctl.c","strtoenc",75,136
34,15,219,2,34,"print_val@139-173@usr.bin/audioctl/audioctl.c","usr.bin/audioctl/audioctl.c","print_val",139,173
14,5,97,3,14,"parse_val@176-190@usr.bin/audioctl/audioctl.c","usr.bin/audioctl/audioctl.c","parse_val",176,190
90,28,581,2,91,"main@193-284@usr.bin/audioctl/audioctl.c","usr.bin/audioctl/audioctl.c","main",193,284
39,11,278,2,40,"makedfa@80-120@usr.bin/awk/b.c","usr.bin/awk/b.c","makedfa",80,120
24,4,253,2,28,"mkdfa@122-150@usr.bin/awk/b.c","usr.bin/awk/b.c","mkdfa",122,150
29,8,298,2,30,"makeinit@152-182@usr.bin/awk/b.c","usr.bin/awk/b.c","makeinit",152,182
24,3,110,1,23,"penter@184-207@usr.bin/awk/b.c","usr.bin/awk/b.c","penter",184,207
22,3,85,1,21,"freetr@209-230@usr.bin/awk/b.c","usr.bin/awk/b.c","freetr",209,230
16,8,136,1,16,"hexstr@235-251@usr.bin/awk/b.c","usr.bin/awk/b.c","hexstr",235,251
30,11,177,1,32,"quoted@255-287@usr.bin/awk/b.c","usr.bin/awk/b.c","quoted",255,287
44,13,335,1,44,"cclenter@289-333@usr.bin/awk/b.c","usr.bin/awk/b.c","cclenter",289,333
4,1,16,1,3,"overflo@335-338@usr.bin/awk/b.c","usr.bin/awk/b.c","overflo",335,338
42,10,291,2,42,"cfoll@340-382@usr.bin/awk/b.c","usr.bin/awk/b.c","cfoll",340,382
45,19,306,1,46,"first@384-430@usr.bin/awk/b.c","usr.bin/awk/b.c","first",384,430
27,9,113,1,29,"follow@432-461@usr.bin/awk/b.c","usr.bin/awk/b.c","follow",432,461
8,3,45,2,8,"member@463-471@usr.bin/awk/b.c","usr.bin/awk/b.c","member",463,471
17,6,126,2,18,"match@473-491@usr.bin/awk/b.c","usr.bin/awk/b.c","match",473,491
55,15,404,2,57,"pmatch@493-550@usr.bin/awk/b.c","usr.bin/awk/b.c","pmatch",493,550
54,15,394,2,56,"nematch@552-608@usr.bin/awk/b.c","usr.bin/awk/b.c","nematch",552,608
14,3,84,1,16,"reparse@610-626@usr.bin/awk/b.c","usr.bin/awk/b.c","reparse",610,626
4,1,19,1,3,"regexp@628-631@usr.bin/awk/b.c","usr.bin/awk/b.c","regexp",628,631
49,12,343,1,49,"primary@633-682@usr.bin/awk/b.c","usr.bin/awk/b.c","primary",633,682
8,9,60,1,7,"concat@684-691@usr.bin/awk/b.c","usr.bin/awk/b.c","concat",684,691
8,2,47,1,7,"alt@693-700@usr.bin/awk/b.c","usr.bin/awk/b.c","alt",693,700
16,4,93,1,15,"unary@702-717@usr.bin/awk/b.c","usr.bin/awk/b.c","unary",702,717
4,2,15,1,3,"int( xisblank)@741-744@usr.bin/awk/b.c","usr.bin/awk/b.c","int( xisblank)",741,744
79,33,547,1,82,"relex@773-855@usr.bin/awk/b.c","usr.bin/awk/b.c","relex",773,855
82,40,764,3,89,"cgoto@857-946@usr.bin/awk/b.c","usr.bin/awk/b.c","cgoto",857,946
15,6,125,1,15,"freefa@949-964@usr.bin/awk/b.c","usr.bin/awk/b.c","freefa",949,964
6,1,21,1,5,"peek@105-110@usr.bin/awk/lex.c","usr.bin/awk/lex.c","peek",105,110
59,22,380,2,61,"gettok@112-173@usr.bin/awk/lex.c","usr.bin/awk/lex.c","gettok",112,173
178,68,1091,1,185,"yylex@181-366@usr.bin/awk/lex.c","usr.bin/awk/lex.c","yylex",181,366
74,38,540,1,77,"string@368-445@usr.bin/awk/lex.c","usr.bin/awk/lex.c","string",368,445
16,4,99,3,16,"binsearch@448-464@usr.bin/awk/lex.c","usr.bin/awk/lex.c","binsearch",448,464
41,13,255,1,42,"word@466-508@usr.bin/awk/lex.c","usr.bin/awk/lex.c","word",466,508
4,1,10,1,3,"startreg@510-513@usr.bin/awk/lex.c","usr.bin/awk/lex.c","startreg",510,513
34,11,230,1,34,"regexpr@515-549@usr.bin/awk/lex.c","usr.bin/awk/lex.c","regexpr",515,549
19,7,102,1,19,"input@559-578@usr.bin/awk/lex.c","usr.bin/awk/lex.c","input",559,578
10,4,58,1,9,"unput@580-589@usr.bin/awk/lex.c","usr.bin/awk/lex.c","unput",580,589
6,2,38,1,6,"unputstr@591-597@usr.bin/awk/lex.c","usr.bin/awk/lex.c","unputstr",591,597
13,5,132,1,12,"recinit@60-72@usr.bin/awk/lib.c","usr.bin/awk/lib.c","recinit",60,72
13,3,100,2,13,"makefields@74-87@usr.bin/awk/lib.c","usr.bin/awk/lib.c","makefields",74,87
19,5,90,1,19,"initgetrec@89-108@usr.bin/awk/lib.c","usr.bin/awk/lib.c","initgetrec",89,108
67,18,430,3,68,"getrec@112-180@usr.bin/awk/lib.c","usr.bin/awk/lib.c","getrec",112,180
7,3,28,1,6,"nextfile@182-188@usr.bin/awk/lib.c","usr.bin/awk/lib.c","nextfile",182,188
39,21,353,3,40,"readrec@190-230@usr.bin/awk/lib.c","usr.bin/awk/lib.c","readrec",190,230
13,2,89,1,13,"getargv@232-245@usr.bin/awk/lib.c","usr.bin/awk/lib.c","getargv",232,245
16,3,109,1,16,"setclvar@247-263@usr.bin/awk/lib.c","usr.bin/awk/lib.c","setclvar",247,263
95,36,687,1,102,"fldbld@266-368@usr.bin/awk/lib.c","usr.bin/awk/lib.c","fldbld",266,368
12,3,69,2,12,"cleanfld@370-382@usr.bin/awk/lib.c","usr.bin/awk/lib.c","cleanfld",370,382
8,2,41,1,7,"newfld@384-391@usr.bin/awk/lib.c","usr.bin/awk/lib.c","newfld",384,391
8,3,39,1,7,"fieldadr@393-400@usr.bin/awk/lib.c","usr.bin/awk/lib.c","fieldadr",393,400
16,4,104,1,16,"growfldtab@402-418@usr.bin/awk/lib.c","usr.bin/awk/lib.c","growfldtab",402,418
43,8,296,2,45,"refldbld@420-465@usr.bin/awk/lib.c","usr.bin/awk/lib.c","refldbld",420,465
32,10,304,1,34,"recbld@467-501@usr.bin/awk/lib.c","usr.bin/awk/lib.c","recbld",467,501
4,1,16,1,3,"yyerror@505-508@usr.bin/awk/lib.c","usr.bin/awk/lib.c","yyerror",505,508
20,5,129,2,20,"SYNTAX@510-530@usr.bin/awk/lib.c","usr.bin/awk/lib.c","SYNTAX",510,530
31,12,268,1,33,"fpecatch@532-565@usr.bin/awk/lib.c","usr.bin/awk/lib.c","fpecatch",532,565
12,4,70,1,12,"bracecheck@569-581@usr.bin/awk/lib.c","usr.bin/awk/lib.c","bracecheck",569,581
11,5,83,3,10,"bcheck2@583-593@usr.bin/awk/lib.c","usr.bin/awk/lib.c","bcheck2",583,593
14,2,73,2,14,"FATAL@595-609@usr.bin/awk/lib.c","usr.bin/awk/lib.c","FATAL",595,609
11,1,58,2,11,"WARNING@611-622@usr.bin/awk/lib.c","usr.bin/awk/lib.c","WARNING",611,622
19,11,147,0,19,"error@624-643@usr.bin/awk/lib.c","usr.bin/awk/lib.c","error",624,643
35,23,251,1,35,"eprint@645-680@usr.bin/awk/lib.c","usr.bin/awk/lib.c","eprint",645,680
11,7,61,1,10,"bclass@682-692@usr.bin/awk/lib.c","usr.bin/awk/lib.c","bclass",682,692
13,3,62,2,13,"errcheck@694-707@usr.bin/awk/lib.c","usr.bin/awk/lib.c","errcheck",694,707
10,8,85,1,10,"isclvar@709-719@usr.bin/awk/lib.c","usr.bin/awk/lib.c","isclvar",709,719
15,8,81,1,14,"is_number@726-740@usr.bin/awk/lib.c","usr.bin/awk/lib.c","is_number",726,740
132,42,820,2,138,"main@60-198@usr.bin/awk/main.c","usr.bin/awk/main.c","main",60,198
21,8,118,1,21,"pgetc@200-221@usr.bin/awk/main.c","usr.bin/awk/main.c","pgetc",200,221
7,2,22,1,6,"cursource@223-229@usr.bin/awk/main.c","usr.bin/awk/main.c","cursource",223,229
54,13,387,2,58,"main@114-172@usr.bin/awk/maketab.c","usr.bin/awk/maketab.c","main",114,172
10,2,65,1,10,"nodealloc@33-43@usr.bin/awk/parse.c","usr.bin/awk/parse.c","nodealloc",33,43
5,1,19,1,4,"exptostat@45-49@usr.bin/awk/parse.c","usr.bin/awk/parse.c","exptostat",45,49
8,1,42,2,8,"node1@51-59@usr.bin/awk/parse.c","usr.bin/awk/parse.c","node1",51,59
9,1,55,3,9,"node2@61-70@usr.bin/awk/parse.c","usr.bin/awk/parse.c","node2",61,70
10,1,68,4,10,"node3@72-82@usr.bin/awk/parse.c","usr.bin/awk/parse.c","node3",72,82
11,1,81,5,11,"node4@84-95@usr.bin/awk/parse.c","usr.bin/awk/parse.c","node4",84,95
7,1,35,2,7,"stat1@97-104@usr.bin/awk/parse.c","usr.bin/awk/parse.c","stat1",97,104
7,1,41,3,7,"stat2@106-113@usr.bin/awk/parse.c","usr.bin/awk/parse.c","stat2",106,113
7,1,47,4,7,"stat3@115-122@usr.bin/awk/parse.c","usr.bin/awk/parse.c","stat3",115,122
7,1,53,5,7,"stat4@124-131@usr.bin/awk/parse.c","usr.bin/awk/parse.c","stat4",124,131
7,1,35,2,7,"op1@133-140@usr.bin/awk/parse.c","usr.bin/awk/parse.c","op1",133,140
7,1,41,3,7,"op2@142-149@usr.bin/awk/parse.c","usr.bin/awk/parse.c","op2",142,149
7,1,47,4,7,"op3@151-158@usr.bin/awk/parse.c","usr.bin/awk/parse.c","op3",151,158
7,1,53,5,7,"op4@160-167@usr.bin/awk/parse.c","usr.bin/awk/parse.c","op4",160,167
9,1,51,2,9,"celltonode@169-178@usr.bin/awk/parse.c","usr.bin/awk/parse.c","celltonode",169,178
5,1,24,1,4,"rectonode@180-184@usr.bin/awk/parse.c","usr.bin/awk/parse.c","rectonode",180,184
15,4,92,1,15,"makearr@186-201@usr.bin/awk/parse.c","usr.bin/awk/parse.c","makearr",186,201
9,2,63,3,9,"pa2stat@207-216@usr.bin/awk/parse.c","usr.bin/awk/parse.c","pa2stat",207,216
14,5,76,2,14,"linkum@218-232@usr.bin/awk/parse.c","usr.bin/awk/parse.c","linkum",218,232
20,4,124,3,21,"defn@234-255@usr.bin/awk/parse.c","usr.bin/awk/parse.c","defn",234,255
10,3,75,1,10,"isarg@257-267@usr.bin/awk/parse.c","usr.bin/awk/parse.c","isarg",257,267
4,1,17,1,3,"ptoi@269-272@usr.bin/awk/parse.c","usr.bin/awk/parse.c","ptoi",269,272
4,1,17,1,3,"itonp@274-277@usr.bin/awk/parse.c","usr.bin/awk/parse.c","itonp",274,277
23,8,153,6,32,"adjbuf@99-131@usr.bin/awk/run.c","usr.bin/awk/run.c","adjbuf",99,131
6,1,21,1,5,"run@133-138@usr.bin/awk/run.c","usr.bin/awk/run.c","run",133,138
34,16,229,1,34,"execute@140-174@usr.bin/awk/run.c","usr.bin/awk/run.c","execute",140,174
32,14,195,2,32,"program@177-209@usr.bin/awk/run.c","usr.bin/awk/run.c","program",177,209
96,24,791,2,98,"call@224-322@usr.bin/awk/run.c","usr.bin/awk/run.c","call",224,322
12,2,79,1,13,"copycell@324-337@usr.bin/awk/run.c","usr.bin/awk/run.c","copycell",324,337
9,2,67,2,9,"arg@339-348@usr.bin/awk/run.c","usr.bin/awk/run.c","arg",339,348
42,12,254,2,42,"jump@350-392@usr.bin/awk/run.c","usr.bin/awk/run.c","jump",350,392
50,9,332,2,51,"awkgetline@394-445@usr.bin/awk/run.c","usr.bin/awk/run.c","awkgetline",394,445
6,2,31,2,5,"getnf@447-452@usr.bin/awk/run.c","usr.bin/awk/run.c","getnf",447,452
37,7,313,2,38,"array@454-492@usr.bin/awk/run.c","usr.bin/awk/run.c","array",454,492
36,7,264,2,36,"awkdelete@494-530@usr.bin/awk/run.c","usr.bin/awk/run.c","awkdelete",494,530
39,8,302,2,39,"intest@532-571@usr.bin/awk/run.c","usr.bin/awk/run.c","intest",532,571
38,9,266,2,38,"matchop@574-612@usr.bin/awk/run.c","usr.bin/awk/run.c","matchop",574,612
30,9,178,2,30,"boolop@615-645@usr.bin/awk/run.c","usr.bin/awk/run.c","boolop",615,645
33,17,255,2,33,"relop@647-680@usr.bin/awk/run.c","usr.bin/awk/run.c","relop",647,680
11,3,70,1,10,"tfree@682-692@usr.bin/awk/run.c","usr.bin/awk/run.c","tfree",682,692
16,4,105,1,16,"gettemp@694-710@usr.bin/awk/run.c","usr.bin/awk/run.c","gettemp",694,710
19,3,124,2,20,"indirect@712-732@usr.bin/awk/run.c","usr.bin/awk/run.c","indirect",712,732
46,9,311,2,46,"substr@734-780@usr.bin/awk/run.c","usr.bin/awk/run.c","substr",734,780
23,5,174,2,24,"sindex@782-806@usr.bin/awk/run.c","usr.bin/awk/run.c","sindex",782,806
134,45,1056,4,136,"format@810-946@usr.bin/awk/run.c","usr.bin/awk/run.c","format",810,946
18,3,127,2,18,"awksprintf@948-966@usr.bin/awk/run.c","usr.bin/awk/run.c","awksprintf",948,966
29,6,213,2,32,"awkprintf@968-1000@usr.bin/awk/run.c","usr.bin/awk/run.c","awkprintf",968,1000
50,13,257,2,50,"arith@1002-1052@usr.bin/awk/run.c","usr.bin/awk/run.c","arith",1002,1052
11,3,54,2,11,"ipow@1054-1065@usr.bin/awk/run.c","usr.bin/awk/run.c","ipow",1054,1065
18,5,116,2,18,"incrdecr@1067-1085@usr.bin/awk/run.c","usr.bin/awk/run.c","incrdecr",1067,1085
61,17,355,2,61,"assign@1087-1148@usr.bin/awk/run.c","usr.bin/awk/run.c","assign",1087,1148
26,2,178,2,26,"cat@1150-1176@usr.bin/awk/run.c","usr.bin/awk/run.c","cat",1150,1176
14,3,74,2,14,"pastat@1178-1192@usr.bin/awk/run.c","usr.bin/awk/run.c","pastat",1178,1192
21,5,128,2,21,"dopa2@1194-1215@usr.bin/awk/run.c","usr.bin/awk/run.c","dopa2",1194,1215
133,40,1052,2,136,"split@1217-1353@usr.bin/awk/run.c","usr.bin/awk/run.c","split",1217,1353
13,2,72,2,13,"condexpr@1355-1368@usr.bin/awk/run.c","usr.bin/awk/run.c","condexpr",1355,1368
13,3,81,2,13,"ifstat@1370-1383@usr.bin/awk/run.c","usr.bin/awk/run.c","ifstat",1370,1383
18,7,105,2,18,"whilestat@1385-1403@usr.bin/awk/run.c","usr.bin/awk/run.c","whilestat",1385,1403
16,7,97,2,16,"dostat@1405-1421@usr.bin/awk/run.c","usr.bin/awk/run.c","dostat",1405,1421
21,8,139,2,21,"forstat@1423-1444@usr.bin/awk/run.c","usr.bin/awk/run.c","forstat",1423,1444
30,8,199,2,30,"instat@1446-1476@usr.bin/awk/run.c","usr.bin/awk/run.c","instat",1446,1476
160,39,1015,2,160,"bltin@1478-1638@usr.bin/awk/run.c","usr.bin/awk/run.c","bltin",1478,1638
24,6,159,2,24,"printstat@1640-1664@usr.bin/awk/run.c","usr.bin/awk/run.c","printstat",1640,1664
6,1,22,2,5,"nullproc@1666-1671@usr.bin/awk/run.c","usr.bin/awk/run.c","nullproc",1666,1671
13,2,67,2,13,"redirect@1674-1687@usr.bin/awk/run.c","usr.bin/awk/run.c","redirect",1674,1687
16,2,117,1,15,"stdinit@1697-1712@usr.bin/awk/run.c","usr.bin/awk/run.c","stdinit",1697,1712
51,21,402,2,52,"openfile@1714-1766@usr.bin/awk/run.c","usr.bin/awk/run.c","openfile",1714,1766
8,3,46,1,8,"filename@1768-1776@usr.bin/awk/run.c","usr.bin/awk/run.c","filename",1768,1776
29,9,233,2,29,"closefile@1778-1807@usr.bin/awk/run.c","usr.bin/awk/run.c","closefile",1778,1807
16,7,124,1,16,"closeall@1809-1825@usr.bin/awk/run.c","usr.bin/awk/run.c","closeall",1809,1825
7,3,41,1,7,"flush_all@1827-1834@usr.bin/awk/run.c","usr.bin/awk/run.c","flush_all",1827,1834
58,16,463,2,58,"sub@1838-1896@usr.bin/awk/run.c","usr.bin/awk/run.c","sub",1838,1896
99,26,762,2,99,"gsub@1898-1997@usr.bin/awk/run.c","usr.bin/awk/run.c","gsub",1898,1997
23,6,153,2,24,"backsub@1999-2023@usr.bin/awk/run.c","usr.bin/awk/run.c","backsub",1999,2023
27,1,388,1,28,"syminit@71-99@usr.bin/awk/tran.c","usr.bin/awk/tran.c","syminit",71,99
18,3,154,2,18,"arginit@101-119@usr.bin/awk/tran.c","usr.bin/awk/tran.c","arginit",101,119
20,5,145,1,20,"envinit@121-141@usr.bin/awk/tran.c","usr.bin/awk/tran.c","envinit",121,141
13,3,84,1,13,"makesymtab@143-156@usr.bin/awk/tran.c","usr.bin/awk/tran.c","makesymtab",143,156
26,7,163,1,26,"freesymtab@158-184@usr.bin/awk/tran.c","usr.bin/awk/tran.c","freesymtab",158,184
21,5,149,2,21,"freeelem@186-207@usr.bin/awk/tran.c","usr.bin/awk/tran.c","freeelem",186,207
28,5,255,5,28,"setsymtab@209-237@usr.bin/awk/tran.c","usr.bin/awk/tran.c","setsymtab",209,237
7,2,45,2,7,"hash@239-246@usr.bin/awk/tran.c","usr.bin/awk/tran.c","hash",239,246
20,4,146,1,20,"rehash@248-268@usr.bin/awk/tran.c","usr.bin/awk/tran.c","rehash",248,268
10,3,75,2,10,"lookup@270-280@usr.bin/awk/tran.c","usr.bin/awk/tran.c","lookup",270,280
22,6,159,2,22,"setfval@282-304@usr.bin/awk/tran.c","usr.bin/awk/tran.c","setfval",282,304
9,3,73,2,8,"funnyvar@306-314@usr.bin/awk/tran.c","usr.bin/awk/tran.c","funnyvar",306,314
28,6,218,2,28,"setsval@316-344@usr.bin/awk/tran.c","usr.bin/awk/tran.c","setsval",316,344
17,9,142,1,16,"getfval@346-362@usr.bin/awk/tran.c","usr.bin/awk/tran.c","getfval",346,362
26,10,208,2,26,"get_str_val@364-390@usr.bin/awk/tran.c","usr.bin/awk/tran.c","get_str_val",364,390
4,1,16,1,3,"getsval@392-395@usr.bin/awk/tran.c","usr.bin/awk/tran.c","getsval",392,395
4,1,16,1,3,"getpssval@397-400@usr.bin/awk/tran.c","usr.bin/awk/tran.c","getpssval",397,400
8,2,36,1,8,"tostring@403-411@usr.bin/awk/tran.c","usr.bin/awk/tran.c","tostring",403,411
45,15,306,2,45,"qstring@413-458@usr.bin/awk/tran.c","usr.bin/awk/tran.c","qstring",413,458
10,3,55,3,16,"scnline@65-81@usr.bin/banner/banner.c","usr.bin/banner/banner.c","scnline",65,81
16,9,73,1,17,"dropit@87-104@usr.bin/banner/banner.c","usr.bin/banner/banner.c","dropit",87,104
33,14,260,3,34,"scan_out@107-141@usr.bin/banner/banner.c","usr.bin/banner/banner.c","scan_out",107,141
11,3,78,2,12,"main@147-159@usr.bin/banner/banner.c","usr.bin/banner/banner.c","main",147,159
36,10,212,2,47,"main@43-90@usr.bin/basename/basename.c","usr.bin/basename/basename.c","main",43,90
5,1,23,1,5,"usage@95-100@usr.bin/basename/basename.c","usr.bin/basename/basename.c","usage",95,100
7,3,39,1,7,"settty@28-35@usr.bin/bc/tty.c","usr.bin/bc/tty.c","settty",28,35
7,3,37,1,7,"gettty@38-45@usr.bin/bc/tty.c","usr.bin/bc/tty.c","gettty",38,45
15,2,73,1,15,"tstpcont@49-64@usr.bin/bc/tty.c","usr.bin/bc/tty.c","tstpcont",49,64
36,11,234,1,37,"lg_urldecode@57-94@usr.bin/bgplg/bgplg.c","usr.bin/bgplg/bgplg.c","lg_urldecode",57,94
22,7,133,2,31,"lg_getenv@97-128@usr.bin/bgplg/bgplg.c","usr.bin/bgplg/bgplg.c","lg_getenv",97,128
18,5,109,3,20,"lg_getarg@131-151@usr.bin/bgplg/bgplg.c","usr.bin/bgplg/bgplg.c","lg_getarg",131,151
31,9,221,2,40,"lg_arg2argv@154-194@usr.bin/bgplg/bgplg.c","usr.bin/bgplg/bgplg.c","lg_arg2argv",154,194
18,5,162,3,28,"lg_argextra@197-225@usr.bin/bgplg/bgplg.c","usr.bin/bgplg/bgplg.c","lg_argextra",197,225
13,3,86,1,15,"lg_incl@228-243@usr.bin/bgplg/bgplg.c","usr.bin/bgplg/bgplg.c","lg_incl",228,243
119,31,719,1,140,"main@246-386@usr.bin/bgplg/bgplg.c","usr.bin/bgplg/bgplg.c","main",246,386
14,4,76,1,20,"lg_checkarg@55-75@usr.bin/bgplg/bgplgsh.c","usr.bin/bgplg/bgplgsh.c","lg_checkarg",55,75
36,12,251,2,45,"lg_arg2argv@78-123@usr.bin/bgplg/bgplgsh.c","usr.bin/bgplg/bgplgsh.c","lg_arg2argv",78,123
20,6,184,4,31,"lg_argextra@126-157@usr.bin/bgplg/bgplgsh.c","usr.bin/bgplg/bgplgsh.c","lg_argextra",126,157
27,12,207,4,30,"lg_checkcmd@160-190@usr.bin/bgplg/bgplgsh.c","usr.bin/bgplg/bgplgsh.c","lg_checkcmd",160,190
15,4,88,2,16,"lg_completion@193-209@usr.bin/bgplg/bgplgsh.c","usr.bin/bgplg/bgplgsh.c","lg_completion",193,209
54,12,342,1,64,"main@212-276@usr.bin/bgplg/bgplgsh.c","usr.bin/bgplg/bgplgsh.c","main",212,276
8,2,58,2,7,"lg_show_version@39-46@usr.bin/bgplg/misc.c","usr.bin/bgplg/misc.c","lg_show_version",39,46
10,4,66,1,18,"lg_checkperm@49-67@usr.bin/bgplg/misc.c","usr.bin/bgplg/misc.c","lg_checkperm",49,67
16,5,110,2,17,"lg_help@70-87@usr.bin/bgplg/misc.c","usr.bin/bgplg/misc.c","lg_help",70,87
6,2,23,1,6,"lg_sig_alarm@90-96@usr.bin/bgplg/misc.c","usr.bin/bgplg/misc.c","lg_sig_alarm",90,96
49,6,278,2,59,"lg_exec@99-158@usr.bin/bgplg/misc.c","usr.bin/bgplg/misc.c","lg_exec",99,158
11,3,72,1,13,"lg_strip@161-174@usr.bin/bgplg/misc.c","usr.bin/bgplg/misc.c","lg_strip",161,174
38,14,256,2,44,"main@46-90@usr.bin/biff/biff.c","usr.bin/biff/biff.c","main",46,90
5,1,21,1,4,"usage@93-97@usr.bin/biff/biff.c","usr.bin/biff/biff.c","usage",93,97
81,25,417,2,87,"main@146-233@usr.bin/cal/cal.c","usr.bin/cal/cal.c","main",146,233
22,4,153,3,24,"week@244-268@usr.bin/cal/cal.c","usr.bin/cal/cal.c","week",244,268
24,5,216,3,26,"isoweek@271-297@usr.bin/cal/cal.c","usr.bin/cal/cal.c","isoweek",271,297
27,9,236,2,27,"monthly@300-327@usr.bin/cal/cal.c","usr.bin/cal/cal.c","monthly",300,327
31,6,302,1,32,"j_yearly@330-362@usr.bin/cal/cal.c","usr.bin/cal/cal.c","j_yearly",330,362
48,13,441,1,50,"yearly@365-415@usr.bin/cal/cal.c","usr.bin/cal/cal.c","yearly",365,415
14,6,120,3,14,"day_array@425-439@usr.bin/cal/cal.c","usr.bin/cal/cal.c","day_array",425,439
8,2,53,3,8,"day_in_year@446-454@usr.bin/cal/cal.c","usr.bin/cal/cal.c","day_in_year",446,454
11,3,96,3,11,"day_in_week@464-475@usr.bin/cal/cal.c","usr.bin/cal/cal.c","day_in_week",464,475
37,7,231,2,37,"ascii_day@478-515@usr.bin/cal/cal.c","usr.bin/cal/cal.c","ascii_day",478,515
11,5,59,1,11,"trim_trailing_spaces@518-529@usr.bin/cal/cal.c","usr.bin/cal/cal.c","trim_trailing_spaces",518,529
6,1,50,3,6,"center@532-538@usr.bin/cal/cal.c","usr.bin/cal/cal.c","center",532,538
5,1,21,1,5,"usage@541-546@usr.bin/cal/cal.c","usr.bin/cal/cal.c","usage",541,546
15,6,101,1,15,"parsemonth@549-564@usr.bin/cal/cal.c","usr.bin/cal/cal.c","parsemonth",549,564
156,50,845,2,194,"main@70-264@usr.bin/calendar/calendar.c","usr.bin/calendar/calendar.c","main",70,264
7,1,22,1,6,"usage@268-274@usr.bin/calendar/calendar.c","usr.bin/calendar/calendar.c","usage",268,274
3,1,7,1,2,"childsig@278-280@usr.bin/calendar/calendar.c","usr.bin/calendar/calendar.c","childsig",278,280
6,3,56,2,5,"fill_print_date@81-86@usr.bin/calendar/day.c","usr.bin/calendar/day.c","fill_print_date",81,86
58,17,579,1,62,"setnnames@89-151@usr.bin/calendar/day.c","usr.bin/calendar/day.c","setnnames",89,151
21,4,147,1,24,"settime@154-178@usr.bin/calendar/day.c","usr.bin/calendar/day.c","settime",154,178
36,7,261,1,48,"Mktime@184-232@usr.bin/calendar/day.c","usr.bin/calendar/day.c","Mktime",184,232
17,6,93,2,17,"adjust_calendar@235-252@usr.bin/calendar/day.c","usr.bin/calendar/day.c","adjust_calendar",235,252
219,82,1501,2,306,"isnow@265-571@usr.bin/calendar/day.c","usr.bin/calendar/day.c","isnow",265,571
15,7,138,1,15,"getmonth@575-590@usr.bin/calendar/day.c","usr.bin/calendar/day.c","getmonth",575,590
15,7,138,1,15,"getday@594-609@usr.bin/calendar/day.c","usr.bin/calendar/day.c","getday",594,609
22,13,180,1,36,"getdayvar@617-653@usr.bin/calendar/day.c","usr.bin/calendar/day.c","getdayvar",617,653
5,1,38,1,5,"foy@657-662@usr.bin/calendar/day.c","usr.bin/calendar/day.c","foy",657,662
26,5,217,3,41,"variable_weekday@667-708@usr.bin/calendar/day.c","usr.bin/calendar/day.c","variable_weekday",667,708
139,51,1020,1,145,"cal@67-212@usr.bin/calendar/io.c","usr.bin/calendar/io.c","cal",67,212
76,34,575,3,95,"getfield@215-310@usr.bin/calendar/io.c","usr.bin/calendar/io.c","getfield",215,310
54,16,393,1,66,"opencal@314-380@usr.bin/calendar/io.c","usr.bin/calendar/io.c","opencal",314,380
44,12,358,1,48,"closecal@383-431@usr.bin/calendar/io.c","usr.bin/calendar/io.c","closecal",383,431
26,6,129,2,27,"insert@435-462@usr.bin/calendar/io.c","usr.bin/calendar/io.c","insert",435,462
29,4,273,1,37,"easter@39-76@usr.bin/calendar/ostern.c","usr.bin/calendar/ostern.c","easter",39,76
16,2,116,1,16,"paskha@37-53@usr.bin/calendar/paskha.c","usr.bin/calendar/paskha.c","paskha",37,53
27,12,211,1,34,"pesach@31-65@usr.bin/calendar/pesach.c","usr.bin/calendar/pesach.c","pesach",31,65
37,12,236,2,47,"main@76-123@usr.bin/cap_mkdb/cap_mkdb.c","usr.bin/cap_mkdb/cap_mkdb.c","main",76,123
5,2,20,1,4,"dounlink@126-130@usr.bin/cap_mkdb/cap_mkdb.c","usr.bin/cap_mkdb/cap_mkdb.c","dounlink",126,130
99,25,718,1,140,"db_build@145-285@usr.bin/cap_mkdb/cap_mkdb.c","usr.bin/cap_mkdb/cap_mkdb.c","db_build",145,285
6,1,21,1,5,"usage@288-293@usr.bin/cap_mkdb/cap_mkdb.c","usr.bin/cap_mkdb/cap_mkdb.c","usage",288,293
9,2,37,1,9,"cddb_sum@52-61@usr.bin/cdio/cddb.c","usr.bin/cdio/cddb.c","cddb_sum",52,61
10,2,83,2,10,"cddb_discid@64-74@usr.bin/cdio/cddb.c","usr.bin/cdio/cddb.c","cddb_discid",64,74
9,2,61,1,9,"send_hello@77-86@usr.bin/cdio/cddb.c","usr.bin/cdio/cddb.c","send_hello",77,86
8,2,85,3,8,"send_query@89-97@usr.bin/cdio/cddb.c","usr.bin/cdio/cddb.c","send_query",89,97
13,3,81,2,13,"safe_copy@103-116@usr.bin/cdio/cddb.c","usr.bin/cdio/cddb.c","safe_copy",103,116
20,3,129,2,20,"further_query@119-139@usr.bin/cdio/cddb.c","usr.bin/cdio/cddb.c","further_query",119,139
30,6,189,2,32,"connect_to@143-175@usr.bin/cdio/cddb.c","usr.bin/cdio/cddb.c","connect_to",143,175
19,6,133,2,20,"parse_connect_to@178-198@usr.bin/cdio/cddb.c","usr.bin/cdio/cddb.c","parse_connect_to",178,198
17,7,99,1,17,"get_line@201-218@usr.bin/cdio/cddb.c","usr.bin/cdio/cddb.c","get_line",201,218
9,3,36,1,9,"get_answer@221-230@usr.bin/cdio/cddb.c","usr.bin/cdio/cddb.c","get_answer",221,230
8,4,61,3,8,"verify_track_names@233-241@usr.bin/cdio/cddb.c","usr.bin/cdio/cddb.c","verify_track_names",233,241
137,40,784,4,142,"cddb@244-386@usr.bin/cdio/cddb.c","usr.bin/cdio/cddb.c","cddb",244,386
7,2,38,1,7,"free_names@389-396@usr.bin/cdio/cddb.c","usr.bin/cdio/cddb.c","free_names",389,396
23,6,134,1,23,"help@197-220@usr.bin/cdio/cdio.c","usr.bin/cdio/cdio.c","help",197,220
6,1,20,1,5,"usage@223-228@usr.bin/cdio/cdio.c","usr.bin/cdio/cdio.c","usage",223,228
72,24,396,2,86,"main@231-317@usr.bin/cdio/cdio.c","usr.bin/cdio/cdio.c","main",231,317
171,68,1086,2,233,"run@320-553@usr.bin/cdio/cdio.c","usr.bin/cdio/cdio.c","run",320,553
12,4,76,1,13,"is_wave@559-572@usr.bin/cdio/cdio.c","usr.bin/cdio/cdio.c","is_wave",559,572
101,24,594,2,108,"tao@575-683@usr.bin/cdio/cdio.c","usr.bin/cdio/cdio.c","tao",575,683
213,67,2033,1,341,"play@686-1027@usr.bin/cdio/cdio.c","usr.bin/cdio/cdio.c","play",686,1027
18,4,122,1,21,"play_prev@1031-1052@usr.bin/cdio/cdio.c","usr.bin/cdio/cdio.c","play_prev",1031,1052
14,3,93,1,16,"play_same@1056-1072@usr.bin/cdio/cdio.c","usr.bin/cdio/cdio.c","play_same",1056,1072
21,4,137,1,27,"play_next@1076-1103@usr.bin/cdio/cdio.c","usr.bin/cdio/cdio.c","play_next",1076,1103
19,7,68,1,18,"strstatus@1106-1124@usr.bin/cdio/cdio.c","usr.bin/cdio/cdio.c","strstatus",1106,1124
55,12,382,1,57,"pstatus@1128-1185@usr.bin/cdio/cdio.c","usr.bin/cdio/cdio.c","pstatus",1128,1185
22,6,128,1,24,"cdid@1188-1212@usr.bin/cdio/cdio.c","usr.bin/cdio/cdio.c","cdid",1188,1212
34,7,232,1,38,"info@1216-1254@usr.bin/cdio/cdio.c","usr.bin/cdio/cdio.c","info",1216,1254
28,6,200,1,33,"cddbinfo@1257-1290@usr.bin/cdio/cdio.c","usr.bin/cdio/cdio.c","cddbinfo",1257,1290
9,1,62,4,8,"lba2msf@1293-1301@usr.bin/cdio/cdio.c","usr.bin/cdio/cdio.c","lba2msf",1293,1301
4,1,32,3,3,"msf2lba@1304-1307@usr.bin/cdio/cdio.c","usr.bin/cdio/cdio.c","msf2lba",1304,1307
12,2,80,1,12,"entry2time@1310-1322@usr.bin/cdio/cdio.c","usr.bin/cdio/cdio.c","entry2time",1310,1322
13,2,95,1,13,"entry2frames@1325-1338@usr.bin/cdio/cdio.c","usr.bin/cdio/cdio.c","entry2frames",1325,1338
37,11,293,3,44,"prtrack@1341-1385@usr.bin/cdio/cdio.c","usr.bin/cdio/cdio.c","prtrack",1341,1385
9,1,55,4,10,"play_track@1388-1398@usr.bin/cdio/cdio.c","usr.bin/cdio/cdio.c","play_track",1388,1398
7,1,37,2,8,"play_blocks@1401-1409@usr.bin/cdio/cdio.c","usr.bin/cdio/cdio.c","play_blocks",1401,1409
9,1,61,2,10,"setvol@1412-1422@usr.bin/cdio/cdio.c","usr.bin/cdio/cdio.c","setvol",1412,1422
18,4,95,1,22,"read_toc_entrys@1425-1447@usr.bin/cdio/cdio.c","usr.bin/cdio/cdio.c","read_toc_entrys",1425,1447
11,1,77,6,12,"play_msf@1450-1462@usr.bin/cdio/cdio.c","usr.bin/cdio/cdio.c","play_msf",1450,1462
26,4,224,4,33,"status@1465-1498@usr.bin/cdio/cdio.c","usr.bin/cdio/cdio.c","status",1465,1498
18,5,110,1,18,"input@1501-1519@usr.bin/cdio/cdio.c","usr.bin/cdio/cdio.c","input",1501,1519
47,20,321,2,58,"parse@1522-1580@usr.bin/cdio/cdio.c","usr.bin/cdio/cdio.c","parse",1522,1580
34,11,187,2,40,"open_cd@1583-1623@usr.bin/cdio/cdio.c","usr.bin/cdio/cdio.c","open_cd",1583,1623
4,2,15,1,3,"prompt@1626-1629@usr.bin/cdio/cdio.c","usr.bin/cdio/cdio.c","prompt",1626,1629
23,5,134,1,24,"switch_el@1632-1656@usr.bin/cdio/cdio.c","usr.bin/cdio/cdio.c","switch_el",1632,1656
14,3,86,6,15,"addmsf@1659-1674@usr.bin/cdio/cdio.c","usr.bin/cdio/cdio.c","addmsf",1659,1674
16,7,99,6,18,"cmpmsf@1677-1695@usr.bin/cdio/cdio.c","usr.bin/cdio/cdio.c","cmpmsf",1677,1695
11,2,89,4,12,"toc2msf@1698-1710@usr.bin/cdio/cdio.c","usr.bin/cdio/cdio.c","toc2msf",1698,1710
29,6,202,1,33,"get_media_type@140-173@usr.bin/cdio/mmc.c","usr.bin/cdio/mmc.c","get_media_type",140,173
94,31,703,2,103,"get_media_capabilities@176-279@usr.bin/cdio/mmc.c","usr.bin/cdio/mmc.c","get_media_capabilities",176,279
17,2,145,1,19,"set_speed@282-301@usr.bin/cdio/mmc.c","usr.bin/cdio/mmc.c","set_speed",282,301
17,2,111,1,18,"blank@304-322@usr.bin/cdio/mmc.c","usr.bin/cdio/mmc.c","blank",304,322
16,2,105,1,17,"unit_ready@325-342@usr.bin/cdio/mmc.c","usr.bin/cdio/mmc.c","unit_ready",325,342
16,2,105,1,17,"synchronize_cache@345-362@usr.bin/cdio/mmc.c","usr.bin/cdio/mmc.c","synchronize_cache",345,362
17,2,111,1,18,"close_session@365-383@usr.bin/cdio/mmc.c","usr.bin/cdio/mmc.c","close_session",365,383
43,6,262,1,45,"writetao@386-431@usr.bin/cdio/mmc.c","usr.bin/cdio/mmc.c","writetao",386,431
81,15,588,2,85,"writetrack@434-519@usr.bin/cdio/mmc.c","usr.bin/cdio/mmc.c","writetrack",434,519
19,2,135,1,21,"mode_sense_write@522-543@usr.bin/cdio/mmc.c","usr.bin/cdio/mmc.c","mode_sense_write",522,543
19,2,159,1,26,"mode_select_write@546-572@usr.bin/cdio/mmc.c","usr.bin/cdio/mmc.c","mode_select_write",546,572
23,2,175,1,24,"get_disc_size@575-599@usr.bin/cdio/mmc.c","usr.bin/cdio/mmc.c","get_disc_size",575,599
22,2,170,1,23,"get_nwa@602-625@usr.bin/cdio/mmc.c","usr.bin/cdio/mmc.c","get_nwa",602,625
19,6,134,3,21,"_parse_val@117-138@usr.bin/cdio/rip.c","usr.bin/cdio/rip.c","_parse_val",117,138
33,10,188,4,37,"_parse_pair@141-178@usr.bin/cdio/rip.c","usr.bin/cdio/rip.c","_parse_pair",141,178
42,16,267,4,51,"_add_pair@181-232@usr.bin/cdio/rip.c","usr.bin/cdio/rip.c","_add_pair",181,232
5,1,27,1,5,"parse_tracks_init@235-240@usr.bin/cdio/rip.c","usr.bin/cdio/rip.c","parse_tracks_init",235,240
8,2,43,1,8,"parse_tracks_final@243-251@usr.bin/cdio/rip.c","usr.bin/cdio/rip.c","parse_tracks_final",243,251
28,11,181,5,36,"parse_tracks@254-290@usr.bin/cdio/rip.c","usr.bin/cdio/rip.c","parse_tracks",254,290
5,1,30,4,5,"parse_tracks_add@293-298@usr.bin/cdio/rip.c","usr.bin/cdio/rip.c","parse_tracks_add",293,298
12,3,61,3,14,"write_sector@301-315@usr.bin/cdio/rip.c","usr.bin/cdio/rip.c","write_sector",301,315
28,5,188,3,34,"read_data_sector@326-360@usr.bin/cdio/rip.c","usr.bin/cdio/rip.c","read_data_sector",326,360
52,13,349,1,57,"read_track@363-420@usr.bin/cdio/rip.c","usr.bin/cdio/rip.c","read_track",363,420
23,4,161,1,28,"rip_next_track@423-451@usr.bin/cdio/rip.c","usr.bin/cdio/rip.c","rip_next_track",423,451
46,14,307,1,55,"play_next_track@454-509@usr.bin/cdio/rip.c","usr.bin/cdio/rip.c","play_next_track",454,509
64,14,434,3,72,"rip_tracks_loop@512-584@usr.bin/cdio/rip.c","usr.bin/cdio/rip.c","rip_tracks_loop",512,584
39,8,251,3,45,"rip_tracks@587-632@usr.bin/cdio/rip.c","usr.bin/cdio/rip.c","rip_tracks",587,632
4,1,18,1,3,"cdrip@635-638@usr.bin/cdio/rip.c","usr.bin/cdio/rip.c","cdrip",635,638
4,1,18,1,3,"cdplay@641-644@usr.bin/cdio/rip.c","usr.bin/cdio/rip.c","cdplay",641,644
122,38,778,2,147,"main@62-209@usr.bin/chpass/chpass.c","usr.bin/chpass/chpass.c","main",62,209
4,1,18,1,4,"baduser@212-216@usr.bin/chpass/chpass.c","usr.bin/chpass/chpass.c","baduser",212,216
16,1,126,1,17,"kbintr@220-237@usr.bin/chpass/chpass.c","usr.bin/chpass/chpass.c","kbintr",220,237
6,1,35,1,6,"usage@240-246@usr.bin/chpass/chpass.c","usr.bin/chpass/chpass.c","usage",240,246
20,9,141,2,20,"edit@51-71@usr.bin/chpass/edit.c","usr.bin/chpass/edit.c","edit",51,71
40,10,407,3,47,"display@79-126@usr.bin/chpass/edit.c","usr.bin/chpass/edit.c","display",79,126
95,33,710,2,100,"verify@129-229@usr.bin/chpass/edit.c","usr.bin/chpass/edit.c","verify",129,229
27,9,163,3,27,"p_login@49-76@usr.bin/chpass/field.c","usr.bin/chpass/field.c","p_login",49,76
10,3,61,3,10,"p_passwd@80-90@usr.bin/chpass/field.c","usr.bin/chpass/field.c","p_passwd",80,90
16,3,89,3,16,"p_uid@94-110@usr.bin/chpass/field.c","usr.bin/chpass/field.c","p_uid",94,110
25,5,148,3,25,"p_gid@114-139@usr.bin/chpass/field.c","usr.bin/chpass/field.c","p_gid",114,139
10,3,61,3,10,"p_class@143-153@usr.bin/chpass/field.c","usr.bin/chpass/field.c","p_class",143,153
7,2,45,3,6,"p_change@157-163@usr.bin/chpass/field.c","usr.bin/chpass/field.c","p_change",157,163
7,2,45,3,6,"p_expire@167-173@usr.bin/chpass/field.c","usr.bin/chpass/field.c","p_expire",167,173
10,3,61,3,9,"p_gecos@177-186@usr.bin/chpass/field.c","usr.bin/chpass/field.c","p_gecos",177,186
12,3,66,3,11,"p_hdir@190-201@usr.bin/chpass/field.c","usr.bin/chpass/field.c","p_hdir",190,201
24,8,141,3,25,"p_shell@205-230@usr.bin/chpass/field.c","usr.bin/chpass/field.c","p_shell",205,230
10,3,71,3,10,"ttoa@46-56@usr.bin/chpass/util.c","usr.bin/chpass/util.c","ttoa",46,56
20,7,149,2,20,"atot@59-79@usr.bin/chpass/util.c","usr.bin/chpass/util.c","atot",59,79
15,7,100,2,16,"ok_shell@82-98@usr.bin/chpass/util.c","usr.bin/chpass/util.c","ok_shell",82,98
84,28,502,2,94,"main@50-144@usr.bin/cmp/cmp.c","usr.bin/cmp/cmp.c","main",50,144
6,1,21,1,6,"usage@147-153@usr.bin/cmp/cmp.c","usr.bin/cmp/cmp.c","usage",147,153
6,2,25,1,5,"eofmsg@42-47@usr.bin/cmp/misc.c","usr.bin/cmp/misc.c","eofmsg",42,47
7,2,52,4,6,"diffmsg@50-56@usr.bin/cmp/misc.c","usr.bin/cmp/misc.c","diffmsg",50,56
50,16,338,8,56,"c_regular@47-103@usr.bin/cmp/regular.c","usr.bin/cmp/regular.c","c_regular",47,103
46,19,305,6,50,"c_special@43-93@usr.bin/cmp/special.c","usr.bin/cmp/special.c","c_special",43,93
182,53,869,2,217,"main@101-318@usr.bin/col/col.c","usr.bin/col/col.c","main",101,318
19,7,95,1,19,"flush_lines@321-340@usr.bin/col/col.c","usr.bin/col/col.c","flush_lines",321,340
22,6,92,1,26,"flush_blanks@348-374@usr.bin/col/col.c","usr.bin/col/col.c","flush_blanks",348,374
75,22,468,1,93,"flush_line@381-474@usr.bin/col/col.c","usr.bin/col/col.c","flush_line",381,474
11,4,59,2,10,"addto_lineno@481-491@usr.bin/col/col.c","usr.bin/col/col.c","addto_lineno",481,491
16,3,95,1,17,"alloc_line@498-515@usr.bin/col/col.c","usr.bin/col/col.c","alloc_line",498,515
5,1,18,1,5,"free_line@518-523@usr.bin/col/col.c","usr.bin/col/col.c","free_line",518,523
6,2,42,3,6,"xreallocarray@526-532@usr.bin/col/col.c","usr.bin/col/col.c","xreallocarray",526,532
5,1,21,1,4,"usage@535-539@usr.bin/col/col.c","usr.bin/col/col.c","usage",535,539
5,2,20,1,5,"dowarn@542-547@usr.bin/col/col.c","usr.bin/col/col.c","dowarn",542,547
95,46,623,2,132,"main@50-182@usr.bin/colrm/colrm.c","usr.bin/colrm/colrm.c","main",50,182
5,1,21,1,4,"usage@185-189@usr.bin/colrm/colrm.c","usr.bin/colrm/colrm.c","usage",185,189
74,24,442,2,82,"main@69-151@usr.bin/column/column.c","usr.bin/column/column.c","main",69,151
21,6,121,1,21,"c_columnate@155-176@usr.bin/column/column.c","usr.bin/column/column.c","c_columnate",155,176
20,7,140,1,21,"r_columnate@179-200@usr.bin/column/column.c","usr.bin/column/column.c","r_columnate",179,200
6,2,32,1,6,"print@203-209@usr.bin/column/column.c","usr.bin/column/column.c","print",203,209
11,3,96,1,11,"maketbl@213-224@usr.bin/column/column.c","usr.bin/column/column.c","maketbl",213,224
82,24,550,1,106,"input@230-336@usr.bin/column/column.c","usr.bin/column/column.c","input",230,336
6,2,41,3,5,"ereallocarray@339-344@usr.bin/column/column.c","usr.bin/column/column.c","ereallocarray",339,344
7,2,39,2,7,"ecalloc@347-354@usr.bin/column/column.c","usr.bin/column/column.c","ecalloc",347,354
6,1,21,1,5,"usage@357-362@usr.bin/column/column.c","usr.bin/column/column.c","usage",357,362
85,31,491,2,101,"main@53-154@usr.bin/comm/comm.c","usr.bin/comm/comm.c","main",53,154
5,3,39,3,4,"show@157-161@usr.bin/comm/comm.c","usr.bin/comm/comm.c","show",157,161
9,3,57,1,9,"file@164-173@usr.bin/comm/comm.c","usr.bin/comm/comm.c","file",164,173
5,1,21,1,4,"usage@176-180@usr.bin/comm/comm.c","usr.bin/comm/comm.c","usage",176,180
35,5,254,3,42,"gz_ropen@104-146@usr.bin/compress/gzopen.c","usr.bin/compress/gzopen.c","gz_ropen",104,146
16,4,102,1,16,"get_byte@149-165@usr.bin/compress/gzopen.c","usr.bin/compress/gzopen.c","get_byte",149,165
9,1,87,1,9,"get_int32@168-177@usr.bin/compress/gzopen.c","usr.bin/compress/gzopen.c","get_int32",168,177
64,20,382,3,77,"get_header@180-257@usr.bin/compress/gzopen.c","usr.bin/compress/gzopen.c","get_header",180,257
58,12,417,3,71,"gz_read@260-331@usr.bin/compress/gzopen.c","usr.bin/compress/gzopen.c","gz_read",260,331
7,2,47,2,7,"put_int32@335-342@usr.bin/compress/gzopen.c","usr.bin/compress/gzopen.c","put_int32",335,342
26,7,249,4,27,"put_header@345-372@usr.bin/compress/gzopen.c","usr.bin/compress/gzopen.c","put_header",345,372
40,7,286,4,48,"gz_wopen@375-423@usr.bin/compress/gzopen.c","usr.bin/compress/gzopen.c","gz_wopen",375,423
18,5,154,3,20,"gz_write@425-445@usr.bin/compress/gzopen.c","usr.bin/compress/gzopen.c","gz_write",425,445
28,10,176,2,35,"gz_flush@448-483@usr.bin/compress/gzopen.c","usr.bin/compress/gzopen.c","gz_flush",448,483
40,12,309,4,51,"gz_close@487-538@usr.bin/compress/gzopen.c","usr.bin/compress/gzopen.c","gz_close",487,538
281,108,1572,2,317,"main@159-476@usr.bin/compress/main.c","usr.bin/compress/main.c","main",159,476
101,39,640,5,115,"docompress@479-594@usr.bin/compress/main.c","usr.bin/compress/main.c","docompress",479,594
18,7,131,1,20,"check_method@597-617@usr.bin/compress/main.c","usr.bin/compress/main.c","check_method",597,617
122,48,768,3,136,"dodecompress@620-756@usr.bin/compress/main.c","usr.bin/compress/main.c","dodecompress",620,756
26,11,186,3,39,"setfile@759-798@usr.bin/compress/main.c","usr.bin/compress/main.c","setfile",759,798
11,4,73,1,11,"permission@801-812@usr.bin/compress/main.c","usr.bin/compress/main.c","permission",801,812
16,5,126,1,17,"check_suffix@818-835@usr.bin/compress/main.c","usr.bin/compress/main.c","check_suffix",818,835
17,4,127,3,21,"set_outfile@842-863@usr.bin/compress/main.c","usr.bin/compress/main.c","set_outfile",842,863
44,10,280,3,46,"list_stats@869-915@usr.bin/compress/main.c","usr.bin/compress/main.c","list_stats",869,915
16,5,96,4,15,"verbose_info@918-933@usr.bin/compress/main.c","usr.bin/compress/main.c","verbose_info",918,933
23,10,123,1,23,"usage@936-959@usr.bin/compress/main.c","usr.bin/compress/main.c","usage",936,959
13,3,79,3,16,"null_ropen@50-66@usr.bin/compress/nullopen.c","usr.bin/compress/nullopen.c","null_ropen",50,66
13,3,82,4,16,"null_wopen@69-85@usr.bin/compress/nullopen.c","usr.bin/compress/nullopen.c","null_wopen",69,85
18,3,128,4,23,"null_close@88-111@usr.bin/compress/nullopen.c","usr.bin/compress/nullopen.c","null_close",88,111
9,3,48,2,10,"null_flush@114-124@usr.bin/compress/nullopen.c","usr.bin/compress/nullopen.c","null_flush",114,124
19,4,112,3,22,"null_read@127-149@usr.bin/compress/nullopen.c","usr.bin/compress/nullopen.c","null_read",127,149
9,2,56,3,10,"null_write@152-162@usr.bin/compress/nullopen.c","usr.bin/compress/nullopen.c","null_write",152,162
83,21,616,3,96,"zwrite@211-307@usr.bin/compress/zopen.c","usr.bin/compress/zopen.c","zwrite",211,307
30,5,211,4,34,"z_close@310-344@usr.bin/compress/zopen.c","usr.bin/compress/zopen.c","z_close",310,344
67,16,461,2,87,"output@367-454@usr.bin/compress/zopen.c","usr.bin/compress/zopen.c","output",367,454
97,23,746,3,121,"zread@463-584@usr.bin/compress/zopen.c","usr.bin/compress/zopen.c","zread",463,584
52,12,396,1,72,"getcode@594-666@usr.bin/compress/zopen.c","usr.bin/compress/zopen.c","getcode",594,666
25,5,151,1,27,"cl_block@670-697@usr.bin/compress/zopen.c","usr.bin/compress/zopen.c","cl_block",670,697
29,3,221,2,29,"cl_hash@701-730@usr.bin/compress/zopen.c","usr.bin/compress/zopen.c","cl_hash",701,730
27,5,181,4,32,"z_wopen@733-765@usr.bin/compress/zopen.c","usr.bin/compress/zopen.c","z_wopen",733,765
23,3,157,3,27,"z_ropen@768-795@usr.bin/compress/zopen.c","usr.bin/compress/zopen.c","z_ropen",768,795
99,33,660,2,115,"main@94-209@usr.bin/csplit/csplit.c","usr.bin/csplit/csplit.c","main",94,209
8,1,25,1,8,"usage@212-220@usr.bin/csplit/csplit.c","usr.bin/csplit/csplit.c","usage",212,220
7,1,38,1,7,"handlesig@224-231@usr.bin/csplit/csplit.c","usr.bin/csplit/csplit.c","handlesig",224,231
11,3,84,1,12,"newfile@235-247@usr.bin/csplit/csplit.c","usr.bin/csplit/csplit.c","newfile",235,247
12,3,63,1,17,"cleanup@251-268@usr.bin/csplit/csplit.c","usr.bin/csplit/csplit.c","cleanup",251,268
17,5,91,1,19,"get_line@272-291@usr.bin/csplit/csplit.c","usr.bin/csplit/csplit.c","get_line",272,291
38,16,301,2,55,"toomuch@295-350@usr.bin/csplit/csplit.c","usr.bin/csplit/csplit.c","toomuch",295,350
58,21,426,1,78,"do_rexp@354-432@usr.bin/csplit/csplit.c","usr.bin/csplit/csplit.c","do_rexp",354,432
29,12,193,1,30,"do_lineno@436-466@usr.bin/csplit/csplit.c","usr.bin/csplit/csplit.c","do_lineno",436,466
127,45,597,1,210,"c_entries@49-259@usr.bin/ctags/C.c","usr.bin/ctags/C.c","c_entries",49,259
75,27,355,1,91,"func_entry@266-357@usr.bin/ctags/C.c","usr.bin/ctags/C.c","func_entry",266,357
51,20,268,1,62,"hash_entry@364-426@usr.bin/ctags/C.c","usr.bin/ctags/C.c","hash_entry",364,426
40,13,193,1,42,"str_entry@433-475@usr.bin/ctags/C.c","usr.bin/ctags/C.c","str_entry",433,475
24,8,87,1,29,"skip_comment@482-511@usr.bin/ctags/C.c","usr.bin/ctags/C.c","skip_comment",482,511
17,6,64,1,18,"skip_string@518-536@usr.bin/ctags/C.c","usr.bin/ctags/C.c","skip_string",518,536
39,13,157,1,42,"skip_key@543-585@usr.bin/ctags/C.c","usr.bin/ctags/C.c","skip_key",543,585
77,24,368,2,82,"main@71-153@usr.bin/ctags/ctags.c","usr.bin/ctags/ctags.c","main",71,153
13,5,104,1,16,"init@166-182@usr.bin/ctags/ctags.c","usr.bin/ctags/ctags.c","init",166,182
40,14,225,1,50,"find_entries@190-240@usr.bin/ctags/ctags.c","usr.bin/ctags/ctags.c","find_entries",190,240
53,15,371,3,73,"preload_entries@243-316@usr.bin/ctags/ctags.c","usr.bin/ctags/ctags.c","preload_entries",243,316
80,34,405,1,81,"PF_funcs@45-126@usr.bin/ctags/fortran.c","usr.bin/ctags/fortran.c","PF_funcs",45,126
13,4,75,1,13,"cicmp@133-146@usr.bin/ctags/fortran.c","usr.bin/ctags/fortran.c","cicmp",133,146
14,6,85,1,13,"takeprec@149-162@usr.bin/ctags/fortran.c","usr.bin/ctags/fortran.c","takeprec",149,162
54,24,317,1,55,"l_entries@45-100@usr.bin/ctags/lisp.c","usr.bin/ctags/lisp.c","l_entries",45,100
34,11,205,1,39,"get_line@47-86@usr.bin/ctags/print.c","usr.bin/ctags/print.c","get_line",47,86
16,5,111,1,16,"put_entries@93-109@usr.bin/ctags/print.c","usr.bin/ctags/print.c","put_entries",93,109
37,11,258,2,37,"pfnote@52-89@usr.bin/ctags/tree.c","usr.bin/ctags/tree.c","pfnote",52,89
29,9,162,2,29,"add_node@92-121@usr.bin/ctags/tree.c","usr.bin/ctags/tree.c","add_node",92,121
12,3,62,1,12,"free_tree@124-136@usr.bin/ctags/tree.c","usr.bin/ctags/tree.c","free_tree",124,136
63,29,290,1,65,"y_entries@45-110@usr.bin/ctags/yacc.c","usr.bin/ctags/yacc.c","y_entries",45,110
23,6,86,1,29,"toss_yysec@117-146@usr.bin/ctags/yacc.c","usr.bin/ctags/yacc.c","toss_yysec",117,146
6,1,22,1,5,"usage@78-83@usr.bin/ctfconv/ctfconv.c","usr.bin/ctfconv/ctfconv.c","usage",78,83
65,22,387,2,82,"main@86-168@usr.bin/ctfconv/ctfconv.c","usr.bin/ctfconv/ctfconv.c","main",86,168
29,6,181,1,33,"convert@171-204@usr.bin/ctfconv/ctfconv.c","usr.bin/ctfconv/ctfconv.c","convert",171,204
28,6,204,2,40,"elf_convert@213-253@usr.bin/ctfconv/ctfconv.c","usr.bin/ctfconv/ctfconv.c","elf_convert",213,253
18,5,123,2,28,"find_symb@256-284@usr.bin/ctfconv/ctfconv.c","usr.bin/ctfconv/ctfconv.c","find_symb",256,284
37,11,220,1,49,"elf_sort@287-336@usr.bin/ctfconv/ctfconv.c","usr.bin/ctfconv/ctfconv.c","elf_sort",287,336
8,2,33,1,9,"type_name@339-348@usr.bin/ctfconv/ctfconv.c","usr.bin/ctfconv/ctfconv.c","type_name",339,348
86,28,516,1,89,"dump_type@352-441@usr.bin/ctfconv/ctfconv.c","usr.bin/ctfconv/ctfconv.c","dump_type",352,441
15,5,112,2,17,"dump_func@444-461@usr.bin/ctfconv/ctfconv.c","usr.bin/ctfconv/ctfconv.c","dump_func",444,461
7,1,60,2,8,"dump_obj@464-472@usr.bin/ctfconv/ctfconv.c","usr.bin/ctfconv/ctfconv.c","dump_obj",464,472
12,4,82,1,14,"ctf_enc2name@475-489@usr.bin/ctfconv/ctfconv.c","usr.bin/ctfconv/ctfconv.c","ctf_enc2name",475,489
9,2,54,3,8,"dw_read_bytes@65-73@usr.bin/ctfconv/dw.c","usr.bin/ctfconv/dw.c","dw_read_bytes",65,73
4,1,27,2,3,"dw_read_u8@76-79@usr.bin/ctfconv/dw.c","usr.bin/ctfconv/dw.c","dw_read_u8",76,79
4,1,27,2,3,"dw_read_u16@82-85@usr.bin/ctfconv/dw.c","usr.bin/ctfconv/dw.c","dw_read_u16",82,85
4,1,27,2,3,"dw_read_u32@88-91@usr.bin/ctfconv/dw.c","usr.bin/ctfconv/dw.c","dw_read_u32",88,91
4,1,27,2,3,"dw_read_u64@94-97@usr.bin/ctfconv/dw.c","usr.bin/ctfconv/dw.c","dw_read_u64",94,97
17,7,115,3,17,"dw_read_leb128@101-118@usr.bin/ctfconv/dw.c","usr.bin/ctfconv/dw.c","dw_read_leb128",101,118
4,1,27,2,3,"dw_read_sleb128@121-124@usr.bin/ctfconv/dw.c","usr.bin/ctfconv/dw.c","dw_read_sleb128",121,124
4,1,23,2,3,"dw_read_uleb128@127-130@usr.bin/ctfconv/dw.c","usr.bin/ctfconv/dw.c","dw_read_uleb128",127,130
12,2,77,2,13,"dw_read_string@134-147@usr.bin/ctfconv/dw.c","usr.bin/ctfconv/dw.c","dw_read_string",134,147
10,2,58,3,9,"dw_read_buf@150-159@usr.bin/ctfconv/dw.c","usr.bin/ctfconv/dw.c","dw_read_buf",150,159
8,2,39,2,7,"dw_skip_bytes@162-169@usr.bin/ctfconv/dw.c","usr.bin/ctfconv/dw.c","dw_skip_bytes",162,169
36,16,241,5,45,"dw_read_filename@172-217@usr.bin/ctfconv/dw.c","usr.bin/ctfconv/dw.c","dw_read_filename",172,217
11,4,57,1,13,"dw_tag2name@221-234@usr.bin/ctfconv/dw.c","usr.bin/ctfconv/dw.c","dw_tag2name",221,234
11,4,57,1,13,"dw_at2name@237-250@usr.bin/ctfconv/dw.c","usr.bin/ctfconv/dw.c","dw_at2name",237,250
11,4,57,1,13,"dw_form2name@253-266@usr.bin/ctfconv/dw.c","usr.bin/ctfconv/dw.c","dw_form2name",253,266
11,4,57,1,13,"dw_op2name@269-282@usr.bin/ctfconv/dw.c","usr.bin/ctfconv/dw.c","dw_op2name",269,282
86,32,506,4,92,"dw_attr_parse@285-377@usr.bin/ctfconv/dw.c","usr.bin/ctfconv/dw.c","dw_attr_parse",285,377
9,2,49,1,10,"dw_attr_purge@380-390@usr.bin/ctfconv/dw.c","usr.bin/ctfconv/dw.c","dw_attr_purge",380,390
44,9,248,5,53,"dw_die_parse@393-446@usr.bin/ctfconv/dw.c","usr.bin/ctfconv/dw.c","dw_die_parse",393,446
10,2,57,1,11,"dw_die_purge@449-460@usr.bin/ctfconv/dw.c","usr.bin/ctfconv/dw.c","dw_die_purge",449,460
39,14,252,2,51,"dw_ab_parse@463-514@usr.bin/ctfconv/dw.c","usr.bin/ctfconv/dw.c","dw_ab_parse",463,514
14,3,90,1,17,"dw_dabq_purge@517-534@usr.bin/ctfconv/dw.c","usr.bin/ctfconv/dw.c","dw_dabq_purge",517,534
66,17,461,4,87,"dw_cu_parse@537-624@usr.bin/ctfconv/dw.c","usr.bin/ctfconv/dw.c","dw_cu_parse",537,624
8,2,41,1,8,"dw_dcu_free@627-635@usr.bin/ctfconv/dw.c","usr.bin/ctfconv/dw.c","dw_dcu_free",627,635
30,12,137,4,35,"dw_loc_parse@638-673@usr.bin/ctfconv/dw.c","usr.bin/ctfconv/dw.c","dw_loc_parse",638,673
39,11,258,2,42,"iself@33-75@usr.bin/ctfconv/elf.c","usr.bin/ctfconv/elf.c","iself",33,75
30,7,181,4,32,"elf_getshstab@78-110@usr.bin/ctfconv/elf.c","usr.bin/ctfconv/elf.c","elf_getshstab",78,110
48,18,377,8,61,"elf_getsymtab@113-174@usr.bin/ctfconv/elf.c","usr.bin/ctfconv/elf.c","elf_getsymtab",113,174
39,12,280,7,48,"elf_getsection@177-225@usr.bin/ctfconv/elf.c","usr.bin/ctfconv/elf.c","elf_getsection",177,225
14,7,49,1,20,"elf_reloc_size@228-248@usr.bin/ctfconv/elf.c","usr.bin/ctfconv/elf.c","elf_reloc_size",228,248
74,21,538,7,86,"elf_reloc_apply@262-348@usr.bin/ctfconv/elf.c","usr.bin/ctfconv/elf.c","elf_reloc_apply",262,348
8,1,61,2,8,"dbuf_realloc@74-82@usr.bin/ctfconv/generate.c","usr.bin/ctfconv/generate.c","dbuf_realloc",74,82
15,3,113,3,18,"dbuf_copy@85-103@usr.bin/ctfconv/generate.c","usr.bin/ctfconv/generate.c","dbuf_copy",85,103
7,2,50,2,8,"dbuf_pad@106-114@usr.bin/ctfconv/generate.c","usr.bin/ctfconv/generate.c","dbuf_pad",106,114
15,4,123,2,18,"imcs_add_string@117-135@usr.bin/ctfconv/generate.c","usr.bin/ctfconv/generate.c","imcs_add_string",117,135
19,2,154,2,23,"imcs_add_func@138-161@usr.bin/ctfconv/generate.c","usr.bin/ctfconv/generate.c","imcs_add_func",138,161
6,1,41,2,6,"imcs_add_obj@164-170@usr.bin/ctfconv/generate.c","usr.bin/ctfconv/generate.c","imcs_add_obj",164,170
99,19,673,2,112,"imcs_add_type@173-285@usr.bin/ctfconv/generate.c","usr.bin/ctfconv/generate.c","imcs_add_type",173,285
32,3,274,3,49,"imcs_generate@288-337@usr.bin/ctfconv/generate.c","usr.bin/ctfconv/generate.c","imcs_generate",288,337
50,8,373,3,69,"generate@343-412@usr.bin/ctfconv/generate.c","usr.bin/ctfconv/generate.c","generate",343,412
38,6,239,4,46,"data_compress@416-462@usr.bin/ctfconv/generate.c","usr.bin/ctfconv/generate.c","data_compress",416,462
5,1,22,1,4,"hash_delete@53-57@usr.bin/ctfconv/hash.c","usr.bin/ctfconv/hash.c","hash_delete",53,57
39,11,302,1,41,"hash_resize@60-101@usr.bin/ctfconv/hash.c","usr.bin/ctfconv/hash.c","hash_resize",60,101
11,5,85,2,12,"hash_remove@104-116@usr.bin/ctfconv/hash.c","usr.bin/ctfconv/hash.c","hash_remove",104,116
13,3,94,4,14,"hash_insert@119-133@usr.bin/ctfconv/hash.c","usr.bin/ctfconv/hash.c","hash_insert",119,133
5,1,27,2,4,"hash_first@136-140@usr.bin/ctfconv/hash.c","usr.bin/ctfconv/hash.c","hash_first",136,140
7,4,77,2,6,"hash_next@143-149@usr.bin/ctfconv/hash.c","usr.bin/ctfconv/hash.c","hash_next",143,149
17,4,106,1,20,"hash_init@152-172@usr.bin/ctfconv/hash.c","usr.bin/ctfconv/hash.c","hash_init",152,172
13,4,83,2,13,"hash_interval@175-188@usr.bin/ctfconv/hash.c","usr.bin/ctfconv/hash.c","hash_interval",175,188
35,10,273,2,38,"hash_qlookup@191-229@usr.bin/ctfconv/hash.c","usr.bin/ctfconv/hash.c","hash_qlookup",191,229
10,3,69,3,12,"hash_find@232-244@usr.bin/ctfconv/hash.c","usr.bin/ctfconv/hash.c","hash_find",232,244
36,7,285,4,56,"dwarf_parse@129-185@usr.bin/ctfconv/parse.c","usr.bin/ctfconv/parse.c","dwarf_parse",129,185
33,5,258,8,40,"it_new@188-228@usr.bin/ctfconv/parse.c","usr.bin/ctfconv/parse.c","it_new",188,228
15,1,130,1,18,"it_dup@231-249@usr.bin/ctfconv/parse.c","usr.bin/ctfconv/parse.c","it_dup",231,249
16,1,138,2,17,"it_merge@256-273@usr.bin/ctfconv/parse.c","usr.bin/ctfconv/parse.c","it_merge",256,273
6,2,28,1,6,"it_name@276-282@usr.bin/ctfconv/parse.c","usr.bin/ctfconv/parse.c","it_name",276,282
10,3,59,1,12,"it_reference@285-297@usr.bin/ctfconv/parse.c","usr.bin/ctfconv/parse.c","it_reference",285,297
12,3,73,1,14,"it_free@300-314@usr.bin/ctfconv/parse.c","usr.bin/ctfconv/parse.c","it_free",300,314
13,8,137,2,20,"it_cmp@320-340@usr.bin/ctfconv/parse.c","usr.bin/ctfconv/parse.c","it_cmp",320,340
7,2,60,2,8,"it_name_cmp@343-351@usr.bin/ctfconv/parse.c","usr.bin/ctfconv/parse.c","it_name_cmp",343,351
4,1,23,2,3,"it_off_cmp@354-357@usr.bin/ctfconv/parse.c","usr.bin/ctfconv/parse.c","it_off_cmp",354,357
11,2,74,2,12,"ir_add@360-372@usr.bin/ctfconv/parse.c","usr.bin/ctfconv/parse.c","ir_add",360,372
8,2,50,1,8,"ir_purge@375-383@usr.bin/ctfconv/parse.c","usr.bin/ctfconv/parse.c","ir_purge",375,383
19,3,111,3,21,"im_new@386-407@usr.bin/ctfconv/parse.c","usr.bin/ctfconv/parse.c","im_new",386,407
6,2,28,1,6,"im_name@410-416@usr.bin/ctfconv/parse.c","usr.bin/ctfconv/parse.c","im_name",410,416
4,1,10,1,5,"cu_stat@419-424@usr.bin/ctfconv/parse.c","usr.bin/ctfconv/parse.c","cu_stat",419,424
48,12,332,3,56,"cu_resolve@432-488@usr.bin/ctfconv/parse.c","usr.bin/ctfconv/parse.c","cu_resolve",432,488
8,2,46,2,8,"cu_reference@491-499@usr.bin/ctfconv/parse.c","usr.bin/ctfconv/parse.c","cu_reference",491,499
60,17,436,2,95,"cu_merge@505-600@usr.bin/ctfconv/parse.c","usr.bin/ctfconv/parse.c","cu_merge",505,600
91,34,468,3,110,"cu_parse@606-716@usr.bin/ctfconv/parse.c","usr.bin/ctfconv/parse.c","cu_parse",606,716
76,18,334,2,79,"parse_base@719-798@usr.bin/ctfconv/parse.c","usr.bin/ctfconv/parse.c","parse_base",719,798
34,9,208,3,38,"parse_refers@801-839@usr.bin/ctfconv/parse.c","usr.bin/ctfconv/parse.c","parse_refers",801,839
24,3,137,2,27,"parse_array@842-869@usr.bin/ctfconv/parse.c","usr.bin/ctfconv/parse.c","parse_array",842,869
24,3,144,2,27,"parse_enum@872-899@usr.bin/ctfconv/parse.c","usr.bin/ctfconv/parse.c","parse_enum",872,899
29,6,166,3,38,"subparse_subrange@902-940@usr.bin/ctfconv/parse.c","usr.bin/ctfconv/parse.c","subparse_subrange",902,940
37,7,218,3,47,"subparse_enumerator@943-990@usr.bin/ctfconv/parse.c","usr.bin/ctfconv/parse.c","subparse_enumerator",943,990
31,5,187,4,34,"parse_struct@993-1027@usr.bin/ctfconv/parse.c","usr.bin/ctfconv/parse.c","parse_struct",993,1027
50,16,323,4,75,"subparse_member@1030-1105@usr.bin/ctfconv/parse.c","usr.bin/ctfconv/parse.c","subparse_member",1030,1105
36,10,215,3,56,"subparse_arguments@1109-1165@usr.bin/ctfconv/parse.c","usr.bin/ctfconv/parse.c","subparse_arguments",1109,1165
33,6,182,2,47,"parse_function@1168-1215@usr.bin/ctfconv/parse.c","usr.bin/ctfconv/parse.c","parse_function",1168,1215
29,4,165,2,34,"parse_funcptr@1218-1252@usr.bin/ctfconv/parse.c","usr.bin/ctfconv/parse.c","parse_funcptr",1218,1252
29,6,162,2,32,"parse_variable@1255-1287@usr.bin/ctfconv/parse.c","usr.bin/ctfconv/parse.c","parse_variable",1255,1287
46,20,179,2,47,"dav2val@1290-1337@usr.bin/ctfconv/parse.c","usr.bin/ctfconv/parse.c","dav2val",1290,1337
20,4,80,1,21,"dav2str@1340-1361@usr.bin/ctfconv/parse.c","usr.bin/ctfconv/parse.c","dav2str",1340,1361
10,3,72,1,11,"enc2name@1364-1375@usr.bin/ctfconv/parse.c","usr.bin/ctfconv/parse.c","enc2name",1364,1375
11,1,81,4,12,"pool_init@42-54@usr.bin/ctfconv/pool.c","usr.bin/ctfconv/pool.c","pool_init",42,54
20,3,136,1,23,"pool_get@57-80@usr.bin/ctfconv/pool.c","usr.bin/ctfconv/pool.c","pool_get",57,80
9,2,61,2,11,"pool_put@83-94@usr.bin/ctfconv/pool.c","usr.bin/ctfconv/pool.c","pool_put",83,94
7,1,37,1,7,"pool_dump@97-104@usr.bin/ctfconv/pool.c","usr.bin/ctfconv/pool.c","pool_dump",97,104
4,1,18,2,3,"pmalloc@40-43@usr.bin/ctfconv/pool.h","usr.bin/ctfconv/pool.h","pmalloc",40,43
7,1,35,2,8,"pzalloc@46-54@usr.bin/ctfconv/pool.h","usr.bin/ctfconv/pool.h","pzalloc",46,54
4,1,20,2,3,"pfree@57-60@usr.bin/ctfconv/pool.h","usr.bin/ctfconv/pool.h","pfree",57,60
10,3,49,1,10,"xmalloc@28-38@usr.bin/ctfconv/xmalloc.c","usr.bin/ctfconv/xmalloc.c","xmalloc",28,38
11,4,60,2,11,"xcalloc@41-52@usr.bin/ctfconv/xmalloc.c","usr.bin/ctfconv/xmalloc.c","xcalloc",41,52
4,1,21,2,3,"xrealloc@55-58@usr.bin/ctfconv/xmalloc.c","usr.bin/ctfconv/xmalloc.c","xrealloc",55,58
11,4,66,3,11,"xreallocarray@61-72@usr.bin/ctfconv/xmalloc.c","usr.bin/ctfconv/xmalloc.c","xreallocarray",61,72
7,2,36,1,7,"xstrdup@75-82@usr.bin/ctfconv/xmalloc.c","usr.bin/ctfconv/xmalloc.c","xstrdup",75,82
42,12,194,2,50,"main@78-128@usr.bin/ctfdump/ctfdump.c","usr.bin/ctfdump/ctfdump.c","main",78,128
32,7,209,2,36,"dump@131-167@usr.bin/ctfdump/ctfdump.c","usr.bin/ctfdump/ctfdump.c","dump",131,167
17,5,92,2,22,"elf_idx2sym@174-196@usr.bin/ctfdump/ctfdump.c","usr.bin/ctfdump/ctfdump.c","elf_idx2sym",174,196
27,9,228,3,38,"elf_dump@199-237@usr.bin/ctfdump/ctfdump.c","usr.bin/ctfdump/ctfdump.c","elf_dump",199,237
34,18,248,2,40,"isctf@240-280@usr.bin/ctfdump/ctfdump.c","usr.bin/ctfdump/ctfdump.c","isctf",240,280
111,23,787,3,132,"ctf_dump@283-415@usr.bin/ctfdump/ctfdump.c","usr.bin/ctfdump/ctfdump.c","ctf_dump",283,415
116,26,775,6,132,"ctf_dump_type@418-550@usr.bin/ctfdump/ctfdump.c","usr.bin/ctfdump/ctfdump.c","ctf_dump_type",418,550
9,2,63,1,10,"ctf_kind2name@553-563@usr.bin/ctfdump/ctfdump.c","usr.bin/ctfdump/ctfdump.c","ctf_kind2name",553,563
12,4,81,1,14,"ctf_enc2name@566-580@usr.bin/ctfdump/ctfdump.c","usr.bin/ctfdump/ctfdump.c","ctf_enc2name",566,580
10,4,83,1,11,"ctf_fpenc2name@583-594@usr.bin/ctfdump/ctfdump.c","usr.bin/ctfdump/ctfdump.c","ctf_fpenc2name",583,594
15,5,93,4,19,"ctf_off2name@597-616@usr.bin/ctfdump/ctfdump.c","usr.bin/ctfdump/ctfdump.c","ctf_off2name",597,616
38,7,225,3,47,"decompress@619-666@usr.bin/ctfdump/ctfdump.c","usr.bin/ctfdump/ctfdump.c","decompress",619,666
6,1,22,1,5,"usage@669-674@usr.bin/ctfdump/ctfdump.c","usr.bin/ctfdump/ctfdump.c","usage",669,674
39,11,258,2,42,"iself@33-75@usr.bin/ctfdump/elf.c","usr.bin/ctfdump/elf.c","iself",33,75
30,7,181,4,32,"elf_getshstab@78-110@usr.bin/ctfdump/elf.c","usr.bin/ctfdump/elf.c","elf_getshstab",78,110
48,18,377,8,61,"elf_getsymtab@113-174@usr.bin/ctfdump/elf.c","usr.bin/ctfdump/elf.c","elf_getsymtab",113,174
39,12,280,7,48,"elf_getsection@177-225@usr.bin/ctfdump/elf.c","usr.bin/ctfdump/elf.c","elf_getsection",177,225
14,7,49,1,20,"elf_reloc_size@228-248@usr.bin/ctfdump/elf.c","usr.bin/ctfdump/elf.c","elf_reloc_size",228,248
74,21,538,7,86,"elf_reloc_apply@262-348@usr.bin/ctfdump/elf.c","usr.bin/ctfdump/elf.c","elf_reloc_apply",262,348
36,13,228,1,44,"pipe_command@43-87@usr.bin/cu/command.c","usr.bin/cu/command.c","pipe_command",43,87
33,12,207,1,47,"connect_command@90-137@usr.bin/cu/command.c","usr.bin/cu/command.c","connect_command",90,137
23,7,137,1,26,"send_file@140-166@usr.bin/cu/command.c","usr.bin/cu/command.c","send_file",140,166
11,3,52,1,12,"send_xmodem@169-181@usr.bin/cu/command.c","usr.bin/cu/command.c","send_xmodem",169,181
15,5,84,1,17,"set_speed@184-201@usr.bin/cu/command.c","usr.bin/cu/command.c","set_speed",184,201
14,5,70,1,16,"start_record@204-220@usr.bin/cu/command.c","usr.bin/cu/command.c","start_record",204,220
58,14,191,1,57,"do_command@223-280@usr.bin/cu/command.c","usr.bin/cu/command.c","do_command",223,280
7,1,29,1,6,"usage@67-73@usr.bin/cu/cu.c","usr.bin/cu/cu.c","usage",67,73
110,39,758,2,131,"main@76-207@usr.bin/cu/cu.c","usr.bin/cu/cu.c","main",76,207
6,1,33,3,6,"signal_event@210-216@usr.bin/cu/cu.c","usr.bin/cu/cu.c","signal_event",210,216
12,5,87,2,12,"set_blocking@219-231@usr.bin/cu/cu.c","usr.bin/cu/cu.c","set_blocking",219,231
20,3,155,1,21,"set_termios@234-255@usr.bin/cu/cu.c","usr.bin/cu/cu.c","set_termios",234,255
5,2,23,1,4,"restore_termios@258-262@usr.bin/cu/cu.c","usr.bin/cu/cu.c","restore_termios",258,262
16,2,126,1,16,"set_line@265-281@usr.bin/cu/cu.c","usr.bin/cu/cu.c","set_line",265,281
33,11,166,2,36,"stream_read@284-320@usr.bin/cu/cu.c","usr.bin/cu/cu.c","stream_read",284,320
4,1,21,3,3,"stream_error@323-326@usr.bin/cu/cu.c","usr.bin/cu/cu.c","stream_error",323,326
13,3,81,2,15,"line_read@329-344@usr.bin/cu/cu.c","usr.bin/cu/cu.c","line_read",329,344
4,1,21,3,3,"line_error@347-350@usr.bin/cu/cu.c","usr.bin/cu/cu.c","line_error",347,350
35,16,253,3,39,"try_remote@353-392@usr.bin/cu/cu.c","usr.bin/cu/cu.c","try_remote",353,392
41,13,277,1,49,"tilde_expand@396-445@usr.bin/cu/cu.c","usr.bin/cu/cu.c","tilde_expand",396,445
7,1,37,3,8,"cu_err@38-46@usr.bin/cu/error.c","usr.bin/cu/error.c","cu_err",38,46
7,1,37,3,8,"cu_errx@49-57@usr.bin/cu/error.c","usr.bin/cu/error.c","cu_errx",49,57
9,1,56,2,11,"cu_warn@60-71@usr.bin/cu/error.c","usr.bin/cu/error.c","cu_warn",60,71
9,1,51,2,11,"cu_warnx@74-85@usr.bin/cu/error.c","usr.bin/cu/error.c","cu_warnx",74,85
4,1,11,1,3,"input_signal@41-44@usr.bin/cu/input.c","usr.bin/cu/input.c","input_signal",41,44
35,9,225,1,41,"get_input@47-88@usr.bin/cu/input.c","usr.bin/cu/input.c","get_input",47,88
4,1,11,1,3,"xmodem_signal@49-52@usr.bin/cu/xmodem.c","usr.bin/cu/xmodem.c","xmodem_signal",49,52
15,4,91,2,15,"xmodem_crc16@55-70@usr.bin/cu/xmodem.c","usr.bin/cu/xmodem.c","xmodem_crc16",55,70
16,7,70,1,15,"xmodem_read@73-88@usr.bin/cu/xmodem.c","usr.bin/cu/xmodem.c","xmodem_read",73,88
15,5,73,2,15,"xmodem_write@91-106@usr.bin/cu/xmodem.c","usr.bin/cu/xmodem.c","xmodem_write",91,106
101,22,618,1,116,"xmodem_send@109-225@usr.bin/cu/xmodem.c","usr.bin/cu/xmodem.c","xmodem_send",109,225
79,27,435,2,87,"main@64-151@usr.bin/cut/cut.c","usr.bin/cut/cut.c","main",64,151
42,20,266,1,54,"get_list@158-212@usr.bin/cut/cut.c","usr.bin/cut/cut.c","get_list",158,212
25,12,148,2,25,"b_cut@216-241@usr.bin/cut/cut.c","usr.bin/cut/cut.c","b_cut",216,241
30,10,182,2,31,"c_cut@244-275@usr.bin/cut/cut.c","usr.bin/cut/cut.c","c_cut",244,275
40,13,239,2,42,"f_cut@278-320@usr.bin/cut/cut.c","usr.bin/cut/cut.c","f_cut",278,320
8,1,23,1,7,"usage@323-330@usr.bin/cut/cut.c","usr.bin/cut/cut.c","usage",323,330
62,15,333,2,76,"cvs_add@58-134@usr.bin/cvs/add.c","usr.bin/cvs/add.c","cvs_add",58,134
15,2,86,1,17,"cvs_add_entry@137-154@usr.bin/cvs/add.c","usr.bin/cvs/add.c","cvs_add_entry",137,154
19,8,112,1,22,"cvs_add_local@157-179@usr.bin/cvs/add.c","usr.bin/cvs/add.c","cvs_add_local",157,179
18,4,128,1,21,"cvs_add_remote@182-203@usr.bin/cvs/add.c","usr.bin/cvs/add.c","cvs_add_remote",182,203
16,2,102,1,21,"cvs_add_loginfo@206-227@usr.bin/cvs/add.c","usr.bin/cvs/add.c","cvs_add_loginfo",206,227
51,13,421,2,67,"cvs_add_tobranch@230-297@usr.bin/cvs/add.c","usr.bin/cvs/add.c","cvs_add_tobranch",230,297
90,15,625,1,107,"add_directory@300-407@usr.bin/cvs/add.c","usr.bin/cvs/add.c","add_directory",300,407
74,21,387,1,84,"add_file@410-494@usr.bin/cvs/add.c","usr.bin/cvs/add.c","add_file",410,494
56,12,420,1,68,"add_entry@497-565@usr.bin/cvs/add.c","usr.bin/cvs/add.c","add_entry",497,565
132,41,625,2,154,"cvs_admin@57-211@usr.bin/cvs/admin.c","usr.bin/cvs/admin.c","cvs_admin",57,211
134,37,974,1,179,"cvs_admin_local@214-393@usr.bin/cvs/admin.c","usr.bin/cvs/admin.c","cvs_admin_local",214,393
76,24,396,2,93,"cvs_annotate@58-151@usr.bin/cvs/annotate.c","usr.bin/cvs/annotate.c","cvs_annotate",58,151
70,17,495,1,98,"cvs_annotate_local@154-252@usr.bin/cvs/annotate.c","usr.bin/cvs/annotate.c","cvs_annotate_local",154,252
28,7,158,4,28,"atomicio@41-69@usr.bin/cvs/atomicio.c","usr.bin/cvs/atomicio.c","atomicio",41,69
12,2,63,1,15,"buf_alloc@60-75@usr.bin/cvs/buf.c","usr.bin/cvs/buf.c","buf_alloc",60,75
11,2,66,1,12,"buf_load@83-95@usr.bin/cvs/buf.c","usr.bin/cvs/buf.c","buf_load",83,95
16,5,131,1,19,"buf_load_fd@98-117@usr.bin/cvs/buf.c","usr.bin/cvs/buf.c","buf_load_fd",98,117
7,2,28,1,6,"buf_free@120-126@usr.bin/cvs/buf.c","usr.bin/cvs/buf.c","buf_free",120,126
7,1,28,1,7,"buf_release@133-140@usr.bin/cvs/buf.c","usr.bin/cvs/buf.c","buf_release",133,140
9,2,54,2,9,"buf_putc@146-155@usr.bin/cvs/buf.c","usr.bin/cvs/buf.c","buf_putc",146,155
4,1,25,2,3,"buf_puts@161-164@usr.bin/cvs/buf.c","usr.bin/cvs/buf.c","buf_puts",161,164
11,2,70,3,13,"buf_append@172-185@usr.bin/cvs/buf.c","usr.bin/cvs/buf.c","buf_append",172,185
4,1,15,1,3,"buf_len@191-194@usr.bin/cvs/buf.c","usr.bin/cvs/buf.c","buf_len",191,194
6,2,43,2,5,"buf_write_fd@200-205@usr.bin/cvs/buf.c","usr.bin/cvs/buf.c","buf_write_fd",200,205
19,6,137,3,22,"buf_write@212-234@usr.bin/cvs/buf.c","usr.bin/cvs/buf.c","buf_write",212,234
18,6,136,3,23,"buf_write_stmp@243-266@usr.bin/cvs/buf.c","usr.bin/cvs/buf.c","buf_write_stmp",243,266
4,1,15,1,3,"buf_get@269-272@usr.bin/cvs/buf.c","usr.bin/cvs/buf.c","buf_get",269,272
6,2,47,2,6,"buf_differ@275-281@usr.bin/cvs/buf.c","usr.bin/cvs/buf.c","buf_differ",275,281
5,1,36,2,4,"buf_grow@288-292@usr.bin/cvs/buf.c","usr.bin/cvs/buf.c","buf_grow",288,292
88,28,387,2,95,"cvs_checkout@79-174@usr.bin/cvs/checkout.c","usr.bin/cvs/checkout.c","cvs_checkout",79,174
47,13,210,2,54,"cvs_export@177-231@usr.bin/cvs/checkout.c","usr.bin/cvs/checkout.c","cvs_export",177,231
119,33,754,2,151,"checkout_check_repository@234-385@usr.bin/cvs/checkout.c","usr.bin/cvs/checkout.c","checkout_check_repository",234,385
30,7,208,2,34,"checkout_classify@388-422@usr.bin/cvs/checkout.c","usr.bin/cvs/checkout.c","checkout_classify",388,422
33,7,195,2,39,"checkout_repository@425-464@usr.bin/cvs/checkout.c","usr.bin/cvs/checkout.c","checkout_repository",425,464
143,40,1084,4,170,"cvs_checkout_file@467-637@usr.bin/cvs/checkout.c","usr.bin/cvs/checkout.c","cvs_checkout_file",467,637
20,4,112,1,22,"client_get_supported_responses@131-153@usr.bin/cvs/client.c","usr.bin/cvs/client.c","client_get_supported_responses",131,153
28,8,196,2,38,"client_check_directory@156-194@usr.bin/cvs/client.c","usr.bin/cvs/client.c","client_check_directory",156,194
88,23,585,1,114,"cvs_client_connect_to_server@197-311@usr.bin/cvs/client.c","usr.bin/cvs/client.c","cvs_client_connect_to_server",197,311
24,6,149,2,30,"cvs_client_send_request@314-344@usr.bin/cvs/client.c","usr.bin/cvs/client.c","cvs_client_send_request",314,344
15,4,97,1,19,"cvs_client_read_response@347-366@usr.bin/cvs/client.c","usr.bin/cvs/client.c","cvs_client_read_response",347,366
6,2,20,1,6,"cvs_client_get_responses@369-375@usr.bin/cvs/client.c","usr.bin/cvs/client.c","cvs_client_get_responses",369,375
16,4,115,1,18,"cvs_client_send_logmsg@378-396@usr.bin/cvs/client.c","usr.bin/cvs/client.c","cvs_client_send_logmsg",378,396
39,16,324,1,50,"cvs_client_senddir@399-449@usr.bin/cvs/client.c","usr.bin/cvs/client.c","cvs_client_senddir",399,449
80,24,570,1,91,"cvs_client_sendfile@452-543@usr.bin/cvs/client.c","usr.bin/cvs/client.c","cvs_client_sendfile",452,543
6,2,37,2,6,"cvs_client_send_files@546-552@usr.bin/cvs/client.c","usr.bin/cvs/client.c","cvs_client_send_files",546,552
5,1,16,1,4,"cvs_client_ok@555-559@usr.bin/cvs/client.c","usr.bin/cvs/client.c","cvs_client_ok",555,559
5,1,16,1,4,"cvs_client_error@562-566@usr.bin/cvs/client.c","usr.bin/cvs/client.c","cvs_client_error",562,566
25,9,155,1,29,"cvs_client_validreq@569-598@usr.bin/cvs/client.c","usr.bin/cvs/client.c","cvs_client_validreq",569,598
6,2,28,1,6,"cvs_client_e@601-607@usr.bin/cvs/client.c","usr.bin/cvs/client.c","cvs_client_e",601,607
6,2,24,1,6,"cvs_client_m@610-616@usr.bin/cvs/client.c","usr.bin/cvs/client.c","cvs_client_m",610,616
52,10,401,1,63,"cvs_client_checkedin@619-682@usr.bin/cvs/client.c","usr.bin/cvs/client.c","cvs_client_checkedin",619,682
77,12,600,1,100,"cvs_client_updated@685-785@usr.bin/cvs/client.c","usr.bin/cvs/client.c","cvs_client_updated",685,785
57,8,426,1,74,"cvs_client_merged@788-862@usr.bin/cvs/client.c","usr.bin/cvs/client.c","cvs_client_merged",788,862
16,3,109,1,20,"cvs_client_removed@865-885@usr.bin/cvs/client.c","usr.bin/cvs/client.c","cvs_client_removed",865,885
14,3,80,1,17,"cvs_client_remove_entry@888-905@usr.bin/cvs/client.c","usr.bin/cvs/client.c","cvs_client_remove_entry",888,905
19,4,108,1,24,"cvs_client_set_static_directory@908-932@usr.bin/cvs/client.c","usr.bin/cvs/client.c","cvs_client_set_static_directory",908,932
14,3,76,1,19,"cvs_client_clear_static_directory@935-954@usr.bin/cvs/client.c","usr.bin/cvs/client.c","cvs_client_clear_static_directory",935,954
23,4,145,1,30,"cvs_client_set_sticky@957-987@usr.bin/cvs/client.c","usr.bin/cvs/client.c","cvs_client_set_sticky",957,987
16,3,90,1,22,"cvs_client_clear_sticky@990-1012@usr.bin/cvs/client.c","usr.bin/cvs/client.c","cvs_client_clear_sticky",990,1012
92,26,636,1,112,"cvs_client_initlog@1024-1136@usr.bin/cvs/client.c","usr.bin/cvs/client.c","cvs_client_initlog",1024,1136
20,6,125,1,21,"cvs_findcmd@67-88@usr.bin/cvs/cmd.c","usr.bin/cvs/cmd.c","cvs_findcmd",67,88
134,28,737,2,163,"cvs_commit@64-227@usr.bin/cvs/commit.c","usr.bin/cvs/commit.c","cvs_commit",64,227
42,5,268,1,57,"cvs_commit_loginfo@230-287@usr.bin/cvs/commit.c","usr.bin/cvs/commit.c","cvs_commit_loginfo",230,287
7,1,45,1,9,"cvs_commit_lock_dirs@290-299@usr.bin/cvs/commit.c","usr.bin/cvs/commit.c","cvs_commit_lock_dirs",290,299
81,29,449,1,95,"cvs_commit_check_files@302-397@usr.bin/cvs/commit.c","usr.bin/cvs/commit.c","cvs_commit_check_files",302,397
234,66,1598,1,285,"cvs_commit_local@400-685@usr.bin/cvs/commit.c","usr.bin/cvs/commit.c","cvs_commit_local",400,685
30,5,222,3,38,"commit_diff@688-726@usr.bin/cvs/commit.c","usr.bin/cvs/commit.c","commit_diff",688,726
17,2,118,1,22,"commit_desc_set@729-751@usr.bin/cvs/commit.c","usr.bin/cvs/commit.c","commit_desc_set",729,751
5,1,20,1,4,"cvs_parse_configfile@31-35@usr.bin/cvs/config.c","usr.bin/cvs/config.c","cvs_parse_configfile",31,35
35,11,250,2,39,"config_parse_line@38-77@usr.bin/cvs/config.c","usr.bin/cvs/config.c","config_parse_line",38,77
33,9,229,2,39,"cvs_read_config@80-119@usr.bin/cvs/config.c","usr.bin/cvs/config.c","cvs_read_config",80,119
13,4,36,1,13,"sighandler@88-101@usr.bin/cvs/cvs.c","usr.bin/cvs/cvs.c","sighandler",88,101
17,4,85,1,19,"cvs_cleanup@104-123@usr.bin/cvs/cvs.c","usr.bin/cvs/cvs.c","cvs_cleanup",104,123
7,1,24,1,6,"usage@126-132@usr.bin/cvs/cvs.c","usr.bin/cvs/cvs.c","usage",126,132
36,8,253,3,44,"cvs_build_cmd@135-179@usr.bin/cvs/cvs.c","usr.bin/cvs/cvs.c","cvs_build_cmd",135,179
110,28,751,2,146,"main@182-328@usr.bin/cvs/cvs.c","usr.bin/cvs/cvs.c","main",182,328
78,23,316,2,90,"cvs_getopt@331-421@usr.bin/cvs/cvs.c","usr.bin/cvs/cvs.c","cvs_getopt",331,421
71,20,417,1,96,"cvs_read_rcfile@431-527@usr.bin/cvs/cvs.c","usr.bin/cvs/cvs.c","cvs_read_rcfile",431,527
27,8,187,2,35,"cvs_var_set@537-572@usr.bin/cvs/cvs.c","usr.bin/cvs/cvs.c","cvs_var_set",537,572
13,2,78,1,14,"cvs_var_unset@581-595@usr.bin/cvs/cvs.c","usr.bin/cvs/cvs.c","cvs_var_unset",581,595
8,2,48,1,9,"cvs_var_get@605-614@usr.bin/cvs/cvs.c","usr.bin/cvs/cvs.c","cvs_var_get",605,614
206,68,1102,2,229,"cvs_diff@69-298@usr.bin/cvs/diff.c","usr.bin/cvs/diff.c","cvs_diff",69,298
281,103,1871,1,320,"cvs_diff_local@301-621@usr.bin/cvs/diff.c","usr.bin/cvs/diff.c","cvs_diff_local",301,621
93,15,815,2,116,"cvs_merge_file@157-273@usr.bin/cvs/diff3.c","usr.bin/cvs/diff3.c","cvs_merge_file",157,273
30,4,243,4,39,"diff3_internal@276-315@usr.bin/cvs/diff3.c","usr.bin/cvs/diff3.c","diff3_internal",276,315
87,31,627,2,111,"ed_patch_lines@318-429@usr.bin/cvs/diff3.c","usr.bin/cvs/diff3.c","ed_patch_lines",318,429
40,9,316,2,44,"readin@438-482@usr.bin/cvs/diff3.c","usr.bin/cvs/diff3.c","readin",438,482
8,2,49,1,9,"number@485-494@usr.bin/cvs/diff3.c","usr.bin/cvs/diff3.c","number",485,494
9,3,51,1,10,"getchange@497-507@usr.bin/cvs/diff3.c","usr.bin/cvs/diff3.c","getchange",497,507
23,6,143,2,25,"get_line@510-535@usr.bin/cvs/diff3.c","usr.bin/cvs/diff3.c","get_line",510,535
84,27,753,2,109,"merge@538-647@usr.bin/cvs/diff3.c","usr.bin/cvs/diff3.c","merge",538,647
4,1,16,1,3,"separate@650-653@usr.bin/cvs/diff3.c","usr.bin/cvs/diff3.c","separate",650,653
11,3,75,3,10,"change@661-671@usr.bin/cvs/diff3.c","usr.bin/cvs/diff3.c","change",661,671
11,3,70,1,10,"prange@677-687@usr.bin/cvs/diff3.c","usr.bin/cvs/diff3.c","prange",677,687
9,1,61,2,9,"keep@695-704@usr.bin/cvs/diff3.c","usr.bin/cvs/diff3.c","keep",695,704
13,4,98,3,13,"skip@711-724@usr.bin/cvs/diff3.c","usr.bin/cvs/diff3.c","skip",711,724
26,7,180,2,26,"duplicate@731-757@usr.bin/cvs/diff3.c","usr.bin/cvs/diff3.c","duplicate",731,757
6,2,42,1,6,"repos@760-766@usr.bin/cvs/diff3.c","usr.bin/cvs/diff3.c","repos",760,766
14,3,152,3,13,"edit@772-785@usr.bin/cvs/diff3.c","usr.bin/cvs/diff3.c","edit",772,785
26,9,228,1,28,"edscript@789-817@usr.bin/cvs/diff3.c","usr.bin/cvs/diff3.c","edscript",789,817
15,2,161,1,17,"increase@820-837@usr.bin/cvs/diff3.c","usr.bin/cvs/diff3.c","increase",820,837
97,20,734,6,117,"diffreg@303-420@usr.bin/cvs/diff_internals.c","usr.bin/cvs/diff_internals.c","diffreg",303,420
19,10,150,2,19,"files_differ@428-447@usr.bin/cvs/diff_internals.c","usr.bin/cvs/diff_internals.c","files_differ",428,447
20,5,160,4,22,"prepare@450-472@usr.bin/cvs/diff_internals.c","usr.bin/cvs/diff_internals.c","prepare",450,472
18,9,186,1,18,"prune@475-493@usr.bin/cvs/diff_internals.c","usr.bin/cvs/diff_internals.c","prune",475,493
25,8,200,5,25,"equiv@496-521@usr.bin/cvs/diff_internals.c","usr.bin/cvs/diff_internals.c","equiv",496,521
13,4,71,1,15,"isqrt@525-540@usr.bin/cvs/diff_internals.c","usr.bin/cvs/diff_internals.c","isqrt",525,540
44,10,293,5,45,"stone@543-588@usr.bin/cvs/diff_internals.c","usr.bin/cvs/diff_internals.c","stone",543,588
13,2,79,3,13,"newcand@591-604@usr.bin/cvs/diff_internals.c","usr.bin/cvs/diff_internals.c","newcand",591,604
21,6,125,3,21,"search@607-628@usr.bin/cvs/diff_internals.c","usr.bin/cvs/diff_internals.c","search",607,628
10,5,102,1,10,"unravel@631-641@usr.bin/cvs/diff_internals.c","usr.bin/cvs/diff_internals.c","unravel",631,641
87,39,553,3,96,"check@650-746@usr.bin/cvs/diff_internals.c","usr.bin/cvs/diff_internals.c","check",650,746
29,10,233,2,29,"sort@750-779@usr.bin/cvs/diff_internals.c","usr.bin/cvs/diff_internals.c","sort",750,779
10,3,95,3,10,"unsort@782-792@usr.bin/cvs/diff_internals.c","usr.bin/cvs/diff_internals.c","unsort",782,792
7,3,44,1,7,"skipline@795-802@usr.bin/cvs/diff_internals.c","usr.bin/cvs/diff_internals.c","skipline",795,802
35,13,277,3,37,"output@805-842@usr.bin/cvs/diff_internals.c","usr.bin/cvs/diff_internals.c","output",805,842
6,3,42,3,5,"range@845-850@usr.bin/cvs/diff_internals.c","usr.bin/cvs/diff_internals.c","range",845,850
9,3,51,2,8,"uni_range@853-861@usr.bin/cvs/diff_internals.c","usr.bin/cvs/diff_internals.c","uni_range",853,861
10,2,70,3,10,"preadline@864-874@usr.bin/cvs/diff_internals.c","usr.bin/cvs/diff_internals.c","preadline",864,874
7,1,39,1,7,"ignoreline@877-884@usr.bin/cvs/diff_internals.c","usr.bin/cvs/diff_internals.c","ignoreline",877,884
29,6,209,1,36,"diff_head@887-923@usr.bin/cvs/diff_internals.c","usr.bin/cvs/diff_internals.c","diff_head",887,923
26,5,190,1,31,"rdiff_head@926-957@usr.bin/cvs/diff_internals.c","usr.bin/cvs/diff_internals.c","rdiff_head",926,957
89,36,597,7,106,"change@967-1073@usr.bin/cvs/diff_internals.c","usr.bin/cvs/diff_internals.c","change",967,1073
58,24,360,7,63,"fetch@1076-1139@usr.bin/cvs/diff_internals.c","usr.bin/cvs/diff_internals.c","fetch",1076,1139
54,21,272,2,59,"readhash@1145-1204@usr.bin/cvs/diff_internals.c","usr.bin/cvs/diff_internals.c","readhash",1145,1204
13,5,95,1,14,"asciifile@1207-1221@usr.bin/cvs/diff_internals.c","usr.bin/cvs/diff_internals.c","asciifile",1207,1221
40,15,269,3,40,"match_function@1226-1266@usr.bin/cvs/diff_internals.c","usr.bin/cvs/diff_internals.c","match_function",1226,1266
85,22,600,3,99,"dump_context_vec@1270-1369@usr.bin/cvs/diff_internals.c","usr.bin/cvs/diff_internals.c","dump_context_vec",1270,1369
54,11,434,3,69,"dump_unified_vec@1373-1442@usr.bin/cvs/diff_internals.c","usr.bin/cvs/diff_internals.c","dump_unified_vec",1373,1442
16,3,83,2,16,"diff_output@1445-1461@usr.bin/cvs/diff_internals.c","usr.bin/cvs/diff_internals.c","diff_output",1445,1461
58,15,312,2,69,"cvs_edit@77-146@usr.bin/cvs/edit.c","usr.bin/cvs/edit.c","cvs_edit",77,146
42,8,208,2,52,"cvs_editors@149-201@usr.bin/cvs/edit.c","usr.bin/cvs/edit.c","cvs_editors",149,201
42,8,208,2,52,"cvs_unedit@204-256@usr.bin/cvs/edit.c","usr.bin/cvs/edit.c","cvs_unedit",204,256
43,12,359,1,58,"cvs_edit_local@259-317@usr.bin/cvs/edit.c","usr.bin/cvs/edit.c","cvs_edit_local",259,317
3,1,9,1,2,"cvs_editors_local@320-322@usr.bin/cvs/edit.c","usr.bin/cvs/edit.c","cvs_editors_local",320,322
70,14,563,1,97,"cvs_unedit_local@325-422@usr.bin/cvs/edit.c","usr.bin/cvs/edit.c","cvs_unedit_local",325,422
61,18,421,2,72,"cvs_base_handle@425-497@usr.bin/cvs/edit.c","usr.bin/cvs/edit.c","cvs_base_handle",425,497
63,14,505,1,82,"cvs_ent_open@35-117@usr.bin/cvs/entries.c","usr.bin/cvs/entries.c","cvs_ent_open",35,117
102,28,729,1,117,"cvs_ent_parse@120-237@usr.bin/cvs/entries.c","usr.bin/cvs/entries.c","cvs_ent_parse",120,237
10,2,57,2,11,"cvs_ent_get@240-251@usr.bin/cvs/entries.c","usr.bin/cvs/entries.c","cvs_ent_get",240,251
39,9,260,2,48,"cvs_ent_close@254-302@usr.bin/cvs/entries.c","usr.bin/cvs/entries.c","cvs_ent_close",254,302
24,5,191,2,31,"cvs_ent_add@305-336@usr.bin/cvs/entries.c","usr.bin/cvs/entries.c","cvs_ent_add",305,336
20,4,146,2,25,"cvs_ent_remove@339-364@usr.bin/cvs/entries.c","usr.bin/cvs/entries.c","cvs_ent_remove",339,364
10,3,92,9,10,"cvs_ent_line_str@373-383@usr.bin/cvs/entries.c","usr.bin/cvs/entries.c","cvs_ent_line_str",373,383
7,1,35,1,6,"cvs_ent_free@386-392@usr.bin/cvs/entries.c","usr.bin/cvs/entries.c","cvs_ent_free",386,392
20,4,137,2,25,"ent_get_line@395-420@usr.bin/cvs/entries.c","usr.bin/cvs/entries.c","ent_get_line",395,420
65,20,405,4,76,"cvs_parse_tagfile@423-499@usr.bin/cvs/entries.c","usr.bin/cvs/entries.c","cvs_parse_tagfile",423,499
45,14,296,3,50,"cvs_write_tagfile@502-552@usr.bin/cvs/entries.c","usr.bin/cvs/entries.c","cvs_write_tagfile",502,552
17,4,86,2,21,"fatal@38-59@usr.bin/cvs/fatal.c","usr.bin/cvs/fatal.c","fatal",38,59
28,7,191,1,36,"cvs_file_init@90-126@usr.bin/cvs/file.c","usr.bin/cvs/file.c","cvs_file_init",90,126
18,4,124,2,21,"cvs_file_ignore@129-150@usr.bin/cvs/file.c","usr.bin/cvs/file.c","cvs_file_ignore",129,150
30,11,214,1,34,"cvs_file_chkign@153-187@usr.bin/cvs/file.c","usr.bin/cvs/file.c","cvs_file_chkign",153,187
12,2,81,3,14,"cvs_file_run@190-204@usr.bin/cvs/file.c","usr.bin/cvs/file.c","cvs_file_run",190,204
17,4,130,4,20,"cvs_file_get@207-227@usr.bin/cvs/file.c","usr.bin/cvs/file.c","cvs_file_get",207,227
24,6,183,6,29,"cvs_file_get_cf@230-259@usr.bin/cvs/file.c","usr.bin/cvs/file.c","cvs_file_get_cf",230,259
106,31,685,2,127,"cvs_file_walklist@262-389@usr.bin/cvs/file.c","usr.bin/cvs/file.c","cvs_file_walklist",262,389
176,54,1160,2,231,"cvs_file_walkdir@392-623@usr.bin/cvs/file.c","usr.bin/cvs/file.c","cvs_file_walkdir",392,623
10,2,70,1,10,"cvs_file_freelist@626-636@usr.bin/cvs/file.c","usr.bin/cvs/file.c","cvs_file_freelist",626,636
297,117,1812,2,332,"cvs_file_classify@639-971@usr.bin/cvs/file.c","usr.bin/cvs/file.c","cvs_file_classify",639,971
17,5,117,1,16,"cvs_file_free@974-990@usr.bin/cvs/file.c","usr.bin/cvs/file.c","cvs_file_free",974,990
5,2,39,2,4,"cvs_file_cmpname@993-997@usr.bin/cvs/file.c","usr.bin/cvs/file.c","cvs_file_cmpname",993,997
46,14,401,2,59,"cvs_file_cmp@1000-1059@usr.bin/cvs/file.c","usr.bin/cvs/file.c","cvs_file_cmp",1000,1059
55,10,417,2,70,"cvs_file_copy@1062-1132@usr.bin/cvs/file.c","usr.bin/cvs/file.c","cvs_file_copy",1062,1132
4,1,28,2,3,"cvs_filelist_cmp@1135-1138@usr.bin/cvs/file.c","usr.bin/cvs/file.c","cvs_filelist_cmp",1135,1138
100,34,508,2,123,"cvs_getlog@73-196@usr.bin/cvs/getlog.c","usr.bin/cvs/getlog.c","cvs_getlog",73,196
87,27,656,1,111,"cvs_log_local@199-310@usr.bin/cvs/getlog.c","usr.bin/cvs/getlog.c","cvs_log_local",199,310
66,15,464,1,89,"log_rev_print@313-402@usr.bin/cvs/getlog.c","usr.bin/cvs/getlog.c","log_rev_print",313,402
11,2,79,2,14,"push_date@405-419@usr.bin/cvs/getlog.c","usr.bin/cvs/getlog.c","push_date",405,419
129,45,717,2,150,"date_select@422-572@usr.bin/cvs/getlog.c","usr.bin/cvs/getlog.c","date_select",422,572
18,6,128,2,22,"hash_table_init@30-52@usr.bin/cvs/hash.c","usr.bin/cvs/hash.c","hash_table_init",30,52
12,1,105,2,13,"hash_table_enter@55-68@usr.bin/cvs/hash.c","usr.bin/cvs/hash.c","hash_table_enter",55,68
13,2,100,3,15,"hash_table_find@71-86@usr.bin/cvs/hash.c","usr.bin/cvs/hash.c","hash_table_find",71,86
31,11,117,2,35,"hash4@42-77@usr.bin/cvs/hash_func.c","usr.bin/cvs/hash_func.c","hash4",42,77
106,39,690,3,122,"cvs_history_add@66-188@usr.bin/cvs/history.c","usr.bin/cvs/history.c","cvs_history_add",66,188
21,5,120,2,26,"history_compress@191-217@usr.bin/cvs/history.c","usr.bin/cvs/history.c","history_compress",191,217
20,4,90,2,23,"cvs_history@220-243@usr.bin/cvs/history.c","usr.bin/cvs/history.c","cvs_history",220,243
106,20,592,2,129,"cvs_import@68-197@usr.bin/cvs/import.c","usr.bin/cvs/import.c","cvs_import",68,197
12,2,69,2,14,"import_printf@200-214@usr.bin/cvs/import.c","usr.bin/cvs/import.c","import_printf",200,214
7,3,48,1,8,"cvs_import_ignored@217-225@usr.bin/cvs/import.c","usr.bin/cvs/import.c","cvs_import_ignored",217,225
30,10,198,1,39,"cvs_import_local@228-267@usr.bin/cvs/import.c","usr.bin/cvs/import.c","cvs_import_local",228,267
26,5,187,1,31,"import_loginfo@270-301@usr.bin/cvs/import.c","usr.bin/cvs/import.c","import_loginfo",270,301
62,16,506,1,83,"import_new@304-387@usr.bin/cvs/import.c","usr.bin/cvs/import.c","import_new",304,387
50,14,383,1,64,"import_update@390-454@usr.bin/cvs/import.c","usr.bin/cvs/import.c","import_update",390,454
9,3,66,3,10,"import_tag@457-467@usr.bin/cvs/import.c","usr.bin/cvs/import.c","import_tag",457,467
23,2,174,2,31,"import_get_rcsdiff@470-501@usr.bin/cvs/import.c","usr.bin/cvs/import.c","import_get_rcsdiff",470,501
13,3,59,2,14,"cvs_init@84-98@usr.bin/cvs/init.c","usr.bin/cvs/init.c","cvs_init",84,98
17,3,124,1,23,"cvs_init_local@101-124@usr.bin/cvs/init.c","usr.bin/cvs/init.c","cvs_init_local",101,124
12,6,78,2,12,"init_mkdir@127-139@usr.bin/cvs/init.c","usr.bin/cvs/init.c","init_mkdir",127,139
37,10,313,2,51,"init_mkfile@142-193@usr.bin/cvs/init.c","usr.bin/cvs/init.c","init_mkfile",142,193
7,1,38,3,7,"cvs_log@44-51@usr.bin/cvs/log.c","usr.bin/cvs/log.c","cvs_log",44,51
48,13,271,3,58,"cvs_vlog@60-118@usr.bin/cvs/log.c","usr.bin/cvs/log.c","cvs_vlog",60,118
34,11,225,2,43,"cvs_printf@127-170@usr.bin/cvs/log.c","usr.bin/cvs/log.c","cvs_printf",127,170
41,9,290,1,51,"cvs_logmsg_read@41-92@usr.bin/cvs/logmsg.c","usr.bin/cvs/logmsg.c","cvs_logmsg_read",41,92
138,39,956,4,159,"cvs_logmsg_create@95-254@usr.bin/cvs/logmsg.c","usr.bin/cvs/logmsg.c","cvs_logmsg_create",95,254
38,6,266,1,40,"cvs_logmsg_edit@263-303@usr.bin/cvs/logmsg.c","usr.bin/cvs/logmsg.c","cvs_logmsg_edit",263,303
29,4,189,1,34,"cvs_logmsg_verify@306-340@usr.bin/cvs/logmsg.c","usr.bin/cvs/logmsg.c","cvs_logmsg_verify",306,340
6,1,25,1,6,"cvs_parse_modules@35-41@usr.bin/cvs/modules.c","usr.bin/cvs/modules.c","cvs_parse_modules",35,41
6,1,29,1,6,"cvs_modules_list@44-50@usr.bin/cvs/modules.c","usr.bin/cvs/modules.c","cvs_modules_list",44,50
137,40,850,2,161,"modules_parse_line@53-214@usr.bin/cvs/modules.c","usr.bin/cvs/modules.c","modules_parse_line",53,214
25,2,170,1,28,"cvs_module_lookup@217-245@usr.bin/cvs/modules.c","usr.bin/cvs/modules.c","cvs_module_lookup",217,245
48,8,342,4,58,"rcs_open@154-212@usr.bin/cvs/rcs.c","usr.bin/cvs/rcs.c","rcs_open",154,212
45,9,346,1,51,"rcs_close@220-271@usr.bin/cvs/rcs.c","usr.bin/cvs/rcs.c","rcs_close",220,271
129,21,1057,1,156,"rcs_write@280-436@usr.bin/cvs/rcs.c","usr.bin/cvs/rcs.c","rcs_write",280,436
35,9,235,1,44,"rcs_head_get@444-488@usr.bin/cvs/rcs.c","usr.bin/cvs/rcs.c","rcs_head_get",444,488
10,3,67,2,11,"rcs_head_set@497-508@usr.bin/cvs/rcs.c","usr.bin/cvs/rcs.c","rcs_head_set",497,508
20,7,116,2,24,"rcs_branch_new@516-540@usr.bin/cvs/rcs.c","usr.bin/cvs/rcs.c","rcs_branch_new",516,540
4,1,15,1,3,"rcs_branch_get@550-553@usr.bin/cvs/rcs.c","usr.bin/cvs/rcs.c","rcs_branch_get",550,553
8,2,51,2,8,"rcs_branch_set@562-570@usr.bin/cvs/rcs.c","usr.bin/cvs/rcs.c","rcs_branch_set",562,570
13,2,97,2,17,"rcs_access_add@579-596@usr.bin/cvs/rcs.c","usr.bin/cvs/rcs.c","rcs_access_add",579,596
14,3,95,2,18,"rcs_access_remove@606-624@usr.bin/cvs/rcs.c","usr.bin/cvs/rcs.c","rcs_access_remove",606,624
17,3,133,3,23,"rcs_sym_add@633-656@usr.bin/cvs/rcs.c","usr.bin/cvs/rcs.c","rcs_sym_add",633,656
17,4,116,2,22,"rcs_sym_remove@667-689@usr.bin/cvs/rcs.c","usr.bin/cvs/rcs.c","rcs_sym_remove",667,689
8,2,54,2,9,"rcs_sym_get@699-708@usr.bin/cvs/rcs.c","usr.bin/cvs/rcs.c","rcs_sym_get",699,708
21,6,137,2,25,"rcs_sym_getrev@719-744@usr.bin/cvs/rcs.c","usr.bin/cvs/rcs.c","rcs_sym_getrev",719,744
15,5,86,1,17,"rcs_sym_check@753-770@usr.bin/cvs/rcs.c","usr.bin/cvs/rcs.c","rcs_sym_check",753,770
4,2,21,1,3,"rcs_lock_getmode@778-781@usr.bin/cvs/rcs.c","usr.bin/cvs/rcs.c","rcs_lock_getmode",778,781
13,3,65,2,14,"rcs_lock_setmode@791-805@usr.bin/cvs/rcs.c","usr.bin/cvs/rcs.c","rcs_lock_setmode",791,805
16,3,133,3,21,"rcs_lock_add@814-835@usr.bin/cvs/rcs.c","usr.bin/cvs/rcs.c","rcs_lock_add",814,835
17,4,121,3,21,"rcs_lock_remove@845-866@usr.bin/cvs/rcs.c","usr.bin/cvs/rcs.c","rcs_lock_remove",845,866
4,1,15,1,3,"rcs_desc_get@874-877@usr.bin/cvs/rcs.c","usr.bin/cvs/rcs.c","rcs_desc_get",874,877
8,1,43,2,8,"rcs_desc_set@885-893@usr.bin/cvs/rcs.c","usr.bin/cvs/rcs.c","rcs_desc_set",885,893
12,4,87,1,13,"rcs_comment_lookup@902-915@usr.bin/cvs/rcs.c","usr.bin/cvs/rcs.c","rcs_comment_lookup",902,915
4,1,15,1,3,"rcs_comment_get@923-926@usr.bin/cvs/rcs.c","usr.bin/cvs/rcs.c","rcs_comment_get",923,926
8,1,43,2,8,"rcs_comment_set@934-942@usr.bin/cvs/rcs.c","usr.bin/cvs/rcs.c","rcs_comment_set",934,942
90,26,646,4,106,"rcs_patch_lines@945-1051@usr.bin/cvs/rcs.c","usr.bin/cvs/rcs.c","rcs_patch_lines",945,1051
40,8,292,3,48,"rcs_delta_stats@1054-1102@usr.bin/cvs/rcs.c","usr.bin/cvs/rcs.c","rcs_delta_stats",1054,1102
83,17,609,5,99,"rcs_rev_add@1117-1216@usr.bin/cvs/rcs.c","usr.bin/cvs/rcs.c","rcs_rev_add",1117,1216
58,16,438,2,84,"rcs_rev_remove@1224-1308@usr.bin/cvs/rcs.c","usr.bin/cvs/rcs.c","rcs_rev_remove",1224,1308
23,11,157,2,31,"rcs_findrev@1319-1350@usr.bin/cvs/rcs.c","usr.bin/cvs/rcs.c","rcs_findrev",1319,1350
24,7,136,2,27,"rcs_kwexp_set@1358-1385@usr.bin/cvs/rcs.c","usr.bin/cvs/rcs.c","rcs_kwexp_set",1358,1385
6,2,31,1,6,"rcs_kwexp_get@1393-1399@usr.bin/cvs/rcs.c","usr.bin/cvs/rcs.c","rcs_kwexp_get",1393,1399
28,11,154,1,30,"rcs_kflag_get@1409-1439@usr.bin/cvs/rcs.c","usr.bin/cvs/rcs.c","rcs_kflag_get",1409,1439
17,2,114,1,19,"rcs_freedelta@1447-1466@usr.bin/cvs/rcs.c","usr.bin/cvs/rcs.c","rcs_freedelta",1447,1466
16,5,120,3,19,"rcs_strprint@1476-1495@usr.bin/cvs/rcs.c","usr.bin/cvs/rcs.c","rcs_strprint",1476,1495
24,4,151,3,30,"rcs_deltatext_set@1504-1534@usr.bin/cvs/rcs.c","usr.bin/cvs/rcs.c","rcs_deltatext_set",1504,1534
10,2,70,3,12,"rcs_rev_setlog@1542-1554@usr.bin/cvs/rcs.c","usr.bin/cvs/rcs.c","rcs_rev_setlog",1542,1554
7,2,49,2,8,"rcs_rev_getdate@1562-1570@usr.bin/cvs/rcs.c","usr.bin/cvs/rcs.c","rcs_rev_getdate",1562,1570
10,2,70,3,14,"rcs_state_set@1581-1595@usr.bin/cvs/rcs.c","usr.bin/cvs/rcs.c","rcs_state_set",1581,1595
6,3,36,1,6,"rcs_state_check@1605-1611@usr.bin/cvs/rcs.c","usr.bin/cvs/rcs.c","rcs_state_check",1605,1611
7,2,44,2,8,"rcs_state_get@1621-1629@usr.bin/cvs/rcs.c","usr.bin/cvs/rcs.c","rcs_state_get",1621,1629
56,15,389,2,81,"rcs_get_revision@1633-1714@usr.bin/cvs/rcs.c","usr.bin/cvs/rcs.c","rcs_get_revision",1633,1714
143,35,927,3,179,"rcs_rev_getlines@1723-1902@usr.bin/cvs/rcs.c","usr.bin/cvs/rcs.c","rcs_rev_getlines",1723,1902
85,21,607,3,113,"rcs_annotate_getlines@1905-2018@usr.bin/cvs/rcs.c","usr.bin/cvs/rcs.c","rcs_annotate_getlines",1905,2018
39,8,258,3,49,"rcs_rev_getbuf@2029-2078@usr.bin/cvs/rcs.c","usr.bin/cvs/rcs.c","rcs_rev_getbuf",2029,2078
52,16,361,4,65,"rcs_rev_write_fd@2087-2152@usr.bin/cvs/rcs.c","usr.bin/cvs/rcs.c","rcs_rev_write_fd",2087,2152
11,3,95,4,14,"rcs_rev_write_stmp@2162-2176@usr.bin/cvs/rcs.c","usr.bin/cvs/rcs.c","rcs_rev_write_stmp",2162,2176
258,71,1775,5,353,"rcs_kwexp_line@2179-2532@usr.bin/cvs/rcs.c","usr.bin/cvs/rcs.c","rcs_kwexp_line",2179,2532
100,30,620,2,125,"rcs_translate_tag@2536-2661@usr.bin/cvs/rcs.c","usr.bin/cvs/rcs.c","rcs_translate_tag",2536,2661
7,1,34,1,8,"rcsnum_alloc@44-52@usr.bin/cvs/rcsnum.c","usr.bin/cvs/rcsnum.c","rcsnum_alloc",44,52
9,3,76,1,9,"rcsnum_addmagic@61-70@usr.bin/cvs/rcsnum.c","usr.bin/cvs/rcsnum.c","rcsnum_addmagic",61,70
11,3,59,1,12,"rcsnum_parse@78-90@usr.bin/cvs/rcsnum.c","usr.bin/cvs/rcsnum.c","rcsnum_parse",78,90
19,7,156,3,21,"rcsnum_tostr@102-123@usr.bin/cvs/rcsnum.c","usr.bin/cvs/rcsnum.c","rcsnum_tostr",102,123
15,3,76,3,16,"rcsnum_itoa@126-142@usr.bin/cvs/rcsnum.c","usr.bin/cvs/rcsnum.c","rcsnum_itoa",126,142
9,3,69,3,10,"rcsnum_cpy@151-161@usr.bin/cvs/rcsnum.c","usr.bin/cvs/rcsnum.c","rcsnum_cpy",151,161
25,11,174,3,32,"rcsnum_cmp@174-206@usr.bin/cvs/rcsnum.c","usr.bin/cvs/rcsnum.c","rcsnum_cmp",174,206
47,14,323,3,87,"rcsnum_aton@218-305@usr.bin/cvs/rcsnum.c","usr.bin/cvs/rcsnum.c","rcsnum_aton",218,305
7,2,45,1,6,"rcsnum_inc@314-320@usr.bin/cvs/rcsnum.c","usr.bin/cvs/rcsnum.c","rcsnum_inc",314,320
7,2,45,1,7,"rcsnum_dec@330-337@usr.bin/cvs/rcsnum.c","usr.bin/cvs/rcsnum.c","rcsnum_dec",330,337
11,3,59,1,14,"rcsnum_revtobr@347-361@usr.bin/cvs/rcsnum.c","usr.bin/cvs/rcsnum.c","rcsnum_revtobr",347,361
12,2,73,1,14,"rcsnum_brtorev@370-384@usr.bin/cvs/rcsnum.c","usr.bin/cvs/rcsnum.c","rcsnum_brtorev",370,384
11,2,67,1,13,"rcsnum_new_branch@387-400@usr.bin/cvs/rcsnum.c","usr.bin/cvs/rcsnum.c","rcsnum_new_branch",387,400
10,2,51,1,11,"rcsnum_branch_root@403-414@usr.bin/cvs/rcsnum.c","usr.bin/cvs/rcsnum.c","rcsnum_branch_root",403,414
4,1,17,2,3,"rcsnum_setsize@417-420@usr.bin/cvs/rcsnum.c","usr.bin/cvs/rcsnum.c","rcsnum_setsize",417,420
12,4,86,2,14,"rcsnum_differ@423-437@usr.bin/cvs/rcsnum.c","usr.bin/cvs/rcsnum.c","rcsnum_differ",423,437
26,5,160,1,32,"rcsparse_init@220-252@usr.bin/cvs/rcsparse.c","usr.bin/cvs/rcsparse.c","rcsparse_init",220,252
24,9,141,2,28,"rcsparse_deltas@263-291@usr.bin/cvs/rcsparse.c","usr.bin/cvs/rcsparse.c","rcsparse_deltas",263,291
24,11,145,2,28,"rcsparse_deltatexts@302-330@usr.bin/cvs/rcsparse.c","usr.bin/cvs/rcsparse.c","rcsparse_deltatexts",302,330
9,2,48,1,10,"rcsparse_free@338-348@usr.bin/cvs/rcsparse.c","usr.bin/cvs/rcsparse.c","rcsparse_free",338,348
15,6,106,1,20,"rcsparse_desc@361-381@usr.bin/cvs/rcsparse.c","usr.bin/cvs/rcsparse.c","rcsparse_desc",361,381
9,1,60,2,10,"rcsparse_deltarevision@395-405@usr.bin/cvs/rcsparse.c","usr.bin/cvs/rcsparse.c","rcsparse_deltarevision",395,405
7,2,53,2,8,"rcsparse_date@417-425@usr.bin/cvs/rcsparse.c","usr.bin/cvs/rcsparse.c","rcsparse_date",417,425
7,2,53,2,8,"rcsparse_author@437-445@usr.bin/cvs/rcsparse.c","usr.bin/cvs/rcsparse.c","rcsparse_author",437,445
7,2,53,2,8,"rcsparse_state@457-465@usr.bin/cvs/rcsparse.c","usr.bin/cvs/rcsparse.c","rcsparse_state",457,465
12,2,84,2,13,"rcsparse_branches@477-490@usr.bin/cvs/rcsparse.c","usr.bin/cvs/rcsparse.c","rcsparse_branches",477,490
11,2,74,2,12,"rcsparse_next@502-514@usr.bin/cvs/rcsparse.c","usr.bin/cvs/rcsparse.c","rcsparse_next",502,514
7,2,53,2,8,"rcsparse_commitid@527-535@usr.bin/cvs/rcsparse.c","usr.bin/cvs/rcsparse.c","rcsparse_commitid",527,535
17,3,105,2,18,"rcsparse_textrevision@549-567@usr.bin/cvs/rcsparse.c","usr.bin/cvs/rcsparse.c","rcsparse_textrevision",549,567
7,2,46,2,8,"rcsparse_log@579-587@usr.bin/cvs/rcsparse.c","usr.bin/cvs/rcsparse.c","rcsparse_log",579,587
15,3,115,2,16,"rcsparse_text@599-615@usr.bin/cvs/rcsparse.c","usr.bin/cvs/rcsparse.c","rcsparse_text",599,615
10,2,61,2,11,"rcsparse_head@627-638@usr.bin/cvs/rcsparse.c","usr.bin/cvs/rcsparse.c","rcsparse_head",627,638
10,2,61,2,11,"rcsparse_branch@651-662@usr.bin/cvs/rcsparse.c","usr.bin/cvs/rcsparse.c","rcsparse_branch",651,662
12,2,82,2,13,"rcsparse_access@674-687@usr.bin/cvs/rcsparse.c","usr.bin/cvs/rcsparse.c","rcsparse_access",674,687
20,4,132,2,21,"rcsparse_symbols@699-720@usr.bin/cvs/rcsparse.c","usr.bin/cvs/rcsparse.c","rcsparse_symbols",699,720
21,4,132,2,22,"rcsparse_locks@732-754@usr.bin/cvs/rcsparse.c","usr.bin/cvs/rcsparse.c","rcsparse_locks",732,754
5,1,31,2,5,"rcsparse_strict@767-772@usr.bin/cvs/rcsparse.c","usr.bin/cvs/rcsparse.c","rcsparse_strict",767,772
10,2,61,2,11,"rcsparse_comment@785-796@usr.bin/cvs/rcsparse.c","usr.bin/cvs/rcsparse.c","rcsparse_comment",785,796
10,2,61,2,11,"rcsparse_expand@809-820@usr.bin/cvs/rcsparse.c","usr.bin/cvs/rcsparse.c","rcsparse_expand",809,820
36,8,206,2,44,"rcsparse_string@834-878@usr.bin/cvs/rcsparse.c","usr.bin/cvs/rcsparse.c","rcsparse_string",834,878
197,50,1209,2,217,"rcsparse_token@881-1098@usr.bin/cvs/rcsparse.c","usr.bin/cvs/rcsparse.c","rcsparse_token",881,1098
37,13,229,2,41,"rcsparse@1101-1142@usr.bin/cvs/rcsparse.c","usr.bin/cvs/rcsparse.c","rcsparse",1101,1142
14,6,85,1,18,"rcsparse_deltatext@1145-1163@usr.bin/cvs/rcsparse.c","usr.bin/cvs/rcsparse.c","rcsparse_deltatext",1145,1163
20,5,118,1,24,"rcsparse_delta@1166-1190@usr.bin/cvs/rcsparse.c","usr.bin/cvs/rcsparse.c","rcsparse_delta",1166,1190
8,1,61,1,8,"rcsparse_growbuf@1200-1208@usr.bin/cvs/rcsparse.c","usr.bin/cvs/rcsparse.c","rcsparse_growbuf",1200,1208
15,10,101,1,18,"valid_login@1215-1233@usr.bin/cvs/rcsparse.c","usr.bin/cvs/rcsparse.c","valid_login",1215,1233
11,4,57,1,12,"valid_commitid@1236-1248@usr.bin/cvs/rcsparse.c","usr.bin/cvs/rcsparse.c","valid_commitid",1236,1248
4,1,34,2,3,"kw_cmp@1251-1254@usr.bin/cvs/rcsparse.c","usr.bin/cvs/rcsparse.c","kw_cmp",1251,1254
16,2,102,3,16,"rcsparse_warnx@1257-1273@usr.bin/cvs/rcsparse.c","usr.bin/cvs/rcsparse.c","rcsparse_warnx",1257,1273
38,7,194,2,48,"cvs_release@44-92@usr.bin/cvs/release.c","usr.bin/cvs/release.c","cvs_release",44,92
60,14,372,1,84,"cvs_release_local@95-179@usr.bin/cvs/release.c","usr.bin/cvs/release.c","cvs_release_local",95,179
10,5,56,1,11,"release_check_files@182-193@usr.bin/cvs/release.c","usr.bin/cvs/release.c","release_check_files",182,193
9,3,64,1,10,"cvs_remote_get_response_info@34-44@usr.bin/cvs/remote.c","usr.bin/cvs/remote.c","cvs_remote_get_response_info",34,44
9,3,64,1,10,"cvs_remote_get_request_info@47-57@usr.bin/cvs/remote.c","usr.bin/cvs/remote.c","cvs_remote_get_request_info",47,57
18,6,103,1,20,"cvs_remote_output@60-80@usr.bin/cvs/remote.c","usr.bin/cvs/remote.c","cvs_remote_output",60,80
36,10,207,1,42,"cvs_remote_input@83-125@usr.bin/cvs/remote.c","usr.bin/cvs/remote.c","cvs_remote_input",83,125
24,8,145,2,30,"cvs_remote_receive_file@128-158@usr.bin/cvs/remote.c","usr.bin/cvs/remote.c","cvs_remote_receive_file",128,158
41,12,319,2,52,"cvs_remote_send_file@161-213@usr.bin/cvs/remote.c","usr.bin/cvs/remote.c","cvs_remote_send_file",161,213
21,6,159,3,27,"cvs_remote_send_file_buf@216-243@usr.bin/cvs/remote.c","usr.bin/cvs/remote.c","cvs_remote_send_file_buf",216,243
40,16,268,1,47,"cvs_remote_classify_file@246-293@usr.bin/cvs/remote.c","usr.bin/cvs/remote.c","cvs_remote_classify_file",246,293
13,4,85,1,16,"cvs_validate_directory@297-313@usr.bin/cvs/remote.c","usr.bin/cvs/remote.c","cvs_validate_directory",297,313
69,17,341,2,78,"cvs_remove@44-122@usr.bin/cvs/remove.c","usr.bin/cvs/remove.c","cvs_remove",44,122
11,4,68,1,10,"cvs_remove_force@125-135@usr.bin/cvs/remove.c","usr.bin/cvs/remove.c","cvs_remove_force",125,135
77,18,463,1,91,"cvs_remove_local@138-229@usr.bin/cvs/remove.c","usr.bin/cvs/remove.c","cvs_remove_local",138,229
8,3,66,1,10,"cvs_repository_unlock@31-41@usr.bin/cvs/repository.c","usr.bin/cvs/repository.c","cvs_repository_unlock",31,41
39,12,259,2,51,"cvs_repository_lock@44-95@usr.bin/cvs/repository.c","usr.bin/cvs/repository.c","cvs_repository_lock",44,95
78,26,474,5,91,"cvs_repository_getdir@98-189@usr.bin/cvs/repository.c","usr.bin/cvs/repository.c","cvs_repository_getdir",98,189
67,17,435,1,91,"cvsroot_parse@60-151@usr.bin/cvs/root.c","usr.bin/cvs/root.c","cvsroot_parse",60,151
33,10,236,1,42,"cvsroot_get@164-206@usr.bin/cvs/root.c","usr.bin/cvs/root.c","cvsroot_get",164,206
6,2,26,1,6,"cvsroot_is_local@209-215@usr.bin/cvs/root.c","usr.bin/cvs/root.c","cvsroot_is_local",209,215
6,2,26,1,6,"cvsroot_is_remote@218-224@usr.bin/cvs/root.c","usr.bin/cvs/root.c","cvsroot_is_remote",218,224
37,10,262,2,52,"cvs_server@93-145@usr.bin/cvs/server.c","usr.bin/cvs/server.c","cvs_server",93,145
14,2,75,2,15,"cvs_server_send_response@148-163@usr.bin/cvs/server.c","usr.bin/cvs/server.c","cvs_server_send_response",148,163
12,5,65,1,14,"cvs_server_root@166-180@usr.bin/cvs/server.c","usr.bin/cvs/server.c","cvs_server_root",166,180
25,9,155,1,29,"cvs_server_validresp@183-212@usr.bin/cvs/server.c","usr.bin/cvs/server.c","cvs_server_validresp",183,212
22,4,126,1,26,"cvs_server_validreq@215-241@usr.bin/cvs/server.c","usr.bin/cvs/server.c","cvs_server_validreq",215,241
12,2,70,1,13,"cvs_server_static_directory@244-257@usr.bin/cvs/server.c","usr.bin/cvs/server.c","cvs_server_static_directory",244,257
15,3,93,1,18,"cvs_server_sticky@260-278@usr.bin/cvs/server.c","usr.bin/cvs/server.c","cvs_server_sticky",260,278
17,8,103,1,22,"cvs_server_globalopt@281-303@usr.bin/cvs/server.c","usr.bin/cvs/server.c","cvs_server_globalopt",281,303
12,4,67,1,14,"cvs_server_set@306-320@usr.bin/cvs/server.c","usr.bin/cvs/server.c","cvs_server_set",306,320
32,7,234,1,50,"cvs_server_directory@323-373@usr.bin/cvs/server.c","usr.bin/cvs/server.c","cvs_server_directory",323,373
8,2,37,1,9,"cvs_server_entry@376-385@usr.bin/cvs/server.c","usr.bin/cvs/server.c","cvs_server_entry",376,385
26,5,186,1,36,"cvs_server_modified@388-424@usr.bin/cvs/server.c","usr.bin/cvs/server.c","cvs_server_modified",388,424
3,1,8,1,2,"cvs_server_useunchanged@427-429@usr.bin/cvs/server.c","usr.bin/cvs/server.c","cvs_server_useunchanged",427,429
25,5,193,1,32,"cvs_server_unchanged@432-464@usr.bin/cvs/server.c","usr.bin/cvs/server.c","cvs_server_unchanged",432,464
12,2,66,1,16,"cvs_server_questionable@467-483@usr.bin/cvs/server.c","usr.bin/cvs/server.c","cvs_server_questionable",467,483
9,2,54,1,9,"cvs_server_argument@486-495@usr.bin/cvs/server.c","usr.bin/cvs/server.c","cvs_server_argument",486,495
12,2,92,1,14,"cvs_server_argumentx@498-512@usr.bin/cvs/server.c","usr.bin/cvs/server.c","cvs_server_argumentx",498,512
3,1,8,1,9,"cvs_server_update_patches@515-524@usr.bin/cvs/server.c","usr.bin/cvs/server.c","cvs_server_update_patches",515,524
9,2,52,1,9,"cvs_server_add@527-536@usr.bin/cvs/server.c","usr.bin/cvs/server.c","cvs_server_add",527,536
9,2,52,1,9,"cvs_server_import@539-548@usr.bin/cvs/server.c","usr.bin/cvs/server.c","cvs_server_import",539,548
9,2,52,1,9,"cvs_server_admin@551-560@usr.bin/cvs/server.c","usr.bin/cvs/server.c","cvs_server_admin",551,560
9,2,52,1,9,"cvs_server_annotate@563-572@usr.bin/cvs/server.c","usr.bin/cvs/server.c","cvs_server_annotate",563,572
9,2,52,1,9,"cvs_server_rannotate@575-584@usr.bin/cvs/server.c","usr.bin/cvs/server.c","cvs_server_rannotate",575,584
9,2,52,1,9,"cvs_server_commit@587-596@usr.bin/cvs/server.c","usr.bin/cvs/server.c","cvs_server_commit",587,596
9,2,52,1,9,"cvs_server_checkout@599-608@usr.bin/cvs/server.c","usr.bin/cvs/server.c","cvs_server_checkout",599,608
9,2,52,1,9,"cvs_server_diff@611-620@usr.bin/cvs/server.c","usr.bin/cvs/server.c","cvs_server_diff",611,620
9,2,52,1,9,"cvs_server_rdiff@623-632@usr.bin/cvs/server.c","usr.bin/cvs/server.c","cvs_server_rdiff",623,632
9,2,52,1,9,"cvs_server_export@635-644@usr.bin/cvs/server.c","usr.bin/cvs/server.c","cvs_server_export",635,644
13,4,72,1,15,"cvs_server_init@647-662@usr.bin/cvs/server.c","usr.bin/cvs/server.c","cvs_server_init",647,662
9,2,52,1,9,"cvs_server_release@665-674@usr.bin/cvs/server.c","usr.bin/cvs/server.c","cvs_server_release",665,674
9,2,52,1,9,"cvs_server_remove@677-686@usr.bin/cvs/server.c","usr.bin/cvs/server.c","cvs_server_remove",677,686
9,2,52,1,9,"cvs_server_status@689-698@usr.bin/cvs/server.c","usr.bin/cvs/server.c","cvs_server_status",689,698
9,2,52,1,9,"cvs_server_log@701-710@usr.bin/cvs/server.c","usr.bin/cvs/server.c","cvs_server_log",701,710
9,2,54,1,9,"cvs_server_rlog@713-722@usr.bin/cvs/server.c","usr.bin/cvs/server.c","cvs_server_rlog",713,722
9,2,52,1,9,"cvs_server_tag@725-734@usr.bin/cvs/server.c","usr.bin/cvs/server.c","cvs_server_tag",725,734
9,2,54,1,9,"cvs_server_rtag@737-746@usr.bin/cvs/server.c","usr.bin/cvs/server.c","cvs_server_rtag",737,746
9,2,52,1,9,"cvs_server_update@749-758@usr.bin/cvs/server.c","usr.bin/cvs/server.c","cvs_server_update",749,758
7,1,32,1,6,"cvs_server_version@761-767@usr.bin/cvs/server.c","usr.bin/cvs/server.c","cvs_server_version",761,767
13,3,107,2,16,"cvs_server_update_entry@770-786@usr.bin/cvs/server.c","usr.bin/cvs/server.c","cvs_server_update_entry",770,786
10,1,65,2,11,"cvs_server_set_sticky@789-800@usr.bin/cvs/server.c","usr.bin/cvs/server.c","cvs_server_set_sticky",789,800
9,1,55,1,10,"cvs_server_clear_sticky@803-813@usr.bin/cvs/server.c","usr.bin/cvs/server.c","cvs_server_clear_sticky",803,813
14,2,84,1,17,"cvs_server_exp_modules@816-833@usr.bin/cvs/server.c","usr.bin/cvs/server.c","cvs_server_exp_modules",816,833
49,10,238,2,57,"cvs_status@60-117@usr.bin/cvs/status.c","usr.bin/cvs/status.c","cvs_status",60,117
145,41,1051,1,172,"cvs_status_local@120-292@usr.bin/cvs/status.c","usr.bin/cvs/status.c","cvs_status_local",120,292
136,43,726,2,168,"cvs_tag@67-235@usr.bin/cvs/tag.c","usr.bin/cvs/tag.c","cvs_tag",67,235
72,20,440,1,85,"cvs_tag_check_files@238-323@usr.bin/cvs/tag.c","usr.bin/cvs/tag.c","cvs_tag_check_files",238,323
48,17,213,1,51,"cvs_tag_local@326-377@usr.bin/cvs/tag.c","usr.bin/cvs/tag.c","cvs_tag_local",326,377
8,3,46,1,9,"tag_del@380-389@usr.bin/cvs/tag.c","usr.bin/cvs/tag.c","tag_del",380,389
60,13,392,1,70,"tag_add@392-462@usr.bin/cvs/tag.c","usr.bin/cvs/tag.c","tag_add",392,462
119,51,609,5,139,"expand_args@41-180@usr.bin/cvs/trigger.c","usr.bin/cvs/trigger.c","expand_args",41,180
36,10,231,2,37,"expand_var@183-220@usr.bin/cvs/trigger.c","usr.bin/cvs/trigger.c","expand_var",183,220
109,26,593,4,119,"parse_cmd@223-342@usr.bin/cvs/trigger.c","usr.bin/cvs/trigger.c","parse_cmd",223,342
26,6,145,5,27,"cvs_trigger_handle@345-372@usr.bin/cvs/trigger.c","usr.bin/cvs/trigger.c","cvs_trigger_handle",345,372
91,26,633,2,114,"cvs_trigger_getlines@375-489@usr.bin/cvs/trigger.c","usr.bin/cvs/trigger.c","cvs_trigger_getlines",375,489
10,2,55,1,11,"cvs_trigger_freelist@492-503@usr.bin/cvs/trigger.c","usr.bin/cvs/trigger.c","cvs_trigger_freelist",492,503
14,2,85,1,15,"cvs_trigger_freeinfo@506-521@usr.bin/cvs/trigger.c","usr.bin/cvs/trigger.c","cvs_trigger_freeinfo",506,521
29,4,194,2,33,"cvs_trigger_loginfo_header@524-557@usr.bin/cvs/trigger.c","usr.bin/cvs/trigger.c","cvs_trigger_loginfo_header",524,557
119,36,526,2,128,"cvs_update@63-191@usr.bin/cvs/update.c","usr.bin/cvs/update.c","cvs_update",63,191
35,14,273,1,41,"cvs_update_enterdir@194-235@usr.bin/cvs/update.c","usr.bin/cvs/update.c","cvs_update_enterdir",194,235
58,22,403,1,75,"cvs_update_leavedir@238-313@usr.bin/cvs/update.c","usr.bin/cvs/update.c","cvs_update_leavedir",238,313
157,70,1013,1,178,"cvs_update_local@316-494@usr.bin/cvs/update.c","usr.bin/cvs/update.c","cvs_update_local",316,494
22,6,201,1,27,"update_clear_conflict@497-524@usr.bin/cvs/update.c","usr.bin/cvs/update.c","update_clear_conflict",497,524
35,8,221,1,41,"update_has_conflict_markers@532-573@usr.bin/cvs/update.c","usr.bin/cvs/update.c","update_has_conflict_markers",532,573
111,29,717,1,137,"update_join_file@576-713@usr.bin/cvs/update.c","usr.bin/cvs/update.c","update_join_file",576,713
16,2,121,1,19,"cvs_backup_file@716-735@usr.bin/cvs/update.c","usr.bin/cvs/update.c","cvs_backup_file",716,735
39,13,283,2,47,"cvs_strtomode@93-140@usr.bin/cvs/util.c","usr.bin/cvs/util.c","cvs_strtomode",93,140
39,18,321,3,48,"cvs_modetostr@151-199@usr.bin/cvs/util.c","usr.bin/cvs/util.c","cvs_modetostr",151,199
30,7,178,3,38,"cvs_getargv@210-248@usr.bin/cvs/util.c","usr.bin/cvs/util.c","cvs_getargv",210,248
14,3,106,2,17,"cvs_makeargv@257-274@usr.bin/cvs/util.c","usr.bin/cvs/util.c","cvs_makeargv",257,274
6,2,35,2,6,"cvs_freeargv@282-288@usr.bin/cvs/util.c","usr.bin/cvs/util.c","cvs_freeargv",282,288
9,3,52,2,9,"cvs_chdir@299-308@usr.bin/cvs/util.c","usr.bin/cvs/util.c","cvs_chdir",299,308
10,4,73,2,12,"cvs_rename@317-329@usr.bin/cvs/util.c","usr.bin/cvs/util.c","cvs_rename",317,329
12,6,75,1,14,"cvs_unlink@339-353@usr.bin/cvs/util.c","usr.bin/cvs/util.c","cvs_unlink",339,353
70,21,365,1,79,"cvs_rmdir@362-441@usr.bin/cvs/util.c","usr.bin/cvs/util.c","cvs_rmdir",362,441
7,1,57,3,7,"cvs_get_repository_path@444-451@usr.bin/cvs/util.c","usr.bin/cvs/util.c","cvs_get_repository_path",444,451
38,14,268,3,41,"cvs_get_repository_name@454-495@usr.bin/cvs/util.c","usr.bin/cvs/util.c","cvs_get_repository_name",454,495
46,16,432,5,60,"cvs_mkadmin@498-558@usr.bin/cvs/util.c","usr.bin/cvs/util.c","cvs_mkadmin",498,558
76,28,621,2,96,"cvs_mkpath@561-657@usr.bin/cvs/util.c","usr.bin/cvs/util.c","cvs_mkpath",561,657
28,11,221,2,37,"cvs_mkdir@660-697@usr.bin/cvs/util.c","usr.bin/cvs/util.c","cvs_mkdir",660,697
25,4,193,2,28,"cvs_splitlines@703-731@usr.bin/cvs/util.c","usr.bin/cvs/util.c","cvs_splitlines",703,731
11,3,73,1,12,"cvs_freelines@734-746@usr.bin/cvs/util.c","usr.bin/cvs/util.c","cvs_freelines",734,746
17,2,138,2,19,"cvs_strsplit@755-774@usr.bin/cvs/util.c","usr.bin/cvs/util.c","cvs_strsplit",755,774
6,1,28,1,5,"cvs_argv_destroy@782-787@usr.bin/cvs/util.c","usr.bin/cvs/util.c","cvs_argv_destroy",782,787
54,14,388,2,65,"cvs_revision_select@790-855@usr.bin/cvs/util.c","usr.bin/cvs/util.c","cvs_revision_select",790,855
13,5,68,1,16,"cvs_yesno@858-874@usr.bin/cvs/util.c","usr.bin/cvs/util.c","cvs_yesno",858,874
41,11,282,3,46,"cvs_exec@884-930@usr.bin/cvs/util.c","usr.bin/cvs/util.c","cvs_exec",884,930
15,6,79,2,19,"cvs_version@33-52@usr.bin/cvs/version.c","usr.bin/cvs/version.c","cvs_version",33,52
88,28,529,2,108,"cvs_watch@57-165@usr.bin/cvs/watch.c","usr.bin/cvs/watch.c","cvs_watch",57,165
42,8,208,2,52,"cvs_watchers@168-220@usr.bin/cvs/watch.c","usr.bin/cvs/watch.c","cvs_watchers",168,220
3,1,9,1,2,"cvs_watch_local@223-225@usr.bin/cvs/watch.c","usr.bin/cvs/watch.c","cvs_watch_local",223,225
3,1,9,1,2,"cvs_watchers_local@228-230@usr.bin/cvs/watch.c","usr.bin/cvs/watch.c","cvs_watchers_local",228,230
14,2,110,2,16,"worklist_add@37-53@usr.bin/cvs/worklist.c","usr.bin/cvs/worklist.c","worklist_add",37,53
13,2,91,2,16,"worklist_run@60-76@usr.bin/cvs/worklist.c","usr.bin/cvs/worklist.c","worklist_run",60,76
6,1,38,2,6,"worklist_clean@82-88@usr.bin/cvs/worklist.c","usr.bin/cvs/worklist.c","worklist_clean",82,88
4,1,19,1,3,"worklist_unlink@91-94@usr.bin/cvs/worklist.c","usr.bin/cvs/worklist.c","worklist_unlink",91,94
11,3,50,1,11,"xmalloc@27-38@usr.bin/cvs/xmalloc.c","usr.bin/cvs/xmalloc.c","xmalloc",27,38
11,4,61,2,11,"xcalloc@41-52@usr.bin/cvs/xmalloc.c","usr.bin/cvs/xmalloc.c","xcalloc",41,52
11,4,67,3,11,"xreallocarray@55-66@usr.bin/cvs/xmalloc.c","usr.bin/cvs/xmalloc.c","xreallocarray",55,66
7,2,39,1,7,"xstrdup@69-76@usr.bin/cvs/xmalloc.c","usr.bin/cvs/xmalloc.c","xstrdup",69,76
11,3,68,3,13,"xasprintf@79-92@usr.bin/cvs/xmalloc.c","usr.bin/cvs/xmalloc.c","xasprintf",79,92
13,4,81,4,16,"xsnprintf@95-111@usr.bin/cvs/xmalloc.c","usr.bin/cvs/xmalloc.c","xsnprintf",95,111
4,1,13,1,3,"sighandler@219-222@usr.bin/dc/bcode.c","usr.bin/dc/bcode.c","sighandler",219,222
32,9,274,1,38,"init_bmachine@225-263@usr.bin/dc/bcode.c","usr.bin/dc/bcode.c","init_bmachine",225,263
4,1,11,1,3,"bmachine_scale@266-269@usr.bin/dc/bcode.c","usr.bin/dc/bcode.c","bmachine_scale",266,269
5,1,25,1,4,"reset_bmachine@273-277@usr.bin/dc/bcode.c","usr.bin/dc/bcode.c","reset_bmachine",273,277
5,1,31,1,5,"readch@280-285@usr.bin/dc/bcode.c","usr.bin/dc/bcode.c","readch",280,285
5,1,30,1,5,"unreadch@288-293@usr.bin/dc/bcode.c","usr.bin/dc/bcode.c","unreadch",288,293
5,1,31,1,5,"readline@296-301@usr.bin/dc/bcode.c","usr.bin/dc/bcode.c","readline",296,301
5,1,30,1,5,"src_free@304-309@usr.bin/dc/bcode.c","usr.bin/dc/bcode.c","src_free",304,309
9,2,70,2,8,"pn@313-321@usr.bin/dc/bcode.c","usr.bin/dc/bcode.c","pn",313,321
9,2,63,2,8,"pbn@324-332@usr.bin/dc/bcode.c","usr.bin/dc/bcode.c","pbn",324,332
4,2,19,2,3,"max@337-340@usr.bin/dc/bcode.c","usr.bin/dc/bcode.c","max",337,340
32,6,210,2,36,"scale_number@348-384@usr.bin/dc/bcode.c","usr.bin/dc/bcode.c","scale_number",348,384
29,5,219,3,32,"split_number@387-419@usr.bin/dc/bcode.c","usr.bin/dc/bcode.c","split_number",387,419
5,1,31,2,4,"normalize@422-426@usr.bin/dc/bcode.c","usr.bin/dc/bcode.c","normalize",422,426
5,1,24,1,4,"get_ulong@429-433@usr.bin/dc/bcode.c","usr.bin/dc/bcode.c","get_ulong",429,433
4,1,24,1,3,"negate@436-439@usr.bin/dc/bcode.c","usr.bin/dc/bcode.c","negate",436,439
4,1,19,1,3,"push_number@442-445@usr.bin/dc/bcode.c","usr.bin/dc/bcode.c","push_number",442,445
4,1,18,1,3,"push_string@448-451@usr.bin/dc/bcode.c","usr.bin/dc/bcode.c","push_string",448,451
4,1,19,1,3,"push@454-457@usr.bin/dc/bcode.c","usr.bin/dc/bcode.c","push",454,457
4,1,15,1,3,"tos@460-463@usr.bin/dc/bcode.c","usr.bin/dc/bcode.c","tos",460,463
4,1,15,1,3,"pop@466-469@usr.bin/dc/bcode.c","usr.bin/dc/bcode.c","pop",466,469
4,1,15,1,3,"pop_number@472-475@usr.bin/dc/bcode.c","usr.bin/dc/bcode.c","pop_number",472,475
4,1,15,1,3,"pop_string@478-481@usr.bin/dc/bcode.c","usr.bin/dc/bcode.c","pop_string",478,481
4,1,14,1,3,"clear_stack@484-487@usr.bin/dc/bcode.c","usr.bin/dc/bcode.c","clear_stack",484,487
4,1,22,1,3,"print_stack@490-493@usr.bin/dc/bcode.c","usr.bin/dc/bcode.c","print_stack",490,493
10,2,50,1,9,"print_tos@496-505@usr.bin/dc/bcode.c","usr.bin/dc/bcode.c","print_tos",496,505
10,2,52,1,9,"print_err@508-517@usr.bin/dc/bcode.c","usr.bin/dc/bcode.c","print_err",508,517
20,5,103,1,20,"pop_print@520-540@usr.bin/dc/bcode.c","usr.bin/dc/bcode.c","pop_print",520,540
9,2,49,1,9,"pop_printn@543-552@usr.bin/dc/bcode.c","usr.bin/dc/bcode.c","pop_printn",543,552
4,1,14,1,3,"dup@555-558@usr.bin/dc/bcode.c","usr.bin/dc/bcode.c","dup",555,558
4,1,14,1,3,"swap@561-564@usr.bin/dc/bcode.c","usr.bin/dc/bcode.c","swap",561,564
6,2,26,1,5,"drop@567-572@usr.bin/dc/bcode.c","usr.bin/dc/bcode.c","drop",567,572
7,1,36,1,7,"get_scale@575-582@usr.bin/dc/bcode.c","usr.bin/dc/bcode.c","get_scale",575,582
18,5,82,1,18,"set_scale@585-603@usr.bin/dc/bcode.c","usr.bin/dc/bcode.c","set_scale",585,603
7,1,36,1,7,"get_obase@606-613@usr.bin/dc/bcode.c","usr.bin/dc/bcode.c","get_obase",606,613
14,5,69,1,14,"set_obase@616-630@usr.bin/dc/bcode.c","usr.bin/dc/bcode.c","set_obase",616,630
7,1,36,1,7,"get_ibase@633-640@usr.bin/dc/bcode.c","usr.bin/dc/bcode.c","get_ibase",633,640
15,5,70,1,15,"set_ibase@643-658@usr.bin/dc/bcode.c","usr.bin/dc/bcode.c","set_ibase",643,658
9,1,47,1,9,"stackdepth@661-670@usr.bin/dc/bcode.c","usr.bin/dc/bcode.c","stackdepth",661,670
22,5,96,1,23,"push_scale@673-696@usr.bin/dc/bcode.c","usr.bin/dc/bcode.c","push_scale",673,696
38,5,232,1,52,"count_digits@699-751@usr.bin/dc/bcode.c","usr.bin/dc/bcode.c","count_digits",699,751
25,5,126,1,25,"num_digits@754-779@usr.bin/dc/bcode.c","usr.bin/dc/bcode.c","num_digits",754,779
26,6,146,1,26,"to_ascii@782-808@usr.bin/dc/bcode.c","usr.bin/dc/bcode.c","to_ascii",782,808
19,7,110,1,19,"readreg@811-830@usr.bin/dc/bcode.c","usr.bin/dc/bcode.c","readreg",811,830
16,3,91,1,16,"load@833-849@usr.bin/dc/bcode.c","usr.bin/dc/bcode.c","load",833,849
13,3,57,1,13,"store@852-865@usr.bin/dc/bcode.c","usr.bin/dc/bcode.c","store",852,865
19,4,86,1,19,"load_stack@868-887@usr.bin/dc/bcode.c","usr.bin/dc/bcode.c","load_stack",868,887
12,3,55,1,12,"store_stack@890-902@usr.bin/dc/bcode.c","usr.bin/dc/bcode.c","store_stack",890,902
31,8,173,1,31,"load_array@905-936@usr.bin/dc/bcode.c","usr.bin/dc/bcode.c","load_array",905,936
31,7,154,1,31,"store_array@939-970@usr.bin/dc/bcode.c","usr.bin/dc/bcode.c","store_array",939,970
4,1,22,1,3,"push_line@973-976@usr.bin/dc/bcode.c","usr.bin/dc/bcode.c","push_line",973,976
4,1,13,1,3,"comment@979-982@usr.bin/dc/bcode.c","usr.bin/dc/bcode.c","comment",979,982
23,5,147,1,24,"badd@985-1009@usr.bin/dc/bcode.c","usr.bin/dc/bcode.c","badd",985,1009
23,5,147,1,25,"bsub@1012-1037@usr.bin/dc/bcode.c","usr.bin/dc/bcode.c","bsub",1012,1037
14,4,122,4,17,"bmul_number@1040-1057@usr.bin/dc/bcode.c","usr.bin/dc/bcode.c","bmul_number",1040,1057
18,3,88,1,20,"bmul@1060-1080@usr.bin/dc/bcode.c","usr.bin/dc/bcode.c","bmul",1060,1080
31,4,176,1,34,"bdiv@1083-1117@usr.bin/dc/bcode.c","usr.bin/dc/bcode.c","bdiv",1083,1117
31,4,185,1,34,"bmod@1120-1154@usr.bin/dc/bcode.c","usr.bin/dc/bcode.c","bmod",1120,1154
35,4,211,1,38,"bdivmod@1157-1195@usr.bin/dc/bcode.c","usr.bin/dc/bcode.c","bdivmod",1157,1195
90,16,552,1,102,"bexp@1198-1300@usr.bin/dc/bcode.c","usr.bin/dc/bcode.c","bexp",1198,1300
45,6,310,1,46,"bsqrt@1303-1349@usr.bin/dc/bcode.c","usr.bin/dc/bcode.c","bsqrt",1303,1349
10,3,57,1,10,"not@1352-1362@usr.bin/dc/bcode.c","usr.bin/dc/bcode.c","not",1352,1362
4,1,11,1,3,"equal@1365-1368@usr.bin/dc/bcode.c","usr.bin/dc/bcode.c","equal",1365,1368
16,4,86,1,16,"equal_numbers@1371-1387@usr.bin/dc/bcode.c","usr.bin/dc/bcode.c","equal_numbers",1371,1387
16,4,86,1,16,"less_numbers@1390-1406@usr.bin/dc/bcode.c","usr.bin/dc/bcode.c","less_numbers",1390,1406
16,4,86,1,16,"lesseq_numbers@1409-1425@usr.bin/dc/bcode.c","usr.bin/dc/bcode.c","lesseq_numbers",1409,1425
4,1,11,1,3,"less@1428-1431@usr.bin/dc/bcode.c","usr.bin/dc/bcode.c","less",1428,1431
18,4,57,1,17,"not_compare@1434-1451@usr.bin/dc/bcode.c","usr.bin/dc/bcode.c","not_compare",1434,1451
4,1,11,1,3,"greater@1454-1457@usr.bin/dc/bcode.c","usr.bin/dc/bcode.c","greater",1454,1457
28,9,148,3,32,"compare_numbers@1460-1492@usr.bin/dc/bcode.c","usr.bin/dc/bcode.c","compare_numbers",1460,1492
42,14,218,1,46,"compare@1495-1541@usr.bin/dc/bcode.c","usr.bin/dc/bcode.c","compare",1495,1541
3,1,6,1,2,"nop@1545-1547@usr.bin/dc/bcode.c","usr.bin/dc/bcode.c","nop",1545,1547
9,2,37,1,8,"quit@1550-1558@usr.bin/dc/bcode.c","usr.bin/dc/bcode.c","quit",1550,1558
20,6,90,1,20,"quitN@1561-1581@usr.bin/dc/bcode.c","usr.bin/dc/bcode.c","quitN",1561,1581
20,6,89,1,20,"skipN@1584-1604@usr.bin/dc/bcode.c","usr.bin/dc/bcode.c","skipN",1584,1604
48,20,181,1,47,"skip_until_mark@1607-1654@usr.bin/dc/bcode.c","usr.bin/dc/bcode.c","skip_until_mark",1607,1654
6,1,30,1,5,"parse_number@1657-1662@usr.bin/dc/bcode.c","usr.bin/dc/bcode.c","parse_number",1657,1662
5,1,29,1,4,"unknown@1665-1669@usr.bin/dc/bcode.c","usr.bin/dc/bcode.c","unknown",1665,1669
24,5,147,1,25,"eval_string@1672-1697@usr.bin/dc/bcode.c","usr.bin/dc/bcode.c","eval_string",1672,1697
9,1,47,1,10,"eval_line@1700-1710@usr.bin/dc/bcode.c","usr.bin/dc/bcode.c","eval_line",1700,1710
7,2,27,1,7,"eval_tos@1713-1720@usr.bin/dc/bcode.c","usr.bin/dc/bcode.c","eval_tos",1713,1720
33,10,187,1,39,"eval@1723-1762@usr.bin/dc/bcode.c","usr.bin/dc/bcode.c","eval",1723,1762
6,1,23,1,5,"usage@33-38@usr.bin/dc/dc.c","usr.bin/dc/dc.c","usage",33,38
69,17,437,2,81,"dc_main@41-122@usr.bin/dc/dc.c","usr.bin/dc/dc.c","dc_main",41,122
5,1,28,2,4,"src_setstream@58-62@usr.bin/dc/inout.c","usr.bin/dc/inout.c","src_setstream",58,62
6,1,44,2,5,"src_setstring@65-70@usr.bin/dc/inout.c","usr.bin/dc/inout.c","src_setstring",65,70
4,1,23,1,3,"src_getcharstream@73-76@usr.bin/dc/inout.c","usr.bin/dc/inout.c","src_getcharstream",73,76
4,1,25,1,3,"src_ungetcharstream@79-82@usr.bin/dc/inout.c","usr.bin/dc/inout.c","src_ungetcharstream",79,82
3,1,9,1,2,"src_freestream@86-88@usr.bin/dc/inout.c","usr.bin/dc/inout.c","src_freestream",86,88
7,2,44,1,7,"src_getlinestream@91-98@usr.bin/dc/inout.c","usr.bin/dc/inout.c","src_getlinestream",91,98
10,2,58,1,9,"src_getcharstring@101-110@usr.bin/dc/inout.c","usr.bin/dc/inout.c","src_getcharstring",101,110
7,3,40,1,6,"src_ungetcharstring@113-119@usr.bin/dc/inout.c","usr.bin/dc/inout.c","src_ungetcharstring",113,119
16,4,78,1,16,"src_getlinestring@122-138@usr.bin/dc/inout.c","usr.bin/dc/inout.c","src_getlinestring",122,138
4,1,20,1,3,"src_freestring@141-144@usr.bin/dc/inout.c","usr.bin/dc/inout.c","src_freestring",141,144
5,2,25,1,4,"flushwrap@147-151@usr.bin/dc/inout.c","usr.bin/dc/inout.c","flushwrap",147,151
12,3,59,2,11,"putcharwrap@154-165@usr.bin/dc/inout.c","usr.bin/dc/inout.c","putcharwrap",154,165
8,2,54,2,8,"printwrap@168-176@usr.bin/dc/inout.c","usr.bin/dc/inout.c","printwrap",168,176
42,15,261,2,49,"readnumber@179-228@usr.bin/dc/inout.c","usr.bin/dc/inout.c","readnumber",179,228
34,9,177,1,35,"read_string@231-266@usr.bin/dc/inout.c","usr.bin/dc/inout.c","read_string",231,266
13,4,88,3,13,"get_digit@269-282@usr.bin/dc/inout.c","usr.bin/dc/inout.c","get_digit",269,282
78,11,521,3,85,"printnumber@285-370@usr.bin/dc/inout.c","usr.bin/dc/inout.c","printnumber",285,370
16,5,100,4,15,"print_value@373-388@usr.bin/dc/inout.c","usr.bin/dc/inout.c","print_value",373,388
12,3,93,2,12,"print_ascii@391-403@usr.bin/dc/inout.c","usr.bin/dc/inout.c","print_ascii",391,403
7,2,45,2,8,"main@26-34@usr.bin/dc/main.c","usr.bin/dc/main.c","main",26,34
10,2,54,1,10,"new_number@28-38@usr.bin/dc/mem.c","usr.bin/dc/mem.c","new_number",28,38
5,1,21,1,4,"free_number@41-45@usr.bin/dc/mem.c","usr.bin/dc/mem.c","free_number",41,45
9,1,55,1,9,"dup_number@48-57@usr.bin/dc/mem.c","usr.bin/dc/mem.c","dup_number",48,57
8,2,34,1,8,"bmalloc@60-68@usr.bin/dc/mem.c","usr.bin/dc/mem.c","bmalloc",60,68
8,2,45,3,8,"breallocarray@71-79@usr.bin/dc/mem.c","usr.bin/dc/mem.c","breallocarray",71,79
8,2,36,1,8,"bstrdup@82-90@usr.bin/dc/mem.c","usr.bin/dc/mem.c","bstrdup",82,90
6,1,28,1,5,"stack_init@35-40@usr.bin/dc/stack.c","usr.bin/dc/stack.c","stack_init",35,40
7,2,32,1,6,"stack_empty@43-49@usr.bin/dc/stack.c","usr.bin/dc/stack.c","stack_empty",43,49
15,4,63,1,14,"stack_free_value@53-67@usr.bin/dc/stack.c","usr.bin/dc/stack.c","stack_free_value",53,67
18,6,115,2,20,"stack_dup_value@71-91@usr.bin/dc/stack.c","usr.bin/dc/stack.c","stack_dup_value",71,91
4,1,17,1,3,"stack_size@94-97@usr.bin/dc/stack.c","usr.bin/dc/stack.c","stack_size",94,97
11,2,53,1,11,"stack_dup@100-111@usr.bin/dc/stack.c","usr.bin/dc/stack.c","stack_dup",100,111
11,2,74,1,11,"stack_swap@114-125@usr.bin/dc/stack.c","usr.bin/dc/stack.c","stack_swap",114,125
10,2,62,1,10,"stack_grow@128-138@usr.bin/dc/stack.c","usr.bin/dc/stack.c","stack_grow",128,138
7,1,60,2,6,"stack_pushnumber@141-147@usr.bin/dc/stack.c","usr.bin/dc/stack.c","stack_pushnumber",141,147
7,1,59,2,6,"stack_pushstring@150-156@usr.bin/dc/stack.c","usr.bin/dc/stack.c","stack_pushstring",150,156
17,5,103,2,16,"stack_push@159-175@usr.bin/dc/stack.c","usr.bin/dc/stack.c","stack_push",159,175
6,2,33,1,5,"stack_tos@178-183@usr.bin/dc/stack.c","usr.bin/dc/stack.c","stack_tos",178,183
11,3,84,2,10,"stack_set_tos@186-196@usr.bin/dc/stack.c","usr.bin/dc/stack.c","stack_set_tos",186,196
6,2,31,1,5,"stack_pop@199-204@usr.bin/dc/stack.c","usr.bin/dc/stack.c","stack_pop",199,204
12,3,86,1,11,"stack_popnumber@207-218@usr.bin/dc/stack.c","usr.bin/dc/stack.c","stack_popnumber",207,218
12,3,86,1,11,"stack_popstring@221-232@usr.bin/dc/stack.c","usr.bin/dc/stack.c","stack_popstring",221,232
7,2,43,1,6,"stack_clear@235-241@usr.bin/dc/stack.c","usr.bin/dc/stack.c","stack_clear",235,241
8,2,69,4,8,"stack_print@244-252@usr.bin/dc/stack.c","usr.bin/dc/stack.c","stack_print",244,252
8,1,37,1,8,"array_new@256-264@usr.bin/dc/stack.c","usr.bin/dc/stack.c","array_new",256,264
10,3,58,1,10,"array_free@267-277@usr.bin/dc/stack.c","usr.bin/dc/stack.c","array_free",267,277
12,3,82,1,12,"array_dup@280-292@usr.bin/dc/stack.c","usr.bin/dc/stack.c","array_dup",280,292
10,2,81,2,10,"array_grow@295-305@usr.bin/dc/stack.c","usr.bin/dc/stack.c","array_grow",295,305
7,2,56,3,6,"array_assign@308-314@usr.bin/dc/stack.c","usr.bin/dc/stack.c","array_assign",308,314
6,2,33,2,5,"array_retrieve@317-322@usr.bin/dc/stack.c","usr.bin/dc/stack.c","array_retrieve",317,322
14,3,103,3,15,"frame_assign@325-340@usr.bin/dc/stack.c","usr.bin/dc/stack.c","frame_assign",325,340
10,3,74,2,10,"frame_retrieve@343-353@usr.bin/dc/stack.c","usr.bin/dc/stack.c","frame_retrieve",343,353
96,21,457,2,103,"main@257-360@usr.bin/deroff/deroff.c","usr.bin/deroff/deroff.c","main",257,360
17,8,108,1,17,"skeqn@363-380@usr.bin/deroff/deroff.c","usr.bin/deroff/deroff.c","skeqn",363,380
7,2,41,1,8,"opn@383-391@usr.bin/deroff/deroff.c","usr.bin/deroff/deroff.c","opn",383,391
14,4,65,1,14,"eof@394-408@usr.bin/deroff/deroff.c","usr.bin/deroff/deroff.c","eof",394,408
30,11,191,1,34,"getfname@411-445@usr.bin/deroff/deroff.c","usr.bin/deroff/deroff.c","getfname",411,445
8,2,29,2,8,"textline@449-457@usr.bin/deroff/deroff.c","usr.bin/deroff/deroff.c","textline",449,457
11,5,44,1,13,"work@460-473@usr.bin/deroff/deroff.c","usr.bin/deroff/deroff.c","work",460,473
25,9,142,2,26,"regline@476-502@usr.bin/deroff/deroff.c","usr.bin/deroff/deroff.c","regline",476,502
13,6,48,1,13,"macro@505-518@usr.bin/deroff/deroff.c","usr.bin/deroff/deroff.c","macro",505,518
7,2,19,1,7,"tbl@521-528@usr.bin/deroff/deroff.c","usr.bin/deroff/deroff.c","tbl",521,528
12,8,55,1,12,"stbl@531-543@usr.bin/deroff/deroff.c","usr.bin/deroff/deroff.c","stbl",531,543
50,26,240,1,54,"eqn@546-600@usr.bin/deroff/deroff.c","usr.bin/deroff/deroff.c","eqn",546,600
63,31,216,1,70,"backsl@604-674@usr.bin/deroff/deroff.c","usr.bin/deroff/deroff.c","backsl",604,674
43,14,181,1,43,"sce@677-720@usr.bin/deroff/deroff.c","usr.bin/deroff/deroff.c","sce",677,720
21,8,82,1,22,"refer@723-745@usr.bin/deroff/deroff.c","usr.bin/deroff/deroff.c","refer",723,745
59,16,239,1,59,"inpic@748-807@usr.bin/deroff/deroff.c","usr.bin/deroff/deroff.c","inpic",748,807
4,1,11,1,4,"_C1@811-815@usr.bin/deroff/deroff.c","usr.bin/deroff/deroff.c","_C1",811,815
4,1,11,1,4,"_C@818-822@usr.bin/deroff/deroff.c","usr.bin/deroff/deroff.c","_C",818,822
41,19,256,2,41,"msputmac@829-870@usr.bin/deroff/deroff.c","usr.bin/deroff/deroff.c","msputmac",829,870
24,11,166,1,31,"msputwords@876-907@usr.bin/deroff/deroff.c","usr.bin/deroff/deroff.c","msputwords",876,907
71,26,376,2,86,"meputmac@916-1002@usr.bin/deroff/deroff.c","usr.bin/deroff/deroff.c","meputmac",916,1002
4,1,12,1,4,"meputwords@1008-1012@usr.bin/deroff/deroff.c","usr.bin/deroff/deroff.c","meputwords",1008,1012
50,25,239,2,57,"noblock@1034-1091@usr.bin/deroff/deroff.c","usr.bin/deroff/deroff.c","noblock",1034,1091
5,1,15,1,5,"EQ@1094-1099@usr.bin/deroff/deroff.c","usr.bin/deroff/deroff.c","EQ",1094,1099
5,1,15,1,5,"domacro@1102-1107@usr.bin/deroff/deroff.c","usr.bin/deroff/deroff.c","domacro",1102,1107
14,5,58,1,15,"PS@1110-1125@usr.bin/deroff/deroff.c","usr.bin/deroff/deroff.c","PS",1110,1125
5,1,13,1,5,"skip@1128-1133@usr.bin/deroff/deroff.c","usr.bin/deroff/deroff.c","skip",1128,1133
8,2,24,1,8,"intbl@1136-1144@usr.bin/deroff/deroff.c","usr.bin/deroff/deroff.c","intbl",1136,1144
5,1,15,1,5,"outtbl@1147-1152@usr.bin/deroff/deroff.c","usr.bin/deroff/deroff.c","outtbl",1147,1152
13,4,63,1,13,"so@1155-1168@usr.bin/deroff/deroff.c","usr.bin/deroff/deroff.c","so",1155,1168
12,4,57,1,12,"nx@1171-1183@usr.bin/deroff/deroff.c","usr.bin/deroff/deroff.c","nx",1171,1183
5,1,13,1,5,"skiptocom@1186-1191@usr.bin/deroff/deroff.c","usr.bin/deroff/deroff.c","skiptocom",1186,1191
10,2,51,1,10,"PP@1194-1204@usr.bin/deroff/deroff.c","usr.bin/deroff/deroff.c","PP",1194,1204
7,2,24,1,7,"AU@1207-1214@usr.bin/deroff/deroff.c","usr.bin/deroff/deroff.c","AU",1207,1214
24,6,111,1,26,"SH@1217-1243@usr.bin/deroff/deroff.c","usr.bin/deroff/deroff.c","SH",1217,1243
8,2,26,1,8,"UX@1246-1254@usr.bin/deroff/deroff.c","usr.bin/deroff/deroff.c","UX",1246,1254
14,3,62,1,14,"MMHU@1257-1271@usr.bin/deroff/deroff.c","usr.bin/deroff/deroff.c","MMHU",1257,1271
7,1,33,1,7,"mesnblock@1274-1281@usr.bin/deroff/deroff.c","usr.bin/deroff/deroff.c","mesnblock",1274,1281
7,1,33,1,7,"mssnblock@1284-1291@usr.bin/deroff/deroff.c","usr.bin/deroff/deroff.c","mssnblock",1284,1291
5,1,18,1,5,"nf@1294-1299@usr.bin/deroff/deroff.c","usr.bin/deroff/deroff.c","nf",1294,1299
5,1,15,1,5,"ce@1302-1307@usr.bin/deroff/deroff.c","usr.bin/deroff/deroff.c","ce",1302,1307
10,3,36,1,10,"meip@1310-1320@usr.bin/deroff/deroff.c","usr.bin/deroff/deroff.c","meip",1310,1320
5,1,17,1,5,"mepp@1326-1331@usr.bin/deroff/deroff.c","usr.bin/deroff/deroff.c","mepp",1326,1331
10,3,34,1,10,"mesh@1337-1347@usr.bin/deroff/deroff.c","usr.bin/deroff/deroff.c","mesh",1337,1347
7,1,25,1,7,"mefont@1353-1360@usr.bin/deroff/deroff.c","usr.bin/deroff/deroff.c","mefont",1353,1360
4,1,15,1,4,"manfont@1363-1367@usr.bin/deroff/deroff.c","usr.bin/deroff/deroff.c","manfont",1363,1367
4,1,15,1,4,"manpp@1370-1374@usr.bin/deroff/deroff.c","usr.bin/deroff/deroff.c","manpp",1370,1374
36,15,149,1,39,"defcomline@1377-1416@usr.bin/deroff/deroff.c","usr.bin/deroff/deroff.c","defcomline",1377,1416
86,32,394,1,99,"comline@1419-1518@usr.bin/deroff/deroff.c","usr.bin/deroff/deroff.c","comline",1419,1518
6,1,49,2,6,"macsort@1521-1527@usr.bin/deroff/deroff.c","usr.bin/deroff/deroff.c","macsort",1521,1527
10,3,41,1,10,"sizetab@1530-1540@usr.bin/deroff/deroff.c","usr.bin/deroff/deroff.c","sizetab",1530,1540
8,3,39,2,8,"macfill@1543-1551@usr.bin/deroff/deroff.c","usr.bin/deroff/deroff.c","macfill",1543,1551
6,1,25,1,6,"usage@1554-1560@usr.bin/deroff/deroff.c","usr.bin/deroff/deroff.c","usage",1554,1560
39,7,209,2,41,"buildtab@1563-1604@usr.bin/deroff/deroff.c","usr.bin/deroff/deroff.c","buildtab",1563,1604
178,73,1029,2,186,"main@82-268@usr.bin/diff/diff.c","usr.bin/diff/diff.c","main",82,268
14,3,97,2,14,"set_argstr@271-285@usr.bin/diff/diff.c","usr.bin/diff/diff.c","set_argstr",271,285
20,6,140,1,20,"read_excludes_file@291-311@usr.bin/diff/diff.c","usr.bin/diff/diff.c","read_excludes_file",291,311
8,1,40,1,8,"push_excludes@317-325@usr.bin/diff/diff.c","usr.bin/diff/diff.c","push_excludes",317,325
12,2,70,1,13,"push_ignore_pats@328-341@usr.bin/diff/diff.c","usr.bin/diff/diff.c","push_ignore_pats",328,341
6,2,40,3,5,"print_only@344-349@usr.bin/diff/diff.c","usr.bin/diff/diff.c","print_only",344,349
35,10,153,4,34,"print_status@352-386@usr.bin/diff/diff.c","usr.bin/diff/diff.c","print_status",352,386
12,1,27,1,12,"usage@389-401@usr.bin/diff/diff.c","usr.bin/diff/diff.c","usage",389,401
96,34,647,3,115,"diffdir@49-164@usr.bin/diff/diffdir.c","usr.bin/diff/diffdir.c","diffdir",49,164
41,16,309,6,42,"diffit@170-212@usr.bin/diff/diffdir.c","usr.bin/diff/diffdir.c","diffit",170,212
13,8,118,1,18,"selectfile@219-237@usr.bin/diff/diffdir.c","usr.bin/diff/diffdir.c","selectfile",219,237
111,27,807,3,123,"diffreg@293-416@usr.bin/diff/diffreg.c","usr.bin/diff/diffreg.c","diffreg",293,416
20,12,179,3,20,"files_differ@424-444@usr.bin/diff/diffreg.c","usr.bin/diff/diffreg.c","files_differ",424,444
26,6,188,1,28,"opentemp@447-475@usr.bin/diff/diffreg.c","usr.bin/diff/diffreg.c","opentemp",447,475
14,4,92,2,14,"splice@478-492@usr.bin/diff/diffreg.c","usr.bin/diff/diffreg.c","splice",478,492
20,5,151,4,22,"prepare@495-517@usr.bin/diff/diffreg.c","usr.bin/diff/diffreg.c","prepare",495,517
18,9,186,1,18,"prune@520-538@usr.bin/diff/diffreg.c","usr.bin/diff/diffreg.c","prune",520,538
25,8,200,5,25,"equiv@541-566@usr.bin/diff/diffreg.c","usr.bin/diff/diffreg.c","equiv",541,566
13,4,71,1,15,"isqrt@570-585@usr.bin/diff/diffreg.c","usr.bin/diff/diffreg.c","isqrt",570,585
44,10,293,5,45,"stone@588-633@usr.bin/diff/diffreg.c","usr.bin/diff/diffreg.c","stone",588,633
13,2,79,3,13,"newcand@636-649@usr.bin/diff/diffreg.c","usr.bin/diff/diffreg.c","newcand",636,649
21,6,125,3,21,"search@652-673@usr.bin/diff/diffreg.c","usr.bin/diff/diffreg.c","search",652,673
10,5,102,1,10,"unravel@676-686@usr.bin/diff/diffreg.c","usr.bin/diff/diffreg.c","unravel",676,686
91,39,562,3,100,"check@695-795@usr.bin/diff/diffreg.c","usr.bin/diff/diffreg.c","check",695,795
29,10,233,2,29,"sort@799-828@usr.bin/diff/diffreg.c","usr.bin/diff/diffreg.c","sort",799,828
10,3,95,3,10,"unsort@831-841@usr.bin/diff/diffreg.c","usr.bin/diff/diffreg.c","unsort",831,841
7,3,44,1,7,"skipline@844-851@usr.bin/diff/diffreg.c","usr.bin/diff/diffreg.c","skipline",844,851
49,20,429,5,51,"output@854-905@usr.bin/diff/diffreg.c","usr.bin/diff/diffreg.c","output",854,905
6,3,42,3,5,"range@908-913@usr.bin/diff/diffreg.c","usr.bin/diff/diffreg.c","range",908,913
9,3,51,2,8,"uni_range@916-924@usr.bin/diff/diffreg.c","usr.bin/diff/diffreg.c","uni_range",916,924
12,4,85,3,12,"preadline@927-939@usr.bin/diff/diffreg.c","usr.bin/diff/diffreg.c","preadline",927,939
7,1,39,1,7,"ignoreline@942-949@usr.bin/diff/diffreg.c","usr.bin/diff/diffreg.c","ignoreline",942,949
108,45,742,9,131,"change@959-1090@usr.bin/diff/diffreg.c","usr.bin/diff/diffreg.c","change",959,1090
62,30,418,7,74,"fetch@1093-1167@usr.bin/diff/diffreg.c","usr.bin/diff/diffreg.c","fetch",1093,1167
54,21,272,2,59,"readhash@1173-1232@usr.bin/diff/diffreg.c","usr.bin/diff/diffreg.c","readhash",1173,1232
10,2,64,1,11,"asciifile@1235-1246@usr.bin/diff/diffreg.c","usr.bin/diff/diffreg.c","asciifile",1235,1246
40,15,269,3,40,"match_function@1251-1291@usr.bin/diff/diffreg.c","usr.bin/diff/diffreg.c","match_function",1251,1291
85,22,600,3,99,"dump_context_vec@1295-1394@usr.bin/diff/diffreg.c","usr.bin/diff/diffreg.c","dump_context_vec",1295,1394
54,11,434,3,69,"dump_unified_vec@1398-1467@usr.bin/diff/diffreg.c","usr.bin/diff/diffreg.c","dump_unified_vec",1398,1467
15,7,116,2,14,"print_header@1470-1484@usr.bin/diff/diffreg.c","usr.bin/diff/diffreg.c","print_header",1470,1484
10,3,49,1,10,"xmalloc@26-36@usr.bin/diff/xmalloc.c","usr.bin/diff/xmalloc.c","xmalloc",26,36
8,2,43,2,8,"xcalloc@39-47@usr.bin/diff/xmalloc.c","usr.bin/diff/xmalloc.c","xcalloc",39,47
9,2,49,3,9,"xreallocarray@50-59@usr.bin/diff/xmalloc.c","usr.bin/diff/xmalloc.c","xreallocarray",50,59
7,2,36,1,7,"xstrdup@62-69@usr.bin/diff/xmalloc.c","usr.bin/diff/xmalloc.c","xstrdup",62,69
11,3,65,3,13,"xasprintf@72-85@usr.bin/diff/xmalloc.c","usr.bin/diff/xmalloc.c","xasprintf",72,85
47,14,300,2,51,"main@144-195@usr.bin/diff3/diff3prog.c","usr.bin/diff3/diff3prog.c","main",144,195
39,9,315,2,39,"readin@204-243@usr.bin/diff3/diff3prog.c","usr.bin/diff3/diff3prog.c","readin",204,243
8,2,49,1,7,"number@246-253@usr.bin/diff3/diff3prog.c","usr.bin/diff3/diff3prog.c","number",246,253
9,3,51,1,9,"getchange@256-265@usr.bin/diff3/diff3prog.c","usr.bin/diff3/diff3prog.c","getchange",256,265
24,7,154,2,25,"get_line@268-293@usr.bin/diff3/diff3prog.c","usr.bin/diff3/diff3prog.c","get_line",268,293
83,27,741,2,102,"merge@296-398@usr.bin/diff3/diff3prog.c","usr.bin/diff3/diff3prog.c","merge",296,398
4,1,16,1,3,"separate@401-404@usr.bin/diff3/diff3prog.c","usr.bin/diff3/diff3prog.c","separate",401,404
11,3,75,3,10,"change@412-422@usr.bin/diff3/diff3prog.c","usr.bin/diff3/diff3prog.c","change",412,422
11,3,70,1,10,"prange@428-438@usr.bin/diff3/diff3prog.c","usr.bin/diff3/diff3prog.c","prange",428,438
9,1,61,2,9,"keep@446-455@usr.bin/diff3/diff3prog.c","usr.bin/diff3/diff3prog.c","keep",446,455
13,4,96,3,13,"skip@462-475@usr.bin/diff3/diff3prog.c","usr.bin/diff3/diff3prog.c","skip",462,475
26,7,178,2,26,"duplicate@482-508@usr.bin/diff3/diff3prog.c","usr.bin/diff3/diff3prog.c","duplicate",482,508
6,2,42,1,6,"repos@511-517@usr.bin/diff3/diff3prog.c","usr.bin/diff3/diff3prog.c","repos",511,517
4,1,13,1,3,"trouble@520-523@usr.bin/diff3/diff3prog.c","usr.bin/diff3/diff3prog.c","trouble",520,523
14,3,152,3,13,"edit@529-542@usr.bin/diff3/diff3prog.c","usr.bin/diff3/diff3prog.c","edit",529,542
25,9,221,1,25,"edscript@546-571@usr.bin/diff3/diff3prog.c","usr.bin/diff3/diff3prog.c","edscript",546,571
29,6,236,1,31,"increase@574-605@usr.bin/diff3/diff3prog.c","usr.bin/diff3/diff3prog.c","increase",574,605
7,1,26,1,7,"usage@609-616@usr.bin/diff3/diff3prog.c","usr.bin/diff3/diff3prog.c","usage",609,616
21,5,125,2,24,"main@28-52@usr.bin/dirname/dirname.c","usr.bin/dirname/dirname.c","main",28,52
5,1,23,1,4,"usage@57-61@usr.bin/dirname/dirname.c","usr.bin/dirname/dirname.c","usage",57,61
6,1,19,1,5,"usage@40-45@usr.bin/doas/doas.c","usr.bin/doas/doas.c","usage",40,45
13,3,74,2,13,"parseuid@48-61@usr.bin/doas/doas.c","usr.bin/doas/doas.c","parseuid",48,61
9,3,44,2,9,"uidcheck@64-73@usr.bin/doas/doas.c","usr.bin/doas/doas.c","uidcheck",64,73
13,3,74,2,13,"parsegid@76-89@usr.bin/doas/doas.c","usr.bin/doas/doas.c","parsegid",76,89
36,16,237,7,37,"match@92-129@usr.bin/doas/doas.c","usr.bin/doas/doas.c","match",92,129
14,4,105,7,14,"permit@132-146@usr.bin/doas/doas.c","usr.bin/doas/doas.c","permit",132,146
22,8,145,2,24,"parseconfig@149-173@usr.bin/doas/doas.c","usr.bin/doas/doas.c","parseconfig",149,173
17,4,128,7,18,"checkconfig@176-194@usr.bin/doas/doas.c","usr.bin/doas/doas.c","checkconfig",176,194
42,11,286,3,43,"authuser@197-240@usr.bin/doas/doas.c","usr.bin/doas/doas.c","authuser",197,240
137,40,907,2,160,"main@243-403@usr.bin/doas/doas.c","usr.bin/doas/doas.c","main",243,403
4,1,26,2,3,"envcmp@42-45@usr.bin/doas/env.c","usr.bin/doas/env.c","envcmp",42,45
12,4,81,2,12,"createnode@49-61@usr.bin/doas/env.c","usr.bin/doas/env.c","createnode",49,61
6,1,36,1,5,"freenode@64-69@usr.bin/doas/env.c","usr.bin/doas/env.c","freenode",64,69
34,8,217,1,42,"createenv@72-114@usr.bin/doas/env.c","usr.bin/doas/env.c","createenv",72,114
17,3,113,1,17,"flattenenv@117-134@usr.bin/doas/env.c","usr.bin/doas/env.c","flattenenv",117,134
42,10,270,2,49,"fillenv@137-186@usr.bin/doas/env.c","usr.bin/doas/env.c","fillenv",137,186
15,3,89,1,18,"prepenv@189-207@usr.bin/doas/env.c","usr.bin/doas/env.c","prepenv",189,207
129,40,660,2,157,"main@57-214@usr.bin/du/du.c","usr.bin/du/du.c","main",57,214
11,5,75,2,10,"links_cmp@226-236@usr.bin/du/du.c","usr.bin/du/du.c","links_cmp",226,236
41,7,235,1,57,"linkchk@244-301@usr.bin/du/du.c","usr.bin/du/du.c","linkchk",244,301
12,3,78,3,12,"prtout@304-316@usr.bin/du/du.c","usr.bin/du/du.c","prtout",304,316
6,1,21,1,6,"usage@319-325@usr.bin/du/du.c","usr.bin/du/du.c","usage",319,325
7,1,23,1,7,"usage@54-61@usr.bin/encrypt/encrypt.c","usr.bin/encrypt/encrypt.c","usage",54,61
21,6,154,3,23,"print_passwd@64-87@usr.bin/encrypt/encrypt.c","usr.bin/encrypt/encrypt.c","print_passwd",64,87
70,19,444,2,85,"main@90-175@usr.bin/encrypt/encrypt.c","usr.bin/encrypt/encrypt.c","main",90,175
34,11,235,2,45,"main@42-87@usr.bin/env/env.c","usr.bin/env/env.c","main",42,87
7,1,29,1,7,"usage@90-97@usr.bin/env/env.c","usr.bin/env/env.c","usage",90,97
79,24,408,2,87,"main@49-136@usr.bin/expand/expand.c","usr.bin/expand/expand.c","main",49,136
24,12,148,1,24,"getstops@139-163@usr.bin/expand/expand.c","usr.bin/expand/expand.c","getstops",139,163
6,1,25,1,5,"usage@166-171@usr.bin/expand/expand.c","usr.bin/expand/expand.c","usage",166,171
4,1,18,2,3,"main@6-9@usr.bin/false/false.c","usr.bin/false/false.c","main",6,9
5,1,20,1,4,"usage@90-94@usr.bin/file/file.c","usr.bin/file/file.c","usage",90,94
109,38,672,2,118,"main@97-215@usr.bin/file/file.c","usr.bin/file/file.c","main",97,215
33,11,218,2,37,"prepare_input@218-255@usr.bin/file/file.c","usr.bin/file/file.c","prepare_input",218,255
35,10,233,2,39,"read_link@258-297@usr.bin/file/file.c","usr.bin/file/file.c","read_link",258,297
25,6,125,3,26,"fill_buffer@300-326@usr.bin/file/file.c","usr.bin/file/file.c","fill_buffer",300,326
26,8,196,1,29,"load_file@329-358@usr.bin/file/file.c","usr.bin/file/file.c","load_file",329,358
61,20,398,1,62,"try_stat@361-423@usr.bin/file/file.c","usr.bin/file/file.c","try_stat",361,423
10,3,52,1,10,"try_empty@426-436@usr.bin/file/file.c","usr.bin/file/file.c","try_empty",426,436
17,7,152,1,19,"try_access@439-458@usr.bin/file/file.c","usr.bin/file/file.c","try_access",439,458
29,7,184,1,33,"try_text@461-494@usr.bin/file/file.c","usr.bin/file/file.c","try_text",461,494
14,3,75,1,15,"try_magic@497-512@usr.bin/file/file.c","usr.bin/file/file.c","try_magic",497,512
8,2,39,1,7,"try_unknown@515-522@usr.bin/file/file.c","usr.bin/file/file.c","try_unknown",515,522
33,12,208,2,35,"test_file@525-560@usr.bin/file/file.c","usr.bin/file/file.c","test_file",525,560
15,7,101,2,16,"magic_strtoull@32-48@usr.bin/file/magic-common.c","usr.bin/file/magic-common.c","magic_strtoull",32,48
15,6,96,2,16,"magic_strtoll@51-67@usr.bin/file/magic-common.c","usr.bin/file/magic-common.c","magic_strtoll",51,67
10,3,70,4,11,"magic_vwarnm@70-81@usr.bin/file/magic-common.c","usr.bin/file/magic-common.c","magic_vwarnm",70,81
7,1,45,4,7,"magic_warnm@84-91@usr.bin/file/magic-common.c","usr.bin/file/magic-common.c","magic_warnm",84,91
7,1,46,3,7,"magic_warn@94-101@usr.bin/file/magic-common.c","usr.bin/file/magic-common.c","magic_warn",94,101
20,8,156,2,22,"magic_dump_line@26-48@usr.bin/file/magic-dump.c","usr.bin/file/magic-dump.c","magic_dump_line",26,48
8,1,50,1,9,"magic_dump@51-60@usr.bin/file/magic-dump.c","usr.bin/file/magic-dump.c","magic_dump",51,60
6,3,30,1,5,"magic_odigit@35-40@usr.bin/file/magic-load.c","usr.bin/file/magic-load.c","magic_odigit",35,40
10,7,68,1,9,"magic_xdigit@43-52@usr.bin/file/magic-load.c","usr.bin/file/magic-load.c","magic_xdigit",43,52
7,2,34,2,6,"magic_mark_text@55-61@usr.bin/file/magic-load.c","usr.bin/file/magic-load.c","magic_mark_text",55,61
13,2,87,4,13,"magic_make_pattern@64-77@usr.bin/file/magic-load.c","usr.bin/file/magic-load.c","magic_make_pattern",64,77
187,117,851,2,199,"magic_set_result@80-279@usr.bin/file/magic-load.c","usr.bin/file/magic-load.c","magic_set_result",80,279
128,81,458,1,131,"magic_get_strength@282-413@usr.bin/file/magic-load.c","usr.bin/file/magic-load.c","magic_get_strength",282,413
98,37,528,3,103,"magic_get_string@416-519@usr.bin/file/magic-load.c","usr.bin/file/magic-load.c","magic_get_string",416,519
89,26,538,2,100,"magic_parse_offset@522-622@usr.bin/file/magic-load.c","usr.bin/file/magic-load.c","magic_parse_offset",522,622
197,91,1752,2,204,"magic_parse_type@625-829@usr.bin/file/magic-load.c","usr.bin/file/magic-load.c","magic_parse_type",625,829
118,49,801,2,134,"magic_parse_value@832-966@usr.bin/file/magic-load.c","usr.bin/file/magic-load.c","magic_parse_value",832,966
12,5,81,2,18,"magic_compare@969-987@usr.bin/file/magic-load.c","usr.bin/file/magic-load.c","magic_compare",969,987
4,1,28,2,3,"magic_named_compare@991-994@usr.bin/file/magic-load.c","usr.bin/file/magic-load.c","magic_named_compare",991,994
29,12,206,4,32,"magic_adjust_strength@998-1030@usr.bin/file/magic-load.c","usr.bin/file/magic-load.c","magic_adjust_strength",998,1030
30,12,211,4,33,"magic_set_mimetype@1033-1066@usr.bin/file/magic-load.c","usr.bin/file/magic-load.c","magic_set_mimetype",1033,1066
85,25,604,3,105,"magic_load@1069-1174@usr.bin/file/magic-load.c","usr.bin/file/magic-load.c","magic_load",1069,1174
6,1,40,2,6,"magic_get_named@40-46@usr.bin/file/magic-test.c","usr.bin/file/magic-test.c","magic_get_named",40,46
73,34,294,2,72,"magic_reverse_type@49-121@usr.bin/file/magic-test.c","usr.bin/file/magic-test.c","magic_reverse_type",49,121
8,5,59,3,7,"magic_one_eq@124-131@usr.bin/file/magic-test.c","usr.bin/file/magic-test.c","magic_one_eq",124,131
36,14,221,7,36,"magic_test_eq@134-170@usr.bin/file/magic-test.c","usr.bin/file/magic-test.c","magic_test_eq",134,170
9,3,65,4,8,"magic_copy_from@173-181@usr.bin/file/magic-test.c","usr.bin/file/magic-test.c","magic_copy_from",173,181
36,9,227,4,39,"magic_add_result@184-223@usr.bin/file/magic-test.c","usr.bin/file/magic-test.c","magic_add_result",184,223
19,5,135,4,19,"magic_add_string@226-245@usr.bin/file/magic-test.c","usr.bin/file/magic-test.c","magic_add_string",226,245
22,9,115,3,21,"magic_test_signed@248-269@usr.bin/file/magic-test.c","usr.bin/file/magic-test.c","magic_test_signed",248,269
22,9,115,3,21,"magic_test_unsigned@272-293@usr.bin/file/magic-test.c","usr.bin/file/magic-test.c","magic_test_unsigned",272,293
10,3,47,3,9,"magic_test_double@296-305@usr.bin/file/magic-test.c","usr.bin/file/magic-test.c","magic_test_double",296,305
5,1,21,2,4,"magic_test_type_none@308-312@usr.bin/file/magic-test.c","usr.bin/file/magic-test.c","magic_test_type_none",308,312
27,11,225,2,29,"magic_test_type_byte@315-344@usr.bin/file/magic-test.c","usr.bin/file/magic-test.c","magic_test_type_byte",315,344
31,13,265,2,33,"magic_test_type_short@347-380@usr.bin/file/magic-test.c","usr.bin/file/magic-test.c","magic_test_type_short",347,380
31,13,265,2,33,"magic_test_type_long@383-416@usr.bin/file/magic-test.c","usr.bin/file/magic-test.c","magic_test_type_long",383,416
31,13,266,2,33,"magic_test_type_quad@419-452@usr.bin/file/magic-test.c","usr.bin/file/magic-test.c","magic_test_type_quad",419,452
27,11,226,2,29,"magic_test_type_ubyte@455-484@usr.bin/file/magic-test.c","usr.bin/file/magic-test.c","magic_test_type_ubyte",455,484
31,13,256,2,33,"magic_test_type_ushort@487-520@usr.bin/file/magic-test.c","usr.bin/file/magic-test.c","magic_test_type_ushort",487,520
31,13,256,2,33,"magic_test_type_ulong@523-556@usr.bin/file/magic-test.c","usr.bin/file/magic-test.c","magic_test_type_ulong",523,556
31,13,257,2,33,"magic_test_type_uquad@559-592@usr.bin/file/magic-test.c","usr.bin/file/magic-test.c","magic_test_type_uquad",559,592
21,7,168,2,23,"magic_test_type_float@595-618@usr.bin/file/magic-test.c","usr.bin/file/magic-test.c","magic_test_type_float",595,618
21,7,168,2,23,"magic_test_type_double@621-644@usr.bin/file/magic-test.c","usr.bin/file/magic-test.c","magic_test_type_double",621,644
62,19,326,2,64,"magic_test_type_string@647-711@usr.bin/file/magic-test.c","usr.bin/file/magic-test.c","magic_test_type_string",647,711
55,16,310,2,57,"magic_test_type_pstring@714-771@usr.bin/file/magic-test.c","usr.bin/file/magic-test.c","magic_test_type_pstring",714,771
41,15,296,2,43,"magic_test_type_date@774-817@usr.bin/file/magic-test.c","usr.bin/file/magic-test.c","magic_test_type_date",774,817
41,15,296,2,43,"magic_test_type_qdate@820-863@usr.bin/file/magic-test.c","usr.bin/file/magic-test.c","magic_test_type_qdate",820,863
41,15,296,2,43,"magic_test_type_udate@866-909@usr.bin/file/magic-test.c","usr.bin/file/magic-test.c","magic_test_type_udate",866,909
41,15,276,2,43,"magic_test_type_uqdate@912-955@usr.bin/file/magic-test.c","usr.bin/file/magic-test.c","magic_test_type_uqdate",912,955
5,1,22,2,4,"magic_test_type_bestring16@958-962@usr.bin/file/magic-test.c","usr.bin/file/magic-test.c","magic_test_type_bestring16",958,962
5,1,22,2,4,"magic_test_type_lestring16@965-969@usr.bin/file/magic-test.c","usr.bin/file/magic-test.c","magic_test_type_lestring16",965,969
5,1,22,2,4,"magic_test_type_melong@972-976@usr.bin/file/magic-test.c","usr.bin/file/magic-test.c","magic_test_type_melong",972,976
5,1,22,2,4,"magic_test_type_medate@979-983@usr.bin/file/magic-test.c","usr.bin/file/magic-test.c","magic_test_type_medate",979,983
5,1,22,2,4,"magic_test_type_meldate@986-990@usr.bin/file/magic-test.c","usr.bin/file/magic-test.c","magic_test_type_meldate",986,990
44,11,265,2,46,"magic_test_type_regex@993-1039@usr.bin/file/magic-test.c","usr.bin/file/magic-test.c","magic_test_type_regex",993,1039
86,35,585,2,96,"magic_test_type_search@1042-1138@usr.bin/file/magic-test.c","usr.bin/file/magic-test.c","magic_test_type_search",1042,1138
6,3,46,2,5,"magic_test_type_default@1141-1146@usr.bin/file/magic-test.c","usr.bin/file/magic-test.c","magic_test_type_default",1141,1146
6,2,38,2,5,"magic_test_type_clear@1149-1154@usr.bin/file/magic-test.c","usr.bin/file/magic-test.c","magic_test_type_clear",1149,1154
5,1,22,2,4,"magic_test_type_name@1157-1161@usr.bin/file/magic-test.c","usr.bin/file/magic-test.c","magic_test_type_name",1157,1161
5,1,21,2,4,"magic_test_type_use@1164-1168@usr.bin/file/magic-test.c","usr.bin/file/magic-test.c","magic_test_type_use",1164,1168
20,1,113,4,24,"magic_test_children@1239-1263@usr.bin/file/magic-test.c","usr.bin/file/magic-test.c","magic_test_children",1239,1263
109,37,724,2,117,"magic_test_line@1266-1383@usr.bin/file/magic-test.c","usr.bin/file/magic-test.c","magic_test_line",1266,1383
23,6,161,4,27,"magic_test@1386-1413@usr.bin/file/magic-test.c","usr.bin/file/magic-test.c","magic_test",1386,1413
9,4,53,1,9,"text_is_ascii@82-91@usr.bin/file/text.c","usr.bin/file/text.c","text_is_ascii",82,91
6,2,26,1,5,"text_is_latin1@94-99@usr.bin/file/text.c","usr.bin/file/text.c","text_is_latin1",94,99
6,2,26,1,5,"text_is_extended@102-107@usr.bin/file/text.c","usr.bin/file/text.c","text_is_extended",102,107
10,3,67,3,10,"text_try_test@110-120@usr.bin/file/text.c","usr.bin/file/text.c","text_try_test",110,120
10,4,65,2,9,"text_get_type@123-132@usr.bin/file/text.c","usr.bin/file/text.c","text_get_type",123,132
29,11,204,3,33,"text_try_words@135-168@usr.bin/file/text.c","usr.bin/file/text.c","text_try_words",135,168
10,3,49,1,10,"xmalloc@26-36@usr.bin/file/xmalloc.c","usr.bin/file/xmalloc.c","xmalloc",26,36
10,4,60,2,10,"xcalloc@39-49@usr.bin/file/xmalloc.c","usr.bin/file/xmalloc.c","xcalloc",39,49
9,2,49,3,9,"xreallocarray@52-61@usr.bin/file/xmalloc.c","usr.bin/file/xmalloc.c","xreallocarray",52,61
7,2,36,1,7,"xstrdup@64-71@usr.bin/file/xmalloc.c","usr.bin/file/xmalloc.c","xstrdup",64,71
11,3,65,3,13,"xasprintf@74-87@usr.bin/file/xmalloc.c","usr.bin/file/xmalloc.c","xasprintf",74,87
34,6,196,1,80,"find_formplan@57-137@usr.bin/find/find.c","usr.bin/find/find.c","find_formplan",57,137
68,24,391,2,84,"find_execute@150-234@usr.bin/find/find.c","usr.bin/find/find.c","find_execute",150,234
21,9,162,3,21,"find_traverse@246-267@usr.bin/find/find.c","usr.bin/find/find.c","find_traverse",246,267
27,9,162,4,34,"find_parsenum@122-156@usr.bin/find/function.c","usr.bin/find/function.c","find_parsenum",122,156
6,1,39,2,6,"f_amin@175-181@usr.bin/find/function.c","usr.bin/find/function.c","f_amin",175,181
9,1,60,3,10,"c_amin@184-194@usr.bin/find/function.c","usr.bin/find/function.c","c_amin",184,194
5,1,35,2,5,"f_atime@203-208@usr.bin/find/function.c","usr.bin/find/function.c","f_atime",203,208
9,1,60,3,10,"c_atime@211-221@usr.bin/find/function.c","usr.bin/find/function.c","c_atime",211,221
6,1,39,2,6,"f_cmin@230-236@usr.bin/find/function.c","usr.bin/find/function.c","f_cmin",230,236
9,1,60,3,10,"c_cmin@239-249@usr.bin/find/function.c","usr.bin/find/function.c","c_cmin",239,249
5,1,35,2,5,"f_ctime@258-263@usr.bin/find/function.c","usr.bin/find/function.c","f_ctime",258,263
9,1,60,3,10,"c_ctime@266-276@usr.bin/find/function.c","usr.bin/find/function.c","c_ctime",266,276
4,1,17,2,3,"f_always_true@286-289@usr.bin/find/function.c","usr.bin/find/function.c","f_always_true",286,289
5,1,30,3,5,"c_depth@292-297@usr.bin/find/function.c","usr.bin/find/function.c","c_depth",292,297
29,17,229,2,40,"f_delete@303-343@usr.bin/find/function.c","usr.bin/find/function.c","f_delete",303,343
8,1,42,3,8,"c_delete@346-354@usr.bin/find/function.c","usr.bin/find/function.c","c_delete",346,354
24,10,168,2,24,"f_empty@362-386@usr.bin/find/function.c","usr.bin/find/function.c","f_empty",362,386
5,1,30,3,5,"c_empty@389-394@usr.bin/find/function.c","usr.bin/find/function.c","c_empty",389,394
50,14,373,2,64,"f_exec@418-482@usr.bin/find/function.c","usr.bin/find/function.c","f_exec",418,482
31,6,185,1,45,"run_f_exec@485-530@usr.bin/find/function.c","usr.bin/find/function.c","run_f_exec",485,530
71,20,574,3,103,"c_exec@544-647@usr.bin/find/function.c","usr.bin/find/function.c","c_exec",544,647
43,12,321,2,53,"f_execdir@659-712@usr.bin/find/function.c","usr.bin/find/function.c","f_execdir",659,712
36,9,291,3,41,"c_execdir@722-763@usr.bin/find/function.c","usr.bin/find/function.c","c_execdir",722,763
11,2,72,2,14,"f_flags@771-785@usr.bin/find/function.c","usr.bin/find/function.c","f_flags",771,785
16,3,100,3,20,"c_flags@788-808@usr.bin/find/function.c","usr.bin/find/function.c","c_flags",788,808
6,1,34,3,6,"c_follow@817-823@usr.bin/find/function.c","usr.bin/find/function.c","c_follow",817,823
41,10,263,2,56,"f_fstype@831-887@usr.bin/find/function.c","usr.bin/find/function.c","f_fstype",831,887
25,5,125,3,27,"c_fstype@890-917@usr.bin/find/function.c","usr.bin/find/function.c","c_fstype",890,917
4,1,25,2,3,"f_group@927-930@usr.bin/find/function.c","usr.bin/find/function.c","f_group",927,930
18,3,106,3,21,"c_group@933-954@usr.bin/find/function.c","usr.bin/find/function.c","c_group",933,954
4,1,25,2,3,"f_inum@962-965@usr.bin/find/function.c","usr.bin/find/function.c","f_inum",962,965
12,2,79,3,13,"c_inum@968-981@usr.bin/find/function.c","usr.bin/find/function.c","c_inum",968,981
4,1,25,2,3,"f_links@989-992@usr.bin/find/function.c","usr.bin/find/function.c","f_links",989,992
12,2,79,3,13,"c_links@995-1008@usr.bin/find/function.c","usr.bin/find/function.c","c_links",995,1008
5,1,32,2,4,"f_ls@1016-1020@usr.bin/find/function.c","usr.bin/find/function.c","f_ls",1016,1020
6,1,34,3,6,"c_ls@1023-1029@usr.bin/find/function.c","usr.bin/find/function.c","c_ls",1023,1029
6,2,42,2,6,"f_maxdepth@1038-1044@usr.bin/find/function.c","usr.bin/find/function.c","f_maxdepth",1038,1044
10,2,72,3,10,"c_maxdepth@1047-1057@usr.bin/find/function.c","usr.bin/find/function.c","c_maxdepth",1047,1057
4,1,23,2,4,"f_mindepth@1066-1070@usr.bin/find/function.c","usr.bin/find/function.c","f_mindepth",1066,1070
10,2,72,3,10,"c_mindepth@1073-1083@usr.bin/find/function.c","usr.bin/find/function.c","c_mindepth",1073,1083
5,1,35,2,5,"f_mtime@1092-1097@usr.bin/find/function.c","usr.bin/find/function.c","f_mtime",1092,1097
9,1,60,3,10,"c_mtime@1100-1110@usr.bin/find/function.c","usr.bin/find/function.c","c_mtime",1100,1110
6,1,39,2,6,"f_mmin@1119-1125@usr.bin/find/function.c","usr.bin/find/function.c","f_mmin",1119,1125
9,1,60,3,10,"c_mmin@1128-1138@usr.bin/find/function.c","usr.bin/find/function.c","c_mmin",1128,1138
4,1,29,2,3,"f_name@1147-1150@usr.bin/find/function.c","usr.bin/find/function.c","f_name",1147,1150
7,1,40,3,7,"c_name@1153-1160@usr.bin/find/function.c","usr.bin/find/function.c","c_name",1153,1160
4,1,29,2,3,"f_iname@1169-1172@usr.bin/find/function.c","usr.bin/find/function.c","f_iname",1169,1172
7,1,40,3,7,"c_iname@1175-1182@usr.bin/find/function.c","usr.bin/find/function.c","c_iname",1175,1182
6,3,59,2,6,"f_newer@1192-1198@usr.bin/find/function.c","usr.bin/find/function.c","f_newer",1192,1198
11,2,80,3,12,"c_newer@1201-1213@usr.bin/find/function.c","usr.bin/find/function.c","c_newer",1201,1213
6,3,59,2,6,"f_anewer@1223-1229@usr.bin/find/function.c","usr.bin/find/function.c","f_anewer",1223,1229
11,2,80,3,12,"c_anewer@1232-1244@usr.bin/find/function.c","usr.bin/find/function.c","c_anewer",1232,1244
6,3,59,2,6,"f_cnewer@1254-1260@usr.bin/find/function.c","usr.bin/find/function.c","f_cnewer",1254,1260
11,2,80,3,12,"c_cnewer@1263-1275@usr.bin/find/function.c","usr.bin/find/function.c","c_cnewer",1263,1275
4,2,30,2,3,"f_nogroup@1284-1287@usr.bin/find/function.c","usr.bin/find/function.c","f_nogroup",1284,1287
5,1,30,3,5,"c_nogroup@1290-1295@usr.bin/find/function.c","usr.bin/find/function.c","c_nogroup",1290,1295
4,2,30,2,3,"f_nouser@1304-1307@usr.bin/find/function.c","usr.bin/find/function.c","f_nouser",1304,1307
5,1,30,3,5,"c_nouser@1310-1315@usr.bin/find/function.c","usr.bin/find/function.c","c_nouser",1310,1315
4,1,29,2,3,"f_path@1324-1327@usr.bin/find/function.c","usr.bin/find/function.c","f_path",1324,1327
7,1,40,3,7,"c_path@1330-1337@usr.bin/find/function.c","usr.bin/find/function.c","c_path",1330,1337
10,2,68,2,11,"f_perm@1347-1358@usr.bin/find/function.c","usr.bin/find/function.c","f_perm",1347,1358
16,3,98,3,20,"c_perm@1361-1381@usr.bin/find/function.c","usr.bin/find/function.c","c_perm",1361,1381
5,1,29,2,4,"f_print@1390-1394@usr.bin/find/function.c","usr.bin/find/function.c","f_print",1390,1394
6,1,39,2,5,"f_print0@1398-1403@usr.bin/find/function.c","usr.bin/find/function.c","f_print0",1398,1403
5,1,30,3,5,"c_print@1406-1411@usr.bin/find/function.c","usr.bin/find/function.c","c_print",1406,1411
5,1,30,3,5,"c_print0@1414-1419@usr.bin/find/function.c","usr.bin/find/function.c","c_print0",1414,1419
6,2,39,2,6,"f_prune@1427-1433@usr.bin/find/function.c","usr.bin/find/function.c","f_prune",1427,1433
4,1,26,3,3,"c_prune@1436-1439@usr.bin/find/function.c","usr.bin/find/function.c","c_prune",1436,1439
7,2,48,2,7,"f_size@1452-1459@usr.bin/find/function.c","usr.bin/find/function.c","f_size",1452,1459
12,2,71,3,13,"c_size@1462-1475@usr.bin/find/function.c","usr.bin/find/function.c","c_size",1462,1475
4,1,29,2,3,"f_type@1485-1488@usr.bin/find/function.c","usr.bin/find/function.c","f_type",1485,1488
34,8,130,3,36,"c_type@1491-1527@usr.bin/find/function.c","usr.bin/find/function.c","c_type",1491,1527
4,1,25,2,3,"f_user@1537-1540@usr.bin/find/function.c","usr.bin/find/function.c","f_user",1537,1540
18,3,106,3,21,"c_user@1543-1564@usr.bin/find/function.c","usr.bin/find/function.c","c_user",1543,1564
5,1,30,3,5,"c_xdev@1573-1578@usr.bin/find/function.c","usr.bin/find/function.c","c_xdev",1573,1578
8,2,59,2,8,"f_expr@1586-1594@usr.bin/find/function.c","usr.bin/find/function.c","f_expr",1586,1594
4,1,40,3,3,"c_openparen@1602-1605@usr.bin/find/function.c","usr.bin/find/function.c","c_openparen",1602,1605
4,1,40,3,3,"c_closeparen@1608-1611@usr.bin/find/function.c","usr.bin/find/function.c","c_closeparen",1608,1611
8,2,60,2,8,"f_not@1619-1627@usr.bin/find/function.c","usr.bin/find/function.c","f_not",1619,1627
4,1,26,3,3,"c_not@1630-1633@usr.bin/find/function.c","usr.bin/find/function.c","c_not",1630,1633
12,4,103,2,14,"f_or@1642-1656@usr.bin/find/function.c","usr.bin/find/function.c","f_or",1642,1656
4,1,26,3,3,"c_or@1659-1662@usr.bin/find/function.c","usr.bin/find/function.c","c_or",1659,1662
6,3,34,2,6,"plan_cleanup@1676-1682@usr.bin/find/function.c","usr.bin/find/function.c","plan_cleanup",1676,1682
10,2,67,2,11,"palloc@1686-1697@usr.bin/find/function.c","usr.bin/find/function.c","palloc",1686,1697
20,4,194,3,21,"printlong@57-78@usr.bin/find/ls.c","usr.bin/find/ls.c","printlong",57,78
15,5,91,1,20,"printtime@81-101@usr.bin/find/ls.c","usr.bin/find/ls.c","printtime",81,101
11,2,68,1,11,"printlink@104-115@usr.bin/find/ls.c","usr.bin/find/ls.c","printlink",104,115
59,17,337,2,73,"main@59-132@usr.bin/find/main.c","usr.bin/find/main.c","main",59,132
6,1,21,1,5,"usage@135-140@usr.bin/find/main.c","usr.bin/find/main.c","usage",135,140
25,6,166,4,26,"brace_subst@55-81@usr.bin/find/misc.c","usr.bin/find/misc.c","brace_subst",55,81
24,6,143,1,26,"queryuser@89-115@usr.bin/find/misc.c","usr.bin/find/misc.c","queryuser",89,115
7,2,34,1,7,"emalloc@122-129@usr.bin/find/misc.c","usr.bin/find/misc.c","emalloc",122,129
7,2,47,3,7,"ereallocarray@132-139@usr.bin/find/misc.c","usr.bin/find/misc.c","ereallocarray",132,139
16,2,119,1,16,"show_path@147-163@usr.bin/find/misc.c","usr.bin/find/misc.c","show_path",147,163
9,2,53,1,9,"yanknode@50-59@usr.bin/find/operator.c","usr.bin/find/operator.c","yanknode",50,59
32,8,178,1,47,"yankexpr@68-115@usr.bin/find/operator.c","usr.bin/find/operator.c","yankexpr",68,115
19,4,93,1,30,"paren_squish@122-152@usr.bin/find/operator.c","usr.bin/find/operator.c","paren_squish",122,152
38,11,222,1,52,"not_squish@159-211@usr.bin/find/operator.c","usr.bin/find/operator.c","not_squish",159,211
30,8,197,1,45,"or_squish@218-263@usr.bin/find/operator.c","usr.bin/find/operator.c","or_squish",218,263
31,8,184,1,33,"find_create@107-140@usr.bin/find/option.c","usr.bin/find/option.c","find_create",107,140
7,1,49,1,7,"option@143-150@usr.bin/find/option.c","usr.bin/find/option.c","option",143,150
4,1,40,2,3,"typecompare@153-156@usr.bin/find/option.c","usr.bin/find/option.c","typecompare",153,156
69,22,334,2,86,"main@78-164@usr.bin/finger/finger.c","usr.bin/finger/finger.c","main",78,164
25,8,180,1,25,"loginlist@167-192@usr.bin/finger/finger.c","usr.bin/finger/finger.c","loginlist",167,192
66,26,516,2,85,"userlist@195-280@usr.bin/finger/finger.c","usr.bin/finger/finger.c","userlist",195,280
15,5,86,1,15,"lflag_print@54-69@usr.bin/finger/lprint.c","usr.bin/finger/lprint.c","lflag_print",54,69
110,27,815,1,144,"lprint@72-216@usr.bin/finger/lprint.c","usr.bin/finger/lprint.c","lprint",72,216
26,5,147,2,35,"demi_print@219-254@usr.bin/finger/lprint.c","usr.bin/finger/lprint.c","demi_print",219,254
16,4,125,3,16,"show_text@257-273@usr.bin/finger/lprint.c","usr.bin/finger/lprint.c","show_text",257,273
8,2,57,1,8,"vputc@276-284@usr.bin/finger/lprint.c","usr.bin/finger/lprint.c","vputc",276,284
74,18,456,1,96,"netfinger@48-144@usr.bin/finger/net.c","usr.bin/finger/net.c","netfinger",48,144
61,19,434,1,82,"sflag_print@45-127@usr.bin/finger/sprint.c","usr.bin/finger/sprint.c","sflag_print",45,127
11,3,94,1,11,"sort@130-141@usr.bin/finger/sprint.c","usr.bin/finger/sprint.c","sort",130,141
4,1,42,2,3,"psort@144-147@usr.bin/finger/sprint.c","usr.bin/finger/sprint.c","psort",144,147
17,4,101,1,17,"stimeprint@150-167@usr.bin/finger/sprint.c","usr.bin/finger/sprint.c","stimeprint",150,167
12,3,95,1,16,"find_idle_and_ttywrite@58-74@usr.bin/finger/util.c","usr.bin/finger/util.c","find_idle_and_ttywrite",58,74
7,2,34,1,6,"estrdup@77-83@usr.bin/finger/util.c","usr.bin/finger/util.c","estrdup",77,83
44,17,406,2,48,"userinfo@86-134@usr.bin/finger/util.c","usr.bin/finger/util.c","userinfo",86,134
13,4,123,2,15,"match@137-152@usr.bin/finger/util.c","usr.bin/finger/util.c","match",137,152
22,5,147,4,27,"expandusername@156-183@usr.bin/finger/util.c","usr.bin/finger/util.c","expandusername",156,183
37,15,289,1,45,"enter_lastlog@186-231@usr.bin/finger/util.c","usr.bin/finger/util.c","enter_lastlog",186,231
11,1,88,2,11,"enter_where@234-245@usr.bin/finger/util.c","usr.bin/finger/util.c","enter_where",234,245
24,5,143,1,24,"enter_person@248-272@usr.bin/finger/util.c","usr.bin/finger/util.c","enter_person",248,272
9,3,53,1,10,"find_person@275-285@usr.bin/finger/util.c","usr.bin/finger/util.c","find_person",275,285
8,3,63,1,9,"hash@288-297@usr.bin/finger/util.c","usr.bin/finger/util.c","hash",288,297
7,2,41,1,7,"palloc@300-307@usr.bin/finger/util.c","usr.bin/finger/util.c","palloc",300,307
14,3,84,1,14,"walloc@310-324@usr.bin/finger/util.c","usr.bin/finger/util.c","walloc",310,324
43,9,238,1,46,"prphone@327-373@usr.bin/finger/util.c","usr.bin/finger/util.c","prphone",327,373
16,4,77,3,17,"get_positive@199-216@usr.bin/fmt/fmt.c","usr.bin/fmt/fmt.c","get_positive",199,216
82,36,455,2,98,"main@257-355@usr.bin/fmt/fmt.c","usr.bin/fmt/fmt.c","main",257,355
11,2,57,1,11,"process_named_file@360-371@usr.bin/fmt/fmt.c","usr.bin/fmt/fmt.c","process_named_file",360,371
96,35,526,2,122,"process_stream@386-508@usr.bin/fmt/fmt.c","usr.bin/fmt/fmt.c","process_stream",386,508
18,4,63,1,18,"indent_length@513-531@usr.bin/fmt/fmt.c","usr.bin/fmt/fmt.c","indent_length",513,531
8,5,66,1,8,"might_be_header@540-548@usr.bin/fmt/fmt.c","usr.bin/fmt/fmt.c","might_be_header",540,548
9,2,34,1,9,"new_paragraph@553-562@usr.bin/fmt/fmt.c","usr.bin/fmt/fmt.c","new_paragraph",553,562
13,5,50,1,13,"output_indent@567-580@usr.bin/fmt/fmt.c","usr.bin/fmt/fmt.c","output_indent",567,580
27,12,168,6,33,"output_word@587-620@usr.bin/fmt/fmt.c","usr.bin/fmt/fmt.c","output_word",587,620
35,10,208,2,36,"center_stream@626-662@usr.bin/fmt/fmt.c","usr.bin/fmt/fmt.c","center_stream",626,662
30,17,201,1,31,"get_line@673-704@usr.bin/fmt/fmt.c","usr.bin/fmt/fmt.c","get_line",673,704
8,2,40,2,8,"xrealloc@709-717@usr.bin/fmt/fmt.c","usr.bin/fmt/fmt.c","xrealloc",709,717
9,1,26,1,9,"usage@720-729@usr.bin/fmt/fmt.c","usr.bin/fmt/fmt.c","usage",720,729
63,26,366,2,67,"main@56-123@usr.bin/fold/fold.c","usr.bin/fold/fold.c","main",56,123
91,29,549,1,123,"fold@137-260@usr.bin/fold/fold.c","usr.bin/fold/fold.c","fold",137,260
4,2,25,1,3,"isu8cont@263-266@usr.bin/fold/fold.c","usr.bin/fold/fold.c","isu8cont",263,266
5,1,21,1,4,"usage@269-273@usr.bin/fold/fold.c","usr.bin/fold/fold.c","usage",269,273
53,18,356,2,57,"main@48-105@usr.bin/from/from.c","usr.bin/from/from.c","main",48,105
22,8,140,2,29,"mail_spool@108-137@usr.bin/from/from.c","usr.bin/from/from.c","mail_spool",108,137
21,9,157,2,22,"match@140-162@usr.bin/from/from.c","usr.bin/from/from.c","match",140,162
4,2,19,1,3,"hide@130-133@usr.bin/fstat/fstat.c","usr.bin/fstat/fstat.c","hide",130,133
146,51,781,2,178,"main@136-314@usr.bin/fstat/fstat.c","usr.bin/fstat/fstat.c","main",136,314
16,6,63,1,15,"fstat_header@317-332@usr.bin/fstat/fstat.c","usr.bin/fstat/fstat.c","fstat_header",317,332
30,9,133,1,31,"fstat_dofile@363-394@usr.bin/fstat/fstat.c","usr.bin/fstat/fstat.c","fstat_dofile",363,394
90,34,588,1,94,"vtrans@397-491@usr.bin/fstat/fstat.c","usr.bin/fstat/fstat.c","vtrans",397,491
19,5,134,1,28,"pipetrans@494-522@usr.bin/fstat/fstat.c","usr.bin/fstat/fstat.c","pipetrans",494,522
12,3,75,1,13,"kqueuetrans@525-538@usr.bin/fstat/fstat.c","usr.bin/fstat/fstat.c","kqueuetrans",525,538
20,4,166,1,22,"inet6_addrstr@541-563@usr.bin/fstat/fstat.c","usr.bin/fstat/fstat.c","inet6_addrstr",541,563
11,5,93,3,12,"splice_insert@566-578@usr.bin/fstat/fstat.c","usr.bin/fstat/fstat.c","splice_insert",566,578
9,3,70,2,9,"splice_find@581-590@usr.bin/fstat/fstat.c","usr.bin/fstat/fstat.c","splice_find",581,590
17,8,142,2,17,"find_splices@593-610@usr.bin/fstat/fstat.c","usr.bin/fstat/fstat.c","find_splices",593,610
32,11,248,1,32,"print_inet_details@613-645@usr.bin/fstat/fstat.c","usr.bin/fstat/fstat.c","print_inet_details",613,645
43,11,316,1,43,"print_inet6_details@648-691@usr.bin/fstat/fstat.c","usr.bin/fstat/fstat.c","print_inet6_details",648,691
7,3,36,1,6,"print_sock_details@694-700@usr.bin/fstat/fstat.c","usr.bin/fstat/fstat.c","print_sock_details",694,700
88,21,548,1,109,"socktrans@703-812@usr.bin/fstat/fstat.c","usr.bin/fstat/fstat.c","socktrans",703,812
11,3,57,1,11,"getinetproto@819-830@usr.bin/fstat/fstat.c","usr.bin/fstat/fstat.c","getinetproto",819,830
37,11,243,1,46,"getfname@833-879@usr.bin/fstat/fstat.c","usr.bin/fstat/fstat.c","getfname",833,879
16,6,113,1,16,"signame_to_signum@882-898@usr.bin/fstat/fstat.c","usr.bin/fstat/fstat.c","signame_to_signum",882,898
11,2,36,1,10,"usage@901-911@usr.bin/fstat/fstat.c","usr.bin/fstat/fstat.c","usage",901,911
10,4,55,2,9,"match@68-77@usr.bin/fstat/fuser.c","usr.bin/fstat/fuser.c","match",68,77
37,10,198,1,44,"fuser_check@84-128@usr.bin/fstat/fuser.c","usr.bin/fstat/fuser.c","fuser_check",84,128
20,6,122,1,25,"printfu@134-159@usr.bin/fstat/fuser.c","usr.bin/fstat/fuser.c","printfu",134,159
17,3,96,1,17,"fuser_run@165-182@usr.bin/fstat/fuser.c","usr.bin/fstat/fuser.c","fuser_run",165,182
5,1,27,2,5,"setascii@93-98@usr.bin/ftp/cmds.c","usr.bin/ftp/cmds.c","setascii",93,98
5,1,27,2,5,"setftmode@105-110@usr.bin/ftp/cmds.c","usr.bin/ftp/cmds.c","setftmode",105,110
5,1,27,2,5,"setform@117-122@usr.bin/ftp/cmds.c","usr.bin/ftp/cmds.c","setform",117,122
5,1,27,2,5,"setstruct@129-134@usr.bin/ftp/cmds.c","usr.bin/ftp/cmds.c","setstruct",129,134
4,1,25,2,4,"reput@137-141@usr.bin/ftp/cmds.c","usr.bin/ftp/cmds.c","reput",137,141
4,1,25,2,4,"put@144-148@usr.bin/ftp/cmds.c","usr.bin/ftp/cmds.c","put",144,148
54,22,367,3,58,"putit@154-212@usr.bin/ftp/cmds.c","usr.bin/ftp/cmds.c","putit",154,212
202,74,1264,2,233,"mput@218-451@usr.bin/ftp/cmds.c","usr.bin/ftp/cmds.c","mput",218,451
4,1,27,2,4,"reget@454-458@usr.bin/ftp/cmds.c","usr.bin/ftp/cmds.c","reget",454,458
4,2,16,1,4,"onoff@461-465@usr.bin/ftp/cmds.c","usr.bin/ftp/cmds.c","onoff",461,465
57,11,372,2,57,"status@472-529@usr.bin/ftp/cmds.c","usr.bin/ftp/cmds.c","status",472,529
16,7,135,4,15,"togglevar@535-550@usr.bin/ftp/cmds.c","usr.bin/ftp/cmds.c","togglevar",535,550
4,1,27,2,4,"setbell@557-561@usr.bin/ftp/cmds.c","usr.bin/ftp/cmds.c","setbell",557,561
5,1,31,2,5,"setedit@568-573@usr.bin/ftp/cmds.c","usr.bin/ftp/cmds.c","setedit",568,573
5,1,31,2,5,"setepsv4@580-585@usr.bin/ftp/cmds.c","usr.bin/ftp/cmds.c","setepsv4",580,585
4,1,27,2,4,"settrace@592-596@usr.bin/ftp/cmds.c","usr.bin/ftp/cmds.c","settrace",592,596
31,7,189,2,31,"sethash@603-634@usr.bin/ftp/cmds.c","usr.bin/ftp/cmds.c","sethash",603,634
4,1,27,2,4,"setverbose@641-645@usr.bin/ftp/cmds.c","usr.bin/ftp/cmds.c","setverbose",641,645
4,1,27,2,4,"setport@652-656@usr.bin/ftp/cmds.c","usr.bin/ftp/cmds.c","setport",652,656
4,1,27,2,4,"setprogress@663-667@usr.bin/ftp/cmds.c","usr.bin/ftp/cmds.c","setprogress",663,667
4,1,27,2,4,"setprompt@674-678@usr.bin/ftp/cmds.c","usr.bin/ftp/cmds.c","setprompt",674,678
37,13,224,2,37,"setgate@685-722@usr.bin/ftp/cmds.c","usr.bin/ftp/cmds.c","setgate",685,722
4,1,27,2,4,"setglob@729-733@usr.bin/ftp/cmds.c","usr.bin/ftp/cmds.c","setglob",729,733
4,1,27,2,4,"setpreserve@740-744@usr.bin/ftp/cmds.c","usr.bin/ftp/cmds.c","setpreserve",740,744
32,7,184,2,32,"setdebug@751-783@usr.bin/ftp/cmds.c","usr.bin/ftp/cmds.c","setdebug",751,783
29,7,181,2,29,"lcd@789-818@usr.bin/ftp/cmds.c","usr.bin/ftp/cmds.c","lcd",789,818
9,4,71,2,9,"deletecmd@824-833@usr.bin/ftp/cmds.c","usr.bin/ftp/cmds.c","deletecmd",824,833
29,10,186,2,29,"mdelete@839-868@usr.bin/ftp/cmds.c","usr.bin/ftp/cmds.c","mdelete",839,868
13,7,108,2,13,"renamefile@874-887@usr.bin/ftp/cmds.c","usr.bin/ftp/cmds.c","renamefile",874,887
34,13,256,2,36,"ls@893-929@usr.bin/ftp/cmds.c","usr.bin/ftp/cmds.c","ls",893,929
38,16,280,2,38,"mls@935-973@usr.bin/ftp/cmds.c","usr.bin/ftp/cmds.c","mls",935,973
51,12,344,2,51,"shell@980-1031@usr.bin/ftp/cmds.c","usr.bin/ftp/cmds.c","shell",980,1031
43,12,273,2,45,"user@1037-1082@usr.bin/ftp/cmds.c","usr.bin/ftp/cmds.c","user",1037,1082
10,3,56,2,13,"pwd@1089-1102@usr.bin/ftp/cmds.c","usr.bin/ftp/cmds.c","pwd",1089,1102
9,2,52,2,9,"lpwd@1109-1118@usr.bin/ftp/cmds.c","usr.bin/ftp/cmds.c","lpwd",1109,1118
14,7,102,2,14,"makedir@1124-1138@usr.bin/ftp/cmds.c","usr.bin/ftp/cmds.c","makedir",1124,1138
14,7,102,2,14,"removedir@1144-1158@usr.bin/ftp/cmds.c","usr.bin/ftp/cmds.c","removedir",1144,1158
9,3,61,2,9,"quote@1164-1173@usr.bin/ftp/cmds.c","usr.bin/ftp/cmds.c","quote",1164,1173
9,3,61,2,9,"site@1181-1190@usr.bin/ftp/cmds.c","usr.bin/ftp/cmds.c","site",1181,1190
21,8,174,3,31,"quote1@1197-1228@usr.bin/ftp/cmds.c","usr.bin/ftp/cmds.c","quote1",1197,1228
12,6,99,2,12,"do_chmod@1231-1243@usr.bin/ftp/cmds.c","usr.bin/ftp/cmds.c","do_chmod",1231,1243
7,2,45,2,7,"do_umask@1246-1253@usr.bin/ftp/cmds.c","usr.bin/ftp/cmds.c","do_umask",1246,1253
7,2,45,2,7,"idle@1256-1263@usr.bin/ftp/cmds.c","usr.bin/ftp/cmds.c","idle",1256,1263
7,2,45,2,7,"rmthelp@1269-1276@usr.bin/ftp/cmds.c","usr.bin/ftp/cmds.c","rmthelp",1269,1276
10,3,47,2,10,"quit@1283-1293@usr.bin/ftp/cmds.c","usr.bin/ftp/cmds.c","quit",1283,1293
14,3,76,2,14,"account@1296-1310@usr.bin/ftp/cmds.c","usr.bin/ftp/cmds.c","account",1296,1310
17,3,62,1,17,"proxabort@1316-1333@usr.bin/ftp/cmds.c","usr.bin/ftp/cmds.c","proxabort",1316,1333
56,11,331,2,56,"doproxy@1336-1392@usr.bin/ftp/cmds.c","usr.bin/ftp/cmds.c","doproxy",1336,1392
4,1,27,2,4,"setcase@1395-1399@usr.bin/ftp/cmds.c","usr.bin/ftp/cmds.c","setcase",1395,1399
4,1,27,2,4,"setcr@1402-1406@usr.bin/ftp/cmds.c","usr.bin/ftp/cmds.c","setcr",1402,1406
17,3,98,2,16,"setntrans@1409-1425@usr.bin/ftp/cmds.c","usr.bin/ftp/cmds.c","setntrans",1409,1425
29,8,176,2,29,"setnmap@1428-1457@usr.bin/ftp/cmds.c","usr.bin/ftp/cmds.c","setnmap",1428,1457
5,2,31,2,5,"setpassive@1460-1465@usr.bin/ftp/cmds.c","usr.bin/ftp/cmds.c","setpassive",1460,1465
4,1,27,2,4,"setsunique@1468-1472@usr.bin/ftp/cmds.c","usr.bin/ftp/cmds.c","setsunique",1468,1472
4,1,27,2,4,"setrunique@1475-1479@usr.bin/ftp/cmds.c","usr.bin/ftp/cmds.c","setrunique",1475,1479
12,5,63,2,12,"cdup@1484-1496@usr.bin/ftp/cmds.c","usr.bin/ftp/cmds.c","cdup",1484,1496
18,4,90,2,18,"restart@1502-1520@usr.bin/ftp/cmds.c","usr.bin/ftp/cmds.c","restart",1502,1520
4,1,21,2,4,"syst@1527-1531@usr.bin/ftp/cmds.c","usr.bin/ftp/cmds.c","syst",1527,1531
55,17,339,2,55,"macdef@1534-1589@usr.bin/ftp/cmds.c","usr.bin/ftp/cmds.c","macdef",1534,1589
13,5,102,2,13,"sizecmd@1595-1608@usr.bin/ftp/cmds.c","usr.bin/ftp/cmds.c","sizecmd",1595,1608
13,5,105,2,13,"modtime@1614-1627@usr.bin/ftp/cmds.c","usr.bin/ftp/cmds.c","modtime",1614,1627
4,2,32,2,4,"rmtstatus@1633-1637@usr.bin/ftp/cmds.c","usr.bin/ftp/cmds.c","rmtstatus",1633,1637
4,1,28,2,4,"newer@1643-1647@usr.bin/ftp/cmds.c","usr.bin/ftp/cmds.c","newer",1643,1647
32,9,225,2,33,"page@1653-1686@usr.bin/ftp/cmds.c","usr.bin/ftp/cmds.c","page",1653,1686
4,1,34,2,3,"comparstr@56-59@usr.bin/ftp/complete.c","usr.bin/ftp/complete.c","comparstr",56,59
41,11,295,3,47,"complete_ambiguous@72-119@usr.bin/ftp/complete.c","usr.bin/ftp/complete.c","complete_ambiguous",72,119
18,4,117,2,20,"complete_command@125-145@usr.bin/ftp/complete.c","usr.bin/ftp/complete.c","complete_command",125,145
42,10,289,2,47,"complete_local@151-198@usr.bin/ftp/complete.c","usr.bin/ftp/complete.c","complete_local",151,198
66,16,420,2,72,"complete_remote@204-276@usr.bin/ftp/complete.c","usr.bin/ftp/complete.c","complete_remote",204,276
57,22,386,2,67,"complete@282-349@usr.bin/ftp/complete.c","usr.bin/ftp/complete.c","complete",282,349
22,12,123,4,25,"ftpvis@355-380@usr.bin/ftp/complete.c","usr.bin/ftp/complete.c","ftpvis",355,380
114,34,682,1,119,"cookie_load@58-177@usr.bin/ftp/cookie.c","usr.bin/ftp/cookie.c","cookie_load",58,177
41,11,296,4,48,"cookie_get@180-228@usr.bin/ftp/cookie.c","usr.bin/ftp/cookie.c","cookie_get",180,228
102,27,630,2,103,"domacro@43-146@usr.bin/ftp/domacro.c","usr.bin/ftp/domacro.c","domacro",43,146
8,6,81,1,18,"unsafe_char@107-125@usr.bin/ftp/fetch.c","usr.bin/ftp/fetch.c","unsafe_char",107,125
21,6,151,1,34,"url_encode@132-166@usr.bin/ftp/fetch.c","usr.bin/ftp/fetch.c","url_encode",132,166
5,1,21,1,4,"tooslow@170-174@usr.bin/ftp/fetch.c","usr.bin/ftp/fetch.c","tooslow",170,174
676,219,4258,4,872,"url_get@182-1054@usr.bin/ftp/fetch.c","usr.bin/ftp/fetch.c","url_get",182,1054
7,1,34,1,7,"aborthttp@1061-1068@usr.bin/ftp/fetch.c","usr.bin/ftp/fetch.c","aborthttp",1061,1068
7,1,34,1,7,"abortfile@1075-1082@usr.bin/ftp/fetch.c","usr.bin/ftp/fetch.c","abortfile",1075,1082
225,74,1409,3,301,"auto_fetch@1099-1400@usr.bin/ftp/fetch.c","usr.bin/ftp/fetch.c","auto_fetch",1099,1400
25,8,175,1,30,"urldecode@1403-1433@usr.bin/ftp/fetch.c","usr.bin/ftp/fetch.c","urldecode",1403,1433
15,3,102,1,17,"recode_credentials@1436-1453@usr.bin/ftp/fetch.c","usr.bin/ftp/fetch.c","recode_credentials",1436,1453
18,5,98,1,19,"hextochar@1456-1475@usr.bin/ftp/fetch.c","usr.bin/ftp/fetch.c","hextochar",1456,1475
10,6,92,1,12,"isurl@1478-1490@usr.bin/ftp/fetch.c","usr.bin/ftp/fetch.c","isurl",1478,1490
9,3,56,3,10,"ftp_readline@1493-1503@usr.bin/ftp/fetch.c","usr.bin/ftp/fetch.c","ftp_readline",1493,1503
16,6,114,4,20,"ftp_read@1506-1526@usr.bin/ftp/fetch.c","usr.bin/ftp/fetch.c","ftp_read",1506,1526
19,4,112,4,25,"ftp_printf@1529-1554@usr.bin/ftp/fetch.c","usr.bin/ftp/fetch.c","ftp_printf",1529,1554
21,6,125,3,21,"SSL_vprintf@1558-1579@usr.bin/ftp/fetch.c","usr.bin/ftp/fetch.c","SSL_vprintf",1558,1579
29,9,186,2,30,"SSL_readline@1582-1612@usr.bin/ftp/fetch.c","usr.bin/ftp/fetch.c","SSL_readline",1582,1612
34,10,228,3,39,"proxy_connect@1615-1654@usr.bin/ftp/fetch.c","usr.bin/ftp/fetch.c","proxy_connect",1615,1654
167,41,1107,2,195,"hookup@105-300@usr.bin/ftp/ftp.c","usr.bin/ftp/ftp.c","hookup",105,300
10,2,50,1,11,"cmdabort@304-315@usr.bin/ftp/ftp.c","usr.bin/ftp/ftp.c","cmdabort",304,315
37,7,231,2,39,"command@318-357@usr.bin/ftp/ftp.c","usr.bin/ftp/ftp.c","command",318,357
11,3,56,1,12,"send_noop_char@369-381@usr.bin/ftp/ftp.c","usr.bin/ftp/ftp.c","send_noop_char",369,381
5,2,19,1,4,"may_reset_noop_timeout@384-388@usr.bin/ftp/ftp.c","usr.bin/ftp/ftp.c","may_reset_noop_timeout",384,388
19,5,105,1,26,"may_receive_noop_ack@391-417@usr.bin/ftp/ftp.c","usr.bin/ftp/ftp.c","may_receive_noop_ack",391,417
14,4,58,1,14,"may_send_noop_char@420-434@usr.bin/ftp/ftp.c","usr.bin/ftp/ftp.c","may_send_noop_char",420,434
115,62,745,1,117,"getreply@439-556@usr.bin/ftp/ftp.c","usr.bin/ftp/ftp.c","getreply",439,556
10,1,54,1,12,"abortsend@563-575@usr.bin/ftp/ftp.c","usr.bin/ftp/ftp.c","abortsend",563,575
270,89,1671,4,274,"sendrequest@578-852@usr.bin/ftp/ftp.c","usr.bin/ftp/ftp.c","sendrequest",578,852
9,1,42,1,9,"abortrecv@859-868@usr.bin/ftp/ftp.c","usr.bin/ftp/ftp.c","abortrecv",859,868
375,129,2255,6,384,"recvrequest@871-1255@usr.bin/ftp/ftp.c","usr.bin/ftp/ftp.c","recvrequest",871,1255
374,92,2505,1,416,"initconn@1262-1678@usr.bin/ftp/ftp.c","usr.bin/ftp/ftp.c","initconn",1262,1678
24,5,156,1,25,"dataconn@1681-1706@usr.bin/ftp/ftp.c","usr.bin/ftp/ftp.c","dataconn",1681,1706
7,2,27,1,7,"psummary@1710-1717@usr.bin/ftp/ftp.c","usr.bin/ftp/ftp.c","psummary",1710,1717
5,1,15,1,5,"psabort@1721-1726@usr.bin/ftp/ftp.c","usr.bin/ftp/ftp.c","psabort",1721,1726
84,6,525,1,84,"pswitch@1729-1813@usr.bin/ftp/ftp.c","usr.bin/ftp/ftp.c","pswitch",1729,1813
10,1,45,1,10,"abortpt@1817-1827@usr.bin/ftp/ftp.c","usr.bin/ftp/ftp.c","abortpt",1817,1827
118,36,666,3,118,"proxtrans@1830-1948@usr.bin/ftp/ftp.c","usr.bin/ftp/ftp.c","proxtrans",1830,1948
16,4,102,2,16,"reset@1953-1969@usr.bin/ftp/ftp.c","usr.bin/ftp/ftp.c","reset",1953,1969
42,12,259,1,42,"gunique@1973-2015@usr.bin/ftp/ftp.c","usr.bin/ftp/ftp.c","gunique",1973,2015
7,1,41,1,10,"abortforce@2021-2031@usr.bin/ftp/ftp.c","usr.bin/ftp/ftp.c","abortforce",2021,2031
47,15,312,1,54,"abort_remote@2034-2088@usr.bin/ftp/ftp.c","usr.bin/ftp/ftp.c","abort_remote",2034,2088
19,9,103,2,22,"parse_unix@26-48@usr.bin/ftp/list.c","usr.bin/ftp/list.c","parse_unix",26,48
20,10,116,2,23,"parse_windows@51-74@usr.bin/ftp/list.c","usr.bin/ftp/list.c","parse_windows",51,74
7,3,39,2,6,"parse_list@77-83@usr.bin/ftp/list.c","usr.bin/ftp/list.c","parse_list",77,83
56,19,281,1,57,"process_ssl_options@109-166@usr.bin/ftp/main.c","usr.bin/ftp/main.c","process_ssl_options",109,166
284,80,1446,2,361,"main@173-534@usr.bin/ftp/main.c","usr.bin/ftp/main.c","main",173,534
8,1,39,1,9,"intr@537-546@usr.bin/ftp/main.c","usr.bin/ftp/main.c","intr",537,546
30,6,151,1,30,"lostpeer@549-579@usr.bin/ftp/main.c","usr.bin/ftp/main.c","lostpeer",549,579
4,1,11,1,3,"prompt@586-589@usr.bin/ftp/main.c","usr.bin/ftp/main.c","prompt",586,589
76,28,474,1,83,"cmdscanner@595-678@usr.bin/ftp/main.c","usr.bin/ftp/main.c","cmdscanner",595,678
27,9,168,1,28,"getcmd@681-709@usr.bin/ftp/main.c","usr.bin/ftp/main.c","getcmd",681,709
21,5,102,1,21,"makeargv@718-739@usr.bin/ftp/main.c","usr.bin/ftp/main.c","makeargv",718,739
107,23,377,1,125,"slurpstring@754-879@usr.bin/ftp/main.c","usr.bin/ftp/main.c","slurpstring",754,879
28,10,185,2,33,"help@886-919@usr.bin/ftp/main.c","usr.bin/ftp/main.c","help",886,919
24,1,36,1,29,"usage@923-952@usr.bin/ftp/main.c","usr.bin/ftp/main.c","usage",923,952
182,73,1144,4,191,"ruserpass@76-267@usr.bin/ftp/ruserpass.c","usr.bin/ftp/ruserpass.c","ruserpass",76,267
44,24,304,1,44,"token@270-314@usr.bin/ftp/ruserpass.c","usr.bin/ftp/ruserpass.c","token",270,314
35,8,220,2,36,"settype@105-141@usr.bin/ftp/small.c","usr.bin/ftp/small.c","settype",105,141
27,11,147,2,29,"changetype@149-178@usr.bin/ftp/small.c","usr.bin/ftp/small.c","changetype",149,178
5,1,27,2,5,"setbinary@191-196@usr.bin/ftp/small.c","usr.bin/ftp/small.c","setbinary",191,196
4,2,31,2,4,"get@199-203@usr.bin/ftp/small.c","usr.bin/ftp/small.c","get",199,203
79,28,516,4,89,"getit@209-298@usr.bin/ftp/small.c","usr.bin/ftp/small.c","getit",209,298
15,4,77,1,18,"mabort@303-321@usr.bin/ftp/small.c","usr.bin/ftp/small.c","mabort",303,321
12,3,78,1,12,"sl_init@45-57@usr.bin/ftp/stringlist.c","usr.bin/ftp/stringlist.c","sl_init",45,57
11,3,80,2,10,"sl_add@64-74@usr.bin/ftp/stringlist.c","usr.bin/ftp/stringlist.c","sl_add",64,74
13,5,71,2,13,"sl_free@81-94@usr.bin/ftp/stringlist.c","usr.bin/ftp/stringlist.c","sl_free",81,94
88,26,495,2,108,"setpeer@102-210@usr.bin/ftp/util.c","usr.bin/ftp/util.c","setpeer",102,210
83,28,571,3,108,"ftp_login@216-324@usr.bin/ftp/util.c","usr.bin/ftp/util.c","ftp_login",216,324
22,5,168,3,22,"another@334-356@usr.bin/ftp/util.c","usr.bin/ftp/util.c","another",334,356
88,27,568,5,97,"remglob2@368-465@usr.bin/ftp/util.c","usr.bin/ftp/util.c","remglob2",368,465
5,1,39,3,5,"remglob@471-476@usr.bin/ftp/util.c","usr.bin/ftp/util.c","remglob",471,476
50,12,213,2,50,"confirm@480-530@usr.bin/ftp/util.c","usr.bin/ftp/util.c","confirm",480,530
20,5,127,1,24,"globulize@540-564@usr.bin/ftp/util.c","usr.bin/ftp/util.c","globulize",540,564
26,8,145,2,31,"remotesize@570-601@usr.bin/ftp/util.c","usr.bin/ftp/util.c","remotesize",570,601
53,12,320,2,67,"remotemodtime@607-674@usr.bin/ftp/util.c","usr.bin/ftp/util.c","remotemodtime",607,674
21,7,145,2,25,"fileindir@681-706@usr.bin/ftp/util.c","usr.bin/ftp/util.c","fileindir",681,706
9,3,51,1,10,"foregroundproc@713-723@usr.bin/ftp/util.c","usr.bin/ftp/util.c","foregroundproc",713,723
7,3,34,1,8,"updateprogressmeter@727-735@usr.bin/ftp/util.c","usr.bin/ftp/util.c","updateprogressmeter",727,735
143,31,1016,2,159,"progressmeter@752-911@usr.bin/ftp/util.c","usr.bin/ftp/util.c","progressmeter",752,911
32,14,288,1,38,"ptransfer@922-960@usr.bin/ftp/util.c","usr.bin/ftp/util.c","ptransfer",922,960
33,9,225,1,35,"list_vertical@967-1002@usr.bin/ftp/util.c","usr.bin/ftp/util.c","list_vertical",967,1002
10,3,55,1,10,"setttywidth@1010-1020@usr.bin/ftp/util.c","usr.bin/ftp/util.c","setttywidth",1010,1020
10,1,54,1,10,"alarmtimer@1026-1036@usr.bin/ftp/util.c","usr.bin/ftp/util.c","alarmtimer",1026,1036
27,7,163,1,31,"controlediting@1043-1074@usr.bin/ftp/util.c","usr.bin/ftp/util.c","controlediting",1043,1074
17,4,106,1,18,"connect_wait@1081-1099@usr.bin/ftp/util.c","usr.bin/ftp/util.c","connect_wait",1081,1099
5,1,20,1,4,"usage@124-128@usr.bin/gencat/gencat.c","usr.bin/gencat/gencat.c","usage",124,128
31,8,194,2,37,"main@131-168@usr.bin/gencat/gencat.c","usr.bin/gencat/gencat.c","main",131,168
10,3,60,2,9,"warning@171-180@usr.bin/gencat/gencat.c","usr.bin/gencat/gencat.c","warning",171,180
5,1,24,2,4,"error@183-187@usr.bin/gencat/gencat.c","usr.bin/gencat/gencat.c","error",183,187
4,1,13,1,3,"nomem@190-193@usr.bin/gencat/gencat.c","usr.bin/gencat/gencat.c","nomem",190,193
7,2,33,1,7,"xmalloc@196-203@usr.bin/gencat/gencat.c","usr.bin/gencat/gencat.c","xmalloc",196,203
6,2,35,2,5,"xrealloc@206-211@usr.bin/gencat/gencat.c","usr.bin/gencat/gencat.c","xrealloc",206,211
7,2,35,1,7,"xstrdup@214-221@usr.bin/gencat/gencat.c","usr.bin/gencat/gencat.c","xstrdup",214,221
39,10,209,1,40,"get_line@224-264@usr.bin/gencat/gencat.c","usr.bin/gencat/gencat.c","get_line",224,264
10,5,54,1,9,"wskip@267-276@usr.bin/gencat/gencat.c","usr.bin/gencat/gencat.c","wskip",267,276
10,5,54,1,9,"cskip@279-288@usr.bin/gencat/gencat.c","usr.bin/gencat/gencat.c","cskip",279,288
99,29,492,3,111,"getmsg@291-402@usr.bin/gencat/gencat.c","usr.bin/gencat/gencat.c","getmsg",291,402
59,14,321,1,74,"MCParse@405-479@usr.bin/gencat/gencat.c","usr.bin/gencat/gencat.c","MCParse",405,479
75,2,485,1,98,"MCWriteCat@491-589@usr.bin/gencat/gencat.c","usr.bin/gencat/gencat.c","MCWriteCat",491,589
27,9,172,1,37,"MCAddSet@592-629@usr.bin/gencat/gencat.c","usr.bin/gencat/gencat.c","MCAddSet",592,629
28,10,196,2,38,"MCAddMsg@632-670@usr.bin/gencat/gencat.c","usr.bin/gencat/gencat.c","MCAddMsg",632,670
18,6,106,1,21,"MCDelSet@673-694@usr.bin/gencat/gencat.c","usr.bin/gencat/gencat.c","MCDelSet",673,694
15,6,92,1,17,"MCDelMsg@697-714@usr.bin/gencat/gencat.c","usr.bin/gencat/gencat.c","MCDelMsg",697,714
79,24,443,2,82,"main@36-118@usr.bin/getcap/getcap.c","usr.bin/getcap/getcap.c","main",36,118
49,18,317,4,51,"lookup_cap@121-172@usr.bin/getcap/getcap.c","usr.bin/getcap/getcap.c","lookup_cap",121,172
9,1,27,1,9,"usage@175-184@usr.bin/getcap/getcap.c","usr.bin/getcap/getcap.c","usage",175,184
2,1,6,1,2,"conf_variableconf_table::sysconf_row@171-173@usr.bin/getconf/getconf.c","usr.bin/getconf/getconf.c","conf_variableconf_table::sysconf_row",171,173
2,1,6,1,2,"conf_variableuposix_conf_table::pathconf_row@295-297@usr.bin/getconf/getconf.c","usr.bin/getconf/getconf.c","conf_variableuposix_conf_table::pathconf_row",295,297
2,1,6,1,2,"conf_variableposix_conf_table::posix_confstr_row@339-341@usr.bin/getconf/getconf.c","usr.bin/getconf/getconf.c","conf_variableposix_conf_table::posix_confstr_row",339,341
2,1,6,1,2,"conf_variablecompat_posix2_conf_table::compat_posix2_constant_row@370-372@usr.bin/getconf/getconf.c","usr.bin/getconf/getconf.c","conf_variablecompat_posix2_conf_table::compat_posix2_constant_row",370,372
106,36,696,2,129,"main@402-531@usr.bin/getconf/getconf.c","usr.bin/getconf/getconf.c","main",402,531
8,1,28,1,8,"usage@535-543@usr.bin/getconf/getconf.c","usr.bin/getconf/getconf.c","usage",535,543
16,9,163,1,16,"list_var@546-562@usr.bin/getconf/getconf.c","usr.bin/getconf/getconf.c","list_var",546,562
17,8,144,1,20,"compilation_spec_valid@565-585@usr.bin/getconf/getconf.c","usr.bin/getconf/getconf.c","compilation_spec_valid",565,585
18,6,134,2,20,"main@94-114@usr.bin/getent/getent.c","usr.bin/getent/getent.c","main",94,114
5,1,20,1,5,"usage@117-122@usr.bin/getent/getent.c","usr.bin/getent/getent.c","usage",117,122
16,2,100,5,17,"printfmtstrings@131-148@usr.bin/getent/getent.c","usr.bin/getent/getent.c","printfmtstrings",131,148
30,6,157,2,30,"ethers@153-183@usr.bin/getent/getent.c","usr.bin/getent/getent.c","ethers",153,183
27,6,144,2,28,"group@190-218@usr.bin/getent/getent.c","usr.bin/getent/getent.c","group",190,218
7,2,69,1,7,"hostsprint@221-228@usr.bin/getent/getent.c","usr.bin/getent/getent.c","hostsprint",221,228
36,7,223,1,38,"hostsaddrinfo@230-268@usr.bin/getent/getent.c","usr.bin/getent/getent.c","hostsaddrinfo",230,268
24,7,170,2,24,"hosts@271-295@usr.bin/getent/getent.c","usr.bin/getent/getent.c","hosts",271,295
27,6,144,2,28,"passwd@303-331@usr.bin/getent/getent.c","usr.bin/getent/getent.c","passwd",303,331
27,6,144,2,28,"protocols@338-366@usr.bin/getent/getent.c","usr.bin/getent/getent.c","protocols",338,366
27,6,144,2,28,"rpc@373-401@usr.bin/getent/getent.c","usr.bin/getent/getent.c","rpc",373,401
31,7,179,2,32,"services@408-440@usr.bin/getent/getent.c","usr.bin/getent/getent.c","services",408,440
26,7,128,2,26,"shells@445-471@usr.bin/getent/getent.c","usr.bin/getent/getent.c","shells",445,471
27,6,151,2,28,"main@14-42@usr.bin/getopt/getopt.c","usr.bin/getopt/getopt.c","main",14,42
3,1,16,3,2,"findcall@12-14@usr.bin/gprof/aarch64.c","usr.bin/gprof/aarch64.c","findcall",12,14
3,1,16,3,3,"findcall@5-8@usr.bin/gprof/alpha.c","usr.bin/gprof/alpha.c","findcall",5,8
3,1,16,3,3,"findcall@5-8@usr.bin/gprof/amd64.c","usr.bin/gprof/amd64.c","findcall",5,8
25,6,143,3,38,"addarc@47-85@usr.bin/gprof/arcs.c","usr.bin/gprof/arcs.c","addarc",47,85
8,2,67,2,8,"topcmp@98-106@usr.bin/gprof/arcs.c","usr.bin/gprof/arcs.c","topcmp",98,106
95,23,617,0,138,"doarcs@109-247@usr.bin/gprof/arcs.c","usr.bin/gprof/arcs.c","doarcs",109,247
8,2,36,0,8,"dotime@250-258@usr.bin/gprof/arcs.c","usr.bin/gprof/arcs.c","dotime",250,258
67,15,371,1,84,"timepropagate@261-345@usr.bin/gprof/arcs.c","usr.bin/gprof/arcs.c","timepropagate",261,345
64,15,395,0,87,"cyclelink@348-435@usr.bin/gprof/arcs.c","usr.bin/gprof/arcs.c","cyclelink",348,435
66,16,390,0,75,"cycleanalyze@441-516@usr.bin/gprof/arcs.c","usr.bin/gprof/arcs.c","cycleanalyze",441,516
25,10,161,3,29,"descend@519-548@usr.bin/gprof/arcs.c","usr.bin/gprof/arcs.c","descend",519,548
66,18,389,2,70,"addcycle@551-621@usr.bin/gprof/arcs.c","usr.bin/gprof/arcs.c","addcycle",551,621
91,27,514,0,112,"compresslist@624-736@usr.bin/gprof/arcs.c","usr.bin/gprof/arcs.c","compresslist",624,736
11,2,87,1,11,"printsubcycle@740-751@usr.bin/gprof/arcs.c","usr.bin/gprof/arcs.c","printsubcycle",740,751
16,4,92,0,20,"cycletime@755-775@usr.bin/gprof/arcs.c","usr.bin/gprof/arcs.c","cycletime",755,775
52,19,320,0,85,"doflags@785-870@usr.bin/gprof/arcs.c","usr.bin/gprof/arcs.c","doflags",785,870
51,12,303,1,68,"inheritflags@880-948@usr.bin/gprof/arcs.c","usr.bin/gprof/arcs.c","inheritflags",880,948
3,1,16,3,2,"findcall@12-14@usr.bin/gprof/arm.c","usr.bin/gprof/arm.c","findcall",12,14
5,1,13,0,5,"dfn_init@49-54@usr.bin/gprof/dfn.c","usr.bin/gprof/dfn.c","dfn_init",49,54
23,7,107,1,40,"dfn@60-100@usr.bin/gprof/dfn.c","usr.bin/gprof/dfn.c","dfn",60,100
14,4,74,1,16,"dfn_pre_visit@106-122@usr.bin/gprof/dfn.c","usr.bin/gprof/dfn.c","dfn_pre_visit",106,122
4,2,23,1,4,"dfn_numbered@128-132@usr.bin/gprof/dfn.c","usr.bin/gprof/dfn.c","dfn_numbered",128,132
7,2,24,1,7,"dfn_busy@138-145@usr.bin/gprof/dfn.c","usr.bin/gprof/dfn.c","dfn_busy",138,145
69,23,368,1,99,"dfn_findcycle@151-250@usr.bin/gprof/dfn.c","usr.bin/gprof/dfn.c","dfn_findcycle",151,250
8,3,32,1,13,"dfn_self_cycle@256-269@usr.bin/gprof/dfn.c","usr.bin/gprof/dfn.c","dfn_self_cycle",256,269
25,9,118,1,35,"dfn_post_visit@277-312@usr.bin/gprof/dfn.c","usr.bin/gprof/dfn.c","dfn_post_visit",277,312
64,19,500,2,81,"getnfile@48-129@usr.bin/gprof/elf.c","usr.bin/gprof/elf.c","getnfile",48,129
17,9,101,2,25,"wantsym@132-157@usr.bin/gprof/elf.c","usr.bin/gprof/elf.c","wantsym",132,157
118,28,577,2,160,"main@41-201@usr.bin/gprof/gprof.c","usr.bin/gprof/gprof.c","main",41,201
15,4,84,1,24,"getpfile@209-233@usr.bin/gprof/gprof.c","usr.bin/gprof/gprof.c","getpfile",209,233
47,12,349,1,49,"openpfile@236-285@usr.bin/gprof/gprof.c","usr.bin/gprof/gprof.c","openpfile",236,285
20,8,117,1,22,"tally@288-310@usr.bin/gprof/gprof.c","usr.bin/gprof/gprof.c","tally",288,310
27,9,219,1,38,"dumpsum@316-354@usr.bin/gprof/gprof.c","usr.bin/gprof/gprof.c","dumpsum",316,354
12,3,61,2,12,"valcmp@357-369@usr.bin/gprof/gprof.c","usr.bin/gprof/gprof.c","valcmp",357,369
18,6,117,1,18,"readsamples@372-390@usr.bin/gprof/gprof.c","usr.bin/gprof/gprof.c","readsamples",372,390
47,13,291,1,62,"asgnsamples@425-487@usr.bin/gprof/gprof.c","usr.bin/gprof/gprof.c","asgnsamples",425,487
6,2,28,2,5,"min@491-496@usr.bin/gprof/gprof.c","usr.bin/gprof/gprof.c","min",491,496
6,2,28,2,5,"max@499-504@usr.bin/gprof/gprof.c","usr.bin/gprof/gprof.c","max",499,504
18,5,110,1,20,"alignentries@513-533@usr.bin/gprof/gprof.c","usr.bin/gprof/gprof.c","alignentries",513,533
12,2,74,1,13,"hertz@30-43@usr.bin/gprof/hertz.c","usr.bin/gprof/hertz.c","hertz",30,43
3,1,16,3,3,"findcall@5-8@usr.bin/gprof/hppa.c","usr.bin/gprof/hppa.c","findcall",5,8
45,18,249,3,53,"findcall@34-87@usr.bin/gprof/i386.c","usr.bin/gprof/i386.c","findcall",34,87
26,11,152,1,34,"nllookup@41-75@usr.bin/gprof/lookup.c","usr.bin/gprof/lookup.c","nllookup",41,75
23,9,116,2,27,"arclookup@78-105@usr.bin/gprof/lookup.c","usr.bin/gprof/lookup.c","arclookup",78,105
3,1,16,3,2,"findcall@10-12@usr.bin/gprof/m88k.c","usr.bin/gprof/m88k.c","findcall",10,12
28,11,192,3,36,"findcall@69-105@usr.bin/gprof/mips64.c","usr.bin/gprof/mips64.c","findcall",69,105
3,1,16,3,3,"findcall@5-8@usr.bin/gprof/powerpc.c","usr.bin/gprof/powerpc.c","findcall",5,8
22,4,140,0,25,"printprof@41-66@usr.bin/gprof/printgprof.c","usr.bin/gprof/printgprof.c","printprof",41,66
14,5,130,2,14,"timecmp@69-83@usr.bin/gprof/printgprof.c","usr.bin/gprof/printgprof.c","timecmp",69,83
18,3,104,0,21,"flatprofheader@89-110@usr.bin/gprof/printgprof.c","usr.bin/gprof/printgprof.c","flatprofheader",89,110
18,5,132,1,18,"flatprofline@113-131@usr.bin/gprof/printgprof.c","usr.bin/gprof/printgprof.c","flatprofline",113,131
23,3,134,0,26,"gprofheader@134-160@usr.bin/gprof/printgprof.c","usr.bin/gprof/printgprof.c","gprofheader",134,160
20,3,137,1,20,"gprofline@163-183@usr.bin/gprof/printgprof.c","usr.bin/gprof/printgprof.c","gprofline",163,183
31,10,152,1,37,"printgprof@186-223@usr.bin/gprof/printgprof.c","usr.bin/gprof/printgprof.c","printgprof",186,223
36,21,277,2,40,"totalcmp@234-274@usr.bin/gprof/printgprof.c","usr.bin/gprof/printgprof.c","totalcmp",234,274
35,8,204,1,41,"printparents@277-318@usr.bin/gprof/printgprof.c","usr.bin/gprof/printgprof.c","printparents",277,318
24,6,156,1,30,"printchildren@321-351@usr.bin/gprof/printgprof.c","usr.bin/gprof/printgprof.c","printchildren",321,351
22,8,119,1,24,"printname@354-378@usr.bin/gprof/printgprof.c","usr.bin/gprof/printgprof.c","printname",354,378
21,4,109,1,36,"sortchildren@381-417@usr.bin/gprof/printgprof.c","usr.bin/gprof/printgprof.c","sortchildren",381,417
18,4,105,1,33,"sortparents@420-453@usr.bin/gprof/printgprof.c","usr.bin/gprof/printgprof.c","sortparents",420,453
14,2,103,1,14,"printcycle@459-473@usr.bin/gprof/printgprof.c","usr.bin/gprof/printgprof.c","printcycle",459,473
16,3,100,1,16,"printmembers@479-495@usr.bin/gprof/printgprof.c","usr.bin/gprof/printgprof.c","printmembers",479,495
16,4,97,1,20,"sortmembers@501-521@usr.bin/gprof/printgprof.c","usr.bin/gprof/printgprof.c","sortmembers",501,521
20,5,103,2,20,"membercmp@528-548@usr.bin/gprof/printgprof.c","usr.bin/gprof/printgprof.c","membercmp",528,548
64,20,354,2,74,"arccmp@559-633@usr.bin/gprof/printgprof.c","usr.bin/gprof/printgprof.c","arccmp",559,633
13,3,65,1,14,"printblurb@636-650@usr.bin/gprof/printgprof.c","usr.bin/gprof/printgprof.c","printblurb",636,650
6,1,52,2,6,"namecmp@653-659@usr.bin/gprof/printgprof.c","usr.bin/gprof/printgprof.c","namecmp",653,659
41,11,315,0,45,"printindex@662-707@usr.bin/gprof/printgprof.c","usr.bin/gprof/printgprof.c","printindex",662,707
10,2,67,2,10,"addlist@57-67@usr.bin/gprof/printlist.c","usr.bin/gprof/printlist.c","addlist",57,67
13,5,85,2,13,"onlist@70-83@usr.bin/gprof/printlist.c","usr.bin/gprof/printlist.c","onlist",70,83
3,1,16,3,2,"findcall@11-13@usr.bin/gprof/sh.c","usr.bin/gprof/sh.c","findcall",11,13
3,1,16,3,3,"findcall@5-8@usr.bin/gprof/sparc64.c","usr.bin/gprof/sparc64.c","findcall",5,8
4,1,26,2,3,"isbinary@38-41@usr.bin/grep/binary.c","usr.bin/grep/binary.c","isbinary",38,41
14,4,82,1,17,"bin_file@44-61@usr.bin/grep/binary.c","usr.bin/grep/binary.c","bin_file",44,61
15,5,94,1,18,"gzbin_file@65-83@usr.bin/grep/binary.c","usr.bin/grep/binary.c","gzbin_file",65,83
4,2,28,1,4,"mmbin_file@88-92@usr.bin/grep/binary.c","usr.bin/grep/binary.c","mmbin_file",88,92
30,9,159,2,33,"gzfgetln@56-89@usr.bin/grep/file.c","usr.bin/grep/file.c","gzfgetln",56,89
23,5,147,2,28,"grep_fdopen@93-121@usr.bin/grep/file.c","usr.bin/grep/file.c","grep_fdopen",93,121
23,5,140,2,31,"grep_open@124-155@usr.bin/grep/file.c","usr.bin/grep/file.c","grep_open",124,155
15,5,67,1,20,"grep_bin_file@158-178@usr.bin/grep/file.c","usr.bin/grep/file.c","grep_bin_file",158,178
13,4,68,2,17,"grep_fgetln@181-198@usr.bin/grep/file.c","usr.bin/grep/file.c","grep_fgetln",181,198
17,4,66,1,21,"grep_close@201-222@usr.bin/grep/file.c","usr.bin/grep/file.c","grep_close",201,222
9,2,22,1,11,"usage@106-117@usr.bin/grep/grep.c","usr.bin/grep/grep.c","usage",106,117
35,17,251,2,35,"add_pattern@167-202@usr.bin/grep/grep.c","usr.bin/grep/grep.c","add_pattern",167,202
9,2,54,1,9,"add_patterns@205-214@usr.bin/grep/grep.c","usr.bin/grep/grep.c","add_patterns",205,214
13,5,95,1,13,"read_patterns@217-230@usr.bin/grep/grep.c","usr.bin/grep/grep.c","read_patterns",217,230
240,93,1220,2,265,"main@233-498@usr.bin/grep/grep.c","usr.bin/grep/grep.c","main",233,498
29,7,205,2,31,"mmopen@44-75@usr.bin/grep/mmfile.c","usr.bin/grep/mmfile.c","mmopen",44,75
6,1,31,1,5,"mmclose@78-83@usr.bin/grep/mmfile.c","usr.bin/grep/mmfile.c","mmclose",78,83
12,4,79,2,13,"mmfgetln@86-99@usr.bin/grep/mmfile.c","usr.bin/grep/mmfile.c","mmfgetln",86,99
4,1,12,1,3,"initqueue@50-53@usr.bin/grep/queue.c","usr.bin/grep/queue.c","initqueue",50,53
4,1,13,1,3,"free_item@56-59@usr.bin/grep/queue.c","usr.bin/grep/queue.c","free_item",56,59
20,3,144,1,22,"enqueue@62-84@usr.bin/grep/queue.c","usr.bin/grep/queue.c","enqueue",62,84
12,3,45,1,13,"dequeue@87-100@usr.bin/grep/queue.c","usr.bin/grep/queue.c","dequeue",87,100
8,2,41,1,8,"printqueue@103-111@usr.bin/grep/queue.c","usr.bin/grep/queue.c","printqueue",103,111
6,2,27,1,6,"clearqueue@114-120@usr.bin/grep/queue.c","usr.bin/grep/queue.c","clearqueue",114,120
30,8,148,1,32,"grep_tree@59-91@usr.bin/grep/util.c","usr.bin/grep/util.c","grep_tree",59,91
61,30,382,1,68,"procfile@94-162@usr.bin/grep/util.c","usr.bin/grep/util.c","procfile",94,162
73,34,421,2,79,"procline@172-251@usr.bin/grep/util.c","usr.bin/grep/util.c","procline",172,251
23,6,206,2,36,"fgrepcomp@255-291@usr.bin/grep/util.c","usr.bin/grep/util.c","fgrepcomp",255,291
93,41,651,2,156,"fastcomp@298-454@usr.bin/grep/util.c","usr.bin/grep/util.c","fastcomp",298,454
66,27,458,5,82,"grep_search@468-550@usr.bin/grep/util.c","usr.bin/grep/util.c","grep_search",468,550
7,2,34,1,7,"grep_malloc@554-561@usr.bin/grep/util.c","usr.bin/grep/util.c","grep_malloc",554,561
7,2,39,2,7,"grep_calloc@564-571@usr.bin/grep/util.c","usr.bin/grep/util.c","grep_calloc",564,571
6,2,36,2,5,"grep_realloc@574-579@usr.bin/grep/util.c","usr.bin/grep/util.c","grep_realloc",574,579
6,2,41,3,5,"grep_reallocarray@582-587@usr.bin/grep/util.c","usr.bin/grep/util.c","grep_reallocarray",582,587
11,7,92,3,12,"grep_cmp@594-606@usr.bin/grep/util.c","usr.bin/grep/util.c","grep_cmp",594,606
10,2,67,2,10,"grep_revstr@609-619@usr.bin/grep/util.c","usr.bin/grep/util.c","grep_revstr",609,619
29,8,156,3,29,"printline@623-652@usr.bin/grep/util.c","usr.bin/grep/util.c","printline",623,652
59,20,362,2,66,"main@49-115@usr.bin/head/head.c","usr.bin/head/head.c","main",49,115
5,1,18,1,4,"usage@119-123@usr.bin/head/head.c","usr.bin/head/head.c","usage",119,123
46,12,203,2,47,"conv_c@41-88@usr.bin/hexdump/conv.c","usr.bin/hexdump/conv.c","conv_c",41,88
28,8,258,2,29,"conv_u@91-120@usr.bin/hexdump/conv.c","usr.bin/hexdump/conv.c","conv_u",91,120
48,20,312,1,52,"display@58-110@usr.bin/hexdump/display.c","usr.bin/hexdump/display.c","display",58,110
87,23,520,2,87,"print@113-200@usr.bin/hexdump/display.c","usr.bin/hexdump/display.c","print",113,200
11,5,101,1,15,"bpad@203-218@usr.bin/hexdump/display.c","usr.bin/hexdump/display.c","bpad",203,218
60,24,367,1,65,"get@223-288@usr.bin/hexdump/display.c","usr.bin/hexdump/display.c","get",223,288
32,11,154,1,33,"next@291-324@usr.bin/hexdump/display.c","usr.bin/hexdump/display.c","next",291,324
26,8,144,2,27,"doskip@327-354@usr.bin/hexdump/display.c","usr.bin/hexdump/display.c","doskip",327,354
26,9,198,2,31,"main@50-81@usr.bin/hexdump/hexdump.c","usr.bin/hexdump/hexdump.c","main",50,81
73,22,320,2,75,"newsyntax@49-124@usr.bin/hexdump/hexsyntax.c","usr.bin/hexdump/hexsyntax.c","newsyntax",49,124
8,1,27,1,7,"usage@127-134@usr.bin/hexdump/hexsyntax.c","usr.bin/hexdump/hexsyntax.c","usage",127,134
110,38,473,2,115,"oldsyntax@80-195@usr.bin/hexdump/odsyntax.c","usr.bin/hexdump/odsyntax.c","oldsyntax",80,195
91,24,363,1,93,"posixtypes@201-294@usr.bin/hexdump/odsyntax.c","usr.bin/hexdump/odsyntax.c","posixtypes",201,294
8,1,27,1,7,"oldusage@297-304@usr.bin/hexdump/odsyntax.c","usr.bin/hexdump/odsyntax.c","oldusage",297,304
62,28,424,2,96,"odoffset@307-403@usr.bin/hexdump/odsyntax.c","usr.bin/hexdump/odsyntax.c","odoffset",307,403
8,2,33,1,8,"odadd@406-414@usr.bin/hexdump/odsyntax.c","usr.bin/hexdump/odsyntax.c","odadd",406,414
26,8,185,1,28,"addfile@55-83@usr.bin/hexdump/parse.c","usr.bin/hexdump/parse.c","addfile",55,83
52,22,433,1,69,"add@86-155@usr.bin/hexdump/parse.c","usr.bin/hexdump/parse.c","add",86,155
45,27,264,1,50,"size@160-210@usr.bin/hexdump/parse.c","usr.bin/hexdump/parse.c","size",160,210
199,82,1220,1,248,"rewrite@213-461@usr.bin/hexdump/parse.c","usr.bin/hexdump/parse.c","rewrite",213,461
43,12,163,1,45,"escape@464-509@usr.bin/hexdump/parse.c","usr.bin/hexdump/parse.c","escape",464,509
4,1,17,1,3,"badcnt@512-515@usr.bin/hexdump/parse.c","usr.bin/hexdump/parse.c","badcnt",512,515
4,1,13,1,3,"badsfmt@518-521@usr.bin/hexdump/parse.c","usr.bin/hexdump/parse.c","badsfmt",518,521
4,1,18,1,3,"badfmt@524-527@usr.bin/hexdump/parse.c","usr.bin/hexdump/parse.c","badfmt",524,527
4,1,17,1,3,"badconv@530-533@usr.bin/hexdump/parse.c","usr.bin/hexdump/parse.c","badconv",530,533
6,1,29,1,5,"usage@37-42@usr.bin/htpasswd/htpasswd.c","usr.bin/htpasswd/htpasswd.c","usage",37,42
141,45,1061,2,161,"main@48-209@usr.bin/htpasswd/htpasswd.c","usr.bin/htpasswd/htpasswd.c","main",48,209
13,6,82,1,12,"nag@212-224@usr.bin/htpasswd/htpasswd.c","usr.bin/htpasswd/htpasswd.c","nag",212,224
112,40,626,2,126,"main@55-181@usr.bin/id/id.c","usr.bin/id/id.c","main",55,181
37,13,289,1,39,"pretty@184-223@usr.bin/id/id.c","usr.bin/id/id.c","pretty",184,223
39,11,320,1,39,"current@226-265@usr.bin/id/id.c","usr.bin/id/id.c","current",226,265
26,6,204,1,27,"user@268-295@usr.bin/id/id.c","usr.bin/id/id.c","user",268,295
30,7,202,2,31,"group@298-329@usr.bin/id/id.c","usr.bin/id/id.c","group",298,329
12,3,79,1,17,"who@332-349@usr.bin/id/id.c","usr.bin/id/id.c","who",332,349
17,3,135,1,16,"usage@352-368@usr.bin/id/id.c","usr.bin/id/id.c","usage",352,368
23,6,150,1,23,"set_profile@161-184@usr.bin/indent/args.c","usr.bin/indent/args.c","set_profile",161,184
20,7,103,1,20,"scan_profile@187-207@usr.bin/indent/args.c","usr.bin/indent/args.c","scan_profile",187,207
9,3,43,2,8,"eqin@212-220@usr.bin/indent/args.c","usr.bin/indent/args.c","eqin",212,220
8,4,55,1,12,"set_defaults@226-238@usr.bin/indent/args.c","usr.bin/indent/args.c","set_defaults",226,238
62,21,336,1,72,"set_option@241-313@usr.bin/indent/args.c","usr.bin/indent/args.c","set_option",241,313
882,327,5162,2,1106,"main@56-1162@usr.bin/indent/indent.c","usr.bin/indent/indent.c","main",56,1162
33,12,246,1,39,"bakcopy@1170-1209@usr.bin/indent/indent.c","usr.bin/indent/indent.c","bakcopy",1170,1209
209,88,1379,1,231,"dump_line@47-278@usr.bin/indent/io.c","usr.bin/indent/io.c","dump_line",47,278
23,7,114,1,24,"compute_code_target@281-305@usr.bin/indent/io.c","usr.bin/indent/io.c","compute_code_target",281,305
7,3,45,1,6,"compute_label_target@308-314@usr.bin/indent/io.c","usr.bin/indent/io.c","compute_label_target",308,314
84,44,538,1,86,"fill_buffer@333-419@usr.bin/indent/io.c","usr.bin/indent/io.c","fill_buffer",333,419
21,6,113,2,21,"pad_output@450-471@usr.bin/indent/io.c","usr.bin/indent/io.c","pad_output",450,471
24,6,98,2,29,"count_spaces@494-523@usr.bin/indent/io.c","usr.bin/indent/io.c","count_spaces",494,523
18,5,114,3,18,"diag@528-546@usr.bin/indent/io.c","usr.bin/indent/io.c","diag",528,546
5,1,31,2,4,"writefdef@549-553@usr.bin/indent/io.c","usr.bin/indent/io.c","writefdef",549,553
28,6,195,3,27,"chfont@556-583@usr.bin/indent/io.c","usr.bin/indent/io.c","chfont",556,583
34,12,239,2,33,"parsefont@586-619@usr.bin/indent/io.c","usr.bin/indent/io.c","parsefont",586,619
353,143,1920,1,444,"lexi@118-562@usr.bin/indent/lexi.c","usr.bin/indent/lexi.c","lexi",118,562
31,8,228,2,37,"addkey@568-605@usr.bin/indent/lexi.c","usr.bin/indent/lexi.c","addkey",568,605
105,31,782,1,159,"parse@42-201@usr.bin/indent/parse.c","usr.bin/indent/parse.c","parse",42,201
53,17,270,1,79,"reduce@243-322@usr.bin/indent/parse.c","usr.bin/indent/parse.c","reduce",243,322
273,100,1570,1,343,"pr_comment@72-415@usr.bin/indent/pr_comment.c","usr.bin/indent/pr_comment.c","pr_comment",72,415
8,2,38,1,7,"ExitProgram@95-102@usr.bin/infocmp/infocmp.c","usr.bin/infocmp/infocmp.c","ExitProgram",95,102
8,2,56,3,10,"canonical_name@106-116@usr.bin/infocmp/infocmp.c","usr.bin/infocmp/infocmp.c","canonical_name",106,116
11,7,90,3,12,"capcmp@125-137@usr.bin/infocmp/infocmp.c","usr.bin/infocmp/infocmp.c","capcmp",125,137
49,17,317,2,80,"use_predicate@140-220@usr.bin/infocmp/infocmp.c","usr.bin/infocmp/infocmp.c","use_predicate",140,220
17,6,116,2,24,"useeq@223-247@usr.bin/infocmp/infocmp.c","usr.bin/infocmp/infocmp.c","useeq",223,247
14,7,139,2,18,"entryeq@250-268@usr.bin/infocmp/infocmp.c","usr.bin/infocmp/infocmp.c","entryeq",250,268
12,4,78,2,13,"print_uses@273-286@usr.bin/infocmp/infocmp.c","usr.bin/infocmp/infocmp.c","print_uses",273,286
15,5,52,1,15,"dump_boolean@289-304@usr.bin/infocmp/infocmp.c","usr.bin/infocmp/infocmp.c","dump_boolean",289,304
14,3,63,3,14,"dump_numeric@307-321@usr.bin/infocmp/infocmp.c","usr.bin/infocmp/infocmp.c","dump_numeric",307,321
10,3,67,3,10,"dump_string@324-334@usr.bin/infocmp/infocmp.c","usr.bin/infocmp/infocmp.c","dump_string",324,334
98,45,638,3,111,"compare_predicate@337-448@usr.bin/infocmp/infocmp.c","usr.bin/infocmp/infocmp.c","compare_predicate",337,448
9,4,54,1,8,"skip_csi@550-558@usr.bin/infocmp/infocmp.c","usr.bin/infocmp/infocmp.c","skip_csi",550,558
8,2,54,3,7,"same_param@561-568@usr.bin/infocmp/infocmp.c","usr.bin/infocmp/infocmp.c","same_param",561,568
27,8,206,4,33,"lookup_params@571-604@usr.bin/infocmp/infocmp.c","usr.bin/infocmp/infocmp.c","lookup_params",571,604
136,45,1088,3,177,"analyze_string@607-784@usr.bin/infocmp/infocmp.c","usr.bin/infocmp/infocmp.c","analyze_string",607,784
142,40,1143,2,181,"file_comparison@793-974@usr.bin/infocmp/infocmp.c","usr.bin/infocmp/infocmp.c","file_comparison",793,974
51,7,189,1,57,"usage@977-1034@usr.bin/infocmp/infocmp.c","usr.bin/infocmp/infocmp.c","usage",977,1034
18,5,149,2,19,"any_initializer@1037-1056@usr.bin/infocmp/infocmp.c","usr.bin/infocmp/infocmp.c","any_initializer",1037,1056
4,1,17,1,3,"name_initializer@1059-1062@usr.bin/infocmp/infocmp.c","usr.bin/infocmp/infocmp.c","name_initializer",1059,1062
4,1,17,1,3,"string_variable@1065-1068@usr.bin/infocmp/infocmp.c","usr.bin/infocmp/infocmp.c","string_variable",1065,1068
104,23,706,1,119,"dump_initializers@1072-1191@usr.bin/infocmp/infocmp.c","usr.bin/infocmp/infocmp.c","dump_initializers",1072,1191
28,5,237,1,36,"dump_termtype@1195-1231@usr.bin/infocmp/infocmp.c","usr.bin/infocmp/infocmp.c","dump_termtype",1195,1231
10,4,62,1,10,"optarg_to_number@1234-1244@usr.bin/infocmp/infocmp.c","usr.bin/infocmp/infocmp.c","optarg_to_number",1234,1244
11,2,45,1,11,"terminal_env@1247-1258@usr.bin/infocmp/infocmp.c","usr.bin/infocmp/infocmp.c","terminal_env",1247,1258
300,87,1616,2,397,"main@1267-1664@usr.bin/infocmp/infocmp.c","usr.bin/infocmp/infocmp.c","main",1267,1664
8,1,26,1,7,"usage@61-68@usr.bin/ipcrm/ipcrm.c","usr.bin/ipcrm/ipcrm.c","usage",61,68
9,3,50,2,8,"msgrm@71-79@usr.bin/ipcrm/ipcrm.c","usr.bin/ipcrm/ipcrm.c","msgrm",71,79
9,3,52,2,8,"shmrm@82-90@usr.bin/ipcrm/ipcrm.c","usr.bin/ipcrm/ipcrm.c","shmrm",82,90
10,3,58,2,10,"semrm@93-103@usr.bin/ipcrm/ipcrm.c","usr.bin/ipcrm/ipcrm.c","semrm",93,103
4,1,10,1,3,"not_configured@107-110@usr.bin/ipcrm/ipcrm.c","usr.bin/ipcrm/ipcrm.c","not_configured",107,110
70,20,371,2,71,"main@113-184@usr.bin/ipcrm/ipcrm.c","usr.bin/ipcrm/ipcrm.c","main",113,184
17,10,197,1,17,"fmt_perm@103-120@usr.bin/ipcs/ipcs.c","usr.bin/ipcs/ipcs.c","fmt_perm",103,120
11,2,72,3,11,"cvt_time@123-134@usr.bin/ipcs/ipcs.c","usr.bin/ipcs/ipcs.c","cvt_time",123,134
66,23,267,2,69,"main@153-222@usr.bin/ipcs/ipcs.c","usr.bin/ipcs/ipcs.c","main",153,222
16,1,68,1,16,"show_msgtotal@225-241@usr.bin/ipcs/ipcs.c","usr.bin/ipcs/ipcs.c","show_msgtotal",225,241
14,1,59,1,14,"show_shmtotal@244-258@usr.bin/ipcs/ipcs.c","usr.bin/ipcs/ipcs.c","show_shmtotal",244,258
22,1,95,1,22,"show_semtotal@261-283@usr.bin/ipcs/ipcs.c","usr.bin/ipcs/ipcs.c","show_semtotal",261,283
16,6,76,1,16,"show_msginfo_hdr@286-302@usr.bin/ipcs/ipcs.c","usr.bin/ipcs/ipcs.c","show_msginfo_hdr",286,302
26,7,233,15,33,"show_msginfo@305-338@usr.bin/ipcs/ipcs.c","usr.bin/ipcs/ipcs.c","show_msginfo",305,338
16,6,76,1,16,"show_shminfo_hdr@341-357@usr.bin/ipcs/ipcs.c","usr.bin/ipcs/ipcs.c","show_shminfo_hdr",341,357
28,7,222,14,35,"show_shminfo@360-395@usr.bin/ipcs/ipcs.c","usr.bin/ipcs/ipcs.c","show_shminfo",360,395
12,4,54,1,12,"show_seminfo_hdr@398-410@usr.bin/ipcs/ipcs.c","usr.bin/ipcs/ipcs.c","show_seminfo_hdr",398,410
19,5,163,10,24,"show_seminfo@413-437@usr.bin/ipcs/ipcs.c","usr.bin/ipcs/ipcs.c","show_seminfo",413,437
62,11,375,1,68,"msg_sysctl@440-508@usr.bin/ipcs/ipcs.c","usr.bin/ipcs/ipcs.c","msg_sysctl",440,508
62,11,370,1,68,"shm_sysctl@511-579@usr.bin/ipcs/ipcs.c","usr.bin/ipcs/ipcs.c","shm_sysctl",511,579
58,11,356,1,65,"sem_sysctl@582-647@usr.bin/ipcs/ipcs.c","usr.bin/ipcs/ipcs.c","sem_sysctl",582,647
186,41,1256,1,215,"ipcs_kvm@650-865@usr.bin/ipcs/ipcs.c","usr.bin/ipcs/ipcs.c","ipcs_kvm",650,865
8,1,25,1,8,"usage@868-876@usr.bin/ipcs/ipcs.c","usr.bin/ipcs/ipcs.c","usage",868,876
150,52,903,2,173,"main@101-274@usr.bin/join/join.c","usr.bin/join/join.c","main",101,274
18,4,87,1,18,"slurp@277-295@usr.bin/join/join.c","usr.bin/join/join.c","slurp",277,295
72,17,551,1,98,"slurpit@298-396@usr.bin/join/join.c","usr.bin/join/join.c","slurpit",298,396
8,3,66,4,7,"cmp@399-406@usr.bin/join/join.c","usr.bin/join/join.c","cmp",399,406
12,5,108,2,17,"joinlines@409-426@usr.bin/join/join.c","usr.bin/join/join.c","joinlines",409,426
23,8,163,2,32,"outoneline@429-461@usr.bin/join/join.c","usr.bin/join/join.c","outoneline",429,461
28,11,230,4,33,"outtwoline@464-497@usr.bin/join/join.c","usr.bin/join/join.c","outtwoline",464,497
17,8,106,3,16,"outfield@500-516@usr.bin/join/join.c","usr.bin/join/join.c","outfield",500,516
34,11,224,1,34,"fieldarg@523-557@usr.bin/join/join.c","usr.bin/join/join.c","fieldarg",523,557
57,25,386,1,77,"obsolete@560-637@usr.bin/join/join.c","usr.bin/join/join.c","obsolete",560,637
11,1,49,1,11,"usage@640-651@usr.bin/join/join.c","usr.bin/join/join.c","usage",640,651
188,70,1117,2,223,"main@80-303@usr.bin/jot/jot.c","usr.bin/jot/jot.c","main",80,303
30,18,201,2,30,"putdata@306-336@usr.bin/jot/jot.c","usr.bin/jot/jot.c","putdata",306,336
7,1,23,1,6,"usage@339-345@usr.bin/jot/jot.c","usr.bin/jot/jot.c","usage",339,345
6,2,36,1,5,"getprec@348-353@usr.bin/jot/jot.c","usr.bin/jot/jot.c","getprec",348,353
95,63,643,1,103,"getformat@356-459@usr.bin/jot/jot.c","usr.bin/jot/jot.c","getformat",356,459
135,52,729,2,141,"main@143-284@usr.bin/kdump/kdump.c","usr.bin/kdump/kdump.c","main",143,284
9,3,58,3,9,"fread_tail@287-296@usr.bin/kdump/kdump.c","usr.bin/kdump/kdump.c","fread_tail",287,296
64,17,320,1,66,"dumpheader@299-365@usr.bin/kdump/kdump.c","usr.bin/kdump/kdump.c","dumpheader",299,365
4,1,12,1,4,"pad@373-377@usr.bin/kdump/kdump.c","usr.bin/kdump/kdump.c","pad",373,377
5,1,19,1,6,"pass_two@382-388@usr.bin/kdump/kdump.c","usr.bin/kdump/kdump.c","pass_two",382,388
5,1,22,1,4,"pdeclong@391-395@usr.bin/kdump/kdump.c","usr.bin/kdump/kdump.c","pdeclong",391,395
5,1,22,1,4,"pdeculong@398-402@usr.bin/kdump/kdump.c","usr.bin/kdump/kdump.c","pdeculong",398,402
5,1,22,1,4,"phexlong@405-409@usr.bin/kdump/kdump.c","usr.bin/kdump/kdump.c","phexlong",405,409
8,2,37,1,7,"pnonfancy@412-419@usr.bin/kdump/kdump.c","usr.bin/kdump/kdump.c","pnonfancy",412,419
4,1,17,1,3,"pdecint@422-425@usr.bin/kdump/kdump.c","usr.bin/kdump/kdump.c","pdecint",422,425
4,1,17,1,3,"pdecuint@428-431@usr.bin/kdump/kdump.c","usr.bin/kdump/kdump.c","pdecuint",428,431
4,1,17,1,3,"phexint@434-437@usr.bin/kdump/kdump.c","usr.bin/kdump/kdump.c","phexint",434,437
4,1,17,1,3,"poctint@440-443@usr.bin/kdump/kdump.c","usr.bin/kdump/kdump.c","poctint",440,443
11,4,90,1,15,"phexll@458-473@usr.bin/kdump/kdump.c","usr.bin/kdump/kdump.c","phexll",458,473
74,23,511,2,81,"ktrsyscall@855-936@usr.bin/kdump/kdump.c","usr.bin/kdump/kdump.c","ktrsyscall",855,936
78,26,290,2,81,"kresolvsysctl@976-1057@usr.bin/kdump/kdump.c","usr.bin/kdump/kdump.c","kresolvsysctl",976,1057
73,28,434,2,77,"ktrsysret@1060-1137@usr.bin/kdump/kdump.c","usr.bin/kdump/kdump.c","ktrsysret",1060,1137
4,1,32,2,3,"ktrnamei@1140-1143@usr.bin/kdump/kdump.c","usr.bin/kdump/kdump.c","ktrnamei",1140,1143
38,8,221,4,43,"showbufc@1146-1189@usr.bin/kdump/kdump.c","usr.bin/kdump/kdump.c","showbufc",1146,1189
50,13,290,2,51,"showbuf@1192-1243@usr.bin/kdump/kdump.c","usr.bin/kdump/kdump.c","showbuf",1192,1243
17,7,117,2,19,"ktrgenio@1246-1265@usr.bin/kdump/kdump.c","usr.bin/kdump/kdump.c","ktrgenio",1246,1265
53,15,230,1,53,"ktrpsig@1268-1321@usr.bin/kdump/kdump.c","usr.bin/kdump/kdump.c","ktrpsig",1268,1321
9,2,73,2,8,"ktruser@1324-1332@usr.bin/kdump/kdump.c","usr.bin/kdump/kdump.c","ktruser",1324,1332
19,3,107,2,19,"ktrexec@1335-1354@usr.bin/kdump/kdump.c","usr.bin/kdump/kdump.c","ktrexec",1335,1354
23,8,180,2,24,"ktrpledge@1357-1381@usr.bin/kdump/kdump.c","usr.bin/kdump/kdump.c","ktrpledge",1357,1381
9,1,44,1,9,"usage@1384-1393@usr.bin/kdump/kdump.c","usr.bin/kdump/kdump.c","usage",1384,1393
20,6,141,1,22,"ioctldecode@1401-1423@usr.bin/kdump/kdump.c","usr.bin/kdump/kdump.c","ioctldecode",1401,1423
33,17,151,1,44,"ptracedecode@1426-1470@usr.bin/kdump/kdump.c","usr.bin/kdump/kdump.c","ptracedecode",1426,1470
7,2,27,1,6,"atfd@1474-1480@usr.bin/kdump/kdump.c","usr.bin/kdump/kdump.c","atfd",1474,1480
7,2,27,1,6,"polltimeout@1483-1489@usr.bin/kdump/kdump.c","usr.bin/kdump/kdump.c","polltimeout",1483,1489
9,3,42,1,8,"wait4pid@1492-1500@usr.bin/kdump/kdump.c","usr.bin/kdump/kdump.c","wait4pid",1492,1500
7,3,41,1,6,"signame@1503-1509@usr.bin/kdump/kdump.c","usr.bin/kdump/kdump.c","signame",1503,1509
24,8,143,1,26,"sigset@1512-1538@usr.bin/kdump/kdump.c","usr.bin/kdump/kdump.c","sigset",1512,1538
37,11,155,1,36,"semctlname@1541-1577@usr.bin/kdump/kdump.c","usr.bin/kdump/kdump.c","semctlname",1541,1577
16,4,64,1,15,"shmctlname@1580-1595@usr.bin/kdump/kdump.c","usr.bin/kdump/kdump.c","shmctlname",1580,1595
15,2,147,1,15,"semgetname@1599-1614@usr.bin/kdump/kdump.c","usr.bin/kdump/kdump.c","semgetname",1599,1614
9,3,53,1,8,"flagsandmodename@1622-1630@usr.bin/kdump/kdump.c","usr.bin/kdump/kdump.c","flagsandmodename",1622,1630
6,2,34,1,5,"clockname@1633-1638@usr.bin/kdump/kdump.c","usr.bin/kdump/kdump.c","clockname",1633,1638
12,3,65,1,12,"sockoptlevelname@1645-1657@usr.bin/kdump/kdump.c","usr.bin/kdump/kdump.c","sockoptlevelname",1645,1657
24,7,123,1,24,"ktraceopname@1660-1684@usr.bin/kdump/kdump.c","usr.bin/kdump/kdump.c","ktraceopname",1660,1684
50,6,301,1,71,"ktrsockaddr@66-137@usr.bin/kdump/ktrstruct.c","usr.bin/kdump/ktrstruct.c","ktrsockaddr",66,137
17,6,121,3,20,"print_time@140-160@usr.bin/kdump/ktrstruct.c","usr.bin/kdump/ktrstruct.c","print_time",140,160
13,5,85,2,12,"print_timespec@163-175@usr.bin/kdump/ktrstruct.c","usr.bin/kdump/ktrstruct.c","print_timespec",163,175
13,4,69,1,13,"uidname@178-191@usr.bin/kdump/ktrstruct.c","usr.bin/kdump/ktrstruct.c","uidname",178,191
13,4,69,1,13,"gidname@194-207@usr.bin/kdump/ktrstruct.c","usr.bin/kdump/ktrstruct.c","gidname",194,207
23,1,157,1,27,"ktrstat@210-237@usr.bin/kdump/ktrstruct.c","usr.bin/kdump/ktrstruct.c","ktrstat",210,237
6,1,30,2,5,"ktrtimespec@240-245@usr.bin/kdump/ktrstruct.c","usr.bin/kdump/ktrstruct.c","ktrtimespec",240,245
7,3,55,2,6,"print_timeval@248-254@usr.bin/kdump/ktrstruct.c","usr.bin/kdump/ktrstruct.c","print_timeval",248,254
6,1,30,2,5,"ktrtimeval@257-262@usr.bin/kdump/ktrstruct.c","usr.bin/kdump/ktrstruct.c","ktrtimeval",257,262
17,4,123,1,26,"ktrsigaction@265-291@usr.bin/kdump/ktrstruct.c","usr.bin/kdump/ktrstruct.c","ktrsigaction",265,291
7,2,31,1,6,"print_rlim@294-300@usr.bin/kdump/ktrstruct.c","usr.bin/kdump/ktrstruct.c","print_rlim",294,300
9,1,44,1,8,"ktrrlimit@303-311@usr.bin/kdump/ktrstruct.c","usr.bin/kdump/ktrstruct.c","ktrrlimit",303,311
5,1,31,1,4,"ktrtfork@314-318@usr.bin/kdump/ktrstruct.c","usr.bin/kdump/ktrstruct.c","ktrtfork",314,318
11,2,97,2,11,"ktrfds@321-332@usr.bin/kdump/ktrstruct.c","usr.bin/kdump/ktrstruct.c","ktrfds",321,332
23,8,153,2,24,"ktrfdset@335-359@usr.bin/kdump/ktrstruct.c","usr.bin/kdump/ktrstruct.c","ktrfdset",335,359
15,1,104,1,14,"ktrrusage@362-376@usr.bin/kdump/ktrstruct.c","usr.bin/kdump/ktrstruct.c","ktrrusage",362,376
12,1,72,1,11,"ktrquota@379-390@usr.bin/kdump/ktrstruct.c","usr.bin/kdump/ktrstruct.c","ktrquota",379,390
9,1,52,1,8,"ktrmsghdr@393-401@usr.bin/kdump/ktrstruct.c","usr.bin/kdump/ktrstruct.c","ktrmsghdr",393,401
14,3,90,2,14,"ktriovec@404-418@usr.bin/kdump/ktrstruct.c","usr.bin/kdump/ktrstruct.c","ktriovec",404,418
24,5,165,2,24,"ktrevent@421-445@usr.bin/kdump/ktrstruct.c","usr.bin/kdump/ktrstruct.c","ktrevent",421,445
18,3,110,2,18,"ktrpollfd@448-466@usr.bin/kdump/ktrstruct.c","usr.bin/kdump/ktrstruct.c","ktrpollfd",448,466
44,10,275,2,49,"ktrcmsghdr@469-518@usr.bin/kdump/ktrstruct.c","usr.bin/kdump/ktrstruct.c","ktrcmsghdr",469,518
129,47,1040,2,142,"ktrstruct@521-663@usr.bin/kdump/ktrstruct.c","usr.bin/kdump/ktrstruct.c","ktrstruct",521,663
140,49,815,2,149,"main@60-209@usr.bin/ktrace/ktrace.c","usr.bin/ktrace/ktrace.c","main",60,209
20,4,88,1,20,"rpid@212-232@usr.bin/ktrace/ktrace.c","usr.bin/ktrace/ktrace.c","rpid",212,232
13,2,39,1,12,"usage@235-247@usr.bin/ktrace/ktrace.c","usr.bin/ktrace/ktrace.c","usage",235,247
6,1,19,1,5,"no_ktrace@251-256@usr.bin/ktrace/ktrace.c","usr.bin/ktrace/ktrace.c","no_ktrace",251,256
42,12,139,2,42,"getpoints@51-93@usr.bin/ktrace/subr.c","usr.bin/ktrace/subr.c","getpoints",51,93
21,8,142,2,29,"main@70-99@usr.bin/lam/lam.c","usr.bin/lam/lam.c","main",70,99
65,29,465,2,69,"getargs@102-171@usr.bin/lam/lam.c","usr.bin/lam/lam.c","getargs",102,171
13,5,123,1,13,"pad@174-187@usr.bin/lam/lam.c","usr.bin/lam/lam.c","pad",174,187
28,10,236,1,29,"gatherline@194-223@usr.bin/lam/lam.c","usr.bin/lam/lam.c","gatherline",194,223
8,1,25,1,8,"usage@226-234@usr.bin/lam/lam.c","usr.bin/lam/lam.c","usage",226,234
66,30,372,2,77,"main@96-173@usr.bin/last/last.c","usr.bin/last/last.c","main",96,173
27,8,108,1,29,"checkargs@180-209@usr.bin/last/last.c","usr.bin/last/last.c","checkargs",180,209
22,4,127,1,25,"print_entry@212-237@usr.bin/last/last.c","usr.bin/last/last.c","print_entry",212,237
130,42,872,1,165,"wtmp@244-409@usr.bin/last/last.c","usr.bin/last/last.c","wtmp",244,409
34,15,224,2,44,"want@415-459@usr.bin/last/last.c","usr.bin/last/last.c","want",415,459
10,2,64,2,10,"addarg@465-475@usr.bin/last/last.c","usr.bin/last/last.c","addarg",465,475
10,2,69,1,10,"addtty@481-491@usr.bin/last/last.c","usr.bin/last/last.c","addtty",481,491
16,6,101,1,16,"hostconv@499-515@usr.bin/last/last.c","usr.bin/last/last.c","hostconv",499,515
17,5,115,1,22,"ttyconv@521-543@usr.bin/last/last.c","usr.bin/last/last.c","ttyconv",521,543
57,12,320,1,63,"dateconv@551-614@usr.bin/last/last.c","usr.bin/last/last.c","dateconv",551,614
10,2,75,1,10,"onintr@621-631@usr.bin/last/last.c","usr.bin/last/last.c","onintr",621,631
8,1,26,1,8,"usage@634-642@usr.bin/last/last.c","usr.bin/last/last.c","usage",634,642
68,19,540,2,87,"main@59-146@usr.bin/lastcomm/lastcomm.c","usr.bin/lastcomm/lastcomm.c","main",59,146
11,2,40,1,11,"expand@149-160@usr.bin/lastcomm/lastcomm.c","usr.bin/lastcomm/lastcomm.c","expand",149,160
15,1,85,1,17,"flagbits@163-180@usr.bin/lastcomm/lastcomm.c","usr.bin/lastcomm/lastcomm.c","flagbits",163,180
12,5,97,2,11,"requested@183-194@usr.bin/lastcomm/lastcomm.c","usr.bin/lastcomm/lastcomm.c","requested",183,194
13,4,72,1,13,"getdev@197-210@usr.bin/lastcomm/lastcomm.c","usr.bin/lastcomm/lastcomm.c","getdev",197,210
6,1,21,1,5,"usage@213-218@usr.bin/lastcomm/lastcomm.c","usr.bin/lastcomm/lastcomm.c","usage",213,218
56,19,371,2,63,"main@56-119@usr.bin/leave/leave.c","usr.bin/leave/leave.c","main",56,119
37,9,186,1,46,"doalarm@122-168@usr.bin/leave/leave.c","usr.bin/leave/leave.c","doalarm",122,168
5,1,18,1,4,"usage@171-175@usr.bin/leave/leave.c","usr.bin/leave/leave.c","usage",171,175
37,17,227,4,62,"match_brac@28-90@usr.bin/less/brac.c","usr.bin/less/brac.c","match_brac",28,90
108,36,645,1,195,"ch_get@140-335@usr.bin/less/ch.c","usr.bin/less/ch.c","ch_get",140,335
6,3,30,1,5,"ch_ungetchar@342-347@usr.bin/less/ch.c","usr.bin/less/ch.c","ch_ungetchar",342,347
16,6,73,1,16,"end_logfile@354-370@usr.bin/less/ch.c","usr.bin/less/ch.c","end_logfile",354,370
25,5,129,1,25,"sync_logfile@378-403@usr.bin/less/ch.c","usr.bin/less/ch.c","sync_logfile",378,403
13,2,60,1,13,"buffered@409-422@usr.bin/less/ch.c","usr.bin/less/ch.c","buffered",409,422
26,12,144,1,31,"ch_seek@429-460@usr.bin/less/ch.c","usr.bin/less/ch.c","ch_seek",429,460
15,6,78,1,21,"ch_end_seek@466-487@usr.bin/less/ch.c","usr.bin/less/ch.c","ch_end_seek",466,487
17,4,91,1,25,"ch_beg_seek@495-520@usr.bin/less/ch.c","usr.bin/less/ch.c","ch_beg_seek",495,520
10,4,44,1,9,"ch_length@526-535@usr.bin/less/ch.c","usr.bin/less/ch.c","ch_length",526,535
6,2,29,1,5,"ch_tell@541-546@usr.bin/less/ch.c","usr.bin/less/ch.c","ch_tell",541,546
16,4,65,1,16,"ch_forw_get@552-568@usr.bin/less/ch.c","usr.bin/less/ch.c","ch_forw_get",552,568
16,6,80,1,15,"ch_back_get@574-589@usr.bin/less/ch.c","usr.bin/less/ch.c","ch_back_get",574,589
10,3,49,1,9,"ch_setbufspace@596-605@usr.bin/less/ch.c","usr.bin/less/ch.c","ch_setbufspace",596,605
24,6,118,1,56,"ch_flush@611-667@usr.bin/less/ch.c","usr.bin/less/ch.c","ch_flush",611,667
14,2,74,1,19,"ch_addbuf@674-693@usr.bin/less/ch.c","usr.bin/less/ch.c","ch_addbuf",674,693
8,2,52,1,8,"init_hashtbl@699-707@usr.bin/less/ch.c","usr.bin/less/ch.c","init_hashtbl",699,707
11,2,44,1,11,"ch_delbufs@713-724@usr.bin/less/ch.c","usr.bin/less/ch.c","ch_delbufs",713,724
4,1,28,1,3,"seekable@730-733@usr.bin/less/ch.c","usr.bin/less/ch.c","seekable",730,733
4,1,10,1,3,"ch_set_eof@740-743@usr.bin/less/ch.c","usr.bin/less/ch.c","ch_set_eof",740,743
23,5,152,2,31,"ch_init@750-781@usr.bin/less/ch.c","usr.bin/less/ch.c","ch_init",750,781
23,6,104,1,36,"ch_close@787-823@usr.bin/less/ch.c","usr.bin/less/ch.c","ch_close",787,823
6,2,22,1,5,"ch_getflags@829-834@usr.bin/less/ch.c","usr.bin/less/ch.c","ch_getflags",829,834
51,20,258,1,60,"checkfmt@31-91@usr.bin/less/charset.c","usr.bin/less/charset.c","checkfmt",31,91
26,11,158,3,31,"setbinfmt@97-128@usr.bin/less/charset.c","usr.bin/less/charset.c","setbinfmt",97,128
10,3,61,1,12,"init_charset@134-146@usr.bin/less/charset.c","usr.bin/less/charset.c","init_charset",134,146
7,3,46,1,6,"binary_char@152-158@usr.bin/less/charset.c","usr.bin/less/charset.c","binary_char",152,158
7,3,49,1,6,"control_char@164-170@usr.bin/less/charset.c","usr.bin/less/charset.c","control_char",164,170
14,7,139,1,15,"prchar@177-192@usr.bin/less/charset.c","usr.bin/less/charset.c","prchar",177,192
40,14,291,1,40,"prutfchar@198-238@usr.bin/less/charset.c","usr.bin/less/charset.c","prutfchar",198,238
16,7,102,1,16,"utf_len@244-260@usr.bin/less/charset.c","usr.bin/less/charset.c","utf_len",244,260
23,9,169,1,25,"is_utf8_well_formed@266-291@usr.bin/less/charset.c","usr.bin/less/charset.c","is_utf8_well_formed",266,291
39,7,339,1,44,"get_wchar@297-341@usr.bin/less/charset.c","usr.bin/less/charset.c","get_wchar",297,341
31,7,548,2,36,"put_wchar@347-383@usr.bin/less/charset.c","usr.bin/less/charset.c","put_wchar",347,383
30,10,179,3,31,"step_char@389-420@usr.bin/less/charset.c","usr.bin/less/charset.c","step_char",389,420
19,5,113,3,20,"is_in_table@810-830@usr.bin/less/charset.c","usr.bin/less/charset.c","is_in_table",810,830
5,1,30,1,4,"is_composing_char@837-841@usr.bin/less/charset.c","usr.bin/less/charset.c","is_composing_char",837,841
5,1,30,1,4,"is_ubin_char@847-851@usr.bin/less/charset.c","usr.bin/less/charset.c","is_ubin_char",847,851
5,1,30,1,4,"is_wide_char@857-861@usr.bin/less/charset.c","usr.bin/less/charset.c","is_wide_char",857,861
10,4,67,2,10,"is_combining_char@869-879@usr.bin/less/charset.c","usr.bin/less/charset.c","is_combining_char",869,879
10,1,36,1,9,"cmd_reset@97-106@usr.bin/less/cmdbuf.c","usr.bin/less/cmdbuf.c","cmd_reset",97,106
6,1,21,1,5,"clear_cmd@112-117@usr.bin/less/cmdbuf.c","usr.bin/less/cmdbuf.c","clear_cmd",112,117
22,7,124,1,21,"cmd_putstr@123-144@usr.bin/less/cmdbuf.c","usr.bin/less/cmdbuf.c","cmd_putstr",123,144
11,2,56,1,11,"len_cmdbuf@150-161@usr.bin/less/cmdbuf.c","usr.bin/less/cmdbuf.c","len_cmdbuf",150,161
45,20,266,5,46,"cmd_step_common@167-213@usr.bin/less/cmdbuf.c","usr.bin/less/cmdbuf.c","cmd_step_common",167,213
6,1,60,3,6,"cmd_step_right@219-225@usr.bin/less/cmdbuf.c","usr.bin/less/cmdbuf.c","cmd_step_right",219,225
6,1,56,3,6,"cmd_step_left@231-237@usr.bin/less/cmdbuf.c","usr.bin/less/cmdbuf.c","cmd_step_left",231,237
25,6,128,1,31,"cmd_repaint@244-275@usr.bin/less/cmdbuf.c","usr.bin/less/cmdbuf.c","cmd_repaint",244,275
11,3,54,1,12,"cmd_home@282-294@usr.bin/less/cmdbuf.c","usr.bin/less/cmdbuf.c","cmd_home",282,294
25,5,124,1,30,"cmd_lshift@300-330@usr.bin/less/cmdbuf.c","usr.bin/less/cmdbuf.c","cmd_lshift",300,330
17,3,82,1,23,"cmd_rshift@336-359@usr.bin/less/cmdbuf.c","usr.bin/less/cmdbuf.c","cmd_rshift",336,359
26,7,139,1,27,"cmd_right@365-392@usr.bin/less/cmdbuf.c","usr.bin/less/cmdbuf.c","cmd_right",365,392
21,6,96,1,22,"cmd_left@398-420@usr.bin/less/cmdbuf.c","usr.bin/less/cmdbuf.c","cmd_left",398,420
16,4,113,2,27,"cmd_ichar@426-453@usr.bin/less/cmdbuf.c","usr.bin/less/cmdbuf.c","cmd_ichar",426,453
21,7,110,1,41,"cmd_erase@460-501@usr.bin/less/cmdbuf.c","usr.bin/less/cmdbuf.c","cmd_erase",460,501
9,2,33,1,12,"cmd_delete@507-519@usr.bin/less/cmdbuf.c","usr.bin/less/cmdbuf.c","cmd_delete",507,519
11,7,72,1,18,"cmd_werase@525-543@usr.bin/less/cmdbuf.c","usr.bin/less/cmdbuf.c","cmd_werase",525,543
11,5,56,1,18,"cmd_wdelete@549-567@usr.bin/less/cmdbuf.c","usr.bin/less/cmdbuf.c","cmd_wdelete",549,567
14,3,61,1,19,"cmd_kill@573-592@usr.bin/less/cmdbuf.c","usr.bin/less/cmdbuf.c","cmd_kill",573,592
7,2,36,2,8,"set_mlist@598-606@usr.bin/less/cmdbuf.c","usr.bin/less/cmdbuf.c","set_mlist",598,606
32,9,174,1,50,"cmd_updown@614-664@usr.bin/less/cmdbuf.c","usr.bin/less/cmdbuf.c","cmd_updown",614,664
16,4,113,2,32,"cmd_addhist@670-702@usr.bin/less/cmdbuf.c","usr.bin/less/cmdbuf.c","cmd_addhist",670,702
7,2,27,1,9,"cmd_accept@709-718@usr.bin/less/cmdbuf.c","usr.bin/less/cmdbuf.c","cmd_accept",709,718
82,31,382,1,95,"cmd_edit@729-824@usr.bin/less/cmdbuf.c","usr.bin/less/cmdbuf.c","cmd_edit",729,824
16,3,90,1,16,"cmd_istr@830-846@usr.bin/less/cmdbuf.c","usr.bin/less/cmdbuf.c","cmd_istr",830,846
38,18,226,1,54,"delimit_word@855-909@usr.bin/less/cmdbuf.c","usr.bin/less/cmdbuf.c","delimit_word",855,909
27,4,148,1,42,"init_compl@917-959@usr.bin/less/cmdbuf.c","usr.bin/less/cmdbuf.c","init_compl",917,959
10,3,50,2,10,"next_compl@965-975@usr.bin/less/cmdbuf.c","usr.bin/less/cmdbuf.c","next_compl",965,975
44,14,222,1,76,"cmd_complete@984-1060@usr.bin/less/cmdbuf.c","usr.bin/less/cmdbuf.c","cmd_complete",984,1060
54,14,249,1,75,"cmd_char@1071-1146@usr.bin/less/cmdbuf.c","usr.bin/less/cmdbuf.c","cmd_char",1071,1146
13,4,88,1,14,"cmd_int@1152-1166@usr.bin/less/cmdbuf.c","usr.bin/less/cmdbuf.c","cmd_int",1152,1166
4,1,11,1,3,"get_cmdbuf@1172-1175@usr.bin/less/cmdbuf.c","usr.bin/less/cmdbuf.c","get_cmdbuf",1172,1175
6,2,28,1,5,"cmd_lastpattern@1181-1186@usr.bin/less/cmdbuf.c","usr.bin/less/cmdbuf.c","cmd_lastpattern",1181,1186
18,8,120,1,22,"histfile_name@1192-1214@usr.bin/less/cmdbuf.c","usr.bin/less/cmdbuf.c","histfile_name",1192,1214
38,13,232,1,38,"init_cmdhist@1220-1258@usr.bin/less/cmdbuf.c","usr.bin/less/cmdbuf.c","init_cmdhist",1220,1258
19,6,126,2,20,"save_mlist@1264-1284@usr.bin/less/cmdbuf.c","usr.bin/less/cmdbuf.c","save_mlist",1264,1284
33,9,202,1,40,"save_cmdhist@1290-1330@usr.bin/less/cmdbuf.c","usr.bin/less/cmdbuf.c","save_cmdhist",1290,1330
6,1,19,1,5,"cmd_exec@80-85@usr.bin/less/command.c","usr.bin/less/command.c","cmd_exec",80,85
8,1,47,4,7,"start_mca@91-98@usr.bin/less/command.c","usr.bin/less/command.c","start_mca",91,98
4,2,17,1,3,"in_mca@101-104@usr.bin/less/command.c","usr.bin/less/command.c","in_mca",101,104
28,10,131,1,30,"mca_search@110-140@usr.bin/less/command.c","usr.bin/less/command.c","mca_search",110,140
26,6,112,1,27,"mca_opt_toggle@146-173@usr.bin/less/command.c","usr.bin/less/command.c","mca_opt_toggle",146,173
64,20,304,1,72,"exec_mca@179-251@usr.bin/less/command.c","usr.bin/less/command.c","exec_mca",179,251
4,3,22,1,3,"is_erase_char@257-260@usr.bin/less/command.c","usr.bin/less/command.c","is_erase_char",257,260
32,9,143,1,36,"mca_opt_first_char@266-302@usr.bin/less/command.c","usr.bin/less/command.c","mca_opt_first_char",266,302
27,9,156,1,40,"mca_opt_nonfirst_char@311-351@usr.bin/less/command.c","usr.bin/less/command.c","mca_opt_nonfirst_char",311,351
38,13,223,1,53,"mca_opt_char@357-410@usr.bin/less/command.c","usr.bin/less/command.c","mca_opt_char",357,410
35,14,144,1,44,"mca_search_char@416-460@usr.bin/less/command.c","usr.bin/less/command.c","mca_search_char",416,460
45,20,219,1,93,"mca_char@466-559@usr.bin/less/command.c","usr.bin/less/command.c","mca_char",466,559
8,2,31,1,7,"clear_buffers@565-572@usr.bin/less/command.c","usr.bin/less/command.c","clear_buffers",565,572
21,5,97,1,33,"make_display@578-611@usr.bin/less/command.c","usr.bin/less/command.c","make_display",578,611
32,14,167,1,62,"prompt@617-679@usr.bin/less/command.c","usr.bin/less/command.c","prompt",617,679
6,1,23,1,6,"dispversion@685-691@usr.bin/less/command.c","usr.bin/less/command.c","dispversion",685,691
28,8,125,1,52,"getcc@700-752@usr.bin/less/command.c","usr.bin/less/command.c","getcc",700,752
8,1,43,1,8,"ungetcc@759-767@usr.bin/less/command.c","usr.bin/less/command.c","ungetcc",759,767
6,2,38,1,6,"ungetsc@774-780@usr.bin/less/command.c","usr.bin/less/command.c","ungetsc",774,780
46,12,198,2,82,"multi_search@788-870@usr.bin/less/command.c","usr.bin/less/command.c","multi_search",788,870
24,9,117,1,31,"forw_loop@876-907@usr.bin/less/command.c","usr.bin/less/command.c","forw_loop",876,907
471,159,2245,1,728,"commands@914-1642@usr.bin/less/command.c","usr.bin/less/command.c","commands",914,1642
6,2,22,1,10,"cvt_length@25-35@usr.bin/less/cvt.c","usr.bin/less/cvt.c","cvt_length",25,35
8,2,50,1,8,"cvt_alloc_chpos@41-49@usr.bin/less/cvt.c","usr.bin/less/cvt.c","cvt_alloc_chpos",41,49
41,21,288,5,46,"cvt_text@57-103@usr.bin/less/cvt.c","usr.bin/less/cvt.c","cvt_text",57,103
32,10,179,2,49,"expand_special_keys@237-286@usr.bin/less/decode.c","usr.bin/less/decode.c","expand_special_keys",237,286
13,2,91,1,22,"init_cmds@292-314@usr.bin/less/decode.c","usr.bin/less/decode.c","init_cmds",292,314
15,3,97,3,19,"add_cmd_table@320-339@usr.bin/less/decode.c","usr.bin/less/decode.c","add_cmd_table",320,339
5,2,32,2,4,"add_fcmd_table@345-349@usr.bin/less/decode.c","usr.bin/less/decode.c","add_fcmd_table",345,349
5,2,32,2,4,"add_ecmd_table@355-359@usr.bin/less/decode.c","usr.bin/less/decode.c","add_ecmd_table",355,359
6,2,37,3,5,"add_var_table@365-370@usr.bin/less/decode.c","usr.bin/less/decode.c","add_var_table",365,370
39,14,224,4,73,"cmd_search@376-449@usr.bin/less/decode.c","usr.bin/less/decode.c","cmd_search",376,449
13,4,86,3,17,"cmd_decode@456-473@usr.bin/less/decode.c","usr.bin/less/decode.c","cmd_decode",456,473
4,1,25,2,3,"fcmd_decode@479-482@usr.bin/less/decode.c","usr.bin/less/decode.c","fcmd_decode",479,482
4,1,25,2,3,"ecmd_decode@488-491@usr.bin/less/decode.c","usr.bin/less/decode.c","ecmd_decode",488,491
21,7,123,1,25,"lgetenv@498-523@usr.bin/less/decode.c","usr.bin/less/decode.c","lgetenv",498,523
7,1,36,1,7,"gint@531-538@usr.bin/less/decode.c","usr.bin/less/decode.c","gint",531,538
7,3,49,2,13,"old_lesskey@544-557@usr.bin/less/decode.c","usr.bin/less/decode.c","old_lesskey",544,557
36,10,182,3,43,"new_lesskey@563-606@usr.bin/less/decode.c","usr.bin/less/decode.c","new_lesskey",563,606
38,12,274,2,58,"lesskey@612-670@usr.bin/less/decode.c","usr.bin/less/decode.c","lesskey",612,670
18,5,106,3,18,"add_hometable@676-694@usr.bin/less/decode.c","usr.bin/less/decode.c","add_hometable",676,694
54,20,243,2,81,"editchar@700-781@usr.bin/less/decode.c","usr.bin/less/decode.c","editchar",700,781
27,10,177,2,27,"init_textlist@51-78@usr.bin/less/edit.c","usr.bin/less/edit.c","init_textlist",51,78
15,5,80,2,19,"forw_textlist@81-100@usr.bin/less/edit.c","usr.bin/less/edit.c","forw_textlist",81,100
17,7,97,2,21,"back_textlist@103-124@usr.bin/less/edit.c","usr.bin/less/edit.c","back_textlist",103,124
20,4,90,1,32,"close_file@130-162@usr.bin/less/edit.c","usr.bin/less/edit.c","close_file",130,162
6,2,35,1,5,"edit@170-175@usr.bin/less/edit.c","usr.bin/less/edit.c","edit",170,175
121,29,662,1,197,"edit_ifile@182-379@usr.bin/less/edit.c","usr.bin/less/edit.c","edit_ifile",182,379
35,7,191,1,48,"edit_list@387-435@usr.bin/less/edit.c","usr.bin/less/edit.c","edit_list",387,435
5,1,18,1,4,"edit_first@441-445@usr.bin/less/edit.c","usr.bin/less/edit.c","edit_first",441,445
5,1,18,1,4,"edit_last@451-455@usr.bin/less/edit.c","usr.bin/less/edit.c","edit_last",451,455
19,7,96,3,32,"edit_istep@462-494@usr.bin/less/edit.c","usr.bin/less/edit.c","edit_istep",462,494
4,1,23,2,3,"edit_inext@497-500@usr.bin/less/edit.c","usr.bin/less/edit.c","edit_inext",497,500
4,1,20,1,3,"edit_next@503-506@usr.bin/less/edit.c","usr.bin/less/edit.c","edit_next",503,506
4,1,23,2,3,"edit_iprev@509-512@usr.bin/less/edit.c","usr.bin/less/edit.c","edit_iprev",509,512
4,1,20,1,3,"edit_prev@515-518@usr.bin/less/edit.c","usr.bin/less/edit.c","edit_prev",515,518
11,3,55,1,15,"edit_index@524-539@usr.bin/less/edit.c","usr.bin/less/edit.c","edit_index",524,539
6,2,24,1,5,"save_curr_ifile@542-547@usr.bin/less/edit.c","usr.bin/less/edit.c","save_curr_ifile",542,547
5,2,21,1,4,"unsave_ifile@550-554@usr.bin/less/edit.c","usr.bin/less/edit.c","unsave_ifile",550,554
15,6,82,1,30,"reedit_ifile@560-590@usr.bin/less/edit.c","usr.bin/less/edit.c","reedit_ifile",560,590
6,1,22,1,5,"reopen_curr_ifile@593-598@usr.bin/less/edit.c","usr.bin/less/edit.c","reopen_curr_ifile",593,598
14,3,51,1,13,"edit_stdin@604-617@usr.bin/less/edit.c","usr.bin/less/edit.c","edit_stdin",604,617
7,2,31,1,7,"cat_file@624-631@usr.bin/less/edit.c","usr.bin/less/edit.c","cat_file",624,631
48,13,241,1,83,"use_logfile@639-722@usr.bin/less/edit.c","usr.bin/less/edit.c","use_logfile",639,722
27,8,154,1,27,"shell_unquote@41-68@usr.bin/less/filename.c","usr.bin/less/filename.c","shell_unquote",41,68
8,2,32,1,8,"get_meta_escape@74-82@usr.bin/less/filename.c","usr.bin/less/filename.c","get_meta_escape",74,82
10,3,43,1,10,"metachars@88-98@usr.bin/less/filename.c","usr.bin/less/filename.c","metachars",88,98
4,1,21,1,3,"metachar@104-107@usr.bin/less/filename.c","usr.bin/less/filename.c","metachar",104,107
40,10,221,1,57,"shell_quote@113-170@usr.bin/less/filename.c","usr.bin/less/filename.c","shell_quote",113,170
19,4,106,2,25,"dirfile@177-202@usr.bin/less/filename.c","usr.bin/less/filename.c","dirfile",177,202
4,1,21,1,3,"homefile@208-211@usr.bin/less/filename.c","usr.bin/less/filename.c","homefile",208,211
53,15,289,1,76,"fexpand@221-297@usr.bin/less/filename.c","usr.bin/less/filename.c","fexpand",221,297
17,3,85,1,24,"fcomplete@304-328@usr.bin/less/filename.c","usr.bin/less/filename.c","fcomplete",304,328
24,9,175,1,28,"bin_file@335-363@usr.bin/less/filename.c","usr.bin/less/filename.c","bin_file",335,363
25,5,147,1,33,"readfd@370-403@usr.bin/less/filename.c","usr.bin/less/filename.c","readfd",370,403
22,4,118,1,32,"shellcmd@410-442@usr.bin/less/filename.c","usr.bin/less/filename.c","shellcmd",410,442
43,8,256,1,54,"lglob@448-502@usr.bin/less/filename.c","usr.bin/less/filename.c","lglob",448,502
51,9,316,2,54,"expand_pct_s@509-563@usr.bin/less/filename.c","usr.bin/less/filename.c","expand_pct_s",509,563
54,14,306,3,80,"open_altfile@570-650@usr.bin/less/filename.c","usr.bin/less/filename.c","open_altfile",570,650
22,6,122,3,22,"close_altfile@656-678@usr.bin/less/filename.c","usr.bin/less/filename.c","close_altfile",656,678
11,2,62,1,12,"is_dir@684-696@usr.bin/less/filename.c","usr.bin/less/filename.c","is_dir",684,696
22,6,121,1,23,"bad_file@704-727@usr.bin/less/filename.c","usr.bin/less/filename.c","bad_file",704,727
7,2,36,1,7,"filesize@733-740@usr.bin/less/filename.c","usr.bin/less/filename.c","filesize",733,740
10,3,52,1,10,"last_component@746-756@usr.bin/less/filename.c","usr.bin/less/filename.c","last_component",746,756
7,2,21,1,6,"eof_bell@42-48@usr.bin/less/forwback.c","usr.bin/less/forwback.c","eof_bell",42,48
10,4,53,1,21,"eof_displayed@54-75@usr.bin/less/forwback.c","usr.bin/less/forwback.c","eof_displayed",54,75
8,3,40,1,11,"entire_file_displayed@81-92@usr.bin/less/forwback.c","usr.bin/less/forwback.c","entire_file_displayed",81,92
7,2,21,1,6,"squish_check@101-107@usr.bin/less/forwback.c","usr.bin/less/forwback.c","squish_check",101,107
62,30,339,5,119,"forw@119-238@usr.bin/less/forwback.c","usr.bin/less/forwback.c","forw",119,238
28,10,144,4,39,"back@244-283@usr.bin/less/forwback.c","usr.bin/less/forwback.c","back",244,283
27,11,158,3,37,"forward@290-327@usr.bin/less/forwback.c","usr.bin/less/forwback.c","forward",290,327
10,4,61,3,10,"backward@334-344@usr.bin/less/forwback.c","usr.bin/less/forwback.c","backward",334,344
10,4,42,1,9,"get_back_scroll@353-362@usr.bin/less/forwback.c","usr.bin/less/forwback.c","get_back_scroll",353,362
5,2,32,2,4,"incr_index@53-57@usr.bin/less/ifile.c","usr.bin/less/ifile.c","incr_index",53,57
12,2,75,2,18,"link_ifile@63-81@usr.bin/less/ifile.c","usr.bin/less/ifile.c","link_ifile",63,81
7,1,42,1,6,"unlink_ifile@87-93@usr.bin/less/ifile.c","usr.bin/less/ifile.c","unlink_ifile",87,93
12,1,79,2,15,"new_ifile@102-117@usr.bin/less/ifile.c","usr.bin/less/ifile.c","new_ifile",102,117
13,3,62,1,17,"del_ifile@123-140@usr.bin/less/ifile.c","usr.bin/less/ifile.c","del_ifile",123,140
8,3,52,1,8,"next_ifile@146-154@usr.bin/less/ifile.c","usr.bin/less/ifile.c","next_ifile",146,154
8,3,52,1,8,"prev_ifile@160-168@usr.bin/less/ifile.c","usr.bin/less/ifile.c","prev_ifile",160,168
9,3,51,1,9,"getoff_ifile@174-183@usr.bin/less/ifile.c","usr.bin/less/ifile.c","getoff_ifile",174,183
4,1,11,1,3,"nifile@189-192@usr.bin/less/ifile.c","usr.bin/less/ifile.c","nifile",189,192
8,3,56,1,8,"find_ifile@198-206@usr.bin/less/ifile.c","usr.bin/less/ifile.c","find_ifile",198,206
7,2,49,2,7,"get_ifile@214-221@usr.bin/less/ifile.c","usr.bin/less/ifile.c","get_ifile",214,221
6,2,28,1,5,"get_filename@227-232@usr.bin/less/ifile.c","usr.bin/less/ifile.c","get_filename",227,232
4,1,17,1,3,"get_index@238-241@usr.bin/less/ifile.c","usr.bin/less/ifile.c","get_index",238,241
4,1,22,2,3,"store_pos@247-250@usr.bin/less/ifile.c","usr.bin/less/ifile.c","store_pos",247,250
4,1,22,2,3,"get_pos@257-260@usr.bin/less/ifile.c","usr.bin/less/ifile.c","get_pos",257,260
4,1,16,1,3,"set_open@266-269@usr.bin/less/ifile.c","usr.bin/less/ifile.c","set_open",266,269
4,1,17,1,3,"opened@275-278@usr.bin/less/ifile.c","usr.bin/less/ifile.c","opened",275,278
4,1,19,2,3,"hold_ifile@281-284@usr.bin/less/ifile.c","usr.bin/less/ifile.c","hold_ifile",281,284
4,1,17,1,3,"held_ifile@287-290@usr.bin/less/ifile.c","usr.bin/less/ifile.c","held_ifile",287,290
4,1,17,1,3,"get_filestate@293-296@usr.bin/less/ifile.c","usr.bin/less/ifile.c","get_filestate",293,296
4,1,20,2,3,"set_filestate@299-302@usr.bin/less/ifile.c","usr.bin/less/ifile.c","set_filestate",299,302
119,40,610,1,168,"forw_line@44-212@usr.bin/less/input.c","usr.bin/less/input.c","forw_line",44,212
104,35,531,1,151,"back_line@222-373@usr.bin/less/input.c","usr.bin/less/input.c","back_line",222,373
24,11,104,1,24,"set_attnpos@379-403@usr.bin/less/input.c","usr.bin/less/input.c","set_attnpos",379,403
20,4,95,1,30,"jump_forw@30-60@usr.bin/less/jump.c","usr.bin/less/jump.c","jump_forw",30,60
17,6,100,1,23,"jump_back@66-89@usr.bin/less/jump.c","usr.bin/less/jump.c","jump_back",66,89
7,1,31,1,10,"repaint@95-105@usr.bin/less/jump.c","usr.bin/less/jump.c","repaint",95,105
16,4,95,2,21,"jump_percent@111-132@usr.bin/less/jump.c","usr.bin/less/jump.c","jump_percent",111,132
14,6,76,2,17,"jump_line_loc@140-157@usr.bin/less/jump.c","usr.bin/less/jump.c","jump_line_loc",140,157
62,17,354,2,113,"jump_loc@165-278@usr.bin/less/jump.c","usr.bin/less/jump.c","jump_loc",165,278
5,1,21,1,4,"usage@219-223@usr.bin/less/lesskey.c","usr.bin/less/lesskey.c","usage",219,223
13,2,83,2,13,"mkpathname@226-239@usr.bin/less/lesskey.c","usr.bin/less/lesskey.c","mkpathname",226,239
13,3,73,1,13,"homefile@245-258@usr.bin/less/lesskey.c","usr.bin/less/lesskey.c","homefile",245,258
55,17,275,2,61,"parse_args@264-325@usr.bin/less/lesskey.c","usr.bin/less/lesskey.c","parse_args",264,325
9,1,48,1,10,"init_tables@331-341@usr.bin/less/lesskey.c","usr.bin/less/lesskey.c","init_tables",331,341
94,37,593,2,105,"tstr@347-452@usr.bin/less/lesskey.c","usr.bin/less/lesskey.c","tstr",347,452
6,3,28,1,5,"skipsp@458-463@usr.bin/less/lesskey.c","usr.bin/less/lesskey.c","skipsp",458,463
6,4,33,1,5,"skipnsp@469-474@usr.bin/less/lesskey.c","usr.bin/less/lesskey.c","skipnsp",469,474
10,7,86,1,10,"clean_line@481-491@usr.bin/less/lesskey.c","usr.bin/less/lesskey.c","clean_line",481,491
8,2,44,1,7,"add_cmd_char@497-504@usr.bin/less/lesskey.c","usr.bin/less/lesskey.c","add_cmd_char",497,504
5,2,25,1,4,"add_cmd_str@510-514@usr.bin/less/lesskey.c","usr.bin/less/lesskey.c","add_cmd_str",510,514
21,5,102,1,22,"control_line@520-542@usr.bin/less/lesskey.c","usr.bin/less/lesskey.c","control_line",520,542
7,2,44,3,6,"fputbytes@548-554@usr.bin/less/lesskey.c","usr.bin/less/lesskey.c","fputbytes",548,554
13,2,94,2,13,"fputint@560-573@usr.bin/less/lesskey.c","usr.bin/less/lesskey.c","fputint",560,573
9,3,71,1,9,"findaction@579-588@usr.bin/less/lesskey.c","usr.bin/less/lesskey.c","findaction",579,588
5,1,25,1,4,"lkerr@591-595@usr.bin/less/lesskey.c","usr.bin/less/lesskey.c","lkerr",591,595
38,8,199,1,62,"parse_cmdline@599-661@usr.bin/less/lesskey.c","usr.bin/less/lesskey.c","parse_cmdline",599,661
21,7,125,1,27,"parse_varline@664-691@usr.bin/less/lesskey.c","usr.bin/less/lesskey.c","parse_varline",664,691
13,4,55,1,22,"parse_line@697-719@usr.bin/less/lesskey.c","usr.bin/less/lesskey.c","parse_line",697,719
53,9,398,2,81,"main@722-803@usr.bin/less/lesskey.c","usr.bin/less/lesskey.c","main",722,803
12,5,78,1,13,"init_line@72-85@usr.bin/less/line.c","usr.bin/less/line.c","init_line",72,85
15,3,87,1,17,"expand_linebuf@91-108@usr.bin/less/line.c","usr.bin/less/line.c","expand_linebuf",91,108
4,1,14,1,3,"is_ascii_char@114-117@usr.bin/less/line.c","usr.bin/less/line.c","is_ascii_char",114,117
13,2,46,1,12,"prewind@123-135@usr.bin/less/line.c","usr.bin/less/line.c","prewind",123,135
38,10,207,1,59,"plinenum@141-200@usr.bin/less/line.c","usr.bin/less/line.c","plinenum",141,200
84,32,533,1,105,"pshift@207-312@usr.bin/less/line.c","usr.bin/less/line.c","pshift",207,312
4,1,11,1,3,"pshift_all@318-321@usr.bin/less/line.c","usr.bin/less/line.c","pshift_all",318,321
14,5,64,1,16,"attr_swidth@328-344@usr.bin/less/line.c","usr.bin/less/line.c","attr_swidth",328,344
14,5,64,1,16,"attr_ewidth@351-367@usr.bin/less/line.c","usr.bin/less/line.c","attr_ewidth",351,367
24,15,180,3,50,"pwidth@376-426@usr.bin/less/line.c","usr.bin/less/line.c","pwidth",376,426
18,5,125,1,20,"backc@433-453@usr.bin/less/line.c","usr.bin/less/line.c","backc",433,453
12,4,71,1,16,"in_ansi_esc_seq@459-475@usr.bin/less/line.c","usr.bin/less/line.c","in_ansi_esc_seq",459,475
6,2,35,1,5,"is_ansi_end@481-486@usr.bin/less/line.c","usr.bin/less/line.c","is_ansi_end",481,486
8,3,47,1,7,"is_ansi_middle@492-499@usr.bin/less/line.c","usr.bin/less/line.c","is_ansi_middle",492,499
54,19,342,4,70,"store_char@509-579@usr.bin/less/line.c","usr.bin/less/line.c","store_char",509,579
21,7,152,2,23,"store_tab@590-613@usr.bin/less/line.c","usr.bin/less/line.c","store_tab",590,613
12,3,86,2,21,"store_prchar@620-641@usr.bin/less/line.c","usr.bin/less/line.c","store_prchar",620,641
8,3,47,1,9,"flush_mbc_buf@644-653@usr.bin/less/line.c","usr.bin/less/line.c","flush_mbc_buf",644,653
63,19,342,2,89,"pappend@661-750@usr.bin/less/line.c","usr.bin/less/line.c","pappend",661,750
83,38,542,3,119,"do_append@753-872@usr.bin/less/line.c","usr.bin/less/line.c","do_append",753,872
9,2,35,1,10,"pflushmbc@878-888@usr.bin/less/line.c","usr.bin/less/line.c","pflushmbc",878,888
38,20,268,2,79,"pdone@894-973@usr.bin/less/line.c","usr.bin/less/line.c","pdone",894,973
5,1,23,1,4,"set_status_col@979-983@usr.bin/less/line.c","usr.bin/less/line.c","set_status_col",979,983
16,5,76,2,21,"gline@991-1012@usr.bin/less/line.c","usr.bin/less/line.c","gline",991,1012
5,1,14,1,4,"null_line@1018-1022@usr.bin/less/line.c","usr.bin/less/line.c","null_line",1018,1022
30,12,166,3,35,"forw_raw_line@1030-1065@usr.bin/less/line.c","usr.bin/less/line.c","forw_raw_line",1030,1065
36,12,204,3,53,"back_raw_line@1072-1125@usr.bin/less/line.c","usr.bin/less/line.c","back_raw_line",1072,1125
13,2,92,1,22,"clr_linenum@80-102@usr.bin/less/linenum.c","usr.bin/less/linenum.c","clr_linenum",80,102
6,3,41,1,11,"calcgap@108-119@usr.bin/less/linenum.c","usr.bin/less/linenum.c","calcgap",108,119
40,8,237,2,74,"add_lnum@127-201@usr.bin/less/linenum.c","usr.bin/less/linenum.c","add_lnum",127,201
5,1,21,1,4,"timeout_set@207-211@usr.bin/less/linenum.c","usr.bin/less/linenum.c","timeout_set",207,211
6,1,30,1,6,"timeout_elapsed@214-220@usr.bin/less/linenum.c","usr.bin/less/linenum.c","timeout_elapsed",214,220
10,4,43,1,9,"longish@223-232@usr.bin/less/linenum.c","usr.bin/less/linenum.c","longish",223,232
7,2,27,1,9,"abort_long@239-248@usr.bin/less/linenum.c","usr.bin/less/linenum.c","abort_long",239,248
52,18,330,1,101,"find_linenum@255-356@usr.bin/less/linenum.c","usr.bin/less/linenum.c","find_linenum",255,356
40,15,273,1,64,"find_pos@363-427@usr.bin/less/linenum.c","usr.bin/less/linenum.c","find_pos",363,427
16,6,84,1,16,"currline@435-451@usr.bin/less/linenum.c","usr.bin/less/linenum.c","currline",435,451
61,10,335,2,106,"lsystem@32-138@usr.bin/less/lsystem.c","usr.bin/less/lsystem.c","lsystem",32,138
19,6,135,2,25,"pipe_mark@153-178@usr.bin/less/lsystem.c","usr.bin/less/lsystem.c","pipe_mark",153,178
45,11,247,3,64,"pipe_data@185-249@usr.bin/less/lsystem.c","usr.bin/less/lsystem.c","pipe_data",185,249
140,48,767,2,210,"main@66-276@usr.bin/less/main.c","usr.bin/less/main.c","main",66,276
10,2,52,2,10,"ecalloc@283-293@usr.bin/less/main.c","usr.bin/less/main.c","ecalloc",283,293
14,3,76,2,15,"easprintf@296-311@usr.bin/less/main.c","usr.bin/less/main.c","easprintf",296,311
10,2,45,1,10,"estrdup@314-324@usr.bin/less/main.c","usr.bin/less/main.c","estrdup",314,324
6,3,28,1,5,"skipsp@330-335@usr.bin/less/main.c","usr.bin/less/main.c","skipsp",330,335
21,7,111,3,21,"sprefix@343-364@usr.bin/less/main.c","usr.bin/less/main.c","sprefix",343,364
18,5,73,1,22,"quit@370-392@usr.bin/less/main.c","usr.bin/less/main.c","quit",370,392
4,2,17,1,3,"helpfile@395-398@usr.bin/less/main.c","usr.bin/less/main.c","helpfile",395,398
6,2,34,1,6,"init_mark@39-45@usr.bin/less/mark.c","usr.bin/less/mark.c","init_mark",39,45
9,5,63,1,10,"getumark@51-61@usr.bin/less/mark.c","usr.bin/less/mark.c","getumark",51,61
41,8,199,1,56,"getmark@69-125@usr.bin/less/mark.c","usr.bin/less/mark.c","getmark",69,125
4,1,17,1,3,"badmark@131-134@usr.bin/less/mark.c","usr.bin/less/mark.c","badmark",131,134
11,2,49,1,11,"setmark@140-151@usr.bin/less/mark.c","usr.bin/less/mark.c","setmark",140,151
11,3,55,1,11,"lastmark@157-168@usr.bin/less/mark.c","usr.bin/less/mark.c","lastmark",157,168
19,6,114,1,35,"gomark@174-209@usr.bin/less/mark.c","usr.bin/less/mark.c","gomark",174,209
12,3,63,1,13,"markpos@219-232@usr.bin/less/mark.c","usr.bin/less/mark.c","markpos",219,232
7,3,46,1,7,"unmark@238-245@usr.bin/less/mark.c","usr.bin/less/mark.c","unmark",238,245
35,8,145,2,35,"opt_o@64-99@usr.bin/less/optfunc.c","usr.bin/less/optfunc.c","opt_o",64,99
5,1,22,2,4,"opt__O@105-109@usr.bin/less/optfunc.c","usr.bin/less/optfunc.c","opt__O",105,109
43,10,216,2,43,"opt_j@115-158@usr.bin/less/optfunc.c","usr.bin/less/optfunc.c","opt_j",115,158
6,2,22,1,5,"calc_jump_sline@161-166@usr.bin/less/optfunc.c","usr.bin/less/optfunc.c","calc_jump_sline",161,166
43,10,216,2,44,"opt_shift@172-216@usr.bin/less/optfunc.c","usr.bin/less/optfunc.c","opt_shift",172,216
6,2,22,1,5,"calc_shift_count@219-224@usr.bin/less/optfunc.c","usr.bin/less/optfunc.c","calc_shift_count",219,224
12,3,50,2,12,"opt_k@227-239@usr.bin/less/optfunc.c","usr.bin/less/optfunc.c","opt_k",227,239
24,6,104,2,30,"opt_t@245-275@usr.bin/less/optfunc.c","usr.bin/less/optfunc.c","opt_t",245,275
17,4,67,2,17,"opt__T@281-298@usr.bin/less/optfunc.c","usr.bin/less/optfunc.c","opt__T",281,298
11,3,41,2,19,"opt_p@304-323@usr.bin/less/optfunc.c","usr.bin/less/optfunc.c","opt_p",304,323
25,10,174,2,28,"opt__P@329-357@usr.bin/less/optfunc.c","usr.bin/less/optfunc.c","opt__P",329,357
11,4,35,2,13,"opt_b@363-376@usr.bin/less/optfunc.c","usr.bin/less/optfunc.c","opt_b",363,376
11,4,34,2,10,"opt_i@382-392@usr.bin/less/optfunc.c","usr.bin/less/optfunc.c","opt_i",382,392
27,4,113,2,29,"opt__V@398-427@usr.bin/less/optfunc.c","usr.bin/less/optfunc.c","opt__V",398,427
47,13,331,2,48,"opt_x@433-481@usr.bin/less/optfunc.c","usr.bin/less/optfunc.c","opt_x",433,481
31,8,148,2,31,"opt_quote@488-519@usr.bin/less/optfunc.c","usr.bin/less/optfunc.c","opt_quote",488,519
11,4,39,2,10,"opt_query@526-536@usr.bin/less/optfunc.c","usr.bin/less/optfunc.c","opt_query",526,536
6,2,24,1,5,"get_swindow@542-547@usr.bin/less/optfunc.c","usr.bin/less/optfunc.c","get_swindow",542,547
10,2,78,1,9,"opt_desc@40-49@usr.bin/less/option.c","usr.bin/less/option.c","opt_desc",40,49
6,1,39,1,6,"propt@56-62@usr.bin/less/option.c","usr.bin/less/option.c","propt",56,62
190,64,877,1,243,"scan_option@69-312@usr.bin/less/option.c","usr.bin/less/option.c","scan_option",69,312
107,40,574,4,160,"toggle_option@324-484@usr.bin/less/option.c","usr.bin/less/option.c","toggle_option",324,484
7,4,41,2,6,"flip_triple@490-496@usr.bin/less/option.c","usr.bin/less/option.c","flip_triple",490,496
8,3,46,1,7,"opt_has_param@502-509@usr.bin/less/option.c","usr.bin/less/option.c","opt_has_param",502,509
6,3,44,1,5,"opt_prompt@516-521@usr.bin/less/option.c","usr.bin/less/option.c","opt_prompt",516,521
4,1,13,1,3,"isoptpending@531-534@usr.bin/less/option.c","usr.bin/less/option.c","isoptpending",531,534
6,1,25,1,5,"nostring@540-545@usr.bin/less/option.c","usr.bin/less/option.c","nostring",540,545
4,1,14,1,3,"nopendopt@551-554@usr.bin/less/option.c","usr.bin/less/option.c","nopendopt",551,554
24,9,152,4,28,"optstring@562-590@usr.bin/less/option.c","usr.bin/less/option.c","optstring",562,590
13,3,62,2,13,"num_error@595-608@usr.bin/less/option.c","usr.bin/less/option.c","num_error",595,608
23,8,134,3,24,"getnum@616-640@usr.bin/less/option.c","usr.bin/less/option.c","getnum",616,640
23,9,146,3,24,"getfraction@649-673@usr.bin/less/option.c","usr.bin/less/option.c","getfraction",649,673
4,1,11,1,3,"get_quit_at_eof@680-683@usr.bin/less/option.c","usr.bin/less/option.c","get_quit_at_eof",680,683
10,4,69,1,13,"init_option@435-448@usr.bin/less/opttbl.c","usr.bin/less/opttbl.c","init_option",435,448
12,5,77,1,12,"findopt@454-466@usr.bin/less/opttbl.c","usr.bin/less/opttbl.c","findopt",454,466
7,4,35,1,6,"is_optchar@472-478@usr.bin/less/opttbl.c","usr.bin/less/opttbl.c","is_optchar",472,478
43,14,270,3,69,"findopt_name@487-556@usr.bin/less/opttbl.c","usr.bin/less/opttbl.c","findopt_name",487,556
15,4,76,3,19,"iread@36-55@usr.bin/less/os.c","usr.bin/less/os.c","iread",36,55
4,1,23,1,3,"errno_message@61-64@usr.bin/less/os.c","usr.bin/less/os.c","errno_message",61,64
5,1,43,3,4,"muldiv@67-71@usr.bin/less/os.c","usr.bin/less/os.c","muldiv",67,71
4,1,28,2,3,"percentage@78-81@usr.bin/less/os.c","usr.bin/less/os.c","percentage",78,81
7,2,58,3,11,"percent_pos@87-98@usr.bin/less/os.c","usr.bin/less/os.c","percent_pos",87,98
18,4,82,1,23,"put_line@34-57@usr.bin/less/output.c","usr.bin/less/output.c","put_line",34,57
17,6,88,1,18,"flush@79-97@usr.bin/less/output.c","usr.bin/less/output.c","flush",79,97
11,3,55,1,14,"putchr@103-117@usr.bin/less/output.c","usr.bin/less/output.c","putchr",103,117
5,2,26,1,4,"putstr@123-127@usr.bin/less/output.c","usr.bin/less/output.c","putstr",123,127
7,1,37,1,7,"iprint_int@158-165@usr.bin/less/output.c","usr.bin/less/output.c","iprint_int",158,165
7,1,38,1,7,"iprint_linenum@171-178@usr.bin/less/output.c","usr.bin/less/output.c","iprint_linenum",171,178
33,7,144,2,33,"less_printf@185-218@usr.bin/less/output.c","usr.bin/less/output.c","less_printf",185,218
7,5,38,1,7,"get_return@226-233@usr.bin/less/output.c","usr.bin/less/output.c","get_return",226,233
28,7,138,2,40,"error@240-280@usr.bin/less/output.c","usr.bin/less/output.c","error",240,280
11,1,54,2,10,"ierror@291-301@usr.bin/less/output.c","usr.bin/less/output.c","ierror",291,301
18,6,95,2,22,"query@308-330@usr.bin/less/output.c","usr.bin/less/output.c","query",308,330
16,5,100,3,16,"compile_pattern2@26-42@usr.bin/less/pattern.c","usr.bin/less/pattern.c","compile_pattern2",26,42
15,3,92,3,15,"compile_pattern@48-63@usr.bin/less/pattern.c","usr.bin/less/pattern.c","compile_pattern",48,63
6,2,26,1,5,"uncompile_pattern@69-74@usr.bin/less/pattern.c","usr.bin/less/pattern.c","uncompile_pattern",69,74
20,8,135,6,20,"match@81-101@usr.bin/less/pattern.c","usr.bin/less/pattern.c","match",81,101
26,8,187,8,28,"match_pattern@108-136@usr.bin/less/pattern.c","usr.bin/less/pattern.c","match_pattern",108,136
14,4,56,1,13,"position@40-53@usr.bin/less/position.c","usr.bin/less/position.c","position",40,53
7,2,44,1,10,"add_forw_pos@59-69@usr.bin/less/position.c","usr.bin/less/position.c","add_forw_pos",59,69
7,2,44,1,10,"add_back_pos@75-85@usr.bin/less/position.c","usr.bin/less/position.c","add_back_pos",75,85
6,2,30,1,6,"pos_clear@91-97@usr.bin/less/position.c","usr.bin/less/position.c","pos_clear",91,97
17,4,89,1,21,"pos_init@103-124@usr.bin/less/position.c","usr.bin/less/position.c","pos_init",103,124
10,4,60,1,10,"onscreen@132-142@usr.bin/less/position.c","usr.bin/less/position.c","onscreen",132,142
4,1,18,1,3,"empty_screen@148-151@usr.bin/less/position.c","usr.bin/less/position.c","empty_screen",148,151
8,4,53,2,8,"empty_lines@154-162@usr.bin/less/position.c","usr.bin/less/position.c","empty_lines",154,162
11,3,63,1,18,"get_scrpos@173-191@usr.bin/less/position.c","usr.bin/less/position.c","get_scrpos",173,191
10,4,46,1,19,"adjsline@203-222@usr.bin/less/position.c","usr.bin/less/position.c","adjsline",203,222
9,3,65,1,8,"init_prompt@76-84@usr.bin/less/prompt.c","usr.bin/less/prompt.c","init_prompt",76,84
10,2,59,1,10,"ap_str@90-100@usr.bin/less/prompt.c","usr.bin/less/prompt.c","ap_str",90,100
7,1,32,1,7,"ap_char@106-113@usr.bin/less/prompt.c","usr.bin/less/prompt.c","ap_char",106,113
6,1,30,1,6,"ap_pos@119-125@usr.bin/less/prompt.c","usr.bin/less/prompt.c","ap_pos",119,125
6,1,28,1,6,"ap_int@131-137@usr.bin/less/prompt.c","usr.bin/less/prompt.c","ap_int",131,137
4,1,11,1,3,"ap_quest@143-146@usr.bin/less/prompt.c","usr.bin/less/prompt.c","ap_quest",143,146
10,5,60,1,10,"curr_byte@152-162@usr.bin/less/prompt.c","usr.bin/less/prompt.c","curr_byte",152,162
39,23,246,2,39,"cond@171-210@usr.bin/less/prompt.c","usr.bin/less/prompt.c","cond",171,210
122,42,562,2,127,"protochar@220-347@usr.bin/less/prompt.c","usr.bin/less/prompt.c","protochar",220,347
25,9,90,1,51,"skipcond@357-408@usr.bin/less/prompt.c","usr.bin/less/prompt.c","skipcond",357,408
15,11,113,2,14,"wherechar@414-428@usr.bin/less/prompt.c","usr.bin/less/prompt.c","wherechar",414,428
50,14,243,2,57,"pr_expand@434-491@usr.bin/less/prompt.c","usr.bin/less/prompt.c","pr_expand",434,491
4,1,16,1,3,"eq_message@497-500@usr.bin/less/prompt.c","usr.bin/less/prompt.c","eq_message",497,500
10,2,54,1,10,"prompt_string@509-519@usr.bin/less/prompt.c","usr.bin/less/prompt.c","prompt_string",509,519
4,1,22,1,3,"wait_message@525-528@usr.bin/less/prompt.c","usr.bin/less/prompt.c","wait_message",525,528
32,8,210,1,60,"raw_mode@104-164@usr.bin/less/screen.c","usr.bin/less/screen.c","raw_mode",104,164
28,12,187,1,33,"scrsize@175-208@usr.bin/less/screen.c","usr.bin/less/screen.c","scrsize",175,208
45,13,155,1,46,"special_key_str@214-260@usr.bin/less/screen.c","usr.bin/less/screen.c","special_key_str",214,260
113,50,675,1,179,"get_term@266-445@usr.bin/less/screen.c","usr.bin/less/screen.c","get_term",266,445
5,1,15,1,4,"inc_costcount@457-461@usr.bin/less/screen.c","usr.bin/less/screen.c","inc_costcount",457,461
6,1,29,1,5,"cost@464-469@usr.bin/less/screen.c","usr.bin/less/screen.c","cost",464,469
14,6,85,3,13,"cheaper@477-490@usr.bin/less/screen.c","usr.bin/less/screen.c","cheaper",477,490
20,5,101,6,25,"tmodes@493-518@usr.bin/less/screen.c","usr.bin/less/screen.c","tmodes",493,518
14,5,79,1,20,"init@529-549@usr.bin/less/screen.c","usr.bin/less/screen.c","init",529,549
10,4,51,1,9,"deinit@555-564@usr.bin/less/screen.c","usr.bin/less/screen.c","deinit",555,564
4,1,18,1,3,"home@570-573@usr.bin/less/screen.c","usr.bin/less/screen.c","home",570,573
4,1,18,1,3,"add_line@580-583@usr.bin/less/screen.c","usr.bin/less/screen.c","add_line",580,583
4,1,18,1,3,"lower_left@589-592@usr.bin/less/screen.c","usr.bin/less/screen.c","lower_left",589,592
4,1,18,1,3,"line_left@598-601@usr.bin/less/screen.c","usr.bin/less/screen.c","line_left",598,601
5,1,40,1,4,"goto_line@607-611@usr.bin/less/screen.c","usr.bin/less/screen.c","goto_line",607,611
6,2,27,1,5,"vbell@617-622@usr.bin/less/screen.c","usr.bin/less/screen.c","vbell",617,622
4,1,17,1,3,"beep@628-631@usr.bin/less/screen.c","usr.bin/less/screen.c","beep",628,631
7,2,21,1,6,"ring_bell@637-643@usr.bin/less/screen.c","usr.bin/less/screen.c","ring_bell",637,643
4,1,18,1,3,"do_clear@649-652@usr.bin/less/screen.c","usr.bin/less/screen.c","do_clear",649,652
4,1,18,1,3,"clear_eol@659-662@usr.bin/less/screen.c","usr.bin/less/screen.c","clear_eol",659,662
7,2,35,1,6,"clear_eol_bot@669-675@usr.bin/less/screen.c","usr.bin/less/screen.c","clear_eol_bot",669,675
16,3,50,1,22,"clear_bot@682-704@usr.bin/less/screen.c","usr.bin/less/screen.c","clear_bot",682,704
13,5,90,1,15,"at_enter@707-722@usr.bin/less/screen.c","usr.bin/less/screen.c","at_enter",707,722
12,5,82,1,13,"at_exit@725-738@usr.bin/less/screen.c","usr.bin/less/screen.c","at_exit",725,738
9,2,45,1,9,"at_switch@741-750@usr.bin/less/screen.c","usr.bin/less/screen.c","at_switch",741,750
6,1,31,2,6,"is_at_equiv@753-759@usr.bin/less/screen.c","usr.bin/less/screen.c","is_at_equiv",753,759
9,3,40,1,9,"apply_at_specials@762-771@usr.bin/less/screen.c","usr.bin/less/screen.c","apply_at_specials",762,771
4,1,18,1,3,"putbs@777-780@usr.bin/less/screen.c","usr.bin/less/screen.c","putbs",777,780
11,3,60,1,11,"is_ucase@76-87@usr.bin/less/search.c","usr.bin/less/search.c","is_ucase",76,87
18,6,114,3,23,"set_pattern@93-116@usr.bin/less/search.c","usr.bin/less/search.c","set_pattern",93,116
6,1,30,1,5,"clear_pattern@122-127@usr.bin/less/search.c","usr.bin/less/search.c","clear_pattern",122,127
6,1,27,1,5,"init_pattern@133-138@usr.bin/less/search.c","usr.bin/less/search.c","init_pattern",133,138
5,1,18,1,4,"init_search@144-148@usr.bin/less/search.c","usr.bin/less/search.c","init_search",144,148
17,8,77,1,16,"get_cvt_ops@154-170@usr.bin/less/search.c","usr.bin/less/search.c","get_cvt_ops",154,170
6,2,39,1,5,"prev_pattern@176-181@usr.bin/less/search.c","usr.bin/less/search.c","prev_pattern",176,181
29,7,122,1,32,"repaint_hilite@189-221@usr.bin/less/search.c","usr.bin/less/search.c","repaint_hilite",189,221
35,10,163,1,37,"clear_attn@227-264@usr.bin/less/search.c","usr.bin/less/search.c","clear_attn",227,264
9,2,36,1,8,"undo_search@270-278@usr.bin/less/search.c","usr.bin/less/search.c","undo_search",270,278
11,2,61,1,11,"clr_hlist@284-295@usr.bin/less/search.c","usr.bin/less/search.c","clr_hlist",284,295
4,1,12,1,3,"clr_hilite@298-301@usr.bin/less/search.c","usr.bin/less/search.c","clr_hilite",298,301
4,1,12,1,3,"clr_filter@304-307@usr.bin/less/search.c","usr.bin/less/search.c","clr_filter",304,307
10,5,66,2,13,"is_hilited_range@313-326@usr.bin/less/search.c","usr.bin/less/search.c","is_hilited_range",313,326
11,4,63,1,16,"is_filtered@332-348@usr.bin/less/search.c","usr.bin/less/search.c","is_filtered",332,348
21,12,119,4,39,"is_hilited@355-394@usr.bin/less/search.c","usr.bin/less/search.c","is_hilited",355,394
20,6,132,2,32,"add_hilite@400-432@usr.bin/less/search.c","usr.bin/less/search.c","add_hilite",400,432
17,5,143,4,28,"create_hilites@438-466@usr.bin/less/search.c","usr.bin/less/search.c","create_hilites",438,466
21,6,147,6,37,"hilite_line@474-511@usr.bin/less/search.c","usr.bin/less/search.c","hilite_line",474,511
7,2,22,1,14,"chg_caseless@518-532@usr.bin/less/search.c","usr.bin/less/search.c","chg_caseless",518,532
9,2,47,1,9,"hilite_screen@538-547@usr.bin/less/search.c","usr.bin/less/search.c","hilite_screen",538,547
7,2,24,1,13,"chg_hilite@553-566@usr.bin/less/search.c","usr.bin/less/search.c","chg_hilite",553,566
53,16,244,1,78,"search_pos@572-650@usr.bin/less/search.c","usr.bin/less/search.c","search_pos",572,650
93,25,542,7,163,"search_range@656-819@usr.bin/less/search.c","usr.bin/less/search.c","search_range",656,819
13,5,72,1,16,"hist_pattern@825-841@usr.bin/less/search.c","usr.bin/less/search.c","hist_pattern",825,841
54,19,308,3,99,"search@853-952@usr.bin/less/search.c","usr.bin/less/search.c","search",853,952
59,22,308,3,110,"prep_hilite@966-1076@usr.bin/less/search.c","usr.bin/less/search.c","prep_hilite",966,1076
9,3,50,2,8,"set_filter_pattern@1082-1090@usr.bin/less/search.c","usr.bin/less/search.c","set_filter_pattern",1082,1090
6,2,28,1,5,"is_filtering@1096-1101@usr.bin/less/search.c","usr.bin/less/search.c","is_filtering",1096,1101
4,1,11,1,3,"u_interrupt@40-43@usr.bin/less/signal.c","usr.bin/less/signal.c","u_interrupt",40,43
4,1,11,1,3,"stop@49-52@usr.bin/less/signal.c","usr.bin/less/signal.c","stop",49,52
4,1,11,1,3,"sigwinch@58-61@usr.bin/less/signal.c","usr.bin/less/signal.c","sigwinch",58,61
14,2,96,1,19,"init_signals@67-86@usr.bin/less/signal.c","usr.bin/less/signal.c","init_signals",67,86
39,8,185,1,52,"psignals@93-145@usr.bin/less/signal.c","usr.bin/less/signal.c","psignals",93,145
10,2,69,2,10,"lsignal@151-161@usr.bin/less/signal.c","usr.bin/less/signal.c","lsignal",151,161
12,2,59,1,17,"cleantags@69-86@usr.bin/less/tags.c","usr.bin/less/tags.c","cleantags",69,86
13,2,84,4,13,"maketagent@92-105@usr.bin/less/tags.c","usr.bin/less/tags.c","maketagent",92,105
19,6,69,1,19,"findtag@111-130@usr.bin/less/tags.c","usr.bin/less/tags.c","findtag",111,130
8,3,43,1,7,"tagsearch@136-143@usr.bin/less/tags.c","usr.bin/less/tags.c","tagsearch",136,143
7,2,31,1,7,"nexttag@149-156@usr.bin/less/tags.c","usr.bin/less/tags.c","nexttag",149,156
7,2,31,1,7,"prevtag@162-169@usr.bin/less/tags.c","usr.bin/less/tags.c","prevtag",162,169
4,1,11,1,3,"ntags@175-178@usr.bin/less/tags.c","usr.bin/less/tags.c","ntags",175,178
4,1,11,1,3,"curr_tag@184-187@usr.bin/less/tags.c","usr.bin/less/tags.c","curr_tag",184,187
66,17,365,1,102,"findctag@194-296@usr.bin/less/tags.c","usr.bin/less/tags.c","findctag",194,296
6,2,27,1,5,"edit_tagfile@302-307@usr.bin/less/tags.c","usr.bin/less/tags.c","edit_tagfile",302,307
31,10,178,1,60,"ctagsearch@319-379@usr.bin/less/tags.c","usr.bin/less/tags.c","ctagsearch",319,379
17,4,73,1,20,"nextctag@389-409@usr.bin/less/tags.c","usr.bin/less/tags.c","nextctag",389,409
17,4,73,1,20,"prevctag@417-437@usr.bin/less/tags.c","usr.bin/less/tags.c","prevctag",417,437
6,2,25,1,11,"open_getchr@26-37@usr.bin/less/ttyin.c","usr.bin/less/ttyin.c","open_getchr",26,37
16,5,79,1,26,"getchr@43-69@usr.bin/less/ttyin.c","usr.bin/less/ttyin.c","getchr",43,69
1,1,5,0,0,"FlexLexer::~FlexLexer@67-67@usr.bin/lex/FlexLexer.h","usr.bin/lex/FlexLexer.h","FlexLexer::~FlexLexer",67,67
1,1,9,0,0,"FlexLexer::YYText@69-69@usr.bin/lex/FlexLexer.h","usr.bin/lex/FlexLexer.h","FlexLexer::YYText",69,69
1,1,9,0,0,"FlexLexer::YYLeng@70-70@usr.bin/lex/FlexLexer.h","usr.bin/lex/FlexLexer.h","FlexLexer::YYLeng",70,70
5,1,28,2,4,"FlexLexer::yylex@82-86@usr.bin/lex/FlexLexer.h","usr.bin/lex/FlexLexer.h","FlexLexer::yylex",82,86
1,1,9,0,0,"FlexLexer::lineno@93-93@usr.bin/lex/FlexLexer.h","usr.bin/lex/FlexLexer.h","FlexLexer::lineno",93,93
1,1,9,0,0,"FlexLexer::debug@95-95@usr.bin/lex/FlexLexer.h","usr.bin/lex/FlexLexer.h","FlexLexer::debug",95,95
1,1,11,1,0,"FlexLexer::set_debug@96-96@usr.bin/lex/FlexLexer.h","usr.bin/lex/FlexLexer.h","FlexLexer::set_debug",96,96
12,5,78,2,13,"buf_print_strings@59-72@usr.bin/lex/buf.c","usr.bin/lex/buf.c","buf_print_strings",59,72
13,2,88,3,13,"buf_prints@76-89@usr.bin/lex/buf.c","usr.bin/lex/buf.c","buf_prints",76,89
23,4,162,3,23,"buf_linedir@98-121@usr.bin/lex/buf.c","usr.bin/lex/buf.c","buf_linedir",98,121
5,1,31,2,4,"buf_concat@130-134@usr.bin/lex/buf.c","usr.bin/lex/buf.c","buf_concat",130,134
6,1,36,3,8,"buf_strnappend@139-147@usr.bin/lex/buf.c","usr.bin/lex/buf.c","buf_strnappend",139,147
4,1,27,2,3,"buf_strappend@151-154@usr.bin/lex/buf.c","usr.bin/lex/buf.c","buf_strappend",151,154
10,1,64,3,9,"buf_strdefine@158-167@usr.bin/lex/buf.c","usr.bin/lex/buf.c","buf_strdefine",158,167
14,3,106,3,15,"buf_m4_define@176-191@usr.bin/lex/buf.c","usr.bin/lex/buf.c","buf_m4_define",176,191
13,2,86,2,14,"buf_m4_undefine@199-213@usr.bin/lex/buf.c","usr.bin/lex/buf.c","buf_m4_undefine",199,213
7,1,36,2,6,"buf_init@217-223@usr.bin/lex/buf.c","usr.bin/lex/buf.c","buf_init",217,223
5,1,22,1,4,"buf_destroy@227-231@usr.bin/lex/buf.c","usr.bin/lex/buf.c","buf_destroy",227,231
27,7,186,3,36,"buf_append@241-277@usr.bin/lex/buf.c","usr.bin/lex/buf.c","buf_append",241,277
10,3,70,2,12,"ccl_contains@40-52@usr.bin/lex/ccl.c","usr.bin/lex/ccl.c","ccl_contains",40,52
23,5,127,2,33,"ccladd@58-91@usr.bin/lex/ccl.c","usr.bin/lex/ccl.c","ccladd",58,91
18,6,120,2,26,"dump_cclp@96-122@usr.bin/lex/ccl.c","usr.bin/lex/ccl.c","dump_cclp",96,122
19,5,123,2,28,"ccl_set_diff@128-156@usr.bin/lex/ccl.c","usr.bin/lex/ccl.c","ccl_set_diff",128,156
20,4,154,2,27,"ccl_set_union@160-187@usr.bin/lex/ccl.c","usr.bin/lex/ccl.c","ccl_set_union",160,187
24,3,114,0,35,"cclinit@193-228@usr.bin/lex/ccl.c","usr.bin/lex/ccl.c","cclinit",193,228
6,1,27,1,5,"cclnegate@234-239@usr.bin/lex/ccl.c","usr.bin/lex/ccl.c","cclnegate",234,239
20,6,122,2,28,"list_character_set@250-278@usr.bin/lex/ccl.c","usr.bin/lex/ccl.c","list_character_set",250,278
12,5,62,2,12,"range_covers_case@292-304@usr.bin/lex/ccl.c","usr.bin/lex/ccl.c","range_covers_case",292,304
4,3,32,1,3,"reverse_case@310-313@usr.bin/lex/ccl.c","usr.bin/lex/ccl.c","reverse_case",310,313
4,3,24,1,3,"has_case@317-320@usr.bin/lex/ccl.c","usr.bin/lex/ccl.c","has_case",317,320
15,6,87,2,22,"check_for_backing_up@54-76@usr.bin/lex/dfa.c","usr.bin/lex/dfa.c","check_for_backing_up",54,76
23,7,132,4,31,"check_trailing_context@101-132@usr.bin/lex/dfa.c","usr.bin/lex/dfa.c","check_trailing_context",101,132
29,8,205,2,36,"dump_associated_rules@142-178@usr.bin/lex/dfa.c","usr.bin/lex/dfa.c","dump_associated_rules",142,178
18,3,128,2,25,"dump_transitions@192-217@usr.bin/lex/dfa.c","usr.bin/lex/dfa.c","dump_transitions",192,217
47,12,289,5,110,"epsclosure@240-350@usr.bin/lex/dfa.c","usr.bin/lex/dfa.c","epsclosure",240,350
16,2,88,0,18,"increase_max_dfas@355-373@usr.bin/lex/dfa.c","usr.bin/lex/dfa.c","increase_max_dfas",355,373
252,60,1431,0,429,"ntod@382-811@usr.bin/lex/dfa.c","usr.bin/lex/dfa.c","ntod",382,811
67,19,478,6,112,"snstods@824-936@usr.bin/lex/dfa.c","usr.bin/lex/dfa.c","snstods",824,936
46,14,278,4,68,"symfollowset@946-1014@usr.bin/lex/dfa.c","usr.bin/lex/dfa.c","symfollowset",946,1014
53,14,355,4,73,"sympartition@1024-1097@usr.bin/lex/dfa.c","usr.bin/lex/dfa.c","sympartition",1024,1097
17,4,106,1,28,"ccl2ecl@42-70@usr.bin/lex/ecs.c","usr.bin/lex/ecs.c","ccl2ecl",42,70
12,4,89,3,18,"cre8ecs@82-100@usr.bin/lex/ecs.c","usr.bin/lex/ecs.c","cre8ecs",82,100
46,17,301,6,85,"mkeccl@119-204@usr.bin/lex/ecs.c","usr.bin/lex/ecs.c","mkeccl",119,204
9,3,73,3,15,"mkechar@210-225@usr.bin/lex/ecs.c","usr.bin/lex/ecs.c","mkechar",210,225
37,7,252,3,43,"filter_create_ext@44-87@usr.bin/lex/filter.c","usr.bin/lex/filter.c","filter_create_ext",44,87
20,4,114,3,24,"filter_create_int@98-122@usr.bin/lex/filter.c","usr.bin/lex/filter.c","filter_create_int",98,122
39,9,276,1,68,"filter_apply_chain@129-197@usr.bin/lex/filter.c","usr.bin/lex/filter.c","filter_apply_chain",129,197
12,4,55,2,14,"filter_truncate@205-219@usr.bin/lex/filter.c","usr.bin/lex/filter.c","filter_truncate",205,219
72,18,474,1,105,"filter_tee_header@227-332@usr.bin/lex/filter.c","usr.bin/lex/filter.c","filter_tee_header",227,332
66,21,391,1,94,"filter_fix_linedirs@341-435@usr.bin/lex/filter.c","usr.bin/lex/filter.c","filter_fix_linedirs",341,435
6,2,15,1,5,"get_int16_decl@61-66@usr.bin/lex/gen.c","usr.bin/lex/gen.c","get_int16_decl",61,66
6,2,15,1,5,"get_int32_decl@70-75@usr.bin/lex/gen.c","usr.bin/lex/gen.c","get_int32_decl",70,75
6,2,15,1,5,"get_state_decl@78-83@usr.bin/lex/gen.c","usr.bin/lex/gen.c","get_state_decl",78,83
12,3,45,0,13,"do_indent@88-101@usr.bin/lex/gen.c","usr.bin/lex/gen.c","do_indent",88,101
18,3,112,1,20,"mkeoltbl@108-128@usr.bin/lex/gen.c","usr.bin/lex/gen.c","mkeoltbl",108,128
17,5,91,0,19,"geneoltbl@132-151@usr.bin/lex/gen.c","usr.bin/lex/gen.c","geneoltbl",132,151
15,4,58,0,16,"gen_backing_up@157-173@usr.bin/lex/gen.c","usr.bin/lex/gen.c","gen_backing_up",157,173
17,5,72,0,25,"gen_bu_action@179-204@usr.bin/lex/gen.c","usr.bin/lex/gen.c","gen_bu_action",179,204
54,11,461,1,94,"mkctbl@214-308@usr.bin/lex/gen.c","usr.bin/lex/gen.c","mkctbl",214,308
19,2,122,1,23,"mkssltbl@315-338@usr.bin/lex/gen.c","usr.bin/lex/gen.c","mkssltbl",315,338
53,15,387,0,98,"genctbl@345-443@usr.bin/lex/gen.c","usr.bin/lex/gen.c","genctbl",345,443
21,2,129,1,25,"mkecstbl@449-474@usr.bin/lex/gen.c","usr.bin/lex/gen.c","mkecstbl",449,474
23,5,150,0,30,"genecs@479-509@usr.bin/lex/gen.c","usr.bin/lex/gen.c","genecs",479,509
97,8,377,0,133,"gen_find_action@515-648@usr.bin/lex/gen.c","usr.bin/lex/gen.c","gen_find_action",515,648
26,5,163,1,32,"mkftbl@655-687@usr.bin/lex/gen.c","usr.bin/lex/gen.c","mkftbl",655,687
18,6,105,0,29,"genftbl@693-722@usr.bin/lex/gen.c","usr.bin/lex/gen.c","genftbl",693,722
22,2,86,1,40,"gen_next_compressed_state@728-768@usr.bin/lex/gen.c","usr.bin/lex/gen.c","gen_next_compressed_state",728,768
70,13,282,0,96,"gen_next_match@774-870@usr.bin/lex/gen.c","usr.bin/lex/gen.c","gen_next_match",774,870
53,17,203,1,61,"gen_next_state@876-937@usr.bin/lex/gen.c","usr.bin/lex/gen.c","gen_next_state",876,937
52,14,236,0,79,"gen_NUL_trans@943-1022@usr.bin/lex/gen.c","usr.bin/lex/gen.c","gen_NUL_trans",943,1022
23,5,71,0,25,"gen_start_state@1028-1053@usr.bin/lex/gen.c","usr.bin/lex/gen.c","gen_start_state",1028,1053
284,72,1878,0,411,"gentabs@1059-1470@usr.bin/lex/gen.c","usr.bin/lex/gen.c","gentabs",1059,1470
7,1,32,2,6,"indent_put2s@1478-1484@usr.bin/lex/gen.c","usr.bin/lex/gen.c","indent_put2s",1478,1484
6,1,20,1,5,"indent_puts@1492-1497@usr.bin/lex/gen.c","usr.bin/lex/gen.c","indent_puts",1492,1497
497,81,2231,0,632,"make_tables@1504-2136@usr.bin/lex/gen.c","usr.bin/lex/gen.c","make_tables",1504,2136
7,2,29,2,7,"main@29-36@usr.bin/lex/libmain.c","usr.bin/lex/libmain.c","main",29,36
4,1,9,1,3,"yywrap@27-30@usr.bin/lex/libyywrap.c","usr.bin/lex/libyywrap.c","yywrap",27,30
36,15,200,2,61,"flex_main@140-201@usr.bin/lex/main.c","usr.bin/lex/main.c","flex_main",140,201
15,4,82,2,19,"main@205-224@usr.bin/lex/main.c","usr.bin/lex/main.c","main",205,224
167,61,1077,0,238,"check_options@229-467@usr.bin/lex/main.c","usr.bin/lex/main.c","check_options",229,467
372,63,1562,1,425,"flexend@476-901@usr.bin/lex/main.c","usr.bin/lex/main.c","flexend",476,901
395,106,1731,2,524,"flexinit@907-1431@usr.bin/lex/main.c","usr.bin/lex/main.c","flexinit",907,1431
170,51,715,0,220,"readin@1437-1657@usr.bin/lex/main.c","usr.bin/lex/main.c","readin",1437,1657
47,2,290,0,55,"set_up_initial_allocations@1663-1718@usr.bin/lex/main.c","usr.bin/lex/main.c","set_up_initial_allocations",1663,1718
15,7,83,2,16,"basename2@1724-1740@usr.bin/lex/main.c","usr.bin/lex/main.c","basename2",1724,1740
66,3,130,0,67,"usage@1743-1810@usr.bin/lex/main.c","usr.bin/lex/main.c","usage",1743,1810
16,4,87,1,16,"sko_push@62-78@usr.bin/lex/misc.c","usr.bin/lex/misc.c","sko_push",62,78
7,3,35,1,6,"sko_peek@80-86@usr.bin/lex/misc.c","usr.bin/lex/misc.c","sko_peek",80,86
7,2,27,1,6,"sko_pop@88-94@usr.bin/lex/misc.c","usr.bin/lex/misc.c","sko_pop",88,94
17,2,93,2,19,"action_define@98-117@usr.bin/lex/misc.c","usr.bin/lex/misc.c","action_define",98,117
13,3,78,2,14,"action_m4_define@125-139@usr.bin/lex/misc.c","usr.bin/lex/misc.c","action_m4_define",125,139
18,3,83,1,26,"add_action@143-169@usr.bin/lex/misc.c","usr.bin/lex/misc.c","add_action",143,169
12,2,48,2,13,"allocate_array@175-188@usr.bin/lex/misc.c","usr.bin/lex/misc.c","allocate_array",175,188
10,4,48,1,10,"all_lower@194-204@usr.bin/lex/misc.c","usr.bin/lex/misc.c","all_lower",194,204
10,4,48,1,10,"all_upper@210-220@usr.bin/lex/misc.c","usr.bin/lex/misc.c","all_upper",210,220
4,1,31,2,3,"intcmp@226-229@usr.bin/lex/misc.c","usr.bin/lex/misc.c","intcmp",226,229
11,3,47,1,11,"check_char@238-249@usr.bin/lex/misc.c","usr.bin/lex/misc.c","check_char",238,249
5,3,34,1,4,"clower@256-260@usr.bin/lex/misc.c","usr.bin/lex/misc.c","clower",256,260
15,4,104,1,21,"copy_string@266-287@usr.bin/lex/misc.c","usr.bin/lex/misc.c","copy_string",266,287
10,3,65,1,14,"copy_unsigned_string@295-309@usr.bin/lex/misc.c","usr.bin/lex/misc.c","copy_unsigned_string",295,309
9,3,62,2,8,"cclcmp@315-323@usr.bin/lex/misc.c","usr.bin/lex/misc.c","cclcmp",315,323
10,3,34,0,13,"dataend@329-342@usr.bin/lex/misc.c","usr.bin/lex/misc.c","dataend",329,342
11,3,39,0,18,"dataflush@348-366@usr.bin/lex/misc.c","usr.bin/lex/misc.c","dataflush",348,366
6,1,27,1,5,"flexerror@372-377@usr.bin/lex/misc.c","usr.bin/lex/misc.c","flexerror",372,377
7,1,30,1,6,"flexfatal@383-389@usr.bin/lex/misc.c","usr.bin/lex/misc.c","flexfatal",383,389
7,1,35,1,8,"htoi@395-403@usr.bin/lex/misc.c","usr.bin/lex/misc.c","htoi",395,403
8,1,41,2,8,"lerrif@409-417@usr.bin/lex/misc.c","usr.bin/lex/misc.c","lerrif",409,417
8,1,56,2,8,"lerrsf@423-431@usr.bin/lex/misc.c","usr.bin/lex/misc.c","lerrsf",423,431
8,1,56,2,8,"lerrsf_fatal@437-445@usr.bin/lex/misc.c","usr.bin/lex/misc.c","lerrsf_fatal",437,445
30,10,182,2,43,"line_directive_out@451-494@usr.bin/lex/misc.c","usr.bin/lex/misc.c","line_directive_out",451,494
7,1,30,0,6,"mark_defs1@502-508@usr.bin/lex/misc.c","usr.bin/lex/misc.c","mark_defs1",502,508
6,1,24,0,5,"mark_prolog@515-520@usr.bin/lex/misc.c","usr.bin/lex/misc.c","mark_prolog",515,520
16,4,60,1,21,"mk2data@528-549@usr.bin/lex/misc.c","usr.bin/lex/misc.c","mk2data",528,549
16,4,60,1,20,"mkdata@558-578@usr.bin/lex/misc.c","usr.bin/lex/misc.c","mkdata",558,578
7,1,32,1,8,"myctoi@584-592@usr.bin/lex/misc.c","usr.bin/lex/misc.c","myctoi",584,592
58,24,236,1,85,"myesc@598-683@usr.bin/lex/misc.c","usr.bin/lex/misc.c","myesc",598,683
7,1,35,1,7,"otoi@689-696@usr.bin/lex/misc.c","usr.bin/lex/misc.c","otoi",689,696
5,1,18,1,4,"out@704-708@usr.bin/lex/misc.c","usr.bin/lex/misc.c","out",704,708
6,1,25,2,5,"out_dec@711-716@usr.bin/lex/misc.c","usr.bin/lex/misc.c","out_dec",711,716
6,1,31,3,5,"out_dec2@719-724@usr.bin/lex/misc.c","usr.bin/lex/misc.c","out_dec2",719,724
6,1,26,2,5,"out_hex@727-732@usr.bin/lex/misc.c","usr.bin/lex/misc.c","out_hex",727,732
5,1,26,2,4,"out_str@735-739@usr.bin/lex/misc.c","usr.bin/lex/misc.c","out_str",735,739
5,1,42,4,4,"out_str3@742-746@usr.bin/lex/misc.c","usr.bin/lex/misc.c","out_str3",742,746
6,1,33,3,5,"out_str_dec@749-754@usr.bin/lex/misc.c","usr.bin/lex/misc.c","out_str_dec",749,754
5,1,16,1,4,"outc@757-761@usr.bin/lex/misc.c","usr.bin/lex/misc.c","outc",757,761
6,1,25,1,5,"outn@764-769@usr.bin/lex/misc.c","usr.bin/lex/misc.c","outn",764,769
5,2,36,2,4,"out_m4_define@777-781@usr.bin/lex/misc.c","usr.bin/lex/misc.c","out_m4_define",777,781
32,13,135,1,38,"readable_form@790-828@usr.bin/lex/misc.c","usr.bin/lex/misc.c","readable_form",790,828
12,2,56,3,13,"reallocate_array@834-847@usr.bin/lex/misc.c","usr.bin/lex/misc.c","reallocate_array",834,847
78,41,553,0,105,"skelout@857-962@usr.bin/lex/misc.c","usr.bin/lex/misc.c","skelout",857,962
14,4,66,2,20,"transition_struct_out@972-992@usr.bin/lex/misc.c","usr.bin/lex/misc.c","transition_struct_out",972,992
9,2,37,1,10,"yy_flex_xmalloc@999-1009@usr.bin/lex/misc.c","usr.bin/lex/misc.c","yy_flex_xmalloc",999,1009
13,7,66,1,17,"chomp@1016-1033@usr.bin/lex/misc.c","usr.bin/lex/misc.c","chomp",1016,1033
11,2,63,2,19,"add_accept@51-70@usr.bin/lex/nfa.c","usr.bin/lex/nfa.c","add_accept",51,70
9,2,53,2,11,"copysingl@85-96@usr.bin/lex/nfa.c","usr.bin/lex/nfa.c","copysingl",85,96
21,3,132,1,36,"dumpnfa@102-138@usr.bin/lex/nfa.c","usr.bin/lex/nfa.c","dumpnfa",102,138
26,6,195,1,32,"dupmachine@159-191@usr.bin/lex/nfa.c","usr.bin/lex/nfa.c","dupmachine",159,191
60,13,336,5,95,"finish_rule@207-302@usr.bin/lex/nfa.c","usr.bin/lex/nfa.c","finish_rule",207,302
15,3,94,2,17,"link_machines@322-339@usr.bin/lex/nfa.c","usr.bin/lex/nfa.c","link_machines",322,339
21,6,92,1,25,"mark_beginning_as_normal@350-375@usr.bin/lex/nfa.c","usr.bin/lex/nfa.c","mark_beginning_as_normal",350,375
13,3,59,2,17,"mkbranch@393-410@usr.bin/lex/nfa.c","usr.bin/lex/nfa.c","mkbranch",393,410
5,1,18,1,4,"mkclos@422-426@usr.bin/lex/nfa.c","usr.bin/lex/nfa.c","mkclos",422,426
13,2,70,1,20,"mkopt@444-464@usr.bin/lex/nfa.c","usr.bin/lex/nfa.c","mkopt",444,464
30,7,188,2,43,"mkor@482-525@usr.bin/lex/nfa.c","usr.bin/lex/nfa.c","mkor",482,525
13,2,62,1,13,"mkposcl@537-550@usr.bin/lex/nfa.c","usr.bin/lex/nfa.c","mkposcl",537,550
22,3,130,3,26,"mkrep@566-592@usr.bin/lex/nfa.c","usr.bin/lex/nfa.c","mkrep",566,592
42,7,231,1,63,"mkstate@612-675@usr.bin/lex/nfa.c","usr.bin/lex/nfa.c","mkstate",612,675
13,4,71,2,14,"mkxtion@689-703@usr.bin/lex/nfa.c","usr.bin/lex/nfa.c","mkxtion",689,703
20,3,94,0,20,"new_rule@708-728@usr.bin/lex/nfa.c","usr.bin/lex/nfa.c","new_rule",708,728
6,1,29,1,6,"flex_init_regex@39-45@usr.bin/lex/regex.c","usr.bin/lex/regex.c","flex_init_regex",39,45
20,4,160,3,23,"flex_regcomp@52-75@usr.bin/lex/regex.c","usr.bin/lex/regex.c","flex_regcomp",52,75
14,4,101,2,14,"regmatch_dup@82-96@usr.bin/lex/regex.c","usr.bin/lex/regex.c","regmatch_dup",82,96
10,4,66,3,10,"regmatch_cpy@104-114@usr.bin/lex/regex.c","usr.bin/lex/regex.c","regmatch_cpy",104,114
7,3,34,1,7,"regmatch_len@121-128@usr.bin/lex/regex.c","usr.bin/lex/regex.c","regmatch_len",121,128
17,5,105,4,23,"regmatch_strtol@139-162@usr.bin/lex/regex.c","usr.bin/lex/regex.c","regmatch_strtol",139,162
4,3,29,1,3,"regmatch_empty@169-172@usr.bin/lex/regex.c","usr.bin/lex/regex.c","regmatch_empty",169,172
7,2,55,1,8,"sf_push@42-50@usr.bin/lex/scanflags.c","usr.bin/lex/scanflags.c","sf_push",42,50
5,1,16,1,4,"sf_pop@53-57@usr.bin/lex/scanflags.c","usr.bin/lex/scanflags.c","sf_pop",53,57
9,2,62,1,8,"sf_init@61-69@usr.bin/lex/scanflags.c","usr.bin/lex/scanflags.c","sf_init",61,69
7,2,46,2,6,"STRCASECMP@47-53@usr.bin/lex/scanopt.c","usr.bin/lex/scanopt.c","STRCASECMP",47,53
7,2,45,2,6,"NAME@92-98@usr.bin/lex/scanopt.c","usr.bin/lex/scanopt.c","NAME",92,98
6,1,26,2,5,"PRINTLEN@100-105@usr.bin/lex/scanopt.c","usr.bin/lex/scanopt.c","PRINTLEN",100,105
6,1,26,2,5,"RVAL@107-112@usr.bin/lex/scanopt.c","usr.bin/lex/scanopt.c","RVAL",107,112
6,1,26,2,5,"FLAGS@114-119@usr.bin/lex/scanopt.c","usr.bin/lex/scanopt.c","FLAGS",114,119
6,2,37,2,5,"DESC@121-126@usr.bin/lex/scanopt.c","usr.bin/lex/scanopt.c","DESC",121,126
12,4,54,0,16,"get_cols@131-147@usr.bin/lex/scanopt.c","usr.bin/lex/scanopt.c","get_cols",131,147
62,15,457,4,73,"scanopt_init@164-237@usr.bin/lex/scanopt.c","usr.bin/lex/scanopt.c","scanopt_init",164,237
190,53,1274,3,270,"scanopt_usage@260-530@usr.bin/lex/scanopt.c","usr.bin/lex/scanopt.c","scanopt_usage",260,530
51,10,244,4,54,"scanopt_err@534-588@usr.bin/lex/scanopt.c","usr.bin/lex/scanopt.c","scanopt_err",534,588
27,8,157,5,39,"matchlongopt@597-636@usr.bin/lex/scanopt.c","usr.bin/lex/scanopt.c","matchlongopt",597,636
51,17,313,6,62,"find_opt@644-706@usr.bin/lex/scanopt.c","usr.bin/lex/scanopt.c","find_opt",644,706
100,24,604,3,148,"scanopt@709-857@usr.bin/lex/scanopt.c","usr.bin/lex/scanopt.c","scanopt",709,857
10,2,42,1,10,"scanopt_destroy@860-870@usr.bin/lex/scanopt.c","usr.bin/lex/scanopt.c","scanopt_destroy",860,870
34,5,190,5,42,"addsym@77-119@usr.bin/lex/sym.c","usr.bin/lex/sym.c","addsym",77,119
7,1,43,2,10,"cclinstal@124-134@usr.bin/lex/sym.c","usr.bin/lex/sym.c","cclinstal",124,134
5,1,27,1,4,"ccllookup@142-146@usr.bin/lex/sym.c","usr.bin/lex/sym.c","ccllookup",142,146
18,3,103,3,20,"findsym@151-171@usr.bin/lex/sym.c","usr.bin/lex/sym.c","findsym",151,171
14,2,66,2,16,"hashfunct@175-191@usr.bin/lex/sym.c","usr.bin/lex/sym.c","hashfunct",175,191
9,2,51,2,9,"ndinstal@196-205@usr.bin/lex/sym.c","usr.bin/lex/sym.c","ndinstal",196,205
5,1,27,1,4,"ndlookup@213-217@usr.bin/lex/sym.c","usr.bin/lex/sym.c","ndlookup",213,217
10,1,57,0,11,"scextend@222-233@usr.bin/lex/sym.c","usr.bin/lex/sym.c","scextend",222,233
17,3,103,2,20,"scinstal@242-262@usr.bin/lex/sym.c","usr.bin/lex/sym.c","scinstal",242,262
5,1,23,1,4,"sclookup@270-274@usr.bin/lex/sym.c","usr.bin/lex/sym.c","sclookup",270,274
6,1,28,2,5,"yytbl_writer_init@68-73@usr.bin/lex/tables.c","usr.bin/lex/tables.c","yytbl_writer_init",68,73
13,1,102,3,13,"yytbl_hdr_init@80-93@usr.bin/lex/tables.c","usr.bin/lex/tables.c","yytbl_hdr_init",80,93
7,1,41,2,7,"yytbl_data_init@100-107@usr.bin/lex/tables.c","usr.bin/lex/tables.c","yytbl_data_init",100,107
7,1,30,1,6,"yytbl_data_destroy@113-119@usr.bin/lex/tables.c","usr.bin/lex/tables.c","yytbl_data_destroy",113,119
11,3,54,1,11,"yytbl_write_pad64@122-133@usr.bin/lex/tables.c","usr.bin/lex/tables.c","yytbl_write_pad64",122,133
29,10,254,2,38,"yytbl_hdr_fwrite@140-178@usr.bin/lex/tables.c","usr.bin/lex/tables.c","yytbl_hdr_fwrite",140,178
59,16,406,2,70,"yytbl_data_fwrite@186-256@usr.bin/lex/tables.c","usr.bin/lex/tables.c","yytbl_data_fwrite",186,256
9,2,53,3,9,"yytbl_writen@264-273@usr.bin/lex/tables.c","usr.bin/lex/tables.c","yytbl_writen",264,273
12,2,69,2,12,"yytbl_write32@280-292@usr.bin/lex/tables.c","usr.bin/lex/tables.c","yytbl_write32",280,292
12,2,69,2,12,"yytbl_write16@299-311@usr.bin/lex/tables.c","usr.bin/lex/tables.c","yytbl_write16",299,311
10,2,59,2,10,"yytbl_write8@318-328@usr.bin/lex/tables.c","usr.bin/lex/tables.c","yytbl_write8",318,328
15,4,105,2,15,"yytbl_data_geti@337-352@usr.bin/lex/tables.c","usr.bin/lex/tables.c","yytbl_data_geti",337,352
18,4,123,3,18,"yytbl_data_seti@361-379@usr.bin/lex/tables.c","usr.bin/lex/tables.c","yytbl_data_seti",361,379
18,5,98,1,22,"min_int_size@386-408@usr.bin/lex/tables.c","usr.bin/lex/tables.c","min_int_size",386,408
27,4,186,1,38,"yytbl_data_compress@419-457@usr.bin/lex/tables.c","usr.bin/lex/tables.c","yytbl_data_compress",419,457
10,3,48,1,12,"yytbl_calc_total_len@60-72@usr.bin/lex/tables_shared.c","usr.bin/lex/tables_shared.c","yytbl_calc_total_len",60,72
61,12,360,5,138,"bldtbl@84-222@usr.bin/lex/tblcmp.c","usr.bin/lex/tblcmp.c","bldtbl",84,222
32,9,189,0,61,"cmptmps@234-295@usr.bin/lex/tblcmp.c","usr.bin/lex/tblcmp.c","cmptmps",234,295
9,1,53,0,12,"expand_nxt_chk@302-314@usr.bin/lex/tblcmp.c","usr.bin/lex/tblcmp.c","expand_nxt_chk",302,314
40,14,206,2,92,"find_table_space@337-429@usr.bin/lex/tblcmp.c","usr.bin/lex/tblcmp.c","find_table_space",337,429
16,3,89,0,26,"inittbl@438-464@usr.bin/lex/tblcmp.c","usr.bin/lex/tblcmp.c","inittbl",438,464
19,3,101,0,28,"mkdeftbl@470-498@usr.bin/lex/tblcmp.c","usr.bin/lex/tblcmp.c","mkdeftbl",470,498
66,31,468,5,110,"mkentry@521-631@usr.bin/lex/tblcmp.c","usr.bin/lex/tblcmp.c","mkentry",521,631
18,6,104,4,21,"mk1tbl@639-660@usr.bin/lex/tblcmp.c","usr.bin/lex/tblcmp.c","mk1tbl",639,660
20,5,137,3,30,"mkprot@666-696@usr.bin/lex/tblcmp.c","usr.bin/lex/tblcmp.c","mkprot",666,696
29,5,190,3,48,"mktemplate@704-752@usr.bin/lex/tblcmp.c","usr.bin/lex/tblcmp.c","mktemplate",704,752
15,4,90,1,17,"mv2front@758-775@usr.bin/lex/tblcmp.c","usr.bin/lex/tblcmp.c","mv2front",758,775
18,4,124,3,34,"place_state@786-820@usr.bin/lex/tblcmp.c","usr.bin/lex/tblcmp.c","place_state",786,820
13,2,74,4,13,"stack1@831-844@usr.bin/lex/tblcmp.c","usr.bin/lex/tblcmp.c","stack1",831,844
16,3,103,3,18,"tbldiff@862-880@usr.bin/lex/tblcmp.c","usr.bin/lex/tblcmp.c","tbldiff",862,880
141,76,536,0,170,"yylex@43-213@usr.bin/lex/yylex.c","usr.bin/lex/yylex.c","yylex",43,213
43,18,340,2,52,"main@83-135@usr.bin/lndir/lndir.c","usr.bin/lndir/lndir.c","main",83,135
14,5,116,2,15,"equivalent@138-153@usr.bin/lndir/lndir.c","usr.bin/lndir/lndir.c","equivalent",138,153
12,3,71,1,13,"addexcept@156-169@usr.bin/lndir/lndir.c","usr.bin/lndir/lndir.c","addexcept",156,169
114,39,799,4,135,"dodir@183-318@usr.bin/lndir/lndir.c","usr.bin/lndir/lndir.c","dodir",183,318
6,1,20,1,5,"usage@321-326@usr.bin/lndir/lndir.c","usr.bin/lndir/lndir.c","usage",321,326
24,22,146,3,24,"put_assignment@41-65@usr.bin/locale/locale.c","usr.bin/locale/locale.c","put_assignment",41,65
17,4,131,1,18,"show_current_locale@68-86@usr.bin/locale/locale.c","usr.bin/locale/locale.c","show_current_locale",68,86
6,2,27,1,6,"show_locales@161-167@usr.bin/locale/locale.c","usr.bin/locale/locale.c","show_locales",161,167
5,1,20,1,4,"usage@170-174@usr.bin/locale/locale.c","usr.bin/locale/locale.c","usage",170,174
32,11,161,2,37,"main@177-214@usr.bin/locale/locale.c","usr.bin/locale/locale.c","main",177,214
29,11,223,1,45,"main@58-103@usr.bin/locate/bigram/locate.bigram.c","usr.bin/locate/bigram/locate.bigram.c","main",58,103
89,37,676,2,127,"main@115-242@usr.bin/locate/code/locate.code.c","usr.bin/locate/code/locate.code.c","main",115,242
10,5,77,1,10,"bgindex@246-256@usr.bin/locate/code/locate.code.c","usr.bin/locate/code/locate.code.c","bgindex",246,256
6,1,21,1,5,"usage@260-265@usr.bin/locate/code/locate.code.c","usr.bin/locate/code/locate.code.c","usage",260,265
52,7,413,2,59,"statistic@42-101@usr.bin/locate/locate/fastfind.c","usr.bin/locate/locate/fastfind.c","statistic",42,101
124,41,747,4,182,"fastfind_mmap@111-293@usr.bin/locate/locate/fastfind.c","usr.bin/locate/locate/fastfind.c","fastfind_mmap",111,293
55,21,304,2,67,"main@121-188@usr.bin/locate/locate/locate.c","usr.bin/locate/locate/locate.c","main",121,188
9,3,58,2,13,"search_statistic@192-205@usr.bin/locate/locate/locate.c","usr.bin/locate/locate/locate.c","search_statistic",192,205
29,11,229,2,39,"search_mmap@208-247@usr.bin/locate/locate/locate.c","usr.bin/locate/locate/locate.c","search_mmap",208,247
6,1,37,1,6,"cputime@251-257@usr.bin/locate/locate/locate.c","usr.bin/locate/locate/locate.c","cputime",251,257
8,1,43,1,7,"usage@261-268@usr.bin/locate/locate/locate.c","usr.bin/locate/locate/locate.c","usage",261,268
7,3,31,1,6,"sane_count@271-277@usr.bin/locate/locate/locate.c","usr.bin/locate/locate/locate.c","sane_count",271,277
11,4,61,1,12,"check_bigram_char@59-71@usr.bin/locate/locate/util.c","usr.bin/locate/locate/util.c","check_bigram_char",59,71
46,14,312,3,55,"colon@82-137@usr.bin/locate/locate/util.c","usr.bin/locate/locate/util.c","colon",82,137
5,1,19,1,4,"print_matches@140-144@usr.bin/locate/locate/util.c","usr.bin/locate/locate/util.c","print_matches",140,144
32,16,230,1,50,"patprep@154-204@usr.bin/locate/locate/util.c","usr.bin/locate/locate/util.c","patprep",154,204
8,2,42,1,9,"tolower_word@208-217@usr.bin/locate/locate/util.c","usr.bin/locate/locate/util.c","tolower_word",208,217
22,6,117,1,24,"getwm@229-253@usr.bin/locate/locate/util.c","usr.bin/locate/locate/util.c","getwm",229,253
16,5,81,1,17,"getwf@264-281@usr.bin/locate/locate/util.c","usr.bin/locate/locate/util.c","getwf",264,281
132,31,895,2,159,"main@70-229@usr.bin/lock/lock.c","usr.bin/lock/lock.c","main",70,229
13,2,78,1,13,"hi@232-245@usr.bin/lock/lock.c","usr.bin/lock/lock.c","hi",232,245
6,2,22,1,6,"bye@248-254@usr.bin/lock/lock.c","usr.bin/lock/lock.c","bye",248,254
63,19,384,2,69,"main@56-125@usr.bin/logger/logger.c","usr.bin/logger/logger.c","main",56,125
27,6,147,1,27,"pencode@131-158@usr.bin/logger/logger.c","usr.bin/logger/logger.c","pencode",131,158
14,5,98,2,16,"decode@161-177@usr.bin/logger/logger.c","usr.bin/logger/logger.c","decode",161,177
6,1,21,1,5,"usage@180-185@usr.bin/logger/logger.c","usr.bin/logger/logger.c","usage",180,185
25,6,250,4,30,"log_failedlogin@52-82@usr.bin/login/failedlogin.c","usr.bin/login/failedlogin.c","log_failedlogin",52,82
42,7,329,1,46,"check_failedlogin@91-137@usr.bin/login/failedlogin.c","usr.bin/login/failedlogin.c","check_failedlogin",91,137
472,148,3314,2,605,"main@139-744@usr.bin/login/login.c","usr.bin/login/login.c","main",139,744
26,7,130,1,26,"getloginname@753-779@usr.bin/login/login.c","usr.bin/login/login.c","getloginname",753,779
5,2,31,1,6,"rootterm@782-788@usr.bin/login/login.c","usr.bin/login/login.c","rootterm",782,788
19,4,158,1,24,"motd@791-815@usr.bin/login/login.c","usr.bin/login/login.c","motd",791,815
4,1,9,1,3,"sigint@819-822@usr.bin/login/login.c","usr.bin/login/login.c","sigint",819,822
10,2,51,1,10,"timedout@826-836@usr.bin/login/login.c","usr.bin/login/login.c","timedout",826,836
31,7,264,1,31,"dolastlog@839-870@usr.bin/login/login.c","usr.bin/login/login.c","dolastlog",839,870
24,11,151,1,24,"badlogin@873-897@usr.bin/login/login.c","usr.bin/login/login.c","badlogin",873,897
6,2,42,1,6,"stypeof@903-909@usr.bin/login/login.c","usr.bin/login/login.c","stypeof",903,909
6,1,25,1,5,"sleepexit@912-917@usr.bin/login/login.c","usr.bin/login/login.c","sleepexit",912,917
6,2,21,1,5,"quickexit@920-925@usr.bin/login/login.c","usr.bin/login/login.c","quickexit",920,925
6,2,21,1,5,"sighup@929-934@usr.bin/login/login.c","usr.bin/login/login.c","sighup",929,934
5,1,21,1,4,"usage@39-43@usr.bin/logname/logname.c","usr.bin/logname/logname.c","usage",39,43
18,5,111,2,22,"main@46-68@usr.bin/logname/logname.c","usr.bin/logname/logname.c","main",46,68
50,14,318,2,54,"main@74-128@usr.bin/look/look.c","usr.bin/look/look.c","main",74,128
17,7,131,3,20,"look@131-151@usr.bin/look/look.c","usr.bin/look/look.c","look",131,151
15,4,97,3,20,"binary_search@196-216@usr.bin/look/look.c","usr.bin/look/look.c","binary_search",196,216
17,5,74,3,16,"linear_search@230-246@usr.bin/look/look.c","usr.bin/look/look.c","linear_search",230,246
10,7,87,3,9,"print_from@252-261@usr.bin/look/look.c","usr.bin/look/look.c","print_from",252,261
16,10,112,3,16,"compare@277-293@usr.bin/look/look.c","usr.bin/look/look.c","compare",277,293
6,1,21,1,5,"usage@296-301@usr.bin/look/look.c","usr.bin/look/look.c","usage",296,301
15,5,97,4,15,"eval@99-114@usr.bin/m4/eval.c","usr.bin/m4/eval.c","eval",99,114
272,105,1525,3,406,"expand_builtin@120-526@usr.bin/m4/eval.c","usr.bin/m4/eval.c","expand_builtin",120,526
66,23,311,2,67,"expand_macro@532-599@usr.bin/m4/eval.c","usr.bin/m4/eval.c","expand_macro",532,599
7,3,38,2,6,"dodefine@606-612@usr.bin/m4/eval.c","usr.bin/m4/eval.c","dodefine",606,612
14,3,75,1,14,"dodefn@619-633@usr.bin/m4/eval.c","usr.bin/m4/eval.c","dodefn",619,633
7,3,38,2,6,"dopushdef@643-649@usr.bin/m4/eval.c","usr.bin/m4/eval.c","dopushdef",643,649
13,4,84,2,12,"dump_one_def@655-667@usr.bin/m4/eval.c","usr.bin/m4/eval.c","dump_one_def",655,667
11,4,75,2,11,"dodump@675-686@usr.bin/m4/eval.c","usr.bin/m4/eval.c","dodump",675,686
9,3,59,3,9,"dotrace@692-701@usr.bin/m4/eval.c","usr.bin/m4/eval.c","dotrace",692,701
15,4,79,2,14,"doifelse@707-721@usr.bin/m4/eval.c","usr.bin/m4/eval.c","doifelse",707,721
11,3,64,1,10,"doincl@727-737@usr.bin/m4/eval.c","usr.bin/m4/eval.c","doincl",727,737
15,4,89,1,15,"dopaste@745-760@usr.bin/m4/eval.c","usr.bin/m4/eval.c","dopaste",745,760
14,3,108,2,13,"dochq@767-780@usr.bin/m4/eval.c","usr.bin/m4/eval.c","dochq",767,780
14,3,94,2,16,"dochc@786-802@usr.bin/m4/eval.c","usr.bin/m4/eval.c","dochc",786,802
12,3,60,1,11,"dom4wrap@808-819@usr.bin/m4/eval.c","usr.bin/m4/eval.c","dom4wrap",808,819
21,8,119,1,23,"dodiv@825-848@usr.bin/m4/eval.c","usr.bin/m4/eval.c","dodiv",825,848
22,10,136,2,22,"doundiv@855-877@usr.bin/m4/eval.c","usr.bin/m4/eval.c","doundiv",855,877
15,7,140,2,21,"dosub@883-904@usr.bin/m4/eval.c","usr.bin/m4/eval.c","dosub",883,904
58,10,789,4,69,"map@918-987@usr.bin/m4/eval.c","usr.bin/m4/eval.c","map",918,987
35,10,208,3,35,"handledash@996-1031@usr.bin/m4/eval.c","usr.bin/m4/eval.c","handledash",996,1031
5,1,25,1,4,"yyerror@30-34@usr.bin/m4/expr.c","usr.bin/m4/expr.c","yyerror",30,34
7,1,25,1,6,"expr@37-43@usr.bin/m4/expr.c","usr.bin/m4/expr.c","expr",37,43
10,2,55,1,10,"new_path_entry@72-82@usr.bin/m4/gnum4.c","usr.bin/m4/gnum4.c","new_path_entry",72,82
11,2,44,1,12,"addtoincludepath@85-97@usr.bin/m4/gnum4.c","usr.bin/m4/gnum4.c","addtoincludepath",85,97
18,4,85,0,19,"ensure_m4path@100-119@usr.bin/m4/gnum4.c","usr.bin/m4/gnum4.c","ensure_m4path",100,119
14,3,95,2,14,"dopath@123-137@usr.bin/m4/gnum4.c","usr.bin/m4/gnum4.c","dopath",123,137
13,3,71,2,15,"fopen_trypath@140-155@usr.bin/m4/gnum4.c","usr.bin/m4/gnum4.c","fopen_trypath",140,155
10,3,90,2,11,"doindir@158-169@usr.bin/m4/gnum4.c","usr.bin/m4/gnum4.c","doindir",158,169
10,2,74,2,10,"dobuiltin@172-182@usr.bin/m4/gnum4.c","usr.bin/m4/gnum4.c","dobuiltin",172,182
17,5,91,2,16,"addchars@206-222@usr.bin/m4/gnum4.c","usr.bin/m4/gnum4.c","addchars",206,222
11,3,51,1,10,"addchar@225-235@usr.bin/m4/gnum4.c","usr.bin/m4/gnum4.c","addchar",225,235
6,1,18,1,5,"getstring@238-243@usr.bin/m4/gnum4.c","usr.bin/m4/gnum4.c","getstring",238,243
10,1,73,3,10,"exit_regerror@247-257@usr.bin/m4/gnum4.c","usr.bin/m4/gnum4.c","exit_regerror",247,257
11,3,50,2,12,"m4_warnx@263-275@usr.bin/m4/gnum4.c","usr.bin/m4/gnum4.c","m4_warnx",263,275
10,4,86,4,11,"add_sub@278-289@usr.bin/m4/gnum4.c","usr.bin/m4/gnum4.c","add_sub",278,289
30,9,182,4,30,"add_replace@295-325@usr.bin/m4/gnum4.c","usr.bin/m4/gnum4.c","add_replace",295,325
33,9,233,5,38,"do_subst@328-366@usr.bin/m4/gnum4.c","usr.bin/m4/gnum4.c","do_subst",328,366
15,3,92,5,15,"do_regexp@369-384@usr.bin/m4/gnum4.c","usr.bin/m4/gnum4.c","do_regexp",369,384
15,3,85,4,15,"do_regexpindex@387-402@usr.bin/m4/gnum4.c","usr.bin/m4/gnum4.c","do_regexpindex",387,402
43,15,180,1,45,"twiddle@408-453@usr.bin/m4/gnum4.c","usr.bin/m4/gnum4.c","twiddle",408,453
41,14,301,2,44,"dopatsubst@461-505@usr.bin/m4/gnum4.c","usr.bin/m4/gnum4.c","dopatsubst",461,505
28,10,211,2,30,"doregexp@508-538@usr.bin/m4/gnum4.c","usr.bin/m4/gnum4.c","doregexp",508,538
84,19,429,2,86,"doformat@541-627@usr.bin/m4/gnum4.c","usr.bin/m4/gnum4.c","doformat",541,627
39,10,267,1,47,"doesyscmd@630-677@usr.bin/m4/gnum4.c","usr.bin/m4/gnum4.c","doesyscmd",630,677
11,3,60,1,12,"getdivfile@680-692@usr.bin/m4/gnum4.c","usr.bin/m4/gnum4.c","getdivfile",680,692
5,1,31,3,4,"hash_calloc@68-72@usr.bin/m4/look.c","usr.bin/m4/look.c","hash_calloc",68,72
4,1,18,2,3,"hash_free@75-78@usr.bin/m4/look.c","usr.bin/m4/look.c","hash_free",75,78
4,1,20,2,3,"element_alloc@81-84@usr.bin/m4/look.c","usr.bin/m4/look.c","element_alloc",81,84
4,1,16,0,3,"init_macros@87-90@usr.bin/m4/look.c","usr.bin/m4/look.c","init_macros",87,90
4,1,24,1,3,"lookup@96-99@usr.bin/m4/look.c","usr.bin/m4/look.c","lookup",96,99
9,2,41,1,9,"lookup_macro_definition@102-111@usr.bin/m4/look.c","usr.bin/m4/look.c","lookup_macro_definition",102,111
17,4,131,3,17,"setup_definition@114-131@usr.bin/m4/look.c","usr.bin/m4/look.c","setup_definition",114,131
16,2,98,1,16,"create_entry@134-150@usr.bin/m4/look.c","usr.bin/m4/look.c","create_entry",134,150
12,3,88,2,11,"macro_define@153-164@usr.bin/m4/look.c","usr.bin/m4/look.c","macro_define",153,164
10,1,67,2,10,"macro_pushdef@167-177@usr.bin/m4/look.c","usr.bin/m4/look.c","macro_pushdef",167,177
14,4,83,1,14,"macro_undefine@180-194@usr.bin/m4/look.c","usr.bin/m4/look.c","macro_undefine",180,194
13,4,70,1,13,"macro_popdef@197-210@usr.bin/m4/look.c","usr.bin/m4/look.c","macro_popdef",197,210
9,3,73,1,9,"macro_for_all@213-222@usr.bin/m4/look.c","usr.bin/m4/look.c","macro_for_all",213,222
17,2,127,2,18,"setup_builtin@225-243@usr.bin/m4/look.c","usr.bin/m4/look.c","setup_builtin",225,243
17,4,90,2,17,"mark_traced@246-263@usr.bin/m4/look.c","usr.bin/m4/look.c","mark_traced",246,263
9,3,38,1,9,"macro_getbuiltin@266-275@usr.bin/m4/look.c","usr.bin/m4/look.c","macro_getbuiltin",266,275
13,3,56,1,12,"keep@288-300@usr.bin/m4/look.c","usr.bin/m4/look.c","keep",288,300
9,4,51,1,8,"string_in_use@303-311@usr.bin/m4/look.c","usr.bin/m4/look.c","string_in_use",303,311
17,5,87,1,20,"free_definition@315-335@usr.bin/m4/look.c","usr.bin/m4/look.c","free_definition",315,335
112,34,584,2,127,"main@167-294@usr.bin/m4/main.c","usr.bin/m4/main.c","main",167,294
15,5,98,2,16,"do_look_ahead@304-320@usr.bin/m4/main.c","usr.bin/m4/main.c","do_look_ahead",304,320
147,46,802,1,172,"macro@330-502@usr.bin/m4/main.c","usr.bin/m4/main.c","macro",330,502
8,3,33,1,7,"outputstr@508-515@usr.bin/m4/main.c","usr.bin/m4/main.c","outputstr",508,515
15,5,76,1,14,"reallyoutputstr@518-532@usr.bin/m4/main.c","usr.bin/m4/main.c","reallyoutputstr",518,532
9,4,52,1,8,"reallyputchar@535-543@usr.bin/m4/main.c","usr.bin/m4/main.c","reallyputchar",535,543
29,11,180,2,33,"inspect@550-583@usr.bin/m4/main.c","usr.bin/m4/main.c","inspect",550,583
11,3,70,1,11,"initkwds@593-604@usr.bin/m4/main.c","usr.bin/m4/main.c","initkwds",593,604
7,2,38,2,6,"record@607-613@usr.bin/m4/main.c","usr.bin/m4/main.c","record",607,613
12,3,68,2,12,"dump_stack@616-628@usr.bin/m4/main.c","usr.bin/m4/main.c","dump_stack",616,628
10,1,51,1,9,"enlarge_stack@632-641@usr.bin/m4/main.c","usr.bin/m4/main.c","enlarge_stack",632,641
9,2,47,2,9,"indx@69-78@usr.bin/m4/misc.c","usr.bin/m4/misc.c","indx",69,78
8,3,31,1,7,"pushback@83-90@usr.bin/m4/misc.c","usr.bin/m4/misc.c","pushback",83,90
9,3,47,1,9,"pbstr@98-107@usr.bin/m4/misc.c","usr.bin/m4/misc.c","pbstr",98,107
4,1,16,1,3,"pbnum@113-116@usr.bin/m4/misc.c","usr.bin/m4/misc.c","pbnum",113,116
22,8,132,3,26,"pbnumbase@119-145@usr.bin/m4/misc.c","usr.bin/m4/misc.c","pbnumbase",119,145
7,2,31,1,6,"pbunsigned@151-157@usr.bin/m4/misc.c","usr.bin/m4/misc.c","pbunsigned",151,157
13,2,72,0,13,"initspaces@160-173@usr.bin/m4/misc.c","usr.bin/m4/misc.c","initspaces",160,173
18,4,115,0,18,"enlarge_strspace@176-194@usr.bin/m4/misc.c","usr.bin/m4/misc.c","enlarge_strspace",176,194
13,2,89,0,13,"enlarge_bufspace@197-210@usr.bin/m4/misc.c","usr.bin/m4/misc.c","enlarge_bufspace",197,210
6,2,23,1,5,"chrsave@216-221@usr.bin/m4/misc.c","usr.bin/m4/misc.c","chrsave",216,221
11,3,75,1,11,"getdiv@227-238@usr.bin/m4/misc.c","usr.bin/m4/misc.c","getdiv",227,238
5,1,26,1,5,"onintr@241-246@usr.bin/m4/misc.c","usr.bin/m4/misc.c","onintr",241,246
8,3,43,0,8,"killdiv@252-260@usr.bin/m4/misc.c","usr.bin/m4/misc.c","killdiv",252,260
13,2,78,3,13,"m4errx@265-278@usr.bin/m4/misc.c","usr.bin/m4/misc.c","m4errx",265,278
9,2,53,1,9,"resizedivs@283-292@usr.bin/m4/misc.c","usr.bin/m4/misc.c","resizedivs",283,292
15,3,74,3,16,"xalloc@295-311@usr.bin/m4/misc.c","usr.bin/m4/misc.c","xalloc",295,311
15,3,79,4,16,"xcalloc@314-330@usr.bin/m4/misc.c","usr.bin/m4/misc.c","xcalloc",314,330
16,3,85,4,17,"xrealloc@333-350@usr.bin/m4/misc.c","usr.bin/m4/misc.c","xrealloc",333,350
16,3,90,5,17,"xreallocarray@353-370@usr.bin/m4/misc.c","usr.bin/m4/misc.c","xreallocarray",353,370
7,2,34,1,6,"xstrdup@373-379@usr.bin/m4/misc.c","usr.bin/m4/misc.c","xstrdup",373,379
7,1,20,1,6,"usage@382-388@usr.bin/m4/misc.c","usr.bin/m4/misc.c","usage",382,388
9,3,49,1,10,"obtain_char@391-401@usr.bin/m4/misc.c","usr.bin/m4/misc.c","obtain_char",391,401
8,1,49,3,7,"set_input@404-411@usr.bin/m4/misc.c","usr.bin/m4/misc.c","set_input",404,411
6,1,40,0,5,"do_emit_synchline@414-419@usr.bin/m4/misc.c","usr.bin/m4/misc.c","do_emit_synchline",414,419
8,3,50,1,11,"release_input@422-433@usr.bin/m4/misc.c","usr.bin/m4/misc.c","release_input",422,433
4,1,16,1,3,"doprintlineno@436-439@usr.bin/m4/misc.c","usr.bin/m4/misc.c","doprintlineno",436,439
6,1,26,1,5,"doprintfilename@442-447@usr.bin/m4/misc.c","usr.bin/m4/misc.c","doprintfilename",442,447
4,1,10,0,3,"buffer_mark@454-457@usr.bin/m4/misc.c","usr.bin/m4/misc.c","buffer_mark",454,457
6,2,38,2,6,"dump_buffer@461-467@usr.bin/m4/misc.c","usr.bin/m4/misc.c","dump_buffer",461,467
8,4,45,1,8,"trace_file@56-64@usr.bin/m4/trace.c","usr.bin/m4/trace.c","trace_file",56,64
29,12,84,1,28,"letter_to_flag@67-95@usr.bin/m4/trace.c","usr.bin/m4/trace.c","letter_to_flag",67,95
20,7,85,1,20,"set_trace_flags@98-118@usr.bin/m4/trace.c","usr.bin/m4/trace.c","set_trace_flags",98,118
9,2,43,0,9,"frame_level@121-130@usr.bin/m4/trace.c","usr.bin/m4/trace.c","frame_level",121,130
11,4,76,1,10,"print_header@133-143@usr.bin/m4/trace.c","usr.bin/m4/trace.c","print_header",133,143
38,11,248,3,38,"trace@146-184@usr.bin/m4/trace.c","usr.bin/m4/trace.c","trace",146,184
10,3,58,1,9,"finish_trace@187-196@usr.bin/m4/trace.c","usr.bin/m4/trace.c","finish_trace",187,196
8,2,52,1,8,"savestr@48-56@usr.bin/mail/aux.c","usr.bin/mail/aux.c","savestr",48,56
14,4,103,2,14,"save2str@62-76@usr.bin/mail/aux.c","usr.bin/mail/aux.c","save2str",62,76
6,2,35,1,6,"touch@84-90@usr.bin/mail/aux.c","usr.bin/mail/aux.c","touch",84,90
7,2,39,1,7,"isdir@97-104@usr.bin/mail/aux.c","usr.bin/mail/aux.c","isdir",97,104
7,2,35,1,7,"argcount@110-117@usr.bin/mail/aux.c","usr.bin/mail/aux.c","argcount",110,117
20,6,149,2,20,"hfield@124-144@usr.bin/mail/aux.c","usr.bin/mail/aux.c","hfield",124,144
43,20,292,4,48,"gethfield@153-201@usr.bin/mail/aux.c","usr.bin/mail/aux.c","gethfield",153,201
13,4,79,3,13,"ishfield@209-222@usr.bin/mail/aux.c","usr.bin/mail/aux.c","ishfield",209,222
19,8,116,3,23,"istrlcpy@229-252@usr.bin/mail/aux.c","usr.bin/mail/aux.c","istrlcpy",229,252
26,4,148,1,26,"source@272-298@usr.bin/mail/aux.c","usr.bin/mail/aux.c","source",272,298
18,4,92,1,18,"unstack@305-323@usr.bin/mail/aux.c","usr.bin/mail/aux.c","unstack",305,323
8,1,57,1,8,"alter@330-338@usr.bin/mail/aux.c","usr.bin/mail/aux.c","alter",330,338
8,4,46,1,8,"blankline@345-353@usr.bin/mail/aux.c","usr.bin/mail/aux.c","blankline",345,353
14,6,96,2,14,"nameof@361-375@usr.bin/mail/aux.c","usr.bin/mail/aux.c","nameof",361,375
19,7,71,1,19,"skip_comment@382-401@usr.bin/mail/aux.c","usr.bin/mail/aux.c","skip_comment",382,401
87,33,506,1,100,"skin@408-508@usr.bin/mail/aux.c","usr.bin/mail/aux.c","skin",408,508
52,21,429,2,52,"name1@518-570@usr.bin/mail/aux.c","usr.bin/mail/aux.c","name1",518,570
9,3,49,2,9,"charcount@576-585@usr.bin/mail/aux.c","usr.bin/mail/aux.c","charcount",576,585
6,2,34,2,6,"copy@591-597@usr.bin/mail/aux.c","usr.bin/mail/aux.c","copy",591,597
11,3,79,2,15,"isign@603-618@usr.bin/mail/aux.c","usr.bin/mail/aux.c","isign",603,618
9,4,71,2,9,"member@621-630@usr.bin/mail/aux.c","usr.bin/mail/aux.c","member",621,630
10,3,56,1,10,"clearnew@633-643@usr.bin/mail/aux.c","usr.bin/mail/aux.c","clearnew",633,643
52,16,354,1,52,"headers@51-103@usr.bin/mail/cmd1.c","usr.bin/mail/cmd1.c","headers",51,103
32,7,142,1,34,"scroll@109-143@usr.bin/mail/cmd1.c","usr.bin/mail/cmd1.c","scroll",109,143
8,2,49,1,8,"screensize@149-157@usr.bin/mail/cmd1.c","usr.bin/mail/cmd1.c","screensize",149,157
10,3,61,1,10,"from@164-174@usr.bin/mail/cmd1.c","usr.bin/mail/cmd1.c","from",164,174
52,16,426,1,58,"printhead@181-239@usr.bin/mail/cmd1.c","usr.bin/mail/cmd1.c","printhead",181,239
5,1,33,1,4,"pdot@245-249@usr.bin/mail/cmd1.c","usr.bin/mail/cmd1.c","pdot",245,249
19,4,120,1,19,"pcmdlist@255-274@usr.bin/mail/cmd1.c","usr.bin/mail/cmd1.c","pcmdlist",255,274
6,1,38,2,6,"pipeit@280-286@usr.bin/mail/cmd1.c","usr.bin/mail/cmd1.c","pipeit",280,286
5,1,28,1,4,"more@292-296@usr.bin/mail/cmd1.c","usr.bin/mail/cmd1.c","more",292,296
5,1,28,1,5,"More@302-307@usr.bin/mail/cmd1.c","usr.bin/mail/cmd1.c","More",302,307
5,1,28,1,5,"type@313-318@usr.bin/mail/cmd1.c","usr.bin/mail/cmd1.c","type",313,318
5,1,28,1,5,"Type@324-329@usr.bin/mail/cmd1.c","usr.bin/mail/cmd1.c","Type",324,329
49,20,368,4,58,"type1@335-393@usr.bin/mail/cmd1.c","usr.bin/mail/cmd1.c","type1",335,393
35,11,225,1,35,"top@401-436@usr.bin/mail/cmd1.c","usr.bin/mail/cmd1.c","top",401,436
11,2,62,1,11,"stouch@443-454@usr.bin/mail/cmd1.c","usr.bin/mail/cmd1.c","stouch",443,454
11,2,64,1,11,"mboxit@460-471@usr.bin/mail/cmd1.c","usr.bin/mail/cmd1.c","mboxit",460,471
12,4,114,1,14,"folders@477-491@usr.bin/mail/cmd1.c","usr.bin/mail/cmd1.c","folders",477,491
14,3,73,1,16,"inc@498-514@usr.bin/mail/cmd1.c","usr.bin/mail/cmd1.c","inc",498,514
4,1,11,1,4,"hdrint@520-524@usr.bin/mail/cmd1.c","usr.bin/mail/cmd1.c","hdrint",520,524
42,13,268,1,65,"next@50-115@usr.bin/mail/cmd2.c","usr.bin/mail/cmd2.c","next",50,115
5,1,28,1,5,"save@122-127@usr.bin/mail/cmd2.c","usr.bin/mail/cmd2.c","save",122,127
5,1,28,1,5,"copycmd@133-138@usr.bin/mail/cmd2.c","usr.bin/mail/cmd2.c","copycmd",133,138
49,14,351,4,49,"save1@145-194@usr.bin/mail/cmd2.c","usr.bin/mail/cmd2.c","save1",145,194
5,1,28,1,5,"swrite@201-206@usr.bin/mail/cmd2.c","usr.bin/mail/cmd2.c","swrite",201,206
20,7,125,2,28,"snarf@217-245@usr.bin/mail/cmd2.c","usr.bin/mail/cmd2.c","snarf",217,245
6,1,24,1,6,"deletecmd@251-257@usr.bin/mail/cmd2.c","usr.bin/mail/cmd2.c","deletecmd",251,257
18,3,108,1,18,"deltype@263-281@usr.bin/mail/cmd2.c","usr.bin/mail/cmd2.c","deltype",263,281
26,4,153,1,30,"delm@289-319@usr.bin/mail/cmd2.c","usr.bin/mail/cmd2.c","delm",289,319
13,3,74,1,13,"undeletecmd@325-338@usr.bin/mail/cmd2.c","usr.bin/mail/cmd2.c","undeletecmd",325,338
5,1,28,1,5,"retfield@345-350@usr.bin/mail/cmd2.c","usr.bin/mail/cmd2.c","retfield",345,350
5,1,26,1,5,"igfield@357-362@usr.bin/mail/cmd2.c","usr.bin/mail/cmd2.c","igfield",357,362
5,1,28,1,5,"saveretfield@365-370@usr.bin/mail/cmd2.c","usr.bin/mail/cmd2.c","saveretfield",365,370
5,1,26,1,5,"saveigfield@373-378@usr.bin/mail/cmd2.c","usr.bin/mail/cmd2.c","saveigfield",373,378
25,6,179,3,25,"ignore1@381-406@usr.bin/mail/cmd2.c","usr.bin/mail/cmd2.c","ignore1",381,406
20,5,166,2,20,"igshow@412-432@usr.bin/mail/cmd2.c","usr.bin/mail/cmd2.c","igshow",412,432
4,1,34,2,4,"igcomp@438-442@usr.bin/mail/cmd2.c","usr.bin/mail/cmd2.c","igcomp",438,442
18,2,143,1,18,"shell@48-66@usr.bin/mail/cmd3.c","usr.bin/mail/cmd3.c","shell",48,66
13,1,97,1,13,"dosh@73-86@usr.bin/mail/cmd3.c","usr.bin/mail/cmd3.c","dosh",73,86
43,9,248,2,43,"bangexp@93-136@usr.bin/mail/cmd3.c","usr.bin/mail/cmd3.c","bangexp",93,136
5,1,36,1,5,"help@142-147@usr.bin/mail/cmd3.c","usr.bin/mail/cmd3.c","help",142,147
18,5,92,1,18,"schdir@153-171@usr.bin/mail/cmd3.c","usr.bin/mail/cmd3.c","schdir",153,171
8,2,40,1,8,"respond@174-182@usr.bin/mail/cmd3.c","usr.bin/mail/cmd3.c","respond",174,182
54,15,428,1,58,"_respond@189-247@usr.bin/mail/cmd3.c","usr.bin/mail/cmd3.c","_respond",189,247
14,3,83,1,14,"reedit@254-268@usr.bin/mail/cmd3.c","usr.bin/mail/cmd3.c","reedit",254,268
11,2,70,1,11,"marknew@275-286@usr.bin/mail/cmd3.c","usr.bin/mail/cmd3.c","marknew",275,286
18,3,93,1,18,"preserve@293-311@usr.bin/mail/cmd3.c","usr.bin/mail/cmd3.c","preserve",293,311
11,2,66,1,11,"unread@317-328@usr.bin/mail/cmd3.c","usr.bin/mail/cmd3.c","unread",317,328
12,2,76,1,12,"messize@334-346@usr.bin/mail/cmd3.c","usr.bin/mail/cmd3.c","messize",334,346
6,2,22,1,7,"rexit@353-360@usr.bin/mail/cmd3.c","usr.bin/mail/cmd3.c","rexit",353,360
41,12,299,1,41,"set@367-408@usr.bin/mail/cmd3.c","usr.bin/mail/cmd3.c","set",367,408
32,6,199,1,32,"unset@414-446@usr.bin/mail/cmd3.c","usr.bin/mail/cmd3.c","unset",414,446
44,12,362,1,51,"group@452-503@usr.bin/mail/cmd3.c","usr.bin/mail/cmd3.c","group",452,503
9,3,54,1,9,"sort@510-519@usr.bin/mail/cmd3.c","usr.bin/mail/cmd3.c","sort",510,519
4,1,34,2,4,"diction@526-530@usr.bin/mail/cmd3.c","usr.bin/mail/cmd3.c","diction",526,530
4,1,13,1,4,"null@537-541@usr.bin/mail/cmd3.c","usr.bin/mail/cmd3.c","null",537,541
13,3,63,1,13,"file@548-561@usr.bin/mail/cmd3.c","usr.bin/mail/cmd3.c","file",548,561
15,4,85,1,15,"echo@567-582@usr.bin/mail/cmd3.c","usr.bin/mail/cmd3.c","echo",567,582
8,2,40,1,8,"Respond@585-593@usr.bin/mail/cmd3.c","usr.bin/mail/cmd3.c","Respond",585,593
28,5,217,1,28,"_Respond@601-629@usr.bin/mail/cmd3.c","usr.bin/mail/cmd3.c","_Respond",601,629
23,6,97,1,25,"ifcmd@636-661@usr.bin/mail/cmd3.c","usr.bin/mail/cmd3.c","ifcmd",636,661
19,4,63,1,22,"elsecmd@668-690@usr.bin/mail/cmd3.c","usr.bin/mail/cmd3.c","elsecmd",668,690
9,2,35,1,9,"endifcmd@696-705@usr.bin/mail/cmd3.c","usr.bin/mail/cmd3.c","endifcmd",696,705
25,8,175,1,25,"alternates@711-736@usr.bin/mail/cmd3.c","usr.bin/mail/cmd3.c","alternates",711,736
241,84,1413,2,325,"collect@57-382@usr.bin/mail/collect.c","usr.bin/mail/collect.c","collect",57,382
38,9,235,3,38,"exwrite@388-426@usr.bin/mail/collect.c","usr.bin/mail/collect.c","exwrite",388,426
15,2,108,2,15,"mesedit@433-448@usr.bin/mail/collect.c","usr.bin/mail/collect.c","mesedit",433,448
34,5,243,2,41,"mespipe@457-498@usr.bin/mail/collect.c","usr.bin/mail/collect.c","mespipe",457,498
36,10,254,4,37,"forward@509-546@usr.bin/mail/collect.c","usr.bin/mail/collect.c","forward",509,546
21,5,97,1,23,"collabort@553-576@usr.bin/mail/collect.c","usr.bin/mail/collect.c","collabort",553,576
18,4,104,1,18,"savedeadletter@579-597@usr.bin/mail/collect.c","usr.bin/mail/collect.c","savedeadletter",579,597
9,3,46,2,9,"gethfromtty@600-609@usr.bin/mail/collect.c","usr.bin/mail/collect.c","gethfromtty",600,609
5,1,24,1,5,"editor@53-58@usr.bin/mail/edit.c","usr.bin/mail/edit.c","editor",53,58
5,1,24,1,5,"visual@64-69@usr.bin/mail/edit.c","usr.bin/mail/edit.c","visual",64,69
58,15,400,2,62,"edit1@77-139@usr.bin/mail/edit.c","usr.bin/mail/edit.c","edit1",77,139
78,21,496,4,85,"run_editor@148-233@usr.bin/mail/edit.c","usr.bin/mail/edit.c","run_editor",148,233
42,12,311,2,44,"editit@242-286@usr.bin/mail/edit.c","usr.bin/mail/edit.c","editit",242,286
7,3,45,3,7,"myread@55-62@usr.bin/mail/fio.c","usr.bin/mail/fio.c","myread",55,62
83,28,615,2,98,"setptr@68-166@usr.bin/mail/fio.c","usr.bin/mail/fio.c","setptr",68,166
13,3,80,3,13,"putline@174-187@usr.bin/mail/fio.c","usr.bin/mail/fio.c","putline",174,187
50,13,392,4,58,"readline@195-253@usr.bin/mail/fio.c","usr.bin/mail/fio.c","readline",195,253
8,2,51,1,8,"setinput@260-268@usr.bin/mail/fio.c","usr.bin/mail/fio.c","setinput",260,268
22,5,182,2,22,"makemessage@275-297@usr.bin/mail/fio.c","usr.bin/mail/fio.c","makemessage",275,297
4,1,37,2,4,"append@304-308@usr.bin/mail/fio.c","usr.bin/mail/fio.c","append",304,308
17,5,95,1,17,"rm@314-331@usr.bin/mail/fio.c","usr.bin/mail/fio.c","rm",314,331
10,2,56,1,10,"holdsigs@339-349@usr.bin/mail/fio.c","usr.bin/mail/fio.c","holdsigs",339,349
5,2,23,1,5,"relsesigs@355-360@usr.bin/mail/fio.c","usr.bin/mail/fio.c","relsesigs",355,360
17,3,117,3,19,"ignoresig@366-385@usr.bin/mail/fio.c","usr.bin/mail/fio.c","ignoresig",366,385
7,2,39,1,7,"fsize@392-399@usr.bin/mail/fio.c","usr.bin/mail/fio.c","fsize",392,399
53,19,378,1,63,"expand@413-476@usr.bin/mail/fio.c","usr.bin/mail/fio.c","expand",413,476
12,4,76,2,12,"getfold@482-494@usr.bin/mail/fio.c","usr.bin/mail/fio.c","getfold",482,494
12,4,86,1,13,"getdeadletter@500-513@usr.bin/mail/fio.c","usr.bin/mail/fio.c","getdeadletter",500,513
4,1,11,1,4,"fioint@520-524@usr.bin/mail/fio.c","usr.bin/mail/fio.c","fioint",520,524
7,2,37,1,7,"getname@43-50@usr.bin/mail/getname.c","usr.bin/mail/getname.c","getname",43,50
7,2,38,1,7,"getuserid@57-64@usr.bin/mail/getname.c","usr.bin/mail/getname.c","getuserid",57,64
20,9,130,1,23,"ishead@48-71@usr.bin/mail/head.c","usr.bin/mail/head.c","ishead",48,71
3,1,12,2,8,"fail@75-83@usr.bin/mail/head.c","usr.bin/mail/head.c","fail",75,83
20,5,149,3,23,"parse@92-115@usr.bin/mail/head.c","usr.bin/mail/head.c","parse",92,115
9,2,51,2,9,"copyin@124-133@usr.bin/mail/head.c","usr.bin/mail/head.c","copyin",124,133
9,3,46,1,9,"isdate@176-185@usr.bin/mail/head.c","usr.bin/mail/head.c","isdate",176,185
47,25,258,2,47,"cmatch@192-239@usr.bin/mail/head.c","usr.bin/mail/head.c","cmatch",192,239
25,12,156,2,25,"nextword@247-272@usr.bin/mail/head.c","usr.bin/mail/head.c","nextword",247,272
73,18,484,1,95,"setfile@55-150@usr.bin/mail/lex.c","usr.bin/mail/lex.c","setfile",55,150
29,6,159,1,30,"incfile@157-187@usr.bin/mail/lex.c","usr.bin/mail/lex.c","incfile",157,187
64,23,318,1,75,"commands@198-273@usr.bin/mail/lex.c","usr.bin/mail/lex.c","commands",198,273
159,58,960,2,234,"execute@283-517@usr.bin/mail/lex.c","usr.bin/mail/lex.c","execute",283,517
10,2,63,1,10,"setmsize@524-534@usr.bin/mail/lex.c","usr.bin/mail/lex.c","setmsize",524,534
11,4,75,1,11,"lex@542-553@usr.bin/mail/lex.c","usr.bin/mail/lex.c","lex",542,553
10,3,58,2,10,"isprefix@560-570@usr.bin/mail/lex.c","usr.bin/mail/lex.c","isprefix",560,570
15,4,62,1,17,"dointr@582-599@usr.bin/mail/lex.c","usr.bin/mail/lex.c","dointr",582,599
13,3,72,1,13,"announce@606-619@usr.bin/mail/lex.c","usr.bin/mail/lex.c","announce",606,619
54,20,406,1,54,"newfileinfo@626-680@usr.bin/mail/lex.c","usr.bin/mail/lex.c","newfileinfo",626,680
6,1,27,1,6,"pversion@687-693@usr.bin/mail/lex.c","usr.bin/mail/lex.c","pversion",687,693
15,2,72,1,15,"load@699-714@usr.bin/mail/lex.c","usr.bin/mail/lex.c","load",699,714
17,5,118,3,17,"getmsglist@52-69@usr.bin/mail/list.c","usr.bin/mail/list.c","getmsglist",52,69
192,62,1137,2,220,"markall@107-327@usr.bin/mail/list.c","usr.bin/mail/list.c","markall",107,327
10,4,60,1,10,"evalcol@334-344@usr.bin/mail/list.c","usr.bin/mail/list.c","evalcol",334,344
14,5,86,2,14,"check@352-366@usr.bin/mail/list.c","usr.bin/mail/list.c","check",352,366
98,42,558,3,101,"getrawlist@373-474@usr.bin/mail/list.c","usr.bin/mail/list.c","getrawlist",373,474
63,20,384,1,91,"scan@498-589@usr.bin/mail/list.c","usr.bin/mail/list.c","scan",498,589
9,2,54,1,9,"regret@595-604@usr.bin/mail/list.c","usr.bin/mail/list.c","regret",595,604
4,1,11,1,4,"scaninit@610-614@usr.bin/mail/list.c","usr.bin/mail/list.c","scaninit",610,614
15,6,117,2,15,"first@621-636@usr.bin/mail/list.c","usr.bin/mail/list.c","first",621,636
8,2,53,2,8,"matchsender@643-651@usr.bin/mail/list.c","usr.bin/mail/list.c","matchsender",643,651
15,5,97,2,18,"matchto@660-678@usr.bin/mail/list.c","usr.bin/mail/list.c","matchto",660,678
25,6,174,2,31,"matchsubj@690-721@usr.bin/mail/list.c","usr.bin/mail/list.c","matchsubj",690,721
8,3,42,1,8,"mark@727-735@usr.bin/mail/list.c","usr.bin/mail/list.c","mark",727,735
8,3,42,1,8,"unmark@741-749@usr.bin/mail/list.c","usr.bin/mail/list.c","unmark",741,749
30,9,214,2,42,"metamess@755-797@usr.bin/mail/list.c","usr.bin/mail/list.c","metamess",755,797
121,33,669,2,199,"main@48-247@usr.bin/mail/main.c","usr.bin/mail/main.c","main",48,247
24,8,143,1,24,"setscreensize@258-282@usr.bin/mail/main.c","usr.bin/mail/main.c","setscreensize",258,282
8,1,39,1,8,"usage@285-293@usr.bin/mail/main.c","usr.bin/mail/main.c","usage",285,293
10,1,64,2,10,"nalloc@49-59@usr.bin/mail/names.c","usr.bin/mail/names.c","nalloc",49,59
10,3,48,1,10,"tailof@65-75@usr.bin/mail/names.c","usr.bin/mail/names.c","tailof",65,75
24,6,149,2,24,"extract@83-107@usr.bin/mail/names.c","usr.bin/mail/names.c","extract",83,107
37,16,238,2,37,"detract@113-150@usr.bin/mail/names.c","usr.bin/mail/names.c","detract",113,150
35,15,189,2,36,"yankword@157-193@usr.bin/mail/names.c","usr.bin/mail/names.c","yankword",157,193
107,20,670,3,133,"outof@204-337@usr.bin/mail/names.c","usr.bin/mail/names.c","outof",204,337
13,7,77,1,13,"isfileaddr@345-358@usr.bin/mail/names.c","usr.bin/mail/names.c","isfileaddr",345,358
25,4,144,1,25,"usermap@367-392@usr.bin/mail/names.c","usr.bin/mail/names.c","usermap",367,392
34,10,215,4,38,"gexpand@400-438@usr.bin/mail/names.c","usr.bin/mail/names.c","gexpand",400,438
12,3,65,2,12,"cat@444-456@usr.bin/mail/names.c","usr.bin/mail/names.c","cat",444,456
60,14,340,1,86,"elide@464-550@usr.bin/mail/names.c","usr.bin/mail/names.c","elide",464,550
8,2,43,2,7,"put@557-564@usr.bin/mail/names.c","usr.bin/mail/names.c","put",557,564
8,3,48,1,8,"count@571-579@usr.bin/mail/names.c","usr.bin/mail/names.c","count",571,579
24,10,175,2,24,"delname@585-609@usr.bin/mail/names.c","usr.bin/mail/names.c","delname",585,609
10,2,54,1,10,"prettyprint@617-627@usr.bin/mail/names.c","usr.bin/mail/names.c","prettyprint",617,627
9,2,62,2,9,"Fopen@66-75@usr.bin/mail/popen.c","usr.bin/mail/popen.c","Fopen",66,75
9,2,61,2,9,"Fdopen@78-87@usr.bin/mail/popen.c","usr.bin/mail/popen.c","Fdopen",78,87
5,1,21,1,5,"Fclose@90-95@usr.bin/mail/popen.c","usr.bin/mail/popen.c","Fclose",90,95
31,5,233,2,31,"Popen@98-129@usr.bin/mail/popen.c","usr.bin/mail/popen.c","Popen",98,129
15,1,91,1,15,"Pclose@132-147@usr.bin/mail/popen.c","usr.bin/mail/popen.c","Pclose",132,147
8,3,37,1,8,"close_all_files@150-158@usr.bin/mail/popen.c","usr.bin/mail/popen.c","close_all_files",150,158
11,2,71,3,11,"register_file@161-172@usr.bin/mail/popen.c","usr.bin/mail/popen.c","register_file",161,172
11,3,73,1,11,"unregister_file@175-186@usr.bin/mail/popen.c","usr.bin/mail/popen.c","unregister_file",175,186
8,3,49,1,9,"file_pid@189-198@usr.bin/mail/popen.c","usr.bin/mail/popen.c","file_pid",189,198
20,4,150,5,21,"start_commandv@209-230@usr.bin/mail/popen.c","usr.bin/mail/popen.c","start_commandv",209,230
11,2,73,5,11,"run_command@233-244@usr.bin/mail/popen.c","usr.bin/mail/popen.c","run_command",233,244
9,1,58,5,9,"start_command@247-256@usr.bin/mail/popen.c","usr.bin/mail/popen.c","start_command",247,256
24,11,166,3,29,"prepare_child@259-288@usr.bin/mail/popen.c","usr.bin/mail/popen.c","prepare_child",259,288
8,2,34,1,8,"wait_command@291-299@usr.bin/mail/popen.c","usr.bin/mail/popen.c","wait_command",291,299
23,7,154,2,23,"findchild@302-325@usr.bin/mail/popen.c","usr.bin/mail/popen.c","findchild",302,325
9,2,54,1,9,"delchild@328-337@usr.bin/mail/popen.c","usr.bin/mail/popen.c","delchild",328,337
19,4,93,1,19,"sigchild@341-360@usr.bin/mail/popen.c","usr.bin/mail/popen.c","sigchild",341,360
21,7,138,1,26,"wait_child@368-394@usr.bin/mail/popen.c","usr.bin/mail/popen.c","wait_child",368,394
15,3,87,1,15,"free_child@400-415@usr.bin/mail/popen.c","usr.bin/mail/popen.c","free_child",400,415
35,7,183,1,41,"handle_spool_locks@422-463@usr.bin/mail/popen.c","usr.bin/mail/popen.c","handle_spool_locks",422,463
4,1,14,1,4,"spool_lock@466-470@usr.bin/mail/popen.c","usr.bin/mail/popen.c","spool_lock",466,470
4,1,14,1,4,"spool_unlock@473-477@usr.bin/mail/popen.c","usr.bin/mail/popen.c","spool_unlock",473,477
6,2,23,1,9,"quitcmd@47-56@usr.bin/mail/quit.c","usr.bin/mail/quit.c","quitcmd",47,56
212,55,1451,1,263,"quit@64-327@usr.bin/mail/quit.c","usr.bin/mail/quit.c","quit",64,327
42,14,293,1,46,"writeback@336-382@usr.bin/mail/quit.c","usr.bin/mail/quit.c","writeback",336,382
95,23,633,1,97,"edstop@389-486@usr.bin/mail/quit.c","usr.bin/mail/quit.c","edstop",389,486
142,50,971,4,200,"sendmessage@52-252@usr.bin/mail/send.c","usr.bin/mail/send.c","sendmessage",52,252
16,6,110,3,16,"statusput@258-274@usr.bin/mail/send.c","usr.bin/mail/send.c","statusput",258,274
13,1,85,6,13,"mail@281-294@usr.bin/mail/send.c","usr.bin/mail/send.c","mail",281,294
13,1,72,1,13,"sendmail@301-314@usr.bin/mail/send.c","usr.bin/mail/send.c","sendmail",301,314
92,22,590,2,113,"mail1@321-434@usr.bin/mail/send.c","usr.bin/mail/send.c","mail1",321,434
17,5,157,2,17,"fixhead@441-458@usr.bin/mail/send.c","usr.bin/mail/send.c","fixhead",441,458
43,7,296,2,43,"infix@465-508@usr.bin/mail/send.c","usr.bin/mail/send.c","infix",465,508
20,13,199,3,20,"puthead@515-535@usr.bin/mail/send.c","usr.bin/mail/send.c","puthead",515,535
24,8,158,4,24,"fmt@541-565@usr.bin/mail/send.c","usr.bin/mail/send.c","fmt",541,565
28,5,209,2,34,"savemail@572-606@usr.bin/mail/send.c","usr.bin/mail/send.c","savemail",572,606
4,1,11,1,4,"sendint@610-614@usr.bin/mail/send.c","usr.bin/mail/send.c","sendint",610,614
32,8,213,1,32,"salloc@52-84@usr.bin/mail/strings.c","usr.bin/mail/strings.c","salloc",52,84
15,4,77,1,15,"sreset@92-107@usr.bin/mail/strings.c","usr.bin/mail/strings.c","sreset",92,107
6,2,38,1,6,"spreserve@114-120@usr.bin/mail/strings.c","usr.bin/mail/strings.c","spreserve",114,120
31,13,184,1,38,"tinit@45-83@usr.bin/mail/temp.c","usr.bin/mail/temp.c","tinit",45,83
80,21,571,2,88,"grabh@74-162@usr.bin/mail/tty.c","usr.bin/mail/tty.c","grabh",74,162
76,16,530,2,82,"readtty@171-253@usr.bin/mail/tty.c","usr.bin/mail/tty.c","readtty",171,253
19,1,137,1,23,"ttystop@259-282@usr.bin/mail/tty.c","usr.bin/mail/tty.c","ttystop",259,282
4,1,11,1,4,"ttyint@286-290@usr.bin/mail/tty.c","usr.bin/mail/tty.c","ttyint",286,290
26,10,211,1,27,"tty_flush@293-320@usr.bin/mail/tty.c","usr.bin/mail/tty.c","tty_flush",293,320
14,3,59,1,15,"tty_getc@323-338@usr.bin/mail/tty.c","usr.bin/mail/tty.c","tty_getc",323,338
32,17,267,3,33,"tty_insert@341-374@usr.bin/mail/tty.c","usr.bin/mail/tty.c","tty_insert",341,374
5,1,30,2,5,"tty_putc@377-382@usr.bin/mail/tty.c","usr.bin/mail/tty.c","tty_putc",377,382
5,1,32,1,4,"tty_reset@385-389@usr.bin/mail/tty.c","usr.bin/mail/tty.c","tty_reset",385,389
16,5,95,2,16,"tty_visc@392-408@usr.bin/mail/tty.c","usr.bin/mail/tty.c","tty_visc",392,408
12,6,97,3,14,"findmail@51-65@usr.bin/mail/v7.local.c","usr.bin/mail/v7.local.c","findmail",51,65
9,4,54,1,9,"demail@71-80@usr.bin/mail/v7.local.c","usr.bin/mail/v7.local.c","demail",71,80
15,5,103,1,15,"username@86-101@usr.bin/mail/v7.local.c","usr.bin/mail/v7.local.c","username",86,101
17,3,110,2,17,"assign@46-63@usr.bin/mail/vars.c","usr.bin/mail/vars.c","assign",46,63
5,2,21,1,5,"vfree@71-76@usr.bin/mail/vars.c","usr.bin/mail/vars.c","vfree",71,76
9,3,49,1,9,"vcopy@83-92@usr.bin/mail/vars.c","usr.bin/mail/vars.c","vcopy",83,92
17,6,111,1,18,"value@100-118@usr.bin/mail/vars.c","usr.bin/mail/vars.c","value",100,118
8,4,64,1,8,"lookup@125-133@usr.bin/mail/vars.c","usr.bin/mail/vars.c","lookup",125,133
8,4,64,1,8,"findgroup@139-147@usr.bin/mail/vars.c","usr.bin/mail/vars.c","findgroup",139,147
13,3,83,1,13,"printgroup@153-166@usr.bin/mail/vars.c","usr.bin/mail/vars.c","printgroup",153,166
11,3,57,1,11,"hash@173-184@usr.bin/mail/vars.c","usr.bin/mail/vars.c","hash",173,184
4,1,35,3,3,"Lst_FindConst@161-164@usr.bin/make/lst.lib/lst.h","usr.bin/make/lst.lib/lst.h","Lst_FindConst",161,164
4,1,32,3,3,"Lst_FindFromConst@167-170@usr.bin/make/lst.lib/lst.h","usr.bin/make/lst.lib/lst.h","Lst_FindFromConst",167,170
9,2,38,2,8,"Lst_AddNew@39-47@usr.bin/make/lst.lib/lstAddNew.c","usr.bin/make/lst.lib/lstAddNew.c","Lst_AddNew",39,47
13,3,80,3,16,"Lst_Append@60-76@usr.bin/make/lst.lib/lstAppend.c","usr.bin/make/lst.lib/lstAppend.c","Lst_Append",60,76
13,2,70,2,14,"Lst_AtEnd@79-93@usr.bin/make/lst.lib/lstAppend.c","usr.bin/make/lst.lib/lstAppend.c","Lst_AtEnd",79,93
21,4,111,2,33,"Lst_Concat@60-93@usr.bin/make/lst.lib/lstConcat.c","usr.bin/make/lst.lib/lstConcat.c","Lst_Concat",60,93
11,3,65,2,18,"Lst_ConcatDestroy@57-75@usr.bin/make/lst.lib/lstConcatDestroy.c","usr.bin/make/lst.lib/lstConcatDestroy.c","Lst_ConcatDestroy",57,75
16,3,72,1,17,"Lst_DeQueue@57-74@usr.bin/make/lst.lib/lstDeQueue.c","usr.bin/make/lst.lib/lstDeQueue.c","Lst_DeQueue",57,74
17,4,93,2,17,"Lst_Destroy@57-74@usr.bin/make/lst.lib/lstDestroy.c","usr.bin/make/lst.lib/lstDestroy.c","Lst_Destroy",57,74
12,3,75,3,13,"Lst_Clone@59-72@usr.bin/make/lst.lib/lstDupl.c","usr.bin/make/lst.lib/lstDupl.c","Lst_Clone",59,72
8,3,54,3,9,"Lst_FindFrom@56-65@usr.bin/make/lst.lib/lstFindFrom.c","usr.bin/make/lst.lib/lstFindFrom.c","Lst_FindFrom",56,65
6,2,45,3,6,"Lst_ForEachFrom@57-63@usr.bin/make/lst.lib/lstForEachFrom.c","usr.bin/make/lst.lib/lstForEachFrom.c","Lst_ForEachFrom",57,63
6,2,41,2,6,"Lst_Every@66-72@usr.bin/make/lst.lib/lstForEachFrom.c","usr.bin/make/lst.lib/lstForEachFrom.c","Lst_Every",66,72
5,1,19,1,4,"Lst_Init@51-55@usr.bin/make/lst.lib/lstInit.c","usr.bin/make/lst.lib/lstInit.c","Lst_Init",51,55
22,8,138,3,29,"Lst_Insert@59-88@usr.bin/make/lst.lib/lstInsert.c","usr.bin/make/lst.lib/lstInsert.c","Lst_Insert",59,88
13,2,70,2,14,"Lst_AtFront@91-105@usr.bin/make/lst.lib/lstInsert.c","usr.bin/make/lst.lib/lstInsert.c","Lst_AtFront",91,105
8,3,46,2,8,"Lst_Member@45-53@usr.bin/make/lst.lib/lstMember.c","usr.bin/make/lst.lib/lstMember.c","Lst_Member",45,53
14,6,91,2,21,"Lst_Remove@58-79@usr.bin/make/lst.lib/lstRemove.c","usr.bin/make/lst.lib/lstRemove.c","Lst_Remove",58,79
5,2,23,2,4,"Lst_Replace@51-55@usr.bin/make/lst.lib/lstReplace.c","usr.bin/make/lst.lib/lstReplace.c","Lst_Replace",51,55
15,5,100,2,20,"Lst_Requeue@33-53@usr.bin/make/lst.lib/lstRequeue.c","usr.bin/make/lst.lib/lstRequeue.c","Lst_Requeue",33,53
7,2,22,1,6,"Lst_Succ@55-61@usr.bin/make/lst.lib/lstSucc.c","usr.bin/make/lst.lib/lstSucc.c","Lst_Succ",55,61
10,1,74,2,12,"new_arch_member@171-183@usr.bin/make/arch.c","usr.bin/make/arch.c","new_arch_member",171,183
7,2,44,1,6,"mtime_of_member@186-192@usr.bin/make/arch.c","usr.bin/make/arch.c","mtime_of_member",186,192
9,1,53,3,9,"Arch_ParseArchive@195-204@usr.bin/make/arch.c","usr.bin/make/arch.c","Arch_ParseArchive",195,204
7,1,38,2,7,"add_archive_node@207-214@usr.bin/make/arch.c","usr.bin/make/arch.c","add_archive_node",207,214
97,26,595,4,144,"parse_archive@217-361@usr.bin/make/arch.c","usr.bin/make/arch.c","parse_archive",217,361
8,1,55,2,8,"field2long@365-373@usr.bin/make/arch.c","usr.bin/make/arch.c","field2long",365,373
85,25,560,2,125,"read_archive@376-501@usr.bin/make/arch.c","usr.bin/make/arch.c","read_archive",376,501
52,10,301,3,71,"ArchMTimeMember@519-590@usr.bin/make/arch.c","usr.bin/make/arch.c","ArchMTimeMember",519,590
55,20,356,4,69,"ArchSVR4Entry@612-681@usr.bin/make/arch.c","usr.bin/make/arch.c","ArchSVR4Entry",612,681
82,31,535,4,132,"ArchFindMember@701-833@usr.bin/make/arch.c","usr.bin/make/arch.c","ArchFindMember",701,833
13,3,110,2,13,"ArchTouch@836-849@usr.bin/make/arch.c","usr.bin/make/arch.c","ArchTouch",836,849
4,1,25,1,3,"Arch_Touch@858-861@usr.bin/make/arch.c","usr.bin/make/arch.c","Arch_Touch",858,861
6,1,36,1,6,"Arch_MTime@864-870@usr.bin/make/arch.c","usr.bin/make/arch.c","Arch_MTime",864,870
25,9,169,1,36,"Arch_MemMTime@873-909@usr.bin/make/arch.c","usr.bin/make/arch.c","Arch_MemMTime",873,909
4,1,17,1,3,"Arch_Init@912-915@usr.bin/make/arch.c","usr.bin/make/arch.c","Arch_Init",912,915
5,1,17,0,4,"fatal_overflow@93-97@usr.bin/make/buf.c","usr.bin/make/buf.c","fatal_overflow",93,97
4,1,14,1,3,"BufOverflow@128-131@usr.bin/make/buf.c","usr.bin/make/buf.c","BufOverflow",128,131
7,2,58,3,8,"Buf_AddChars@135-143@usr.bin/make/buf.c","usr.bin/make/buf.c","Buf_AddChars",135,143
16,2,117,3,15,"Buf_printf@146-161@usr.bin/make/buf.c","usr.bin/make/buf.c","Buf_printf",146,161
12,5,64,2,13,"Buf_Init@164-177@usr.bin/make/buf.c","usr.bin/make/buf.c","Buf_Init",164,177
64,17,403,2,98,"Cmd_Exec@40-138@usr.bin/make/cmd_exec.c","usr.bin/make/cmd_exec.c","Cmd_Exec",40,138
128,41,711,2,196,"CompatMake@71-267@usr.bin/make/compat.c","usr.bin/make/compat.c","CompatMake",71,267
18,5,93,1,31,"Compat_Run@270-301@usr.bin/make/compat.c","usr.bin/make/compat.c","Compat_Run",270,301
7,3,33,1,7,"find_cond@171-178@usr.bin/make/cond.c","usr.bin/make/cond.c","find_cond",171,178
35,9,167,4,45,"CondGetArg@195-240@usr.bin/make/cond.c","usr.bin/make/cond.c","CondGetArg",195,240
4,1,21,1,3,"CondDoDefined@252-255@usr.bin/make/cond.c","usr.bin/make/cond.c","CondDoDefined",252,255
10,3,71,1,11,"CondDoMake@267-278@usr.bin/make/cond.c","usr.bin/make/cond.c","CondDoMake",267,278
15,3,75,1,16,"CondDoExists@290-306@usr.bin/make/cond.c","usr.bin/make/cond.c","CondDoExists",290,306
9,3,49,1,9,"CondDoTarget@318-327@usr.bin/make/cond.c","usr.bin/make/cond.c","CondDoTarget",318,327
9,4,57,1,9,"CondDoTargetWithCommands@339-348@usr.bin/make/cond.c","usr.bin/make/cond.c","CondDoTargetWithCommands",339,348
23,7,146,2,23,"CondCvtArg@368-391@usr.bin/make/cond.c","usr.bin/make/cond.c","CondCvtArg",368,391
11,3,65,1,11,"CondHandleNumber@395-406@usr.bin/make/cond.c","usr.bin/make/cond.c","CondHandleNumber",395,406
24,7,156,1,35,"CondHandleVarSpec@409-444@usr.bin/make/cond.c","usr.bin/make/cond.c","CondHandleVarSpec",409,444
17,4,98,1,19,"CondHandleString@447-466@usr.bin/make/cond.c","usr.bin/make/cond.c","CondHandleString",447,466
143,58,769,3,167,"CondHandleComparison@469-636@usr.bin/make/cond.c","usr.bin/make/cond.c","CondHandleComparison",469,636
56,17,342,1,76,"CondHandleDefault@653-729@usr.bin/make/cond.c","usr.bin/make/cond.c","CondHandleDefault",653,729
44,24,187,1,46,"CondToken@744-790@usr.bin/make/cond.c","usr.bin/make/cond.c","CondToken",744,790
20,8,102,1,24,"CondT@809-833@usr.bin/make/cond.c","usr.bin/make/cond.c","CondT",809,833
16,4,72,1,24,"CondF@849-873@usr.bin/make/cond.c","usr.bin/make/cond.c","CondF",849,873
16,4,72,1,25,"CondE@889-914@usr.bin/make/cond.c","usr.bin/make/cond.c","CondE",889,914
198,87,1082,1,233,"Cond_Eval@927-1160@usr.bin/make/cond.c","usr.bin/make/cond.c","Cond_Eval",927,1160
15,5,92,1,15,"Cond_End@1163-1178@usr.bin/make/cond.c","usr.bin/make/cond.c","Cond_End",1163,1178
15,2,94,2,15,"record_stamp@244-259@usr.bin/make/dir.c","usr.bin/make/dir.c","record_stamp",244,259
4,1,32,2,3,"find_stampi@262-265@usr.bin/make/dir.c","usr.bin/make/dir.c","find_stampi",262,265
13,2,90,2,13,"add_file@272-285@usr.bin/make/dir.c","usr.bin/make/dir.c","add_file",272,285
6,1,49,4,6,"find_file_hashi@288-294@usr.bin/make/dir.c","usr.bin/make/dir.c","find_file_hashi",288,294
23,9,163,1,26,"read_directory@297-323@usr.bin/make/dir.c","usr.bin/make/dir.c","read_directory",297,323
18,3,109,2,19,"create_PathEntry@327-346@usr.bin/make/dir.c","usr.bin/make/dir.c","create_PathEntry",327,346
4,1,14,1,3,"PathEntry_name@349-352@usr.bin/make/dir.c","usr.bin/make/dir.c","PathEntry_name",349,352
10,2,60,1,13,"Dir_Init@356-369@usr.bin/make/dir.c","usr.bin/make/dir.c","Dir_Init",356,369
15,6,122,4,19,"Dir_MatchFilesi@382-401@usr.bin/make/dir.c","usr.bin/make/dir.c","Dir_MatchFilesi",382,401
137,47,849,4,213,"Dir_FindFileComplexi@413-626@usr.bin/make/dir.c","usr.bin/make/dir.c","Dir_FindFileComplexi",413,626
11,4,67,3,11,"Dir_AddDiri@629-640@usr.bin/make/dir.c","usr.bin/make/dir.c","Dir_AddDiri",629,640
6,1,23,1,5,"Dir_CopyDir@643-648@usr.bin/make/dir.c","usr.bin/make/dir.c","Dir_CopyDir",643,648
10,2,55,1,10,"Dir_Destroy@651-661@usr.bin/make/dir.c","usr.bin/make/dir.c","Dir_Destroy",651,661
10,3,61,2,10,"Dir_Concat@674-684@usr.bin/make/dir.c","usr.bin/make/dir.c","Dir_Concat",674,684
5,1,25,1,4,"DirPrintDir@687-691@usr.bin/make/dir.c","usr.bin/make/dir.c","DirPrintDir",687,691
4,1,14,1,3,"Dir_PrintPath@694-697@usr.bin/make/dir.c","usr.bin/make/dir.c","Dir_PrintPath",694,697
41,12,253,1,48,"Dir_MTime@700-748@usr.bin/make/dir.c","usr.bin/make/dir.c","Dir_MTime",700,748
6,2,57,4,6,"PathMatchFilesi@93-99@usr.bin/make/direxpand.c","usr.bin/make/direxpand.c","PathMatchFilesi",93,99
37,11,253,4,57,"DirExpandWildi@113-170@usr.bin/make/direxpand.c","usr.bin/make/direxpand.c","DirExpandWildi",113,170
68,22,436,4,87,"DirExpandCurlyi@183-270@usr.bin/make/direxpand.c","usr.bin/make/direxpand.c","DirExpandCurlyi",183,270
18,4,120,4,20,"Dir_Expandi@275-295@usr.bin/make/direxpand.c","usr.bin/make/direxpand.c","Dir_Expandi",275,295
5,1,22,1,4,"DirPrintWord@298-302@usr.bin/make/direxpand.c","usr.bin/make/direxpand.c","DirPrintWord",298,302
35,12,141,2,35,"Dir_HasWildcardsi@307-342@usr.bin/make/direxpand.c","usr.bin/make/direxpand.c","Dir_HasWildcardsi",307,342
6,1,56,2,5,"compare_names@49-54@usr.bin/make/dump.c","usr.bin/make/dump.c","compare_names",49,54
5,1,25,1,5,"sort_ohash_by_name@57-62@usr.bin/make/dump.c","usr.bin/make/dump.c","sort_ohash_by_name",57,62
13,2,132,2,15,"sort_ohash@65-80@usr.bin/make/dump.c","usr.bin/make/dump.c","sort_ohash",65,80
5,1,24,1,4,"TargPrintName@83-87@usr.bin/make/dump.c","usr.bin/make/dump.c","TargPrintName",83,87
11,6,80,1,10,"TargPrintOnlySrc@90-100@usr.bin/make/dump.c","usr.bin/make/dump.c","TargPrintOnlySrc",90,100
57,19,337,2,58,"TargPrintNode@103-161@usr.bin/make/dump.c","usr.bin/make/dump.c","TargPrintNode",103,161
15,5,93,3,15,"dump_special@164-179@usr.bin/make/dump.c","usr.bin/make/dump.c","dump_special",164,179
18,3,133,1,19,"targ_dump@182-201@usr.bin/make/dump.c","usr.bin/make/dump.c","targ_dump",182,201
7,1,23,1,6,"dump_data@206-212@usr.bin/make/dump.c","usr.bin/make/dump.c","dump_data",206,212
8,2,26,1,7,"post_mortem@215-222@usr.bin/make/dump.c","usr.bin/make/dump.c","post_mortem",215,222
10,6,68,1,11,"drop_silently@108-119@usr.bin/make/engine.c","usr.bin/make/engine.c","drop_silently",108,119
27,12,188,1,49,"node_find_valid_commands@122-171@usr.bin/make/engine.c","usr.bin/make/engine.c","node_find_valid_commands",122,171
17,5,103,2,17,"list_parents@174-191@usr.bin/make/engine.c","usr.bin/make/engine.c","list_parents",174,191
24,4,111,1,29,"node_failure@194-223@usr.bin/make/engine.c","usr.bin/make/engine.c","node_failure",194,223
14,3,90,1,19,"rewrite_time@227-246@usr.bin/make/engine.c","usr.bin/make/engine.c","rewrite_time",227,246
26,8,155,1,34,"Job_Touch@249-283@usr.bin/make/engine.c","usr.bin/make/engine.c","Job_Touch",249,283
6,2,35,2,5,"Make_TimeStamp@286-291@usr.bin/make/engine.c","usr.bin/make/engine.c","Make_TimeStamp",286,291
29,9,203,2,45,"Make_HandleUse@294-339@usr.bin/make/engine.c","usr.bin/make/engine.c","Make_HandleUse",294,339
65,20,430,1,86,"Make_DoAllVar@342-428@usr.bin/make/engine.c","usr.bin/make/engine.c","Make_DoAllVar",342,428
4,1,19,2,3,"MakeTimeStamp@432-435@usr.bin/make/engine.c","usr.bin/make/engine.c","MakeTimeStamp",432,435
51,20,327,1,92,"Make_OODate@438-530@usr.bin/make/engine.c","usr.bin/make/engine.c","Make_OODate",438,530
7,2,43,1,8,"setup_meta@539-547@usr.bin/make/engine.c","usr.bin/make/engine.c","setup_meta",539,547
14,4,96,1,18,"recheck_command_for_shell@550-568@usr.bin/make/engine.c","usr.bin/make/engine.c","recheck_command_for_shell",550,568
28,6,182,2,39,"run_command@571-610@usr.bin/make/engine.c","usr.bin/make/engine.c","run_command",571,610
9,1,56,2,8,"job_attach_node@615-623@usr.bin/make/engine.c","usr.bin/make/engine.c","job_attach_node",615,623
60,22,377,2,77,"job_handle_status@626-703@usr.bin/make/engine.c","usr.bin/make/engine.c","job_handle_status",626,703
14,5,74,1,16,"run_gnode@706-722@usr.bin/make/engine.c","usr.bin/make/engine.c","run_gnode",706,722
8,2,27,1,8,"setup_engine@726-734@usr.bin/make/engine.c","usr.bin/make/engine.c","setup_engine",726,734
63,22,344,2,82,"do_run_command@737-819@usr.bin/make/engine.c","usr.bin/make/engine.c","do_run_command",737,819
23,4,138,1,24,"job_run_next@822-846@usr.bin/make/engine.c","usr.bin/make/engine.c","job_run_next",822,846
8,1,48,2,8,"Error@56-64@usr.bin/make/error.c","usr.bin/make/error.c","Error",56,64
12,2,68,2,14,"Fatal@75-89@usr.bin/make/error.c","usr.bin/make/error.c","Fatal",75,89
15,3,84,2,16,"Punt@100-116@usr.bin/make/error.c","usr.bin/make/error.c","Punt",100,116
8,2,29,0,7,"Finish@126-133@usr.bin/make/error.c","usr.bin/make/error.c","Finish",126,133
19,5,122,4,18,"ParseVErrorInternal@146-164@usr.bin/make/error.c","usr.bin/make/error.c","ParseVErrorInternal",146,164
9,1,50,3,9,"Parse_Error@172-181@usr.bin/make/error.c","usr.bin/make/error.c","Parse_Error",172,181
12,2,68,2,13,"build_words_list@116-129@usr.bin/make/for.c","usr.bin/make/for.c","build_words_list",116,129
61,16,443,1,73,"For_Eval@132-205@usr.bin/make/for.c","usr.bin/make/for.c","For_Eval",132,205
27,11,191,2,31,"For_Accumulate@209-240@usr.bin/make/for.c","usr.bin/make/for.c","For_Accumulate",209,240
23,5,184,2,26,"ForExec@245-271@usr.bin/make/for.c","usr.bin/make/for.c","ForExec",245,271
11,1,91,1,11,"For_Run@275-286@usr.bin/make/for.c","usr.bin/make/for.c","For_Run",275,286
49,10,288,2,51,"main@137-188@usr.bin/make/generate.c","usr.bin/make/generate.c","main",137,188
11,1,38,1,13,"Init@42-55@usr.bin/make/init.c","usr.bin/make/init.c","Init",42,55
15,5,85,2,14,"really_kill@170-184@usr.bin/make/job.c","usr.bin/make/job.c","really_kill",170,184
12,7,91,1,13,"may_remove_target@187-200@usr.bin/make/job.c","usr.bin/make/job.c","may_remove_target",187,200
15,5,92,1,14,"buf_addcurdir@203-217@usr.bin/make/job.c","usr.bin/make/job.c","buf_addcurdir",203,217
11,2,46,1,10,"shortened_curdir@220-230@usr.bin/make/job.c","usr.bin/make/job.c","shortened_curdir",220,230
10,2,71,3,10,"quick_error@233-243@usr.bin/make/job.c","usr.bin/make/job.c","quick_error",233,243
40,10,313,1,41,"print_error@246-287@usr.bin/make/job.c","usr.bin/make/job.c","print_error",246,287
20,7,124,1,20,"quick_summary@289-309@usr.bin/make/job.c","usr.bin/make/job.c","quick_summary",289,309
25,7,140,0,26,"internal_print_errors@312-338@usr.bin/make/job.c","usr.bin/make/job.c","internal_print_errors",312,338
5,1,14,1,4,"print_errors@341-345@usr.bin/make/job.c","usr.bin/make/job.c","print_errors",341,345
7,2,38,1,6,"setup_signal@348-354@usr.bin/make/job.c","usr.bin/make/job.c","setup_signal",348,354
26,7,74,1,26,"notice_signal@357-383@usr.bin/make/job.c","usr.bin/make/job.c","notice_signal",357,383
12,1,52,1,17,"setup_all_signals@386-403@usr.bin/make/job.c","usr.bin/make/job.c","setup_all_signals",386,403
24,5,159,1,31,"handle_siginfo@406-437@usr.bin/make/job.c","usr.bin/make/job.c","handle_siginfo",406,437
16,10,93,1,15,"check_dying_signal@440-455@usr.bin/make/job.c","usr.bin/make/job.c","check_dying_signal",440,455
25,7,88,1,25,"handle_all_signals@458-483@usr.bin/make/job.c","usr.bin/make/job.c","handle_all_signals",458,483
6,1,40,2,5,"debug_vprintf@486-491@usr.bin/make/job.c","usr.bin/make/job.c","debug_vprintf",486,491
9,2,42,2,8,"debug_job_printf@494-502@usr.bin/make/job.c","usr.bin/make/job.c","debug_job_printf",494,502
9,2,42,2,8,"debug_kill_printf@505-513@usr.bin/make/job.c","usr.bin/make/job.c","debug_kill_printf",505,513
17,11,92,2,21,"postprocess_job@531-552@usr.bin/make/job.c","usr.bin/make/job.c","postprocess_job",531,552
12,4,73,1,11,"determine_expensive_job@573-584@usr.bin/make/job.c","usr.bin/make/job.c","determine_expensive_job",573,584
8,3,46,1,7,"expensive_job@587-594@usr.bin/make/job.c","usr.bin/make/job.c","expensive_job",587,594
41,19,221,1,47,"expensive_command@597-644@usr.bin/make/job.c","usr.bin/make/job.c","expensive_command",597,644
19,4,80,1,26,"prepare_job@647-673@usr.bin/make/job.c","usr.bin/make/job.c","prepare_job",647,673
11,3,55,1,10,"may_continue_job@676-686@usr.bin/make/job.c","usr.bin/make/job.c","may_continue_job",676,686
8,2,33,1,7,"continue_job@689-696@usr.bin/make/job.c","usr.bin/make/job.c","continue_job",689,696
9,2,34,1,9,"Job_Make@710-719@usr.bin/make/job.c","usr.bin/make/job.c","Job_Make",710,719
17,5,84,1,17,"determine_job_next_step@722-739@usr.bin/make/job.c","usr.bin/make/job.c","determine_job_next_step",722,739
16,4,79,2,15,"remove_job@742-757@usr.bin/make/job.c","usr.bin/make/job.c","remove_job",742,757
11,3,69,1,12,"reap_finished_job@767-779@usr.bin/make/job.c","usr.bin/make/job.c","reap_finished_job",767,779
20,6,108,1,22,"reap_jobs@786-808@usr.bin/make/job.c","usr.bin/make/job.c","reap_jobs",786,808
12,3,56,1,28,"handle_running_jobs@811-839@usr.bin/make/job.c","usr.bin/make/job.c","handle_running_jobs",811,839
17,3,89,1,17,"handle_one_job@842-859@usr.bin/make/job.c","usr.bin/make/job.c","handle_one_job",842,859
5,2,15,0,4,"loop_handle_running_jobs@862-866@usr.bin/make/job.c","usr.bin/make/job.c","loop_handle_running_jobs",862,866
11,1,41,1,12,"Job_Init@869-881@usr.bin/make/job.c","usr.bin/make/job.c","Job_Init",869,881
7,3,21,1,6,"can_start_job@884-890@usr.bin/make/job.c","usr.bin/make/job.c","can_start_job",884,890
4,1,11,1,3,"Job_Empty@893-896@usr.bin/make/job.c","usr.bin/make/job.c","Job_Empty",893,896
26,5,161,1,32,"handle_fatal_signal@909-941@usr.bin/make/job.c","usr.bin/make/job.c","handle_fatal_signal",909,941
13,3,53,1,13,"Job_Finish@953-966@usr.bin/make/job.c","usr.bin/make/job.c","Job_Finish",953,966
7,2,29,1,6,"Job_Begin@969-975@usr.bin/make/job.c","usr.bin/make/job.c","Job_Begin",969,975
6,1,18,1,5,"Job_Wait@989-994@usr.bin/make/job.c","usr.bin/make/job.c","Job_Wait",989,994
12,3,69,1,17,"Job_AbortAll@1008-1025@usr.bin/make/job.c","usr.bin/make/job.c","Job_AbortAll",1008,1025
5,1,20,1,4,"Parse_setcurdir@120-124@usr.bin/make/lowparse.c","usr.bin/make/lowparse.c","Parse_setcurdir",120,124
4,2,36,3,3,"startswith@127-130@usr.bin/make/lowparse.c","usr.bin/make/lowparse.c","startswith",127,130
15,3,97,1,14,"simplify@133-147@usr.bin/make/lowparse.c","usr.bin/make/lowparse.c","simplify",133,147
12,1,80,2,13,"new_input_file@150-163@usr.bin/make/lowparse.c","usr.bin/make/lowparse.c","new_input_file",150,163
11,4,66,1,12,"free_input_stream@166-178@usr.bin/make/lowparse.c","usr.bin/make/lowparse.c","free_input_stream",166,178
10,1,66,2,13,"new_input_string@181-194@usr.bin/make/lowparse.c","usr.bin/make/lowparse.c","new_input_string",181,194
11,2,75,2,12,"Parse_FromString@198-210@usr.bin/make/lowparse.c","usr.bin/make/lowparse.c","Parse_FromString",198,210
6,2,36,2,5,"Parse_FromFile@214-219@usr.bin/make/lowparse.c","usr.bin/make/lowparse.c","Parse_FromFile",214,219
7,2,30,1,6,"Parse_NextFile@222-228@usr.bin/make/lowparse.c","usr.bin/make/lowparse.c","Parse_NextFile",222,228
14,3,68,1,14,"grab_new_line_and_readchar@231-245@usr.bin/make/lowparse.c","usr.bin/make/lowparse.c","grab_new_line_and_readchar",231,245
16,6,84,1,16,"skip_to_end_of_line@248-264@usr.bin/make/lowparse.c","usr.bin/make/lowparse.c","skip_to_end_of_line",248,264
17,6,90,1,21,"Parse_ReadNextConditionalLine@268-289@usr.bin/make/lowparse.c","usr.bin/make/lowparse.c","Parse_ReadNextConditionalLine",268,289
30,9,142,2,29,"read_logical_line@292-321@usr.bin/make/lowparse.c","usr.bin/make/lowparse.c","read_logical_line",292,321
28,7,141,2,31,"Parse_ReadUnparsedLine@324-355@usr.bin/make/lowparse.c","usr.bin/make/lowparse.c","Parse_ReadUnparsedLine",324,355
64,22,313,1,68,"skip_empty_lines_and_read_char@360-428@usr.bin/make/lowparse.c","usr.bin/make/lowparse.c","skip_empty_lines_and_read_char",360,428
11,2,42,1,12,"Parse_ReadNormalLine@441-453@usr.bin/make/lowparse.c","usr.bin/make/lowparse.c","Parse_ReadNormalLine",441,453
4,2,17,1,3,"Parse_Getlineno@456-459@usr.bin/make/lowparse.c","usr.bin/make/lowparse.c","Parse_Getlineno",456,459
4,2,17,1,3,"Parse_Getfilename@462-465@usr.bin/make/lowparse.c","usr.bin/make/lowparse.c","Parse_Getfilename",462,465
4,1,12,1,3,"Parse_SetLocation@468-471@usr.bin/make/lowparse.c","usr.bin/make/lowparse.c","Parse_SetLocation",468,471
9,2,39,1,8,"Parse_FillLocation@474-482@usr.bin/make/lowparse.c","usr.bin/make/lowparse.c","Parse_FillLocation",474,482
7,2,23,1,6,"Parse_ReportErrors@485-491@usr.bin/make/lowparse.c","usr.bin/make/lowparse.c","Parse_ReportErrors",485,491
4,1,35,3,3,"Lst_FindConst@161-164@usr.bin/make/lst.h","usr.bin/make/lst.h","Lst_FindConst",161,164
4,1,32,3,3,"Lst_FindFromConst@167-170@usr.bin/make/lst.h","usr.bin/make/lst.h","Lst_FindFromConst",167,170
10,2,59,2,10,"record_option@117-127@usr.bin/make/main.c","usr.bin/make/main.c","record_option",117,127
42,13,129,1,42,"posixParseOptLetter@130-172@usr.bin/make/main.c","usr.bin/make/main.c","posixParseOptLetter",130,172
150,46,632,2,158,"MainParseArgs@186-344@usr.bin/make/main.c","usr.bin/make/main.c","MainParseArgs",186,344
33,11,172,2,33,"MainParseChdir@347-380@usr.bin/make/main.c","usr.bin/make/main.c","MainParseChdir",347,380
34,8,194,1,40,"Main_ParseArgLine@395-435@usr.bin/make/main.c","usr.bin/make/main.c","Main_ParseArgLine",395,435
14,5,77,2,14,"add_dirpath@439-453@usr.bin/make/main.c","usr.bin/make/main.c","add_dirpath",439,453
11,3,54,0,11,"figure_out_MACHINE@463-474@usr.bin/make/main.c","usr.bin/make/main.c","figure_out_MACHINE",463,474
9,2,33,0,11,"figure_out_MACHINE_ARCH@477-488@usr.bin/make/main.c","usr.bin/make/main.c","figure_out_MACHINE_ARCH",477,488
10,4,37,0,15,"figure_out_MACHINE_CPU@490-505@usr.bin/make/main.c","usr.bin/make/main.c","figure_out_MACHINE_CPU",490,505
18,7,128,0,24,"figure_out_CURDIR@508-532@usr.bin/make/main.c","usr.bin/make/main.c","figure_out_CURDIR",508,532
10,3,56,2,9,"chdir_verify_path@535-544@usr.bin/make/main.c","usr.bin/make/main.c","chdir_verify_path",535,544
11,3,67,1,20,"setup_CURDIR_OBJDIR@547-567@usr.bin/make/main.c","usr.bin/make/main.c","setup_CURDIR_OBJDIR",547,567
9,2,46,0,9,"setup_VPATH@575-584@usr.bin/make/main.c","usr.bin/make/main.c","setup_VPATH",575,584
7,2,46,2,6,"read_makefile_list@587-593@usr.bin/make/main.c","usr.bin/make/main.c","read_makefile_list",587,593
19,6,123,4,28,"read_all_make_rules@596-624@usr.bin/make/main.c","usr.bin/make/main.c","read_all_make_rules",596,624
104,21,640,2,176,"main@646-822@usr.bin/make/main.c","usr.bin/make/main.c","main",646,822
33,9,214,2,41,"ReadMakefile@835-876@usr.bin/make/main.c","usr.bin/make/main.c","ReadMakefile",835,876
8,1,20,0,7,"usage@884-891@usr.bin/make/main.c","usr.bin/make/main.c","usage",884,891
4,1,12,0,3,"no_jobs_left@121-124@usr.bin/make/make.c","usr.bin/make/make.c","no_jobs_left",121,124
7,3,41,0,11,"random_setup@127-138@usr.bin/make/make.c","usr.bin/make/make.c","random_setup",127,138
15,3,92,1,16,"randomize_garray@141-157@usr.bin/make/make.c","usr.bin/make/make.c","randomize_garray",141,157
16,6,94,1,19,"has_unmade_predecessor@160-179@usr.bin/make/make.c","usr.bin/make/make.c","has_unmade_predecessor",160,179
10,5,71,1,14,"requeue_successors@182-196@usr.bin/make/make.c","usr.bin/make/make.c","requeue_successors",182,196
17,4,127,1,18,"requeue@199-217@usr.bin/make/make.c","usr.bin/make/make.c","requeue",199,217
37,14,249,1,65,"Make_Update@238-303@usr.bin/make/make.c","usr.bin/make/make.c","Make_Update",238,303
78,25,437,1,91,"try_to_make_node@306-397@usr.bin/make/make.c","usr.bin/make/make.c","try_to_make_node",306,397
9,3,43,1,9,"MakeStartJobs@415-424@usr.bin/make/make.c","usr.bin/make/make.c","MakeStartJobs",415,424
9,3,53,1,8,"MakePrintStatus@427-435@usr.bin/make/make.c","usr.bin/make/make.c","MakePrintStatus",427,435
7,3,48,2,7,"MakeAddChild@438-445@usr.bin/make/make.c","usr.bin/make/make.c","MakeAddChild",438,445
7,2,39,2,7,"MakeHandleUse@448-455@usr.bin/make/make.c","usr.bin/make/make.c","MakeHandleUse",448,455
32,8,198,1,43,"add_targets_to_make@462-505@usr.bin/make/make.c","usr.bin/make/make.c","add_targets_to_make",462,505
29,6,144,1,61,"Make_Run@529-590@usr.bin/make/make.c","usr.bin/make/make.c","Make_Run",529,590
20,5,102,1,20,"targets_contain_cycles@597-617@usr.bin/make/make.c","usr.bin/make/make.c","targets_contain_cycles",597,617
23,5,150,2,27,"print_unlink_cycle@620-647@usr.bin/make/make.c","usr.bin/make/make.c","print_unlink_cycle",620,647
15,3,67,1,16,"break_and_print_cycles@653-669@usr.bin/make/make.c","usr.bin/make/make.c","break_and_print_cycles",653,669
23,6,127,2,26,"find_cycle@673-699@usr.bin/make/make.c","usr.bin/make/make.c","find_cycle",673,699
7,2,32,1,7,"emalloc@58-65@usr.bin/make/memory.c","usr.bin/make/memory.c","emalloc",58,65
9,1,44,1,10,"estrdup@72-82@usr.bin/make/memory.c","usr.bin/make/memory.c","estrdup",72,82
6,2,34,2,5,"erealloc@89-94@usr.bin/make/memory.c","usr.bin/make/memory.c","erealloc",89,94
6,2,41,3,5,"ereallocarray@97-102@usr.bin/make/memory.c","usr.bin/make/memory.c","ereallocarray",97,102
7,2,44,3,7,"hash_calloc@106-113@usr.bin/make/memory.c","usr.bin/make/memory.c","hash_calloc",106,113
4,1,18,2,3,"hash_free@116-119@usr.bin/make/memory.c","usr.bin/make/memory.c","hash_free",116,119
4,1,18,2,3,"element_alloc@122-125@usr.bin/make/memory.c","usr.bin/make/memory.c","element_alloc",122,125
5,1,26,1,4,"enomem@134-138@usr.bin/make/memory.c","usr.bin/make/memory.c","enomem",134,138
5,1,31,2,4,"enocmem@141-145@usr.bin/make/memory.c","usr.bin/make/memory.c","enocmem",141,145
7,2,46,2,7,"esetenv@151-158@usr.bin/make/memory.c","usr.bin/make/memory.c","esetenv",151,158
11,3,55,1,12,"eunlink@166-178@usr.bin/make/memory.c","usr.bin/make/memory.c","eunlink",166,178
8,2,53,1,8,"free_hash@181-189@usr.bin/make/memory.c","usr.bin/make/memory.c","free_hash",181,189
10,2,87,0,10,"create_special_nodes@222-232@usr.bin/make/parse.c","usr.bin/make/parse.c","create_special_nodes",222,232
8,3,47,2,7,"ParseLinkSrc@248-255@usr.bin/make/parse.c","usr.bin/make/parse.c","ParseLinkSrc",248,255
17,4,78,1,19,"operator_string@258-277@usr.bin/make/parse.c","usr.bin/make/parse.c","operator_string",258,277
26,7,193,2,49,"ParseDoOp@293-342@usr.bin/make/parse.c","usr.bin/make/parse.c","ParseDoOp",293,342
9,2,51,2,11,"ParseAddDep@361-372@usr.bin/make/parse.c","usr.bin/make/parse.c","ParseAddDep",361,372
7,2,37,3,6,"apply_op@375-381@usr.bin/make/parse.c","usr.bin/make/parse.c","apply_op",375,381
46,9,255,5,71,"ParseDoSrc@398-469@usr.bin/make/parse.c","usr.bin/make/parse.c","ParseDoSrc",398,469
10,3,52,2,10,"ParseFindMain@486-496@usr.bin/make/parse.c","usr.bin/make/parse.c","ParseFindMain",486,496
6,1,25,1,6,"ParseClearPath@505-511@usr.bin/make/parse.c","usr.bin/make/parse.c","ParseClearPath",505,511
10,2,60,2,12,"add_target_node@514-526@usr.bin/make/parse.c","usr.bin/make/parse.c","add_target_node",514,526
18,3,114,2,25,"add_target_nodes@529-554@usr.bin/make/parse.c","usr.bin/make/parse.c","add_target_nodes",529,554
19,10,110,1,24,"found_delimiter@568-592@usr.bin/make/parse.c","usr.bin/make/parse.c","found_delimiter",568,592
49,17,282,3,75,"parse_do_targets@595-670@usr.bin/make/parse.c","usr.bin/make/parse.c","parse_do_targets",595,670
7,2,46,0,6,"dump_targets@673-679@usr.bin/make/parse.c","usr.bin/make/parse.c","dump_targets",673,679
64,14,315,1,66,"handle_special_targets@682-748@usr.bin/make/parse.c","usr.bin/make/parse.c","handle_special_targets",682,748
23,5,106,1,26,"parse_operator@751-777@usr.bin/make/parse.c","usr.bin/make/parse.c","parse_operator",751,777
114,35,551,1,184,"ParseDoDependency@811-995@usr.bin/make/parse.c","usr.bin/make/parse.c","ParseDoDependency",811,995
8,2,46,2,8,"ParseAddCmd@1012-1020@usr.bin/make/parse.c","usr.bin/make/parse.c","ParseAddCmd",1012,1020
5,1,20,1,5,"ParseHasCommands@1030-1035@usr.bin/make/parse.c","usr.bin/make/parse.c","ParseHasCommands",1030,1035
26,7,154,2,27,"strip_comments@1040-1067@usr.bin/make/parse.c","usr.bin/make/parse.c","strip_comments",1040,1067
4,1,16,1,3,"Parse_AddIncludeDir@1077-1080@usr.bin/make/parse.c","usr.bin/make/parse.c","Parse_AddIncludeDir",1077,1080
36,12,208,3,52,"resolve_include_filename@1083-1135@usr.bin/make/parse.c","usr.bin/make/parse.c","resolve_include_filename",1083,1135
17,6,107,4,19,"handle_include_file@1138-1157@usr.bin/make/parse.c","usr.bin/make/parse.c","handle_include_file",1138,1157
31,6,158,1,38,"lookup_bsd_include@1161-1199@usr.bin/make/parse.c","usr.bin/make/parse.c","lookup_bsd_include",1161,1199
26,7,137,3,32,"lookup_sysv_style_include@1203-1235@usr.bin/make/parse.c","usr.bin/make/parse.c","lookup_sysv_style_include",1203,1235
4,1,23,2,3,"lookup_sysv_include@1240-1243@usr.bin/make/parse.c","usr.bin/make/parse.c","lookup_sysv_include",1240,1243
4,1,23,2,3,"lookup_conditional_include@1248-1251@usr.bin/make/parse.c","usr.bin/make/parse.c","lookup_conditional_include",1248,1251
64,22,309,1,64,"handle_poison@1263-1327@usr.bin/make/parse.c","usr.bin/make/parse.c","handle_poison",1263,1327
20,4,88,2,21,"handle_for_loop@1331-1352@usr.bin/make/parse.c","usr.bin/make/parse.c","handle_for_loop",1331,1352
10,4,57,1,10,"handle_undef@1355-1365@usr.bin/make/parse.c","usr.bin/make/parse.c","handle_undef",1355,1365
30,12,153,3,35,"handle_bsd_command@1369-1404@usr.bin/make/parse.c","usr.bin/make/parse.c","handle_bsd_command",1369,1404
15,2,91,2,17,"register_target@1408-1425@usr.bin/make/parse.c","usr.bin/make/parse.c","register_target",1408,1425
43,13,297,2,54,"build_target_group@1428-1482@usr.bin/make/parse.c","usr.bin/make/parse.c","build_target_group",1428,1482
7,2,30,0,6,"reset_target_hash@1485-1491@usr.bin/make/parse.c","usr.bin/make/parse.c","reset_target_hash",1485,1491
5,2,15,0,4,"Parse_End@1494-1498@usr.bin/make/parse.c","usr.bin/make/parse.c","Parse_End",1494,1498
13,4,92,1,15,"dedup_targets@1501-1516@usr.bin/make/parse.c","usr.bin/make/parse.c","dedup_targets",1501,1516
5,1,24,1,4,"finish_commands@1524-1528@usr.bin/make/parse.c","usr.bin/make/parse.c","finish_commands",1524,1528
9,1,71,2,13,"parse_commands@1531-1544@usr.bin/make/parse.c","usr.bin/make/parse.c","parse_commands",1531,1544
27,15,186,3,27,"parse_as_special_line@1547-1574@usr.bin/make/parse.c","usr.bin/make/parse.c","parse_as_special_line",1547,1574
31,6,180,4,44,"parse_target_line@1577-1621@usr.bin/make/parse.c","usr.bin/make/parse.c","parse_target_line",1577,1621
47,9,228,2,53,"Parse_File@1624-1677@usr.bin/make/parse.c","usr.bin/make/parse.c","Parse_File",1624,1677
9,1,40,1,8,"Parse_Init@1680-1688@usr.bin/make/parse.c","usr.bin/make/parse.c","Parse_Init",1680,1688
11,3,56,1,11,"Parse_MainName@1691-1702@usr.bin/make/parse.c","usr.bin/make/parse.c","Parse_MainName",1691,1702
12,9,82,1,11,"find_op1@46-57@usr.bin/make/parsevar.c","usr.bin/make/parsevar.c","find_op1",46,57
10,6,57,1,9,"find_op2@60-69@usr.bin/make/parsevar.c","usr.bin/make/parsevar.c","find_op2",60,69
104,31,584,2,150,"parse_variable_assignment@72-222@usr.bin/make/parsevar.c","usr.bin/make/parsevar.c","parse_variable_assignment",72,222
4,1,17,1,3,"Parse_As_Var_Assignment@225-228@usr.bin/make/parsevar.c","usr.bin/make/parsevar.c","Parse_As_Var_Assignment",225,228
9,1,37,1,9,"Parse_CmdlineVar@231-240@usr.bin/make/parsevar.c","usr.bin/make/parsevar.c","Parse_CmdlineVar",231,240
26,2,256,1,27,"main@49-76@usr.bin/make/regress.c","usr.bin/make/regress.c","main",49,76
4,1,16,1,3,"average_runs@59-62@usr.bin/make/stats.c","usr.bin/make/stats.c","average_runs",59,62
57,11,316,1,70,"print_stats@65-135@usr.bin/make/stats.c","usr.bin/make/stats.c","print_stats",65,135
28,6,170,1,36,"Init_Stats@138-174@usr.bin/make/stats.c","usr.bin/make/stats.c","Init_Stats",138,174
17,3,111,5,26,"Str_concati@51-77@usr.bin/make/str.c","usr.bin/make/str.c","Str_concati",51,77
89,30,410,3,105,"brk_string@90-195@usr.bin/make/str.c","usr.bin/make/str.c","brk_string",90,195
33,14,142,1,35,"iterate_words@199-234@usr.bin/make/str.c","usr.bin/make/str.c","iterate_words",199,234
22,9,110,4,26,"star_match@237-263@usr.bin/make/str.c","usr.bin/make/str.c","star_match",237,263
41,20,239,3,47,"range_match@266-313@usr.bin/make/str.c","usr.bin/make/str.c","range_match",266,313
29,11,150,4,39,"Str_Matchi@316-355@usr.bin/make/str.c","usr.bin/make/str.c","Str_Matchi",316,355
28,10,170,3,38,"Str_SYSVMatch@369-407@usr.bin/make/str.c","usr.bin/make/str.c","Str_SYSVMatch",369,407
10,2,73,4,16,"Str_SYSVSubst@422-438@usr.bin/make/str.c","usr.bin/make/str.c","Str_SYSVSubst",422,438
8,1,52,2,8,"Str_dupi@441-449@usr.bin/make/str.c","usr.bin/make/str.c","Str_dupi",441,449
19,5,110,3,19,"escape_dupi@452-471@usr.bin/make/str.c","usr.bin/make/str.c","escape_dupi",452,471
9,4,51,3,8,"Str_rchri@474-482@usr.bin/make/str.c","usr.bin/make/str.c","Str_rchri",474,482
4,1,37,2,3,"reverse_hash_add_char@214-217@usr.bin/make/suff.c","usr.bin/make/suff.c","reverse_hash_add_char",214,217
16,4,81,2,16,"reverse_hashi@221-237@usr.bin/make/suff.c","usr.bin/make/suff.c","reverse_hashi",221,237
6,1,44,3,6,"reverse_slot@240-246@usr.bin/make/suff.c","usr.bin/make/suff.c","reverse_slot",240,246
16,4,92,3,18,"suffix_is_suffix@250-268@usr.bin/make/suff.c","usr.bin/make/suff.c","suffix_is_suffix",250,268
7,2,43,2,8,"find_suffi@271-279@usr.bin/make/suff.c","usr.bin/make/suff.c","find_suffi",271,279
7,2,35,1,10,"find_transform@282-292@usr.bin/make/suff.c","usr.bin/make/suff.c","find_transform",282,292
13,3,78,2,17,"find_or_create_transformi@295-312@usr.bin/make/suff.c","usr.bin/make/suff.c","find_or_create_transformi",295,312
23,9,165,2,24,"SuffInsert@325-349@usr.bin/make/suff.c","usr.bin/make/suff.c","SuffInsert",325,349
10,2,56,1,11,"clear_suffixes@362-373@usr.bin/make/suff.c","usr.bin/make/suff.c","clear_suffixes",362,373
4,1,10,1,3,"Suff_ClearSuffixes@376-379@usr.bin/make/suff.c","usr.bin/make/suff.c","Suff_ClearSuffixes",376,379
51,17,319,4,67,"parse_transformi@389-456@usr.bin/make/suff.c","usr.bin/make/suff.c","parse_transformi",389,456
5,1,23,1,4,"special_path_hack@459-463@usr.bin/make/suff.c","usr.bin/make/suff.c","special_path_hack",459,463
23,7,136,2,23,"find_best_suffix@466-489@usr.bin/make/suff.c","usr.bin/make/suff.c","find_best_suffix",466,489
26,6,169,2,33,"Suff_ParseAsTransform@501-534@usr.bin/make/suff.c","usr.bin/make/suff.c","Suff_ParseAsTransform",501,534
9,3,49,1,8,"make_suffix_known@537-545@usr.bin/make/suff.c","usr.bin/make/suff.c","make_suffix_known",537,545
11,1,72,2,11,"new_suffixi@548-559@usr.bin/make/suff.c","usr.bin/make/suff.c","new_suffixi",548,559
4,1,24,2,3,"Suff_AddSuffixi@573-576@usr.bin/make/suff.c","usr.bin/make/suff.c","Suff_AddSuffixi",573,576
13,2,80,2,14,"add_suffixi@579-593@usr.bin/make/suff.c","usr.bin/make/suff.c","add_suffixi",579,593
7,3,36,1,6,"find_suffix_path@596-602@usr.bin/make/suff.c","usr.bin/make/suff.c","find_suffix_path",596,602
17,6,122,1,17,"build_suffixes_graph@605-622@usr.bin/make/suff.c","usr.bin/make/suff.c","build_suffixes_graph",605,622
12,3,78,1,12,"setup_paths@640-652@usr.bin/make/suff.c","usr.bin/make/suff.c","setup_paths",640,652
5,1,14,1,8,"process_suffixes_after_makefile_is_read@655-663@usr.bin/make/suff.c","usr.bin/make/suff.c","process_suffixes_after_makefile_is_read",655,663
24,2,156,2,28,"SuffAddSrc@678-706@usr.bin/make/suff.c","usr.bin/make/suff.c","SuffAddSrc",678,706
9,1,41,2,10,"SuffAddLevel@718-728@usr.bin/make/suff.c","usr.bin/make/suff.c","SuffAddLevel",718,728
35,9,221,1,46,"SuffRemoveSrc@743-789@usr.bin/make/suff.c","usr.bin/make/suff.c","SuffRemoveSrc",743,789
32,10,174,2,46,"SuffFindThem@801-847@usr.bin/make/suff.c","usr.bin/make/suff.c","SuffFindThem",801,847
43,8,280,2,61,"SuffFindCmds@858-919@usr.bin/make/suff.c","usr.bin/make/suff.c","SuffFindCmds",858,919
11,4,77,2,10,"SuffLinkParent@922-932@usr.bin/make/suff.c","usr.bin/make/suff.c","SuffLinkParent",922,932
54,17,380,3,82,"SuffExpandVarChildren@935-1017@usr.bin/make/suff.c","usr.bin/make/suff.c","SuffExpandVarChildren",935,1017
31,8,216,3,49,"SuffExpandWildChildren@1020-1069@usr.bin/make/suff.c","usr.bin/make/suff.c","SuffExpandWildChildren",1020,1069
13,3,79,2,21,"SuffExpandChildren@1084-1105@usr.bin/make/suff.c","usr.bin/make/suff.c","SuffExpandChildren",1084,1105
8,2,46,2,8,"expand_children_from@1108-1116@usr.bin/make/suff.c","usr.bin/make/suff.c","expand_children_from",1108,1116
34,7,215,4,62,"SuffApplyTransform@1136-1198@usr.bin/make/suff.c","usr.bin/make/suff.c","SuffApplyTransform",1136,1198
11,3,70,3,11,"find_suffix_as_suffix@1201-1212@usr.bin/make/suff.c","usr.bin/make/suff.c","find_suffix_as_suffix",1201,1212
44,11,279,2,82,"SuffFindArchiveDeps@1224-1306@usr.bin/make/suff.c","usr.bin/make/suff.c","SuffFindArchiveDeps",1224,1306
18,2,145,5,28,"record_possible_suffix@1309-1337@usr.bin/make/suff.c","usr.bin/make/suff.c","record_possible_suffix",1309,1337
22,6,148,3,24,"record_possible_suffixes@1340-1364@usr.bin/make/suff.c","usr.bin/make/suff.c","record_possible_suffixes",1340,1364
134,35,908,2,243,"SuffFindNormalDeps@1376-1619@usr.bin/make/suff.c","usr.bin/make/suff.c","SuffFindNormalDeps",1376,1619
6,2,26,1,6,"Suff_FindDeps@1647-1653@usr.bin/make/suff.c","usr.bin/make/suff.c","Suff_FindDeps",1647,1653
16,4,79,2,20,"SuffFindDeps@1657-1677@usr.bin/make/suff.c","usr.bin/make/suff.c","SuffFindDeps",1657,1677
12,1,68,1,18,"Suff_Init@1689-1707@usr.bin/make/suff.c","usr.bin/make/suff.c","Suff_Init",1689,1707
5,2,30,1,4,"SuffPrintName@1713-1717@usr.bin/make/suff.c","usr.bin/make/suff.c","SuffPrintName",1713,1717
14,3,86,1,15,"SuffPrintSuff@1720-1735@usr.bin/make/suff.c","usr.bin/make/suff.c","SuffPrintSuff",1720,1735
8,1,48,1,7,"SuffPrintTrans@1738-1745@usr.bin/make/suff.c","usr.bin/make/suff.c","SuffPrintTrans",1738,1745
6,1,53,2,5,"compare_order@1748-1753@usr.bin/make/suff.c","usr.bin/make/suff.c","compare_order",1748,1753
20,6,119,1,21,"print_path@1756-1777@usr.bin/make/suff.c","usr.bin/make/suff.c","print_path",1756,1777
42,12,312,1,46,"Suff_PrintAll@1780-1826@usr.bin/make/suff.c","usr.bin/make/suff.c","Suff_PrintAll",1780,1826
4,1,19,1,3,"PrintAddr@1830-1833@usr.bin/make/suff.c","usr.bin/make/suff.c","PrintAddr",1830,1833
12,1,95,1,13,"Targ_Init@131-144@usr.bin/make/targ.c","usr.bin/make/targ.c","Targ_Init",131,144
31,2,196,2,35,"Targ_NewGNi@147-182@usr.bin/make/targ.c","usr.bin/make/targ.c","Targ_NewGNi",147,182
6,1,42,3,6,"Targ_FindNodei@185-191@usr.bin/make/targ.c","usr.bin/make/targ.c","Targ_FindNodei",185,191
12,3,88,4,15,"Targ_FindNodeih@194-209@usr.bin/make/targ.c","usr.bin/make/targ.c","Targ_FindNodeih",194,209
13,3,84,2,16,"Targ_FindList@212-228@usr.bin/make/targ.c","usr.bin/make/targ.c","Targ_FindList",212,228
7,3,25,1,6,"Targ_Ignore@231-237@usr.bin/make/targ.c","usr.bin/make/targ.c","Targ_Ignore",231,237
7,3,25,1,6,"Targ_Silent@240-246@usr.bin/make/targ.c","usr.bin/make/targ.c","Targ_Silent",240,246
7,3,33,1,6,"Targ_Precious@249-255@usr.bin/make/targ.c","usr.bin/make/targ.c","Targ_Precious",249,255
5,1,25,1,4,"Targ_PrintCmd@258-262@usr.bin/make/targ.c","usr.bin/make/targ.c","Targ_PrintCmd",258,262
26,4,116,1,32,"Targ_PrintType@265-297@usr.bin/make/targ.c","usr.bin/make/targ.c","Targ_PrintType",265,297
17,6,51,1,16,"status_to_string@300-316@usr.bin/make/targ.c","usr.bin/make/targ.c","status_to_string",300,316
4,1,9,0,3,"targets_hash@319-322@usr.bin/make/targ.c","usr.bin/make/targ.c","targets_hash",319,322
4,1,34,4,3,"Targ_FindNodeh@325-328@usr.bin/make/targ.c","usr.bin/make/targ.c","Targ_FindNodeh",325,328
4,1,34,4,3,"Targ_FindNodeh@56-59@usr.bin/make/targ.h","usr.bin/make/targ.h","Targ_FindNodeh",56,59
23,4,155,2,24,"add_to_equiv_list@86-110@usr.bin/make/targequiv.c","usr.bin/make/targequiv.c","add_to_equiv_list",86,110
18,4,137,0,22,"build_equivalence@113-135@usr.bin/make/targequiv.c","usr.bin/make/targequiv.c","build_equivalence",113,135
10,1,62,2,10,"Targ_setdirs@142-152@usr.bin/make/targequiv.c","usr.bin/make/targequiv.c","Targ_setdirs",142,152
20,6,140,1,21,"kludge_look_harder_for_target@156-177@usr.bin/make/targequiv.c","usr.bin/make/targequiv.c","kludge_look_harder_for_target",156,177
7,1,36,2,10,"attach_node@180-190@usr.bin/make/targequiv.c","usr.bin/make/targequiv.c","attach_node",180,190
33,14,199,2,33,"parse_reduce@196-229@usr.bin/make/targequiv.c","usr.bin/make/targequiv.c","parse_reduce",196,229
9,2,50,1,10,"absolute_reduce@232-242@usr.bin/make/targequiv.c","usr.bin/make/targequiv.c","absolute_reduce",232,242
13,3,86,2,15,"relative_reduce@245-260@usr.bin/make/targequiv.c","usr.bin/make/targequiv.c","relative_reduce",245,260
17,4,122,3,20,"relative_reduce2@263-283@usr.bin/make/targequiv.c","usr.bin/make/targequiv.c","relative_reduce2",263,283
28,6,133,5,29,"names_match_with_dir@286-315@usr.bin/make/targequiv.c","usr.bin/make/targequiv.c","names_match_with_dir",286,315
28,6,142,6,29,"names_match_with_dirs@318-347@usr.bin/make/targequiv.c","usr.bin/make/targequiv.c","names_match_with_dirs",318,347
46,14,306,2,48,"names_match@350-398@usr.bin/make/targequiv.c","usr.bin/make/targequiv.c","names_match",350,398
24,9,145,1,27,"find_siblings@401-428@usr.bin/make/targequiv.c","usr.bin/make/targequiv.c","find_siblings",401,428
12,3,54,1,13,"look_harder_for_target@431-444@usr.bin/make/targequiv.c","usr.bin/make/targequiv.c","look_harder_for_target",431,444
11,3,48,2,12,"is_sibling@447-459@usr.bin/make/targequiv.c","usr.bin/make/targequiv.c","is_sibling",447,459
4,1,17,1,3,"set_times@38-41@usr.bin/make/timestamp.c","usr.bin/make/timestamp.c","set_times",38,41
15,2,102,1,15,"time_to_string@45-60@usr.bin/make/timestamp.c","usr.bin/make/timestamp.c","time_to_string",45,60
4,1,11,1,3,"Var_setCheckEnvFirst@109-112@usr.bin/make/var.c","usr.bin/make/var.c","Var_setCheckEnvFirst",109,112
116,90,841,3,118,"classify_var@274-392@usr.bin/make/var.c","usr.bin/make/var.c","classify_var",274,392
4,1,26,2,3,"create_var@408-411@usr.bin/make/var.c","usr.bin/make/var.c","create_var",408,411
7,1,51,2,7,"var_set_initial_value@416-423@usr.bin/make/var.c","usr.bin/make/var.c","var_set_initial_value",416,423
10,2,65,2,9,"var_set_value@429-438@usr.bin/make/var.c","usr.bin/make/var.c","var_set_value",429,438
10,2,65,2,9,"var_append_value@444-453@usr.bin/make/var.c","usr.bin/make/var.c","var_append_value",444,453
6,2,35,1,5,"delete_var@459-464@usr.bin/make/var.c","usr.bin/make/var.c","delete_var",459,464
5,1,26,1,4,"SymTable_Init@479-483@usr.bin/make/var.c","usr.bin/make/var.c","SymTable_Init",479,483
13,2,85,3,13,"find_global_var_without_env@493-506@usr.bin/make/var.c","usr.bin/make/var.c","find_global_var_without_env",493,506
12,3,54,1,15,"fill_from_env@511-526@usr.bin/make/var.c","usr.bin/make/var.c","fill_from_env",511,526
10,5,78,3,12,"find_global_var@531-543@usr.bin/make/var.c","usr.bin/make/var.c","find_global_var",531,543
23,5,121,3,27,"Var_Mark@548-575@usr.bin/make/var.c","usr.bin/make/var.c","Var_Mark",548,575
17,5,87,1,16,"poison_check@580-596@usr.bin/make/var.c","usr.bin/make/var.c","poison_check",580,596
23,6,132,2,27,"Var_Deletei@601-628@usr.bin/make/var.c","usr.bin/make/var.c","Var_Deletei",601,628
32,15,269,5,38,"var_set_append@633-671@usr.bin/make/var.c","usr.bin/make/var.c","var_set_append",633,671
5,1,35,4,4,"Var_Seti_with_ctxt@674-678@usr.bin/make/var.c","usr.bin/make/var.c","Var_Seti_with_ctxt",674,678
5,1,35,4,4,"Var_Appendi_with_ctxt@681-685@usr.bin/make/var.c","usr.bin/make/var.c","Var_Appendi_with_ctxt",681,685
13,2,82,1,12,"var_exec_cmd@688-700@usr.bin/make/var.c","usr.bin/make/var.c","var_exec_cmd",688,700
20,4,106,2,20,"Var_Valuei@709-729@usr.bin/make/var.c","usr.bin/make/var.c","Var_Valuei",709,729
15,4,87,2,18,"Var_Definedi@732-750@usr.bin/make/var.c","usr.bin/make/var.c","Var_Definedi",732,750
6,5,37,1,5,"find_rparen@764-769@usr.bin/make/var.c","usr.bin/make/var.c","find_rparen",764,769
6,5,37,1,5,"find_ket@772-777@usr.bin/make/var.c","usr.bin/make/var.c","find_ket",772,777
13,3,39,1,12,"find_pos@782-794@usr.bin/make/var.c","usr.bin/make/var.c","find_pos",782,794
26,5,149,3,27,"parse_base_variable_name@797-824@usr.bin/make/var.c","usr.bin/make/var.c","parse_base_variable_name",797,824
26,5,146,2,26,"Var_ParseSkip@827-853@usr.bin/make/var.c","usr.bin/make/var.c","Var_ParseSkip",827,853
13,3,74,5,14,"Var_ParseBuffer@859-873@usr.bin/make/var.c","usr.bin/make/var.c","Var_ParseBuffer",859,873
17,5,105,1,18,"push_used@883-901@usr.bin/make/var.c","usr.bin/make/var.c","push_used",883,901
5,1,17,1,4,"pop_used@904-908@usr.bin/make/var.c","usr.bin/make/var.c","pop_used",904,908
39,11,234,7,51,"get_expanded_value@911-962@usr.bin/make/var.c","usr.bin/make/var.c","get_expanded_value",911,962
28,7,143,1,28,"bad_dynamic_variable@967-995@usr.bin/make/var.c","usr.bin/make/var.c","bad_dynamic_variable",967,995
41,8,236,5,57,"Var_Parse@998-1055@usr.bin/make/var.c","usr.bin/make/var.c","Var_Parse",998,1055
47,12,238,3,68,"Var_Subst@1059-1127@usr.bin/make/var.c","usr.bin/make/var.c","Var_Subst",1059,1127
34,9,186,1,39,"Var_Check_for_target@1133-1172@usr.bin/make/var.c","usr.bin/make/var.c","Var_Check_for_target",1133,1172
8,3,72,4,9,"Var_Substi@1180-1189@usr.bin/make/var.c","usr.bin/make/var.c","Var_Substi",1180,1189
11,1,80,2,17,"Var_NewLoopVar@1205-1222@usr.bin/make/var.c","usr.bin/make/var.c","Var_NewLoopVar",1205,1222
4,1,16,1,3,"Var_LoopVarName@1225-1228@usr.bin/make/var.c","usr.bin/make/var.c","Var_LoopVarName",1225,1228
7,2,51,1,6,"Var_DeleteLoopVar@1231-1237@usr.bin/make/var.c","usr.bin/make/var.c","Var_DeleteLoopVar",1231,1237
60,15,367,4,78,"Var_SubstVar@1240-1318@usr.bin/make/var.c","usr.bin/make/var.c","Var_SubstVar",1240,1318
11,1,62,0,12,"set_magic_shell_variable@1325-1337@usr.bin/make/var.c","usr.bin/make/var.c","set_magic_shell_variable",1325,1337
9,1,42,1,11,"Var_Init@1344-1355@usr.bin/make/var.c","usr.bin/make/var.c","Var_Init",1344,1355
6,2,19,1,5,"interpret@1361-1366@usr.bin/make/var.c","usr.bin/make/var.c","interpret",1361,1366
5,2,41,1,4,"print_var@1370-1374@usr.bin/make/var.c","usr.bin/make/var.c","print_var",1370,1374
33,5,221,1,57,"Var_Dump@1378-1435@usr.bin/make/var.c","usr.bin/make/var.c","Var_Dump",1378,1435
24,5,164,1,30,"Var_AddCmdline@1443-1473@usr.bin/make/var.c","usr.bin/make/var.c","Var_AddCmdline",1443,1473
33,8,226,0,32,"VarModifiers_Init@211-243@usr.bin/make/varmodifiers.c","usr.bin/make/varmodifiers.c","VarModifiers_Init",211,243
16,4,93,4,17,"VarHead@257-274@usr.bin/make/varmodifiers.c","usr.bin/make/varmodifiers.c","VarHead",257,274
12,3,85,4,12,"VarTail@284-296@usr.bin/make/varmodifiers.c","usr.bin/make/varmodifiers.c","VarTail",284,296
12,3,77,4,12,"VarSuffix@305-317@usr.bin/make/varmodifiers.c","usr.bin/make/varmodifiers.c","VarSuffix",305,317
12,3,83,4,12,"VarRoot@327-339@usr.bin/make/varmodifiers.c","usr.bin/make/varmodifiers.c","VarRoot",327,339
12,3,79,4,12,"VarMatch@348-360@usr.bin/make/varmodifiers.c","usr.bin/make/varmodifiers.c","VarMatch",348,360
12,3,80,4,12,"VarNoMatch@369-381@usr.bin/make/varmodifiers.c","usr.bin/make/varmodifiers.c","VarNoMatch",369,381
14,5,118,4,15,"VarUniq@384-399@usr.bin/make/varmodifiers.c","usr.bin/make/varmodifiers.c","VarUniq",384,399
8,2,55,4,8,"VarLoop@402-410@usr.bin/make/varmodifiers.c","usr.bin/make/varmodifiers.c","VarLoop",402,410
5,1,39,3,5,"finish_loop@413-418@usr.bin/make/varmodifiers.c","usr.bin/make/varmodifiers.c","finish_loop",413,418
24,5,148,2,24,"NameCompare@421-445@usr.bin/make/varmodifiers.c","usr.bin/make/varmodifiers.c","NameCompare",421,445
36,6,262,3,38,"do_sort@448-486@usr.bin/make/varmodifiers.c","usr.bin/make/varmodifiers.c","do_sort",448,486
4,1,33,3,3,"do_label@489-492@usr.bin/make/varmodifiers.c","usr.bin/make/varmodifiers.c","do_label",489,492
9,2,67,3,9,"do_path@495-504@usr.bin/make/varmodifiers.c","usr.bin/make/varmodifiers.c","do_path",495,504
9,2,48,3,8,"do_def@507-515@usr.bin/make/varmodifiers.c","usr.bin/make/varmodifiers.c","do_def",507,515
9,2,48,3,8,"do_undef@518-526@usr.bin/make/varmodifiers.c","usr.bin/make/varmodifiers.c","do_undef",518,526
30,8,185,3,31,"do_assign@529-560@usr.bin/make/varmodifiers.c","usr.bin/make/varmodifiers.c","do_assign",529,560
10,2,65,3,10,"do_exec@563-573@usr.bin/make/varmodifiers.c","usr.bin/make/varmodifiers.c","do_exec",563,573
16,4,109,4,16,"VarSYSVMatch@583-599@usr.bin/make/varmodifiers.c","usr.bin/make/varmodifiers.c","VarSYSVMatch",583,599
77,22,460,4,79,"get_sysvpattern@602-681@usr.bin/make/varmodifiers.c","usr.bin/make/varmodifiers.c","get_sysvpattern",602,681
88,27,599,4,120,"VarSubstitute@692-812@usr.bin/make/varmodifiers.c","usr.bin/make/varmodifiers.c","VarSubstitute",692,812
10,1,68,3,10,"VarREError@821-831@usr.bin/make/varmodifiers.c","usr.bin/make/varmodifiers.c","VarREError",821,831
99,23,592,4,114,"VarRESubstitute@841-955@usr.bin/make/varmodifiers.c","usr.bin/make/varmodifiers.c","VarRESubstitute",841,955
19,2,143,3,25,"VarModify@968-993@usr.bin/make/varmodifiers.c","usr.bin/make/varmodifiers.c","VarModify",968,993
41,13,278,7,59,"VarGetPattern@1012-1071@usr.bin/make/varmodifiers.c","usr.bin/make/varmodifiers.c","VarGetPattern",1012,1071
17,4,112,3,19,"VarQuote@1083-1102@usr.bin/make/varmodifiers.c","usr.bin/make/varmodifiers.c","VarQuote",1083,1102
9,3,64,4,8,"check_empty@1105-1113@usr.bin/make/varmodifiers.c","usr.bin/make/varmodifiers.c","check_empty",1105,1113
16,4,107,4,15,"check_quote@1116-1131@usr.bin/make/varmodifiers.c","usr.bin/make/varmodifiers.c","check_quote",1116,1131
8,4,71,4,7,"check_shcmd@1134-1141@usr.bin/make/varmodifiers.c","usr.bin/make/varmodifiers.c","check_shcmd",1134,1141
9,2,53,3,9,"do_shcmd@1145-1154@usr.bin/make/varmodifiers.c","usr.bin/make/varmodifiers.c","do_shcmd",1145,1154
15,8,122,4,15,"get_stringarg@1157-1172@usr.bin/make/varmodifiers.c","usr.bin/make/varmodifiers.c","get_stringarg",1157,1172
4,1,13,1,3,"free_stringarg@1175-1178@usr.bin/make/varmodifiers.c","usr.bin/make/varmodifiers.c","free_stringarg",1175,1178
11,2,82,3,11,"do_upper@1181-1192@usr.bin/make/varmodifiers.c","usr.bin/make/varmodifiers.c","do_upper",1181,1192
11,2,82,3,11,"do_lower@1195-1206@usr.bin/make/varmodifiers.c","usr.bin/make/varmodifiers.c","do_lower",1195,1206
4,1,33,4,3,"get_patternarg@1209-1212@usr.bin/make/varmodifiers.c","usr.bin/make/varmodifiers.c","get_patternarg",1209,1212
17,5,112,4,17,"get_spatternarg@1216-1233@usr.bin/make/varmodifiers.c","usr.bin/make/varmodifiers.c","get_spatternarg",1216,1233
6,1,29,1,6,"free_looparg@1236-1242@usr.bin/make/varmodifiers.c","usr.bin/make/varmodifiers.c","free_looparg",1236,1242
13,4,75,1,13,"LoopGrab@1245-1258@usr.bin/make/varmodifiers.c","usr.bin/make/varmodifiers.c","LoopGrab",1245,1258
21,4,129,4,22,"get_loop@1261-1283@usr.bin/make/varmodifiers.c","usr.bin/make/varmodifiers.c","get_loop",1261,1283
41,10,233,5,46,"common_get_patternarg@1286-1332@usr.bin/make/varmodifiers.c","usr.bin/make/varmodifiers.c","common_get_patternarg",1286,1332
23,9,154,4,24,"assign_get_value@1335-1359@usr.bin/make/varmodifiers.c","usr.bin/make/varmodifiers.c","assign_get_value",1335,1359
16,3,114,4,16,"get_value@1362-1378@usr.bin/make/varmodifiers.c","usr.bin/make/varmodifiers.c","get_value",1362,1378
16,2,107,4,16,"get_cmd@1381-1397@usr.bin/make/varmodifiers.c","usr.bin/make/varmodifiers.c","get_cmd",1381,1397
7,1,33,1,7,"free_patternarg@1400-1407@usr.bin/make/varmodifiers.c","usr.bin/make/varmodifiers.c","free_patternarg",1400,1407
24,4,181,3,24,"do_regex@1410-1434@usr.bin/make/varmodifiers.c","usr.bin/make/varmodifiers.c","do_regex",1410,1434
73,27,456,7,101,"VarModifiers_Apply@1437-1538@usr.bin/make/varmodifiers.c","usr.bin/make/varmodifiers.c","VarModifiers_Apply",1437,1538
4,1,18,1,3,"Var_GetHead@1541-1544@usr.bin/make/varmodifiers.c","usr.bin/make/varmodifiers.c","Var_GetHead",1541,1544
4,1,18,1,3,"Var_GetTail@1547-1550@usr.bin/make/varmodifiers.c","usr.bin/make/varmodifiers.c","Var_GetTail",1547,1550
33,6,213,5,34,"VarName_Get@35-69@usr.bin/make/varname.c","usr.bin/make/varname.c","VarName_Get",35,69
5,2,26,1,4,"VarName_Free@72-76@usr.bin/make/varname.c","usr.bin/make/varname.c","VarName_Free",72,76
18,1,110,1,19,"mdoc_a2att@30-49@usr.bin/mandoc/att.c","usr.bin/mandoc/att.c","mdoc_a2att",30,49
20,5,66,1,20,"html_putchar@135-155@usr.bin/mandoc/cgi.c","usr.bin/mandoc/cgi.c","html_putchar",135,155
7,3,31,1,7,"html_print@162-169@usr.bin/mandoc/cgi.c","usr.bin/mandoc/cgi.c","html_print",162,169
10,2,50,2,10,"set_query_attr@176-186@usr.bin/mandoc/cgi.c","usr.bin/mandoc/cgi.c","set_query_attr",176,186
55,18,392,2,83,"parse_query_string@193-276@usr.bin/mandoc/cgi.c","usr.bin/mandoc/cgi.c","parse_query_string",193,276
25,8,159,1,28,"http_decode@284-312@usr.bin/mandoc/cgi.c","usr.bin/mandoc/cgi.c","http_decode",284,312
10,2,40,2,12,"resp_begin_http@315-327@usr.bin/mandoc/cgi.c","usr.bin/mandoc/cgi.c","resp_begin_http",315,327
12,3,78,1,12,"resp_copy@330-342@usr.bin/mandoc/cgi.c","usr.bin/mandoc/cgi.c","resp_copy",330,342
26,4,130,3,28,"resp_begin_html@345-373@usr.bin/mandoc/cgi.c","usr.bin/mandoc/cgi.c","resp_begin_html",345,373
6,1,18,1,7,"resp_end_html@376-383@usr.bin/mandoc/cgi.c","usr.bin/mandoc/cgi.c","resp_end_html",376,383
58,13,364,2,74,"resp_searchform@386-460@usr.bin/mandoc/cgi.c","usr.bin/mandoc/cgi.c","resp_searchform",386,460
11,7,62,1,11,"validate_urifrag@463-474@usr.bin/mandoc/cgi.c","usr.bin/mandoc/cgi.c","validate_urifrag",463,474
8,3,54,2,9,"validate_manpath@477-486@usr.bin/mandoc/cgi.c","usr.bin/mandoc/cgi.c","validate_manpath",477,486
7,6,67,1,8,"validate_filename@489-497@usr.bin/mandoc/cgi.c","usr.bin/mandoc/cgi.c","validate_filename",489,497
15,3,63,1,15,"pg_index@500-515@usr.bin/mandoc/cgi.c","usr.bin/mandoc/cgi.c","pg_index",500,515
9,1,50,2,8,"pg_noresult@518-526@usr.bin/mandoc/cgi.c","usr.bin/mandoc/cgi.c","pg_noresult",518,526
11,1,42,1,11,"pg_error_badrequest@529-540@usr.bin/mandoc/cgi.c","usr.bin/mandoc/cgi.c","pg_error_badrequest",529,540
6,1,24,1,5,"pg_error_internal@543-548@usr.bin/mandoc/cgi.c","usr.bin/mandoc/cgi.c","pg_error_internal",543,548
15,5,118,2,14,"pg_redirect@551-565@usr.bin/mandoc/cgi.c","usr.bin/mandoc/cgi.c","pg_redirect",551,565
92,27,587,3,107,"pg_searchres@568-675@usr.bin/mandoc/cgi.c","usr.bin/mandoc/cgi.c","pg_searchres",568,675
95,51,680,2,134,"resp_catman@678-812@usr.bin/mandoc/cgi.c","usr.bin/mandoc/cgi.c","resp_catman",678,812
46,7,310,2,52,"resp_format@815-867@usr.bin/mandoc/cgi.c","usr.bin/mandoc/cgi.c","resp_format",815,867
9,4,57,2,10,"resp_show@870-880@usr.bin/mandoc/cgi.c","usr.bin/mandoc/cgi.c","resp_show",870,880
34,5,164,2,44,"pg_show@883-927@usr.bin/mandoc/cgi.c","usr.bin/mandoc/cgi.c","pg_show",883,927
63,17,427,1,78,"pg_search@930-1008@usr.bin/mandoc/cgi.c","usr.bin/mandoc/cgi.c","pg_search",930,1008
67,19,473,1,98,"main@1011-1109@usr.bin/mandoc/cgi.c","usr.bin/mandoc/cgi.c","main",1011,1109
57,15,472,2,71,"parse_path_info@1115-1186@usr.bin/mandoc/cgi.c","usr.bin/mandoc/cgi.c","parse_path_info",1115,1186
41,7,242,1,44,"parse_manpath_conf@1192-1236@usr.bin/mandoc/cgi.c","usr.bin/mandoc/cgi.c","parse_manpath_conf",1192,1236
4,1,12,1,4,"mchars_free@433-437@usr.bin/mandoc/chars.c","usr.bin/mandoc/chars.c","mchars_free",433,437
11,2,95,1,11,"mchars_alloc@440-451@usr.bin/mandoc/chars.c","usr.bin/mandoc/chars.c","mchars_alloc",440,451
8,3,71,2,8,"mchars_spec2cp@454-462@usr.bin/mandoc/chars.c","usr.bin/mandoc/chars.c","mchars_spec2cp",454,462
6,3,40,2,6,"mchars_num2char@465-471@usr.bin/mandoc/chars.c","usr.bin/mandoc/chars.c","mchars_num2char",465,471
7,2,40,2,7,"mchars_num2uc@474-481@usr.bin/mandoc/chars.c","usr.bin/mandoc/chars.c","mchars_num2uc",474,481
13,3,89,3,14,"mchars_spec2str@484-498@usr.bin/mandoc/chars.c","usr.bin/mandoc/chars.c","mchars_spec2str",484,498
8,3,56,1,8,"mchars_uc2str@501-509@usr.bin/mandoc/chars.c","usr.bin/mandoc/chars.c","mchars_uc2str",501,509
16,2,108,1,16,"dba_new@56-72@usr.bin/mandoc/dba.c","usr.bin/mandoc/dba.c","dba_new",56,72
28,2,179,1,30,"dba_free@75-105@usr.bin/mandoc/dba.c","usr.bin/mandoc/dba.c","dba_free",75,105
25,3,134,2,25,"dba_write@116-141@usr.bin/mandoc/dba.c","usr.bin/mandoc/dba.c","dba_write",116,141
22,3,178,5,22,"dba_page_new@150-172@usr.bin/mandoc/dba.c","usr.bin/mandoc/dba.c","dba_page_new",150,172
24,9,135,3,24,"dba_page_add@180-204@usr.bin/mandoc/dba.c","usr.bin/mandoc/dba.c","dba_page_add",180,204
17,3,95,3,17,"dba_page_alias@210-227@usr.bin/mandoc/dba.c","usr.bin/mandoc/dba.c","dba_page_alias",210,227
14,2,79,2,14,"prepend@233-247@usr.bin/mandoc/dba.c","usr.bin/mandoc/dba.c","prepend",233,247
39,2,254,1,39,"dba_pages_write@263-302@usr.bin/mandoc/dba.c","usr.bin/mandoc/dba.c","dba_pages_write",263,302
9,2,73,2,9,"compare_names@305-314@usr.bin/mandoc/dba.c","usr.bin/mandoc/dba.c","compare_names",305,314
7,1,54,2,7,"compare_strings@317-324@usr.bin/mandoc/dba.c","usr.bin/mandoc/dba.c","compare_strings",317,324
15,2,112,3,15,"get_macro_entry@333-348@usr.bin/mandoc/dba.c","usr.bin/mandoc/dba.c","get_macro_entry",333,348
14,3,114,4,15,"dba_macro_new@356-371@usr.bin/mandoc/dba.c","usr.bin/mandoc/dba.c","dba_macro_new",356,371
9,2,61,4,9,"dba_macro_add@378-387@usr.bin/mandoc/dba.c","usr.bin/mandoc/dba.c","dba_macro_add",378,387
15,1,80,1,15,"dba_macros_write@396-411@usr.bin/mandoc/dba.c","usr.bin/mandoc/dba.c","dba_macros_write",396,411
48,8,351,1,66,"dba_macro_write@424-490@usr.bin/mandoc/dba.c","usr.bin/mandoc/dba.c","dba_macro_write",424,490
7,1,61,2,7,"compare_entries@493-500@usr.bin/mandoc/dba.c","usr.bin/mandoc/dba.c","compare_entries",493,500
15,1,110,2,15,"dba_array_new@42-57@usr.bin/mandoc/dba_array.c","usr.bin/mandoc/dba_array.c","dba_array_new",42,57
12,4,72,1,12,"dba_array_free@60-72@usr.bin/mandoc/dba_array.c","usr.bin/mandoc/dba_array.c","dba_array_free",60,72
12,3,87,3,11,"dba_array_set@75-86@usr.bin/mandoc/dba_array.c","usr.bin/mandoc/dba_array.c","dba_array_set",75,86
12,2,101,2,11,"dba_array_add@89-100@usr.bin/mandoc/dba_array.c","usr.bin/mandoc/dba_array.c","dba_array_add",89,100
6,4,45,2,5,"dba_array_get@103-108@usr.bin/mandoc/dba_array.c","usr.bin/mandoc/dba_array.c","dba_array_get",103,108
4,1,17,1,3,"dba_array_start@111-114@usr.bin/mandoc/dba_array.c","usr.bin/mandoc/dba_array.c","dba_array_start",111,114
10,5,78,1,9,"dba_array_next@117-126@usr.bin/mandoc/dba_array.c","usr.bin/mandoc/dba_array.c","dba_array_next",117,126
7,3,50,1,6,"dba_array_del@129-135@usr.bin/mandoc/dba_array.c","usr.bin/mandoc/dba_array.c","dba_array_del",129,135
4,1,30,1,3,"dba_array_undel@138-141@usr.bin/mandoc/dba_array.c","usr.bin/mandoc/dba_array.c","dba_array_undel",138,141
4,1,24,3,3,"dba_array_setpos@144-147@usr.bin/mandoc/dba_array.c","usr.bin/mandoc/dba_array.c","dba_array_setpos",144,147
4,1,14,1,3,"dba_array_getpos@150-153@usr.bin/mandoc/dba_array.c","usr.bin/mandoc/dba_array.c","dba_array_getpos",150,153
5,1,42,2,4,"dba_array_sort@156-160@usr.bin/mandoc/dba_array.c","usr.bin/mandoc/dba_array.c","dba_array_sort",156,160
5,1,37,2,4,"dba_array_writelen@163-167@usr.bin/mandoc/dba_array.c","usr.bin/mandoc/dba_array.c","dba_array_writelen",163,167
8,3,57,1,8,"dba_array_writepos@170-178@usr.bin/mandoc/dba_array.c","usr.bin/mandoc/dba_array.c","dba_array_writepos",170,178
7,1,30,1,7,"dba_array_writelst@181-188@usr.bin/mandoc/dba_array.c","usr.bin/mandoc/dba_array.c","dba_array_writelst",181,188
36,11,327,1,36,"dba_read@36-72@usr.bin/mandoc/dba_read.c","usr.bin/mandoc/dba_read.c","dba_read",36,72
5,2,28,1,4,"dba_open@34-38@usr.bin/mandoc/dba_write.c","usr.bin/mandoc/dba_write.c","dba_open",34,38
4,2,19,1,3,"dba_close@41-44@usr.bin/mandoc/dba_write.c","usr.bin/mandoc/dba_write.c","dba_close",41,44
11,3,54,1,11,"dba_tell@47-58@usr.bin/mandoc/dba_write.c","usr.bin/mandoc/dba_write.c","dba_tell",47,58
5,2,30,1,4,"dba_seek@61-65@usr.bin/mandoc/dba_write.c","usr.bin/mandoc/dba_write.c","dba_seek",61,65
10,2,34,1,10,"dba_align@68-78@usr.bin/mandoc/dba_write.c","usr.bin/mandoc/dba_write.c","dba_align",68,78
13,3,106,2,13,"dba_skip@81-94@usr.bin/mandoc/dba_write.c","usr.bin/mandoc/dba_write.c","dba_skip",81,94
5,2,25,1,4,"dba_char_write@97-101@usr.bin/mandoc/dba_write.c","usr.bin/mandoc/dba_write.c","dba_char_write",97,101
6,2,32,1,5,"dba_str_write@104-109@usr.bin/mandoc/dba_write.c","usr.bin/mandoc/dba_write.c","dba_str_write",104,109
6,2,40,1,5,"dba_int_write@112-117@usr.bin/mandoc/dba_write.c","usr.bin/mandoc/dba_write.c","dba_int_write",112,117
36,7,219,1,39,"dbm_open@76-115@usr.bin/mandoc/dbm.c","usr.bin/mandoc/dbm.c","dbm_open",76,115
4,1,10,1,3,"dbm_close@118-121@usr.bin/mandoc/dbm.c","usr.bin/mandoc/dbm.c","dbm_close",118,121
4,1,9,1,3,"dbm_page_count@127-130@usr.bin/mandoc/dbm.c","usr.bin/mandoc/dbm.c","dbm_page_count",127,130
21,6,176,1,21,"dbm_page_get@136-157@usr.bin/mandoc/dbm.c","usr.bin/mandoc/dbm.c","dbm_page_get",136,157
5,1,24,1,4,"dbm_page_byname@163-167@usr.bin/mandoc/dbm.c","usr.bin/mandoc/dbm.c","dbm_page_byname",163,167
5,1,24,1,4,"dbm_page_bysect@170-174@usr.bin/mandoc/dbm.c","usr.bin/mandoc/dbm.c","dbm_page_bysect",170,174
5,1,22,1,4,"dbm_page_byarch@177-181@usr.bin/mandoc/dbm.c","usr.bin/mandoc/dbm.c","dbm_page_byarch",177,181
5,1,24,1,4,"dbm_page_bydesc@184-188@usr.bin/mandoc/dbm.c","usr.bin/mandoc/dbm.c","dbm_page_bydesc",184,188
7,1,41,2,6,"dbm_page_bymacro@191-197@usr.bin/mandoc/dbm.c","usr.bin/mandoc/dbm.c","dbm_page_bymacro",191,197
14,4,59,1,14,"dbm_page_next@203-217@usr.bin/mandoc/dbm.c","usr.bin/mandoc/dbm.c","dbm_page_next",203,217
62,19,320,2,77,"page_bytitle@223-300@usr.bin/mandoc/dbm.c","usr.bin/mandoc/dbm.c","page_bytitle",223,300
25,6,141,1,33,"page_byarch@303-336@usr.bin/mandoc/dbm.c","usr.bin/mandoc/dbm.c","page_byarch",303,336
33,9,215,2,42,"page_bymacro@339-381@usr.bin/mandoc/dbm.c","usr.bin/mandoc/dbm.c","page_bymacro",339,381
6,1,27,1,5,"dbm_macro_count@387-392@usr.bin/mandoc/dbm.c","usr.bin/mandoc/dbm.c","dbm_macro_count",387,392
11,1,84,2,11,"dbm_macro_get@395-406@usr.bin/mandoc/dbm.c","usr.bin/mandoc/dbm.c","dbm_macro_get",395,406
7,1,38,2,6,"dbm_macro_bypage@412-418@usr.bin/mandoc/dbm.c","usr.bin/mandoc/dbm.c","dbm_macro_bypage",412,418
4,1,14,1,3,"dbm_macro_next@421-424@usr.bin/mandoc/dbm.c","usr.bin/mandoc/dbm.c","dbm_macro_next",421,424
31,10,167,2,43,"macro_bypage@427-470@usr.bin/mandoc/dbm.c","usr.bin/mandoc/dbm.c","macro_bypage",427,470
64,12,357,1,65,"dbm_map@50-115@usr.bin/mandoc/dbm_map.c","usr.bin/mandoc/dbm_map.c","dbm_map",50,115
8,3,49,1,7,"dbm_unmap@118-125@usr.bin/mandoc/dbm_map.c","usr.bin/mandoc/dbm_map.c","dbm_unmap",118,125
14,3,57,1,13,"dbm_get@133-146@usr.bin/mandoc/dbm_map.c","usr.bin/mandoc/dbm_map.c","dbm_get",133,146
4,1,16,1,3,"dbm_getint@154-157@usr.bin/mandoc/dbm_map.c","usr.bin/mandoc/dbm_map.c","dbm_getint",154,157
4,1,22,1,3,"dbm_addr@166-169@usr.bin/mandoc/dbm_map.c","usr.bin/mandoc/dbm_map.c","dbm_addr",166,169
13,4,80,2,12,"dbm_match@172-184@usr.bin/mandoc/dbm_map.c","usr.bin/mandoc/dbm_map.c","dbm_match",172,184
8,1,42,1,8,"eqn_alloc@296-304@usr.bin/mandoc/eqn.c","usr.bin/mandoc/eqn.c","eqn_alloc",296,304
6,1,40,1,5,"eqn_reset@307-312@usr.bin/mandoc/eqn.c","usr.bin/mandoc/eqn.c","eqn_reset",307,312
13,2,86,2,13,"eqn_read@315-328@usr.bin/mandoc/eqn.c","usr.bin/mandoc/eqn.c","eqn_read",315,328
9,4,82,1,10,"eqn_def_find@334-344@usr.bin/mandoc/eqn.c","usr.bin/mandoc/eqn.c","eqn_def_find",334,344
88,28,691,2,97,"eqn_next@367-464@usr.bin/mandoc/eqn.c","usr.bin/mandoc/eqn.c","eqn_next",367,464
13,3,75,1,14,"eqn_box_free@467-481@usr.bin/mandoc/eqn.c","usr.bin/mandoc/eqn.c","eqn_box_free",467,481
17,2,111,2,19,"eqn_box_alloc@487-506@usr.bin/mandoc/eqn.c","usr.bin/mandoc/eqn.c","eqn_box_alloc",487,506
19,2,126,2,19,"eqn_box_makebinary@515-534@usr.bin/mandoc/eqn.c","usr.bin/mandoc/eqn.c","eqn_box_makebinary",515,534
20,8,169,1,19,"eqn_delim@540-559@usr.bin/mandoc/eqn.c","usr.bin/mandoc/eqn.c","eqn_delim",540,559
15,3,101,1,15,"eqn_undef@565-580@usr.bin/mandoc/eqn.c","usr.bin/mandoc/eqn.c","eqn_undef",565,580
37,7,306,1,46,"eqn_def@583-629@usr.bin/mandoc/eqn.c","usr.bin/mandoc/eqn.c","eqn_def",583,629
398,148,2329,1,454,"eqn_parse@632-1086@usr.bin/mandoc/eqn.c","usr.bin/mandoc/eqn.c","eqn_parse",632,1086
11,2,75,1,12,"eqn_free@1089-1101@usr.bin/mandoc/eqn.c","usr.bin/mandoc/eqn.c","eqn_free",1089,1101
173,71,1195,2,194,"eqn_box@31-225@usr.bin/mandoc/eqn_html.c","usr.bin/mandoc/eqn_html.c","eqn_box",31,225
11,2,69,2,14,"print_eqn@228-242@usr.bin/mandoc/eqn_html.c","usr.bin/mandoc/eqn_html.c","print_eqn",228,242
5,1,28,2,5,"term_eqn@42-47@usr.bin/mandoc/eqn_term.c","usr.bin/mandoc/eqn_term.c","term_eqn",42,47
105,66,831,2,122,"eqn_box@50-172@usr.bin/mandoc/eqn_term.c","usr.bin/mandoc/eqn_term.c","eqn_box",50,172
12,2,73,1,14,"html_alloc@131-145@usr.bin/mandoc/html.c","usr.bin/mandoc/html.c","html_alloc",131,145
11,2,59,1,13,"html_free@148-161@usr.bin/mandoc/html.c","usr.bin/mandoc/html.c","html_free",148,161
17,2,119,1,23,"print_gen_head@164-187@usr.bin/mandoc/html.c","usr.bin/mandoc/html.c","print_gen_head",164,187
44,11,189,2,47,"print_metaf@190-237@usr.bin/mandoc/html.c","usr.bin/mandoc/html.c","print_metaf",190,237
16,6,102,1,21,"html_make_id@240-261@usr.bin/mandoc/html.c","usr.bin/mandoc/html.c","html_make_id",240,261
40,12,141,1,48,"html_strlen@264-312@usr.bin/mandoc/html.c","usr.bin/mandoc/html.c","html_strlen",264,312
28,8,103,2,28,"print_escape@315-343@usr.bin/mandoc/html.c","usr.bin/mandoc/html.c","print_escape",315,343
104,43,577,4,117,"print_encode@346-463@usr.bin/mandoc/html.c","usr.bin/mandoc/html.c","print_encode",346,463
21,11,184,4,21,"print_href@466-487@usr.bin/mandoc/html.c","usr.bin/mandoc/html.c","print_href",466,487
202,53,1092,4,238,"print_otag@490-728@usr.bin/mandoc/html.c","usr.bin/mandoc/html.c","print_otag",490,728
24,7,153,2,31,"print_ctag@731-762@usr.bin/mandoc/html.c","usr.bin/mandoc/html.c","print_ctag",731,762
5,1,21,1,4,"print_gen_decls@765-769@usr.bin/mandoc/html.c","usr.bin/mandoc/html.c","print_gen_decls",765,769
39,11,243,2,42,"print_text@772-814@usr.bin/mandoc/html.c","usr.bin/mandoc/html.c","print_text",772,814
9,4,51,2,9,"print_tagq@817-826@usr.bin/mandoc/html.c","usr.bin/mandoc/html.c","print_tagq",817,826
9,4,51,2,9,"print_stagq@829-838@usr.bin/mandoc/html.c","usr.bin/mandoc/html.c","print_stagq",829,838
6,1,34,1,6,"print_paragraph@841-847@usr.bin/mandoc/html.c","usr.bin/mandoc/html.c","print_paragraph",841,847
22,3,149,2,23,"print_byte@861-884@usr.bin/mandoc/html.c","usr.bin/mandoc/html.c","print_byte",861,884
14,3,76,1,14,"print_endline@891-905@usr.bin/mandoc/html.c","usr.bin/mandoc/html.c","print_endline",891,905
16,4,96,1,16,"print_endword@912-928@usr.bin/mandoc/html.c","usr.bin/mandoc/html.c","print_endword",912,928
12,4,66,1,13,"print_indent@937-950@usr.bin/mandoc/html.c","usr.bin/mandoc/html.c","print_indent",937,950
5,2,30,2,4,"print_word@957-961@usr.bin/mandoc/html.c","usr.bin/mandoc/html.c","print_word",957,961
10,4,77,2,10,"a2width@969-979@usr.bin/mandoc/html.c","usr.bin/mandoc/html.c","a2width",969,979
371,120,2112,2,463,"main@112-575@usr.bin/mandoc/main.c","usr.bin/mandoc/main.c","main",112,575
26,5,78,1,26,"usage@578-604@usr.bin/mandoc/main.c","usr.bin/mandoc/main.c","usage",578,604
64,14,463,7,69,"fs_lookup@607-676@usr.bin/mandoc/main.c","usr.bin/mandoc/main.c","fs_lookup",607,676
32,12,256,6,34,"fs_search@679-713@usr.bin/mandoc/main.c","usr.bin/mandoc/main.c","fs_search",679,713
74,31,378,3,88,"parse@716-804@usr.bin/mandoc/main.c","usr.bin/mandoc/main.c","parse",716,804
31,7,228,1,32,"check_xr@807-839@usr.bin/mandoc/main.c","usr.bin/mandoc/main.c","check_xr",807,839
25,7,117,1,24,"outdata_alloc@842-866@usr.bin/mandoc/main.c","usr.bin/mandoc/main.c","outdata_alloc",842,866
62,14,326,3,69,"passthrough@869-938@usr.bin/mandoc/main.c","usr.bin/mandoc/main.c","passthrough",869,938
16,4,95,2,16,"koptions@941-957@usr.bin/mandoc/main.c","usr.bin/mandoc/main.c","koptions",941,957
9,4,53,2,9,"moptions@960-969@usr.bin/mandoc/main.c","usr.bin/mandoc/main.c","moptions",960,969
30,11,220,2,31,"toptions@972-1003@usr.bin/mandoc/main.c","usr.bin/mandoc/main.c","toptions",972,1003
55,12,266,2,56,"woptions@1006-1062@usr.bin/mandoc/main.c","usr.bin/mandoc/main.c","woptions",1006,1062
15,5,123,6,20,"mmsg@1065-1085@usr.bin/mandoc/main.c","usr.bin/mandoc/main.c","mmsg",1065,1085
58,17,411,1,76,"spawn_pager@1088-1164@usr.bin/mandoc/main.c","usr.bin/mandoc/main.c","spawn_pager",1088,1164
8,4,78,4,9,"man_parseln@42-51@usr.bin/mandoc/man.c","usr.bin/mandoc/man.c","man_parseln",42,51
12,3,87,3,17,"man_descope@54-71@usr.bin/mandoc/man.c","usr.bin/mandoc/man.c","man_descope",54,71
57,22,424,4,86,"man_ptext@74-160@usr.bin/mandoc/man.c","usr.bin/mandoc/man.c","man_ptext",74,160
60,22,431,4,104,"man_pmacro@163-267@usr.bin/mandoc/man.c","usr.bin/mandoc/man.c","man_pmacro",163,267
44,18,364,2,68,"man_breakscope@270-338@usr.bin/mandoc/man.c","usr.bin/mandoc/man.c","man_breakscope",270,338
5,2,24,1,5,"man_mparse@341-346@usr.bin/mandoc/man.c","usr.bin/mandoc/man.c","man_mparse",341,346
23,9,137,2,23,"man_state@349-372@usr.bin/mandoc/man.c","usr.bin/mandoc/man.c","man_state",349,372
6,1,28,1,6,"man_validate@375-381@usr.bin/mandoc/man.c","usr.bin/mandoc/man.c","man_validate",375,381
10,7,74,2,12,"print_bvspace@122-134@usr.bin/mandoc/man_html.c","usr.bin/mandoc/man_html.c","print_bvspace",122,134
20,2,173,2,22,"html_man@137-159@usr.bin/mandoc/man_html.c","usr.bin/mandoc/man_html.c","html_man",137,159
9,1,52,1,9,"print_man_head@162-171@usr.bin/mandoc/man_html.c","usr.bin/mandoc/man_html.c","print_man_head",162,171
7,2,29,1,7,"print_man_nodelist@174-181@usr.bin/mandoc/man_html.c","usr.bin/mandoc/man_html.c","print_man_nodelist",174,181
102,42,506,1,148,"print_man_node@184-332@usr.bin/mandoc/man_html.c","usr.bin/mandoc/man_html.c","print_man_node",184,332
16,7,94,2,18,"fillmode@340-358@usr.bin/mandoc/man_html.c","usr.bin/mandoc/man_html.c","fillmode",340,358
6,2,40,2,5,"a2width@361-366@usr.bin/mandoc/man_html.c","usr.bin/mandoc/man_html.c","a2width",361,366
21,2,162,1,25,"man_root_pre@369-394@usr.bin/mandoc/man_html.c","usr.bin/mandoc/man_html.c","man_root_pre",369,394
13,2,98,1,15,"man_root_post@397-412@usr.bin/mandoc/man_html.c","usr.bin/mandoc/man_html.c","man_root_post",397,412
12,3,67,1,12,"man_SH_pre@415-427@usr.bin/mandoc/man_html.c","usr.bin/mandoc/man_html.c","man_SH_pre",415,427
39,17,205,1,43,"man_alt_pre@430-473@usr.bin/mandoc/man_html.c","usr.bin/mandoc/man_html.c","man_alt_pre",430,473
7,2,35,1,6,"man_SM_pre@476-482@usr.bin/mandoc/man_html.c","usr.bin/mandoc/man_html.c","man_SM_pre",476,482
12,3,67,1,12,"man_SS_pre@485-497@usr.bin/mandoc/man_html.c","usr.bin/mandoc/man_html.c","man_SS_pre",485,497
8,3,36,1,9,"man_PP_pre@500-509@usr.bin/mandoc/man_html.c","usr.bin/mandoc/man_html.c","man_PP_pre",500,509
24,9,159,1,34,"man_IP_pre@512-546@usr.bin/mandoc/man_html.c","usr.bin/mandoc/man_html.c","man_IP_pre",512,546
17,5,116,1,21,"man_HP_pre@549-570@usr.bin/mandoc/man_html.c","usr.bin/mandoc/man_html.c","man_HP_pre",549,570
20,4,133,1,24,"man_OP_pre@573-597@usr.bin/mandoc/man_html.c","usr.bin/mandoc/man_html.c","man_OP_pre",573,597
5,1,18,1,4,"man_B_pre@600-604@usr.bin/mandoc/man_html.c","usr.bin/mandoc/man_html.c","man_B_pre",600,604
5,1,18,1,4,"man_I_pre@607-611@usr.bin/mandoc/man_html.c","usr.bin/mandoc/man_html.c","man_I_pre",607,611
5,1,18,1,4,"man_in_pre@614-618@usr.bin/mandoc/man_html.c","usr.bin/mandoc/man_html.c","man_in_pre",614,618
4,1,9,1,4,"man_ign_pre@621-625@usr.bin/mandoc/man_html.c","usr.bin/mandoc/man_html.c","man_ign_pre",621,625
13,4,76,1,15,"man_RS_pre@628-643@usr.bin/mandoc/man_html.c","usr.bin/mandoc/man_html.c","man_RS_pre",628,643
20,4,147,1,22,"man_UR_pre@646-668@usr.bin/mandoc/man_html.c","usr.bin/mandoc/man_html.c","man_UR_pre",646,668
37,10,248,2,56,"man_unscope@83-139@usr.bin/mandoc/man_macro.c","usr.bin/mandoc/man_macro.c","man_unscope",83,139
31,16,189,2,34,"rew_scope@147-181@usr.bin/mandoc/man_macro.c","usr.bin/mandoc/man_macro.c","rew_scope",147,181
58,21,376,1,64,"blk_close@188-252@usr.bin/mandoc/man_macro.c","usr.bin/mandoc/man_macro.c","blk_close",188,252
26,6,209,1,29,"blk_exp@255-284@usr.bin/mandoc/man_macro.c","usr.bin/mandoc/man_macro.c","blk_exp",255,284
24,8,164,1,37,"blk_imp@293-330@usr.bin/mandoc/man_macro.c","usr.bin/mandoc/man_macro.c","blk_imp",293,330
45,17,335,1,63,"in_line_eoln@333-396@usr.bin/mandoc/man_macro.c","usr.bin/mandoc/man_macro.c","in_line_eoln",333,396
5,1,24,1,5,"man_endparse@399-404@usr.bin/mandoc/man_macro.c","usr.bin/mandoc/man_macro.c","man_endparse",399,404
11,2,81,5,13,"man_args@407-420@usr.bin/mandoc/man_macro.c","usr.bin/mandoc/man_macro.c","man_args",407,420
42,10,311,2,44,"terminal_man@136-180@usr.bin/mandoc/man_term.c","usr.bin/mandoc/man_term.c","terminal_man",136,180
13,8,98,3,16,"print_bvspace@191-207@usr.bin/mandoc/man_term.c","usr.bin/mandoc/man_term.c","print_bvspace",191,207
4,1,9,1,4,"pre_ign@211-215@usr.bin/mandoc/man_term.c","usr.bin/mandoc/man_term.c","pre_ign",211,215
5,1,16,1,5,"pre_I@218-223@usr.bin/mandoc/man_term.c","usr.bin/mandoc/man_term.c","pre_I",218,223
16,5,107,1,24,"pre_literal@226-250@usr.bin/mandoc/man_term.c","usr.bin/mandoc/man_term.c","pre_literal",226,250
13,3,73,1,13,"pre_PD@253-266@usr.bin/mandoc/man_term.c","usr.bin/mandoc/man_term.c","pre_PD",253,266
48,12,266,1,51,"pre_alternate@269-320@usr.bin/mandoc/man_term.c","usr.bin/mandoc/man_term.c","pre_alternate",269,320
5,1,16,1,5,"pre_B@323-328@usr.bin/mandoc/man_term.c","usr.bin/mandoc/man_term.c","pre_B",323,328
17,4,104,1,19,"pre_OP@331-350@usr.bin/mandoc/man_term.c","usr.bin/mandoc/man_term.c","pre_OP",331,350
32,9,197,1,39,"pre_in@353-392@usr.bin/mandoc/man_term.c","usr.bin/mandoc/man_term.c","pre_in",353,392
7,1,30,1,6,"pre_DT@395-401@usr.bin/mandoc/man_term.c","usr.bin/mandoc/man_term.c","pre_DT",395,401
32,9,214,1,37,"pre_HP@404-441@usr.bin/mandoc/man_term.c","usr.bin/mandoc/man_term.c","pre_HP",404,441
16,3,77,1,25,"post_HP@444-469@usr.bin/mandoc/man_term.c","usr.bin/mandoc/man_term.c","post_HP",444,469
13,2,69,1,14,"pre_PP@472-486@usr.bin/mandoc/man_term.c","usr.bin/mandoc/man_term.c","pre_PP",472,486
49,13,307,1,58,"pre_IP@489-547@usr.bin/mandoc/man_term.c","usr.bin/mandoc/man_term.c","pre_IP",489,547
17,3,70,1,17,"post_IP@550-567@usr.bin/mandoc/man_term.c","usr.bin/mandoc/man_term.c","post_IP",550,567
56,17,363,1,67,"pre_TP@570-637@usr.bin/mandoc/man_term.c","usr.bin/mandoc/man_term.c","pre_TP",570,637
14,3,48,1,14,"post_TP@640-654@usr.bin/mandoc/man_term.c","usr.bin/mandoc/man_term.c","post_TP",640,654
35,11,235,1,43,"pre_SS@657-700@usr.bin/mandoc/man_term.c","usr.bin/mandoc/man_term.c","pre_SS",657,700
13,3,38,1,13,"post_SS@703-716@usr.bin/mandoc/man_term.c","usr.bin/mandoc/man_term.c","post_SS",703,716
35,11,230,1,43,"pre_SH@719-762@usr.bin/mandoc/man_term.c","usr.bin/mandoc/man_term.c","pre_SH",719,762
13,3,38,1,13,"post_SH@765-778@usr.bin/mandoc/man_term.c","usr.bin/mandoc/man_term.c","post_SH",765,778
30,9,226,1,34,"pre_RS@781-815@usr.bin/mandoc/man_term.c","usr.bin/mandoc/man_term.c","pre_RS",781,815
16,4,72,1,18,"post_RS@818-836@usr.bin/mandoc/man_term.c","usr.bin/mandoc/man_term.c","post_RS",818,836
4,1,13,1,4,"pre_UR@839-843@usr.bin/mandoc/man_term.c","usr.bin/mandoc/man_term.c","pre_UR",839,843
11,3,67,1,14,"post_UR@846-860@usr.bin/mandoc/man_term.c","usr.bin/mandoc/man_term.c","post_UR",846,860
66,30,494,1,86,"print_man_node@863-949@usr.bin/mandoc/man_term.c","usr.bin/mandoc/man_term.c","print_man_node",863,949
7,2,31,1,7,"print_man_nodelist@953-960@usr.bin/mandoc/man_term.c","usr.bin/mandoc/man_term.c","print_man_nodelist",953,960
47,8,336,2,68,"print_man_foot@963-1031@usr.bin/mandoc/man_term.c","usr.bin/mandoc/man_term.c","print_man_foot",963,1031
44,7,357,2,65,"print_man_head@1034-1099@usr.bin/mandoc/man_term.c","usr.bin/mandoc/man_term.c","print_man_head",1034,1099
47,13,232,1,48,"man_node_validate@97-145@usr.bin/mandoc/man_validate.c","usr.bin/mandoc/man_validate.c","man_node_validate",97,145
22,7,198,1,31,"check_root@148-179@usr.bin/mandoc/man_validate.c","usr.bin/mandoc/man_validate.c","check_root",148,179
10,3,76,1,11,"check_text@182-193@usr.bin/mandoc/man_validate.c","usr.bin/mandoc/man_validate.c","check_text",182,193
11,4,89,1,11,"post_OP@196-207@usr.bin/mandoc/man_validate.c","usr.bin/mandoc/man_validate.c","post_OP",196,207
7,3,51,1,6,"post_UR@210-216@usr.bin/mandoc/man_validate.c","usr.bin/mandoc/man_validate.c","post_UR",210,216
6,3,44,1,6,"check_part@219-225@usr.bin/mandoc/man_validate.c","usr.bin/mandoc/man_validate.c","check_part",219,225
24,8,136,1,24,"check_par@228-252@usr.bin/mandoc/man_validate.c","usr.bin/mandoc/man_validate.c","check_par",228,252
17,7,97,1,17,"post_IP@255-272@usr.bin/mandoc/man_validate.c","usr.bin/mandoc/man_validate.c","post_IP",255,272
71,25,642,1,96,"post_TH@275-371@usr.bin/mandoc/man_validate.c","usr.bin/mandoc/man_validate.c","post_TH",275,371
31,8,192,1,34,"post_UC@374-408@usr.bin/mandoc/man_validate.c","usr.bin/mandoc/man_validate.c","post_UC",374,408
33,9,194,1,36,"post_AT@411-447@usr.bin/mandoc/man_validate.c","usr.bin/mandoc/man_validate.c","post_AT",411,447
13,6,85,1,13,"post_in@450-463@usr.bin/mandoc/man_validate.c","usr.bin/mandoc/man_validate.c","post_in",450,463
20,8,92,1,26,"post_vs@466-492@usr.bin/mandoc/man_validate.c","usr.bin/mandoc/man_validate.c","post_vs",466,492
231,96,1084,3,318,"mandoc_escape@39-357@usr.bin/mandoc/mandoc.c","usr.bin/mandoc/mandoc.c","mandoc_escape",39,357
60,21,339,4,83,"mandoc_getarg@369-452@usr.bin/mandoc/mandoc.c","usr.bin/mandoc/mandoc.c","mandoc_getarg",369,452
12,3,80,3,14,"a2time@455-469@usr.bin/mandoc/mandoc.c","usr.bin/mandoc/mandoc.c","a2time",455,469
23,5,152,1,44,"time2a@472-516@usr.bin/mandoc/mandoc.c","usr.bin/mandoc/mandoc.c","time2a",472,516
25,10,222,4,36,"mandoc_normdate@519-555@usr.bin/mandoc/mandoc.c","usr.bin/mandoc/mandoc.c","mandoc_normdate",519,555
28,14,131,2,36,"mandoc_eos@558-594@usr.bin/mandoc/mandoc.c","usr.bin/mandoc/mandoc.c","mandoc_eos",558,594
19,6,117,3,24,"mandoc_strntoi@601-625@usr.bin/mandoc/mandoc.c","usr.bin/mandoc/mandoc.c","mandoc_strntoi",601,625
11,2,64,3,12,"mandoc_asprintf@30-42@usr.bin/mandoc/mandoc_aux.c","usr.bin/mandoc/mandoc_aux.c","mandoc_asprintf",30,42
8,2,42,2,8,"mandoc_calloc@45-53@usr.bin/mandoc/mandoc_aux.c","usr.bin/mandoc/mandoc_aux.c","mandoc_calloc",45,53
8,2,37,1,8,"mandoc_malloc@56-64@usr.bin/mandoc/mandoc_aux.c","usr.bin/mandoc/mandoc_aux.c","mandoc_malloc",56,64
7,2,39,2,6,"mandoc_realloc@67-73@usr.bin/mandoc/mandoc_aux.c","usr.bin/mandoc/mandoc_aux.c","mandoc_realloc",67,73
7,2,44,3,6,"mandoc_reallocarray@76-82@usr.bin/mandoc/mandoc_aux.c","usr.bin/mandoc/mandoc_aux.c","mandoc_reallocarray",76,82
7,2,49,4,6,"mandoc_recallocarray@85-91@usr.bin/mandoc/mandoc_aux.c","usr.bin/mandoc/mandoc_aux.c","mandoc_recallocarray",85,91
8,2,39,1,8,"mandoc_strdup@94-102@usr.bin/mandoc/mandoc_aux.c","usr.bin/mandoc/mandoc_aux.c","mandoc_strdup",94,102
8,1,47,2,8,"mandoc_strndup@105-113@usr.bin/mandoc/mandoc_aux.c","usr.bin/mandoc/mandoc_aux.c","mandoc_strndup",105,113
10,1,60,3,11,"mandoc_ohash_init@31-42@usr.bin/mandoc/mandoc_ohash.c","usr.bin/mandoc/mandoc_ohash.c","mandoc_ohash_init",31,42
4,1,17,2,4,"hash_alloc@45-49@usr.bin/mandoc/mandoc_ohash.c","usr.bin/mandoc/mandoc_ohash.c","hash_alloc",45,49
4,1,22,3,4,"hash_calloc@52-56@usr.bin/mandoc/mandoc_ohash.c","usr.bin/mandoc/mandoc_ohash.c","hash_calloc",52,56
4,1,17,2,4,"hash_free@59-63@usr.bin/mandoc/mandoc_ohash.c","usr.bin/mandoc/mandoc_ohash.c","hash_free",59,63
11,3,59,1,11,"mandoc_xr_clear@37-48@usr.bin/mandoc/mandoc_xr.c","usr.bin/mandoc/mandoc_xr.c","mandoc_xr_clear",37,48
10,2,49,1,9,"mandoc_xr_reset@51-60@usr.bin/mandoc/mandoc_xr.c","usr.bin/mandoc/mandoc_xr.c","mandoc_xr_reset",51,60
41,5,294,4,44,"mandoc_xr_add@63-107@usr.bin/mandoc/mandoc_xr.c","usr.bin/mandoc/mandoc_xr.c","mandoc_xr_add",63,107
4,1,9,1,3,"mandoc_xr_get@110-113@usr.bin/mandoc/mandoc_xr.c","usr.bin/mandoc/mandoc_xr.c","mandoc_xr_get",110,113
6,1,19,1,5,"mandoc_xr_free@116-121@usr.bin/mandoc/mandoc_xr.c","usr.bin/mandoc/mandoc_xr.c","mandoc_xr_free",116,121
168,45,967,2,215,"mandocdb@297-512@usr.bin/mandoc/mandocdb.c","usr.bin/mandoc/mandocdb.c","mandocdb",297,512
4,1,33,2,3,"fts_compare@519-522@usr.bin/mandoc/mandocdb.c","usr.bin/mandoc/mandocdb.c","fts_compare",519,522
155,51,843,1,188,"treescan@539-727@usr.bin/mandoc/mandocdb.c","usr.bin/mandoc/mandocdb.c","treescan",539,727
92,27,637,1,143,"filescan@744-887@usr.bin/mandoc/mandocdb.c","usr.bin/mandoc/mandocdb.c","filescan",744,887
40,9,357,2,44,"mlink_add@890-934@usr.bin/mandoc/mandocdb.c","usr.bin/mandoc/mandocdb.c","mlink_add",890,934
8,1,42,1,8,"mlink_free@937-945@usr.bin/mandoc/mandocdb.c","usr.bin/mandoc/mandocdb.c","mlink_free",937,945
17,3,94,1,17,"mpages_free@948-965@usr.bin/mandoc/mandocdb.c","usr.bin/mandoc/mandocdb.c","mpages_free",948,965
34,7,223,1,34,"mlinks_undupe@974-1008@usr.bin/mandoc/mandocdb.c","usr.bin/mandoc/mandocdb.c","mlinks_undupe",974,1008
19,6,149,2,54,"mlink_check@1011-1065@usr.bin/mandoc/mandocdb.c","usr.bin/mandoc/mandocdb.c","mlink_check",1011,1065
103,27,748,2,132,"mpages_merge@1075-1207@usr.bin/mandoc/mandocdb.c","usr.bin/mandoc/mandocdb.c","mpages_merge",1075,1207
88,31,619,2,131,"parse_cat@1210-1341@usr.bin/mandoc/mandocdb.c","usr.bin/mandoc/mandocdb.c","parse_cat",1210,1341
4,1,31,3,3,"putkey@1347-1350@usr.bin/mandoc/mandocdb.c","usr.bin/mandoc/mandocdb.c","putkey",1347,1350
12,5,87,4,12,"putmdockey@1356-1368@usr.bin/mandoc/mandocdb.c","usr.bin/mandoc/mandocdb.c","putmdockey",1356,1368
81,31,527,3,122,"parse_man@1371-1493@usr.bin/mandoc/mandocdb.c","usr.bin/mandoc/mandocdb.c","parse_man",1371,1493
29,15,205,3,29,"parse_mdoc@1496-1525@usr.bin/mandoc/mandocdb.c","usr.bin/mandoc/mandocdb.c","parse_mdoc",1496,1525
25,13,182,3,41,"parse_mdoc_Fd@1528-1569@usr.bin/mandoc/mandocdb.c","usr.bin/mandoc/mandocdb.c","parse_mdoc_Fd",1528,1569
14,5,92,2,18,"parse_mdoc_fname@1572-1590@usr.bin/mandoc/mandocdb.c","usr.bin/mandoc/mandocdb.c","parse_mdoc_fname",1572,1590
11,4,83,3,14,"parse_mdoc_Fn@1593-1607@usr.bin/mandoc/mandocdb.c","usr.bin/mandoc/mandocdb.c","parse_mdoc_Fn",1593,1607
9,3,52,3,11,"parse_mdoc_Fo@1610-1621@usr.bin/mandoc/mandocdb.c","usr.bin/mandoc/mandocdb.c","parse_mdoc_Fo",1610,1621
19,9,124,3,22,"parse_mdoc_Va@1624-1646@usr.bin/mandoc/mandocdb.c","usr.bin/mandoc/mandocdb.c","parse_mdoc_Va",1624,1646
15,3,99,3,17,"parse_mdoc_Xr@1649-1666@usr.bin/mandoc/mandocdb.c","usr.bin/mandoc/mandocdb.c","parse_mdoc_Xr",1649,1666
7,2,42,3,7,"parse_mdoc_Nd@1669-1676@usr.bin/mandoc/mandocdb.c","usr.bin/mandoc/mandocdb.c","parse_mdoc_Nd",1669,1676
19,9,152,3,19,"parse_mdoc_Nm@1679-1698@usr.bin/mandoc/mandocdb.c","usr.bin/mandoc/mandocdb.c","parse_mdoc_Nm",1679,1698
5,2,34,3,5,"parse_mdoc_Sh@1701-1706@usr.bin/mandoc/mandocdb.c","usr.bin/mandoc/mandocdb.c","parse_mdoc_Sh",1701,1706
5,1,28,3,5,"parse_mdoc_head@1709-1714@usr.bin/mandoc/mandocdb.c","usr.bin/mandoc/mandocdb.c","parse_mdoc_head",1709,1714
44,12,299,4,49,"putkeys@1722-1771@usr.bin/mandoc/mandocdb.c","usr.bin/mandoc/mandocdb.c","putkeys",1722,1771
42,7,427,2,43,"utf8@1780-1823@usr.bin/mandoc/mandocdb.c","usr.bin/mandoc/mandocdb.c","utf8",1780,1823
82,20,451,2,116,"render_string@1832-1948@usr.bin/mandoc/mandocdb.c","usr.bin/mandoc/mandocdb.c","render_string",1832,1948
8,1,85,1,7,"dbadd_mlink@1951-1958@usr.bin/mandoc/mandocdb.c","usr.bin/mandoc/mandocdb.c","dbadd_mlink",1951,1958
75,21,544,2,80,"dbadd@1965-2045@usr.bin/mandoc/mandocdb.c","usr.bin/mandoc/mandocdb.c","dbadd",1965,2045
19,4,98,1,19,"dbprune@2048-2067@usr.bin/mandoc/mandocdb.c","usr.bin/mandoc/mandocdb.c","dbprune",2048,2067
81,21,549,1,100,"dbwrite@2073-2173@usr.bin/mandoc/mandocdb.c","usr.bin/mandoc/mandocdb.c","dbwrite",2073,2173
53,15,306,2,77,"set_basedir@2176-2253@usr.bin/mandoc/mandocdb.c","usr.bin/mandoc/mandocdb.c","set_basedir",2176,2253
38,15,207,3,39,"say@2256-2295@usr.bin/mandoc/mandocdb.c","usr.bin/mandoc/mandocdb.c","say",2256,2295
36,8,240,4,51,"manconf_parse@41-92@usr.bin/mandoc/manpath.c","usr.bin/mandoc/manpath.c","manconf_parse",41,92
5,1,25,1,4,"manpath_base@95-99@usr.bin/mandoc/manpath.c","usr.bin/mandoc/manpath.c","manpath_base",95,99
8,3,59,3,9,"manpath_parseline@105-114@usr.bin/mandoc/manpath.c","usr.bin/mandoc/manpath.c","manpath_parseline",105,114
23,7,163,3,27,"manpath_add@121-148@usr.bin/mandoc/manpath.c","usr.bin/mandoc/manpath.c","manpath_add",121,148
11,2,86,1,12,"manconf_free@151-163@usr.bin/mandoc/manpath.c","usr.bin/mandoc/manpath.c","manconf_free",151,163
56,20,377,2,63,"manconf_file@166-229@usr.bin/mandoc/manpath.c","usr.bin/mandoc/manpath.c","manconf_file",166,229
98,30,575,3,101,"manconf_output@232-333@usr.bin/mandoc/manpath.c","usr.bin/mandoc/manpath.c","manconf_output",232,333
115,34,798,6,146,"mansearch@82-228@usr.bin/mandoc/mansearch.c","usr.bin/mandoc/mansearch.c","mansearch",82,228
13,4,65,2,12,"manmerge@235-247@usr.bin/mandoc/mansearch.c","usr.bin/mandoc/mansearch.c","manmerge",235,247
47,11,281,2,56,"manmerge_term@250-306@usr.bin/mandoc/mansearch.c","usr.bin/mandoc/mansearch.c","manmerge_term",250,306
8,2,40,2,7,"manmerge_or@309-316@usr.bin/mandoc/mansearch.c","usr.bin/mandoc/mansearch.c","manmerge_or",309,316
49,9,366,2,68,"manmerge_and@319-387@usr.bin/mandoc/mansearch.c","usr.bin/mandoc/mansearch.c","manmerge_and",319,387
10,2,65,2,10,"mansearch_free@390-400@usr.bin/mandoc/mansearch.c","usr.bin/mandoc/mansearch.c","mansearch_free",390,400
22,9,187,2,26,"manpage_compare@403-429@usr.bin/mandoc/mansearch.c","usr.bin/mandoc/mansearch.c","manpage_compare",403,429
20,3,169,1,20,"buildnames@432-452@usr.bin/mandoc/mansearch.c","usr.bin/mandoc/mansearch.c","buildnames",432,452
20,7,95,2,28,"lstlen@460-488@usr.bin/mandoc/mansearch.c","usr.bin/mandoc/mansearch.c","lstlen",460,488
21,8,138,4,30,"lstcat@495-525@usr.bin/mandoc/mansearch.c","usr.bin/mandoc/mansearch.c","lstcat",495,525
11,6,69,2,10,"lstmatch@534-544@usr.bin/mandoc/mansearch.c","usr.bin/mandoc/mansearch.c","lstmatch",534,544
48,9,248,2,50,"buildoutput@550-600@usr.bin/mandoc/mansearch.c","usr.bin/mandoc/mansearch.c","buildoutput",550,600
50,14,292,4,50,"exprcomp@608-658@usr.bin/mandoc/mansearch.c","usr.bin/mandoc/mansearch.c","exprcomp",608,658
53,16,310,4,53,"expr_and@661-714@usr.bin/mandoc/mansearch.c","usr.bin/mandoc/mansearch.c","expr_and",661,714
94,23,674,4,114,"exprterm@717-831@usr.bin/mandoc/mansearch.c","usr.bin/mandoc/mansearch.c","exprterm",717,831
8,3,44,1,7,"exprfree@834-841@usr.bin/mandoc/mansearch.c","usr.bin/mandoc/mansearch.c","exprfree",834,841
12,5,102,4,20,"mdoc_parseln@58-78@usr.bin/mandoc/mdoc.c","usr.bin/mandoc/mdoc.c","mdoc_parseln",58,78
5,2,40,1,4,"mdoc_macro@81-85@usr.bin/mandoc/mdoc.c","usr.bin/mandoc/mdoc.c","mdoc_macro",81,85
7,1,52,4,7,"mdoc_tail_alloc@88-95@usr.bin/mandoc/mdoc.c","usr.bin/mandoc/mdoc.c","mdoc_tail_alloc",88,95
14,1,94,5,14,"mdoc_endbody_alloc@98-112@usr.bin/mandoc/mdoc.c","usr.bin/mandoc/mdoc.c","mdoc_endbody_alloc",98,112
23,7,121,5,24,"mdoc_block_alloc@115-139@usr.bin/mandoc/mdoc.c","usr.bin/mandoc/mdoc.c","mdoc_block_alloc",115,139
18,3,106,5,19,"mdoc_elem_alloc@142-161@usr.bin/mandoc/mdoc.c","usr.bin/mandoc/mdoc.c","mdoc_elem_alloc",142,161
6,1,38,2,6,"mdoc_node_relink@164-170@usr.bin/mandoc/mdoc.c","usr.bin/mandoc/mdoc.c","mdoc_node_relink",164,170
91,41,677,4,137,"mdoc_ptext@177-314@usr.bin/mandoc/mdoc.c","usr.bin/mandoc/mdoc.c","mdoc_ptext",177,314
54,24,395,4,89,"mdoc_pmacro@321-410@usr.bin/mandoc/mdoc.c","usr.bin/mandoc/mdoc.c","mdoc_pmacro",321,410
31,17,133,1,35,"mdoc_isdelim@413-448@usr.bin/mandoc/mdoc.c","usr.bin/mandoc/mdoc.c","mdoc_isdelim",413,448
6,1,27,1,6,"mdoc_validate@451-457@usr.bin/mandoc/mdoc.c","usr.bin/mandoc/mdoc.c","mdoc_validate",451,457
55,17,407,6,95,"mdoc_argv@276-371@usr.bin/mandoc/mdoc_argv.c","usr.bin/mandoc/mdoc_argv.c","mdoc_argv",276,371
16,5,89,1,19,"mdoc_argv_free@374-393@usr.bin/mandoc/mdoc_argv.c","usr.bin/mandoc/mdoc_argv.c","mdoc_argv_free",374,393
13,5,114,2,15,"argn_free@396-411@usr.bin/mandoc/mdoc_argv.c","usr.bin/mandoc/mdoc_argv.c","argn_free",396,411
20,7,139,6,29,"mdoc_args@414-443@usr.bin/mandoc/mdoc_argv.c","usr.bin/mandoc/mdoc_argv.c","mdoc_args",414,443
84,36,656,6,142,"args@446-588@usr.bin/mandoc/mdoc_argv.c","usr.bin/mandoc/mdoc_argv.c","args",446,588
29,15,202,2,41,"args_checkpunct@597-638@usr.bin/mandoc/mdoc_argv.c","usr.bin/mandoc/mdoc_argv.c","args_checkpunct",597,638
17,5,137,5,19,"argv_multi@641-660@usr.bin/mandoc/mdoc_argv.c","usr.bin/mandoc/mdoc_argv.c","argv_multi",641,660
12,2,90,5,13,"argv_single@663-676@usr.bin/mandoc/mdoc_argv.c","usr.bin/mandoc/mdoc_argv.c","argv_single",663,676
29,15,148,2,32,"synopsis_pre@248-280@usr.bin/mandoc/mdoc_html.c","usr.bin/mandoc/mdoc_html.c","synopsis_pre",248,280
20,2,179,2,22,"html_mdoc@283-305@usr.bin/mandoc/mdoc_html.c","usr.bin/mandoc/mdoc_html.c","html_mdoc",283,305
17,5,130,1,19,"print_mdoc_head@308-327@usr.bin/mandoc/mdoc_html.c","usr.bin/mandoc/mdoc_html.c","print_mdoc_head",308,327
7,2,29,1,7,"print_mdoc_nodelist@330-337@usr.bin/mandoc/mdoc_html.c","usr.bin/mandoc/mdoc_html.c","print_mdoc_nodelist",330,337
65,25,418,1,87,"print_mdoc_node@340-427@usr.bin/mandoc/mdoc_html.c","usr.bin/mandoc/mdoc_html.c","print_mdoc_node",340,427
12,1,92,1,14,"mdoc_root_post@430-444@usr.bin/mandoc/mdoc_html.c","usr.bin/mandoc/mdoc_html.c","mdoc_root_post",430,444
29,3,201,1,35,"mdoc_root_pre@447-482@usr.bin/mandoc/mdoc_html.c","usr.bin/mandoc/mdoc_html.c","mdoc_root_pre",447,482
14,10,108,1,13,"cond_id@485-498@usr.bin/mandoc/mdoc_html.c","usr.bin/mandoc/mdoc_html.c","cond_id",485,498
20,5,97,1,20,"mdoc_sh_pre@501-521@usr.bin/mandoc/mdoc_html.c","usr.bin/mandoc/mdoc_html.c","mdoc_sh_pre",501,521
12,3,68,1,13,"mdoc_ss_pre@524-537@usr.bin/mandoc/mdoc_html.c","usr.bin/mandoc/mdoc_html.c","mdoc_ss_pre",524,537
15,6,105,1,17,"mdoc_fl_pre@540-557@usr.bin/mandoc/mdoc_html.c","usr.bin/mandoc/mdoc_html.c","mdoc_fl_pre",540,557
9,2,57,1,9,"mdoc_cm_pre@560-569@usr.bin/mandoc/mdoc_html.c","usr.bin/mandoc/mdoc_html.c","mdoc_cm_pre",560,569
8,2,38,1,10,"mdoc_nd_pre@572-582@usr.bin/mandoc/mdoc_html.c","usr.bin/mandoc/mdoc_html.c","mdoc_nd_pre",572,582
19,4,92,1,19,"mdoc_nm_pre@585-604@usr.bin/mandoc/mdoc_html.c","usr.bin/mandoc/mdoc_html.c","mdoc_nm_pre",585,604
22,5,144,1,25,"mdoc_xr_pre@607-632@usr.bin/mandoc/mdoc_html.c","usr.bin/mandoc/mdoc_html.c","mdoc_xr_pre",607,632
6,2,26,1,6,"mdoc_ns_pre@635-641@usr.bin/mandoc/mdoc_html.c","usr.bin/mandoc/mdoc_html.c","mdoc_ns_pre",635,641
5,1,20,1,4,"mdoc_ar_pre@644-648@usr.bin/mandoc/mdoc_html.c","usr.bin/mandoc/mdoc_html.c","mdoc_ar_pre",644,648
5,1,20,1,4,"mdoc_xx_pre@651-655@usr.bin/mandoc/mdoc_html.c","usr.bin/mandoc/mdoc_html.c","mdoc_xx_pre",651,655
124,39,554,1,127,"mdoc_it_pre@658-785@usr.bin/mandoc/mdoc_html.c","usr.bin/mandoc/mdoc_html.c","mdoc_it_pre",658,785
75,20,466,1,87,"mdoc_bl_pre@788-875@usr.bin/mandoc/mdoc_html.c","usr.bin/mandoc/mdoc_html.c","mdoc_bl_pre",788,875
6,2,24,1,5,"mdoc_ex_pre@878-883@usr.bin/mandoc/mdoc_html.c","usr.bin/mandoc/mdoc_html.c","mdoc_ex_pre",878,883
5,1,20,1,4,"mdoc_st_pre@886-890@usr.bin/mandoc/mdoc_html.c","usr.bin/mandoc/mdoc_html.c","mdoc_st_pre",886,890
5,1,20,1,4,"mdoc_em_pre@893-897@usr.bin/mandoc/mdoc_html.c","usr.bin/mandoc/mdoc_html.c","mdoc_em_pre",893,897
9,3,50,1,11,"mdoc_d1_pre@900-911@usr.bin/mandoc/mdoc_html.c","usr.bin/mandoc/mdoc_html.c","mdoc_d1_pre",900,911
8,1,38,1,8,"mdoc_sx_pre@914-922@usr.bin/mandoc/mdoc_html.c","usr.bin/mandoc/mdoc_html.c","mdoc_sx_pre",914,922
65,31,414,1,85,"mdoc_bd_pre@925-1010@usr.bin/mandoc/mdoc_html.c","usr.bin/mandoc/mdoc_html.c","mdoc_bd_pre",925,1010
5,1,20,1,4,"mdoc_pa_pre@1013-1017@usr.bin/mandoc/mdoc_html.c","usr.bin/mandoc/mdoc_html.c","mdoc_pa_pre",1013,1017
5,1,20,1,4,"mdoc_ad_pre@1020-1024@usr.bin/mandoc/mdoc_html.c","usr.bin/mandoc/mdoc_html.c","mdoc_ad_pre",1020,1024
19,6,118,1,21,"mdoc_an_pre@1027-1048@usr.bin/mandoc/mdoc_html.c","usr.bin/mandoc/mdoc_html.c","mdoc_an_pre",1027,1048
6,1,27,1,5,"mdoc_cd_pre@1051-1056@usr.bin/mandoc/mdoc_html.c","usr.bin/mandoc/mdoc_html.c","mdoc_cd_pre",1051,1056
9,2,57,1,9,"mdoc_dv_pre@1059-1068@usr.bin/mandoc/mdoc_html.c","usr.bin/mandoc/mdoc_html.c","mdoc_dv_pre",1059,1068
9,2,57,1,9,"mdoc_ev_pre@1071-1080@usr.bin/mandoc/mdoc_html.c","usr.bin/mandoc/mdoc_html.c","mdoc_ev_pre",1071,1080
14,6,97,1,15,"mdoc_er_pre@1083-1098@usr.bin/mandoc/mdoc_html.c","usr.bin/mandoc/mdoc_html.c","mdoc_er_pre",1083,1098
23,7,147,1,26,"mdoc_fa_pre@1101-1127@usr.bin/mandoc/mdoc_html.c","usr.bin/mandoc/mdoc_html.c","mdoc_fa_pre",1101,1127
38,11,279,1,48,"mdoc_fd_pre@1130-1178@usr.bin/mandoc/mdoc_html.c","usr.bin/mandoc/mdoc_html.c","mdoc_fd_pre",1130,1178
12,4,70,1,12,"mdoc_vt_pre@1181-1193@usr.bin/mandoc/mdoc_html.c","usr.bin/mandoc/mdoc_html.c","mdoc_vt_pre",1181,1193
6,1,27,1,5,"mdoc_ft_pre@1196-1201@usr.bin/mandoc/mdoc_html.c","usr.bin/mandoc/mdoc_html.c","mdoc_ft_pre",1196,1201
51,8,347,1,63,"mdoc_fn_pre@1204-1267@usr.bin/mandoc/mdoc_html.c","usr.bin/mandoc/mdoc_html.c","mdoc_fn_pre",1204,1267
12,4,69,1,14,"mdoc_sm_pre@1270-1284@usr.bin/mandoc/mdoc_html.c","usr.bin/mandoc/mdoc_html.c","mdoc_sm_pre",1270,1284
4,1,9,1,4,"mdoc_skip_pre@1287-1291@usr.bin/mandoc/mdoc_html.c","usr.bin/mandoc/mdoc_html.c","mdoc_skip_pre",1287,1291
5,1,14,1,5,"mdoc_pp_pre@1294-1299@usr.bin/mandoc/mdoc_html.c","usr.bin/mandoc/mdoc_html.c","mdoc_pp_pre",1294,1299
28,8,183,1,34,"mdoc_lk_pre@1302-1336@usr.bin/mandoc/mdoc_html.c","usr.bin/mandoc/mdoc_html.c","mdoc_lk_pre",1302,1336
14,2,93,1,16,"mdoc_mt_pre@1339-1355@usr.bin/mandoc/mdoc_html.c","usr.bin/mandoc/mdoc_html.c","mdoc_mt_pre",1339,1355
20,4,118,1,22,"mdoc_fo_pre@1358-1380@usr.bin/mandoc/mdoc_html.c","usr.bin/mandoc/mdoc_html.c","mdoc_fo_pre",1358,1380
9,2,42,1,9,"mdoc_fo_post@1383-1392@usr.bin/mandoc/mdoc_html.c","usr.bin/mandoc/mdoc_html.c","mdoc_fo_post",1383,1392
27,6,192,1,42,"mdoc_in_pre@1395-1437@usr.bin/mandoc/mdoc_html.c","usr.bin/mandoc/mdoc_html.c","mdoc_in_pre",1395,1437
9,2,57,1,9,"mdoc_ic_pre@1440-1449@usr.bin/mandoc/mdoc_html.c","usr.bin/mandoc/mdoc_html.c","mdoc_ic_pre",1440,1449
5,1,20,1,4,"mdoc_va_pre@1452-1456@usr.bin/mandoc/mdoc_html.c","usr.bin/mandoc/mdoc_html.c","mdoc_va_pre",1452,1456
7,1,28,1,7,"mdoc_ap_pre@1459-1466@usr.bin/mandoc/mdoc_html.c","usr.bin/mandoc/mdoc_html.c","mdoc_ap_pre",1459,1466
18,6,109,1,25,"mdoc_bf_pre@1469-1494@usr.bin/mandoc/mdoc_html.c","usr.bin/mandoc/mdoc_html.c","mdoc_bf_pre",1469,1494
9,2,57,1,9,"mdoc_ms_pre@1497-1506@usr.bin/mandoc/mdoc_html.c","usr.bin/mandoc/mdoc_html.c","mdoc_ms_pre",1497,1506
5,1,15,1,5,"mdoc_igndelim_pre@1509-1514@usr.bin/mandoc/mdoc_html.c","usr.bin/mandoc/mdoc_html.c","mdoc_igndelim_pre",1509,1514
5,3,31,1,5,"mdoc_pf_post@1517-1522@usr.bin/mandoc/mdoc_html.c","usr.bin/mandoc/mdoc_html.c","mdoc_pf_post",1517,1522
9,4,48,1,10,"mdoc_rs_pre@1525-1535@usr.bin/mandoc/mdoc_html.c","usr.bin/mandoc/mdoc_html.c","mdoc_rs_pre",1525,1535
9,2,57,1,9,"mdoc_no_pre@1538-1547@usr.bin/mandoc/mdoc_html.c","usr.bin/mandoc/mdoc_html.c","mdoc_no_pre",1538,1547
9,2,57,1,9,"mdoc_li_pre@1550-1559@usr.bin/mandoc/mdoc_html.c","usr.bin/mandoc/mdoc_html.c","mdoc_li_pre",1550,1559
5,1,20,1,4,"mdoc_sy_pre@1562-1566@usr.bin/mandoc/mdoc_html.c","usr.bin/mandoc/mdoc_html.c","mdoc_sy_pre",1562,1566
7,4,47,1,7,"mdoc_lb_pre@1569-1576@usr.bin/mandoc/mdoc_html.c","usr.bin/mandoc/mdoc_html.c","mdoc_lb_pre",1569,1576
60,19,236,1,62,"mdoc__x_pre@1579-1641@usr.bin/mandoc/mdoc_html.c","usr.bin/mandoc/mdoc_html.c","mdoc__x_pre",1579,1641
11,11,101,1,15,"mdoc__x_post@1644-1659@usr.bin/mandoc/mdoc_html.c","usr.bin/mandoc/mdoc_html.c","mdoc__x_post",1644,1659
16,6,63,1,17,"mdoc_bk_pre@1662-1679@usr.bin/mandoc/mdoc_html.c","usr.bin/mandoc/mdoc_html.c","mdoc_bk_pre",1662,1679
5,2,24,1,5,"mdoc_bk_post@1682-1687@usr.bin/mandoc/mdoc_html.c","usr.bin/mandoc/mdoc_html.c","mdoc_bk_post",1682,1687
55,25,264,1,56,"mdoc_quote_pre@1690-1746@usr.bin/mandoc/mdoc_html.c","usr.bin/mandoc/mdoc_html.c","mdoc_quote_pre",1690,1746
48,27,232,1,50,"mdoc_quote_post@1749-1799@usr.bin/mandoc/mdoc_html.c","usr.bin/mandoc/mdoc_html.c","mdoc_quote_post",1749,1799
15,11,118,1,16,"mdoc_eo_pre@1802-1818@usr.bin/mandoc/mdoc_html.c","usr.bin/mandoc/mdoc_html.c","mdoc_eo_pre",1802,1818
16,8,101,1,19,"mdoc_eo_post@1821-1840@usr.bin/mandoc/mdoc_html.c","usr.bin/mandoc/mdoc_html.c","mdoc_eo_post",1821,1840
13,5,102,1,19,"mdoc_endparse@211-230@usr.bin/mandoc/mdoc_macro.c","usr.bin/mandoc/mdoc_macro.c","mdoc_endparse",211,230
18,6,116,5,18,"lookup@237-255@usr.bin/mandoc/mdoc_macro.c","usr.bin/mandoc/mdoc_macro.c","lookup",237,255
13,3,89,2,14,"rew_last@261-275@usr.bin/mandoc/mdoc_macro.c","usr.bin/mandoc/mdoc_macro.c","rew_last",261,275
32,11,148,2,35,"rew_pending@281-316@usr.bin/mandoc/mdoc_macro.c","usr.bin/mandoc/mdoc_macro.c","rew_pending",281,316
39,17,115,1,38,"rew_alt@323-361@usr.bin/mandoc/mdoc_macro.c","usr.bin/mandoc/mdoc_macro.c","rew_alt",323,361
10,2,63,2,10,"rew_elem@364-374@usr.bin/mandoc/mdoc_macro.c","usr.bin/mandoc/mdoc_macro.c","rew_elem",364,374
12,8,83,2,11,"break_intermediate@377-388@usr.bin/mandoc/mdoc_macro.c","usr.bin/mandoc/mdoc_macro.c","break_intermediate",377,388
29,9,186,5,30,"find_pending@396-426@usr.bin/mandoc/mdoc_macro.c","usr.bin/mandoc/mdoc_macro.c","find_pending",396,426
21,11,158,6,31,"dword@433-464@usr.bin/mandoc/mdoc_macro.c","usr.bin/mandoc/mdoc_macro.c","dword",433,464
16,5,108,4,30,"append_delims@467-497@usr.bin/mandoc/mdoc_macro.c","usr.bin/mandoc/mdoc_macro.c","append_delims",467,497
24,9,162,2,25,"macro_or_word@505-530@usr.bin/mandoc/mdoc_macro.c","usr.bin/mandoc/mdoc_macro.c","macro_or_word",505,530
133,47,818,1,207,"blk_exp_close@536-743@usr.bin/mandoc/mdoc_macro.c","usr.bin/mandoc/mdoc_macro.c","blk_exp_close",536,743
108,48,659,1,177,"in_line@746-923@usr.bin/mandoc/mdoc_macro.c","usr.bin/mandoc/mdoc_macro.c","in_line",746,923
161,57,1069,1,246,"blk_full@926-1172@usr.bin/mandoc/mdoc_macro.c","usr.bin/mandoc/mdoc_macro.c","blk_full",926,1172
38,15,293,1,63,"blk_part_imp@1175-1238@usr.bin/mandoc/mdoc_macro.c","usr.bin/mandoc/mdoc_macro.c","blk_part_imp",1175,1238
37,12,260,1,52,"blk_part_exp@1241-1293@usr.bin/mandoc/mdoc_macro.c","usr.bin/mandoc/mdoc_macro.c","blk_part_exp",1241,1293
88,36,546,1,109,"in_line_argn@1296-1405@usr.bin/mandoc/mdoc_macro.c","usr.bin/mandoc/mdoc_macro.c","in_line_argn",1296,1405
24,10,175,1,26,"in_line_eoln@1408-1434@usr.bin/mandoc/mdoc_macro.c","usr.bin/mandoc/mdoc_macro.c","in_line_eoln",1408,1434
12,4,83,5,12,"parse_rest@1442-1454@usr.bin/mandoc/mdoc_macro.c","usr.bin/mandoc/mdoc_macro.c","parse_rest",1442,1454
11,3,80,1,11,"ctx_synopsis@1457-1468@usr.bin/mandoc/mdoc_macro.c","usr.bin/mandoc/mdoc_macro.c","ctx_synopsis",1457,1468
21,9,148,1,27,"phrase_ta@1476-1503@usr.bin/mandoc/mdoc_macro.c","usr.bin/mandoc/mdoc_macro.c","phrase_ta",1476,1503
40,12,142,1,40,"man_strlen@292-332@usr.bin/mandoc/mdoc_man.c","usr.bin/mandoc/mdoc_man.c","man_strlen",292,332
13,2,71,1,13,"font_push@335-348@usr.bin/mandoc/mdoc_man.c","usr.bin/mandoc/mdoc_man.c","font_push",335,348
9,2,43,1,9,"font_pop@351-360@usr.bin/mandoc/mdoc_man.c","usr.bin/mandoc/mdoc_man.c","font_pop",351,360
66,30,370,1,82,"print_word@363-445@usr.bin/mandoc/mdoc_man.c","usr.bin/mandoc/mdoc_man.c","print_word",363,445
6,1,25,2,6,"print_line@448-454@usr.bin/mandoc/mdoc_man.c","usr.bin/mandoc/mdoc_man.c","print_line",448,454
15,4,83,2,15,"print_block@457-472@usr.bin/mandoc/mdoc_man.c","usr.bin/mandoc/mdoc_man.c","print_block",457,472
31,13,199,2,46,"print_offs@475-521@usr.bin/mandoc/mdoc_man.c","usr.bin/mandoc/mdoc_man.c","print_offs",475,521
42,12,271,2,55,"print_width@527-582@usr.bin/mandoc/mdoc_man.c","usr.bin/mandoc/mdoc_man.c","print_width",527,582
6,1,38,1,6,"print_count@585-591@usr.bin/mandoc/mdoc_man.c","usr.bin/mandoc/mdoc_man.c","print_count",585,591
5,1,32,2,10,"man_man@594-604@usr.bin/mandoc/mdoc_man.c","usr.bin/mandoc/mdoc_man.c","man_man",594,604
18,4,148,2,21,"man_mdoc@607-628@usr.bin/mandoc/mdoc_man.c","usr.bin/mandoc/mdoc_man.c","man_mdoc",607,628
50,25,360,1,77,"print_node@631-708@usr.bin/mandoc/mdoc_man.c","usr.bin/mandoc/mdoc_man.c","print_node",631,708
4,1,13,1,4,"cond_head@711-715@usr.bin/mandoc/mdoc_man.c","usr.bin/mandoc/mdoc_man.c","cond_head",711,715
4,1,13,1,4,"cond_body@718-722@usr.bin/mandoc/mdoc_man.c","usr.bin/mandoc/mdoc_man.c","cond_body",718,722
10,2,43,1,10,"pre_enc@725-735@usr.bin/mandoc/mdoc_man.c","usr.bin/mandoc/mdoc_man.c","pre_enc",725,735
9,2,43,1,9,"post_enc@738-747@usr.bin/mandoc/mdoc_man.c","usr.bin/mandoc/mdoc_man.c","post_enc",738,747
5,1,15,1,4,"pre_ex@750-754@usr.bin/mandoc/mdoc_man.c","usr.bin/mandoc/mdoc_man.c","pre_ex",750,754
4,1,10,1,4,"post_font@757-761@usr.bin/mandoc/mdoc_man.c","usr.bin/mandoc/mdoc_man.c","post_font",757,761
14,6,79,1,14,"post_percent@764-778@usr.bin/mandoc/mdoc_man.c","usr.bin/mandoc/mdoc_man.c","post_percent",764,778
9,3,46,1,9,"pre__t@781-790@usr.bin/mandoc/mdoc_man.c","usr.bin/mandoc/mdoc_man.c","pre__t",781,790
9,3,49,1,9,"post__t@793-802@usr.bin/mandoc/mdoc_man.c","usr.bin/mandoc/mdoc_man.c","post__t",793,802
11,2,51,1,11,"pre_sect@808-819@usr.bin/mandoc/mdoc_man.c","usr.bin/mandoc/mdoc_man.c","pre_sect",808,819
11,4,56,1,11,"post_sect@825-836@usr.bin/mandoc/mdoc_man.c","usr.bin/mandoc/mdoc_man.c","post_sect",825,836
29,15,131,1,32,"pre_syn@840-872@usr.bin/mandoc/mdoc_man.c","usr.bin/mandoc/mdoc_man.c","pre_syn",840,872
20,6,81,1,20,"pre_an@875-895@usr.bin/mandoc/mdoc_man.c","usr.bin/mandoc/mdoc_man.c","pre_an",875,895
7,1,22,1,7,"pre_ap@898-905@usr.bin/mandoc/mdoc_man.c","usr.bin/mandoc/mdoc_man.c","pre_ap",898,905
7,4,42,1,7,"pre_aq@908-915@usr.bin/mandoc/mdoc_man.c","usr.bin/mandoc/mdoc_man.c","pre_aq",908,915
6,4,43,1,6,"post_aq@918-924@usr.bin/mandoc/mdoc_man.c","usr.bin/mandoc/mdoc_man.c","post_aq",918,924
11,5,85,1,12,"pre_bd@927-939@usr.bin/mandoc/mdoc_man.c","usr.bin/mandoc/mdoc_man.c","pre_bd",927,939
9,4,56,1,12,"post_bd@942-954@usr.bin/mandoc/mdoc_man.c","usr.bin/mandoc/mdoc_man.c","post_bd",942,954
23,5,74,1,23,"pre_bf@957-980@usr.bin/mandoc/mdoc_man.c","usr.bin/mandoc/mdoc_man.c","pre_bf",957,980
5,2,18,1,5,"post_bf@983-988@usr.bin/mandoc/mdoc_man.c","usr.bin/mandoc/mdoc_man.c","post_bf",983,988
13,4,38,1,12,"pre_bk@991-1003@usr.bin/mandoc/mdoc_man.c","usr.bin/mandoc/mdoc_man.c","pre_bk",991,1003
14,5,52,1,14,"post_bk@1006-1020@usr.bin/mandoc/mdoc_man.c","usr.bin/mandoc/mdoc_man.c","post_bk",1006,1020
25,6,133,1,32,"pre_bl@1023-1055@usr.bin/mandoc/mdoc_man.c","usr.bin/mandoc/mdoc_man.c","pre_bl",1023,1055
25,6,125,1,29,"post_bl@1058-1087@usr.bin/mandoc/mdoc_man.c","usr.bin/mandoc/mdoc_man.c","post_bl",1058,1087
4,1,10,1,3,"pre_br@1090-1093@usr.bin/mandoc/mdoc_man.c","usr.bin/mandoc/mdoc_man.c","pre_br",1090,1093
5,1,16,1,5,"pre_dl@1096-1101@usr.bin/mandoc/mdoc_man.c","usr.bin/mandoc/mdoc_man.c","pre_dl",1096,1101
6,2,27,1,8,"post_dl@1104-1112@usr.bin/mandoc/mdoc_man.c","usr.bin/mandoc/mdoc_man.c","post_dl",1104,1112
5,1,14,1,5,"pre_em@1115-1120@usr.bin/mandoc/mdoc_man.c","usr.bin/mandoc/mdoc_man.c","pre_em",1115,1120
9,3,49,1,10,"pre_en@1123-1133@usr.bin/mandoc/mdoc_man.c","usr.bin/mandoc/mdoc_man.c","pre_en",1123,1133
10,4,61,1,11,"post_en@1136-1147@usr.bin/mandoc/mdoc_man.c","usr.bin/mandoc/mdoc_man.c","post_en",1136,1147
13,10,107,1,13,"pre_eo@1150-1163@usr.bin/mandoc/mdoc_man.c","usr.bin/mandoc/mdoc_man.c","pre_eo",1150,1163
16,9,100,1,18,"post_eo@1166-1184@usr.bin/mandoc/mdoc_man.c","usr.bin/mandoc/mdoc_man.c","post_eo",1166,1184
17,6,85,1,19,"pre_fa@1187-1206@usr.bin/mandoc/mdoc_man.c","usr.bin/mandoc/mdoc_man.c","pre_fa",1187,1206
5,3,27,1,5,"post_fa@1209-1214@usr.bin/mandoc/mdoc_man.c","usr.bin/mandoc/mdoc_man.c","post_fa",1209,1214
6,1,19,1,6,"pre_fd@1217-1223@usr.bin/mandoc/mdoc_man.c","usr.bin/mandoc/mdoc_man.c","pre_fd",1217,1223
5,1,14,1,5,"post_fd@1226-1231@usr.bin/mandoc/mdoc_man.c","usr.bin/mandoc/mdoc_man.c","post_fd",1226,1231
8,2,31,1,8,"pre_fl@1234-1242@usr.bin/mandoc/mdoc_man.c","usr.bin/mandoc/mdoc_man.c","pre_fl",1234,1242
9,5,47,1,9,"post_fl@1245-1254@usr.bin/mandoc/mdoc_man.c","usr.bin/mandoc/mdoc_man.c","post_fl",1245,1254
19,4,92,1,23,"pre_fn@1257-1280@usr.bin/mandoc/mdoc_man.c","usr.bin/mandoc/mdoc_man.c","pre_fn",1257,1280
8,2,30,1,8,"post_fn@1283-1291@usr.bin/mandoc/mdoc_man.c","usr.bin/mandoc/mdoc_man.c","post_fn",1283,1291
23,6,89,1,23,"pre_fo@1294-1317@usr.bin/mandoc/mdoc_man.c","usr.bin/mandoc/mdoc_man.c","pre_fo",1294,1317
14,4,47,1,14,"post_fo@1320-1334@usr.bin/mandoc/mdoc_man.c","usr.bin/mandoc/mdoc_man.c","post_fo",1320,1334
6,1,19,1,6,"pre_Ft@1337-1343@usr.bin/mandoc/mdoc_man.c","usr.bin/mandoc/mdoc_man.c","pre_Ft",1337,1343
6,1,26,1,5,"pre_ft@1346-1351@usr.bin/mandoc/mdoc_man.c","usr.bin/mandoc/mdoc_man.c","pre_ft",1346,1351
14,2,55,1,14,"pre_in@1354-1368@usr.bin/mandoc/mdoc_man.c","usr.bin/mandoc/mdoc_man.c","pre_in",1354,1368
13,2,49,1,13,"post_in@1371-1384@usr.bin/mandoc/mdoc_man.c","usr.bin/mandoc/mdoc_man.c","post_in",1371,1384
63,17,315,1,63,"pre_it@1387-1450@usr.bin/mandoc/mdoc_man.c","usr.bin/mandoc/mdoc_man.c","pre_it",1387,1450
13,4,83,1,20,"mid_it@1457-1477@usr.bin/mandoc/mdoc_man.c","usr.bin/mandoc/mdoc_man.c","mid_it",1457,1477
47,14,177,1,54,"post_it@1480-1534@usr.bin/mandoc/mdoc_man.c","usr.bin/mandoc/mdoc_man.c","post_it",1480,1534
5,2,18,1,5,"post_lb@1537-1542@usr.bin/mandoc/mdoc_man.c","usr.bin/mandoc/mdoc_man.c","post_lb",1537,1542
36,10,203,1,44,"pre_lk@1545-1589@usr.bin/mandoc/mdoc_man.c","usr.bin/mandoc/mdoc_man.c","pre_lk",1545,1589
13,4,85,1,12,"pre_onearg@1592-1604@usr.bin/mandoc/mdoc_man.c","usr.bin/mandoc/mdoc_man.c","pre_onearg",1592,1604
5,1,14,1,5,"pre_li@1607-1612@usr.bin/mandoc/mdoc_man.c","usr.bin/mandoc/mdoc_man.c","pre_li",1607,1612
22,8,126,1,22,"pre_nm@1615-1637@usr.bin/mandoc/mdoc_man.c","usr.bin/mandoc/mdoc_man.c","pre_nm",1615,1637
15,6,55,1,15,"post_nm@1640-1655@usr.bin/mandoc/mdoc_man.c","usr.bin/mandoc/mdoc_man.c","post_nm",1640,1655
5,1,13,1,5,"pre_no@1658-1663@usr.bin/mandoc/mdoc_man.c","usr.bin/mandoc/mdoc_man.c","pre_no",1658,1663
5,1,13,1,5,"pre_ns@1666-1671@usr.bin/mandoc/mdoc_man.c","usr.bin/mandoc/mdoc_man.c","pre_ns",1666,1671
5,3,29,1,5,"post_pf@1674-1679@usr.bin/mandoc/mdoc_man.c","usr.bin/mandoc/mdoc_man.c","post_pf",1674,1679
8,2,33,1,8,"pre_pp@1682-1690@usr.bin/mandoc/mdoc_man.c","usr.bin/mandoc/mdoc_man.c","pre_pp",1682,1690
8,2,31,1,8,"pre_rs@1693-1701@usr.bin/mandoc/mdoc_man.c","usr.bin/mandoc/mdoc_man.c","pre_rs",1693,1701
4,1,9,1,4,"pre_skip@1704-1708@usr.bin/mandoc/mdoc_man.c","usr.bin/mandoc/mdoc_man.c","pre_skip",1704,1708
12,4,56,1,14,"pre_sm@1711-1725@usr.bin/mandoc/mdoc_man.c","usr.bin/mandoc/mdoc_man.c","pre_sm",1711,1725
12,3,56,1,11,"pre_sp@1728-1739@usr.bin/mandoc/mdoc_man.c","usr.bin/mandoc/mdoc_man.c","pre_sp",1728,1739
5,1,14,1,5,"pre_sy@1742-1747@usr.bin/mandoc/mdoc_man.c","usr.bin/mandoc/mdoc_man.c","pre_sy",1742,1747
7,2,42,1,6,"pre_ta@1750-1756@usr.bin/mandoc/mdoc_man.c","usr.bin/mandoc/mdoc_man.c","pre_ta",1750,1756
16,4,53,1,16,"pre_vt@1759-1775@usr.bin/mandoc/mdoc_man.c","usr.bin/mandoc/mdoc_man.c","pre_vt",1759,1775
6,3,26,1,6,"post_vt@1778-1784@usr.bin/mandoc/mdoc_man.c","usr.bin/mandoc/mdoc_man.c","post_vt",1778,1784
15,3,67,1,15,"pre_xr@1787-1802@usr.bin/mandoc/mdoc_man.c","usr.bin/mandoc/mdoc_man.c","pre_xr",1787,1802
25,3,152,2,26,"markdown_mdoc@254-280@usr.bin/mandoc/mdoc_markdown.c","usr.bin/mandoc/mdoc_markdown.c","markdown_mdoc",254,280
7,2,28,1,6,"md_nodelist@283-289@usr.bin/mandoc/mdoc_markdown.c","usr.bin/mandoc/mdoc_markdown.c","md_nodelist",283,289
53,25,344,1,60,"md_node@292-352@usr.bin/mandoc/mdoc_markdown.c","usr.bin/mandoc/mdoc_markdown.c","md_node",292,352
23,5,104,1,23,"md_stack@355-378@usr.bin/mandoc/mdoc_markdown.c","usr.bin/mandoc/mdoc_markdown.c","md_stack",355,378
38,13,207,1,59,"md_preword@384-443@usr.bin/mandoc/mdoc_markdown.c","usr.bin/mandoc/mdoc_markdown.c","md_preword",384,443
33,11,137,1,35,"md_rawword@451-486@usr.bin/mandoc/mdoc_markdown.c","usr.bin/mandoc/mdoc_markdown.c","md_rawword",451,486
164,72,753,1,172,"md_word@492-664@usr.bin/mandoc/mdoc_markdown.c","usr.bin/mandoc/mdoc_markdown.c","md_word",492,664
6,1,27,1,5,"md_named@670-675@usr.bin/mandoc/mdoc_markdown.c","usr.bin/mandoc/mdoc_markdown.c","md_named",670,675
20,9,93,1,19,"md_char@681-700@usr.bin/mandoc/mdoc_markdown.c","usr.bin/mandoc/mdoc_markdown.c","md_char",681,700
4,1,16,1,3,"md_cond_head@703-706@usr.bin/mandoc/mdoc_markdown.c","usr.bin/mandoc/mdoc_markdown.c","md_cond_head",703,706
4,1,16,1,3,"md_cond_body@709-712@usr.bin/mandoc/mdoc_markdown.c","usr.bin/mandoc/mdoc_markdown.c","md_cond_body",709,712
11,3,55,1,11,"md_pre_raw@715-726@usr.bin/mandoc/mdoc_markdown.c","usr.bin/mandoc/mdoc_markdown.c","md_pre_raw",715,726
10,3,56,1,10,"md_post_raw@729-739@usr.bin/mandoc/mdoc_markdown.c","usr.bin/mandoc/mdoc_markdown.c","md_post_raw",729,739
9,2,45,1,9,"md_pre_word@742-751@usr.bin/mandoc/mdoc_markdown.c","usr.bin/mandoc/mdoc_markdown.c","md_pre_word",742,751
8,2,46,1,8,"md_post_word@754-762@usr.bin/mandoc/mdoc_markdown.c","usr.bin/mandoc/mdoc_markdown.c","md_post_word",754,762
16,6,86,1,15,"md_post_pc@765-780@usr.bin/mandoc/mdoc_markdown.c","usr.bin/mandoc/mdoc_markdown.c","md_post_pc",765,780
4,1,12,1,3,"md_pre_skip@783-786@usr.bin/mandoc/mdoc_markdown.c","usr.bin/mandoc/mdoc_markdown.c","md_pre_skip",783,786
29,15,130,1,31,"md_pre_syn@789-820@usr.bin/mandoc/mdoc_markdown.c","usr.bin/mandoc/mdoc_markdown.c","md_pre_syn",789,820
20,6,84,1,19,"md_pre_An@823-842@usr.bin/mandoc/mdoc_markdown.c","usr.bin/mandoc/mdoc_markdown.c","md_pre_An",823,842
7,1,25,1,6,"md_pre_Ap@845-851@usr.bin/mandoc/mdoc_markdown.c","usr.bin/mandoc/mdoc_markdown.c","md_pre_Ap",845,851
10,3,41,1,9,"md_pre_Bd@854-863@usr.bin/mandoc/mdoc_markdown.c","usr.bin/mandoc/mdoc_markdown.c","md_pre_Bd",854,863
12,3,38,1,11,"md_pre_Bk@866-877@usr.bin/mandoc/mdoc_markdown.c","usr.bin/mandoc/mdoc_markdown.c","md_pre_Bk",866,877
5,2,21,1,4,"md_post_Bk@880-884@usr.bin/mandoc/mdoc_markdown.c","usr.bin/mandoc/mdoc_markdown.c","md_post_Bk",880,884
8,2,43,1,7,"md_pre_Bl@887-894@usr.bin/mandoc/mdoc_markdown.c","usr.bin/mandoc/mdoc_markdown.c","md_pre_Bl",887,894
7,2,40,1,6,"md_post_Bl@897-903@usr.bin/mandoc/mdoc_markdown.c","usr.bin/mandoc/mdoc_markdown.c","md_post_Bl",897,903
12,2,41,1,15,"md_pre_D1@906-921@usr.bin/mandoc/mdoc_markdown.c","usr.bin/mandoc/mdoc_markdown.c","md_pre_D1",906,921
9,2,33,1,8,"md_post_D1@924-932@usr.bin/mandoc/mdoc_markdown.c","usr.bin/mandoc/mdoc_markdown.c","md_post_D1",924,932
12,2,41,1,15,"md_pre_Dl@935-950@usr.bin/mandoc/mdoc_markdown.c","usr.bin/mandoc/mdoc_markdown.c","md_pre_Dl",935,950
9,3,52,1,9,"md_pre_En@953-962@usr.bin/mandoc/mdoc_markdown.c","usr.bin/mandoc/mdoc_markdown.c","md_pre_En",953,962
9,4,62,1,9,"md_post_En@965-974@usr.bin/mandoc/mdoc_markdown.c","usr.bin/mandoc/mdoc_markdown.c","md_post_En",965,974
13,10,109,1,12,"md_pre_Eo@977-989@usr.bin/mandoc/mdoc_markdown.c","usr.bin/mandoc/mdoc_markdown.c","md_pre_Eo",977,989
13,6,74,1,14,"md_post_Eo@992-1006@usr.bin/mandoc/mdoc_markdown.c","usr.bin/mandoc/mdoc_markdown.c","md_post_Eo",992,1006
17,4,81,1,19,"md_pre_Fa@1009-1028@usr.bin/mandoc/mdoc_markdown.c","usr.bin/mandoc/mdoc_markdown.c","md_pre_Fa",1009,1028
5,3,30,1,4,"md_post_Fa@1031-1035@usr.bin/mandoc/mdoc_markdown.c","usr.bin/mandoc/mdoc_markdown.c","md_post_Fa",1031,1035
6,1,22,1,5,"md_pre_Fd@1038-1043@usr.bin/mandoc/mdoc_markdown.c","usr.bin/mandoc/mdoc_markdown.c","md_pre_Fd",1038,1043
5,1,18,1,4,"md_post_Fd@1046-1050@usr.bin/mandoc/mdoc_markdown.c","usr.bin/mandoc/mdoc_markdown.c","md_post_Fd",1046,1050
7,5,51,1,6,"md_post_Fl@1053-1059@usr.bin/mandoc/mdoc_markdown.c","usr.bin/mandoc/mdoc_markdown.c","md_post_Fl",1053,1059
16,3,81,1,18,"md_pre_Fn@1062-1080@usr.bin/mandoc/mdoc_markdown.c","usr.bin/mandoc/mdoc_markdown.c","md_pre_Fn",1062,1080
8,2,33,1,7,"md_post_Fn@1083-1090@usr.bin/mandoc/mdoc_markdown.c","usr.bin/mandoc/mdoc_markdown.c","md_post_Fn",1083,1090
20,5,73,1,19,"md_pre_Fo@1093-1112@usr.bin/mandoc/mdoc_markdown.c","usr.bin/mandoc/mdoc_markdown.c","md_pre_Fo",1093,1112
14,4,49,1,13,"md_post_Fo@1115-1128@usr.bin/mandoc/mdoc_markdown.c","usr.bin/mandoc/mdoc_markdown.c","md_post_Fo",1115,1128
15,2,62,1,14,"md_pre_In@1131-1145@usr.bin/mandoc/mdoc_markdown.c","usr.bin/mandoc/mdoc_markdown.c","md_pre_In",1131,1145
11,2,44,1,10,"md_post_In@1148-1158@usr.bin/mandoc/mdoc_markdown.c","usr.bin/mandoc/mdoc_markdown.c","md_post_In",1148,1158
70,23,291,1,74,"md_pre_It@1161-1235@usr.bin/mandoc/mdoc_markdown.c","usr.bin/mandoc/mdoc_markdown.c","md_pre_It",1161,1235
41,19,222,1,55,"md_post_It@1238-1293@usr.bin/mandoc/mdoc_markdown.c","usr.bin/mandoc/mdoc_markdown.c","md_post_It",1238,1293
5,2,21,1,4,"md_post_Lb@1296-1300@usr.bin/mandoc/mdoc_markdown.c","usr.bin/mandoc/mdoc_markdown.c","md_post_Lb",1296,1300
13,3,59,1,12,"md_uri@1303-1315@usr.bin/mandoc/mdoc_markdown.c","usr.bin/mandoc/mdoc_markdown.c","md_uri",1303,1315
29,7,163,1,37,"md_pre_Lk@1318-1355@usr.bin/mandoc/mdoc_markdown.c","usr.bin/mandoc/mdoc_markdown.c","md_pre_Lk",1318,1355
20,4,115,1,20,"md_pre_Mt@1358-1378@usr.bin/mandoc/mdoc_markdown.c","usr.bin/mandoc/mdoc_markdown.c","md_pre_Mt",1358,1378
7,1,25,1,6,"md_pre_Nd@1381-1387@usr.bin/mandoc/mdoc_markdown.c","usr.bin/mandoc/mdoc_markdown.c","md_pre_Nd",1381,1387
16,4,51,1,15,"md_pre_Nm@1390-1405@usr.bin/mandoc/mdoc_markdown.c","usr.bin/mandoc/mdoc_markdown.c","md_pre_Nm",1390,1405
14,4,43,1,13,"md_post_Nm@1408-1421@usr.bin/mandoc/mdoc_markdown.c","usr.bin/mandoc/mdoc_markdown.c","md_post_Nm",1408,1421
5,1,16,1,4,"md_pre_No@1424-1428@usr.bin/mandoc/mdoc_markdown.c","usr.bin/mandoc/mdoc_markdown.c","md_pre_No",1424,1428
5,1,16,1,4,"md_pre_Ns@1431-1435@usr.bin/mandoc/mdoc_markdown.c","usr.bin/mandoc/mdoc_markdown.c","md_pre_Ns",1431,1435
5,3,33,1,4,"md_post_Pf@1438-1442@usr.bin/mandoc/mdoc_markdown.c","usr.bin/mandoc/mdoc_markdown.c","md_post_Pf",1438,1442
5,1,16,1,4,"md_pre_Pp@1445-1449@usr.bin/mandoc/mdoc_markdown.c","usr.bin/mandoc/mdoc_markdown.c","md_pre_Pp",1445,1449
6,2,24,1,5,"md_pre_Rs@1452-1457@usr.bin/mandoc/mdoc_markdown.c","usr.bin/mandoc/mdoc_markdown.c","md_pre_Rs",1452,1457
19,6,76,1,18,"md_pre_Sh@1460-1478@usr.bin/mandoc/mdoc_markdown.c","usr.bin/mandoc/mdoc_markdown.c","md_pre_Sh",1460,1478
12,4,59,1,13,"md_pre_Sm@1481-1494@usr.bin/mandoc/mdoc_markdown.c","usr.bin/mandoc/mdoc_markdown.c","md_pre_Sm",1481,1494
14,4,47,1,13,"md_pre_Vt@1497-1510@usr.bin/mandoc/mdoc_markdown.c","usr.bin/mandoc/mdoc_markdown.c","md_pre_Vt",1497,1510
11,3,34,1,10,"md_post_Vt@1513-1523@usr.bin/mandoc/mdoc_markdown.c","usr.bin/mandoc/mdoc_markdown.c","md_post_Vt",1513,1523
15,3,66,1,14,"md_pre_Xr@1526-1540@usr.bin/mandoc/mdoc_markdown.c","usr.bin/mandoc/mdoc_markdown.c","md_pre_Xr",1526,1540
9,3,47,1,8,"md_pre__T@1543-1551@usr.bin/mandoc/mdoc_markdown.c","usr.bin/mandoc/mdoc_markdown.c","md_pre__T",1543,1551
9,3,49,1,8,"md_post__T@1554-1562@usr.bin/mandoc/mdoc_markdown.c","usr.bin/mandoc/mdoc_markdown.c","md_post__T",1554,1562
5,1,16,1,4,"md_pre_br@1565-1569@usr.bin/mandoc/mdoc_markdown.c","usr.bin/mandoc/mdoc_markdown.c","md_pre_br",1565,1569
12,6,94,2,14,"mdoc_state@165-179@usr.bin/mandoc/mdoc_state.c","usr.bin/mandoc/mdoc_state.c","mdoc_state",165,179
5,1,28,1,5,"mdoc_state_reset@182-187@usr.bin/mandoc/mdoc_state.c","usr.bin/mandoc/mdoc_state.c","mdoc_state_reset",182,187
13,7,80,1,16,"state_bd@190-206@usr.bin/mandoc/mdoc_state.c","usr.bin/mandoc/mdoc_state.c","state_bd",190,206
20,6,104,1,21,"state_bl@209-230@usr.bin/mandoc/mdoc_state.c","usr.bin/mandoc/mdoc_state.c","state_bl",209,230
13,3,40,1,13,"state_dl@233-246@usr.bin/mandoc/mdoc_state.c","usr.bin/mandoc/mdoc_state.c","state_dl",233,246
23,6,159,1,36,"state_sh@249-285@usr.bin/mandoc/mdoc_state.c","usr.bin/mandoc/mdoc_state.c","state_sh",249,285
9,4,62,1,9,"state_sm@288-297@usr.bin/mandoc/mdoc_state.c","usr.bin/mandoc/mdoc_state.c","state_sm",288,297
40,11,257,2,41,"terminal_mdoc@253-294@usr.bin/mandoc/mdoc_term.c","usr.bin/mandoc/mdoc_term.c","terminal_mdoc",253,294
7,2,31,1,7,"print_mdoc_nodelist@297-304@usr.bin/mandoc/mdoc_term.c","usr.bin/mandoc/mdoc_term.c","print_mdoc_nodelist",297,304
78,32,534,1,103,"print_mdoc_node@307-410@usr.bin/mandoc/mdoc_term.c","usr.bin/mandoc/mdoc_term.c","print_mdoc_node",307,410
30,3,249,2,46,"print_mdoc_foot@413-459@usr.bin/mandoc/mdoc_term.c","usr.bin/mandoc/mdoc_term.c","print_mdoc_foot",413,459
46,7,367,2,66,"print_mdoc_head@462-528@usr.bin/mandoc/mdoc_term.c","usr.bin/mandoc/mdoc_term.c","print_mdoc_head",462,528
11,3,82,2,11,"a2width@531-542@usr.bin/mandoc/mdoc_term.c","usr.bin/mandoc/mdoc_term.c","a2width",531,542
37,23,273,3,49,"print_bvspace@550-599@usr.bin/mandoc/mdoc_term.c","usr.bin/mandoc/mdoc_term.c","print_bvspace",550,599
203,72,1150,1,296,"termp_it_pre@603-899@usr.bin/mandoc/mdoc_term.c","usr.bin/mandoc/mdoc_term.c","termp_it_pre",603,899
24,8,113,1,33,"termp_it_post@902-935@usr.bin/mandoc/mdoc_term.c","usr.bin/mandoc/mdoc_term.c","termp_it_post",902,935
46,15,324,1,51,"termp_nm_pre@938-989@usr.bin/mandoc/mdoc_term.c","usr.bin/mandoc/mdoc_term.c","termp_nm_pre",938,989
12,7,94,1,12,"termp_nm_post@992-1004@usr.bin/mandoc/mdoc_term.c","usr.bin/mandoc/mdoc_term.c","termp_nm_post",992,1004
12,5,75,1,14,"termp_fl_pre@1007-1021@usr.bin/mandoc/mdoc_term.c","usr.bin/mandoc/mdoc_term.c","termp_fl_pre",1007,1021
7,5,46,1,8,"termp__a_pre@1024-1032@usr.bin/mandoc/mdoc_term.c","usr.bin/mandoc/mdoc_term.c","termp__a_pre",1024,1032
18,6,103,1,21,"termp_an_pre@1035-1056@usr.bin/mandoc/mdoc_term.c","usr.bin/mandoc/mdoc_term.c","termp_an_pre",1035,1056
6,2,26,1,6,"termp_ns_pre@1059-1065@usr.bin/mandoc/mdoc_term.c","usr.bin/mandoc/mdoc_term.c","termp_ns_pre",1059,1065
8,4,39,1,8,"termp_rs_pre@1068-1076@usr.bin/mandoc/mdoc_term.c","usr.bin/mandoc/mdoc_term.c","termp_rs_pre",1068,1076
5,1,14,1,4,"termp_ex_pre@1079-1083@usr.bin/mandoc/mdoc_term.c","usr.bin/mandoc/mdoc_term.c","termp_ex_pre",1079,1083
6,2,24,1,6,"termp_nd_pre@1086-1092@usr.bin/mandoc/mdoc_term.c","usr.bin/mandoc/mdoc_term.c","termp_nd_pre",1086,1092
4,1,13,1,4,"termp_bl_pre@1095-1099@usr.bin/mandoc/mdoc_term.c","usr.bin/mandoc/mdoc_term.c","termp_bl_pre",1095,1099
11,4,62,1,11,"termp_bl_post@1102-1113@usr.bin/mandoc/mdoc_term.c","usr.bin/mandoc/mdoc_term.c","termp_bl_post",1102,1113
17,3,107,1,23,"termp_xr_pre@1116-1139@usr.bin/mandoc/mdoc_term.c","usr.bin/mandoc/mdoc_term.c","termp_xr_pre",1116,1139
29,15,140,2,45,"synopsis_pre@1147-1192@usr.bin/mandoc/mdoc_term.c","usr.bin/mandoc/mdoc_term.c","synopsis_pre",1147,1192
12,4,80,1,13,"termp_vt_pre@1195-1208@usr.bin/mandoc/mdoc_term.c","usr.bin/mandoc/mdoc_term.c","termp_vt_pre",1195,1208
6,1,27,1,6,"termp_bold_pre@1211-1217@usr.bin/mandoc/mdoc_term.c","usr.bin/mandoc/mdoc_term.c","termp_bold_pre",1211,1217
5,1,25,1,5,"termp_fd_pre@1220-1225@usr.bin/mandoc/mdoc_term.c","usr.bin/mandoc/mdoc_term.c","termp_fd_pre",1220,1225
4,1,11,1,4,"termp_fd_post@1228-1232@usr.bin/mandoc/mdoc_term.c","usr.bin/mandoc/mdoc_term.c","termp_fd_post",1228,1232
34,10,156,1,38,"termp_sh_pre@1235-1273@usr.bin/mandoc/mdoc_term.c","usr.bin/mandoc/mdoc_term.c","termp_sh_pre",1235,1273
14,3,46,1,14,"termp_sh_post@1276-1290@usr.bin/mandoc/mdoc_term.c","usr.bin/mandoc/mdoc_term.c","termp_sh_post",1276,1290
5,3,25,1,5,"termp_lb_post@1293-1298@usr.bin/mandoc/mdoc_term.c","usr.bin/mandoc/mdoc_term.c","termp_lb_post",1293,1298
11,2,63,1,11,"termp_d1_pre@1301-1312@usr.bin/mandoc/mdoc_term.c","usr.bin/mandoc/mdoc_term.c","termp_d1_pre",1301,1312
6,1,23,1,7,"termp_ft_pre@1315-1322@usr.bin/mandoc/mdoc_term.c","usr.bin/mandoc/mdoc_term.c","termp_ft_pre",1315,1322
50,10,332,1,62,"termp_fn_pre@1325-1387@usr.bin/mandoc/mdoc_term.c","usr.bin/mandoc/mdoc_term.c","termp_fn_pre",1325,1387
19,6,117,1,22,"termp_fa_pre@1390-1412@usr.bin/mandoc/mdoc_term.c","usr.bin/mandoc/mdoc_term.c","termp_fa_pre",1390,1412
69,29,509,1,89,"termp_bd_pre@1415-1504@usr.bin/mandoc/mdoc_term.c","usr.bin/mandoc/mdoc_term.c","termp_bd_pre",1415,1504
11,4,61,1,10,"termp_bd_post@1507-1517@usr.bin/mandoc/mdoc_term.c","usr.bin/mandoc/mdoc_term.c","termp_bd_post",1507,1517
6,2,31,1,5,"termp_xx_pre@1520-1525@usr.bin/mandoc/mdoc_term.c","usr.bin/mandoc/mdoc_term.c","termp_xx_pre",1520,1525
5,2,24,1,4,"termp_xx_post@1528-1532@usr.bin/mandoc/mdoc_term.c","usr.bin/mandoc/mdoc_term.c","termp_xx_post",1528,1532
5,3,31,1,5,"termp_pf_post@1535-1540@usr.bin/mandoc/mdoc_term.c","usr.bin/mandoc/mdoc_term.c","termp_pf_post",1535,1540
27,7,153,1,28,"termp_ss_pre@1543-1571@usr.bin/mandoc/mdoc_term.c","usr.bin/mandoc/mdoc_term.c","termp_ss_pre",1543,1571
5,3,25,1,5,"termp_ss_post@1574-1579@usr.bin/mandoc/mdoc_term.c","usr.bin/mandoc/mdoc_term.c","termp_ss_post",1574,1579
6,1,23,1,6,"termp_cd_pre@1582-1588@usr.bin/mandoc/mdoc_term.c","usr.bin/mandoc/mdoc_term.c","termp_cd_pre",1582,1588
14,3,76,1,16,"termp_in_pre@1591-1607@usr.bin/mandoc/mdoc_term.c","usr.bin/mandoc/mdoc_term.c","termp_in_pre",1591,1607
9,3,47,1,11,"termp_in_post@1610-1621@usr.bin/mandoc/mdoc_term.c","usr.bin/mandoc/mdoc_term.c","termp_in_post",1610,1621
6,1,18,1,5,"termp_pp_pre@1624-1629@usr.bin/mandoc/mdoc_term.c","usr.bin/mandoc/mdoc_term.c","termp_pp_pre",1624,1629
4,1,9,1,4,"termp_skip_pre@1632-1636@usr.bin/mandoc/mdoc_term.c","usr.bin/mandoc/mdoc_term.c","termp_skip_pre",1632,1636
50,27,230,1,53,"termp_quote_pre@1639-1692@usr.bin/mandoc/mdoc_term.c","usr.bin/mandoc/mdoc_term.c","termp_quote_pre",1639,1692
51,28,244,1,54,"termp_quote_post@1695-1749@usr.bin/mandoc/mdoc_term.c","usr.bin/mandoc/mdoc_term.c","termp_quote_post",1695,1749
15,11,118,1,17,"termp_eo_pre@1752-1769@usr.bin/mandoc/mdoc_term.c","usr.bin/mandoc/mdoc_term.c","termp_eo_pre",1752,1769
18,10,118,1,21,"termp_eo_post@1772-1793@usr.bin/mandoc/mdoc_term.c","usr.bin/mandoc/mdoc_term.c","termp_eo_post",1772,1793
35,6,208,1,40,"termp_fo_pre@1796-1836@usr.bin/mandoc/mdoc_term.c","usr.bin/mandoc/mdoc_term.c","termp_fo_pre",1796,1836
12,3,57,1,14,"termp_fo_post@1839-1853@usr.bin/mandoc/mdoc_term.c","usr.bin/mandoc/mdoc_term.c","termp_fo_post",1839,1853
14,5,79,1,16,"termp_bf_pre@1856-1872@usr.bin/mandoc/mdoc_term.c","usr.bin/mandoc/mdoc_term.c","termp_bf_pre",1856,1872
12,5,73,1,14,"termp_sm_pre@1875-1889@usr.bin/mandoc/mdoc_term.c","usr.bin/mandoc/mdoc_term.c","termp_sm_pre",1875,1889
7,1,28,1,7,"termp_ap_pre@1892-1899@usr.bin/mandoc/mdoc_term.c","usr.bin/mandoc/mdoc_term.c","termp_ap_pre",1892,1899
15,11,119,1,24,"termp____post@1902-1926@usr.bin/mandoc/mdoc_term.c","usr.bin/mandoc/mdoc_term.c","termp____post",1902,1926
6,1,27,1,6,"termp_li_pre@1929-1935@usr.bin/mandoc/mdoc_term.c","usr.bin/mandoc/mdoc_term.c","termp_li_pre",1929,1935
39,11,253,1,47,"termp_lk_pre@1938-1985@usr.bin/mandoc/mdoc_term.c","usr.bin/mandoc/mdoc_term.c","termp_lk_pre",1938,1985
16,6,63,1,17,"termp_bk_pre@1988-2005@usr.bin/mandoc/mdoc_term.c","usr.bin/mandoc/mdoc_term.c","termp_bk_pre",1988,2005
5,2,24,1,5,"termp_bk_post@2008-2013@usr.bin/mandoc/mdoc_term.c","usr.bin/mandoc/mdoc_term.c","termp_bk_post",2008,2013
7,4,52,1,12,"termp__t_post@2016-2028@usr.bin/mandoc/mdoc_term.c","usr.bin/mandoc/mdoc_term.c","termp__t_post",2016,2028
8,4,52,1,13,"termp__t_pre@2031-2044@usr.bin/mandoc/mdoc_term.c","usr.bin/mandoc/mdoc_term.c","termp__t_pre",2031,2044
5,1,16,1,5,"termp_under_pre@2047-2052@usr.bin/mandoc/mdoc_term.c","usr.bin/mandoc/mdoc_term.c","termp_under_pre",2047,2052
8,3,47,1,7,"termp_em_pre@2055-2062@usr.bin/mandoc/mdoc_term.c","usr.bin/mandoc/mdoc_term.c","termp_em_pre",2055,2062
8,3,47,1,7,"termp_sy_pre@2065-2072@usr.bin/mandoc/mdoc_term.c","usr.bin/mandoc/mdoc_term.c","termp_sy_pre",2065,2072
9,5,64,1,9,"termp_er_pre@2075-2084@usr.bin/mandoc/mdoc_term.c","usr.bin/mandoc/mdoc_term.c","termp_er_pre",2075,2084
14,10,113,1,14,"termp_tag_pre@2087-2101@usr.bin/mandoc/mdoc_term.c","usr.bin/mandoc/mdoc_term.c","termp_tag_pre",2087,2101
59,22,358,1,71,"mdoc_node_validate@287-358@usr.bin/mandoc/mdoc_validate.c","usr.bin/mandoc/mdoc_validate.c","mdoc_node_validate",287,358
9,3,73,2,10,"check_args@361-371@usr.bin/mandoc/mdoc_validate.c","usr.bin/mandoc/mdoc_validate.c","check_args",361,371
6,2,60,3,6,"check_argv@374-380@usr.bin/mandoc/mdoc_validate.c","usr.bin/mandoc/mdoc_validate.c","check_argv",374,380
9,3,79,4,10,"check_text@383-393@usr.bin/mandoc/mdoc_validate.c","usr.bin/mandoc/mdoc_validate.c","check_text",383,393
30,13,295,4,32,"check_toptext@396-428@usr.bin/mandoc/mdoc_validate.c","usr.bin/mandoc/mdoc_validate.c","check_toptext",396,428
24,12,172,1,25,"post_delim@431-456@usr.bin/mandoc/mdoc_validate.c","usr.bin/mandoc/mdoc_validate.c","post_delim",431,456
74,43,498,1,92,"post_delim_nb@459-551@usr.bin/mandoc/mdoc_validate.c","usr.bin/mandoc/mdoc_validate.c","post_delim_nb",459,551
148,44,858,1,175,"post_bl_norm@554-729@usr.bin/mandoc/mdoc_validate.c","usr.bin/mandoc/mdoc_validate.c","post_bl_norm",554,729
70,17,394,1,73,"post_bd@732-805@usr.bin/mandoc/mdoc_validate.c","usr.bin/mandoc/mdoc_validate.c","post_bd",732,805
22,5,140,1,24,"post_an_norm@812-836@usr.bin/mandoc/mdoc_validate.c","usr.bin/mandoc/mdoc_validate.c","post_an_norm",812,836
15,4,118,1,17,"post_eoln@839-856@usr.bin/mandoc/mdoc_validate.c","usr.bin/mandoc/mdoc_validate.c","post_eoln",839,856
24,6,181,2,24,"build_list@859-883@usr.bin/mandoc/mdoc_validate.c","usr.bin/mandoc/mdoc_validate.c","build_list",859,883
32,4,242,1,35,"post_ex@886-921@usr.bin/mandoc/mdoc_validate.c","usr.bin/mandoc/mdoc_validate.c","post_ex",886,921
16,1,128,1,17,"post_lb@924-941@usr.bin/mandoc/mdoc_validate.c","usr.bin/mandoc/mdoc_validate.c","post_lb",924,941
34,3,259,1,36,"post_rv@944-980@usr.bin/mandoc/mdoc_validate.c","usr.bin/mandoc/mdoc_validate.c","post_rv",944,980
11,4,77,1,13,"post_std@983-996@usr.bin/mandoc/mdoc_validate.c","usr.bin/mandoc/mdoc_validate.c","post_std",983,996
19,2,130,1,21,"post_st@999-1020@usr.bin/mandoc/mdoc_validate.c","usr.bin/mandoc/mdoc_validate.c","post_st",999,1020
8,3,55,1,8,"post_obsolete@1023-1031@usr.bin/mandoc/mdoc_validate.c","usr.bin/mandoc/mdoc_validate.c","post_obsolete",1023,1031
7,1,41,1,7,"post_useless@1034-1041@usr.bin/mandoc/mdoc_validate.c","usr.bin/mandoc/mdoc_validate.c","post_useless",1034,1041
47,12,320,1,62,"post_bf@1048-1110@usr.bin/mandoc/mdoc_validate.c","usr.bin/mandoc/mdoc_validate.c","post_bf",1048,1110
12,4,98,1,12,"post_fname@1113-1125@usr.bin/mandoc/mdoc_validate.c","usr.bin/mandoc/mdoc_validate.c","post_fname",1113,1125
5,1,16,1,5,"post_fn@1128-1133@usr.bin/mandoc/mdoc_validate.c","usr.bin/mandoc/mdoc_validate.c","post_fn",1128,1133
21,5,136,1,24,"post_fo@1136-1160@usr.bin/mandoc/mdoc_validate.c","usr.bin/mandoc/mdoc_validate.c","post_fo",1136,1160
18,6,116,1,19,"post_fa@1163-1182@usr.bin/mandoc/mdoc_validate.c","usr.bin/mandoc/mdoc_validate.c","post_fa",1163,1182
35,17,267,1,42,"post_nm@1185-1227@usr.bin/mandoc/mdoc_validate.c","usr.bin/mandoc/mdoc_validate.c","post_nm",1185,1227
16,4,92,1,20,"post_nd@1230-1250@usr.bin/mandoc/mdoc_validate.c","usr.bin/mandoc/mdoc_validate.c","post_nd",1230,1250
44,14,273,1,44,"post_display@1253-1297@usr.bin/mandoc/mdoc_validate.c","usr.bin/mandoc/mdoc_validate.c","post_display",1253,1297
27,5,150,1,34,"post_defaults@1300-1334@usr.bin/mandoc/mdoc_validate.c","usr.bin/mandoc/mdoc_validate.c","post_defaults",1300,1334
19,3,144,1,27,"post_at@1337-1364@usr.bin/mandoc/mdoc_validate.c","usr.bin/mandoc/mdoc_validate.c","post_at",1337,1364
16,4,106,1,17,"post_an@1367-1384@usr.bin/mandoc/mdoc_validate.c","usr.bin/mandoc/mdoc_validate.c","post_an",1367,1384
6,2,33,1,6,"post_en@1387-1393@usr.bin/mandoc/mdoc_validate.c","usr.bin/mandoc/mdoc_validate.c","post_en",1387,1393
5,1,19,1,5,"post_es@1396-1401@usr.bin/mandoc/mdoc_validate.c","usr.bin/mandoc/mdoc_validate.c","post_es",1396,1401
48,16,286,1,49,"post_xx@1404-1453@usr.bin/mandoc/mdoc_validate.c","usr.bin/mandoc/mdoc_validate.c","post_xx",1404,1453
70,28,479,1,77,"post_it@1456-1533@usr.bin/mandoc/mdoc_validate.c","usr.bin/mandoc/mdoc_validate.c","post_it",1456,1533
36,10,213,1,37,"post_bl_block@1536-1573@usr.bin/mandoc/mdoc_validate.c","usr.bin/mandoc/mdoc_validate.c","post_bl_block",1536,1573
15,4,91,2,16,"rewrite_macro2len@1580-1596@usr.bin/mandoc/mdoc_validate.c","usr.bin/mandoc/mdoc_validate.c","rewrite_macro2len",1580,1596
41,9,325,1,60,"post_bl_head@1599-1659@usr.bin/mandoc/mdoc_validate.c","usr.bin/mandoc/mdoc_validate.c","post_bl_head",1599,1659
104,26,592,1,136,"post_bl@1662-1798@usr.bin/mandoc/mdoc_validate.c","usr.bin/mandoc/mdoc_validate.c","post_bl",1662,1798
10,3,61,1,11,"post_bk@1801-1812@usr.bin/mandoc/mdoc_validate.c","usr.bin/mandoc/mdoc_validate.c","post_bk",1801,1812
23,4,129,1,27,"post_sm@1815-1842@usr.bin/mandoc/mdoc_validate.c","usr.bin/mandoc/mdoc_validate.c","post_sm",1815,1842
72,23,623,1,83,"post_root@1845-1928@usr.bin/mandoc/mdoc_validate.c","usr.bin/mandoc/mdoc_validate.c","post_root",1845,1928
50,18,358,1,86,"post_rs@1931-2017@usr.bin/mandoc/mdoc_validate.c","usr.bin/mandoc/mdoc_validate.c","post_rs",1931,2017
17,8,109,1,17,"post_hyph@2024-2041@usr.bin/mandoc/mdoc_validate.c","usr.bin/mandoc/mdoc_validate.c","post_hyph",2024,2041
9,4,60,1,9,"post_ns@2044-2053@usr.bin/mandoc/mdoc_validate.c","usr.bin/mandoc/mdoc_validate.c","post_ns",2044,2053
5,1,16,1,4,"post_sx@2056-2060@usr.bin/mandoc/mdoc_validate.c","usr.bin/mandoc/mdoc_validate.c","post_sx",2056,2060
26,6,82,1,27,"post_sh@2063-2090@usr.bin/mandoc/mdoc_validate.c","usr.bin/mandoc/mdoc_validate.c","post_sh",2063,2090
41,15,271,1,44,"post_sh_name@2093-2137@usr.bin/mandoc/mdoc_validate.c","usr.bin/mandoc/mdoc_validate.c","post_sh_name",2093,2137
55,18,362,1,61,"post_sh_see_also@2140-2201@usr.bin/mandoc/mdoc_validate.c","usr.bin/mandoc/mdoc_validate.c","post_sh_see_also",2140,2201
7,5,55,1,7,"child_an@2204-2211@usr.bin/mandoc/mdoc_validate.c","usr.bin/mandoc/mdoc_validate.c","child_an",2204,2211
6,2,39,1,6,"post_sh_authors@2214-2220@usr.bin/mandoc/mdoc_validate.c","usr.bin/mandoc/mdoc_validate.c","post_sh_authors",2214,2220
28,11,185,2,28,"similar@2233-2261@usr.bin/mandoc/mdoc_validate.c","usr.bin/mandoc/mdoc_validate.c","similar",2233,2261
80,27,518,1,115,"post_sh_head@2264-2379@usr.bin/mandoc/mdoc_validate.c","usr.bin/mandoc/mdoc_validate.c","post_sh_head",2264,2379
18,3,130,1,18,"post_xr@2382-2400@usr.bin/mandoc/mdoc_validate.c","usr.bin/mandoc/mdoc_validate.c","post_xr",2382,2400
33,10,199,1,35,"post_ignpar@2403-2438@usr.bin/mandoc/mdoc_validate.c","usr.bin/mandoc/mdoc_validate.c","post_ignpar",2403,2438
23,13,175,1,30,"post_prevpar@2441-2471@usr.bin/mandoc/mdoc_validate.c","usr.bin/mandoc/mdoc_validate.c","post_prevpar",2441,2471
28,15,267,1,31,"post_par@2474-2505@usr.bin/mandoc/mdoc_validate.c","usr.bin/mandoc/mdoc_validate.c","post_par",2474,2505
34,9,263,1,37,"post_dd@2508-2545@usr.bin/mandoc/mdoc_validate.c","usr.bin/mandoc/mdoc_validate.c","post_dd",2508,2545
68,14,550,1,93,"post_dt@2548-2641@usr.bin/mandoc/mdoc_validate.c","usr.bin/mandoc/mdoc_validate.c","post_dt",2548,2641
39,8,315,1,50,"post_bx@2644-2694@usr.bin/mandoc/mdoc_validate.c","usr.bin/mandoc/mdoc_validate.c","post_bx",2644,2694
64,19,477,1,92,"post_os@2697-2789@usr.bin/mandoc/mdoc_validate.c","usr.bin/mandoc/mdoc_validate.c","post_os",2697,2789
8,4,57,1,9,"mdoc_a2sec@2792-2801@usr.bin/mandoc/mdoc_validate.c","usr.bin/mandoc/mdoc_validate.c","mdoc_a2sec",2792,2801
90,42,268,1,90,"macro2len@2804-2894@usr.bin/mandoc/mdoc_validate.c","usr.bin/mandoc/mdoc_validate.c","macro2len",2804,2894
5,1,14,1,6,"mandoc_a2msec@28-34@usr.bin/mandoc/msec.c","usr.bin/mandoc/msec.c","mandoc_a2msec",28,34
47,14,198,3,48,"a2roffsu@47-95@usr.bin/mandoc/out.c","usr.bin/mandoc/out.c","a2roffsu",47,95
105,40,744,4,146,"tblcalc@104-250@usr.bin/mandoc/out.c","usr.bin/mandoc/out.c","tblcalc",104,250
26,10,132,5,28,"tblcalc_data@253-281@usr.bin/mandoc/out.c","usr.bin/mandoc/out.c","tblcalc_data",253,281
30,14,205,4,30,"tblcalc_literal@284-314@usr.bin/mandoc/out.c","usr.bin/mandoc/out.c","tblcalc_literal",284,314
32,7,264,4,50,"tblcalc_number@317-367@usr.bin/mandoc/out.c","usr.bin/mandoc/out.c","tblcalc_number",317,367
67,23,408,5,77,"preconv_encode@27-104@usr.bin/mandoc/preconv.c","usr.bin/mandoc/preconv.c","preconv_encode",27,104
46,19,295,2,67,"preconv_cue@107-174@usr.bin/mandoc/preconv.c","usr.bin/mandoc/preconv.c","preconv_cue",107,174
5,2,47,2,5,"resize_buf@277-282@usr.bin/mandoc/read.c","usr.bin/mandoc/read.c","resize_buf",277,282
36,13,234,1,43,"choose_parser@285-328@usr.bin/mandoc/read.c","usr.bin/mandoc/read.c","choose_parser",285,328
146,48,995,4,209,"mparse_buf_r@338-547@usr.bin/mandoc/read.c","usr.bin/mandoc/read.c","mparse_buf_r",338,547
62,14,407,5,78,"read_whole_file@550-628@usr.bin/mandoc/read.c","usr.bin/mandoc/read.c","read_whole_file",550,628
10,3,59,1,9,"mparse_end@631-640@usr.bin/mandoc/read.c","usr.bin/mandoc/read.c","mparse_end",631,640
30,8,199,3,37,"mparse_parse_buffer@643-680@usr.bin/mandoc/read.c","usr.bin/mandoc/read.c","mparse_parse_buffer",643,680
18,3,109,3,18,"mparse_readfd@687-705@usr.bin/mandoc/read.c","usr.bin/mandoc/read.c","mparse_readfd",687,705
21,5,146,2,33,"mparse_open@708-741@usr.bin/mandoc/read.c","usr.bin/mandoc/read.c","mparse_open",708,741
25,6,209,5,27,"mparse_alloc@744-771@usr.bin/mandoc/read.c","usr.bin/mandoc/read.c","mparse_alloc",744,771
11,2,62,1,13,"mparse_reset@774-787@usr.bin/mandoc/read.c","usr.bin/mandoc/read.c","mparse_reset",774,787
12,2,75,1,13,"mparse_free@790-803@usr.bin/mandoc/read.c","usr.bin/mandoc/read.c","mparse_free",790,803
10,3,53,3,10,"mparse_result@806-816@usr.bin/mandoc/read.c","usr.bin/mandoc/read.c","mparse_result",806,816
5,2,30,2,4,"mparse_updaterc@819-823@usr.bin/mandoc/read.c","usr.bin/mandoc/read.c","mparse_updaterc",819,823
10,1,77,6,11,"mandoc_vmsg@826-837@usr.bin/mandoc/read.c","usr.bin/mandoc/read.c","mandoc_vmsg",826,837
14,6,100,5,17,"mandoc_msg@840-857@usr.bin/mandoc/read.c","usr.bin/mandoc/read.c","mandoc_msg",840,857
4,1,14,1,4,"mparse_strerror@860-864@usr.bin/mandoc/read.c","usr.bin/mandoc/read.c","mparse_strerror",860,864
4,1,14,1,3,"mparse_strlevel@867-870@usr.bin/mandoc/read.c","usr.bin/mandoc/read.c","mparse_strlevel",867,870
5,1,33,1,5,"mparse_keep@873-878@usr.bin/mandoc/read.c","usr.bin/mandoc/read.c","mparse_keep",873,878
5,2,32,1,5,"mparse_getkeep@881-886@usr.bin/mandoc/read.c","usr.bin/mandoc/read.c","mparse_getkeep",881,886
21,3,155,2,22,"roffhash_alloc@595-617@usr.bin/mandoc/roff.c","usr.bin/mandoc/roff.c","roffhash_alloc",595,617
12,3,67,1,12,"roffhash_free@620-632@usr.bin/mandoc/roff.c","usr.bin/mandoc/roff.c","roffhash_free",620,632
11,3,82,3,11,"roffhash_find@635-646@usr.bin/mandoc/roff.c","usr.bin/mandoc/roff.c","roffhash_find",635,646
10,1,56,1,11,"roffnode_pop@655-666@usr.bin/mandoc/roff.c","usr.bin/mandoc/roff.c","roffnode_pop",655,666
14,3,103,5,15,"roffnode_push@673-688@usr.bin/mandoc/roff.c","usr.bin/mandoc/roff.c","roffnode_push",673,688
30,6,212,1,36,"roff_free1@693-729@usr.bin/mandoc/roff.c","usr.bin/mandoc/roff.c","roff_free1",693,729
11,1,56,1,10,"roff_reset@732-742@usr.bin/mandoc/roff.c","usr.bin/mandoc/roff.c","roff_reset",732,742
6,1,26,1,5,"roff_free@745-750@usr.bin/mandoc/roff.c","usr.bin/mandoc/roff.c","roff_free",745,750
12,1,81,2,12,"roff_alloc@753-765@usr.bin/mandoc/roff.c","usr.bin/mandoc/roff.c","roff_alloc",753,765
12,2,89,1,12,"roff_man_free1@770-782@usr.bin/mandoc/roff.c","usr.bin/mandoc/roff.c","roff_man_free1",770,782
12,1,93,1,12,"roff_man_alloc1@785-797@usr.bin/mandoc/roff.c","usr.bin/mandoc/roff.c","roff_man_alloc1",785,797
5,1,19,1,5,"roff_man_reset@800-805@usr.bin/mandoc/roff.c","usr.bin/mandoc/roff.c","roff_man_reset",800,805
5,1,19,1,5,"roff_man_free@808-813@usr.bin/mandoc/roff.c","usr.bin/mandoc/roff.c","roff_man_free",808,813
13,1,78,4,13,"roff_man_alloc@816-829@usr.bin/mandoc/roff.c","usr.bin/mandoc/roff.c","roff_man_alloc",816,829
19,3,116,5,21,"roff_node_alloc@834-855@usr.bin/mandoc/roff.c","usr.bin/mandoc/roff.c","roff_node_alloc",834,855
44,9,252,2,51,"roff_node_append@858-909@usr.bin/mandoc/roff.c","usr.bin/mandoc/roff.c","roff_node_append",858,909
9,1,74,4,9,"roff_word_alloc@912-921@usr.bin/mandoc/roff.c","usr.bin/mandoc/roff.c","roff_word_alloc",912,921
12,1,81,2,12,"roff_word_append@924-936@usr.bin/mandoc/roff.c","usr.bin/mandoc/roff.c","roff_word_append",924,936
7,1,51,4,7,"roff_elem_alloc@939-946@usr.bin/mandoc/roff.c","usr.bin/mandoc/roff.c","roff_elem_alloc",939,946
8,1,54,4,8,"roff_block_alloc@949-957@usr.bin/mandoc/roff.c","usr.bin/mandoc/roff.c","roff_block_alloc",949,957
8,1,54,4,8,"roff_head_alloc@960-968@usr.bin/mandoc/roff.c","usr.bin/mandoc/roff.c","roff_head_alloc",960,968
8,1,54,4,8,"roff_body_alloc@971-979@usr.bin/mandoc/roff.c","usr.bin/mandoc/roff.c","roff_body_alloc",971,979
14,3,99,2,14,"roff_addtbl@982-996@usr.bin/mandoc/roff.c","usr.bin/mandoc/roff.c","roff_addtbl",982,996
26,10,169,2,34,"roff_node_unlink@999-1033@usr.bin/mandoc/roff.c","usr.bin/mandoc/roff.c","roff_node_unlink",999,1033
11,5,72,1,11,"roff_node_free@1036-1047@usr.bin/mandoc/roff.c","usr.bin/mandoc/roff.c","roff_node_free",1036,1047
7,2,43,2,7,"roff_node_delete@1050-1057@usr.bin/mandoc/roff.c","usr.bin/mandoc/roff.c","roff_node_delete",1050,1057
32,14,233,2,46,"deroff@1060-1106@usr.bin/mandoc/roff.c","usr.bin/mandoc/roff.c","deroff",1060,1106
221,62,1275,4,269,"roff_res@1116-1385@usr.bin/mandoc/roff.c","usr.bin/mandoc/roff.c","roff_res",1116,1385
52,14,307,4,63,"roff_parsetext@1391-1454@usr.bin/mandoc/roff.c","usr.bin/mandoc/roff.c","roff_parsetext",1391,1454
78,40,661,4,122,"roff_parseln@1457-1579@usr.bin/mandoc/roff.c","usr.bin/mandoc/roff.c","roff_parseln",1457,1579
19,4,143,1,20,"roff_endparse@1582-1602@usr.bin/mandoc/roff.c","usr.bin/mandoc/roff.c","roff_endparse",1582,1602
29,8,171,5,32,"roff_parse@1609-1641@usr.bin/mandoc/roff.c","usr.bin/mandoc/roff.c","roff_parse",1609,1641
26,8,126,1,37,"roff_cblock@1646-1683@usr.bin/mandoc/roff.c","usr.bin/mandoc/roff.c","roff_cblock",1646,1683
8,3,35,1,8,"roffnode_cleanscope@1686-1694@usr.bin/mandoc/roff.c","usr.bin/mandoc/roff.c","roffnode_cleanscope",1686,1694
26,6,124,3,29,"roff_ccond@1697-1726@usr.bin/mandoc/roff.c","usr.bin/mandoc/roff.c","roff_ccond",1697,1726
95,26,696,1,122,"roff_block@1729-1851@usr.bin/mandoc/roff.c","usr.bin/mandoc/roff.c","roff_block",1729,1851
31,13,257,1,51,"roff_block_sub@1854-1905@usr.bin/mandoc/roff.c","usr.bin/mandoc/roff.c","roff_block_sub",1854,1905
6,2,34,1,7,"roff_block_text@1908-1915@usr.bin/mandoc/roff.c","usr.bin/mandoc/roff.c","roff_block_text",1908,1915
29,10,203,1,44,"roff_cond_sub@1918-1962@usr.bin/mandoc/roff.c","usr.bin/mandoc/roff.c","roff_cond_sub",1918,1962
17,5,100,1,18,"roff_cond_text@1965-1983@usr.bin/mandoc/roff.c","usr.bin/mandoc/roff.c","roff_cond_text",1965,1983
55,20,301,4,63,"roff_getnum@1994-2057@usr.bin/mandoc/roff.c","usr.bin/mandoc/roff.c","roff_getnum",1994,2057
29,7,152,2,32,"roff_evalstrcond@2068-2100@usr.bin/mandoc/roff.c","usr.bin/mandoc/roff.c","roff_evalstrcond",2068,2100
52,16,293,4,54,"roff_evalcond@2107-2161@usr.bin/mandoc/roff.c","usr.bin/mandoc/roff.c","roff_evalcond",2107,2161
4,1,9,1,4,"roff_line_ignore@2164-2168@usr.bin/mandoc/roff.c","usr.bin/mandoc/roff.c","roff_line_ignore",2164,2168
6,1,27,1,6,"roff_insec@2171-2177@usr.bin/mandoc/roff.c","usr.bin/mandoc/roff.c","roff_insec",2171,2177
6,1,27,1,6,"roff_unsupp@2180-2186@usr.bin/mandoc/roff.c","usr.bin/mandoc/roff.c","roff_unsupp",2180,2186
37,13,292,1,75,"roff_cond@2189-2264@usr.bin/mandoc/roff.c","usr.bin/mandoc/roff.c","roff_cond",2189,2264
22,6,139,1,36,"roff_ds@2267-2303@usr.bin/mandoc/roff.c","usr.bin/mandoc/roff.c","roff_ds",2267,2303
54,17,216,3,56,"roff_getop@2311-2367@usr.bin/mandoc/roff.c","usr.bin/mandoc/roff.c","roff_getop",2311,2367
14,5,108,6,23,"roff_evalpar@2374-2397@usr.bin/mandoc/roff.c","usr.bin/mandoc/roff.c","roff_evalpar",2374,2397
96,36,499,6,105,"roff_evalnum@2404-2509@usr.bin/mandoc/roff.c","usr.bin/mandoc/roff.c","roff_evalnum",2404,2509
21,6,145,4,26,"roff_setreg@2514-2540@usr.bin/mandoc/roff.c","usr.bin/mandoc/roff.c","roff_setreg",2514,2540
21,8,72,2,21,"roff_getregro@2549-2570@usr.bin/mandoc/roff.c","usr.bin/mandoc/roff.c","roff_getregro",2549,2570
14,7,108,2,16,"roff_getreg@2573-2589@usr.bin/mandoc/roff.c","usr.bin/mandoc/roff.c","roff_getreg",2573,2589
15,7,111,3,17,"roff_getregn@2592-2609@usr.bin/mandoc/roff.c","usr.bin/mandoc/roff.c","roff_getregn",2592,2609
15,7,109,3,17,"roff_hasregn@2612-2629@usr.bin/mandoc/roff.c","usr.bin/mandoc/roff.c","roff_hasregn",2612,2629
10,2,46,1,10,"roff_freereg@2632-2642@usr.bin/mandoc/roff.c","usr.bin/mandoc/roff.c","roff_freereg",2632,2642
20,6,125,1,24,"roff_nr@2645-2669@usr.bin/mandoc/roff.c","usr.bin/mandoc/roff.c","roff_nr",2645,2669
24,6,142,1,25,"roff_rr@2672-2697@usr.bin/mandoc/roff.c","usr.bin/mandoc/roff.c","roff_rr",2672,2697
16,3,112,1,16,"roff_rm@2702-2718@usr.bin/mandoc/roff.c","usr.bin/mandoc/roff.c","roff_rm",2702,2718
16,5,109,1,26,"roff_it@2721-2747@usr.bin/mandoc/roff.c","usr.bin/mandoc/roff.c","roff_it",2721,2747
27,7,133,1,27,"roff_Dd@2750-2777@usr.bin/mandoc/roff.c","usr.bin/mandoc/roff.c","roff_Dd",2750,2777
17,3,87,1,16,"roff_TE@2780-2796@usr.bin/mandoc/roff.c","usr.bin/mandoc/roff.c","roff_TE",2780,2796
9,2,44,1,10,"roff_T_@2799-2809@usr.bin/mandoc/roff.c","usr.bin/mandoc/roff.c","roff_T_",2799,2809
34,9,236,3,60,"roff_eqndelim@2815-2875@usr.bin/mandoc/roff.c","usr.bin/mandoc/roff.c","roff_eqndelim",2815,2875
24,5,194,1,27,"roff_EQ@2878-2905@usr.bin/mandoc/roff.c","usr.bin/mandoc/roff.c","roff_EQ",2878,2905
12,3,80,1,11,"roff_EN@2908-2919@usr.bin/mandoc/roff.c","usr.bin/mandoc/roff.c","roff_EN",2908,2919
15,3,89,1,14,"roff_TS@2922-2936@usr.bin/mandoc/roff.c","usr.bin/mandoc/roff.c","roff_TS",2922,2936
53,19,393,1,57,"roff_onearg@2939-2996@usr.bin/mandoc/roff.c","usr.bin/mandoc/roff.c","roff_onearg",2939,2996
18,5,136,1,20,"roff_manyarg@2999-3019@usr.bin/mandoc/roff.c","usr.bin/mandoc/roff.c","roff_manyarg",2999,3019
21,5,169,1,24,"roff_als@3022-3046@usr.bin/mandoc/roff.c","usr.bin/mandoc/roff.c","roff_als",3022,3046
12,3,104,1,11,"roff_br@3049-3060@usr.bin/mandoc/roff.c","usr.bin/mandoc/roff.c","roff_br",3049,3060
11,4,75,1,14,"roff_cc@3063-3077@usr.bin/mandoc/roff.c","usr.bin/mandoc/roff.c","roff_cc",3063,3077
14,3,74,1,14,"roff_ec@3080-3094@usr.bin/mandoc/roff.c","usr.bin/mandoc/roff.c","roff_ec",3080,3094
8,2,47,1,7,"roff_eo@3097-3104@usr.bin/mandoc/roff.c","usr.bin/mandoc/roff.c","roff_eo",3097,3104
51,10,363,1,59,"roff_tr@3107-3166@usr.bin/mandoc/roff.c","usr.bin/mandoc/roff.c","roff_tr",3107,3166
44,9,387,1,47,"roff_rn@3169-3216@usr.bin/mandoc/roff.c","usr.bin/mandoc/roff.c","roff_rn",3169,3216
18,4,123,1,27,"roff_so@3219-3246@usr.bin/mandoc/roff.c","usr.bin/mandoc/roff.c","roff_so",3219,3246
81,24,569,1,139,"roff_userdef@3251-3390@usr.bin/mandoc/roff.c","usr.bin/mandoc/roff.c","roff_userdef",3251,3390
9,2,63,1,9,"roff_renamed@3397-3406@usr.bin/mandoc/roff.c","usr.bin/mandoc/roff.c","roff_renamed",3397,3406
30,10,187,4,35,"roff_getname@3409-3444@usr.bin/mandoc/roff.c","usr.bin/mandoc/roff.c","roff_getname",3409,3444
9,2,75,4,9,"roff_setstr@3454-3463@usr.bin/mandoc/roff.c","usr.bin/mandoc/roff.c","roff_setstr",3454,3463
47,13,368,6,69,"roff_setstrn@3466-3535@usr.bin/mandoc/roff.c","usr.bin/mandoc/roff.c","roff_setstrn",3466,3535
58,24,405,4,58,"roff_getstrn@3538-3596@usr.bin/mandoc/roff.c","usr.bin/mandoc/roff.c","roff_getstrn",3538,3596
10,2,60,1,10,"roff_freestr@3599-3609@usr.bin/mandoc/roff.c","usr.bin/mandoc/roff.c","roff_freestr",3599,3609
54,13,435,2,85,"roff_strdup@3619-3704@usr.bin/mandoc/roff.c","usr.bin/mandoc/roff.c","roff_strdup",3619,3704
4,1,15,1,4,"roff_getformat@3707-3711@usr.bin/mandoc/roff.c","usr.bin/mandoc/roff.c","roff_getformat",3707,3711
19,10,133,3,22,"roff_getcontrol@3724-3746@usr.bin/mandoc/roff.c","usr.bin/mandoc/roff.c","roff_getcontrol",3724,3746
6,2,50,2,5,"roff_html_pre@51-56@usr.bin/mandoc/roff_html.c","usr.bin/mandoc/roff_html.c","roff_html_pre",51,56
7,1,36,1,7,"roff_html_pre_br@59-66@usr.bin/mandoc/roff_html.c","usr.bin/mandoc/roff_html.c","roff_html_pre_br",59,66
12,4,77,1,11,"roff_html_pre_ce@69-80@usr.bin/mandoc/roff_html.c","usr.bin/mandoc/roff_html.c","roff_html_pre_ce",69,80
13,4,94,1,13,"roff_html_pre_sp@83-96@usr.bin/mandoc/roff_html.c","usr.bin/mandoc/roff_html.c","roff_html_pre_sp",83,96
5,1,39,2,4,"roff_term_pre@56-60@usr.bin/mandoc/roff_term.c","usr.bin/mandoc/roff_term.c","roff_term_pre",56,60
9,2,53,1,8,"roff_term_pre_br@63-71@usr.bin/mandoc/roff_term.c","usr.bin/mandoc/roff_term.c","roff_term_pre_br",63,71
35,12,241,1,35,"roff_term_pre_ce@74-109@usr.bin/mandoc/roff_term.c","usr.bin/mandoc/roff_term.c","roff_term_pre_ce",74,109
24,10,82,1,23,"roff_term_pre_ft@112-135@usr.bin/mandoc/roff_term.c","usr.bin/mandoc/roff_term.c","roff_term_pre_ft",112,135
4,2,25,1,3,"roff_term_pre_ll@138-141@usr.bin/mandoc/roff_term.c","usr.bin/mandoc/roff_term.c","roff_term_pre_ll",138,141
13,3,68,1,12,"roff_term_pre_mc@144-156@usr.bin/mandoc/roff_term.c","usr.bin/mandoc/roff_term.c","roff_term_pre_mc",144,156
18,6,121,1,19,"roff_term_pre_po@159-178@usr.bin/mandoc/roff_term.c","usr.bin/mandoc/roff_term.c","roff_term_pre_po",159,178
17,5,94,1,19,"roff_term_pre_sp@181-200@usr.bin/mandoc/roff_term.c","usr.bin/mandoc/roff_term.c","roff_term_pre_sp",181,200
6,2,40,1,5,"roff_term_pre_ta@203-208@usr.bin/mandoc/roff_term.c","usr.bin/mandoc/roff_term.c","roff_term_pre_ta",203,208
34,8,214,1,37,"roff_term_pre_ti@211-248@usr.bin/mandoc/roff_term.c","usr.bin/mandoc/roff_term.c","roff_term_pre_ti",211,248
8,2,55,1,8,"roff_validate@48-56@usr.bin/mandoc/roff_validate.c","usr.bin/mandoc/roff_validate.c","roff_validate",48,56
36,17,185,1,38,"roff_valid_ft@59-97@usr.bin/mandoc/roff_validate.c","usr.bin/mandoc/roff_validate.c","roff_valid_ft",59,97
5,1,14,1,6,"mdoc_a2st@30-36@usr.bin/mandoc/st.c","usr.bin/mandoc/st.c","mdoc_a2st",30,36
44,8,323,1,67,"tag_init@51-118@usr.bin/mandoc/tag.c","usr.bin/mandoc/tag.c","tag_init",51,118
39,15,294,3,59,"tag_put@125-184@usr.bin/mandoc/tag.c","usr.bin/mandoc/tag.c","tag_put",125,184
23,7,151,1,23,"tag_write@191-214@usr.bin/mandoc/tag.c","usr.bin/mandoc/tag.c","tag_write",191,214
15,7,98,1,15,"tag_unlink@217-232@usr.bin/mandoc/tag.c","usr.bin/mandoc/tag.c","tag_unlink",217,232
11,1,66,1,12,"tag_signal@235-247@usr.bin/mandoc/tag.c","usr.bin/mandoc/tag.c","tag_signal",235,247
42,11,195,4,51,"tbl_read@33-84@usr.bin/mandoc/tbl.c","usr.bin/mandoc/tbl.c","tbl_read",33,84
12,1,76,3,12,"tbl_alloc@87-99@usr.bin/mandoc/tbl.c","usr.bin/mandoc/tbl.c","tbl_alloc",87,99
28,5,160,1,30,"tbl_free@102-132@usr.bin/mandoc/tbl.c","usr.bin/mandoc/tbl.c","tbl_free",102,132
9,2,56,3,9,"tbl_restart@135-144@usr.bin/mandoc/tbl.c","usr.bin/mandoc/tbl.c","tbl_restart",135,144
10,3,48,1,10,"tbl_span@147-157@usr.bin/mandoc/tbl.c","usr.bin/mandoc/tbl.c","tbl_span",147,157
16,5,98,1,17,"tbl_end@160-177@usr.bin/mandoc/tbl.c","usr.bin/mandoc/tbl.c","tbl_end",160,177
65,25,526,5,89,"getdata@38-127@usr.bin/mandoc/tbl_data.c","usr.bin/mandoc/tbl_data.c","getdata",38,127
31,8,253,4,37,"tbl_cdata@130-167@usr.bin/mandoc/tbl_data.c","usr.bin/mandoc/tbl_data.c","tbl_cdata",130,167
16,2,104,3,18,"newspan@170-188@usr.bin/mandoc/tbl_data.c","usr.bin/mandoc/tbl_data.c","newspan",170,188
36,13,278,4,48,"tbl_data@191-239@usr.bin/mandoc/tbl_data.c","usr.bin/mandoc/tbl_data.c","tbl_data",191,239
4,1,14,2,3,"html_tbl_len@36-39@usr.bin/mandoc/tbl_html.c","usr.bin/mandoc/tbl_html.c","html_tbl_len",36,39
4,1,19,2,3,"html_tbl_strlen@42-45@usr.bin/mandoc/tbl_html.c","usr.bin/mandoc/tbl_html.c","html_tbl_strlen",42,45
27,12,159,2,27,"html_tbl_sulen@48-75@usr.bin/mandoc/tbl_html.c","usr.bin/mandoc/tbl_html.c","html_tbl_sulen",48,75
17,3,152,2,19,"html_tblopen@78-97@usr.bin/mandoc/tbl_html.c","usr.bin/mandoc/tbl_html.c","html_tblopen",78,97
6,1,31,1,6,"print_tblclose@100-106@usr.bin/mandoc/tbl_html.c","usr.bin/mandoc/tbl_html.c","print_tblclose",100,106
39,10,251,2,50,"print_tbl@109-159@usr.bin/mandoc/tbl_html.c","usr.bin/mandoc/tbl_html.c","print_tbl",109,159
123,45,775,5,140,"mods@60-200@usr.bin/mandoc/tbl_layout.c","usr.bin/mandoc/tbl_layout.c","mods",60,200
43,19,354,5,58,"cell@203-261@usr.bin/mandoc/tbl_layout.c","usr.bin/mandoc/tbl_layout.c","cell",203,261
63,21,404,4,87,"tbl_layout@264-351@usr.bin/mandoc/tbl_layout.c","usr.bin/mandoc/tbl_layout.c","tbl_layout",264,351
16,3,121,3,19,"cell_alloc@354-373@usr.bin/mandoc/tbl_layout.c","usr.bin/mandoc/tbl_layout.c","cell_alloc",354,373
44,15,281,5,50,"arg@63-113@usr.bin/mandoc/tbl_opts.c","usr.bin/mandoc/tbl_opts.c","arg",63,113
38,13,261,4,50,"tbl_option@121-171@usr.bin/mandoc/tbl_opts.c","usr.bin/mandoc/tbl_opts.c","tbl_option",121,171
6,2,41,2,6,"term_tbl_sulen@50-56@usr.bin/mandoc/tbl_term.c","usr.bin/mandoc/tbl_term.c","term_tbl_sulen",50,56
4,1,27,2,3,"term_tbl_strlen@59-62@usr.bin/mandoc/tbl_term.c","usr.bin/mandoc/tbl_term.c","term_tbl_strlen",59,62
4,1,25,2,3,"term_tbl_len@65-68@usr.bin/mandoc/tbl_term.c","usr.bin/mandoc/tbl_term.c","term_tbl_len",65,68
292,126,2190,2,375,"term_tbl@71-446@usr.bin/mandoc/tbl_term.c","usr.bin/mandoc/tbl_term.c","term_tbl",71,446
47,25,369,3,48,"tbl_hrule@456-504@usr.bin/mandoc/tbl_term.c","usr.bin/mandoc/tbl_term.c","tbl_hrule",456,504
47,16,201,5,49,"tbl_data@507-556@usr.bin/mandoc/tbl_term.c","usr.bin/mandoc/tbl_term.c","tbl_data",507,556
10,2,70,3,12,"tbl_char@559-571@usr.bin/mandoc/tbl_term.c","usr.bin/mandoc/tbl_term.c","tbl_char",559,571
36,8,211,3,39,"tbl_literal@574-613@usr.bin/mandoc/tbl_term.c","usr.bin/mandoc/tbl_term.c","tbl_literal",574,613
32,7,262,4,42,"tbl_number@616-658@usr.bin/mandoc/tbl_term.c","usr.bin/mandoc/tbl_term.c","tbl_number",616,658
11,3,75,2,13,"tbl_word@661-674@usr.bin/mandoc/tbl_term.c","usr.bin/mandoc/tbl_term.c","tbl_word",661,674
10,2,69,2,9,"term_setcol@41-50@usr.bin/mandoc/term.c","usr.bin/mandoc/term.c","term_setcol",41,50
8,2,64,1,7,"term_free@53-60@usr.bin/mandoc/term.c","usr.bin/mandoc/term.c","term_free",53,60
8,1,49,4,8,"term_begin@63-71@usr.bin/mandoc/term.c","usr.bin/mandoc/term.c","term_begin",63,71
4,1,19,1,4,"term_end@74-78@usr.bin/mandoc/term.c","usr.bin/mandoc/term.c","term_end",74,78
141,59,1187,1,213,"term_flushln@106-319@usr.bin/mandoc/term.c","usr.bin/mandoc/term.c","term_flushln",106,319
17,5,132,1,16,"endline@322-338@usr.bin/mandoc/term.c","usr.bin/mandoc/term.c","endline",322,338
6,3,32,1,6,"term_newln@346-352@usr.bin/mandoc/term.c","usr.bin/mandoc/term.c","term_newln",346,352
10,2,50,1,10,"term_vspace@361-371@usr.bin/mandoc/term.c","usr.bin/mandoc/term.c","term_vspace",361,371
7,1,43,1,7,"term_fontlast@375-382@usr.bin/mandoc/term.c","usr.bin/mandoc/term.c","term_fontlast",375,382
5,1,37,2,5,"term_fontrepl@386-391@usr.bin/mandoc/term.c","usr.bin/mandoc/term.c","term_fontrepl",386,391
10,2,79,2,10,"term_fontpush@395-405@usr.bin/mandoc/term.c","usr.bin/mandoc/term.c","term_fontpush",395,405
6,2,33,2,6,"term_fontpopq@409-415@usr.bin/mandoc/term.c","usr.bin/mandoc/term.c","term_fontpopq",409,415
5,1,21,1,5,"term_fontpop@419-424@usr.bin/mandoc/term.c","usr.bin/mandoc/term.c","term_fontpop",419,424
203,66,1214,2,213,"term_word@432-645@usr.bin/mandoc/term.c","usr.bin/mandoc/term.c","term_word",432,645
8,3,64,2,7,"adjbuf@648-655@usr.bin/mandoc/term.c","usr.bin/mandoc/term.c","adjbuf",648,655
13,7,121,2,12,"bufferc@658-670@usr.bin/mandoc/term.c","usr.bin/mandoc/term.c","bufferc",658,670
39,19,344,2,42,"encode1@678-720@usr.bin/mandoc/term.c","usr.bin/mandoc/term.c","encode1",678,720
29,13,250,3,37,"encode@723-760@usr.bin/mandoc/term.c","usr.bin/mandoc/term.c","encode",723,760
26,5,118,2,26,"term_setwidth@763-789@usr.bin/mandoc/term.c","usr.bin/mandoc/term.c","term_setwidth",763,789
4,1,28,2,4,"term_len@792-796@usr.bin/mandoc/term.c","usr.bin/mandoc/term.c","term_len",792,796
8,2,48,3,8,"cond_width@799-807@usr.bin/mandoc/term.c","usr.bin/mandoc/term.c","cond_width",799,807
94,27,515,2,117,"term_strlen@810-927@usr.bin/mandoc/term.c","usr.bin/mandoc/term.c","term_strlen",810,927
39,13,203,2,39,"term_vspan@930-969@usr.bin/mandoc/term.c","usr.bin/mandoc/term.c","term_vspan",930,969
4,1,29,2,4,"term_hspan@975-979@usr.bin/mandoc/term.c","usr.bin/mandoc/term.c","term_hspan",975,979
8,2,62,2,8,"term_hen@985-993@usr.bin/mandoc/term.c","usr.bin/mandoc/term.c","term_hen",985,993
46,9,310,2,60,"ascii_init@53-113@usr.bin/mandoc/term_ascii.c","usr.bin/mandoc/term_ascii.c","ascii_init",53,113
4,1,18,1,4,"ascii_alloc@116-120@usr.bin/mandoc/term_ascii.c","usr.bin/mandoc/term_ascii.c","ascii_alloc",116,120
4,1,18,1,4,"utf8_alloc@123-127@usr.bin/mandoc/term_ascii.c","usr.bin/mandoc/term_ascii.c","utf8_alloc",123,127
4,1,18,1,4,"locale_alloc@130-134@usr.bin/mandoc/term_ascii.c","usr.bin/mandoc/term_ascii.c","locale_alloc",130,134
15,5,112,3,15,"ascii_setwidth@137-152@usr.bin/mandoc/term_ascii.c","usr.bin/mandoc/term_ascii.c","ascii_setwidth",137,152
11,2,82,1,11,"terminal_sepline@155-166@usr.bin/mandoc/term_ascii.c","usr.bin/mandoc/term_ascii.c","terminal_sepline",155,166
4,1,16,2,4,"ascii_width@169-173@usr.bin/mandoc/term_ascii.c","usr.bin/mandoc/term_ascii.c","ascii_width",169,173
4,1,18,1,4,"ascii_free@176-180@usr.bin/mandoc/term_ascii.c","usr.bin/mandoc/term_ascii.c","ascii_free",176,180
4,1,17,2,4,"ascii_letter@183-187@usr.bin/mandoc/term_ascii.c","usr.bin/mandoc/term_ascii.c","ascii_letter",183,187
4,1,23,1,4,"ascii_begin@190-194@usr.bin/mandoc/term_ascii.c","usr.bin/mandoc/term_ascii.c","ascii_begin",190,194
4,1,23,1,4,"ascii_end@197-201@usr.bin/mandoc/term_ascii.c","usr.bin/mandoc/term_ascii.c","ascii_end",197,201
7,1,35,1,7,"ascii_endline@204-211@usr.bin/mandoc/term_ascii.c","usr.bin/mandoc/term_ascii.c","ascii_endline",204,211
6,2,33,2,6,"ascii_advance@214-220@usr.bin/mandoc/term_ascii.c","usr.bin/mandoc/term_ascii.c","ascii_advance",214,220
35,12,182,2,35,"ascii_hspan@223-258@usr.bin/mandoc/term_ascii.c","usr.bin/mandoc/term_ascii.c","ascii_hspan",223,258
73,2,1094,1,73,"ascii_uc2str@261-334@usr.bin/mandoc/term_ascii.c","usr.bin/mandoc/term_ascii.c","ascii_uc2str",261,334
10,3,46,2,10,"locale_width@337-347@usr.bin/mandoc/term_ascii.c","usr.bin/mandoc/term_ascii.c","locale_width",337,347
6,2,34,2,6,"locale_advance@350-356@usr.bin/mandoc/term_ascii.c","usr.bin/mandoc/term_ascii.c","locale_advance",350,356
7,1,36,1,7,"locale_endline@359-366@usr.bin/mandoc/term_ascii.c","usr.bin/mandoc/term_ascii.c","locale_endline",359,366
4,1,17,2,4,"locale_letter@369-373@usr.bin/mandoc/term_ascii.c","usr.bin/mandoc/term_ascii.c","locale_letter",369,373
4,1,18,1,3,"pdf_alloc@511-514@usr.bin/mandoc/term_ps.c","usr.bin/mandoc/term_ps.c","pdf_alloc",511,514
4,1,18,1,3,"ps_alloc@517-520@usr.bin/mandoc/term_ps.c","usr.bin/mandoc/term_ps.c","ps_alloc",517,520
66,8,605,2,96,"pspdf_alloc@523-619@usr.bin/mandoc/term_ps.c","usr.bin/mandoc/term_ps.c","pspdf_alloc",523,619
14,5,105,3,14,"ps_setwidth@622-636@usr.bin/mandoc/term_ps.c","usr.bin/mandoc/term_ps.c","ps_setwidth",622,636
9,1,52,1,11,"pspdf_free@639-650@usr.bin/mandoc/term_ps.c","usr.bin/mandoc/term_ps.c","pspdf_free",639,650
17,3,136,3,34,"ps_printf@653-687@usr.bin/mandoc/term_ps.c","usr.bin/mandoc/term_ps.c","ps_printf",653,687
13,2,86,2,17,"ps_putchar@690-707@usr.bin/mandoc/term_ps.c","usr.bin/mandoc/term_ps.c","ps_putchar",690,707
11,2,100,2,13,"pdf_obj@710-723@usr.bin/mandoc/term_ps.c","usr.bin/mandoc/term_ps.c","pdf_obj",710,723
32,4,278,1,48,"ps_closepage@726-774@usr.bin/mandoc/term_ps.c","usr.bin/mandoc/term_ps.c","ps_closepage",726,774
49,5,412,1,64,"ps_end@777-841@usr.bin/mandoc/term_ps.c","usr.bin/mandoc/term_ps.c","ps_end",777,841
81,6,661,1,106,"ps_begin@844-950@usr.bin/mandoc/term_ps.c","usr.bin/mandoc/term_ps.c","ps_begin",844,950
52,11,403,2,77,"ps_pletter@953-1030@usr.bin/mandoc/term_ps.c","usr.bin/mandoc/term_ps.c","ps_pletter",953,1030
14,4,91,1,22,"ps_pclose@1033-1055@usr.bin/mandoc/term_ps.c","usr.bin/mandoc/term_ps.c","ps_pclose",1033,1055
23,6,193,1,39,"ps_plast@1059-1098@usr.bin/mandoc/term_ps.c","usr.bin/mandoc/term_ps.c","ps_plast",1059,1098
53,13,305,2,93,"ps_letter@1101-1194@usr.bin/mandoc/term_ps.c","usr.bin/mandoc/term_ps.c","ps_letter",1101,1194
6,1,30,2,13,"ps_advance@1197-1210@usr.bin/mandoc/term_ps.c","usr.bin/mandoc/term_ps.c","ps_advance",1197,1210
17,4,112,1,40,"ps_endline@1213-1253@usr.bin/mandoc/term_ps.c","usr.bin/mandoc/term_ps.c","ps_endline",1213,1253
12,3,79,2,19,"ps_setfont@1256-1275@usr.bin/mandoc/term_ps.c","usr.bin/mandoc/term_ps.c","ps_setfont",1256,1275
8,3,53,2,9,"ps_width@1278-1287@usr.bin/mandoc/term_ps.c","usr.bin/mandoc/term_ps.c","ps_width",1278,1287
40,10,257,2,52,"ps_hspan@1290-1342@usr.bin/mandoc/term_ps.c","usr.bin/mandoc/term_ps.c","ps_hspan",1290,1342
9,3,69,2,10,"ps_growbuf@1345-1355@usr.bin/mandoc/term_ps.c","usr.bin/mandoc/term_ps.c","ps_growbuf",1345,1355
38,11,264,2,50,"term_tab_set@39-89@usr.bin/mandoc/term_tab.c","usr.bin/mandoc/term_tab.c","term_tab_set",39,89
9,2,78,1,8,"term_tab_iset@96-104@usr.bin/mandoc/term_tab.c","usr.bin/mandoc/term_tab.c","term_tab_iset",96,104
21,8,197,1,21,"term_tab_next@107-128@usr.bin/mandoc/term_tab.c","usr.bin/mandoc/term_tab.c","term_tab_next",107,128
6,1,38,2,5,"tree_mdoc@40-45@usr.bin/mandoc/tree.c","usr.bin/mandoc/tree.c","tree_mdoc",40,45
8,2,53,2,7,"tree_man@48-55@usr.bin/mandoc/tree.c","usr.bin/mandoc/tree.c","tree_man",48,55
17,8,129,1,16,"print_meta@58-74@usr.bin/mandoc/tree.c","usr.bin/mandoc/tree.c","print_meta",58,74
124,41,660,2,132,"print_mdoc@77-209@usr.bin/mandoc/tree.c","usr.bin/mandoc/tree.c","print_mdoc",77,209
77,27,356,2,82,"print_man@212-294@usr.bin/mandoc/tree.c","usr.bin/mandoc/tree.c","print_man",212,294
55,19,336,2,59,"print_box@297-356@usr.bin/mandoc/tree.c","usr.bin/mandoc/tree.c","print_box",297,356
39,12,190,2,42,"print_span@359-401@usr.bin/mandoc/tree.c","usr.bin/mandoc/tree.c","print_span",359,401
41,12,270,2,47,"main@49-96@usr.bin/mesg/mesg.c","usr.bin/mesg/mesg.c","main",49,96
27,6,146,1,29,"find_autoexec@32-61@usr.bin/mg/autoexec.c","usr.bin/mg/autoexec.c","find_autoexec",32,61
23,5,129,2,24,"add_autoexec@64-88@usr.bin/mg/autoexec.c","usr.bin/mg/autoexec.c","add_autoexec",64,88
18,6,145,2,18,"auto_execute@98-116@usr.bin/mg/autoexec.c","usr.bin/mg/autoexec.c","auto_execute",98,116
7,2,32,2,7,"gotobol@29-36@usr.bin/mg/basic.c","usr.bin/mg/basic.c","gotobol",29,36
23,6,130,2,23,"backchar@46-69@usr.bin/mg/basic.c","usr.bin/mg/basic.c","backchar",46,69
7,2,37,2,7,"gotoeol@76-83@usr.bin/mg/basic.c","usr.bin/mg/basic.c","gotoeol",76,83
23,6,136,2,22,"forwchar@93-115@usr.bin/mg/basic.c","usr.bin/mg/basic.c","forwchar",93,115
9,1,52,2,8,"gotobob@123-131@usr.bin/mg/basic.c","usr.bin/mg/basic.c","gotobob",123,131
18,4,126,2,21,"gotoeob@139-160@usr.bin/mg/basic.c","usr.bin/mg/basic.c","gotoeob",139,160
36,9,210,2,37,"forwline@171-208@usr.bin/mg/basic.c","usr.bin/mg/basic.c","forwline",171,208
29,9,174,2,29,"backline@219-248@usr.bin/mg/basic.c","usr.bin/mg/basic.c","backline",219,248
4,1,13,1,4,"setgoal@256-260@usr.bin/mg/basic.c","usr.bin/mg/basic.c","setgoal",256,260
23,8,134,1,26,"getgoal@270-296@usr.bin/mg/basic.c","usr.bin/mg/basic.c","getgoal",270,296
28,10,194,2,34,"forwpage@308-342@usr.bin/mg/basic.c","usr.bin/mg/basic.c","forwpage",308,342
33,12,231,2,40,"backpage@354-394@usr.bin/mg/basic.c","usr.bin/mg/basic.c","backpage",354,394
9,2,43,2,8,"forw1page@401-409@usr.bin/mg/basic.c","usr.bin/mg/basic.c","forw1page",401,409
9,2,43,2,8,"back1page@412-420@usr.bin/mg/basic.c","usr.bin/mg/basic.c","back1page",412,420
15,2,78,2,15,"pagenext@427-442@usr.bin/mg/basic.c","usr.bin/mg/basic.c","pagenext",427,442
6,1,30,1,5,"isetmark@448-453@usr.bin/mg/basic.c","usr.bin/mg/basic.c","isetmark",448,453
6,1,24,2,5,"setmark@462-467@usr.bin/mg/basic.c","usr.bin/mg/basic.c","setmark",462,467
9,2,45,2,10,"clearmark@472-482@usr.bin/mg/basic.c","usr.bin/mg/basic.c","clearmark",472,482
21,2,115,2,21,"swapmark@493-514@usr.bin/mg/basic.c","usr.bin/mg/basic.c","swapmark",493,514
19,5,127,2,19,"gotoline@525-544@usr.bin/mg/basic.c","usr.bin/mg/basic.c","gotoline",525,544
32,7,171,1,32,"setlineno@550-582@usr.bin/mg/basic.c","usr.bin/mg/basic.c","setlineno",550,582
5,1,14,1,4,"bellinit@23-27@usr.bin/mg/bell.c","usr.bin/mg/bell.c","bellinit",23,27
13,4,42,1,12,"dobeep@30-42@usr.bin/mg/bell.c","usr.bin/mg/bell.c","dobeep",30,42
8,2,33,2,8,"toggleaudiblebell@46-54@usr.bin/mg/bell.c","usr.bin/mg/bell.c","toggleaudiblebell",46,54
8,2,33,2,8,"togglevisiblebell@58-66@usr.bin/mg/bell.c","usr.bin/mg/bell.c","togglevisiblebell",58,66
15,4,81,2,16,"togglereadonly@34-50@usr.bin/mg/buffer.c","usr.bin/mg/buffer.c","togglereadonly",34,50
13,6,105,1,15,"usebufname@56-71@usr.bin/mg/buffer.c","usr.bin/mg/buffer.c","usebufname",56,71
12,3,83,2,15,"usebuffer@81-96@usr.bin/mg/buffer.c","usr.bin/mg/buffer.c","usebuffer",81,96
26,8,197,2,28,"poptobuffer@103-131@usr.bin/mg/buffer.c","usr.bin/mg/buffer.c","poptobuffer",103,131
15,5,110,2,15,"killbuffer_cmd@142-157@usr.bin/mg/buffer.c","usr.bin/mg/buffer.c","killbuffer_cmd",142,157
53,17,344,1,63,"killbuffer@160-223@usr.bin/mg/buffer.c","usr.bin/mg/buffer.c","killbuffer",160,223
6,2,29,2,5,"savebuffers@230-235@usr.bin/mg/buffer.c","usr.bin/mg/buffer.c","savebuffers",230,235
18,4,130,2,20,"listbuffers@277-297@usr.bin/mg/buffer.c","usr.bin/mg/buffer.c","listbuffers",277,297
44,14,301,1,50,"makelist@307-357@usr.bin/mg/buffer.c","usr.bin/mg/buffer.c","makelist",307,357
4,1,22,2,3,"listbuf_goto_buffer@360-363@usr.bin/mg/buffer.c","usr.bin/mg/buffer.c","listbuf_goto_buffer",360,363
4,1,22,2,3,"listbuf_goto_buffer_one@366-369@usr.bin/mg/buffer.c","usr.bin/mg/buffer.c","listbuf_goto_buffer_one",366,369
40,11,258,3,47,"listbuf_goto_buffer_helper@372-419@usr.bin/mg/buffer.c","usr.bin/mg/buffer.c","listbuf_goto_buffer_helper",372,419
21,3,144,3,23,"addlinef@427-450@usr.bin/mg/buffer.c","usr.bin/mg/buffer.c","addlinef",427,450
32,11,215,1,32,"anycb@459-491@usr.bin/mg/buffer.c","usr.bin/mg/buffer.c","anycb",459,491
14,4,76,2,16,"bfind@500-516@usr.bin/mg/buffer.c","usr.bin/mg/buffer.c","bfind",500,516
52,8,341,1,54,"bnew@523-577@usr.bin/mg/buffer.c","usr.bin/mg/buffer.c","bnew",523,577
18,4,129,1,20,"bclear@590-610@usr.bin/mg/buffer.c","usr.bin/mg/buffer.c","bclear",590,610
42,9,299,3,48,"showbuffer@617-665@usr.bin/mg/buffer.c","usr.bin/mg/buffer.c","showbuffer",617,665
11,3,88,3,13,"augbname@676-689@usr.bin/mg/buffer.c","usr.bin/mg/buffer.c","augbname",676,689
24,10,146,2,37,"popbuf@696-733@usr.bin/mg/buffer.c","usr.bin/mg/buffer.c","popbuf",696,733
47,16,320,2,51,"bufferinsert@740-791@usr.bin/mg/buffer.c","usr.bin/mg/buffer.c","bufferinsert",740,791
13,3,63,2,13,"notmodified@798-811@usr.bin/mg/buffer.c","usr.bin/mg/buffer.c","notmodified",798,811
15,4,100,2,15,"popbuftop@817-832@usr.bin/mg/buffer.c","usr.bin/mg/buffer.c","popbuftop",817,832
17,5,110,2,18,"getbufcwd@840-858@usr.bin/mg/buffer.c","usr.bin/mg/buffer.c","getbufcwd",840,858
22,6,118,1,24,"checkdirty@867-891@usr.bin/mg/buffer.c","usr.bin/mg/buffer.c","checkdirty",867,891
14,3,80,2,17,"revertbuffer@898-915@usr.bin/mg/buffer.c","usr.bin/mg/buffer.c","revertbuffer",898,915
24,5,132,1,31,"dorevert@918-949@usr.bin/mg/buffer.c","usr.bin/mg/buffer.c","dorevert",918,949
57,13,384,2,67,"diffbuffer@956-1023@usr.bin/mg/buffer.c","usr.bin/mg/buffer.c","diffbuffer",956,1023
18,5,130,1,21,"findbuffer@1030-1051@usr.bin/mg/buffer.c","usr.bin/mg/buffer.c","findbuffer",1030,1051
52,14,298,3,52,"getkeyname@106-158@usr.bin/mg/cinfo.c","usr.bin/mg/cinfo.c","getkeyname",106,158
10,1,60,1,9,"cmode_init@92-101@usr.bin/mg/cmode.c","usr.bin/mg/cmode.c","cmode_init",92,101
4,1,22,2,3,"cmode@107-110@usr.bin/mg/cmode.c","usr.bin/mg/cmode.c","cmode",107,110
8,3,47,2,7,"cc_char@116-123@usr.bin/mg/cmode.c","usr.bin/mg/cmode.c","cc_char",116,123
8,3,47,2,7,"cc_brace@129-136@usr.bin/mg/cmode.c","usr.bin/mg/cmode.c","cc_brace",129,136
8,3,64,2,11,"cc_tab@145-156@usr.bin/mg/cmode.c","usr.bin/mg/cmode.c","cc_tab",145,156
22,4,135,2,36,"cc_indent@162-198@usr.bin/mg/cmode.c","usr.bin/mg/cmode.c","cc_indent",162,198
8,3,47,2,7,"cc_lfindent@204-211@usr.bin/mg/cmode.c","usr.bin/mg/cmode.c","cc_lfindent",204,211
107,40,580,2,134,"getindent@220-354@usr.bin/mg/cmode.c","usr.bin/mg/cmode.c","getindent",220,354
22,6,91,2,23,"getmatch@361-384@usr.bin/mg/cmode.c","usr.bin/mg/cmode.c","getmatch",361,384
12,4,67,2,13,"in_whitespace@387-400@usr.bin/mg/cmode.c","usr.bin/mg/cmode.c","in_whitespace",387,400
22,7,135,3,27,"findcolpos@405-432@usr.bin/mg/cmode.c","usr.bin/mg/cmode.c","findcolpos",405,432
35,15,207,1,48,"findnonblank@440-488@usr.bin/mg/cmode.c","usr.bin/mg/cmode.c","findnonblank",440,488
21,8,114,2,24,"isnonblank@498-522@usr.bin/mg/cmode.c","usr.bin/mg/cmode.c","isnonblank",498,522
4,1,18,2,3,"cssymbol@83-86@usr.bin/mg/cscope.c","usr.bin/mg/cscope.c","cssymbol",83,86
4,1,18,2,3,"csdefinition@92-95@usr.bin/mg/cscope.c","usr.bin/mg/cscope.c","csdefinition",92,95
4,1,18,2,3,"csfuncalled@102-105@usr.bin/mg/cscope.c","usr.bin/mg/cscope.c","csfuncalled",102,105
4,1,18,2,3,"cscallerfuncs@112-115@usr.bin/mg/cscope.c","usr.bin/mg/cscope.c","cscallerfuncs",112,115
4,1,18,2,3,"csfindtext@122-125@usr.bin/mg/cscope.c","usr.bin/mg/cscope.c","csfindtext",122,125
4,1,18,2,3,"csegrep@132-135@usr.bin/mg/cscope.c","usr.bin/mg/cscope.c","csegrep",132,135
4,1,18,2,3,"csfindfile@142-145@usr.bin/mg/cscope.c","usr.bin/mg/cscope.c","csfindfile",142,145
4,1,18,2,3,"csfindinc@152-155@usr.bin/mg/cscope.c","usr.bin/mg/cscope.c","csfindinc",152,155
66,16,459,2,75,"cscreatelist@163-238@usr.bin/mg/cscope.c","usr.bin/mg/cscope.c","cscreatelist",163,238
30,5,153,2,30,"csnextmatch@245-275@usr.bin/mg/cscope.c","usr.bin/mg/cscope.c","csnextmatch",245,275
26,4,116,2,26,"csprevmatch@282-308@usr.bin/mg/cscope.c","usr.bin/mg/cscope.c","csprevmatch",282,308
20,4,108,2,21,"csnextfile@314-335@usr.bin/mg/cscope.c","usr.bin/mg/cscope.c","csnextfile",314,335
21,4,111,2,22,"csprevfile@341-363@usr.bin/mg/cscope.c","usr.bin/mg/cscope.c","csprevfile",341,363
21,8,133,1,21,"jumptomatch@371-392@usr.bin/mg/cscope.c","usr.bin/mg/cscope.c","jumptomatch",371,392
70,17,475,1,78,"do_cscope@400-478@usr.bin/mg/cscope.c","usr.bin/mg/cscope.c","do_cscope",400,478
43,10,319,2,45,"addentry@485-530@usr.bin/mg/cscope.c","usr.bin/mg/cscope.c","addentry",485,530
22,5,144,2,26,"getattr@536-562@usr.bin/mg/cscope.c","usr.bin/mg/cscope.c","getattr",536,562
8,2,60,2,8,"prettyprint@565-573@usr.bin/mg/cscope.c","usr.bin/mg/cscope.c","prettyprint",565,573
6,2,27,1,5,"ltrim@576-581@usr.bin/mg/cscope.c","usr.bin/mg/cscope.c","ltrim",576,581
18,3,105,1,18,"csflush@584-602@usr.bin/mg/cscope.c","usr.bin/mg/cscope.c","csflush",584,602
38,12,255,1,41,"csexists@609-650@usr.bin/mg/cscope.c","usr.bin/mg/cscope.c","csexists",609,650
8,1,20,1,7,"undo_rec::TAILQ_ENTRY@297-304@usr.bin/mg/def.h","usr.bin/mg/def.h","undo_rec::TAILQ_ENTRY",297,304
8,5,73,1,7,"dirinit@27-34@usr.bin/mg/dir.c","usr.bin/mg/dir.c","dirinit",27,34
25,7,208,2,26,"changedir@41-67@usr.bin/mg/dir.c","usr.bin/mg/dir.c","changedir",41,67
5,1,22,2,4,"showcwdir@74-78@usr.bin/mg/dir.c","usr.bin/mg/dir.c","showcwdir",74,78
6,2,34,2,6,"getcwdir@81-87@usr.bin/mg/dir.c","usr.bin/mg/dir.c","getcwdir",81,87
4,1,17,2,3,"makedir@92-95@usr.bin/mg/dir.c","usr.bin/mg/dir.c","makedir",92,95
13,4,88,1,15,"ask_makedir@98-113@usr.bin/mg/dir.c","usr.bin/mg/dir.c","ask_makedir",98,113
55,18,318,1,67,"do_makedir@116-183@usr.bin/mg/dir.c","usr.bin/mg/dir.c","do_makedir",116,183
21,1,139,1,20,"dired_init@202-222@usr.bin/mg/dired.c","usr.bin/mg/dired.c","dired_init",202,222
23,7,185,2,25,"dired@226-251@usr.bin/mg/dired.c","usr.bin/mg/dired.c","dired",226,251
27,8,206,2,28,"d_otherwindow@255-283@usr.bin/mg/dired.c","usr.bin/mg/dired.c","d_otherwindow",255,283
17,5,117,2,16,"d_del@287-303@usr.bin/mg/dired.c","usr.bin/mg/dired.c","d_del",287,303
15,5,110,2,14,"d_undel@307-321@usr.bin/mg/dired.c","usr.bin/mg/dired.c","d_undel",307,321
15,5,110,2,14,"d_undelbak@325-339@usr.bin/mg/dired.c","usr.bin/mg/dired.c","d_undelbak",325,339
20,6,129,2,20,"d_findfile@343-363@usr.bin/mg/dired.c","usr.bin/mg/dired.c","d_findfile",343,363
18,6,135,2,18,"d_ffotherwindow@367-385@usr.bin/mg/dired.c","usr.bin/mg/dired.c","d_ffotherwindow",367,385
49,10,293,2,53,"d_expunge@389-442@usr.bin/mg/dired.c","usr.bin/mg/dired.c","d_expunge",389,442
33,8,250,2,34,"d_copy@446-480@usr.bin/mg/dired.c","usr.bin/mg/dired.c","d_copy",446,480
34,8,251,2,35,"d_rename@484-519@usr.bin/mg/dired.c","usr.bin/mg/dired.c","d_rename",484,519
7,2,40,1,7,"reaper@523-530@usr.bin/mg/dired.c","usr.bin/mg/dired.c","reaper",523,530
27,6,206,2,31,"d_shell_command@537-568@usr.bin/mg/dired.c","usr.bin/mg/dired.c","d_shell_command",537,568
93,23,672,5,105,"d_exec@576-681@usr.bin/mg/dired.c","usr.bin/mg/dired.c","d_exec",576,681
11,3,67,2,13,"d_create_directory@685-698@usr.bin/mg/dired.c","usr.bin/mg/dired.c","d_create_directory",685,698
4,1,20,2,3,"d_killbuffer_cmd@702-705@usr.bin/mg/dired.c","usr.bin/mg/dired.c","d_killbuffer_cmd",702,705
7,2,47,2,8,"d_refreshbuffer@708-716@usr.bin/mg/dired.c","usr.bin/mg/dired.c","d_refreshbuffer",708,716
32,7,200,1,45,"refreshbuffer@724-769@usr.bin/mg/dired.c","usr.bin/mg/dired.c","refreshbuffer",724,769
12,4,105,3,15,"d_makename@772-787@usr.bin/mg/dired.c","usr.bin/mg/dired.c","d_makename",772,787
18,6,104,2,24,"d_warpdot@792-816@usr.bin/mg/dired.c","usr.bin/mg/dired.c","d_warpdot",792,816
5,1,34,2,4,"d_forwpage@819-823@usr.bin/mg/dired.c","usr.bin/mg/dired.c","d_forwpage",819,823
5,1,34,2,4,"d_backpage@826-830@usr.bin/mg/dired.c","usr.bin/mg/dired.c","d_backpage",826,830
5,1,34,2,4,"d_forwline@833-837@usr.bin/mg/dired.c","usr.bin/mg/dired.c","d_forwline",833,837
5,1,34,2,4,"d_backline@840-844@usr.bin/mg/dired.c","usr.bin/mg/dired.c","d_backline",840,844
7,2,47,2,8,"d_filevisitalt@847-855@usr.bin/mg/dired.c","usr.bin/mg/dired.c","d_filevisitalt",847,855
61,14,457,1,69,"dired_@861-930@usr.bin/mg/dired.c","usr.bin/mg/dired.c","dired_",861,930
41,8,261,1,43,"redelete@940-983@usr.bin/mg/dired.c","usr.bin/mg/dired.c","redelete",940,983
43,9,282,1,47,"createlist@989-1036@usr.bin/mg/dired.c","usr.bin/mg/dired.c","createlist",989,1036
9,2,49,2,9,"findfname@1042-1051@usr.bin/mg/dired.c","usr.bin/mg/dired.c","findfname",1042,1051
9,2,37,2,10,"linenotoggle@107-117@usr.bin/mg/display.c","usr.bin/mg/display.c","linenotoggle",107,117
9,2,37,2,10,"colnotoggle@121-131@usr.bin/mg/display.c","usr.bin/mg/display.c","colnotoggle",121,131
54,21,423,3,95,"vtresize@138-233@usr.bin/mg/display.c","usr.bin/mg/display.c","vtresize",138,233
9,2,45,1,15,"vtinit@250-265@usr.bin/mg/display.c","usr.bin/mg/display.c","vtinit",250,265
10,1,40,1,9,"vttidy@275-284@usr.bin/mg/display.c","usr.bin/mg/display.c","vttidy",275,284
5,1,18,2,4,"vtmove@294-298@usr.bin/mg/display.c","usr.bin/mg/display.c","vtmove",294,298
24,9,150,1,28,"vtputc@313-341@usr.bin/mg/display.c","usr.bin/mg/display.c","vtputc",313,341
27,11,184,1,31,"vtpute@349-380@usr.bin/mg/display.c","usr.bin/mg/display.c","vtpute",349,380
7,2,34,1,7,"vteeol@388-395@usr.bin/mg/display.c","usr.bin/mg/display.c","vteeol",388,395
214,58,1378,1,239,"update@407-646@usr.bin/mg/display.c","usr.bin/mg/display.c","update",407,646
9,1,65,2,8,"ucopy@657-665@usr.bin/mg/display.c","usr.bin/mg/display.c","ucopy",657,665
14,3,104,2,24,"updext@673-697@usr.bin/mg/display.c","usr.bin/mg/display.c","updext",673,697
64,28,470,3,78,"uline@709-787@usr.bin/mg/display.c","usr.bin/mg/display.c","uline",709,787
64,19,428,2,67,"modeline@798-865@usr.bin/mg/display.c","usr.bin/mg/display.c","modeline",798,865
9,2,38,1,9,"vtputs@871-880@usr.bin/mg/display.c","usr.bin/mg/display.c","vtputs",871,880
19,6,135,1,19,"hash@891-910@usr.bin/mg/display.c","usr.bin/mg/display.c","hash",891,910
72,11,470,2,72,"setscores@939-1011@usr.bin/mg/display.c","usr.bin/mg/display.c","setscores",939,1011
55,18,388,4,55,"traceback@1026-1081@usr.bin/mg/display.c","usr.bin/mg/display.c","traceback",1026,1081
8,1,32,1,7,"eerase@43-50@usr.bin/mg/echo.c","usr.bin/mg/echo.c","eerase",43,50
23,10,130,1,25,"eyorn@59-84@usr.bin/mg/echo.c","usr.bin/mg/echo.c","eyorn",59,84
27,12,150,1,29,"eynorr@93-122@usr.bin/mg/echo.c","usr.bin/mg/echo.c","eynorr",93,122
32,8,185,1,35,"eyesno@129-164@usr.bin/mg/echo.c","usr.bin/mg/echo.c","eyesno",129,164
9,1,60,5,9,"eread@175-184@usr.bin/mg/echo.c","usr.bin/mg/echo.c","eread",175,184
335,93,1915,5,344,"veread@187-531@usr.bin/mg/echo.c","usr.bin/mg/echo.c","veread",187,531
75,27,512,6,91,"complt@541-632@usr.bin/mg/echo.c","usr.bin/mg/echo.c","complt",541,632
99,24,635,3,150,"complt_list@638-788@usr.bin/mg/echo.c","usr.bin/mg/echo.c","complt_list",638,788
15,6,94,4,15,"getxtra@797-812@usr.bin/mg/echo.c","usr.bin/mg/echo.c","getxtra",797,812
14,2,65,2,15,"ewprintf@821-836@usr.bin/mg/echo.c","usr.bin/mg/echo.c","ewprintf",821,836
55,13,294,2,63,"eformat@853-916@usr.bin/mg/echo.c","usr.bin/mg/echo.c","eformat",853,916
11,3,59,2,11,"eputi@922-933@usr.bin/mg/echo.c","usr.bin/mg/echo.c","eputi",922,933
11,3,64,2,11,"eputl@939-950@usr.bin/mg/echo.c","usr.bin/mg/echo.c","eputl",939,950
6,2,29,1,6,"eputs@956-962@usr.bin/mg/echo.c","usr.bin/mg/echo.c","eputs",956,962
11,3,46,1,10,"eputc@969-979@usr.bin/mg/echo.c","usr.bin/mg/echo.c","eputc",969,979
10,2,42,1,10,"free_file_list@982-992@usr.bin/mg/echo.c","usr.bin/mg/echo.c","free_file_list",982,992
21,4,118,1,22,"copy_list@995-1017@usr.bin/mg/echo.c","usr.bin/mg/echo.c","copy_list",995,1017
32,13,217,2,34,"insert@38-72@usr.bin/mg/extend.c","usr.bin/mg/extend.c","insert",38,72
169,44,1242,4,176,"remap@92-268@usr.bin/mg/extend.c","usr.bin/mg/extend.c","remap",92,268
34,6,275,1,34,"reallocmap@275-309@usr.bin/mg/extend.c","usr.bin/mg/extend.c","reallocmap",275,309
12,4,89,3,12,"fixmap@315-327@usr.bin/mg/extend.c","usr.bin/mg/extend.c","fixmap",315,327
55,14,392,3,59,"dobind@334-393@usr.bin/mg/extend.c","usr.bin/mg/extend.c","dobind",334,393
24,7,180,4,28,"bindkey@402-430@usr.bin/mg/extend.c","usr.bin/mg/extend.c","bindkey",402,430
38,17,243,3,39,"dobindkey@436-475@usr.bin/mg/extend.c","usr.bin/mg/extend.c","dobindkey",436,475
4,1,22,2,3,"bindtokey@482-485@usr.bin/mg/extend.c","usr.bin/mg/extend.c","bindtokey",482,485
5,1,31,2,4,"localbind@492-496@usr.bin/mg/extend.c","usr.bin/mg/extend.c","localbind",492,496
20,5,171,2,21,"redefine_key@503-524@usr.bin/mg/extend.c","usr.bin/mg/extend.c","redefine_key",503,524
4,1,22,2,3,"unbindtokey@528-531@usr.bin/mg/extend.c","usr.bin/mg/extend.c","unbindtokey",528,531
5,1,31,2,4,"localunbind@535-539@usr.bin/mg/extend.c","usr.bin/mg/extend.c","localunbind",535,539
26,6,175,2,26,"extend@548-574@usr.bin/mg/extend.c","usr.bin/mg/extend.c","extend",548,574
10,3,71,2,10,"evalexpr@596-606@usr.bin/mg/extend.c","usr.bin/mg/extend.c","evalexpr",596,606
16,4,121,2,18,"evalbuffer@614-632@usr.bin/mg/extend.c","usr.bin/mg/extend.c","evalbuffer",614,632
10,3,68,2,10,"evalfile@640-650@usr.bin/mg/extend.c","usr.bin/mg/extend.c","evalfile",640,650
32,9,209,1,35,"load@656-691@usr.bin/mg/extend.c","usr.bin/mg/extend.c","load",656,691
211,64,1119,1,224,"excline@697-921@usr.bin/mg/extend.c","usr.bin/mg/extend.c","excline",697,921
8,7,59,1,7,"skipwhite@927-934@usr.bin/mg/extend.c","usr.bin/mg/extend.c","skipwhite",927,934
14,11,90,1,17,"parsetoken@937-954@usr.bin/mg/extend.c","usr.bin/mg/extend.c","parsetoken",937,954
16,5,120,2,16,"fileinsert@29-45@usr.bin/mg/file.c","usr.bin/mg/file.c","fileinsert",29,45
30,10,214,2,30,"filevisit@55-85@usr.bin/mg/file.c","usr.bin/mg/file.c","filevisit",55,85
13,4,93,2,14,"filevisitalt@95-109@usr.bin/mg/file.c","usr.bin/mg/file.c","filevisitalt",95,109
25,9,160,1,26,"do_filevisitalt@112-138@usr.bin/mg/file.c","usr.bin/mg/file.c","do_filevisitalt",112,138
9,2,44,2,9,"filevisitro@141-150@usr.bin/mg/file.c","usr.bin/mg/file.c","filevisitro",141,150
33,11,241,2,33,"poptofile@158-191@usr.bin/mg/file.c","usr.bin/mg/file.c","poptofile",158,191
56,18,391,1,76,"readin@200-276@usr.bin/mg/file.c","usr.bin/mg/file.c","readin",200,276
166,34,1022,3,201,"insertfile@300-501@usr.bin/mg/file.c","usr.bin/mg/file.c","insertfile",300,501
47,12,385,2,52,"filewrite@511-563@usr.bin/mg/file.c","usr.bin/mg/file.c","filewrite",511,563
7,2,40,2,6,"filesave@572-578@usr.bin/mg/file.c","usr.bin/mg/file.c","filesave",572,578
35,10,214,1,44,"buffsave@589-633@usr.bin/mg/file.c","usr.bin/mg/file.c","buffsave",589,633
9,3,44,2,8,"makebkfile@643-651@usr.bin/mg/file.c","usr.bin/mg/file.c","makebkfile",643,651
33,9,234,3,36,"writeout@669-705@usr.bin/mg/file.c","usr.bin/mg/file.c","writeout",669,705
7,4,48,1,7,"upmodes@712-719@usr.bin/mg/file.c","usr.bin/mg/file.c","upmodes",712,719
12,4,89,3,12,"xdirname@730-742@usr.bin/mg/file.c","usr.bin/mg/file.c","xdirname",730,742
6,1,49,3,6,"xbasename@750-756@usr.bin/mg/file.c","usr.bin/mg/file.c","xbasename",750,756
8,2,49,1,8,"do_dired@762-770@usr.bin/mg/file.c","usr.bin/mg/file.c","do_dired",762,770
12,4,79,3,15,"ffropen@40-55@usr.bin/mg/fileio.c","usr.bin/mg/fileio.c","ffropen",40,55
11,3,88,2,13,"ffstat@61-74@usr.bin/mg/fileio.c","usr.bin/mg/fileio.c","ffstat",61,74
12,3,70,1,12,"fupdstat@81-93@usr.bin/mg/fileio.c","usr.bin/mg/fileio.c","fupdstat",81,93
25,7,182,3,35,"ffwopen@99-134@usr.bin/mg/fileio.c","usr.bin/mg/fileio.c","ffwopen",99,134
6,2,32,2,5,"ffclose@141-146@usr.bin/mg/fileio.c","usr.bin/mg/fileio.c","ffclose",141,146
21,6,158,2,24,"ffputbuf@153-177@usr.bin/mg/fileio.c","usr.bin/mg/fileio.c","ffputbuf",153,177
17,7,111,4,17,"ffgetline@187-204@usr.bin/mg/fileio.c","usr.bin/mg/fileio.c","ffgetline",187,204
71,13,466,1,78,"fbackupfile@215-293@usr.bin/mg/fileio.c","usr.bin/mg/fileio.c","fbackupfile",215,293
25,9,158,2,27,"adjustname@301-328@usr.bin/mg/fileio.c","usr.bin/mg/fileio.c","adjustname",301,328
33,16,244,1,38,"startupfile@337-375@usr.bin/mg/fileio.c","usr.bin/mg/fileio.c","startupfile",337,375
39,10,289,2,47,"copy@378-425@usr.bin/mg/fileio.c","usr.bin/mg/fileio.c","copy",378,425
77,23,511,1,123,"make_file_list@431-554@usr.bin/mg/fileio.c","usr.bin/mg/fileio.c","make_file_list",431,554
9,3,49,1,11,"fisdir@561-572@usr.bin/mg/fileio.c","usr.bin/mg/fileio.c","fisdir",561,572
10,4,73,1,13,"fchecktime@580-593@usr.bin/mg/fileio.c","usr.bin/mg/fileio.c","fchecktime",580,593
33,12,229,1,40,"bkuplocation@599-639@usr.bin/mg/fileio.c","usr.bin/mg/fileio.c","bkuplocation",599,639
19,5,102,2,21,"backuptohomedir@642-663@usr.bin/mg/fileio.c","usr.bin/mg/fileio.c","backuptohomedir",642,663
5,1,20,2,5,"toggleleavetmp@670-675@usr.bin/mg/fileio.c","usr.bin/mg/fileio.c","toggleleavetmp",670,675
8,3,42,1,9,"bkupleavetmp@682-691@usr.bin/mg/fileio.c","usr.bin/mg/fileio.c","bkupleavetmp",682,691
55,16,392,1,57,"expandtilde@700-757@usr.bin/mg/fileio.c","usr.bin/mg/fileio.c","expandtilde",700,757
8,2,38,1,8,"funmap_init@223-231@usr.bin/mg/funmap.c","usr.bin/mg/funmap.c","funmap_init",223,231
11,2,66,2,13,"funmap_add@234-247@usr.bin/mg/funmap.c","usr.bin/mg/funmap.c","funmap_add",234,247
9,3,57,1,9,"name_function@253-262@usr.bin/mg/funmap.c","usr.bin/mg/funmap.c","name_function",253,262
9,3,50,1,9,"function_name@265-274@usr.bin/mg/funmap.c","usr.bin/mg/funmap.c","function_name",265,274
20,4,126,1,20,"complete_function_list@280-300@usr.bin/mg/funmap.c","usr.bin/mg/funmap.c","complete_function_list",280,300
9,1,53,1,8,"grep_init@53-61@usr.bin/mg/grep.c","usr.bin/mg/grep.c","grep_init",53,61
21,6,166,2,22,"grep@65-87@usr.bin/mg/grep.c","usr.bin/mg/grep.c","grep",65,87
23,6,180,2,24,"compile@91-115@usr.bin/mg/grep.c","usr.bin/mg/grep.c","compile",91,115
44,18,334,2,53,"gid@120-173@usr.bin/mg/grep.c","usr.bin/mg/grep.c","gid",120,173
65,13,462,2,72,"compile_mode@176-248@usr.bin/mg/grep.c","usr.bin/mg/grep.c","compile_mode",176,248
58,17,393,2,64,"compile_goto_error@252-316@usr.bin/mg/grep.c","usr.bin/mg/grep.c","compile_goto_error",252,316
18,4,98,2,18,"next_error@320-338@usr.bin/mg/grep.c","usr.bin/mg/grep.c","next_error",320,338
9,2,37,2,10,"globalwdtoggle@346-356@usr.bin/mg/grep.c","usr.bin/mg/grep.c","globalwdtoggle",346,356
65,18,432,2,66,"desckey@29-95@usr.bin/mg/help.c","usr.bin/mg/help.c","desckey",29,95
20,8,163,2,21,"wallchart@104-125@usr.bin/mg/help.c","usr.bin/mg/help.c","wallchart",104,125
25,8,181,3,27,"showall@128-155@usr.bin/mg/help.c","usr.bin/mg/help.c","showall",128,155
14,6,100,2,16,"help_help@158-174@usr.bin/mg/help.c","usr.bin/mg/help.c","help_help",158,174
26,6,193,2,31,"apropos_command@178-209@usr.bin/mg/help.c","usr.bin/mg/help.c","apropos_command",178,209
22,5,154,4,23,"findbind@212-235@usr.bin/mg/help.c","usr.bin/mg/help.c","findbind",212,235
9,3,44,2,8,"do_meta@37-45@usr.bin/mg/kbd.c","usr.bin/mg/kbd.c","do_meta",37,45
9,3,44,2,8,"bsmap@53-61@usr.bin/mg/kbd.c","usr.bin/mg/kbd.c","bsmap",53,61
8,4,33,1,7,"ungetkey@64-71@usr.bin/mg/kbd.c","usr.bin/mg/kbd.c","ungetkey",64,71
36,14,209,1,39,"getkey@74-113@usr.bin/mg/kbd.c","usr.bin/mg/kbd.c","getkey",74,113
16,7,119,3,19,"doscan@121-140@usr.bin/mg/kbd.c","usr.bin/mg/kbd.c","doscan",121,140
14,4,105,1,16,"doin@143-159@usr.bin/mg/kbd.c","usr.bin/mg/kbd.c","doin",143,159
50,20,384,2,51,"rescan@162-213@usr.bin/mg/kbd.c","usr.bin/mg/kbd.c","rescan",162,213
30,11,213,2,30,"universal_argument@216-246@usr.bin/mg/kbd.c","usr.bin/mg/kbd.c","universal_argument",216,246
29,8,203,2,29,"digit_argument@250-279@usr.bin/mg/kbd.c","usr.bin/mg/kbd.c","digit_argument",250,279
33,9,206,2,33,"negative_argument@282-315@usr.bin/mg/kbd.c","usr.bin/mg/kbd.c","negative_argument",282,315
52,19,335,2,59,"selfinsert@322-381@usr.bin/mg/kbd.c","usr.bin/mg/kbd.c","selfinsert",322,381
19,7,159,2,19,"quote@387-406@usr.bin/mg/kbd.c","usr.bin/mg/kbd.c","quote",387,406
15,6,68,3,16,"mgwrap@414-430@usr.bin/mg/kbd.c","usr.bin/mg/kbd.c","mgwrap",414,430
11,2,57,1,11,"maps_init@526-537@usr.bin/mg/keymap.c","usr.bin/mg/keymap.c","maps_init",526,537
11,2,67,2,13,"maps_add@543-556@usr.bin/mg/keymap.c","usr.bin/mg/keymap.c","maps_add",543,556
8,3,53,1,8,"name_mode@559-567@usr.bin/mg/keymap.c","usr.bin/mg/keymap.c","name_mode",559,567
5,2,34,1,5,"name_map@570-575@usr.bin/mg/keymap.c","usr.bin/mg/keymap.c","name_map",570,575
14,3,80,1,14,"lalloc@34-48@usr.bin/mg/line.c","usr.bin/mg/line.c","lalloc",34,48
11,3,65,2,11,"lrealloc@51-62@usr.bin/mg/line.c","usr.bin/mg/line.c","lrealloc",51,62
33,9,209,1,33,"lfree@71-104@usr.bin/mg/line.c","usr.bin/mg/line.c","lfree",71,104
15,5,82,1,16,"lchange@114-130@usr.bin/mg/line.c","usr.bin/mg/line.c","lchange",114,130
70,22,479,2,86,"linsert@142-228@usr.bin/mg/line.c","usr.bin/mg/line.c","linsert",142,228
59,19,431,2,70,"lnewline_at@238-308@usr.bin/mg/line.c","usr.bin/mg/line.c","lnewline_at",238,308
12,3,65,1,12,"lnewline@315-327@usr.bin/mg/line.c","usr.bin/mg/line.c","lnewline",315,327
72,19,450,2,79,"ldelete@338-417@usr.bin/mg/line.c","usr.bin/mg/line.c","ldelete",338,417
67,18,504,1,70,"ldelnewline@432-502@usr.bin/mg/line.c","usr.bin/mg/line.c","ldelnewline",432,502
20,3,122,2,23,"lreplace@511-534@usr.bin/mg/line.c","usr.bin/mg/line.c","lreplace",511,534
13,3,82,1,16,"linetostr@540-556@usr.bin/mg/line.c","usr.bin/mg/line.c","linetostr",540,556
21,5,126,2,26,"definemacro@29-55@usr.bin/mg/macro.c","usr.bin/mg/macro.c","definemacro",29,55
9,2,37,2,8,"finishmacro@59-67@usr.bin/mg/macro.c","usr.bin/mg/macro.c","finishmacro",59,67
38,9,203,2,41,"executemacro@71-112@usr.bin/mg/macro.c","usr.bin/mg/macro.c","executemacro",71,112
6,1,19,0,5,"usage@44-49@usr.bin/mg/main.c","usr.bin/mg/main.c","usage",44,49
123,33,684,2,160,"main@52-212@usr.bin/mg/main.c","usr.bin/mg/main.c","main",52,212
18,3,102,1,20,"edinit@218-238@usr.bin/mg/main.c","usr.bin/mg/main.c","edinit",218,238
15,6,79,2,15,"quit@246-261@usr.bin/mg/main.c","usr.bin/mg/main.c","quit",246,261
4,1,15,2,3,"ctrlg@269-272@usr.bin/mg/main.c","usr.bin/mg/main.c","ctrlg",269,272
11,4,67,2,12,"showmatch@43-55@usr.bin/mg/match.c","usr.bin/mg/match.c","showmatch",43,55
38,10,212,1,57,"balance@65-122@usr.bin/mg/match.c","usr.bin/mg/match.c","balance",65,122
47,10,266,2,58,"displaymatch@130-188@usr.bin/mg/match.c","usr.bin/mg/match.c","displaymatch",130,188
38,13,261,3,41,"changemode@26-67@usr.bin/mg/modes.c","usr.bin/mg/modes.c","changemode",26,67
4,1,22,2,3,"indentmode@70-73@usr.bin/mg/modes.c","usr.bin/mg/modes.c","indentmode",70,73
4,1,22,2,3,"fillmode@76-79@usr.bin/mg/modes.c","usr.bin/mg/modes.c","fillmode",76,79
13,4,67,2,12,"notabmode@83-95@usr.bin/mg/modes.c","usr.bin/mg/modes.c","notabmode",83,95
13,4,67,2,12,"overwrite_mode@99-111@usr.bin/mg/modes.c","usr.bin/mg/modes.c","overwrite_mode",99,111
54,20,329,2,60,"set_default_mode@114-174@usr.bin/mg/modes.c","usr.bin/mg/modes.c","set_default_mode",114,174
25,8,149,2,31,"gotobop@35-66@usr.bin/mg/paragraph.c","usr.bin/mg/paragraph.c","gotobop",35,66
5,1,26,2,5,"gotoeop@74-79@usr.bin/mg/paragraph.c","usr.bin/mg/paragraph.c","gotoeop",74,79
31,9,196,3,41,"do_gotoeop@82-123@usr.bin/mg/paragraph.c","usr.bin/mg/paragraph.c","do_gotoeop",82,123
84,30,549,2,129,"fillpara@131-260@usr.bin/mg/paragraph.c","usr.bin/mg/paragraph.c","fillpara",131,260
17,4,112,2,25,"killpara@269-294@usr.bin/mg/paragraph.c","usr.bin/mg/paragraph.c","killpara",269,294
14,3,90,2,21,"markpara@303-324@usr.bin/mg/paragraph.c","usr.bin/mg/paragraph.c","markpara",303,324
24,4,161,2,36,"transposepara@333-369@usr.bin/mg/paragraph.c","usr.bin/mg/paragraph.c","transposepara",333,369
20,6,111,1,26,"findpara@375-401@usr.bin/mg/paragraph.c","usr.bin/mg/paragraph.c","findpara",375,401
40,20,343,2,45,"fillword@409-454@usr.bin/mg/paragraph.c","usr.bin/mg/paragraph.c","fillword",409,454
24,5,144,2,24,"setfillcol@460-484@usr.bin/mg/paragraph.c","usr.bin/mg/paragraph.c","setfillcol",460,484
8,2,33,2,8,"sentencespace@487-495@usr.bin/mg/paragraph.c","usr.bin/mg/paragraph.c","sentencespace",487,495
13,3,66,2,13,"re_forwsearch@56-69@usr.bin/mg/re_search.c","usr.bin/mg/re_search.c","re_forwsearch",56,69
13,3,66,2,13,"re_backsearch@80-93@usr.bin/mg/re_search.c","usr.bin/mg/re_search.c","re_backsearch",80,93
23,6,108,2,23,"re_searchagain@105-128@usr.bin/mg/re_search.c","usr.bin/mg/re_search.c","re_searchagain",105,128
61,18,353,2,72,"re_queryrepl@140-212@usr.bin/mg/re_search.c","usr.bin/mg/re_search.c","re_queryrepl",140,212
76,19,393,2,79,"re_doreplace@221-300@usr.bin/mg/re_search.c","usr.bin/mg/re_search.c","re_doreplace",221,300
32,5,184,1,41,"re_forwsrch@309-350@usr.bin/mg/re_search.c","usr.bin/mg/re_search.c","re_forwsrch",309,350
39,6,263,1,53,"re_backsrch@359-412@usr.bin/mg/re_search.c","usr.bin/mg/re_search.c","re_backsrch",359,412
37,9,243,1,39,"re_readpattern@423-462@usr.bin/mg/re_search.c","usr.bin/mg/re_search.c","re_readpattern",423,462
12,2,51,2,16,"setcasefold@470-486@usr.bin/mg/re_search.c","usr.bin/mg/re_search.c","setcasefold",470,486
9,2,43,2,10,"delmatchlines@493-503@usr.bin/mg/re_search.c","usr.bin/mg/re_search.c","delmatchlines",493,503
9,2,43,2,10,"delnonmatchlines@510-520@usr.bin/mg/re_search.c","usr.bin/mg/re_search.c","delnonmatchlines",510,520
30,9,203,1,37,"killmatches@526-563@usr.bin/mg/re_search.c","usr.bin/mg/re_search.c","killmatches",526,563
8,2,43,2,9,"cntmatchlines@570-579@usr.bin/mg/re_search.c","usr.bin/mg/re_search.c","cntmatchlines",570,579
8,2,43,2,9,"cntnonmatchlines@586-595@usr.bin/mg/re_search.c","usr.bin/mg/re_search.c","cntnonmatchlines",586,595
23,8,149,1,30,"countmatches@601-631@usr.bin/mg/re_search.c","usr.bin/mg/re_search.c","countmatches",601,631
16,3,103,2,18,"killregion@44-62@usr.bin/mg/region.c","usr.bin/mg/region.c","killregion",44,62
28,7,168,2,36,"copyregion@71-107@usr.bin/mg/region.c","usr.bin/mg/region.c","copyregion",71,107
31,7,191,2,34,"lowerregion@117-151@usr.bin/mg/region.c","usr.bin/mg/region.c","lowerregion",117,151
31,7,191,2,33,"upperregion@161-194@usr.bin/mg/region.c","usr.bin/mg/region.c","upperregion",161,194
52,10,369,1,55,"getregion@208-263@usr.bin/mg/region.c","usr.bin/mg/region.c","getregion",208,263
10,2,47,2,9,"setsize@269-278@usr.bin/mg/region.c","usr.bin/mg/region.c","setsize",269,278
34,9,256,2,40,"prefixregion@290-330@usr.bin/mg/region.c","usr.bin/mg/region.c","prefixregion",290,330
21,6,146,2,22,"setprefix@337-359@usr.bin/mg/region.c","usr.bin/mg/region.c","setprefix",337,359
21,4,122,3,21,"region_get_data@362-383@usr.bin/mg/region.c","usr.bin/mg/region.c","region_get_data",362,383
10,4,61,2,10,"region_put_data@386-396@usr.bin/mg/region.c","usr.bin/mg/region.c","region_put_data",386,396
8,3,47,2,7,"markbuffer@404-411@usr.bin/mg/region.c","usr.bin/mg/region.c","markbuffer",404,411
28,7,205,2,37,"piperegion@418-455@usr.bin/mg/region.c","usr.bin/mg/region.c","piperegion",418,455
12,4,109,2,16,"shellcommand@462-478@usr.bin/mg/region.c","usr.bin/mg/region.c","shellcommand",462,478
21,4,131,3,26,"shellcmdoutput@482-508@usr.bin/mg/region.c","usr.bin/mg/region.c","shellcmdoutput",482,508
38,8,268,5,43,"pipeio@516-559@usr.bin/mg/region.c","usr.bin/mg/region.c","pipeio",516,559
39,13,290,4,49,"iomux@566-615@usr.bin/mg/region.c","usr.bin/mg/region.c","iomux",566,615
17,5,91,3,18,"pwriteout@622-640@usr.bin/mg/region.c","usr.bin/mg/region.c","pwriteout",622,640
32,6,223,2,33,"preadin@648-681@usr.bin/mg/region.c","usr.bin/mg/region.c","preadin",648,681
13,3,66,2,13,"forwsearch@61-74@usr.bin/mg/search.c","usr.bin/mg/search.c","forwsearch",61,74
13,3,66,2,13,"backsearch@84-97@usr.bin/mg/search.c","usr.bin/mg/search.c","backsearch",84,97
22,5,102,2,21,"searchagain@106-127@usr.bin/mg/search.c","usr.bin/mg/search.c","searchagain",106,127
7,3,35,2,7,"forwisearch@135-142@usr.bin/mg/search.c","usr.bin/mg/search.c","forwisearch",135,142
7,3,35,2,7,"backisearch@150-157@usr.bin/mg/search.c","usr.bin/mg/search.c","backisearch",150,157
213,49,1169,1,234,"isearch@171-405@usr.bin/mg/search.c","usr.bin/mg/search.c","isearch",171,405
6,2,27,1,5,"is_cpush@408-413@usr.bin/mg/search.c","usr.bin/mg/search.c","is_cpush",408,413
11,2,67,1,11,"is_lpush@416-427@usr.bin/mg/search.c","usr.bin/mg/search.c","is_lpush",416,427
12,3,80,1,11,"is_pop@430-441@usr.bin/mg/search.c","usr.bin/mg/search.c","is_pop",430,441
4,1,16,1,3,"is_peek@444-447@usr.bin/mg/search.c","usr.bin/mg/search.c","is_peek",444,447
30,9,122,2,30,"is_undo@451-481@usr.bin/mg/search.c","usr.bin/mg/search.c","is_undo",451,481
35,6,187,1,35,"is_find@484-519@usr.bin/mg/search.c","usr.bin/mg/search.c","is_find",484,519
15,5,78,3,14,"is_prompt@528-542@usr.bin/mg/search.c","usr.bin/mg/search.c","is_prompt",528,542
7,2,34,2,6,"is_dspl@549-555@usr.bin/mg/search.c","usr.bin/mg/search.c","is_dspl",549,555
66,21,353,2,75,"queryrepl@563-638@usr.bin/mg/search.c","usr.bin/mg/search.c","queryrepl",563,638
26,6,154,2,32,"replstr@645-677@usr.bin/mg/search.c","usr.bin/mg/search.c","replstr",645,677
51,12,315,1,51,"forwsrch@686-737@usr.bin/mg/search.c","usr.bin/mg/search.c","forwsrch",686,737
56,14,348,1,57,"backsrch@746-803@usr.bin/mg/search.c","usr.bin/mg/search.c","backsrch",746,803
14,5,86,3,13,"eq@810-823@usr.bin/mg/search.c","usr.bin/mg/search.c","eq",810,823
20,5,137,1,22,"readpattern@833-855@usr.bin/mg/search.c","usr.bin/mg/search.c","readpattern",833,855
21,3,119,2,26,"spawncli@25-51@usr.bin/mg/spawn.c","usr.bin/mg/spawn.c","spawncli",25,51
4,1,26,2,3,"ctagcmp@63-66@usr.bin/mg/tags.c","usr.bin/mg/tags.c","ctagcmp",63,66
58,13,357,2,63,"tagsvisit@75-138@usr.bin/mg/tags.c","usr.bin/mg/tags.c","tagsvisit",75,138
35,9,209,2,38,"findtag@145-183@usr.bin/mg/tags.c","usr.bin/mg/tags.c","findtag",145,183
10,2,70,1,11,"unloadtags@189-200@usr.bin/mg/tags.c","usr.bin/mg/tags.c","unloadtags",189,200
45,8,284,1,52,"pushtag@209-261@usr.bin/mg/tags.c","usr.bin/mg/tags.c","pushtag",209,261
23,4,136,2,29,"poptag@268-297@usr.bin/mg/tags.c","usr.bin/mg/tags.c","poptag",268,297
19,4,106,1,19,"loadtags@304-323@usr.bin/mg/tags.c","usr.bin/mg/tags.c","loadtags",304,323
12,2,59,1,12,"closetags@329-341@usr.bin/mg/tags.c","usr.bin/mg/tags.c","closetags",329,341
10,3,56,2,13,"strip@352-365@usr.bin/mg/tags.c","usr.bin/mg/tags.c","strip",352,365
26,5,162,1,26,"addctag@373-399@usr.bin/mg/tags.c","usr.bin/mg/tags.c","addctag",373,399
22,5,124,1,22,"searchpat@405-427@usr.bin/mg/tags.c","usr.bin/mg/tags.c","searchpat",405,427
9,4,62,1,8,"atbow@434-442@usr.bin/mg/tags.c","usr.bin/mg/tags.c","atbow",434,442
35,9,233,3,51,"curtoken@448-499@usr.bin/mg/tags.c","usr.bin/mg/tags.c","curtoken",448,499
11,2,61,1,11,"searchtag@505-516@usr.bin/mg/tags.c","usr.bin/mg/tags.c","searchtag",505,516
28,8,171,1,29,"loadbuffer@526-555@usr.bin/mg/tags.c","usr.bin/mg/tags.c","loadbuffer",526,555
4,1,11,1,3,"winchhandler@50-53@usr.bin/mg/tty.c","usr.bin/mg/tty.c","winchhandler",50,53
45,20,248,1,63,"ttinit@60-123@usr.bin/mg/tty.c","usr.bin/mg/tty.c","ttinit",60,123
11,4,49,1,16,"ttreinit@130-146@usr.bin/mg/tty.c","usr.bin/mg/tty.c","ttreinit",130,146
6,2,21,1,7,"tttidy@155-162@usr.bin/mg/tty.c","usr.bin/mg/tty.c","tttidy",155,162
8,3,44,2,7,"ttmove@170-177@usr.bin/mg/tty.c","usr.bin/mg/tty.c","ttmove",170,177
12,3,45,1,12,"tteeol@183-195@usr.bin/mg/tty.c","usr.bin/mg/tty.c","tteeol",183,195
18,4,88,1,19,"tteeop@201-220@usr.bin/mg/tty.c","usr.bin/mg/tty.c","tteeop",201,220
5,1,17,1,4,"ttbeep@226-230@usr.bin/mg/tty.c","usr.bin/mg/tty.c","ttbeep",226,230
36,10,214,3,44,"ttinsl@239-283@usr.bin/mg/tty.c","usr.bin/mg/tty.c","ttinsl",239,283
35,9,210,3,43,"ttdell@292-335@usr.bin/mg/tty.c","usr.bin/mg/tty.c","ttdell",292,335
10,4,58,2,9,"ttwindow@346-355@usr.bin/mg/tty.c","usr.bin/mg/tty.c","ttwindow",346,355
11,3,54,1,10,"ttnowindow@366-376@usr.bin/mg/tty.c","usr.bin/mg/tty.c","ttnowindow",366,376
10,4,46,1,12,"ttcolor@386-398@usr.bin/mg/tty.c","usr.bin/mg/tty.c","ttcolor",386,398
16,6,105,1,17,"ttresize@409-426@usr.bin/mg/tty.c","usr.bin/mg/tty.c","ttresize",409,426
5,1,15,1,4,"fakec@433-437@usr.bin/mg/tty.c","usr.bin/mg/tty.c","fakec",433,437
6,1,27,1,6,"charcost@441-447@usr.bin/mg/tty.c","usr.bin/mg/tty.c","charcost",441,447
7,4,38,1,7,"ttopen@46-53@usr.bin/mg/ttyio.c","usr.bin/mg/ttyio.c","ttopen",46,53
22,3,156,1,24,"ttraw@63-87@usr.bin/mg/ttyio.c","usr.bin/mg/ttyio.c","ttraw",63,87
8,3,29,1,7,"ttclose@96-103@usr.bin/mg/ttyio.c","usr.bin/mg/ttyio.c","ttclose",96,103
10,2,47,1,9,"ttcooked@110-119@usr.bin/mg/ttyio.c","usr.bin/mg/ttyio.c","ttcooked",110,119
7,2,30,1,6,"ttputc@126-132@usr.bin/mg/ttyio.c","usr.bin/mg/ttyio.c","ttputc",126,132
17,5,79,1,18,"ttflush@138-156@usr.bin/mg/ttyio.c","usr.bin/mg/ttyio.c","ttflush",138,156
18,8,98,1,18,"ttgetc@163-181@usr.bin/mg/ttyio.c","usr.bin/mg/ttyio.c","ttgetc",163,181
5,2,30,1,5,"charswaiting@187-192@usr.bin/mg/ttyio.c","usr.bin/mg/ttyio.c","charswaiting",187,192
13,2,64,1,13,"panic@198-211@usr.bin/mg/ttyio.c","usr.bin/mg/ttyio.c","panic",198,211
9,2,57,1,10,"ttwait@218-228@usr.bin/mg/ttyio.c","usr.bin/mg/ttyio.c","ttwait",218,228
30,15,194,1,33,"ttykeymapinit@32-65@usr.bin/mg/ttykbd.c","usr.bin/mg/ttykbd.c","ttykeymapinit",32,65
5,2,17,1,5,"ttykeymaptidy@71-76@usr.bin/mg/ttykbd.c","usr.bin/mg/ttykbd.c","ttykeymaptidy",71,76
18,4,94,2,19,"find_dot@42-61@usr.bin/mg/undo.c","usr.bin/mg/undo.c","find_dot",42,61
20,3,113,4,21,"find_lo@64-85@usr.bin/mg/undo.c","usr.bin/mg/undo.c","find_lo",64,85
14,3,83,1,16,"new_undo_record@88-104@usr.bin/mg/undo.c","usr.bin/mg/undo.c","new_undo_record",88,104
16,3,74,1,20,"free_undo_record@107-127@usr.bin/mg/undo.c","usr.bin/mg/undo.c","free_undo_record",107,127
12,2,61,1,12,"drop_oldest_undo_record@134-146@usr.bin/mg/undo.c","usr.bin/mg/undo.c","drop_oldest_undo_record",134,146
7,2,39,1,7,"lastrectype@149-156@usr.bin/mg/undo.c","usr.bin/mg/undo.c","lastrectype",149,156
4,1,11,1,3,"undo_enabled@162-165@usr.bin/mg/undo.c","usr.bin/mg/undo.c","undo_enabled",162,165
11,4,62,2,13,"undo_enable@172-185@usr.bin/mg/undo.c","usr.bin/mg/undo.c","undo_enable",172,185
15,5,79,2,19,"undo_boundary_enable@195-214@usr.bin/mg/undo.c","usr.bin/mg/undo.c","undo_boundary_enable",195,214
14,4,79,2,18,"undo_add_boundary@221-239@usr.bin/mg/undo.c","usr.bin/mg/undo.c","undo_add_boundary",221,239
13,2,80,1,16,"undo_add_modified@245-261@usr.bin/mg/undo.c","usr.bin/mg/undo.c","undo_add_modified",245,261
28,5,197,3,41,"undo_add_insert@264-305@usr.bin/mg/undo.c","usr.bin/mg/undo.c","undo_add_insert",264,305
38,13,287,4,50,"undo_add_delete@311-361@usr.bin/mg/undo.c","usr.bin/mg/undo.c","undo_add_delete",311,361
12,2,72,3,12,"undo_add_change@367-379@usr.bin/mg/undo.c","usr.bin/mg/undo.c","undo_add_change",367,379
53,14,406,2,59,"undo_dump@386-445@usr.bin/mg/undo.c","usr.bin/mg/undo.c","undo_dump",386,445
83,19,430,2,118,"undo@484-602@usr.bin/mg/undo.c","usr.bin/mg/undo.c","undo",484,602
40,8,227,2,46,"showcpos@29-75@usr.bin/mg/util.c","usr.bin/mg/util.c","showcpos",29,75
22,7,131,1,27,"getcolpos@78-105@usr.bin/mg/util.c","usr.bin/mg/util.c","getcolpos",78,105
40,9,260,2,44,"twiddle@115-159@usr.bin/mg/util.c","usr.bin/mg/util.c","twiddle",115,159
17,6,96,2,21,"openline@169-190@usr.bin/mg/util.c","usr.bin/mg/util.c","openline",169,190
11,4,53,2,12,"enewline@197-209@usr.bin/mg/util.c","usr.bin/mg/util.c","enewline",197,209
17,5,128,2,17,"deblank@221-238@usr.bin/mg/util.c","usr.bin/mg/util.c","deblank",221,238
8,1,46,2,7,"justone@244-251@usr.bin/mg/util.c","usr.bin/mg/util.c","justone",244,251
20,7,142,2,22,"delwhite@258-280@usr.bin/mg/util.c","usr.bin/mg/util.c","delwhite",258,280
17,4,103,2,20,"delleadwhite@286-306@usr.bin/mg/util.c","usr.bin/mg/util.c","delleadwhite",286,306
10,2,52,2,15,"deltrailwhite@312-327@usr.bin/mg/util.c","usr.bin/mg/util.c","deltrailwhite",312,327
28,14,198,2,31,"lfindent@341-372@usr.bin/mg/util.c","usr.bin/mg/util.c","lfindent",341,372
18,9,143,2,27,"indent@380-407@usr.bin/mg/util.c","usr.bin/mg/util.c","indent",380,407
11,5,76,2,13,"forwdel@418-431@usr.bin/mg/util.c","usr.bin/mg/util.c","forwdel",418,431
14,6,100,2,17,"backdel@440-457@usr.bin/mg/util.c","usr.bin/mg/util.c","backdel",440,457
8,3,55,2,7,"space_to_tabstop@462-469@usr.bin/mg/util.c","usr.bin/mg/util.c","space_to_tabstop",462,469
8,3,56,2,7,"backtoindent@476-483@usr.bin/mg/util.c","usr.bin/mg/util.c","backtoindent",476,483
19,3,105,2,22,"joinline@491-513@usr.bin/mg/util.c","usr.bin/mg/util.c","joinline",491,513
5,1,22,2,4,"showversion@24-28@usr.bin/mg/version.c","usr.bin/mg/version.c","showversion",24,28
19,3,110,1,20,"new_window@17-37@usr.bin/mg/window.c","usr.bin/mg/window.c","new_window",17,37
7,3,49,2,6,"reposition@47-53@usr.bin/mg/window.c","usr.bin/mg/window.c","reposition",47,53
4,1,22,2,3,"redraw@70-73@usr.bin/mg/window.c","usr.bin/mg/window.c","redraw",70,73
23,6,124,3,27,"do_redraw@77-104@usr.bin/mg/window.c","usr.bin/mg/window.c","do_redraw",77,104
9,2,46,2,9,"nextwind@113-122@usr.bin/mg/window.c","usr.bin/mg/window.c","nextwind",113,122
13,3,65,2,13,"prevwind@132-145@usr.bin/mg/window.c","usr.bin/mg/window.c","prevwind",132,145
43,7,293,2,45,"onlywind@156-201@usr.bin/mg/window.c","usr.bin/mg/window.c","onlywind",156,201
64,10,393,2,81,"splitwind@211-292@usr.bin/mg/window.c","usr.bin/mg/window.c","splitwind",211,292
41,11,259,2,44,"enlargewind@302-346@usr.bin/mg/window.c","usr.bin/mg/window.c","enlargewind",302,346
41,12,266,2,48,"shrinkwind@353-401@usr.bin/mg/window.c","usr.bin/mg/window.c","shrinkwind",353,401
27,7,198,2,31,"delwind@409-440@usr.bin/mg/window.c","usr.bin/mg/window.c","delwind",409,440
18,8,114,2,17,"backword@29-46@usr.bin/mg/word.c","usr.bin/mg/word.c","backword",29,46
16,7,93,2,15,"forwword@54-69@usr.bin/mg/word.c","usr.bin/mg/word.c","forwword",54,69
101,19,556,2,122,"transposeword@78-200@usr.bin/mg/word.c","usr.bin/mg/word.c","transposeword",78,200
18,6,114,1,18,"grabword@206-224@usr.bin/mg/word.c","usr.bin/mg/word.c","grabword",206,224
33,10,203,2,35,"upperword@232-267@usr.bin/mg/word.c","usr.bin/mg/word.c","upperword",232,267
33,10,203,2,34,"lowerword@275-309@usr.bin/mg/word.c","usr.bin/mg/word.c","lowerword",275,309
43,13,278,2,45,"capword@319-364@usr.bin/mg/word.c","usr.bin/mg/word.c","capword",319,364
18,3,78,0,20,"countfword@370-390@usr.bin/mg/word.c","usr.bin/mg/word.c","countfword",370,390
38,10,196,2,44,"delfword@398-442@usr.bin/mg/word.c","usr.bin/mg/word.c","delfword",398,442
37,12,199,2,47,"delbword@455-502@usr.bin/mg/word.c","usr.bin/mg/word.c","delbword",455,502
5,2,34,1,5,"inword@509-514@usr.bin/mg/word.c","usr.bin/mg/word.c","inword",509,514
8,2,31,1,7,"kdelete@32-39@usr.bin/mg/yank.c","usr.bin/mg/yank.c","kdelete",32,39
16,10,105,2,15,"kinsert@50-65@usr.bin/mg/yank.c","usr.bin/mg/yank.c","kinsert",50,65
23,4,169,1,24,"kgrow@72-96@usr.bin/mg/yank.c","usr.bin/mg/yank.c","kgrow",72,96
6,3,38,1,5,"kremove@104-109@usr.bin/mg/yank.c","usr.bin/mg/yank.c","kremove",104,109
19,8,134,3,24,"kchunk@116-140@usr.bin/mg/yank.c","usr.bin/mg/yank.c","kchunk",116,140
52,17,331,2,58,"killline@153-211@usr.bin/mg/yank.c","usr.bin/mg/yank.c","killline",153,211
33,10,184,2,41,"yank@225-266@usr.bin/mg/yank.c","usr.bin/mg/yank.c","yank",225,266
8,1,29,1,8,"usage@125-133@usr.bin/midiplay/midiplay.c","usr.bin/midiplay/midiplay.c","usage",125,133
14,4,85,3,14,"send_event@143-157@usr.bin/midiplay/midiplay.c","usr.bin/midiplay/midiplay.c","send_event",143,157
10,3,66,1,10,"getvar@160-170@usr.bin/midiplay/midiplay.c","usr.bin/midiplay/midiplay.c","getvar",160,170
40,17,190,3,39,"dometa@173-212@usr.bin/midiplay/midiplay.c","usr.bin/midiplay/midiplay.c","dometa",173,212
5,1,34,1,6,"midireset@215-221@usr.bin/midiplay/midiplay.c","usr.bin/midiplay/midiplay.c","midireset",215,221
26,5,150,2,33,"playfile@224-257@usr.bin/midiplay/midiplay.c","usr.bin/midiplay/midiplay.c","playfile",224,257
3,1,7,1,2,"sigalrm@260-262@usr.bin/midiplay/midiplay.c","usr.bin/midiplay/midiplay.c","sigalrm",260,262
129,31,862,3,137,"playdata@265-402@usr.bin/midiplay/midiplay.c","usr.bin/midiplay/midiplay.c","playdata",265,402
74,19,389,2,78,"main@405-483@usr.bin/midiplay/midiplay.c","usr.bin/midiplay/midiplay.c","main",405,483
28,8,166,4,28,"atomicio@39-67@usr.bin/nc/atomicio.c","usr.bin/nc/atomicio.c","atomicio",39,67
497,214,2960,2,553,"main@150-703@usr.bin/nc/netcat.c","usr.bin/nc/netcat.c","main",150,703
23,5,153,2,28,"unix_bind@710-738@usr.bin/nc/netcat.c","usr.bin/nc/netcat.c","unix_bind",710,738
23,6,133,3,24,"timeout_tls@741-765@usr.bin/nc/netcat.c","usr.bin/nc/netcat.c","timeout_tls",741,765
24,12,174,3,24,"tls_setup_client@768-792@usr.bin/nc/netcat.c","usr.bin/nc/netcat.c","tls_setup_client",768,792
29,15,201,3,30,"tls_setup_server@795-825@usr.bin/nc/netcat.c","usr.bin/nc/netcat.c","tls_setup_server",795,825
27,6,172,1,30,"unix_connect@832-862@usr.bin/nc/netcat.c","usr.bin/nc/netcat.c","unix_connect",832,862
11,3,55,1,11,"unix_listen@869-880@usr.bin/nc/netcat.c","usr.bin/nc/netcat.c","unix_listen",869,880
40,13,336,3,51,"remote_connect@888-939@usr.bin/nc/netcat.c","usr.bin/nc/netcat.c","remote_connect",888,939
24,7,160,3,25,"timeout_connect@942-967@usr.bin/nc/netcat.c","usr.bin/nc/netcat.c","timeout_connect",942,967
33,11,259,3,48,"local_listen@975-1023@usr.bin/nc/netcat.c","usr.bin/nc/netcat.c","local_listen",975,1023
143,70,1177,2,192,"readwrite@1030-1222@usr.bin/nc/netcat.c","usr.bin/nc/netcat.c","readwrite",1030,1222
19,7,120,4,21,"drainbuf@1225-1246@usr.bin/nc/netcat.c","usr.bin/nc/netcat.c","drainbuf",1225,1246
16,6,105,4,17,"fillbuf@1249-1266@usr.bin/nc/netcat.c","usr.bin/nc/netcat.c","fillbuf",1249,1266
47,8,312,1,52,"fdpass@1273-1325@usr.bin/nc/netcat.c","usr.bin/nc/netcat.c","fdpass",1273,1325
24,9,162,3,27,"atelnet@1329-1356@usr.bin/nc/netcat.c","usr.bin/nc/netcat.c","atelnet",1329,1356
16,5,111,2,17,"strtoport@1360-1377@usr.bin/nc/netcat.c","usr.bin/nc/netcat.c","strtoport",1360,1377
38,9,246,1,46,"build_ports@1385-1431@usr.bin/nc/netcat.c","usr.bin/nc/netcat.c","build_ports",1385,1431
11,3,53,1,11,"udptest@1439-1450@usr.bin/nc/netcat.c","usr.bin/nc/netcat.c","udptest",1439,1450
48,24,371,2,53,"set_common_sockopts@1453-1506@usr.bin/nc/netcat.c","usr.bin/nc/netcat.c","set_common_sockopts",1453,1506
43,3,249,2,45,"process_tos_opt@1509-1554@usr.bin/nc/netcat.c","usr.bin/nc/netcat.c","process_tos_opt",1509,1554
37,7,231,2,39,"process_tls_opt@1557-1596@usr.bin/nc/netcat.c","usr.bin/nc/netcat.c","process_tls_opt",1557,1596
11,4,85,2,11,"save_peer_cert@1599-1610@usr.bin/nc/netcat.c","usr.bin/nc/netcat.c","save_peer_cert",1599,1610
54,15,360,2,55,"report_tls@1613-1668@usr.bin/nc/netcat.c","usr.bin/nc/netcat.c","report_tls",1613,1668
25,5,135,3,28,"report_connect@1671-1699@usr.bin/nc/netcat.c","usr.bin/nc/netcat.c","report_connect",1671,1699
46,1,23,1,45,"help@1702-1747@usr.bin/nc/netcat.c","usr.bin/nc/netcat.c","help",1702,1747
16,2,32,1,15,"usage@1750-1765@usr.bin/nc/netcat.c","usr.bin/nc/netcat.c","usage",1750,1765
25,6,172,6,26,"decode_addrport@62-88@usr.bin/nc/socks.c","usr.bin/nc/socks.c","decode_addrport",62,88
18,6,103,3,19,"proxy_read_line@91-110@usr.bin/nc/socks.c","usr.bin/nc/socks.c","proxy_read_line",91,110
10,2,73,2,10,"getproxypass@113-123@usr.bin/nc/socks.c","usr.bin/nc/socks.c","getproxypass",113,123
15,5,42,1,14,"socks4_strerror@131-145@usr.bin/nc/socks.c","usr.bin/nc/socks.c","socks4_strerror",131,145
25,10,72,1,24,"socks5_strerror@151-175@usr.bin/nc/socks.c","usr.bin/nc/socks.c","socks5_strerror",151,175
180,48,1442,8,218,"socks_connect@178-396@usr.bin/nc/socks.c","usr.bin/nc/socks.c","socks_connect",178,396
6,1,44,3,6,"catstr@68-74@usr.bin/mixerctl/mixerctl.c","usr.bin/mixerctl/mixerctl.c","catstr",68,74
8,3,60,1,7,"findfield@77-84@usr.bin/mixerctl/mixerctl.c","usr.bin/mixerctl/mixerctl.c","findfield",77,84
43,16,364,4,43,"prfield@90-133@usr.bin/mixerctl/mixerctl.c","usr.bin/mixerctl/mixerctl.c","prfield",90,133
23,13,170,3,25,"adjlevel@136-161@usr.bin/mixerctl/mixerctl.c","usr.bin/mixerctl/mixerctl.c","adjlevel",136,161
73,23,602,5,75,"rdfield@164-239@usr.bin/mixerctl/mixerctl.c","usr.bin/mixerctl/mixerctl.c","rdfield",164,239
129,48,966,2,146,"main@242-388@usr.bin/mixerctl/mixerctl.c","usr.bin/mixerctl/mixerctl.c","main",242,388
11,1,34,1,12,"usage@391-403@usr.bin/mixerctl/mixerctl.c","usr.bin/mixerctl/mixerctl.c","usage",391,403
77,25,429,2,87,"main@35-122@usr.bin/mktemp/mktemp.c","usr.bin/mktemp/mktemp.c","main",35,122
10,2,45,2,10,"fatal@125-135@usr.bin/mktemp/mktemp.c","usr.bin/mktemp/mktemp.c","fatal",125,135
10,2,45,2,10,"fatalx@138-148@usr.bin/mktemp/mktemp.c","usr.bin/mktemp/mktemp.c","fatalx",138,148
7,1,28,1,7,"usage@151-158@usr.bin/mktemp/mktemp.c","usr.bin/mktemp/mktemp.c","usage",151,158
89,25,627,2,102,"intpr@72-174@usr.bin/netstat/if.c","usr.bin/netstat/if.c","intpr",72,174
102,28,680,3,105,"print_addr@177-282@usr.bin/netstat/if.c","usr.bin/netstat/if.c","print_addr",177,282
114,21,686,2,123,"sidewaysintpr@305-428@usr.bin/netstat/if.c","usr.bin/netstat/if.c","sidewaysintpr",305,428
4,1,11,1,3,"catchalarm@436-439@usr.bin/netstat/if.c","usr.bin/netstat/if.c","catchalarm",436,439
12,3,92,3,12,"get_rtaddrs@442-454@usr.bin/netstat/if.c","usr.bin/netstat/if.c","get_rtaddrs",442,454
31,9,224,1,36,"isegress@458-494@usr.bin/netstat/if.c","usr.bin/netstat/if.c","isegress",458,494
79,16,589,1,84,"fetchifs@497-581@usr.bin/netstat/if.c","usr.bin/netstat/if.c","fetchifs",497,581
36,19,280,2,38,"kf_comp@106-144@usr.bin/netstat/inet.c","usr.bin/netstat/inet.c","kf_comp",106,144
55,28,405,4,63,"protopr@147-210@usr.bin/netstat/inet.c","usr.bin/netstat/inet.c","protopr",147,210
121,45,756,2,138,"netdomainpr@219-357@usr.bin/netstat/inet.c","usr.bin/netstat/inet.c","netdomainpr",219,357
113,3,701,1,143,"tcp_stats@363-506@usr.bin/netstat/inet.c","usr.bin/netstat/inet.c","tcp_stats",363,506
33,5,231,1,41,"udp_stats@512-553@usr.bin/netstat/inet.c","usr.bin/netstat/inet.c","udp_stats",512,553
45,3,316,1,53,"ip_stats@559-612@usr.bin/netstat/inet.c","usr.bin/netstat/inet.c","ip_stats",559,612
18,3,127,1,25,"div_stats@618-643@usr.bin/netstat/inet.c","usr.bin/netstat/inet.c","div_stats",618,643
50,11,329,1,56,"icmp_stats@693-749@usr.bin/netstat/inet.c","usr.bin/netstat/inet.c","icmp_stats",693,749
22,3,155,1,30,"igmp_stats@755-785@usr.bin/netstat/inet.c","usr.bin/netstat/inet.c","igmp_stats",755,785
57,11,387,2,60,"getrpcportnam@795-855@usr.bin/netstat/inet.c","usr.bin/netstat/inet.c","getrpcportnam",795,855
22,12,221,4,22,"inetprint@862-884@usr.bin/netstat/inet.c","usr.bin/netstat/inet.c","inetprint",862,884
37,11,280,1,38,"inetname@892-930@usr.bin/netstat/inet.c","usr.bin/netstat/inet.c","inetname",892,930
32,3,225,1,41,"ah_stats@936-977@usr.bin/netstat/inet.c","usr.bin/netstat/inet.c","ah_stats",936,977
22,3,155,1,27,"etherip_stats@983-1010@usr.bin/netstat/inet.c","usr.bin/netstat/inet.c","etherip_stats",983,1010
37,3,260,1,43,"esp_stats@1016-1059@usr.bin/netstat/inet.c","usr.bin/netstat/inet.c","esp_stats",1016,1059
23,3,162,1,28,"ipip_stats@1065-1093@usr.bin/netstat/inet.c","usr.bin/netstat/inet.c","ipip_stats",1065,1093
28,3,197,1,36,"carp_stats@1099-1135@usr.bin/netstat/inet.c","usr.bin/netstat/inet.c","carp_stats",1099,1135
29,3,204,1,37,"pfsync_stats@1141-1178@usr.bin/netstat/inet.c","usr.bin/netstat/inet.c","pfsync_stats",1141,1178
17,3,119,1,25,"pflow_stats@1184-1209@usr.bin/netstat/inet.c","usr.bin/netstat/inet.c","pflow_stats",1184,1209
30,3,211,1,36,"ipcomp_stats@1215-1251@usr.bin/netstat/inet.c","usr.bin/netstat/inet.c","ipcomp_stats",1215,1251
34,3,281,1,40,"socket_dump@1257-1297@usr.bin/netstat/inet.c","usr.bin/netstat/inet.c","socket_dump",1257,1297
13,2,90,1,20,"sosplice_dump@1303-1323@usr.bin/netstat/inet.c","usr.bin/netstat/inet.c","sosplice_dump",1303,1323
16,1,125,2,17,"sockbuf_dump@1329-1346@usr.bin/netstat/inet.c","usr.bin/netstat/inet.c","sockbuf_dump",1329,1346
13,2,94,2,19,"protosw_dump@1352-1371@usr.bin/netstat/inet.c","usr.bin/netstat/inet.c","protosw_dump",1352,1371
12,2,92,3,15,"domain_dump@1377-1392@usr.bin/netstat/inet.c","usr.bin/netstat/inet.c","domain_dump",1377,1392
54,6,452,3,62,"inpcb_dump@1398-1460@usr.bin/netstat/inet.c","usr.bin/netstat/inet.c","inpcb_dump",1398,1460
67,4,574,1,72,"tcpcb_dump@1466-1538@usr.bin/netstat/inet.c","usr.bin/netstat/inet.c","tcpcb_dump",1466,1538
127,27,807,1,158,"ip6_stats@329-487@usr.bin/netstat/inet6.c","usr.bin/netstat/inet6.c","ip6_stats",329,487
64,9,439,1,73,"icmp6_stats@752-825@usr.bin/netstat/inet6.c","usr.bin/netstat/inet6.c","icmp6_stats",752,825
30,5,186,1,35,"rip6_stats@831-866@usr.bin/netstat/inet6.c","usr.bin/netstat/inet6.c","rip6_stats",831,866
18,3,127,1,25,"div6_stats@872-897@usr.bin/netstat/inet6.c","usr.bin/netstat/inet6.c","div6_stats",872,897
26,13,213,3,37,"inet6print@905-942@usr.bin/netstat/inet6.c","usr.bin/netstat/inet6.c","inet6print",905,942
51,16,381,1,53,"inet6name@951-1004@usr.bin/netstat/inet6.c","usr.bin/netstat/inet6.c","inet6name",951,1004
231,86,1179,2,249,"main@111-360@usr.bin/netstat/main.c","usr.bin/netstat/main.c","main",111,360
9,2,59,3,9,"kread@366-375@usr.bin/netstat/main.c","usr.bin/netstat/main.c","kread",366,375
4,2,18,1,3,"plural@378-381@usr.bin/netstat/main.c","usr.bin/netstat/main.c","plural",378,381
4,2,18,1,3,"plurales@384-387@usr.bin/netstat/main.c","usr.bin/netstat/main.c","plurales",384,387
4,2,18,1,3,"pluralys@390-393@usr.bin/netstat/main.c","usr.bin/netstat/main.c","pluralys",390,393
9,4,65,1,9,"knownname@399-408@usr.bin/netstat/main.c","usr.bin/netstat/main.c","knownname",399,408
18,5,106,1,24,"name2protox@414-438@usr.bin/netstat/main.c","usr.bin/netstat/main.c","name2protox",414,438
15,1,42,1,14,"usage@441-455@usr.bin/netstat/main.c","usr.bin/netstat/main.c","usage",441,455
21,3,142,1,24,"gettable@458-482@usr.bin/netstat/main.c","usr.bin/netstat/main.c","gettable",458,482
107,19,801,1,118,"mbpr@88-206@usr.bin/netstat/mbuf.c","usr.bin/netstat/mbuf.c","mbpr",88,206
83,15,540,1,94,"mroutepr@62-156@usr.bin/netstat/mroute.c","usr.bin/netstat/mroute.c","mroutepr",62,156
54,7,367,1,58,"mrt_stats@159-217@usr.bin/netstat/mroute.c","usr.bin/netstat/mroute.c","mrt_stats",159,217
90,16,584,1,104,"mroute6pr@87-191@usr.bin/netstat/mroute6.c","usr.bin/netstat/mroute6.c","mroute6pr",87,191
57,6,394,1,59,"mrt6_stats@194-253@usr.bin/netstat/mroute6.c","usr.bin/netstat/mroute6.c","mrt6_stats",194,253
94,3,601,1,103,"net80211_ifstats@44-147@usr.bin/netstat/net80211.c","usr.bin/netstat/net80211.c","net80211_ifstats",44,147
51,17,401,5,58,"routepr@89-147@usr.bin/netstat/route.c","usr.bin/netstat/route.c","routepr",89,147
7,2,70,1,7,"kgetsa@150-157@usr.bin/netstat/route.c","usr.bin/netstat/route.c","kgetsa",150,157
33,11,194,1,33,"p_tree@160-193@usr.bin/netstat/route.c","usr.bin/netstat/route.c","p_tree",160,193
13,5,69,1,12,"p_rtflags@196-208@usr.bin/netstat/route.c","usr.bin/netstat/route.c","p_rtflags",196,208
43,9,336,1,46,"p_rtnode@213-259@usr.bin/netstat/route.c","usr.bin/netstat/route.c","p_rtnode",213,259
37,11,333,1,42,"p_krtentry@262-304@usr.bin/netstat/route.c","usr.bin/netstat/route.c","p_krtentry",262,304
28,2,186,1,30,"rt_stats@310-340@usr.bin/netstat/route.c","usr.bin/netstat/route.c","rt_stats",310,340
19,7,129,3,20,"get_sysctl@109-129@usr.bin/netstat/show.c","usr.bin/netstat/show.c","get_sysctl",109,129
29,4,189,2,32,"p_rttables@135-167@usr.bin/netstat/show.c","usr.bin/netstat/show.c","p_rttables",135,167
19,5,52,1,19,"WID_DST@177-196@usr.bin/netstat/show.c","usr.bin/netstat/show.c","WID_DST",177,196
26,6,147,2,25,"pr_rthdr@202-227@usr.bin/netstat/show.c","usr.bin/netstat/show.c","pr_rthdr",202,227
12,3,87,3,12,"get_rtaddrs@230-242@usr.bin/netstat/show.c","usr.bin/netstat/show.c","get_rtaddrs",230,242
40,10,328,1,46,"p_rtentry@248-294@usr.bin/netstat/show.c","usr.bin/netstat/show.c","p_rtentry",248,294
25,6,80,1,25,"pr_family@300-325@usr.bin/netstat/show.c","usr.bin/netstat/show.c","pr_family",300,325
4,1,33,3,3,"p_addr@328-331@usr.bin/netstat/show.c","usr.bin/netstat/show.c","p_addr",328,331
4,1,26,2,3,"p_gwaddr@334-337@usr.bin/netstat/show.c","usr.bin/netstat/show.c","p_gwaddr",334,337
39,11,230,4,45,"p_sockaddr@340-385@usr.bin/netstat/show.c","usr.bin/netstat/show.c","p_sockaddr",340,385
13,4,103,4,14,"p_sockaddr_mpls@391-405@usr.bin/netstat/show.c","usr.bin/netstat/show.c","p_sockaddr_mpls",391,405
10,4,82,2,10,"p_flags@408-418@usr.bin/netstat/show.c","usr.bin/netstat/show.c","p_flags",408,418
58,15,399,1,65,"routename@421-486@usr.bin/netstat/show.c","usr.bin/netstat/show.c","routename",421,486
20,8,135,1,21,"routename4@489-510@usr.bin/netstat/show.c","usr.bin/netstat/show.c","routename4",489,510
12,3,77,1,14,"routename6@513-527@usr.bin/netstat/show.c","usr.bin/netstat/show.c","routename6",513,527
21,7,222,2,23,"netname4@534-557@usr.bin/netstat/show.c","usr.bin/netstat/show.c","netname4",534,557
82,22,442,2,89,"netname6@560-649@usr.bin/netstat/show.c","usr.bin/netstat/show.c","netname6",560,649
21,6,136,2,20,"netname@656-676@usr.bin/netstat/show.c","usr.bin/netstat/show.c","netname",656,676
15,3,132,1,15,"any_ntoa@681-696@usr.bin/netstat/show.c","usr.bin/netstat/show.c","any_ntoa",681,696
17,6,120,1,17,"link_print@699-716@usr.bin/netstat/show.c","usr.bin/netstat/show.c","link_print",699,716
15,5,60,1,14,"mpls_op@719-733@usr.bin/netstat/show.c","usr.bin/netstat/show.c","mpls_op",719,733
10,2,71,1,11,"label_print@736-747@usr.bin/netstat/show.c","usr.bin/netstat/show.c","label_print",736,747
24,4,168,1,27,"unixdomainpr@59-86@usr.bin/netstat/unix.c","usr.bin/netstat/unix.c","unixdomainpr",59,86
23,3,188,1,31,"unpcb_dump@92-123@usr.bin/netstat/unix.c","usr.bin/netstat/unix.c","unpcb_dump",92,123
82,29,556,2,99,"main@176-275@usr.bin/newsyslog/newsyslog.c","usr.bin/newsyslog/newsyslog.c","main",176,275
61,40,533,1,62,"do_entry@278-340@usr.bin/newsyslog/newsyslog.c","usr.bin/newsyslog/newsyslog.c","do_entry",278,340
7,2,28,1,6,"run_command@344-350@usr.bin/newsyslog/newsyslog.c","usr.bin/newsyslog/newsyslog.c","run_command",344,350
40,15,259,2,42,"send_signal@354-396@usr.bin/newsyslog/newsyslog.c","usr.bin/newsyslog/newsyslog.c","send_signal",354,396
45,12,231,2,51,"parse_args@399-450@usr.bin/newsyslog/newsyslog.c","usr.bin/newsyslog/newsyslog.c","parse_args",399,450
7,1,30,1,7,"usage@453-460@usr.bin/newsyslog/newsyslog.c","usr.bin/newsyslog/newsyslog.c","usage",453,460
285,76,1852,2,308,"parse_file@467-775@usr.bin/newsyslog/newsyslog.c","usr.bin/newsyslog/newsyslog.c","parse_file",467,775
9,3,54,3,8,"missing_field@778-786@usr.bin/newsyslog/newsyslog.c","usr.bin/newsyslog/newsyslog.c","missing_field",778,786
38,11,328,2,46,"rotate@789-835@usr.bin/newsyslog/newsyslog.c","usr.bin/newsyslog/newsyslog.c","rotate",789,835
47,18,422,1,54,"dotrim@838-892@usr.bin/newsyslog/newsyslog.c","usr.bin/newsyslog/newsyslog.c","dotrim",838,892
11,3,75,1,11,"log_trim@896-907@usr.bin/newsyslog/newsyslog.c","usr.bin/newsyslog/newsyslog.c","log_trim",896,907
26,6,166,1,27,"compress_log@911-938@usr.bin/newsyslog/newsyslog.c","usr.bin/newsyslog/newsyslog.c","compress_log",911,938
7,2,38,1,7,"sizefile@942-949@usr.bin/newsyslog/newsyslog.c","usr.bin/newsyslog/newsyslog.c","sizefile",942,949
20,7,175,1,20,"age_old_log@953-973@usr.bin/newsyslog/newsyslog.c","usr.bin/newsyslog/newsyslog.c","age_old_log",953,973
8,3,39,1,7,"sob@977-984@usr.bin/newsyslog/newsyslog.c","usr.bin/newsyslog/newsyslog.c","sob",977,984
6,4,34,1,5,"son@988-993@usr.bin/newsyslog/newsyslog.c","usr.bin/newsyslog/newsyslog.c","son",988,993
8,3,39,1,7,"isnumberstr@997-1004@usr.bin/newsyslog/newsyslog.c","usr.bin/newsyslog/newsyslog.c","isnumberstr",997,1004
79,18,497,1,97,"domonitor@1007-1104@usr.bin/newsyslog/newsyslog.c","usr.bin/newsyslog/newsyslog.c","domonitor",1007,1104
8,2,35,1,8,"child_killer@1108-1116@usr.bin/newsyslog/newsyslog.c","usr.bin/newsyslog/newsyslog.c","child_killer",1108,1116
10,3,87,5,10,"stat_suffix@1119-1129@usr.bin/newsyslog/newsyslog.c","usr.bin/newsyslog/newsyslog.c","stat_suffix",1119,1129
16,6,114,3,17,"lstat_log@1136-1153@usr.bin/newsyslog/newsyslog.c","usr.bin/newsyslog/newsyslog.c","lstat_log",1136,1153
58,30,403,1,72,"parse8601@1164-1236@usr.bin/newsyslog/newsyslog.c","usr.bin/newsyslog/newsyslog.c","parse8601",1164,1236
84,26,514,1,97,"parseDWM@1253-1350@usr.bin/newsyslog/newsyslog.c","usr.bin/newsyslog/newsyslog.c","parseDWM",1253,1350
34,15,306,5,40,"movefile@1356-1396@usr.bin/newsyslog/newsyslog.c","usr.bin/newsyslog/newsyslog.c","movefile",1356,1396
79,21,459,2,88,"main@78-166@usr.bin/nfsstat/nfsstat.c","usr.bin/nfsstat/nfsstat.c","main",78,166
15,4,114,1,16,"getnfsstats@169-185@usr.bin/nfsstat/nfsstat.c","usr.bin/nfsstat/nfsstat.c","getnfsstats",169,185
130,4,798,1,133,"intpr@191-324@usr.bin/nfsstat/nfsstat.c","usr.bin/nfsstat/nfsstat.c","intpr",191,324
66,6,409,2,70,"sidewaysintpr@333-403@usr.bin/nfsstat/nfsstat.c","usr.bin/nfsstat/nfsstat.c","sidewaysintpr",333,403
7,1,32,1,6,"printhdr@406-412@usr.bin/nfsstat/nfsstat.c","usr.bin/nfsstat/nfsstat.c","printhdr",406,412
4,1,11,1,3,"catchalarm@420-423@usr.bin/nfsstat/nfsstat.c","usr.bin/nfsstat/nfsstat.c","catchalarm",420,423
7,1,25,1,7,"usage@426-433@usr.bin/nfsstat/nfsstat.c","usr.bin/nfsstat/nfsstat.c","usage",426,433
41,14,291,2,48,"main@47-95@usr.bin/nice/nice.c","usr.bin/nice/nice.c","main",47,95
7,1,25,1,6,"usage@98-104@usr.bin/nice/nice.c","usr.bin/nice/nice.c","usage",98,104
109,33,624,2,119,"main@111-230@usr.bin/nl/nl.c","usr.bin/nl/nl.c","main",111,230
65,16,353,1,78,"filter@233-311@usr.bin/nl/nl.c","usr.bin/nl/nl.c","filter",233,311
36,7,203,2,39,"parse_numbering@318-357@usr.bin/nl/nl.c","usr.bin/nl/nl.c","parse_numbering",318,357
7,1,27,1,6,"usage@360-366@usr.bin/nl/nl.c","usr.bin/nl/nl.c","usage",360,366
19,2,172,1,21,"elf_fix_header@122-143@usr.bin/nm/elf.c","usr.bin/nm/elf.c","elf_fix_header",122,143
33,7,219,4,40,"elf_load_shdrs@146-186@usr.bin/nm/elf.c","usr.bin/nm/elf.c","elf_load_shdrs",146,186
20,4,143,4,23,"elf_load_phdrs@189-212@usr.bin/nm/elf.c","usr.bin/nm/elf.c","elf_load_phdrs",189,212
19,3,162,2,22,"elf_fix_shdrs@215-237@usr.bin/nm/elf.c","usr.bin/nm/elf.c","elf_fix_shdrs",215,237
17,3,140,2,20,"elf_fix_phdrs@240-260@usr.bin/nm/elf.c","usr.bin/nm/elf.c","elf_fix_phdrs",240,260
10,2,77,2,12,"elf_fix_sym@263-275@usr.bin/nm/elf.c","usr.bin/nm/elf.c","elf_fix_sym",263,275
55,25,334,3,64,"elf_shn2type@278-342@usr.bin/nm/elf.c","usr.bin/nm/elf.c","elf_shn2type",278,342
75,28,488,5,85,"elf2nlist@349-434@usr.bin/nm/elf.c","usr.bin/nm/elf.c","elf2nlist",349,434
18,6,142,5,20,"elf_size@437-457@usr.bin/nm/elf.c","usr.bin/nm/elf.c","elf_size",437,457
80,19,597,13,86,"elf_symloadx@460-546@usr.bin/nm/elf.c","usr.bin/nm/elf.c","elf_symloadx",460,546
44,8,315,9,50,"elf_symload@549-599@usr.bin/nm/elf.c","usr.bin/nm/elf.c","elf_symload",549,599
103,37,458,2,113,"main@130-243@usr.bin/nm/nm.c","usr.bin/nm/nm.c","main",130,243
36,10,274,2,44,"process_file@251-295@usr.bin/nm/nm.c","usr.bin/nm/nm.c","process_file",251,295
45,17,397,5,54,"mmbr_name@304-358@usr.bin/nm/nm.c","usr.bin/nm/nm.c","mmbr_name",304,358
44,8,329,4,52,"show_symtab@365-417@usr.bin/nm/nm.c","usr.bin/nm/nm.c","show_symtab",365,417
47,9,358,4,54,"show_symdef@424-478@usr.bin/nm/nm.c","usr.bin/nm/nm.c","show_symdef",424,478
104,33,680,3,139,"show_archive@485-624@usr.bin/nm/nm.c","usr.bin/nm/nm.c","show_archive",485,624
80,28,632,6,119,"show_file@635-754@usr.bin/nm/nm.c","usr.bin/nm/nm.c","show_file",635,754
4,1,18,1,3,"symname@757-760@usr.bin/nm/nm.c","usr.bin/nm/nm.c","symname",757,760
28,8,196,2,36,"print_symbol@767-803@usr.bin/nm/nm.c","usr.bin/nm/nm.c","print_symbol",767,803
25,18,150,1,30,"typeletter@812-842@usr.bin/nm/nm.c","usr.bin/nm/nm.c","typeletter",812,842
5,1,58,2,5,"fname@845-850@usr.bin/nm/nm.c","usr.bin/nm/nm.c","fname",845,850
5,1,58,2,5,"rname@853-858@usr.bin/nm/nm.c","usr.bin/nm/nm.c","rname",853,858
20,9,217,2,20,"value@861-881@usr.bin/nm/nm.c","usr.bin/nm/nm.c","value",861,881
23,4,142,1,24,"pipe2cppfilt@886-910@usr.bin/nm/nm.c","usr.bin/nm/nm.c","pipe2cppfilt",886,910
10,2,39,1,10,"usage@913-923@usr.bin/nm/nm.c","usr.bin/nm/nm.c","usage",913,923
20,8,162,2,31,"main@72-103@usr.bin/nohup/nohup.c","usr.bin/nohup/nohup.c","main",72,103
23,7,217,1,24,"dofile@106-130@usr.bin/nohup/nohup.c","usr.bin/nohup/nohup.c","dofile",106,130
5,1,21,1,4,"usage@133-137@usr.bin/nohup/nohup.c","usr.bin/nohup/nohup.c","usage",133,137
26,21,235,1,25,"str2fmt@170-195@usr.bin/openssl/apps.c","usr.bin/openssl/apps.c","str2fmt",170,195
10,2,51,3,10,"program_name@198-208@usr.bin/openssl/apps.c","usr.bin/openssl/apps.c","program_name",198,208
57,23,398,4,67,"chopup_args@211-278@usr.bin/openssl/apps.c","usr.bin/openssl/apps.c","chopup_args",211,278
14,1,92,2,16,"dump_cert_text@281-297@usr.bin/openssl/apps.c","usr.bin/openssl/apps.c","dump_cert_text",281,297
4,1,19,1,3,"ui_open@300-303@usr.bin/openssl/apps.c","usr.bin/openssl/apps.c","ui_open",300,303
18,7,108,2,18,"ui_read@306-324@usr.bin/openssl/apps.c","usr.bin/openssl/apps.c","ui_read",306,324
16,7,97,2,16,"ui_write@327-343@usr.bin/openssl/apps.c","usr.bin/openssl/apps.c","ui_write",327,343
4,1,19,1,3,"ui_close@346-349@usr.bin/openssl/apps.c","usr.bin/openssl/apps.c","ui_close",346,349
62,16,390,4,66,"password_callback@352-418@usr.bin/openssl/apps.c","usr.bin/openssl/apps.c","password_callback",352,418
21,11,132,5,21,"app_passwd@423-444@usr.bin/openssl/apps.c","usr.bin/openssl/apps.c","app_passwd",423,444
69,16,394,3,73,"app_get_pass@447-520@usr.bin/openssl/apps.c","usr.bin/openssl/apps.c","app_get_pass",447,520
24,5,152,2,24,"add_oid_section@523-547@usr.bin/openssl/apps.c","usr.bin/openssl/apps.c","add_oid_section",523,547
38,9,232,8,40,"load_pkcs12@550-590@usr.bin/openssl/apps.c","usr.bin/openssl/apps.c","load_pkcs12",550,590
57,12,336,5,60,"load_cert@593-653@usr.bin/openssl/apps.c","usr.bin/openssl/apps.c","load_cert",593,653
55,18,349,6,60,"load_key@656-716@usr.bin/openssl/apps.c","usr.bin/openssl/apps.c","load_key",656,716
66,21,400,6,72,"load_pubkey@719-791@usr.bin/openssl/apps.c","usr.bin/openssl/apps.c","load_pubkey",719,791
39,9,233,5,40,"load_netscape_key@795-835@usr.bin/openssl/apps.c","usr.bin/openssl/apps.c","load_netscape_key",795,835
73,25,422,7,81,"load_certs_crls@839-920@usr.bin/openssl/apps.c","usr.bin/openssl/apps.c","load_certs_crls",839,920
8,2,60,5,8,"load_certs@923-931@usr.bin/openssl/apps.c","usr.bin/openssl/apps.c","load_certs",923,931
8,2,60,5,8,"load_crls@934-942@usr.bin/openssl/apps.c","usr.bin/openssl/apps.c","load_crls",934,942
25,1,185,2,24,"set_cert_ex@958-982@usr.bin/openssl/apps.c","usr.bin/openssl/apps.c","set_cert_ex",958,982
34,1,257,2,33,"set_name_ex@985-1018@usr.bin/openssl/apps.c","usr.bin/openssl/apps.c","set_name_ex",985,1018
12,4,67,2,11,"set_ext_copy@1021-1032@usr.bin/openssl/apps.c","usr.bin/openssl/apps.c","set_ext_copy",1021,1032
31,9,207,3,38,"copy_extensions@1035-1073@usr.bin/openssl/apps.c","usr.bin/openssl/apps.c","copy_extensions",1035,1073
17,4,107,3,17,"set_multi_opts@1076-1093@usr.bin/openssl/apps.c","usr.bin/openssl/apps.c","set_multi_opts",1076,1093
26,6,131,3,27,"set_table_opts@1096-1123@usr.bin/openssl/apps.c","usr.bin/openssl/apps.c","set_table_opts",1096,1123
23,5,136,4,23,"print_name@1126-1149@usr.bin/openssl/apps.c","usr.bin/openssl/apps.c","print_name",1126,1149
32,8,179,3,35,"setup_verify@1152-1187@usr.bin/openssl/apps.c","usr.bin/openssl/apps.c","setup_verify",1152,1187
18,5,85,2,20,"load_config@1190-1210@usr.bin/openssl/apps.c","usr.bin/openssl/apps.c","load_config",1190,1210
8,2,39,0,8,"make_config_name@1213-1221@usr.bin/openssl/apps.c","usr.bin/openssl/apps.c","make_config_name",1213,1221
8,2,39,1,8,"index_serial_hash@1224-1232@usr.bin/openssl/apps.c","usr.bin/openssl/apps.c","index_serial_hash",1224,1232
9,3,68,2,9,"index_serial_cmp@1235-1244@usr.bin/openssl/apps.c","usr.bin/openssl/apps.c","index_serial_cmp",1235,1244
4,1,21,1,3,"index_name_qual@1247-1250@usr.bin/openssl/apps.c","usr.bin/openssl/apps.c","index_name_qual",1247,1250
4,1,20,1,3,"index_name_hash@1253-1256@usr.bin/openssl/apps.c","usr.bin/openssl/apps.c","index_name_hash",1253,1256
4,1,30,2,3,"index_name_cmp@1259-1262@usr.bin/openssl/apps.c","usr.bin/openssl/apps.c","index_name_cmp",1259,1262
46,13,241,3,49,"load_serial@1270-1319@usr.bin/openssl/apps.c","usr.bin/openssl/apps.c","load_serial",1270,1319
44,10,241,4,45,"save_serial@1322-1367@usr.bin/openssl/apps.c","usr.bin/openssl/apps.c","save_serial",1322,1367
35,8,198,3,40,"rotate_serial@1370-1410@usr.bin/openssl/apps.c","usr.bin/openssl/apps.c","rotate_serial",1370,1410
20,7,95,2,25,"rand_serial@1413-1438@usr.bin/openssl/apps.c","usr.bin/openssl/apps.c","rand_serial",1413,1438
62,14,333,2,66,"load_index@1441-1507@usr.bin/openssl/apps.c","usr.bin/openssl/apps.c","load_index",1441,1507
18,4,125,1,17,"index_index@1510-1527@usr.bin/openssl/apps.c","usr.bin/openssl/apps.c","index_index",1510,1527
41,8,245,3,47,"save_index@1530-1577@usr.bin/openssl/apps.c","usr.bin/openssl/apps.c","save_index",1530,1577
87,20,525,3,92,"rotate_index@1580-1672@usr.bin/openssl/apps.c","usr.bin/openssl/apps.c","rotate_index",1580,1672
8,3,32,1,7,"free_index@1675-1682@usr.bin/openssl/apps.c","usr.bin/openssl/apps.c","free_index",1675,1682
26,12,83,2,26,"parse_yesno@1685-1711@usr.bin/openssl/apps.c","usr.bin/openssl/apps.c","parse_yesno",1685,1711
104,23,582,3,127,"parse_name@1718-1845@usr.bin/openssl/apps.c","usr.bin/openssl/apps.c","parse_name",1718,1845
121,35,721,5,133,"args_verify@1848-1981@usr.bin/openssl/apps.c","usr.bin/openssl/apps.c","args_verify",1848,1981
29,8,162,3,30,"bio_to_mem@1988-2018@usr.bin/openssl/apps.c","usr.bin/openssl/apps.c","bio_to_mem",1988,2018
18,4,92,2,19,"pkey_ctrl_string@2021-2040@usr.bin/openssl/apps.c","usr.bin/openssl/apps.c","pkey_ctrl_string",2021,2040
14,3,93,3,14,"nodes_print@2043-2057@usr.bin/openssl/apps.c","usr.bin/openssl/apps.c","nodes_print",2043,2057
18,4,105,2,20,"policies_print@2060-2080@usr.bin/openssl/apps.c","usr.bin/openssl/apps.c","policies_print",2060,2080
25,7,151,2,28,"next_protos_parse@2092-2120@usr.bin/openssl/apps.c","usr.bin/openssl/apps.c","next_protos_parse",2092,2120
7,2,37,1,7,"app_isdir@2123-2130@usr.bin/openssl/apps.c","usr.bin/openssl/apps.c","app_isdir",2123,2130
22,6,199,1,24,"options_usage@2135-2159@usr.bin/openssl/apps.c","usr.bin/openssl/apps.c","options_usage",2135,2159
143,46,848,5,170,"options_parse@2162-2332@usr.bin/openssl/apps.c","usr.bin/openssl/apps.c","options_parse",2162,2332
12,2,66,1,12,"real_interval@127-139@usr.bin/openssl/apps_posix.c","usr.bin/openssl/apps_posix.c","real_interval",127,139
13,2,72,1,13,"user_interval@142-155@usr.bin/openssl/apps_posix.c","usr.bin/openssl/apps_posix.c","user_interval",142,155
4,2,25,2,3,"app_tminterval@158-161@usr.bin/openssl/apps_posix.c","usr.bin/openssl/apps_posix.c","app_tminterval",158,161
9,1,44,1,8,"setup_ui@164-172@usr.bin/openssl/apps_posix.c","usr.bin/openssl/apps_posix.c","setup_ui",164,172
7,2,21,1,6,"destroy_ui@175-181@usr.bin/openssl/apps_posix.c","usr.bin/openssl/apps_posix.c","destroy_ui",175,181
11,2,55,1,11,"asn1pars_opt_dlimit@92-103@usr.bin/openssl/asn1pars.c","usr.bin/openssl/asn1pars.c","asn1pars_opt_dlimit",92,103
11,2,55,1,11,"asn1pars_opt_length@106-117@usr.bin/openssl/asn1pars.c","usr.bin/openssl/asn1pars.c","asn1pars_opt_length",106,117
8,2,41,1,7,"asn1pars_opt_strparse@120-127@usr.bin/openssl/asn1pars.c","usr.bin/openssl/asn1pars.c","asn1pars_opt_strparse",120,127
10,1,21,0,9,"asn1pars_usage@224-233@usr.bin/openssl/asn1pars.c","usr.bin/openssl/asn1pars.c","asn1pars_usage",224,233
172,39,1026,2,187,"asn1parse_main@238-425@usr.bin/openssl/asn1pars.c","usr.bin/openssl/asn1pars.c","asn1parse_main",238,425
43,9,237,4,54,"do_generate@428-482@usr.bin/openssl/asn1pars.c","usr.bin/openssl/asn1pars.c","do_generate",428,482
10,3,75,2,9,"setCertificateTime@219-228@usr.bin/openssl/ca.c","usr.bin/openssl/ca.c","setCertificateTime",219,228
1005,311,6257,2,1111,"ca_main@231-1342@usr.bin/openssl/ca.c","usr.bin/openssl/ca.c","ca_main",231,1342
4,1,25,2,3,"lookup_fail@1345-1348@usr.bin/openssl/ca.c","usr.bin/openssl/ca.c","lookup_fail",1345,1348
60,11,413,25,65,"certify@1351-1416@usr.bin/openssl/ca.c","usr.bin/openssl/ca.c","certify",1351,1416
49,9,365,24,54,"certify_cert@1419-1473@usr.bin/openssl/ca.c","usr.bin/openssl/ca.c","certify_cert",1419,1473
427,126,2777,25,515,"do_body@1476-1991@usr.bin/openssl/ca.c","usr.bin/openssl/ca.c","do_body",1476,1991
10,3,55,4,9,"write_new_certificate@1994-2003@usr.bin/openssl/ca.c","usr.bin/openssl/ca.c","write_new_certificate",1994,2003
102,21,669,23,132,"certify_spkac@2006-2138@usr.bin/openssl/ca.c","usr.bin/openssl/ca.c","certify_spkac",2006,2138
4,1,17,1,3,"check_time_format@2141-2144@usr.bin/openssl/ca.c","usr.bin/openssl/ca.c","check_time_format",2141,2144
89,18,675,4,109,"do_revoke@2147-2256@usr.bin/openssl/ca.c","usr.bin/openssl/ca.c","do_revoke",2147,2256
55,11,467,2,69,"get_certificate_status@2259-2328@usr.bin/openssl/ca.c","usr.bin/openssl/ca.c","get_certificate_status",2259,2328
48,9,313,1,60,"do_updatedb@2331-2391@usr.bin/openssl/ca.c","usr.bin/openssl/ca.c","do_updatedb",2331,2391
56,17,275,2,66,"make_revocation_str@2420-2486@usr.bin/openssl/ca.c","usr.bin/openssl/ca.c","make_revocation_str",2420,2486
43,16,251,2,50,"make_revoked@2496-2546@usr.bin/openssl/ca.c","usr.bin/openssl/ca.c","make_revoked",2496,2546
36,11,281,3,38,"old_entry_print@2549-2587@usr.bin/openssl/ca.c","usr.bin/openssl/ca.c","old_entry_print",2549,2587
97,24,471,5,103,"unpack_revinfo@2590-2693@usr.bin/openssl/ca.c","usr.bin/openssl/ca.c","unpack_revinfo",2590,2693
14,3,111,2,14,"bin2hex@2696-2710@usr.bin/openssl/ca.c","usr.bin/openssl/ca.c","bin2hex",2696,2710
16,5,115,3,17,"hashinfo@71-88@usr.bin/openssl/certhash.c","usr.bin/openssl/certhash.c","hashinfo",71,88
8,2,36,1,8,"hashinfo_free@91-99@usr.bin/openssl/certhash.c","usr.bin/openssl/certhash.c","hashinfo_free",91,99
10,3,78,1,10,"hashinfo_print@103-113@usr.bin/openssl/certhash.c","usr.bin/openssl/certhash.c","hashinfo_print",103,113
14,4,118,2,14,"hashinfo_compare@117-131@usr.bin/openssl/certhash.c","usr.bin/openssl/certhash.c","hashinfo_compare",117,131
10,3,57,2,11,"hashinfo_chain@134-145@usr.bin/openssl/certhash.c","usr.bin/openssl/certhash.c","hashinfo_chain",134,145
9,2,37,1,9,"hashinfo_chain_free@148-157@usr.bin/openssl/certhash.c","usr.bin/openssl/certhash.c","hashinfo_chain_free",148,157
9,2,36,1,9,"hashinfo_chain_length@160-169@usr.bin/openssl/certhash.c","usr.bin/openssl/certhash.c","hashinfo_chain_length",160,169
22,5,175,1,26,"hashinfo_chain_sort@172-198@usr.bin/openssl/certhash.c","usr.bin/openssl/certhash.c","hashinfo_chain_sort",172,198
8,3,54,1,9,"hashinfo_linkname@201-210@usr.bin/openssl/certhash.c","usr.bin/openssl/certhash.c","hashinfo_linkname",201,210
15,10,100,1,16,"filename_is_hash@213-229@usr.bin/openssl/certhash.c","usr.bin/openssl/certhash.c","filename_is_hash",213,229
11,4,81,1,12,"filename_is_pem@232-244@usr.bin/openssl/certhash.c","usr.bin/openssl/certhash.c","filename_is_pem",232,244
40,14,270,2,49,"hashinfo_from_linkname@247-296@usr.bin/openssl/certhash.c","usr.bin/openssl/certhash.c","hashinfo_from_linkname",247,296
21,3,132,2,26,"certhash_cert@299-325@usr.bin/openssl/certhash.c","usr.bin/openssl/certhash.c","certhash_cert",299,325
21,3,137,2,26,"certhash_crl@328-354@usr.bin/openssl/certhash.c","usr.bin/openssl/certhash.c","certhash_crl",328,354
16,3,110,2,20,"certhash_addlink@357-377@usr.bin/openssl/certhash.c","usr.bin/openssl/certhash.c","certhash_addlink",357,377
17,8,112,2,17,"certhash_findlink@380-397@usr.bin/openssl/certhash.c","usr.bin/openssl/certhash.c","certhash_findlink",380,397
27,5,139,2,27,"certhash_index@400-427@usr.bin/openssl/certhash.c","usr.bin/openssl/certhash.c","certhash_index",400,427
34,15,260,3,40,"certhash_merge@430-470@usr.bin/openssl/certhash.c","usr.bin/openssl/certhash.c","certhash_merge",430,470
27,5,192,2,30,"certhash_link@473-503@usr.bin/openssl/certhash.c","usr.bin/openssl/certhash.c","certhash_link",473,503
38,8,247,3,46,"certhash_file@506-552@usr.bin/openssl/certhash.c","usr.bin/openssl/certhash.c","certhash_file",506,552
69,25,454,1,81,"certhash_directory@555-636@usr.bin/openssl/certhash.c","usr.bin/openssl/certhash.c","certhash_directory",555,636
5,1,18,1,4,"certhash_usage@639-643@usr.bin/openssl/certhash.c","usr.bin/openssl/certhash.c","certhash_usage",639,643
37,8,219,2,42,"certhash_main@646-688@usr.bin/openssl/certhash.c","usr.bin/openssl/certhash.c","certhash_main",646,688
5,1,18,1,4,"ciphers_usage@66-70@usr.bin/openssl/ciphers.c","usr.bin/openssl/ciphers.c","ciphers_usage",66,70
67,16,414,2,79,"ciphers_main@73-152@usr.bin/openssl/ciphers.c","usr.bin/openssl/ciphers.c","ciphers_main",73,152
9,1,21,1,8,"crl_usage@205-213@usr.bin/openssl/crl.c","usr.bin/openssl/crl.c","crl_usage",205,213
198,45,1118,2,219,"crl_main@219-438@usr.bin/openssl/crl.c","usr.bin/openssl/crl.c","crl_main",219,438
35,7,170,2,36,"load_crl@441-477@usr.bin/openssl/crl.c","usr.bin/openssl/crl.c","load_crl",441,477
14,4,77,1,14,"crl2p7_opt_certfile@89-103@usr.bin/openssl/crl2p7.c","usr.bin/openssl/crl2p7.c","crl2p7_opt_certfile",89,103
7,1,19,1,6,"crl2p7_usage@151-157@usr.bin/openssl/crl2p7.c","usr.bin/openssl/crl2p7.c","crl2p7_usage",151,157
119,30,698,2,131,"crl2pkcs7_main@160-291@usr.bin/openssl/crl2p7.c","usr.bin/openssl/crl2p7.c","crl2pkcs7_main",160,291
34,8,198,2,39,"add_certs_from_file@294-333@usr.bin/openssl/crl2p7.c","usr.bin/openssl/crl2p7.c","add_certs_from_file",294,333
15,5,94,4,17,"list_md_fn@82-99@usr.bin/openssl/dgst.c","usr.bin/openssl/dgst.c","list_md_fn",82,99
341,94,2087,2,364,"dgst_main@102-466@usr.bin/openssl/dgst.c","usr.bin/openssl/dgst.c","dgst_main",102,466
71,18,452,12,72,"do_fp@469-541@usr.bin/openssl/dgst.c","usr.bin/openssl/dgst.c","do_fp",469,541
7,1,19,1,6,"dh_usage@145-151@usr.bin/openssl/dh.c","usr.bin/openssl/dh.c","dh_usage",145,151
135,33,780,2,145,"dh_main@154-299@usr.bin/openssl/dh.c","usr.bin/openssl/dh.c","dh_main",154,299
8,1,19,0,7,"dhparam_usage@225-232@usr.bin/openssl/dhparam.c","usr.bin/openssl/dhparam.c","dhparam_usage",225,232
215,56,1206,2,241,"dhparam_main@237-478@usr.bin/openssl/dhparam.c","usr.bin/openssl/dhparam.c","dhparam_main",237,478
15,5,84,3,15,"dh_cb@482-497@usr.bin/openssl/dhparam.c","usr.bin/openssl/dhparam.c","dh_cb",482,497
11,3,69,3,13,"dsa_opt_enc@94-107@usr.bin/openssl/dsa.c","usr.bin/openssl/dsa.c","dsa_opt_enc",94,107
7,3,56,2,8,"show_ciphers@208-216@usr.bin/openssl/dsa.c","usr.bin/openssl/dsa.c","show_ciphers",208,216
13,1,51,1,13,"dsa_usage@219-232@usr.bin/openssl/dsa.c","usr.bin/openssl/dsa.c","dsa_usage",219,232
125,33,752,2,138,"dsa_main@235-373@usr.bin/openssl/dsa.c","usr.bin/openssl/dsa.c","dsa_main",235,373
8,1,20,1,7,"dsaparam_usage@150-157@usr.bin/openssl/dsaparam.c","usr.bin/openssl/dsaparam.c","dsaparam_usage",150,157
174,38,1046,2,187,"dsaparam_main@162-349@usr.bin/openssl/dsaparam.c","usr.bin/openssl/dsaparam.c","dsaparam_main",162,349
17,7,91,3,19,"dsa_cb@352-371@usr.bin/openssl/dsaparam.c","usr.bin/openssl/dsaparam.c","dsa_cb",352,371
11,3,69,3,13,"ec_opt_enc@95-108@usr.bin/openssl/ec.c","usr.bin/openssl/ec.c","ec_opt_enc",95,108
15,4,89,1,15,"ec_opt_form@111-126@usr.bin/openssl/ec.c","usr.bin/openssl/ec.c","ec_opt_form",111,126
13,3,71,1,13,"ec_opt_named@129-142@usr.bin/openssl/ec.c","usr.bin/openssl/ec.c","ec_opt_named",129,142
7,3,56,2,8,"show_ciphers@243-251@usr.bin/openssl/ec.c","usr.bin/openssl/ec.c","show_ciphers",243,251
13,1,51,1,14,"ec_usage@254-268@usr.bin/openssl/ec.c","usr.bin/openssl/ec.c","ec_usage",254,268
123,32,726,2,134,"ec_main@271-405@usr.bin/openssl/ec.c","usr.bin/openssl/ec.c","ec_main",271,405
13,4,78,1,13,"ecparam_opt_form@113-126@usr.bin/openssl/ecparam.c","usr.bin/openssl/ecparam.c","ecparam_opt_form",113,126
11,3,60,1,11,"ecparam_opt_enctype@129-140@usr.bin/openssl/ecparam.c","usr.bin/openssl/ecparam.c","ecparam_opt_enctype",129,140
9,1,22,1,8,"ecparam_usage@242-250@usr.bin/openssl/ecparam.c","usr.bin/openssl/ecparam.c","ecparam_usage",242,250
299,64,1832,2,337,"ecparam_main@253-590@usr.bin/openssl/ecparam.c","usr.bin/openssl/ecparam.c","ecparam_main",253,590
21,5,152,5,21,"ecparam_print_var@593-614@usr.bin/openssl/ecparam.c","usr.bin/openssl/ecparam.c","ecparam_print_var",593,614
16,4,98,3,19,"enc_opt_cipher@105-124@usr.bin/openssl/enc.c","usr.bin/openssl/enc.c","enc_opt_cipher",105,124
7,3,56,2,8,"show_ciphers@293-301@usr.bin/openssl/enc.c","usr.bin/openssl/enc.c","show_ciphers",293,301
13,1,52,1,13,"enc_usage@304-317@usr.bin/openssl/enc.c","usr.bin/openssl/enc.c","enc_usage",304,317
347,110,2285,2,415,"enc_main@320-735@usr.bin/openssl/enc.c","usr.bin/openssl/enc.c","enc_main",320,735
32,11,219,3,32,"set_hex@738-770@usr.bin/openssl/enc.c","usr.bin/openssl/enc.c","set_hex",738,770
5,1,17,0,4,"errstr_usage@86-90@usr.bin/openssl/errstr.c","usr.bin/openssl/errstr.c","errstr_usage",86,90
46,12,294,2,55,"errstr_main@93-148@usr.bin/openssl/errstr.c","usr.bin/openssl/errstr.c","errstr_main",93,148
6,1,18,1,5,"gendh_usage@121-126@usr.bin/openssl/gendh.c","usr.bin/openssl/gendh.c","gendh_usage",121,126
59,15,354,2,69,"gendh_main@129-198@usr.bin/openssl/gendh.c","usr.bin/openssl/gendh.c","gendh_main",129,198
15,5,84,3,15,"dh_cb@201-216@usr.bin/openssl/gendh.c","usr.bin/openssl/gendh.c","dh_cb",201,216
115,33,746,2,138,"gendsa_main@78-216@usr.bin/openssl/gendsa.c","usr.bin/openssl/gendsa.c","gendsa_main",78,216
166,46,974,2,178,"genpkey_main@73-251@usr.bin/openssl/genpkey.c","usr.bin/openssl/genpkey.c","genpkey_main",73,251
38,8,188,3,40,"init_keygen_file@254-294@usr.bin/openssl/genpkey.c","usr.bin/openssl/genpkey.c","init_keygen_file",254,294
36,8,188,4,42,"init_gen_str@297-339@usr.bin/openssl/genpkey.c","usr.bin/openssl/genpkey.c","init_gen_str",297,339
18,5,95,1,17,"genpkey_cb@342-359@usr.bin/openssl/genpkey.c","usr.bin/openssl/genpkey.c","genpkey_cb",342,359
129,38,855,2,159,"genrsa_main@89-248@usr.bin/openssl/genrsa.c","usr.bin/openssl/genrsa.c","genrsa_main",89,248
15,5,84,3,15,"genrsa_cb@251-266@usr.bin/openssl/genrsa.c","usr.bin/openssl/genrsa.c","genrsa_cb",251,266
5,1,17,0,4,"nseq_usage@98-102@usr.bin/openssl/nseq.c","usr.bin/openssl/nseq.c","nseq_usage",98,102
65,13,417,2,71,"nseq_main@105-176@usr.bin/openssl/nseq.c","usr.bin/openssl/nseq.c","nseq_main",105,176
635,193,3938,2,658,"ocsp_main@106-764@usr.bin/openssl/ocsp.c","usr.bin/openssl/ocsp.c","ocsp_main",106,764
22,7,127,5,22,"add_ocsp_cert@767-789@usr.bin/openssl/ocsp.c","usr.bin/openssl/ocsp.c","add_ocsp_cert",767,789
33,8,188,5,33,"add_ocsp_serial@792-825@usr.bin/openssl/ocsp.c","usr.bin/openssl/ocsp.c","add_ocsp_serial",792,825
45,11,305,7,58,"print_ocsp_summary@828-886@usr.bin/openssl/ocsp.c","usr.bin/openssl/ocsp.c","print_ocsp_summary",828,886
85,12,554,10,97,"make_ocsp_response@890-987@usr.bin/openssl/ocsp.c","usr.bin/openssl/ocsp.c","make_ocsp_response",890,987
19,3,123,2,19,"lookup_serial@990-1009@usr.bin/openssl/ocsp.c","usr.bin/openssl/ocsp.c","lookup_serial",990,1009
22,4,106,1,23,"init_responder@1014-1037@usr.bin/openssl/ocsp.c","usr.bin/openssl/ocsp.c","init_responder",1014,1037
35,9,203,4,44,"do_responder@1040-1084@usr.bin/openssl/ocsp.c","usr.bin/openssl/ocsp.c","do_responder",1040,1084
12,2,62,2,11,"send_ocsp_response@1087-1098@usr.bin/openssl/ocsp.c","usr.bin/openssl/ocsp.c","send_ocsp_response",1087,1098
74,23,469,6,80,"query_responder@1101-1181@usr.bin/openssl/ocsp.c","usr.bin/openssl/ocsp.c","query_responder",1101,1181
36,8,206,8,35,"process_responder@1184-1219@usr.bin/openssl/ocsp.c","usr.bin/openssl/ocsp.c","process_responder",1184,1219
41,12,212,4,47,"lock_dbg_cb@347-394@usr.bin/openssl/openssl.c","usr.bin/openssl/openssl.c","lock_dbg_cb",347,394
8,1,29,1,9,"openssl_startup@397-406@usr.bin/openssl/openssl.c","usr.bin/openssl/openssl.c","openssl_startup",397,406
10,1,36,1,9,"openssl_shutdown@409-418@usr.bin/openssl/openssl.c","usr.bin/openssl/openssl.c","openssl_shutdown",409,418
132,25,711,2,160,"main@421-581@usr.bin/openssl/openssl.c","usr.bin/openssl/openssl.c","main",421,581
112,38,817,3,120,"do_cmd@592-712@usr.bin/openssl/openssl.c","usr.bin/openssl/openssl.c","do_cmd",592,712
8,2,59,2,8,"SortFnByName@715-723@usr.bin/openssl/openssl.c","usr.bin/openssl/openssl.c","SortFnByName",715,723
27,5,165,1,28,"list_pkey@726-754@usr.bin/openssl/openssl.c","usr.bin/openssl/openssl.c","list_pkey",726,754
13,4,71,4,12,"list_cipher_fn@757-769@usr.bin/openssl/openssl.c","usr.bin/openssl/openssl.c","list_cipher_fn",757,769
4,1,15,1,3,"list_cipher@772-775@usr.bin/openssl/openssl.c","usr.bin/openssl/openssl.c","list_cipher",772,775
12,4,71,4,11,"list_md_fn@778-789@usr.bin/openssl/openssl.c","usr.bin/openssl/openssl.c","list_md_fn",778,789
4,1,15,1,3,"list_md@792-795@usr.bin/openssl/openssl.c","usr.bin/openssl/openssl.c","list_md",792,795
4,1,28,2,3,"function_cmp@798-801@usr.bin/openssl/openssl.c","usr.bin/openssl/openssl.c","function_cmp",798,801
4,1,16,1,3,"function_hash@806-809@usr.bin/openssl/openssl.c","usr.bin/openssl/openssl.c","function_hash",806,809
14,4,103,1,17,"prog_init@814-831@usr.bin/openssl/openssl.c","usr.bin/openssl/openssl.c","prog_init",814,831
7,1,20,1,6,"passwd_usage@127-133@usr.bin/openssl/passwd.c","usr.bin/openssl/passwd.c","passwd_usage",127,133
122,41,779,2,150,"passwd_main@136-286@usr.bin/openssl/passwd.c","usr.bin/openssl/passwd.c","passwd_main",136,286
84,13,800,3,99,"md5crypt@301-400@usr.bin/openssl/passwd.c","usr.bin/openssl/passwd.c","md5crypt",301,400
54,20,414,12,77,"do_passwd@405-482@usr.bin/openssl/passwd.c","usr.bin/openssl/passwd.c","do_passwd",405,482
5,1,22,2,4,"passwd_main@486-490@usr.bin/openssl/passwd.c","usr.bin/openssl/passwd.c","passwd_main",486,490
443,130,2861,2,502,"pkcs12_main@96-598@usr.bin/openssl/pkcs12.c","usr.bin/openssl/pkcs12.c","pkcs12_main",96,598
42,10,257,6,44,"dump_certs_keys_p12@601-645@usr.bin/openssl/pkcs12.c","usr.bin/openssl/pkcs12.c","dump_certs_keys_p12",601,645
13,3,79,6,12,"dump_certs_pkeys_bags@648-660@usr.bin/openssl/pkcs12.c","usr.bin/openssl/pkcs12.c","dump_certs_pkeys_bags",648,660
73,20,475,6,77,"dump_certs_pkeys_bag@663-740@usr.bin/openssl/pkcs12.c","usr.bin/openssl/pkcs12.c","dump_certs_pkeys_bag",663,740
19,3,109,3,29,"get_cert_chain@747-776@usr.bin/openssl/pkcs12.c","usr.bin/openssl/pkcs12.c","get_cert_chain",747,776
14,2,94,2,13,"alg_print@779-792@usr.bin/openssl/pkcs12.c","usr.bin/openssl/pkcs12.c","alg_print",779,792
13,3,67,2,12,"cert_load@797-809@usr.bin/openssl/pkcs12.c","usr.bin/openssl/pkcs12.c","cert_load",797,809
52,9,333,3,55,"print_attribs@814-869@usr.bin/openssl/pkcs12.c","usr.bin/openssl/pkcs12.c","print_attribs",814,869
6,2,44,3,5,"hex_prin@872-877@usr.bin/openssl/pkcs12.c","usr.bin/openssl/pkcs12.c","hex_prin",872,877
15,4,78,3,14,"set_pbe@880-894@usr.bin/openssl/pkcs12.c","usr.bin/openssl/pkcs12.c","set_pbe",880,894
7,1,19,0,6,"pkcs7_usage@141-147@usr.bin/openssl/pkcs7.c","usr.bin/openssl/pkcs7.c","pkcs7_usage",141,147
123,31,716,2,139,"pkcs7_main@150-289@usr.bin/openssl/pkcs7.c","usr.bin/openssl/pkcs7.c","pkcs7_main",150,289
8,2,44,1,8,"pkcs8_opt_v1@86-94@usr.bin/openssl/pkcs8.c","usr.bin/openssl/pkcs8.c","pkcs8_opt_v1",86,94
8,2,44,1,8,"pkcs8_opt_v2@97-105@usr.bin/openssl/pkcs8.c","usr.bin/openssl/pkcs8.c","pkcs8_opt_v2",97,105
9,1,21,0,8,"pkcs8_usage@209-217@usr.bin/openssl/pkcs8.c","usr.bin/openssl/pkcs8.c","pkcs8_usage",209,217
184,38,995,2,199,"pkcs8_main@220-419@usr.bin/openssl/pkcs8.c","usr.bin/openssl/pkcs8.c","pkcs8_main",220,419
142,37,866,2,151,"pkey_main@69-220@usr.bin/openssl/pkey.c","usr.bin/openssl/pkey.c","pkey_main",69,220
7,1,18,0,6,"pkeyparam_usage@106-112@usr.bin/openssl/pkeyparam.c","usr.bin/openssl/pkeyparam.c","pkeyparam_usage",106,112
50,11,292,2,59,"pkeyparam_main@115-174@usr.bin/openssl/pkeyparam.c","usr.bin/openssl/pkeyparam.c","pkeyparam_main",115,174
226,65,1398,2,237,"pkeyutl_main@85-322@usr.bin/openssl/pkeyutl.c","usr.bin/openssl/pkeyutl.c","pkeyutl_main",85,322
20,1,124,0,20,"usage@325-345@usr.bin/openssl/pkeyutl.c","usr.bin/openssl/pkeyutl.c","usage",325,345
72,19,353,6,90,"init_ctx@348-438@usr.bin/openssl/pkeyutl.c","usr.bin/openssl/pkeyutl.c","init_ctx",348,438
21,4,115,4,22,"setup_peer@441-463@usr.bin/openssl/pkeyutl.c","usr.bin/openssl/pkeyutl.c","setup_peer",441,463
24,6,138,6,28,"do_keyop@466-494@usr.bin/openssl/pkeyutl.c","usr.bin/openssl/pkeyutl.c","do_keyop",466,494
7,1,18,0,6,"prime_usage@104-110@usr.bin/openssl/prime.c","usr.bin/openssl/prime.c","prime_usage",104,110
75,17,428,2,86,"prime_main@113-199@usr.bin/openssl/prime.c","usr.bin/openssl/prime.c","prime_main",113,199
6,1,17,0,5,"rand_usage@95-100@usr.bin/openssl/rand.c","usr.bin/openssl/rand.c","rand_usage",95,100
70,21,420,2,82,"rand_main@103-185@usr.bin/openssl/rand.c","usr.bin/openssl/rand.c","rand_main",103,185
687,225,4338,2,739,"req_main@148-887@usr.bin/openssl/req.c","usr.bin/openssl/req.c","req_main",148,887
52,13,324,6,58,"make_REQ@890-948@usr.bin/openssl/req.c","usr.bin/openssl/req.c","make_REQ",890,948
12,3,70,4,13,"build_subject@955-968@usr.bin/openssl/req.c","usr.bin/openssl/req.c","build_subject",955,968
173,51,1113,7,182,"prompt_info@972-1154@usr.bin/openssl/req.c","usr.bin/openssl/req.c","prompt_info",972,1154
44,13,292,5,51,"auto_info@1157-1208@usr.bin/openssl/req.c","usr.bin/openssl/req.c","auto_info",1157,1208
47,14,353,9,48,"add_DN_object@1212-1260@usr.bin/openssl/req.c","usr.bin/openssl/req.c","add_DN_object",1212,1260
51,14,357,8,54,"add_attribute_object@1263-1317@usr.bin/openssl/req.c","usr.bin/openssl/req.c","add_attribute_object",1263,1317
12,5,78,3,11,"req_check_len@1320-1331@usr.bin/openssl/req.c","usr.bin/openssl/req.c","req_check_len",1320,1331
11,2,63,2,10,"check_end@1335-1345@usr.bin/openssl/req.c","usr.bin/openssl/req.c","check_end",1335,1345
119,27,693,5,127,"set_keygen_ctx@1348-1475@usr.bin/openssl/req.c","usr.bin/openssl/req.c","set_keygen_ctx",1348,1475
18,5,95,1,17,"genpkey_cb@1478-1495@usr.bin/openssl/req.c","usr.bin/openssl/req.c","genpkey_cb",1478,1495
18,4,124,5,17,"do_sign_init@1498-1515@usr.bin/openssl/req.c","usr.bin/openssl/req.c","do_sign_init",1498,1515
12,3,87,5,11,"do_X509_sign@1518-1529@usr.bin/openssl/req.c","usr.bin/openssl/req.c","do_X509_sign",1518,1529
12,3,87,5,11,"do_X509_REQ_sign@1533-1544@usr.bin/openssl/req.c","usr.bin/openssl/req.c","do_X509_REQ_sign",1533,1544
12,3,87,5,11,"do_X509_CRL_sign@1549-1560@usr.bin/openssl/req.c","usr.bin/openssl/req.c","do_X509_CRL_sign",1549,1560
12,3,78,3,14,"rsa_opt_cipher@96-110@usr.bin/openssl/rsa.c","usr.bin/openssl/rsa.c","rsa_opt_cipher",96,110
5,2,39,2,5,"show_ciphers@238-243@usr.bin/openssl/rsa.c","usr.bin/openssl/rsa.c","show_ciphers",238,243
14,1,51,0,14,"rsa_usage@246-260@usr.bin/openssl/rsa.c","usr.bin/openssl/rsa.c","rsa_usage",246,260
166,49,1005,2,186,"rsa_main@263-449@usr.bin/openssl/rsa.c","usr.bin/openssl/rsa.c","rsa_main",263,449
203,54,1243,2,227,"rsautl_main@82-309@usr.bin/openssl/rsautl.c","usr.bin/openssl/rsautl.c","rsautl_main",82,309
19,1,117,0,18,"usage@312-330@usr.bin/openssl/rsautl.c","usr.bin/openssl/rsautl.c","usage",312,330
61,16,318,2,63,"verify_callback@137-200@usr.bin/openssl/s_cb.c","usr.bin/openssl/s_cb.c","verify_callback",137,200
27,6,129,3,56,"set_cert_stuff@203-259@usr.bin/openssl/s_cb.c","usr.bin/openssl/s_cb.c","set_cert_stuff",203,259
21,5,104,3,24,"set_cert_key_stuff@262-286@usr.bin/openssl/s_cb.c","usr.bin/openssl/s_cb.c","set_cert_key_stuff",262,286
28,5,166,2,34,"ssl_print_tmp_key@289-323@usr.bin/openssl/s_cb.c","usr.bin/openssl/s_cb.c","ssl_print_tmp_key",289,323
21,4,160,6,22,"bio_dump_callback@326-348@usr.bin/openssl/s_cb.c","usr.bin/openssl/s_cb.c","bio_dump_callback",326,348
28,9,169,3,30,"apps_ssl_info_callback@351-381@usr.bin/openssl/s_cb.c","usr.bin/openssl/s_cb.c","apps_ssl_info_callback",351,381
257,83,997,7,268,"msg_cb@385-653@usr.bin/openssl/s_cb.c","usr.bin/openssl/s_cb.c","msg_cb",385,653
69,20,252,6,89,"tlsext_cb@656-745@usr.bin/openssl/s_cb.c","usr.bin/openssl/s_cb.c","tlsext_cb",656,745
56,7,346,3,65,"generate_cookie_callback@748-813@usr.bin/openssl/s_cb.c","usr.bin/openssl/s_cb.c","generate_cookie_callback",748,813
54,9,341,3,64,"verify_cookie_callback@816-880@usr.bin/openssl/s_cb.c","usr.bin/openssl/s_cb.c","verify_cookie_callback",816,880
58,1,395,1,60,"sc_usage@193-253@usr.bin/openssl/s_client.c","usr.bin/openssl/s_client.c","sc_usage",193,253
10,3,73,3,10,"ssl_servername_cb@264-274@usr.bin/openssl/s_client.c","usr.bin/openssl/s_client.c","ssl_servername_cb",264,274
849,264,5435,2,942,"s_client_main@291-1233@usr.bin/openssl/s_client.c","usr.bin/openssl/s_client.c","s_client_main",291,1233
147,26,959,3,175,"print_stuff@1237-1412@usr.bin/openssl/s_client.c","usr.bin/openssl/s_client.c","print_stuff",1237,1412
23,3,134,2,22,"ocsp_resp_cb@1416-1438@usr.bin/openssl/s_client.c","usr.bin/openssl/s_client.c","ocsp_resp_cb",1416,1438
21,1,79,1,21,"s_server_init@240-261@usr.bin/openssl/s_server.c","usr.bin/openssl/s_server.c","s_server_init",240,261
75,1,495,1,78,"sv_usage@264-342@usr.bin/openssl/s_server.c","usr.bin/openssl/s_server.c","sv_usage",264,342
18,7,114,3,19,"ssl_servername_cb@357-376@usr.bin/openssl/s_server.c","usr.bin/openssl/s_server.c","ssl_servername_cb",357,376
103,21,599,2,106,"cert_status_cb@403-509@usr.bin/openssl/s_server.c","usr.bin/openssl/s_server.c","cert_status_cb",403,509
26,6,190,6,31,"alpn_cb@518-549@usr.bin/openssl/s_server.c","usr.bin/openssl/s_server.c","alpn_cb",518,549
614,205,3983,2,676,"s_server_main@556-1232@usr.bin/openssl/s_server.c","usr.bin/openssl/s_server.c","s_server_main",556,1232
24,1,161,2,23,"print_stats@1235-1258@usr.bin/openssl/s_server.c","usr.bin/openssl/s_server.c","print_stats",1235,1258
265,75,1550,3,302,"sv_body@1261-1563@usr.bin/openssl/s_server.c","usr.bin/openssl/s_server.c","sv_body",1261,1563
8,2,33,1,7,"close_accept_socket@1566-1573@usr.bin/openssl/s_server.c","usr.bin/openssl/s_server.c","close_accept_socket",1566,1573
74,14,443,1,79,"init_ssl_connection@1576-1655@usr.bin/openssl/s_server.c","usr.bin/openssl/s_server.c","init_ssl_connection",1576,1655
11,2,62,1,11,"load_dh_param@1659-1670@usr.bin/openssl/s_server.c","usr.bin/openssl/s_server.c","load_dh_param",1659,1670
252,75,1627,3,292,"www_body@1674-1966@usr.bin/openssl/s_server.c","usr.bin/openssl/s_server.c","www_body",1674,1966
16,5,93,3,22,"generate_session_id@1970-1992@usr.bin/openssl/s_server.c","usr.bin/openssl/s_server.c","generate_session_id",1970,1992
47,11,318,5,49,"init_client@81-130@usr.bin/openssl/s_socket.c","usr.bin/openssl/s_socket.c","init_client",81,130
35,8,204,5,37,"do_server@133-170@usr.bin/openssl/s_socket.c","usr.bin/openssl/s_socket.c","do_server",133,170
41,11,275,4,46,"init_server_long@173-219@usr.bin/openssl/s_socket.c","usr.bin/openssl/s_socket.c","init_server_long",173,219
4,1,28,3,3,"init_server@222-225@usr.bin/openssl/s_socket.c","usr.bin/openssl/s_socket.c","init_server",222,225
47,8,281,3,63,"do_accept@228-291@usr.bin/openssl/s_socket.c","usr.bin/openssl/s_socket.c","do_accept",228,291
20,7,122,4,23,"extract_host_port@294-317@usr.bin/openssl/s_socket.c","usr.bin/openssl/s_socket.c","extract_host_port",294,317
18,3,108,2,18,"extract_port@320-338@usr.bin/openssl/s_socket.c","usr.bin/openssl/s_socket.c","extract_port",320,338
10,1,22,1,9,"s_time_usage@218-227@usr.bin/openssl/s_time.c","usr.bin/openssl/s_time.c","s_time_usage",218,227
4,1,15,1,3,"tm_Time_F@236-239@usr.bin/openssl/s_time.c","usr.bin/openssl/s_time.c","tm_Time_F",236,239
201,45,1229,2,246,"s_time_main@246-492@usr.bin/openssl/s_time.c","usr.bin/openssl/s_time.c","s_time_main",246,492
43,8,224,1,50,"doConnection@502-552@usr.bin/openssl/s_time.c","usr.bin/openssl/s_time.c","doConnection",502,552
8,1,20,1,7,"sess_id_usage@142-149@usr.bin/openssl/sess_id.c","usr.bin/openssl/sess_id.c","sess_id_usage",142,149
93,25,515,2,103,"sess_id_main@154-257@usr.bin/openssl/sess_id.c","usr.bin/openssl/sess_id.c","sess_id_main",154,257
35,7,170,2,35,"load_sess_id@260-295@usr.bin/openssl/sess_id.c","usr.bin/openssl/sess_id.c","load_sess_id",260,295
516,171,3342,2,560,"smime_main@86-646@usr.bin/openssl/smime.c","usr.bin/openssl/smime.c","smime_main",86,646
14,4,83,2,13,"save_certs@649-662@usr.bin/openssl/smime.c","usr.bin/openssl/smime.c","save_certs",649,662
10,4,56,2,14,"smime_cb@668-682@usr.bin/openssl/smime.c","usr.bin/openssl/smime.c","smime_cb",668,682
5,1,18,1,4,"sig_done@192-196@usr.bin/openssl/speed.c","usr.bin/openssl/speed.c","sig_done",192,196
4,1,15,1,3,"Time_F@203-206@usr.bin/openssl/speed.c","usr.bin/openssl/speed.c","Time_F",203,206
9,2,49,4,11,"KDF1_SHA1@211-222@usr.bin/openssl/speed.c","usr.bin/openssl/speed.c","KDF1_SHA1",211,222
1333,325,10887,2,1695,"speed_main@225-1920@usr.bin/openssl/speed.c","usr.bin/openssl/speed.c","speed_main",225,1920
7,2,45,3,6,"print_message@1923-1929@usr.bin/openssl/speed.c","usr.bin/openssl/speed.c","print_message",1923,1929
8,2,55,5,7,"pkey_print_message@1932-1939@usr.bin/openssl/speed.c","usr.bin/openssl/speed.c","pkey_print_message",1932,1939
6,2,58,4,5,"print_result@1942-1947@usr.bin/openssl/speed.c","usr.bin/openssl/speed.c","print_result",1942,1947
21,5,121,2,25,"sstrsep@1950-1975@usr.bin/openssl/speed.c","usr.bin/openssl/speed.c","sstrsep",1950,1975
154,27,1222,1,176,"do_multi@1978-2154@usr.bin/openssl/speed.c","usr.bin/openssl/speed.c","do_multi",1978,2154
10,1,22,1,9,"spkac_usage@162-171@usr.bin/openssl/spkac.c","usr.bin/openssl/spkac.c","spkac_usage",162,171
125,23,710,2,139,"spkac_main@174-313@usr.bin/openssl/spkac.c","usr.bin/openssl/spkac.c","spkac_main",174,313
15,7,158,0,15,"get_dsa512@41-56@usr.bin/openssl/testdsa.h","usr.bin/openssl/testdsa.h","get_dsa512",41,56
15,7,158,0,15,"get_dsa1024@107-122@usr.bin/openssl/testdsa.h","usr.bin/openssl/testdsa.h","get_dsa1024",107,122
15,7,158,0,15,"get_dsa2048@206-221@usr.bin/openssl/testdsa.h","usr.bin/openssl/testdsa.h","get_dsa2048",206,221
189,70,1211,2,212,"ts_main@120-332@usr.bin/openssl/ts.c","usr.bin/openssl/ts.c","ts_main",120,332
7,2,41,1,8,"txt2obj@339-347@usr.bin/openssl/ts.c","usr.bin/openssl/ts.c","txt2obj",339,347
36,9,190,1,38,"load_config_file@350-388@usr.bin/openssl/ts.c","usr.bin/openssl/ts.c","load_config_file",350,388
40,9,246,9,53,"query_command@395-448@usr.bin/openssl/ts.c","usr.bin/openssl/ts.c","query_command",395,448
5,2,37,3,4,"BIO_open_with_default@451-455@usr.bin/openssl/ts.c","usr.bin/openssl/ts.c","BIO_open_with_default",451,455
58,20,389,6,79,"create_query@458-537@usr.bin/openssl/ts.c","usr.bin/openssl/ts.c","create_query",458,537
34,7,190,4,39,"create_digest@540-579@usr.bin/openssl/ts.c","usr.bin/openssl/ts.c","create_digest",540,579
24,6,163,1,30,"create_nonce@582-612@usr.bin/openssl/ts.c","usr.bin/openssl/ts.c","create_nonce",582,612
62,14,359,13,77,"reply_command@618-695@usr.bin/openssl/ts.c","usr.bin/openssl/ts.c","reply_command",618,695
33,8,184,1,41,"read_PKCS7@699-740@usr.bin/openssl/ts.c","usr.bin/openssl/ts.c","read_PKCS7",699,740
50,18,353,8,82,"create_response@743-825@usr.bin/openssl/ts.c","usr.bin/openssl/ts.c","create_response",743,825
14,2,68,2,15,"serial_cb@828-843@usr.bin/openssl/ts.c","usr.bin/openssl/ts.c","serial_cb",828,843
40,9,220,1,41,"next_serial@846-887@usr.bin/openssl/ts.c","usr.bin/openssl/ts.c","next_serial",846,887
18,5,97,2,18,"save_ts_serial@890-908@usr.bin/openssl/ts.c","usr.bin/openssl/ts.c","save_ts_serial",890,908
37,8,219,8,45,"verify_command@915-960@usr.bin/openssl/ts.c","usr.bin/openssl/ts.c","verify_command",915,960
49,15,314,6,60,"create_verify_ctx@963-1023@usr.bin/openssl/ts.c","usr.bin/openssl/ts.c","create_verify_ctx",963,1023
38,7,183,2,44,"create_cert_store@1026-1070@usr.bin/openssl/ts.c","usr.bin/openssl/ts.c","create_cert_store",1026,1070
4,1,14,2,17,"verify_cb@1073-1090@usr.bin/openssl/ts.c","usr.bin/openssl/ts.c","verify_cb",1073,1090
141,43,875,2,151,"verify_main@77-228@usr.bin/openssl/verify.c","usr.bin/openssl/verify.c","verify_main",77,228
37,9,227,5,41,"check@231-272@usr.bin/openssl/verify.c","usr.bin/openssl/verify.c","check",231,272
38,17,167,2,49,"cb@275-324@usr.bin/openssl/verify.c","usr.bin/openssl/verify.c","cb",275,324
10,1,47,1,10,"version_all_opts@148-158@usr.bin/openssl/version.c","usr.bin/openssl/version.c","version_all_opts",148,158
5,1,18,1,4,"version_usage@207-211@usr.bin/openssl/version.c","usr.bin/openssl/version.c","version_usage",207,211
43,12,269,2,55,"version_main@214-269@usr.bin/openssl/version.c","usr.bin/openssl/version.c","version_main",214,269
721,217,4934,2,770,"x509_main@158-928@usr.bin/openssl/x509.c","usr.bin/openssl/x509.c","x509_main",158,928
37,9,236,3,41,"x509_load_serial@931-972@usr.bin/openssl/x509.c","usr.bin/openssl/x509.c","x509_load_serial",931,972
59,18,408,14,72,"x509_certify@975-1047@usr.bin/openssl/x509.c","usr.bin/openssl/x509.c","x509_certify",975,1047
19,3,96,2,30,"callb@1050-1080@usr.bin/openssl/x509.c","usr.bin/openssl/x509.c","callb",1050,1080
36,10,241,7,45,"sign@1084-1129@usr.bin/openssl/x509.c","usr.bin/openssl/x509.c","sign",1084,1129
18,5,122,3,18,"purpose_print@1132-1150@usr.bin/openssl/x509.c","usr.bin/openssl/x509.c","purpose_print",1132,1150
69,18,490,2,89,"local_passwd@60-149@usr.bin/passwd/local_passwd.c","usr.bin/passwd/local_passwd.c","local_passwd",60,149
67,19,507,3,75,"getnewpasswd@152-227@usr.bin/passwd/local_passwd.c","usr.bin/passwd/local_passwd.c","getnewpasswd",152,227
5,1,21,1,4,"kbintr@230-234@usr.bin/passwd/local_passwd.c","usr.bin/passwd/local_passwd.c","kbintr",230,234
28,5,127,2,33,"main@42-75@usr.bin/passwd/passwd.c","usr.bin/passwd/passwd.c","main",42,75
5,1,19,1,4,"usage@78-82@usr.bin/passwd/passwd.c","usr.bin/passwd/passwd.c","usage",78,82
93,23,612,2,114,"pwd_check@87-201@usr.bin/passwd/pwd_check.c","usr.bin/passwd/pwd_check.c","pwd_check",87,201
11,4,65,1,18,"pwd_gettries@204-222@usr.bin/passwd/pwd_check.c","usr.bin/passwd/pwd_check.c","pwd_gettries",204,222
33,8,151,2,36,"main@54-90@usr.bin/paste/paste.c","usr.bin/paste/paste.c","main",54,90
65,23,478,1,71,"parallel@100-171@usr.bin/paste/paste.c","usr.bin/paste/paste.c","parallel",100,171
43,13,276,1,43,"sequential@174-217@usr.bin/paste/paste.c","usr.bin/paste/paste.c","sequential",174,217
27,7,123,1,28,"tr@220-248@usr.bin/paste/paste.c","usr.bin/paste/paste.c","tr",220,248
7,1,28,1,6,"usage@251-257@usr.bin/paste/paste.c","usr.bin/paste/paste.c","usage",251,257
20,6,119,1,20,"find_backup_file_name@54-74@usr.bin/patch/backupfile.c","usr.bin/patch/backupfile.c","find_backup_file_name",54,74
21,5,114,2,24,"max_backup_version@83-107@usr.bin/patch/backupfile.c","usr.bin/patch/backupfile.c","max_backup_version",83,107
7,2,39,2,7,"make_version_name@114-121@usr.bin/patch/backupfile.c","usr.bin/patch/backupfile.c","make_version_name",114,121
14,6,110,3,14,"version_number@129-143@usr.bin/patch/backupfile.c","usr.bin/patch/backupfile.c","version_number",129,143
7,2,41,2,7,"concat@150-157@usr.bin/patch/backupfile.c","usr.bin/patch/backupfile.c","concat",150,157
22,6,115,2,27,"argmatch@166-193@usr.bin/patch/backupfile.c","usr.bin/patch/backupfile.c","argmatch",166,193
9,2,57,3,8,"invalid_arg@201-209@usr.bin/patch/backupfile.c","usr.bin/patch/backupfile.c","invalid_arg",201,209
11,4,61,1,11,"get_version@225-236@usr.bin/patch/backupfile.c","usr.bin/patch/backupfile.c","get_version",225,236
75,17,363,1,86,"do_ed_script@70-156@usr.bin/patch/ed.c","usr.bin/patch/ed.c","do_ed_script",70,156
55,16,289,1,64,"get_command@159-223@usr.bin/patch/ed.c","usr.bin/patch/ed.c","get_command",159,223
36,12,248,1,40,"write_lines@226-266@usr.bin/patch/ed.c","usr.bin/patch/ed.c","write_lines",226,266
16,3,91,1,16,"init_lines@270-286@usr.bin/patch/ed.c","usr.bin/patch/ed.c","init_lines",270,286
9,2,42,1,9,"free_lines@289-298@usr.bin/patch/ed.c","usr.bin/patch/ed.c","free_lines",289,298
12,3,50,1,14,"get_line@301-315@usr.bin/patch/ed.c","usr.bin/patch/ed.c","get_line",301,315
11,2,57,1,12,"create_line@318-330@usr.bin/patch/ed.c","usr.bin/patch/ed.c","create_line",318,330
4,2,19,2,3,"valid_addr@333-336@usr.bin/patch/ed.c","usr.bin/patch/ed.c","valid_addr",333,336
21,3,106,1,20,"re_input@73-93@usr.bin/patch/inp.c","usr.bin/patch/inp.c","re_input",73,93
9,4,43,1,8,"scan_input@98-106@usr.bin/patch/inp.c","usr.bin/patch/inp.c","scan_input",98,106
18,2,89,1,18,"reallocate_lines@109-127@usr.bin/patch/inp.c","usr.bin/patch/inp.c","reallocate_lines",109,127
113,36,621,1,142,"plan_a@132-274@usr.bin/patch/inp.c","usr.bin/patch/inp.c","plan_a",132,274
87,30,582,1,91,"plan_b@279-370@usr.bin/patch/inp.c","usr.bin/patch/inp.c","plan_b",279,370
30,9,171,2,32,"ifetch@376-408@usr.bin/patch/inp.c","usr.bin/patch/inp.c","ifetch",376,408
18,8,118,1,18,"rev_in_string@414-432@usr.bin/patch/inp.c","usr.bin/patch/inp.c","rev_in_string",414,432
25,7,148,1,30,"mkpath@46-76@usr.bin/patch/mkpath.c","usr.bin/patch/mkpath.c","mkpath",46,76
220,81,1265,2,267,"main@143-410@usr.bin/patch/patch.c","usr.bin/patch/patch.c","main",143,410
21,2,86,1,27,"reinitialize_almost_everything@415-442@usr.bin/patch/patch.c","usr.bin/patch/patch.c","reinitialize_almost_everything",415,442
157,42,838,1,163,"get_some_switches@447-610@usr.bin/patch/patch.c","usr.bin/patch/patch.c","get_some_switches",447,610
10,1,22,1,9,"usage@613-622@usr.bin/patch/patch.c","usr.bin/patch/patch.c","usage",613,622
38,21,246,1,43,"locate_hunk@628-671@usr.bin/patch/patch.c","usr.bin/patch/patch.c","locate_hunk",628,671
45,15,281,1,49,"abort_context_hunk@676-725@usr.bin/patch/patch.c","usr.bin/patch/patch.c","abort_context_hunk",676,725
9,3,63,2,10,"rej_line@728-738@usr.bin/patch/patch.c","usr.bin/patch/patch.c","rej_line",728,738
62,24,386,1,62,"abort_hunk@741-803@usr.bin/patch/patch.c","usr.bin/patch/patch.c","abort_hunk",741,803
99,33,571,1,106,"apply_hunk@808-914@usr.bin/patch/patch.c","usr.bin/patch/patch.c","apply_hunk",808,914
6,2,31,1,5,"init_output@920-925@usr.bin/patch/patch.c","usr.bin/patch/patch.c","init_output",920,925
6,2,31,1,5,"init_reject@931-936@usr.bin/patch/patch.c","usr.bin/patch/patch.c","init_reject",931,936
11,5,54,2,10,"copy_till@944-954@usr.bin/patch/patch.c","usr.bin/patch/patch.c","copy_till",944,954
9,4,41,1,10,"spew_output@960-970@usr.bin/patch/patch.c","usr.bin/patch/patch.c","spew_output",960,970
11,4,61,2,12,"dump_line@976-988@usr.bin/patch/patch.c","usr.bin/patch/patch.c","dump_line",976,988
31,10,185,3,37,"patch_match@994-1031@usr.bin/patch/patch.c","usr.bin/patch/patch.c","patch_match",994,1031
19,12,140,3,19,"similar@1037-1056@usr.bin/patch/patch.c","usr.bin/patch/patch.c","similar",1037,1056
10,1,38,1,9,"re_patch@84-93@usr.bin/patch/pch.c","usr.bin/patch/pch.c","re_patch",84,93
21,8,144,1,21,"open_patch_file@99-120@usr.bin/patch/pch.c","usr.bin/patch/pch.c","open_patch_file",99,120
9,4,70,1,8,"set_hunkmax@126-134@usr.bin/patch/pch.c","usr.bin/patch/pch.c","set_hunkmax",126,134
29,11,172,1,37,"grow_hunkmax@140-177@usr.bin/patch/pch.c","usr.bin/patch/pch.c","grow_hunkmax",140,177
60,27,325,1,60,"there_is_another_patch@182-242@usr.bin/patch/pch.c","usr.bin/patch/pch.c","there_is_another_patch",182,242
156,59,1071,1,170,"intuit_diff_type@247-417@usr.bin/patch/pch.c","usr.bin/patch/pch.c","intuit_diff_type",247,417
5,1,18,2,4,"next_intuit_at@423-427@usr.bin/patch/pch.c","usr.bin/patch/pch.c","next_intuit_at",423,427
20,6,123,2,20,"skip_to@433-453@usr.bin/patch/pch.c","usr.bin/patch/pch.c","skip_to",433,453
4,1,15,1,4,"malformed@457-461@usr.bin/patch/pch.c","usr.bin/patch/pch.c","malformed",457,461
14,5,67,1,16,"remove_special_line@468-484@usr.bin/patch/pch.c","usr.bin/patch/pch.c","remove_special_line",468,484
630,205,3506,1,667,"another_hunk@490-1157@usr.bin/patch/pch.c","usr.bin/patch/pch.c","another_hunk",490,1157
18,10,130,3,18,"pgets@1163-1181@usr.bin/patch/pch.c","usr.bin/patch/pch.c","pgets",1163,1181
88,19,514,1,101,"pch_swap@1187-1288@usr.bin/patch/pch.c","usr.bin/patch/pch.c","pch_swap",1187,1288
4,1,9,1,3,"pch_first@1294-1297@usr.bin/patch/pch.c","usr.bin/patch/pch.c","pch_first",1294,1297
4,1,9,1,3,"pch_ptrn_lines@1303-1306@usr.bin/patch/pch.c","usr.bin/patch/pch.c","pch_ptrn_lines",1303,1306
4,1,9,1,3,"pch_newfirst@1312-1315@usr.bin/patch/pch.c","usr.bin/patch/pch.c","pch_newfirst",1312,1315
4,1,9,1,3,"pch_repl_lines@1321-1324@usr.bin/patch/pch.c","usr.bin/patch/pch.c","pch_repl_lines",1321,1324
4,1,9,1,3,"pch_end@1330-1333@usr.bin/patch/pch.c","usr.bin/patch/pch.c","pch_end",1330,1333
4,1,9,1,3,"pch_context@1339-1342@usr.bin/patch/pch.c","usr.bin/patch/pch.c","pch_context",1339,1342
4,1,13,1,3,"pch_line_len@1348-1351@usr.bin/patch/pch.c","usr.bin/patch/pch.c","pch_line_len",1348,1351
4,1,13,1,3,"pch_char@1357-1360@usr.bin/patch/pch.c","usr.bin/patch/pch.c","pch_char",1357,1360
4,1,13,1,3,"pfetch@1366-1369@usr.bin/patch/pch.c","usr.bin/patch/pch.c","pfetch",1366,1369
4,1,9,1,3,"pch_hunk_beg@1375-1378@usr.bin/patch/pch.c","usr.bin/patch/pch.c","pch_hunk_beg",1375,1378
17,10,115,2,27,"posix_name@1386-1413@usr.bin/patch/pch.c","usr.bin/patch/pch.c","posix_name",1386,1413
30,10,179,2,37,"compare_names@1416-1453@usr.bin/patch/pch.c","usr.bin/patch/pch.c","compare_names",1416,1453
8,4,53,2,11,"best_name@1460-1471@usr.bin/patch/pch.c","usr.bin/patch/pch.c","best_name",1460,1471
10,3,61,1,10,"num_components@1474-1484@usr.bin/patch/pch.c","usr.bin/patch/pch.c","num_components",1474,1484
20,4,111,2,25,"strtolinenum@1492-1517@usr.bin/patch/pch.c","usr.bin/patch/pch.c","strtolinenum",1492,1517
32,13,205,2,38,"move_file@51-89@usr.bin/patch/util.c","usr.bin/patch/util.c","move_file",51,89
43,20,326,1,54,"backup_file@94-148@usr.bin/patch/util.c","usr.bin/patch/util.c","backup_file",94,148
17,5,122,2,17,"copy_file@154-171@usr.bin/patch/util.c","usr.bin/patch/util.c","copy_file",154,171
14,4,54,1,14,"savestr@177-191@usr.bin/patch/util.c","usr.bin/patch/util.c","savestr",177,191
10,3,43,1,10,"xstrdup@197-207@usr.bin/patch/util.c","usr.bin/patch/util.c","xstrdup",197,207
8,1,40,2,8,"say@213-221@usr.bin/patch/util.c","usr.bin/patch/util.c","say",213,221
9,1,47,2,9,"fatal@227-236@usr.bin/patch/util.c","usr.bin/patch/util.c","fatal",227,236
11,1,64,2,11,"pfatal@242-253@usr.bin/patch/util.c","usr.bin/patch/util.c","pfatal",242,253
21,7,135,2,22,"ask@259-281@usr.bin/patch/util.c","usr.bin/patch/util.c","ask",259,281
14,4,78,1,14,"set_signals@287-301@usr.bin/patch/util.c","usr.bin/patch/util.c","set_signals",287,301
5,1,20,1,4,"ignore_signals@307-311@usr.bin/patch/util.c","usr.bin/patch/util.c","ignore_signals",307,311
17,5,92,2,18,"makedirs@319-337@usr.bin/patch/util.c","usr.bin/patch/util.c","makedirs",319,337
34,20,285,3,46,"fetchname@343-389@usr.bin/patch/util.c","usr.bin/patch/util.c","fetchname",343,389
5,1,18,1,4,"version@392-396@usr.bin/patch/util.c","usr.bin/patch/util.c","version",392,396
10,3,42,1,9,"my_exit@402-411@usr.bin/patch/util.c","usr.bin/patch/util.c","my_exit",402,411
86,35,416,2,91,"main@64-155@usr.bin/pctr/pctr.c","usr.bin/pctr/pctr.c","main",64,155
62,20,460,1,72,"pctr_cpu_creds@158-230@usr.bin/pctr/pctr.c","usr.bin/pctr/pctr.c","pctr_cpu_creds",158,230
8,3,55,2,8,"pctr_ctrfn_index@233-241@usr.bin/pctr/pctr.c","usr.bin/pctr/pctr.c","pctr_ctrfn_index",233,241
67,30,497,1,67,"pctr_fn2str@244-311@usr.bin/pctr/pctr.c","usr.bin/pctr/pctr.c","pctr_fn2str",244,311
19,8,98,1,19,"pctr_printvals@314-333@usr.bin/pctr/pctr.c","usr.bin/pctr/pctr.c","pctr_printvals",314,333
14,3,77,1,14,"pctr_read@336-350@usr.bin/pctr/pctr.c","usr.bin/pctr/pctr.c","pctr_read",336,350
14,3,81,2,14,"pctr_write@353-367@usr.bin/pctr/pctr.c","usr.bin/pctr/pctr.c","pctr_write",353,367
21,7,101,1,21,"pctr_printdesc@370-391@usr.bin/pctr/pctr.c","usr.bin/pctr/pctr.c","pctr_printdesc",370,391
30,12,169,1,31,"pctr_list_fnct@394-425@usr.bin/pctr/pctr.c","usr.bin/pctr/pctr.c","pctr_list_fnct",394,425
73,43,418,1,74,"pctr_set_cntr@428-502@usr.bin/pctr/pctr.c","usr.bin/pctr/pctr.c","pctr_set_cntr",428,502
21,5,71,1,22,"usage@505-527@usr.bin/pctr/pctr.c","usr.bin/pctr/pctr.c","usage",505,527
22,7,153,1,24,"getargv@114-138@usr.bin/pkill/pkill.c","usr.bin/pkill/pkill.c","getargv",114,138
273,107,1688,2,320,"main@141-461@usr.bin/pkill/pkill.c","usr.bin/pkill/pkill.c","main",141,461
12,2,41,1,14,"usage@464-478@usr.bin/pkill/pkill.c","usr.bin/pkill/pkill.c","usage",464,478
10,4,71,1,11,"askyn@481-492@usr.bin/pkill/pkill.c","usr.bin/pkill/pkill.c","askyn",481,492
18,7,109,2,19,"killact@495-514@usr.bin/pkill/pkill.c","usr.bin/pkill/pkill.c","killact",495,514
23,12,164,2,24,"grepact@517-541@usr.bin/pkill/pkill.c","usr.bin/pkill/pkill.c","grepact",517,541
82,26,488,3,91,"makelist@544-635@usr.bin/pkill/pkill.c","usr.bin/pkill/pkill.c","makelist",544,635
102,37,620,3,142,"egetopt@64-206@usr.bin/pr/egetopt.c","usr.bin/pr/egetopt.c","egetopt",64,206
26,9,155,2,30,"main@138-168@usr.bin/pr/pr.c","usr.bin/pr/pr.c","main",138,168
102,27,562,2,162,"onecol@175-337@usr.bin/pr/pr.c","usr.bin/pr/pr.c","onecol",175,337
192,54,1172,2,324,"vertcol@344-668@usr.bin/pr/pr.c","usr.bin/pr/pr.c","vertcol",344,668
97,28,556,2,154,"horzcol@674-828@usr.bin/pr/pr.c","usr.bin/pr/pr.c","horzcol",674,828
8,3,50,1,8,"flsh_errs@841-849@usr.bin/pr/pr.c","usr.bin/pr/pr.c","flsh_errs",841,849
32,6,197,2,34,"ferrout@853-887@usr.bin/pr/pr.c","usr.bin/pr/pr.c","ferrout",853,887
144,38,857,2,232,"mulfile@894-1126@usr.bin/pr/pr.c","usr.bin/pr/pr.c","mulfile",894,1126
65,23,405,7,100,"inln@1142-1242@usr.bin/pr/pr.c","usr.bin/pr/pr.c","inln",1142,1242
93,27,471,5,145,"otln@1256-1401@usr.bin/pr/pr.c","usr.bin/pr/pr.c","otln",1256,1401
18,7,97,3,18,"inskip@1413-1431@usr.bin/pr/pr.c","usr.bin/pr/pr.c","inskip",1413,1431
100,26,554,5,114,"nxtfile@1442-1556@usr.bin/pr/pr.c","usr.bin/pr/pr.c","nxtfile",1442,1556
10,4,63,3,14,"addnum@1574-1588@usr.bin/pr/pr.c","usr.bin/pr/pr.c","addnum",1574,1588
18,9,129,3,33,"prhead@1606-1639@usr.bin/pr/pr.c","usr.bin/pr/pr.c","prhead",1606,1639
51,19,223,2,83,"prtail@1652-1735@usr.bin/pr/pr.c","usr.bin/pr/pr.c","prtail",1652,1735
5,1,16,1,4,"terminate@1742-1746@usr.bin/pr/pr.c","usr.bin/pr/pr.c","terminate",1742,1746
4,1,11,1,3,"mfail@1749-1752@usr.bin/pr/pr.c","usr.bin/pr/pr.c","mfail",1749,1752
4,1,16,1,3,"pfail@1755-1758@usr.bin/pr/pr.c","usr.bin/pr/pr.c","pfail",1755,1758
9,1,21,1,8,"usage@1761-1769@usr.bin/pr/pr.c","usr.bin/pr/pr.c","usage",1761,1769
216,74,1140,2,233,"setup@1776-2009@usr.bin/pr/pr.c","usr.bin/pr/pr.c","setup",1776,2009
23,9,157,2,24,"main@45-69@usr.bin/printenv/printenv.c","usr.bin/printenv/printenv.c","main",45,69
126,38,606,2,153,"main@74-227@usr.bin/printf/printf.c","usr.bin/printf/printf.c","main",74,227
28,7,132,1,34,"print_escape_str@235-269@usr.bin/printf/printf.c","usr.bin/printf/printf.c","print_escape_str",235,269
72,27,327,1,93,"print_escape@275-368@usr.bin/printf/printf.c","usr.bin/printf/printf.c","print_escape",275,368
24,3,136,2,25,"mklong@371-396@usr.bin/printf/printf.c","usr.bin/printf/printf.c","mklong",371,396
6,2,30,1,5,"getchr@399-404@usr.bin/printf/printf.c","usr.bin/printf/printf.c","getchr",399,404
6,2,24,1,5,"getstr@407-412@usr.bin/printf/printf.c","usr.bin/printf/printf.c","getstr",407,412
8,3,40,1,9,"getint@416-425@usr.bin/printf/printf.c","usr.bin/printf/printf.c","getint",416,425
13,4,81,1,15,"getlong@428-443@usr.bin/printf/printf.c","usr.bin/printf/printf.c","getlong",428,443
13,4,82,1,15,"getulong@446-461@usr.bin/printf/printf.c","usr.bin/printf/printf.c","getulong",446,461
13,4,81,1,15,"getdouble@464-479@usr.bin/printf/printf.c","usr.bin/printf/printf.c","getdouble",464,479
13,4,68,2,12,"check_conversion@482-494@usr.bin/printf/printf.c","usr.bin/printf/printf.c","check_conversion",482,494
5,1,21,1,4,"usage@497-501@usr.bin/printf/printf.c","usr.bin/printf/printf.c","usage",497,501
67,22,343,2,69,"main@96-165@usr.bin/quota/quota.c","usr.bin/quota/quota.c","main",96,165
8,1,24,1,7,"usage@168-175@usr.bin/quota/quota.c","usr.bin/quota/quota.c","usage",168,175
16,4,80,1,16,"showuid@181-197@usr.bin/quota/quota.c","usr.bin/quota/quota.c","showuid",181,197
16,4,87,1,16,"showusrname@203-219@usr.bin/quota/quota.c","usr.bin/quota/quota.c","showusrname",203,219
28,8,149,1,28,"showgid@225-253@usr.bin/quota/quota.c","usr.bin/quota/quota.c","showgid",225,253
28,8,158,1,28,"showgrpname@259-287@usr.bin/quota/quota.c","usr.bin/quota/quota.c","showgrpname",259,287
84,35,561,3,84,"showquotas@290-374@usr.bin/quota/quota.c","usr.bin/quota/quota.c","showquotas",290,374
17,3,79,4,17,"heading@377-394@usr.bin/quota/quota.c","usr.bin/quota/quota.c","heading",377,394
25,5,176,1,25,"timeprt@400-425@usr.bin/quota/quota.c","usr.bin/quota/quota.c","timeprt",400,425
43,13,335,2,52,"getprivs@431-483@usr.bin/quota/quota.c","usr.bin/quota/quota.c","getprivs",431,483
34,10,260,3,34,"ufshasquota@489-523@usr.bin/quota/quota.c","usr.bin/quota/quota.c","ufshasquota",489,523
29,6,221,5,34,"getufsquota@526-560@usr.bin/quota/quota.c","usr.bin/quota/quota.c","getufsquota",526,560
66,9,400,5,80,"getnfsquota@563-643@usr.bin/quota/quota.c","usr.bin/quota/quota.c","getnfsquota",563,643
27,3,213,8,32,"callaurpc@646-678@usr.bin/quota/quota.c","usr.bin/quota/quota.c","callaurpc",646,678
10,3,57,1,10,"alldigits@681-691@usr.bin/quota/quota.c","usr.bin/quota/quota.c","alldigits",681,691
70,23,382,2,86,"main@129-215@usr.bin/radioctl/radioctl.c","usr.bin/radioctl/radioctl.c","main",129,215
9,1,26,1,8,"usage@218-226@usr.bin/radioctl/radioctl.c","usr.bin/radioctl/radioctl.c","usage",218,226
5,2,24,2,4,"show_verbose@229-233@usr.bin/radioctl/radioctl.c","usr.bin/radioctl/radioctl.c","show_verbose",229,233
4,1,17,1,3,"warn_unsupported@236-239@usr.bin/radioctl/radioctl.c","usr.bin/radioctl/radioctl.c","warn_unsupported",236,239
33,11,205,3,43,"do_ioctls@242-285@usr.bin/radioctl/radioctl.c","usr.bin/radioctl/radioctl.c","do_ioctls",242,285
46,16,249,1,49,"change_value@288-337@usr.bin/radioctl/radioctl.c","usr.bin/radioctl/radioctl.c","change_value",288,337
16,6,120,1,19,"str_to_opt@343-362@usr.bin/radioctl/radioctl.c","usr.bin/radioctl/radioctl.c","str_to_opt",343,362
14,4,50,3,13,"update_value@365-378@usr.bin/radioctl/radioctl.c","usr.bin/radioctl/radioctl.c","update_value",365,378
11,4,70,2,13,"str_to_int@384-397@usr.bin/radioctl/radioctl.c","usr.bin/radioctl/radioctl.c","str_to_int",384,397
78,29,529,2,91,"parse_opt@404-495@usr.bin/radioctl/radioctl.c","usr.bin/radioctl/radioctl.c","parse_opt",404,495
45,19,251,2,46,"print_value@501-547@usr.bin/radioctl/radioctl.c","usr.bin/radioctl/radioctl.c","print_value",501,547
5,1,35,4,4,"show_int_val@550-554@usr.bin/radioctl/radioctl.c","usr.bin/radioctl/radioctl.c","show_int_val",550,554
5,1,35,4,4,"show_float_val@557-561@usr.bin/radioctl/radioctl.c","usr.bin/radioctl/radioctl.c","show_float_val",557,561
5,1,31,3,4,"show_char_val@564-568@usr.bin/radioctl/radioctl.c","usr.bin/radioctl/radioctl.c","show_char_val",564,568
41,17,355,2,45,"print_vars@574-619@usr.bin/radioctl/radioctl.c","usr.bin/radioctl/radioctl.c","print_vars",574,619
12,2,63,1,15,"buf_alloc@62-77@usr.bin/rcs/buf.c","usr.bin/rcs/buf.c","buf_alloc",62,77
41,8,221,1,50,"buf_load@86-136@usr.bin/rcs/buf.c","usr.bin/rcs/buf.c","buf_load",86,136
7,2,28,1,6,"buf_free@139-145@usr.bin/rcs/buf.c","usr.bin/rcs/buf.c","buf_free",139,145
7,1,28,1,7,"buf_release@153-160@usr.bin/rcs/buf.c","usr.bin/rcs/buf.c","buf_release",153,160
4,1,15,1,3,"buf_get@163-166@usr.bin/rcs/buf.c","usr.bin/rcs/buf.c","buf_get",163,166
5,1,27,1,4,"buf_empty@172-176@usr.bin/rcs/buf.c","usr.bin/rcs/buf.c","buf_empty",172,176
9,2,54,2,9,"buf_putc@182-191@usr.bin/rcs/buf.c","usr.bin/rcs/buf.c","buf_putc",182,191
4,1,25,2,3,"buf_puts@197-200@usr.bin/rcs/buf.c","usr.bin/rcs/buf.c","buf_puts",197,200
4,1,21,2,3,"buf_getc@206-209@usr.bin/rcs/buf.c","usr.bin/rcs/buf.c","buf_getc",206,209
13,2,81,3,15,"buf_append@218-233@usr.bin/rcs/buf.c","usr.bin/rcs/buf.c","buf_append",218,233
4,1,15,1,3,"buf_len@239-242@usr.bin/rcs/buf.c","usr.bin/rcs/buf.c","buf_len",239,242
19,5,100,2,22,"buf_write_fd@248-270@usr.bin/rcs/buf.c","usr.bin/rcs/buf.c","buf_write_fd",248,270
19,6,134,3,22,"buf_write@277-299@usr.bin/rcs/buf.c","usr.bin/rcs/buf.c","buf_write",277,299
12,3,85,2,15,"buf_write_stmp@307-322@usr.bin/rcs/buf.c","usr.bin/rcs/buf.c","buf_write_stmp",307,322
5,1,36,2,4,"buf_grow@329-333@usr.bin/rcs/buf.c","usr.bin/rcs/buf.c","buf_grow",329,333
9,1,21,1,9,"checkin_usage@93-102@usr.bin/rcs/ci.c","usr.bin/rcs/ci.c","checkin_usage",93,102
181,51,1070,2,214,"checkin_main@111-325@usr.bin/rcs/ci.c","usr.bin/rcs/ci.c","checkin_main",111,325
36,4,237,1,45,"checkin_diff_file@334-379@usr.bin/rcs/ci.c","usr.bin/rcs/ci.c","checkin_diff_file",334,379
21,3,148,3,24,"checkin_getlogmsg@388-412@usr.bin/rcs/ci.c","usr.bin/rcs/ci.c","checkin_getlogmsg",388,412
104,37,900,1,164,"checkin_update@422-586@usr.bin/rcs/ci.c","usr.bin/rcs/ci.c","checkin_update",422,586
69,24,587,1,112,"checkin_init@595-707@usr.bin/rcs/ci.c","usr.bin/rcs/ci.c","checkin_init",595,707
27,8,188,1,26,"checkin_attach_symbol@716-742@usr.bin/rcs/ci.c","usr.bin/rcs/ci.c","checkin_attach_symbol",716,742
24,8,196,1,33,"checkin_revert@753-786@usr.bin/rcs/ci.c","usr.bin/rcs/ci.c","checkin_revert",753,786
13,4,101,1,15,"checkin_checklock@795-810@usr.bin/rcs/ci.c","usr.bin/rcs/ci.c","checkin_checklock",795,810
7,2,47,1,8,"checkin_mtimedate@819-827@usr.bin/rcs/ci.c","usr.bin/rcs/ci.c","checkin_mtimedate",819,827
60,13,348,5,73,"checkin_keywordscan@842-915@usr.bin/rcs/ci.c","usr.bin/rcs/ci.c","checkin_keywordscan",842,915
19,7,149,1,19,"checkin_keywordtype@926-945@usr.bin/rcs/ci.c","usr.bin/rcs/ci.c","checkin_keywordtype",926,945
64,22,417,5,71,"checkin_parsekeyword@956-1027@usr.bin/rcs/ci.c","usr.bin/rcs/ci.c","checkin_parsekeyword",956,1027
152,41,821,2,172,"checkout_main@47-219@usr.bin/rcs/co.c","usr.bin/rcs/co.c","checkout_main",47,219
8,1,20,1,8,"checkout_usage@222-230@usr.bin/rcs/co.c","usr.bin/rcs/co.c","checkout_usage",222,230
199,82,1429,8,257,"checkout_rev@241-498@usr.bin/rcs/co.c","usr.bin/rcs/co.c","checkout_rev",241,498
18,14,121,5,19,"checkout_err_nobranch@506-525@usr.bin/rcs/co.c","usr.bin/rcs/co.c","checkout_err_nobranch",506,525
24,3,150,3,29,"checkout_file_has_diffs@534-563@usr.bin/rcs/co.c","usr.bin/rcs/co.c","checkout_file_has_diffs",534,563
86,17,632,4,102,"diffreg@300-402@usr.bin/rcs/diff.c","usr.bin/rcs/diff.c","diffreg",300,402
19,10,150,2,19,"files_differ@410-429@usr.bin/rcs/diff.c","usr.bin/rcs/diff.c","files_differ",410,429
20,5,160,4,22,"prepare@432-454@usr.bin/rcs/diff.c","usr.bin/rcs/diff.c","prepare",432,454
18,9,186,1,18,"prune@457-475@usr.bin/rcs/diff.c","usr.bin/rcs/diff.c","prune",457,475
25,8,200,5,25,"equiv@478-503@usr.bin/rcs/diff.c","usr.bin/rcs/diff.c","equiv",478,503
13,4,71,1,15,"isqrt@507-522@usr.bin/rcs/diff.c","usr.bin/rcs/diff.c","isqrt",507,522
44,10,293,5,45,"stone@525-570@usr.bin/rcs/diff.c","usr.bin/rcs/diff.c","stone",525,570
13,2,79,3,13,"newcand@573-586@usr.bin/rcs/diff.c","usr.bin/rcs/diff.c","newcand",573,586
21,6,125,3,21,"search@589-610@usr.bin/rcs/diff.c","usr.bin/rcs/diff.c","search",589,610
10,5,102,1,10,"unravel@613-623@usr.bin/rcs/diff.c","usr.bin/rcs/diff.c","unravel",613,623
87,39,553,3,96,"check@632-728@usr.bin/rcs/diff.c","usr.bin/rcs/diff.c","check",632,728
29,10,233,2,29,"sort@732-761@usr.bin/rcs/diff.c","usr.bin/rcs/diff.c","sort",732,761
10,3,95,3,10,"unsort@764-774@usr.bin/rcs/diff.c","usr.bin/rcs/diff.c","unsort",764,774
7,3,44,1,7,"skipline@777-784@usr.bin/rcs/diff.c","usr.bin/rcs/diff.c","skipline",777,784
35,13,277,3,37,"output@787-824@usr.bin/rcs/diff.c","usr.bin/rcs/diff.c","output",787,824
6,3,42,3,5,"range@827-832@usr.bin/rcs/diff.c","usr.bin/rcs/diff.c","range",827,832
9,3,51,2,8,"uni_range@835-843@usr.bin/rcs/diff.c","usr.bin/rcs/diff.c","uni_range",835,843
10,2,67,3,10,"preadline@846-856@usr.bin/rcs/diff.c","usr.bin/rcs/diff.c","preadline",846,856
7,1,38,1,7,"ignoreline@859-866@usr.bin/rcs/diff.c","usr.bin/rcs/diff.c","ignoreline",859,866
109,39,745,7,132,"change@876-1008@usr.bin/rcs/diff.c","usr.bin/rcs/diff.c","change",876,1008
53,20,332,7,58,"fetch@1011-1069@usr.bin/rcs/diff.c","usr.bin/rcs/diff.c","fetch",1011,1069
54,21,272,2,59,"readhash@1075-1134@usr.bin/rcs/diff.c","usr.bin/rcs/diff.c","readhash",1075,1134
10,2,64,1,11,"asciifile@1137-1148@usr.bin/rcs/diff.c","usr.bin/rcs/diff.c","asciifile",1137,1148
40,15,271,3,40,"match_function@1153-1193@usr.bin/rcs/diff.c","usr.bin/rcs/diff.c","match_function",1153,1193
85,22,600,3,99,"dump_context_vec@1197-1296@usr.bin/rcs/diff.c","usr.bin/rcs/diff.c","dump_context_vec",1197,1296
54,11,432,3,69,"dump_unified_vec@1300-1369@usr.bin/rcs/diff.c","usr.bin/rcs/diff.c","dump_unified_vec",1300,1369
16,3,90,2,16,"diff_output@1372-1388@usr.bin/rcs/diff.c","usr.bin/rcs/diff.c","diff_output",1372,1388
83,12,628,2,103,"merge_diff3@155-258@usr.bin/rcs/diff3.c","usr.bin/rcs/diff3.c","merge_diff3",155,258
90,14,706,5,113,"rcs_diff3@261-374@usr.bin/rcs/diff3.c","usr.bin/rcs/diff3.c","rcs_diff3",261,374
30,11,269,4,35,"diff3_internal@377-412@usr.bin/rcs/diff3.c","usr.bin/rcs/diff3.c","diff3_internal",377,412
83,29,610,2,108,"ed_patch_lines@415-523@usr.bin/rcs/diff3.c","usr.bin/rcs/diff3.c","ed_patch_lines",415,523
40,9,313,2,43,"readin@532-575@usr.bin/rcs/diff3.c","usr.bin/rcs/diff3.c","readin",532,575
8,2,49,1,9,"number@578-587@usr.bin/rcs/diff3.c","usr.bin/rcs/diff3.c","number",578,587
9,3,51,1,10,"getchange@590-600@usr.bin/rcs/diff3.c","usr.bin/rcs/diff3.c","getchange",590,600
23,6,143,2,25,"get_line@603-628@usr.bin/rcs/diff3.c","usr.bin/rcs/diff3.c","get_line",603,628
84,27,753,2,109,"merge@631-740@usr.bin/rcs/diff3.c","usr.bin/rcs/diff3.c","merge",631,740
4,1,16,1,3,"separate@743-746@usr.bin/rcs/diff3.c","usr.bin/rcs/diff3.c","separate",743,746
11,3,75,3,10,"change@754-764@usr.bin/rcs/diff3.c","usr.bin/rcs/diff3.c","change",754,764
11,3,70,1,10,"prange@770-780@usr.bin/rcs/diff3.c","usr.bin/rcs/diff3.c","prange",770,780
9,1,61,2,9,"keep@788-797@usr.bin/rcs/diff3.c","usr.bin/rcs/diff3.c","keep",788,797
13,4,98,3,13,"skip@804-817@usr.bin/rcs/diff3.c","usr.bin/rcs/diff3.c","skip",804,817
26,7,180,2,26,"duplicate@824-850@usr.bin/rcs/diff3.c","usr.bin/rcs/diff3.c","duplicate",824,850
6,2,42,1,6,"repos@853-859@usr.bin/rcs/diff3.c","usr.bin/rcs/diff3.c","repos",853,859
14,3,152,3,13,"edit@865-878@usr.bin/rcs/diff3.c","usr.bin/rcs/diff3.c","edit",865,878
26,9,228,1,28,"edscript@882-910@usr.bin/rcs/diff3.c","usr.bin/rcs/diff3.c","edscript",882,910
15,2,161,1,17,"increase@913-930@usr.bin/rcs/diff3.c","usr.bin/rcs/diff3.c","increase",913,930
36,8,195,2,41,"ident_main@46-87@usr.bin/rcs/ident.c","usr.bin/rcs/ident.c","ident_main",46,87
18,8,104,2,21,"ident_file@91-112@usr.bin/rcs/ident.c","usr.bin/rcs/ident.c","ident_file",91,112
34,8,180,1,46,"ident_line@115-161@usr.bin/rcs/ident.c","usr.bin/rcs/ident.c","ident_line",115,161
5,1,18,1,5,"ident_usage@164-169@usr.bin/rcs/ident.c","usr.bin/rcs/ident.c","ident_usage",164,169
58,17,299,2,75,"merge_main@37-112@usr.bin/rcs/merge.c","usr.bin/rcs/merge.c","merge_main",37,112
6,1,21,1,6,"merge_usage@115-121@usr.bin/rcs/merge.c","usr.bin/rcs/merge.c","merge_usage",115,121
41,7,293,4,50,"rcs_open@84-134@usr.bin/rcs/rcs.c","usr.bin/rcs/rcs.c","rcs_open",84,134
45,9,346,1,53,"rcs_close@142-195@usr.bin/rcs/rcs.c","usr.bin/rcs/rcs.c","rcs_close",142,195
120,18,975,1,146,"rcs_write@204-350@usr.bin/rcs/rcs.c","usr.bin/rcs/rcs.c","rcs_write",204,350
56,12,392,4,63,"rcs_movefile@359-422@usr.bin/rcs/rcs.c","usr.bin/rcs/rcs.c","rcs_movefile",359,422
10,3,67,2,11,"rcs_head_set@431-442@usr.bin/rcs/rcs.c","usr.bin/rcs/rcs.c","rcs_head_set",431,442
4,1,15,1,3,"rcs_branch_get@453-456@usr.bin/rcs/rcs.c","usr.bin/rcs/rcs.c","rcs_branch_get",453,456
15,2,103,2,19,"rcs_access_add@465-484@usr.bin/rcs/rcs.c","usr.bin/rcs/rcs.c","rcs_access_add",465,484
16,3,101,2,20,"rcs_access_remove@494-514@usr.bin/rcs/rcs.c","usr.bin/rcs/rcs.c","rcs_access_remove",494,514
21,3,146,3,27,"rcs_sym_add@524-551@usr.bin/rcs/rcs.c","usr.bin/rcs/rcs.c","rcs_sym_add",524,551
21,4,128,2,26,"rcs_sym_remove@562-588@usr.bin/rcs/rcs.c","usr.bin/rcs/rcs.c","rcs_sym_remove",562,588
20,4,110,2,23,"rcs_sym_getrev@599-622@usr.bin/rcs/rcs.c","usr.bin/rcs/rcs.c","rcs_sym_getrev",599,622
15,5,86,1,17,"rcs_sym_check@631-648@usr.bin/rcs/rcs.c","usr.bin/rcs/rcs.c","rcs_sym_check",631,648
4,2,21,1,3,"rcs_lock_getmode@656-659@usr.bin/rcs/rcs.c","usr.bin/rcs/rcs.c","rcs_lock_getmode",656,659
13,3,67,2,14,"rcs_lock_setmode@669-683@usr.bin/rcs/rcs.c","usr.bin/rcs/rcs.c","rcs_lock_setmode",669,683
18,3,139,3,23,"rcs_lock_add@692-715@usr.bin/rcs/rcs.c","usr.bin/rcs/rcs.c","rcs_lock_add",692,715
19,4,127,3,23,"rcs_lock_remove@725-748@usr.bin/rcs/rcs.c","usr.bin/rcs/rcs.c","rcs_lock_remove",725,748
8,1,43,2,8,"rcs_desc_set@756-764@usr.bin/rcs/rcs.c","usr.bin/rcs/rcs.c","rcs_desc_set",756,764
8,1,43,2,8,"rcs_comment_set@772-780@usr.bin/rcs/rcs.c","usr.bin/rcs/rcs.c","rcs_comment_set",772,780
77,23,571,2,93,"rcs_patch_lines@783-876@usr.bin/rcs/rcs.c","usr.bin/rcs/rcs.c","rcs_patch_lines",783,876
105,28,644,2,138,"rcs_getrev@886-1024@usr.bin/rcs/rcs.c","usr.bin/rcs/rcs.c","rcs_getrev",886,1024
41,8,301,3,49,"rcs_delta_stats@1027-1076@usr.bin/rcs/rcs.c","usr.bin/rcs/rcs.c","rcs_delta_stats",1027,1076
47,9,350,5,59,"rcs_rev_add@1091-1150@usr.bin/rcs/rcs.c","usr.bin/rcs/rcs.c","rcs_rev_add",1091,1150
61,18,473,2,89,"rcs_rev_remove@1158-1247@usr.bin/rcs/rcs.c","usr.bin/rcs/rcs.c","rcs_rev_remove",1158,1247
32,9,198,2,46,"rcs_findrev@1261-1307@usr.bin/rcs/rcs.c","usr.bin/rcs/rcs.c","rcs_findrev",1261,1307
24,7,136,2,27,"rcs_kwexp_set@1315-1342@usr.bin/rcs/rcs.c","usr.bin/rcs/rcs.c","rcs_kwexp_set",1315,1342
6,2,31,1,6,"rcs_kwexp_get@1350-1356@usr.bin/rcs/rcs.c","usr.bin/rcs/rcs.c","rcs_kwexp_get",1350,1356
28,11,154,1,30,"rcs_kflag_get@1366-1396@usr.bin/rcs/rcs.c","usr.bin/rcs/rcs.c","rcs_kflag_get",1366,1396
17,2,114,1,20,"rcs_freedelta@1404-1424@usr.bin/rcs/rcs.c","usr.bin/rcs/rcs.c","rcs_freedelta",1404,1424
16,5,120,3,19,"rcs_strprint@1434-1453@usr.bin/rcs/rcs.c","usr.bin/rcs/rcs.c","rcs_strprint",1434,1453
166,49,1130,4,213,"rcs_expand_keywords@1463-1676@usr.bin/rcs/rcs.c","usr.bin/rcs/rcs.c","rcs_expand_keywords",1463,1676
24,4,151,3,31,"rcs_deltatext_set@1685-1716@usr.bin/rcs/rcs.c","usr.bin/rcs/rcs.c","rcs_deltatext_set",1685,1716
10,2,70,3,12,"rcs_rev_setlog@1724-1736@usr.bin/rcs/rcs.c","usr.bin/rcs/rcs.c","rcs_rev_setlog",1724,1736
7,2,49,2,8,"rcs_rev_getdate@1744-1752@usr.bin/rcs/rcs.c","usr.bin/rcs/rcs.c","rcs_rev_getdate",1744,1752
10,2,70,3,14,"rcs_state_set@1763-1777@usr.bin/rcs/rcs.c","usr.bin/rcs/rcs.c","rcs_state_set",1763,1777
15,5,88,1,17,"rcs_state_check@1787-1804@usr.bin/rcs/rcs.c","usr.bin/rcs/rcs.c","rcs_state_check",1787,1804
12,3,85,3,16,"rcs_kwexp_buf@1813-1829@usr.bin/rcs/rcs.c","usr.bin/rcs/rcs.c","rcs_kwexp_buf",1813,1829
64,18,332,2,72,"rcsclean_main@48-120@usr.bin/rcs/rcsclean.c","usr.bin/rcs/rcsclean.c","rcsclean_main",48,120
7,1,19,1,7,"rcsclean_usage@123-130@usr.bin/rcs/rcsclean.c","usr.bin/rcs/rcsclean.c","rcsclean_usage",123,130
69,21,449,2,84,"rcsclean_file@133-217@usr.bin/rcs/rcsclean.c","usr.bin/rcs/rcsclean.c","rcsclean_file",133,217
188,54,1162,2,210,"rcsdiff_main@49-259@usr.bin/rcs/rcsdiff.c","usr.bin/rcs/rcsdiff.c","rcsdiff_main",49,259
7,1,19,1,7,"rcsdiff_usage@262-269@usr.bin/rcs/rcsdiff.c","usr.bin/rcs/rcsdiff.c","rcsdiff_usage",262,269
65,9,495,4,85,"rcsdiff_file@272-357@usr.bin/rcs/rcsdiff.c","usr.bin/rcs/rcsdiff.c","rcsdiff_file",272,357
55,8,454,4,72,"rcsdiff_rev@360-432@usr.bin/rcs/rcsdiff.c","usr.bin/rcs/rcsdiff.c","rcsdiff_rev",360,432
14,2,90,1,15,"push_ignore_pats@435-450@usr.bin/rcs/rcsdiff.c","usr.bin/rcs/rcsdiff.c","push_ignore_pats",435,450
115,36,733,2,142,"rcsmerge_main@38-180@usr.bin/rcs/rcsmerge.c","usr.bin/rcs/rcsmerge.c","rcsmerge_main",38,180
7,1,19,1,7,"rcsmerge_usage@183-190@usr.bin/rcs/rcsmerge.c","usr.bin/rcs/rcsmerge.c","rcsmerge_usage",183,190
8,1,38,1,9,"rcsnum_alloc@50-59@usr.bin/rcs/rcsnum.c","usr.bin/rcs/rcsnum.c","rcsnum_alloc",50,59
9,3,76,1,9,"rcsnum_addmagic@68-77@usr.bin/rcs/rcsnum.c","usr.bin/rcs/rcsnum.c","rcsnum_addmagic",68,77
13,4,70,1,14,"rcsnum_parse@85-99@usr.bin/rcs/rcsnum.c","usr.bin/rcs/rcsnum.c","rcsnum_parse",85,99
7,2,28,1,6,"rcsnum_free@107-113@usr.bin/rcs/rcsnum.c","usr.bin/rcs/rcsnum.c","rcsnum_free",107,113
19,7,160,3,22,"rcsnum_tostr@125-147@usr.bin/rcs/rcsnum.c","usr.bin/rcs/rcsnum.c","rcsnum_tostr",125,147
15,3,76,3,16,"rcsnum_itoa@150-166@usr.bin/rcs/rcsnum.c","usr.bin/rcs/rcsnum.c","rcsnum_itoa",150,166
10,3,72,3,12,"rcsnum_cpy@175-187@usr.bin/rcs/rcsnum.c","usr.bin/rcs/rcsnum.c","rcsnum_cpy",175,187
23,10,161,3,29,"rcsnum_cmp@200-229@usr.bin/rcs/rcsnum.c","usr.bin/rcs/rcsnum.c","rcsnum_cmp",200,229
58,16,428,3,99,"rcsnum_aton@241-340@usr.bin/rcs/rcsnum.c","usr.bin/rcs/rcsnum.c","rcsnum_aton",241,340
7,2,45,1,6,"rcsnum_inc@349-355@usr.bin/rcs/rcsnum.c","usr.bin/rcs/rcsnum.c","rcsnum_inc",349,355
11,3,59,1,14,"rcsnum_revtobr@365-379@usr.bin/rcs/rcsnum.c","usr.bin/rcs/rcsnum.c","rcsnum_revtobr",365,379
12,2,73,1,14,"rcsnum_brtorev@388-402@usr.bin/rcs/rcsnum.c","usr.bin/rcs/rcsnum.c","rcsnum_brtorev",388,402
5,1,40,2,4,"rcsnum_setsize@405-409@usr.bin/rcs/rcsnum.c","usr.bin/rcs/rcsnum.c","rcsnum_setsize",405,409
26,5,160,1,32,"rcsparse_init@220-252@usr.bin/rcs/rcsparse.c","usr.bin/rcs/rcsparse.c","rcsparse_init",220,252
24,9,141,2,28,"rcsparse_deltas@263-291@usr.bin/rcs/rcsparse.c","usr.bin/rcs/rcsparse.c","rcsparse_deltas",263,291
24,11,145,2,28,"rcsparse_deltatexts@302-330@usr.bin/rcs/rcsparse.c","usr.bin/rcs/rcsparse.c","rcsparse_deltatexts",302,330
9,2,48,1,10,"rcsparse_free@338-348@usr.bin/rcs/rcsparse.c","usr.bin/rcs/rcsparse.c","rcsparse_free",338,348
15,6,106,1,20,"rcsparse_desc@361-381@usr.bin/rcs/rcsparse.c","usr.bin/rcs/rcsparse.c","rcsparse_desc",361,381
9,1,60,2,10,"rcsparse_deltarevision@395-405@usr.bin/rcs/rcsparse.c","usr.bin/rcs/rcsparse.c","rcsparse_deltarevision",395,405
7,2,53,2,8,"rcsparse_date@417-425@usr.bin/rcs/rcsparse.c","usr.bin/rcs/rcsparse.c","rcsparse_date",417,425
7,2,53,2,8,"rcsparse_author@437-445@usr.bin/rcs/rcsparse.c","usr.bin/rcs/rcsparse.c","rcsparse_author",437,445
7,2,53,2,8,"rcsparse_state@457-465@usr.bin/rcs/rcsparse.c","usr.bin/rcs/rcsparse.c","rcsparse_state",457,465
12,2,84,2,13,"rcsparse_branches@477-490@usr.bin/rcs/rcsparse.c","usr.bin/rcs/rcsparse.c","rcsparse_branches",477,490
11,2,74,2,12,"rcsparse_next@502-514@usr.bin/rcs/rcsparse.c","usr.bin/rcs/rcsparse.c","rcsparse_next",502,514
7,2,53,2,8,"rcsparse_commitid@527-535@usr.bin/rcs/rcsparse.c","usr.bin/rcs/rcsparse.c","rcsparse_commitid",527,535
17,3,105,2,18,"rcsparse_textrevision@549-567@usr.bin/rcs/rcsparse.c","usr.bin/rcs/rcsparse.c","rcsparse_textrevision",549,567
7,2,46,2,8,"rcsparse_log@579-587@usr.bin/rcs/rcsparse.c","usr.bin/rcs/rcsparse.c","rcsparse_log",579,587
15,3,115,2,16,"rcsparse_text@599-615@usr.bin/rcs/rcsparse.c","usr.bin/rcs/rcsparse.c","rcsparse_text",599,615
10,2,61,2,11,"rcsparse_head@627-638@usr.bin/rcs/rcsparse.c","usr.bin/rcs/rcsparse.c","rcsparse_head",627,638
10,2,61,2,11,"rcsparse_branch@651-662@usr.bin/rcs/rcsparse.c","usr.bin/rcs/rcsparse.c","rcsparse_branch",651,662
12,2,82,2,13,"rcsparse_access@674-687@usr.bin/rcs/rcsparse.c","usr.bin/rcs/rcsparse.c","rcsparse_access",674,687
20,4,132,2,21,"rcsparse_symbols@699-720@usr.bin/rcs/rcsparse.c","usr.bin/rcs/rcsparse.c","rcsparse_symbols",699,720
21,4,132,2,22,"rcsparse_locks@732-754@usr.bin/rcs/rcsparse.c","usr.bin/rcs/rcsparse.c","rcsparse_locks",732,754
5,1,31,2,5,"rcsparse_strict@767-772@usr.bin/rcs/rcsparse.c","usr.bin/rcs/rcsparse.c","rcsparse_strict",767,772
10,2,61,2,11,"rcsparse_comment@785-796@usr.bin/rcs/rcsparse.c","usr.bin/rcs/rcsparse.c","rcsparse_comment",785,796
10,2,61,2,11,"rcsparse_expand@809-820@usr.bin/rcs/rcsparse.c","usr.bin/rcs/rcsparse.c","rcsparse_expand",809,820
36,8,206,2,44,"rcsparse_string@834-878@usr.bin/rcs/rcsparse.c","usr.bin/rcs/rcsparse.c","rcsparse_string",834,878
196,50,1205,2,216,"rcsparse_token@881-1097@usr.bin/rcs/rcsparse.c","usr.bin/rcs/rcsparse.c","rcsparse_token",881,1097
36,13,225,2,40,"rcsparse@1100-1140@usr.bin/rcs/rcsparse.c","usr.bin/rcs/rcsparse.c","rcsparse",1100,1140
14,6,85,1,18,"rcsparse_deltatext@1143-1161@usr.bin/rcs/rcsparse.c","usr.bin/rcs/rcsparse.c","rcsparse_deltatext",1143,1161
20,5,118,1,24,"rcsparse_delta@1164-1188@usr.bin/rcs/rcsparse.c","usr.bin/rcs/rcsparse.c","rcsparse_delta",1164,1188
8,1,61,1,8,"rcsparse_growbuf@1198-1206@usr.bin/rcs/rcsparse.c","usr.bin/rcs/rcsparse.c","rcsparse_growbuf",1198,1206
15,10,101,1,18,"valid_login@1213-1231@usr.bin/rcs/rcsparse.c","usr.bin/rcs/rcsparse.c","valid_login",1213,1231
11,4,57,1,12,"valid_commitid@1234-1246@usr.bin/rcs/rcsparse.c","usr.bin/rcs/rcsparse.c","valid_commitid",1234,1246
4,1,34,2,3,"kw_cmp@1249-1252@usr.bin/rcs/rcsparse.c","usr.bin/rcs/rcsparse.c","kw_cmp",1249,1252
16,2,98,3,16,"rcsparse_warnx@1255-1271@usr.bin/rcs/rcsparse.c","usr.bin/rcs/rcsparse.c","rcsparse_warnx",1255,1271
5,1,20,1,4,"sighdlr@71-75@usr.bin/rcs/rcsprog.c","usr.bin/rcs/rcsprog.c","sighdlr",71,75
36,8,259,3,44,"build_cmd@78-122@usr.bin/rcs/rcsprog.c","usr.bin/rcs/rcsprog.c","build_cmd",78,122
28,5,210,2,36,"main@125-161@usr.bin/rcs/rcsprog.c","usr.bin/rcs/rcsprog.c","main",125,161
8,1,20,1,8,"rcs_usage@165-173@usr.bin/rcs/rcsprog.c","usr.bin/rcs/rcsprog.c","rcs_usage",165,173
303,83,1765,2,360,"rcs_main@182-542@usr.bin/rcs/rcsprog.c","usr.bin/rcs/rcsprog.c","rcs_main",182,542
42,15,238,2,46,"rcs_attach_symbol@545-591@usr.bin/rcs/rcsprog.c","usr.bin/rcs/rcsprog.c","rcs_attach_symbol",545,591
53,12,363,3,61,"rcs_set_tz@35-96@usr.bin/rcs/rcstime.c","usr.bin/rcs/rcstime.c","rcs_set_tz",35,96
13,3,77,1,16,"rcs_get_mtime@50-66@usr.bin/rcs/rcsutil.c","usr.bin/rcs/rcsutil.c","rcs_get_mtime",50,66
10,4,81,2,12,"rcs_set_mtime@74-86@usr.bin/rcs/rcsutil.c","usr.bin/rcs/rcsutil.c","rcs_set_mtime",74,86
45,13,236,3,53,"rcs_getopt@89-142@usr.bin/rcs/rcsutil.c","usr.bin/rcs/rcsutil.c","rcs_getopt",89,142
73,29,691,3,122,"rcs_choosefile@154-276@usr.bin/rcs/rcsutil.c","usr.bin/rcs/rcsutil.c","rcs_choosefile",154,276
8,3,37,2,7,"rcs_setrevstr@282-289@usr.bin/rcs/rcsutil.c","usr.bin/rcs/rcsutil.c","rcs_setrevstr",282,289
11,4,57,3,10,"rcs_setrevstr2@296-306@usr.bin/rcs/rcsutil.c","usr.bin/rcs/rcsutil.c","rcs_setrevstr2",296,306
8,2,44,2,12,"rcs_getrevnum@313-325@usr.bin/rcs/rcsutil.c","usr.bin/rcs/rcsutil.c","rcs_getrevnum",313,325
24,10,170,2,28,"rcs_prompt@333-361@usr.bin/rcs/rcsutil.c","usr.bin/rcs/rcsutil.c","rcs_prompt",333,361
61,18,489,2,70,"rcs_rev_select@364-434@usr.bin/rcs/rcsutil.c","usr.bin/rcs/rcsutil.c","rcs_rev_select",364,434
20,5,121,3,25,"rcs_set_description@444-469@usr.bin/rcs/rcsutil.c","usr.bin/rcs/rcsutil.c","rcs_set_description",444,469
25,4,191,2,29,"rcs_splitlines@475-504@usr.bin/rcs/rcsutil.c","usr.bin/rcs/rcsutil.c","rcs_splitlines",475,504
9,2,58,1,10,"rcs_freelines@507-517@usr.bin/rcs/rcsutil.c","usr.bin/rcs/rcsutil.c","rcs_freelines",507,517
23,3,154,5,26,"rcs_patchfile@520-546@usr.bin/rcs/rcsutil.c","usr.bin/rcs/rcsutil.c","rcs_patchfile",520,546
16,8,96,1,19,"rcs_yesno@556-575@usr.bin/rcs/rcsutil.c","usr.bin/rcs/rcsutil.c","rcs_yesno",556,575
17,2,139,2,19,"rcs_strsplit@584-603@usr.bin/rcs/rcsutil.c","usr.bin/rcs/rcsutil.c","rcs_strsplit",584,603
6,1,28,1,5,"rcs_argv_destroy@611-616@usr.bin/rcs/rcsutil.c","usr.bin/rcs/rcsutil.c","rcs_argv_destroy",611,616
14,4,92,1,14,"rcs_strip_suffix@622-636@usr.bin/rcs/rcsutil.c","usr.bin/rcs/rcsutil.c","rcs_strip_suffix",622,636
9,1,21,1,9,"rlog_usage@63-72@usr.bin/rcs/rlog.c","usr.bin/rcs/rlog.c","rlog_usage",63,72
103,29,447,2,120,"rlog_main@75-195@usr.bin/rcs/rlog.c","usr.bin/rcs/rlog.c","rlog_main",75,195
128,45,712,2,148,"rlog_select_daterev@198-346@usr.bin/rcs/rlog.c","usr.bin/rcs/rlog.c","rlog_select_daterev",198,346
62,23,510,2,83,"rlog_file@349-432@usr.bin/rcs/rlog.c","usr.bin/rcs/rlog.c","rlog_file",349,432
107,38,741,1,140,"rlog_rev_print@435-575@usr.bin/rcs/rlog.c","usr.bin/rcs/rlog.c","rlog_rev_print",435,575
14,2,112,2,16,"worklist_add@42-58@usr.bin/rcs/worklist.c","usr.bin/rcs/worklist.c","worklist_add",42,58
13,2,91,2,16,"worklist_run@65-81@usr.bin/rcs/worklist.c","usr.bin/rcs/worklist.c","worklist_run",65,81
6,1,38,2,6,"worklist_clean@87-93@usr.bin/rcs/worklist.c","usr.bin/rcs/worklist.c","worklist_clean",87,93
4,1,19,1,3,"worklist_unlink@96-99@usr.bin/rcs/worklist.c","usr.bin/rcs/worklist.c","worklist_unlink",96,99
10,3,49,1,10,"xmalloc@26-36@usr.bin/rcs/xmalloc.c","usr.bin/rcs/xmalloc.c","xmalloc",26,36
10,4,60,2,10,"xcalloc@39-49@usr.bin/rcs/xmalloc.c","usr.bin/rcs/xmalloc.c","xcalloc",39,49
9,2,49,3,9,"xreallocarray@52-61@usr.bin/rcs/xmalloc.c","usr.bin/rcs/xmalloc.c","xreallocarray",52,61
7,2,36,1,7,"xstrdup@64-71@usr.bin/rcs/xmalloc.c","usr.bin/rcs/xmalloc.c","xstrdup",64,71
11,3,65,3,13,"xasprintf@74-87@usr.bin/rcs/xmalloc.c","usr.bin/rcs/xmalloc.c","xasprintf",74,87
29,5,191,1,42,"removechild@82-124@usr.bin/rdist/child.c","usr.bin/rdist/child.c","removechild",82,124
11,1,67,1,13,"copychild@130-143@usr.bin/rdist/child.c","usr.bin/rdist/child.c","copychild",130,143
12,1,60,1,15,"addchild@149-164@usr.bin/rdist/child.c","usr.bin/rdist/child.c","addchild",149,164
24,5,200,1,40,"readchild@170-210@usr.bin/rdist/child.c","usr.bin/rdist/child.c","readchild",170,210
21,6,112,2,27,"waitproc@219-246@usr.bin/rdist/child.c","usr.bin/rdist/child.c","waitproc",219,246
29,7,147,1,52,"reap@253-305@usr.bin/rdist/child.c","usr.bin/rdist/child.c","reap",253,305
14,3,71,1,16,"childscan@312-328@usr.bin/rdist/child.c","usr.bin/rdist/child.c","childscan",312,328
56,17,335,1,90,"waitup@336-426@usr.bin/rdist/child.c","usr.bin/rdist/child.c","waitup",336,426
9,3,56,1,9,"setnonblocking@432-441@usr.bin/rdist/child.c","usr.bin/rdist/child.c","setnonblocking",432,441
48,7,303,2,73,"spawn@447-520@usr.bin/rdist/child.c","usr.bin/rdist/child.c","spawn",447,520
50,12,331,5,57,"remfilename@86-143@usr.bin/rdist/client.c","usr.bin/rdist/client.c","remfilename",86,143
8,3,57,2,8,"inlist@149-157@usr.bin/rdist/client.c","usr.bin/rdist/client.c","inlist",149,157
24,7,156,4,25,"runspecial@163-188@usr.bin/rdist/client.c","usr.bin/rdist/client.c","runspecial",163,188
22,7,144,3,24,"addcmdspecialfile@195-219@usr.bin/rdist/client.c","usr.bin/rdist/client.c","addcmdspecialfile",195,219
14,4,74,1,14,"freecmdspecialfiles@225-239@usr.bin/rdist/client.c","usr.bin/rdist/client.c","freecmdspecialfiles",225,239
35,11,212,2,37,"runcmdspecial@245-282@usr.bin/rdist/client.c","usr.bin/rdist/client.c","runcmdspecial",245,282
14,4,67,1,15,"checkfilename@288-303@usr.bin/rdist/client.c","usr.bin/rdist/client.c","checkfilename",288,303
7,1,35,1,6,"freelinkinfo@306-312@usr.bin/rdist/client.c","usr.bin/rdist/client.c","freelinkinfo",306,312
22,5,150,1,25,"linkinfo@318-343@usr.bin/rdist/client.c","usr.bin/rdist/client.c","linkinfo",318,343
23,5,180,4,25,"sendhardlink@349-374@usr.bin/rdist/client.c","usr.bin/rdist/client.c","sendhardlink",349,374
65,14,467,6,98,"sendfile@380-478@usr.bin/rdist/client.c","usr.bin/rdist/client.c","sendfile",380,478
61,17,359,1,80,"rmchk@489-569@usr.bin/rdist/client.c","usr.bin/rdist/client.c","rmchk",489,569
55,13,364,6,69,"senddir@579-648@usr.bin/rdist/client.c","usr.bin/rdist/client.c","senddir",579,648
76,19,513,6,105,"sendlink@654-759@usr.bin/rdist/client.c","usr.bin/rdist/client.c","sendlink",654,759
176,55,1042,3,244,"update@771-1015@usr.bin/rdist/client.c","usr.bin/rdist/client.c","update",771,1015
12,4,78,3,13,"dostat@1021-1034@usr.bin/rdist/client.c","usr.bin/rdist/client.c","dostat",1021,1034
25,3,162,8,25,"statupdate@1040-1065@usr.bin/rdist/client.c","usr.bin/rdist/client.c","statupdate",1040,1065
39,12,312,8,52,"fullupdate@1072-1124@usr.bin/rdist/client.c","usr.bin/rdist/client.c","fullupdate",1072,1124
35,15,298,3,56,"sendit@1135-1191@usr.bin/rdist/client.c","usr.bin/rdist/client.c","sendit",1135,1191
6,2,31,1,6,"cleanup@1197-1203@usr.bin/rdist/client.c","usr.bin/rdist/client.c","cleanup",1197,1203
71,25,479,5,99,"install@1215-1314@usr.bin/rdist/client.c","usr.bin/rdist/client.c","install",1215,1314
14,3,69,3,15,"xwrite@87-102@usr.bin/rdist/common.c","usr.bin/rdist/common.c","xwrite",87,102
27,7,200,3,40,"init@108-148@usr.bin/rdist/common.c","usr.bin/rdist/common.c","init",108,148
18,6,79,1,27,"finish@154-181@usr.bin/rdist/common.c","usr.bin/rdist/common.c","finish",154,181
9,2,44,1,11,"lostconn@187-198@usr.bin/rdist/common.c","usr.bin/rdist/common.c","lostconn",187,198
28,8,99,1,38,"sighandler@204-242@usr.bin/rdist/common.c","usr.bin/rdist/common.c","sighandler",204,242
19,7,149,3,26,"sendcmdmsg@249-275@usr.bin/rdist/common.c","usr.bin/rdist/common.c","sendcmdmsg",249,275
13,2,92,3,14,"sendcmd@283-297@usr.bin/rdist/common.c","usr.bin/rdist/common.c","sendcmd",283,297
4,1,30,3,3,"remread@312-315@usr.bin/rdist/common.c","usr.bin/rdist/common.c","remread",312,315
14,3,84,1,16,"remmore@318-334@usr.bin/rdist/common.c","usr.bin/rdist/common.c","remmore",318,334
42,10,216,3,53,"remline@344-397@usr.bin/rdist/common.c","usr.bin/rdist/common.c","remline",344,397
18,4,106,2,26,"readrem@403-429@usr.bin/rdist/common.c","usr.bin/rdist/common.c","readrem",403,429
25,8,198,3,36,"getusername@435-471@usr.bin/rdist/common.c","usr.bin/rdist/common.c","getusername",435,471
24,8,201,3,35,"getgroupname@477-512@usr.bin/rdist/common.c","usr.bin/rdist/common.c","getgroupname",477,512
37,10,185,1,44,"response@518-562@usr.bin/rdist/common.c","usr.bin/rdist/common.c","response",518,562
45,15,262,3,45,"exptilde@573-618@usr.bin/rdist/common.c","usr.bin/rdist/common.c","exptilde",573,618
11,3,88,3,11,"setfiletime@626-637@usr.bin/rdist/common.c","usr.bin/rdist/common.c","setfiletime",626,637
9,1,45,1,10,"getversion@643-653@usr.bin/rdist/common.c","usr.bin/rdist/common.c","getversion",643,653
67,16,471,1,74,"runcommand@660-734@usr.bin/rdist/common.c","usr.bin/rdist/common.c","runcommand",660,734
7,2,36,1,8,"xmalloc@740-748@usr.bin/rdist/common.c","usr.bin/rdist/common.c","xmalloc",740,748
7,2,42,2,8,"xrealloc@754-762@usr.bin/rdist/common.c","usr.bin/rdist/common.c","xrealloc",754,762
8,2,47,2,9,"xcalloc@768-777@usr.bin/rdist/common.c","usr.bin/rdist/common.c","xcalloc",768,777
6,1,40,1,6,"xstrdup@783-789@usr.bin/rdist/common.c","usr.bin/rdist/common.c","xstrdup",783,789
8,2,40,1,8,"xbasename@795-803@usr.bin/rdist/common.c","usr.bin/rdist/common.c","xbasename",795,803
15,4,95,1,15,"searchpath@811-826@usr.bin/rdist/common.c","usr.bin/rdist/common.c","searchpath",811,826
9,3,74,2,10,"getdistopt@82-92@usr.bin/rdist/distopt.c","usr.bin/rdist/distopt.c","getdistopt",82,92
26,8,186,3,34,"parsedistopts@100-134@usr.bin/rdist/distopt.c","usr.bin/rdist/distopt.c","parsedistopts",100,134
14,3,107,1,15,"getdistoptlist@140-155@usr.bin/rdist/distopt.c","usr.bin/rdist/distopt.c","getdistoptlist",140,155
20,5,167,1,22,"getondistoptlist@162-184@usr.bin/rdist/distopt.c","usr.bin/rdist/distopt.c","getondistoptlist",162,184
12,2,64,1,14,"closeconn@70-84@usr.bin/rdist/docmd.c","usr.bin/rdist/docmd.c","closeconn",70,84
76,20,570,3,93,"notify@92-185@usr.bin/rdist/docmd.c","usr.bin/rdist/docmd.c","notify",92,185
15,5,84,1,16,"checkcmd@194-210@usr.bin/rdist/docmd.c","usr.bin/rdist/docmd.c","checkcmd",194,210
10,4,69,2,10,"markassigned@217-227@usr.bin/rdist/docmd.c","usr.bin/rdist/docmd.c","markassigned",217,227
16,5,96,2,17,"markfailed@233-250@usr.bin/rdist/docmd.c","usr.bin/rdist/docmd.c","markfailed",233,250
18,3,148,4,22,"remotecmd@253-275@usr.bin/rdist/docmd.c","usr.bin/rdist/docmd.c","remotecmd",253,275
91,27,610,1,126,"makeconn@282-408@usr.bin/rdist/docmd.c","usr.bin/rdist/docmd.c","makeconn",282,408
131,39,781,2,171,"doarrow@414-585@usr.bin/rdist/docmd.c","usr.bin/rdist/docmd.c","doarrow",414,585
17,9,100,1,18,"okname@588-606@usr.bin/rdist/docmd.c","usr.bin/rdist/docmd.c","okname",588,606
33,7,225,3,34,"rcmptime@609-643@usr.bin/rdist/docmd.c","usr.bin/rdist/docmd.c","rcmptime",609,643
52,17,362,3,61,"cmptime@649-710@usr.bin/rdist/docmd.c","usr.bin/rdist/docmd.c","cmptime",649,710
66,20,509,2,76,"dodcolon@716-792@usr.bin/rdist/docmd.c","usr.bin/rdist/docmd.c","dodcolon",716,792
42,11,254,1,45,"except@798-843@usr.bin/rdist/docmd.c","usr.bin/rdist/docmd.c","except",798,843
30,10,148,2,48,"docmdhost@849-897@usr.bin/rdist/docmd.c","usr.bin/rdist/docmd.c","docmdhost",849,897
20,7,135,3,20,"docmd@903-923@usr.bin/rdist/docmd.c","usr.bin/rdist/docmd.c","docmd",903,923
69,24,425,3,104,"docmds@945-1049@usr.bin/rdist/docmd.c","usr.bin/rdist/docmd.c","docmds",945,1049
20,6,139,2,22,"Cat@69-91@usr.bin/rdist/expand.c","usr.bin/rdist/expand.c","Cat",69,91
10,2,36,1,9,"addpath@94-103@usr.bin/rdist/expand.c","usr.bin/rdist/expand.c","addpath",94,103
33,6,201,2,43,"expand@115-158@usr.bin/rdist/expand.c","usr.bin/rdist/expand.c","expand",115,158
8,4,48,2,9,"xstrchr@165-174@usr.bin/rdist/expand.c","usr.bin/rdist/expand.c","xstrchr",165,174
119,36,790,1,132,"expstr@177-309@usr.bin/rdist/expand.c","usr.bin/rdist/expand.c","expstr",177,309
5,1,42,2,5,"argcmp@312-317@usr.bin/rdist/expand.c","usr.bin/rdist/expand.c","argcmp",312,317
35,11,207,1,35,"expsh@324-359@usr.bin/rdist/expand.c","usr.bin/rdist/expand.c","expsh",324,359
37,8,225,1,38,"matchdir@362-400@usr.bin/rdist/expand.c","usr.bin/rdist/expand.c","matchdir",362,400
79,29,434,2,90,"execbrc@403-493@usr.bin/rdist/expand.c","usr.bin/rdist/expand.c","execbrc",403,493
14,3,71,2,14,"match@496-510@usr.bin/rdist/expand.c","usr.bin/rdist/expand.c","match",496,510
83,29,431,2,90,"amatch@513-603@usr.bin/rdist/expand.c","usr.bin/rdist/expand.c","amatch",513,603
14,6,114,2,20,"isexec@43-63@usr.bin/rdist/isexec.c","usr.bin/rdist/isexec.c","isexec",43,63
52,16,268,1,53,"define@53-106@usr.bin/rdist/lookup.c","usr.bin/rdist/lookup.c","define",53,106
40,9,275,3,45,"lookup@116-161@usr.bin/rdist/lookup.c","usr.bin/rdist/lookup.c","lookup",116,161
14,3,127,1,18,"msgprusage@124-142@usr.bin/rdist/message.c","usr.bin/rdist/message.c","msgprusage",124,142
19,5,164,1,20,"msgprconfig@148-168@usr.bin/rdist/message.c","usr.bin/rdist/message.c","msgprconfig",148,168
8,3,57,1,9,"getmsgfac@174-183@usr.bin/rdist/message.c","usr.bin/rdist/message.c","getmsgfac",174,183
8,3,57,1,9,"getmsgtype@189-198@usr.bin/rdist/message.c","usr.bin/rdist/message.c","getmsgtype",189,198
55,16,310,2,81,"setmsgtypes@205-286@usr.bin/rdist/message.c","usr.bin/rdist/message.c","setmsgtypes",205,286
37,11,250,2,50,"msgparseopts@292-342@usr.bin/rdist/message.c","usr.bin/rdist/message.c","msgparseopts",292,342
40,22,208,4,48,"msgsendstdout@349-397@usr.bin/rdist/message.c","usr.bin/rdist/message.c","msgsendstdout",349,397
19,20,123,4,35,"msgsendsyslog@403-438@usr.bin/rdist/message.c","usr.bin/rdist/message.c","msgsendsyslog",403,438
9,4,64,4,10,"msgsendfile@444-454@usr.bin/rdist/message.c","usr.bin/rdist/message.c","msgsendfile",444,454
29,10,215,4,38,"msgsendnotify@460-498@usr.bin/rdist/message.c","usr.bin/rdist/message.c","msgsendnotify",460,498
13,4,74,1,13,"checkhostname@504-517@usr.bin/rdist/message.c","usr.bin/rdist/message.c","checkhostname",504,517
38,18,326,2,60,"_message@523-583@usr.bin/rdist/message.c","usr.bin/rdist/message.c","_message",523,583
11,3,72,3,12,"message@589-601@usr.bin/rdist/message.c","usr.bin/rdist/message.c","message",589,601
5,2,27,2,4,"_debugmsg@607-611@usr.bin/rdist/message.c","usr.bin/rdist/message.c","_debugmsg",607,611
9,1,60,3,10,"debugmsg@617-627@usr.bin/rdist/message.c","usr.bin/rdist/message.c","debugmsg",617,627
15,4,87,1,17,"_error@633-650@usr.bin/rdist/message.c","usr.bin/rdist/message.c","_error",633,650
11,3,75,2,12,"error@656-668@usr.bin/rdist/message.c","usr.bin/rdist/message.c","error",656,668
11,2,70,1,14,"_fatalerr@674-688@usr.bin/rdist/message.c","usr.bin/rdist/message.c","_fatalerr",674,688
9,1,55,2,10,"fatalerr@694-704@usr.bin/rdist/message.c","usr.bin/rdist/message.c","fatalerr",694,704
12,4,82,1,13,"getnotifyfile@713-726@usr.bin/rdist/message.c","usr.bin/rdist/message.c","getnotifyfile",713,726
16,6,100,2,18,"addhostlist@67-85@usr.bin/rdist/rdist.c","usr.bin/rdist/rdist.c","addhostlist",67,85
166,64,948,3,206,"main@88-294@usr.bin/rdist/rdist.c","usr.bin/rdist/rdist.c","main",88,294
22,7,124,1,29,"opendist@300-329@usr.bin/rdist/rdist.c","usr.bin/rdist/rdist.c","opendist",300,329
16,1,52,1,20,"usage@335-355@usr.bin/rdist/rdist.c","usr.bin/rdist/rdist.c","usage",335,355
43,8,264,2,48,"docmdargs@361-409@usr.bin/rdist/rdist.c","usr.bin/rdist/rdist.c","docmdargs",361,409
22,4,154,1,25,"getnlstr@415-440@usr.bin/rdist/rdist.c","usr.bin/rdist/rdist.c","getnlstr",415,440
14,3,80,1,17,"setmountent@50-67@usr.bin/rdistd/filesys-os.c","usr.bin/rdistd/filesys-os.c","setmountent",50,67
19,4,122,1,24,"getmountent@73-97@usr.bin/rdistd/filesys-os.c","usr.bin/rdistd/filesys-os.c","getmountent",73,97
5,1,15,1,4,"endmountent@103-107@usr.bin/rdistd/filesys-os.c","usr.bin/rdistd/filesys-os.c","endmountent",103,107
8,1,46,1,9,"newmountent@113-122@usr.bin/rdistd/filesys-os.c","usr.bin/rdistd/filesys-os.c","newmountent",113,122
63,23,443,3,109,"find_file@53-162@usr.bin/rdistd/filesys.c","usr.bin/rdistd/filesys.c","find_file",53,162
11,4,69,2,12,"findmnt@169-181@usr.bin/rdistd/filesys.c","usr.bin/rdistd/filesys.c","findmnt",169,181
8,3,59,2,9,"isdupmnt@187-196@usr.bin/rdistd/filesys.c","usr.bin/rdistd/filesys.c","isdupmnt",187,196
5,1,21,1,4,"wakeup@202-206@usr.bin/rdistd/filesys.c","usr.bin/rdistd/filesys.c","wakeup",202,206
41,8,248,1,61,"makemntinfo@213-274@usr.bin/rdistd/filesys.c","usr.bin/rdistd/filesys.c","makemntinfo",213,274
25,7,158,3,43,"getmntpt@284-327@usr.bin/rdistd/filesys.c","usr.bin/rdistd/filesys.c","getmntpt",284,327
9,3,62,3,11,"is_nfs_mounted@334-345@usr.bin/rdistd/filesys.c","usr.bin/rdistd/filesys.c","is_nfs_mounted",334,345
9,3,62,3,11,"is_ro_mounted@352-363@usr.bin/rdistd/filesys.c","usr.bin/rdistd/filesys.c","is_ro_mounted",352,363
12,4,74,3,14,"is_symlinked@370-384@usr.bin/rdistd/filesys.c","usr.bin/rdistd/filesys.c","is_symlinked",370,384
26,5,164,3,37,"getfilesysinfo@395-432@usr.bin/rdistd/filesys.c","usr.bin/rdistd/filesys.c","getfilesysinfo",395,432
5,1,20,1,4,"usage@45-49@usr.bin/rdistd/rdistd.c","usr.bin/rdistd/rdistd.c","usage",45,49
36,9,187,3,51,"main@57-108@usr.bin/rdistd/rdistd.c","usr.bin/rdistd/rdistd.c","main",57,108
14,3,90,1,15,"cattarget@86-101@usr.bin/rdistd/server.c","usr.bin/rdistd/server.c","cattarget",86,101
31,9,167,5,38,"setownership@107-145@usr.bin/rdistd/server.c","usr.bin/rdistd/server.c","setownership",107,145
17,8,119,4,22,"setfilemode@151-173@usr.bin/rdistd/server.c","usr.bin/rdistd/server.c","setfilemode",151,173
97,34,644,5,108,"fchog@178-286@usr.bin/rdistd/server.c","usr.bin/rdistd/server.c","fchog",178,286
83,27,470,2,99,"removefile@293-392@usr.bin/rdistd/server.c","usr.bin/rdistd/server.c","removefile",293,392
56,13,368,1,62,"doclean@399-461@usr.bin/rdistd/server.c","usr.bin/rdistd/server.c","doclean",399,461
6,1,30,1,5,"clean@467-472@usr.bin/rdistd/server.c","usr.bin/rdistd/server.c","clean",467,472
9,2,40,1,8,"dospecial@480-488@usr.bin/rdistd/server.c","usr.bin/rdistd/server.c","dospecial",480,488
47,8,284,1,53,"docmdspecial@499-552@usr.bin/rdistd/server.c","usr.bin/rdistd/server.c","docmdspecial",499,552
60,18,354,1,77,"query@565-642@usr.bin/rdistd/server.c","usr.bin/rdistd/server.c","query",565,642
25,7,153,2,31,"chkparent@648-679@usr.bin/rdistd/server.c","usr.bin/rdistd/server.c","chkparent",648,679
41,11,252,2,50,"savetarget@685-735@usr.bin/rdistd/server.c","usr.bin/rdistd/server.c","savetarget",685,735
153,35,982,8,217,"recvfile@741-958@usr.bin/rdistd/server.c","usr.bin/rdistd/server.c","recvfile",741,958
121,31,721,4,143,"recvdir@964-1107@usr.bin/rdistd/server.c","usr.bin/rdistd/server.c","recvdir",964,1107
67,18,442,4,91,"recvlink@1113-1204@usr.bin/rdistd/server.c","usr.bin/rdistd/server.c","recvlink",1113,1204
61,16,347,1,71,"hardlink@1210-1281@usr.bin/rdistd/server.c","usr.bin/rdistd/server.c","hardlink",1210,1281
43,11,224,1,52,"setconfig@1292-1344@usr.bin/rdistd/server.c","usr.bin/rdistd/server.c","setconfig",1292,1344
124,31,719,2,181,"recvit@1350-1531@usr.bin/rdistd/server.c","usr.bin/rdistd/server.c","recvit",1350,1531
48,9,259,1,73,"dochmog@1537-1610@usr.bin/rdistd/server.c","usr.bin/rdistd/server.c","dochmog",1537,1610
23,5,118,2,33,"settarget@1616-1649@usr.bin/rdistd/server.c","usr.bin/rdistd/server.c","settarget",1616,1649
3,1,7,1,3,"cleanup@1655-1658@usr.bin/rdistd/server.c","usr.bin/rdistd/server.c","cleanup",1655,1658
104,32,525,1,135,"server@1664-1799@usr.bin/rdistd/server.c","usr.bin/rdistd/server.c","server",1664,1799
42,11,249,2,47,"main@41-88@usr.bin/readlink/readlink.c","usr.bin/readlink/readlink.c","main",41,88
5,1,21,1,4,"usage@91-95@usr.bin/readlink/readlink.c","usr.bin/readlink/readlink.c","usage",91,95
92,27,566,2,104,"main@49-153@usr.bin/renice/renice.c","usr.bin/renice/renice.c","main",49,153
25,7,160,2,25,"renice@156-181@usr.bin/renice/renice.c","usr.bin/renice/renice.c","renice",156,181
5,1,18,1,4,"usage@184-188@usr.bin/renice/renice.c","usr.bin/renice/renice.c","usage",184,188
51,12,304,2,55,"main@47-102@usr.bin/rev/rev.c","usr.bin/rev/rev.c","main",47,102
4,2,25,1,3,"isu8cont@105-108@usr.bin/rev/rev.c","usr.bin/rev/rev.c","isu8cont",105,108
6,1,28,1,6,"usage@111-117@usr.bin/rev/rev.c","usr.bin/rev/rev.c","usage",111,117
15,3,72,0,15,"write_stubs@52-67@usr.bin/rpcgen/rpc_clntout.c","usr.bin/rpcgen/rpc_clntout.c","write_stubs",52,67
18,3,128,1,18,"write_program@70-88@usr.bin/rpcgen/rpc_clntout.c","usr.bin/rpcgen/rpc_clntout.c","write_program",70,88
41,10,349,3,44,"printarglist@98-142@usr.bin/rpcgen/rpc_clntout.c","usr.bin/rpcgen/rpc_clntout.c","printarglist",98,142
8,2,32,1,7,"ampr@145-152@usr.bin/rpcgen/rpc_clntout.c","usr.bin/rpcgen/rpc_clntout.c","ampr",145,152
57,13,410,1,63,"printbody@155-218@usr.bin/rpcgen/rpc_clntout.c","usr.bin/rpcgen/rpc_clntout.c","printbody",155,218
33,9,131,1,37,"emit@69-106@usr.bin/rpcgen/rpc_cout.c","usr.bin/rpcgen/rpc_cout.c","emit",69,106
10,3,52,2,10,"findtype@109-119@usr.bin/rpcgen/rpc_cout.c","usr.bin/rpcgen/rpc_cout.c","findtype",109,119
7,1,36,1,7,"undefined@122-129@usr.bin/rpcgen/rpc_cout.c","usr.bin/rpcgen/rpc_cout.c","undefined",122,129
22,4,124,2,21,"print_generic_header@132-153@usr.bin/rpcgen/rpc_cout.c","usr.bin/rpcgen/rpc_cout.c","print_generic_header",132,153
9,3,51,1,11,"print_header@156-167@usr.bin/rpcgen/rpc_cout.c","usr.bin/rpcgen/rpc_cout.c","print_header",156,167
5,1,21,1,4,"print_prog_header@170-174@usr.bin/rpcgen/rpc_cout.c","usr.bin/rpcgen/rpc_cout.c","print_prog_header",170,174
5,1,19,0,4,"print_trailer@177-181@usr.bin/rpcgen/rpc_cout.c","usr.bin/rpcgen/rpc_cout.c","print_trailer",177,181
7,1,31,2,6,"print_ifopen@184-190@usr.bin/rpcgen/rpc_cout.c","usr.bin/rpcgen/rpc_cout.c","print_ifopen",184,190
5,1,19,1,4,"print_ifarg@193-197@usr.bin/rpcgen/rpc_cout.c","usr.bin/rpcgen/rpc_cout.c","print_ifarg",193,197
14,4,75,2,13,"print_ifsizeof@200-213@usr.bin/rpcgen/rpc_cout.c","usr.bin/rpcgen/rpc_cout.c","print_ifsizeof",200,213
7,1,30,1,6,"print_ifclose@216-222@usr.bin/rpcgen/rpc_cout.c","usr.bin/rpcgen/rpc_cout.c","print_ifclose",216,222
77,15,384,7,77,"print_ifstat@225-302@usr.bin/rpcgen/rpc_cout.c","usr.bin/rpcgen/rpc_cout.c","print_ifstat",225,302
8,1,34,1,8,"emit_enum@306-314@usr.bin/rpcgen/rpc_cout.c","usr.bin/rpcgen/rpc_cout.c","emit_enum",306,314
17,6,116,1,18,"emit_program@317-335@usr.bin/rpcgen/rpc_cout.c","usr.bin/rpcgen/rpc_cout.c","emit_program",317,335
66,10,486,1,70,"emit_union@338-408@usr.bin/rpcgen/rpc_cout.c","usr.bin/rpcgen/rpc_cout.c","emit_union",338,408
182,45,1052,1,219,"emit_struct@411-630@usr.bin/rpcgen/rpc_cout.c","usr.bin/rpcgen/rpc_cout.c","emit_struct",411,630
10,1,83,1,10,"emit_typedef@633-643@usr.bin/rpcgen/rpc_cout.c","usr.bin/rpcgen/rpc_cout.c","emit_typedef",633,643
16,2,113,2,16,"print_stat@646-662@usr.bin/rpcgen/rpc_cout.c","usr.bin/rpcgen/rpc_cout.c","print_stat",646,662
20,3,95,2,22,"emit_inline@667-689@usr.bin/rpcgen/rpc_cout.c","usr.bin/rpcgen/rpc_cout.c","emit_inline",667,689
35,8,184,3,39,"emit_single_in_line@692-731@usr.bin/rpcgen/rpc_cout.c","usr.bin/rpcgen/rpc_cout.c","emit_single_in_line",692,731
15,3,89,1,17,"upcase@734-751@usr.bin/rpcgen/rpc_cout.c","usr.bin/rpcgen/rpc_cout.c","upcase",734,751
35,12,156,1,36,"print_datadef@64-100@usr.bin/rpcgen/rpc_hout.c","usr.bin/rpcgen/rpc_hout.c","print_datadef",64,100
12,2,39,1,11,"print_funcdef@104-115@usr.bin/rpcgen/rpc_hout.c","usr.bin/rpcgen/rpc_hout.c","print_funcdef",104,115
14,3,90,2,14,"pxdrfuncdecl@118-132@usr.bin/rpcgen/rpc_hout.c","usr.bin/rpcgen/rpc_hout.c","pxdrfuncdecl",118,132
5,1,23,1,4,"pconstdef@136-140@usr.bin/rpcgen/rpc_hout.c","usr.bin/rpcgen/rpc_hout.c","pconstdef",136,140
26,6,170,1,26,"pargdef@147-173@usr.bin/rpcgen/rpc_hout.c","usr.bin/rpcgen/rpc_hout.c","pargdef",147,173
11,2,85,1,11,"pstructdef@176-187@usr.bin/rpcgen/rpc_hout.c","usr.bin/rpcgen/rpc_hout.c","pstructdef",176,187
26,6,205,1,26,"puniondef@190-216@usr.bin/rpcgen/rpc_hout.c","usr.bin/rpcgen/rpc_hout.c","puniondef",190,216
6,1,27,2,5,"pdefine@219-224@usr.bin/rpcgen/rpc_hout.c","usr.bin/rpcgen/rpc_hout.c","pdefine",219,224
6,1,27,2,5,"puldefine@227-232@usr.bin/rpcgen/rpc_hout.c","usr.bin/rpcgen/rpc_hout.c","puldefine",227,232
17,5,100,2,18,"define_printed@235-253@usr.bin/rpcgen/rpc_hout.c","usr.bin/rpcgen/rpc_hout.c","define_printed",235,253
40,8,288,1,47,"pprogramdef@256-303@usr.bin/rpcgen/rpc_hout.c","usr.bin/rpcgen/rpc_hout.c","pprogramdef",256,303
18,4,104,5,22,"pprocdef@306-328@usr.bin/rpcgen/rpc_hout.c","usr.bin/rpcgen/rpc_hout.c","pprocdef",306,328
18,6,124,2,20,"parglist@332-352@usr.bin/rpcgen/rpc_hout.c","usr.bin/rpcgen/rpc_hout.c","parglist",332,352
29,5,181,1,29,"penumdef@355-384@usr.bin/rpcgen/rpc_hout.c","usr.bin/rpcgen/rpc_hout.c","penumdef",355,384
43,11,282,1,43,"ptypedef@387-430@usr.bin/rpcgen/rpc_hout.c","usr.bin/rpcgen/rpc_hout.c","ptypedef",387,430
54,12,338,4,54,"pdeclaration@433-487@usr.bin/rpcgen/rpc_hout.c","usr.bin/rpcgen/rpc_hout.c","pdeclaration",433,487
18,5,104,2,18,"undefined2@490-508@usr.bin/rpcgen/rpc_hout.c","usr.bin/rpcgen/rpc_hout.c","undefined2",490,508
59,26,519,2,64,"main@139-203@usr.bin/rpcgen/rpc_main.c","usr.bin/rpcgen/rpc_main.c","main",139,203
23,4,156,2,24,"extendfile@209-233@usr.bin/rpcgen/rpc_main.c","usr.bin/rpcgen/rpc_main.c","extendfile",209,233
19,5,96,2,20,"open_output@239-259@usr.bin/rpcgen/rpc_main.c","usr.bin/rpcgen/rpc_main.c","open_output",239,259
7,1,34,1,6,"add_warning@262-268@usr.bin/rpcgen/rpc_main.c","usr.bin/rpcgen/rpc_main.c","add_warning",262,268
7,2,33,1,6,"clear_args@272-278@usr.bin/rpcgen/rpc_main.c","usr.bin/rpcgen/rpc_main.c","clear_args",272,278
17,4,77,1,19,"find_cpp@282-301@usr.bin/rpcgen/rpc_main.c","usr.bin/rpcgen/rpc_main.c","find_cpp",282,301
31,5,201,2,31,"open_input@307-338@usr.bin/rpcgen/rpc_main.c","usr.bin/rpcgen/rpc_main.c","open_input",307,338
10,3,64,2,9,"check_nettype@362-371@usr.bin/rpcgen/rpc_main.c","usr.bin/rpcgen/rpc_main.c","check_nettype",362,371
28,6,161,4,29,"c_output@378-407@usr.bin/rpcgen/rpc_main.c","usr.bin/rpcgen/rpc_main.c","c_output",378,407
10,1,55,1,14,"c_initialize@411-425@usr.bin/rpcgen/rpc_main.c","usr.bin/rpcgen/rpc_main.c","c_initialize",411,425
21,5,136,1,25,"generate_guard@437-462@usr.bin/rpcgen/rpc_main.c","usr.bin/rpcgen/rpc_main.c","generate_guard",437,462
35,8,213,4,45,"h_output@469-514@usr.bin/rpcgen/rpc_main.c","usr.bin/rpcgen/rpc_main.c","h_output",469,514
90,33,527,8,96,"s_output@520-616@usr.bin/rpcgen/rpc_main.c","usr.bin/rpcgen/rpc_main.c","s_output",520,616
29,7,168,4,30,"l_output@622-652@usr.bin/rpcgen/rpc_main.c","usr.bin/rpcgen/rpc_main.c","l_output",622,652
21,5,114,4,22,"t_output@658-680@usr.bin/rpcgen/rpc_main.c","usr.bin/rpcgen/rpc_main.c","t_output",658,680
26,6,160,4,31,"svc_output@684-715@usr.bin/rpcgen/rpc_main.c","usr.bin/rpcgen/rpc_main.c","svc_output",684,715
28,7,174,4,36,"clnt_output@720-756@usr.bin/rpcgen/rpc_main.c","usr.bin/rpcgen/rpc_main.c","clnt_output",720,756
28,10,181,2,28,"do_registers@763-791@usr.bin/rpcgen/rpc_main.c","usr.bin/rpcgen/rpc_main.c","do_registers",763,791
9,2,37,1,10,"addarg@797-807@usr.bin/rpcgen/rpc_main.c","usr.bin/rpcgen/rpc_main.c","addarg",797,807
10,2,41,2,10,"putarg@810-820@usr.bin/rpcgen/rpc_main.c","usr.bin/rpcgen/rpc_main.c","putarg",810,820
21,6,83,2,23,"checkfiles@828-851@usr.bin/rpcgen/rpc_main.c","usr.bin/rpcgen/rpc_main.c","checkfiles",828,851
168,56,981,3,190,"parseargs@857-1047@usr.bin/rpcgen/rpc_main.c","usr.bin/rpcgen/rpc_main.c","parseargs",857,1047
9,1,40,1,8,"usage@1050-1058@usr.bin/rpcgen/rpc_main.c","usr.bin/rpcgen/rpc_main.c","usage",1050,1058
35,8,135,1,35,"get_definition@64-99@usr.bin/rpcgen/rpc_parse.c","usr.bin/rpcgen/rpc_parse.c","get_definition",64,99
5,1,18,1,4,"isdefined@102-106@usr.bin/rpcgen/rpc_parse.c","usr.bin/rpcgen/rpc_parse.c","isdefined",102,106
24,2,138,1,25,"def_struct@109-134@usr.bin/rpcgen/rpc_parse.c","usr.bin/rpcgen/rpc_parse.c","def_struct",109,134
93,12,603,1,102,"def_program@137-239@usr.bin/rpcgen/rpc_parse.c","usr.bin/rpcgen/rpc_parse.c","def_program",137,239
27,3,169,1,27,"def_enum@243-270@usr.bin/rpcgen/rpc_parse.c","usr.bin/rpcgen/rpc_parse.c","def_enum",243,270
11,1,63,1,11,"def_const@273-284@usr.bin/rpcgen/rpc_parse.c","usr.bin/rpcgen/rpc_parse.c","def_const",273,284
60,6,416,1,63,"def_union@287-350@usr.bin/rpcgen/rpc_parse.c","usr.bin/rpcgen/rpc_parse.c","def_union",287,350
22,6,129,2,22,"check_type_name@377-399@usr.bin/rpcgen/rpc_parse.c","usr.bin/rpcgen/rpc_parse.c","check_type_name",377,399
13,1,92,1,13,"def_typedef@402-415@usr.bin/rpcgen/rpc_parse.c","usr.bin/rpcgen/rpc_parse.c","def_typedef",402,415
48,13,300,2,50,"get_declaration@418-468@usr.bin/rpcgen/rpc_parse.c","usr.bin/rpcgen/rpc_parse.c","get_declaration",418,468
60,17,378,3,69,"get_prog_declaration@471-540@usr.bin/rpcgen/rpc_parse.c","usr.bin/rpcgen/rpc_parse.c","get_prog_declaration",471,540
54,20,230,3,54,"get_type@543-597@usr.bin/rpcgen/rpc_parse.c","usr.bin/rpcgen/rpc_parse.c","get_type",543,597
34,6,149,1,34,"unsigned_dec@600-634@usr.bin/rpcgen/rpc_parse.c","usr.bin/rpcgen/rpc_parse.c","unsigned_dec",600,634
7,2,25,1,7,"write_sample_svc@51-58@usr.bin/rpcgen/rpc_sample.c","usr.bin/rpcgen/rpc_sample.c","write_sample_svc",51,58
13,3,73,1,14,"write_sample_clnt@62-76@usr.bin/rpcgen/rpc_sample.c","usr.bin/rpcgen/rpc_sample.c","write_sample_clnt",62,76
72,15,598,2,80,"write_sample_client@80-160@usr.bin/rpcgen/rpc_sample.c","usr.bin/rpcgen/rpc_sample.c","write_sample_client",80,160
28,5,181,1,35,"write_sample_server@163-198@usr.bin/rpcgen/rpc_sample.c","usr.bin/rpcgen/rpc_sample.c","write_sample_server",163,198
5,1,23,1,4,"return_type@201-205@usr.bin/rpcgen/rpc_sample.c","usr.bin/rpcgen/rpc_sample.c","return_type",201,205
8,1,41,1,7,"add_sample_msg@208-215@usr.bin/rpcgen/rpc_sample.c","usr.bin/rpcgen/rpc_sample.c","add_sample_msg",208,215
27,5,168,0,29,"write_sample_clnt_main@218-247@usr.bin/rpcgen/rpc_sample.c","usr.bin/rpcgen/rpc_sample.c","write_sample_clnt_main",218,247
8,2,33,2,7,"scan@66-73@usr.bin/rpcgen/rpc_scan.c","usr.bin/rpcgen/rpc_scan.c","scan",66,73
9,3,46,3,8,"scan2@79-87@usr.bin/rpcgen/rpc_scan.c","usr.bin/rpcgen/rpc_scan.c","scan2",79,87
11,4,59,4,10,"scan3@93-103@usr.bin/rpcgen/rpc_scan.c","usr.bin/rpcgen/rpc_scan.c","scan3",93,103
11,2,35,1,10,"scan_num@109-119@usr.bin/rpcgen/rpc_scan.c","usr.bin/rpcgen/rpc_scan.c","scan_num",109,119
6,1,20,1,5,"peek@125-130@usr.bin/rpcgen/rpc_scan.c","usr.bin/rpcgen/rpc_scan.c","peek",125,130
11,2,45,2,10,"peekscan@136-146@usr.bin/rpcgen/rpc_scan.c","usr.bin/rpcgen/rpc_scan.c","peekscan",136,146
141,44,621,1,150,"get_token@152-302@usr.bin/rpcgen/rpc_scan.c","usr.bin/rpcgen/rpc_scan.c","get_token",152,302
6,1,19,1,5,"unget_token@305-310@usr.bin/rpcgen/rpc_scan.c","usr.bin/rpcgen/rpc_scan.c","unget_token",305,310
22,5,119,2,22,"findstrconst@313-335@usr.bin/rpcgen/rpc_scan.c","usr.bin/rpcgen/rpc_scan.c","findstrconst",313,335
25,6,132,2,25,"findchrconst@338-363@usr.bin/rpcgen/rpc_scan.c","usr.bin/rpcgen/rpc_scan.c","findchrconst",338,363
25,6,147,2,25,"findconst@366-391@usr.bin/rpcgen/rpc_scan.c","usr.bin/rpcgen/rpc_scan.c","findconst",366,391
31,8,213,2,31,"findkind@421-452@usr.bin/rpcgen/rpc_scan.c","usr.bin/rpcgen/rpc_scan.c","findkind",421,452
5,2,22,1,4,"cppline@455-459@usr.bin/rpcgen/rpc_scan.c","usr.bin/rpcgen/rpc_scan.c","cppline",455,459
5,2,22,1,4,"directive@462-466@usr.bin/rpcgen/rpc_scan.c","usr.bin/rpcgen/rpc_scan.c","directive",462,466
5,1,21,1,4,"printdirective@469-473@usr.bin/rpcgen/rpc_scan.c","usr.bin/rpcgen/rpc_scan.c","printdirective",469,473
41,10,209,3,41,"docppline@476-517@usr.bin/rpcgen/rpc_scan.c","usr.bin/rpcgen/rpc_scan.c","docppline",476,517
9,2,45,2,8,"p_xdrfunc@68-76@usr.bin/rpcgen/rpc_svcout.c","usr.bin/rpcgen/rpc_svcout.c","p_xdrfunc",68,76
7,1,37,1,6,"internal_proctype@79-85@usr.bin/rpcgen/rpc_svcout.c","usr.bin/rpcgen/rpc_svcout.c","internal_proctype",79,85
48,12,265,3,51,"write_most@91-142@usr.bin/rpcgen/rpc_svcout.c","usr.bin/rpcgen/rpc_svcout.c","write_most",91,142
47,4,344,1,48,"write_netid_register@148-196@usr.bin/rpcgen/rpc_svcout.c","usr.bin/rpcgen/rpc_svcout.c","write_netid_register",148,196
24,4,161,1,24,"write_nettype_register@202-226@usr.bin/rpcgen/rpc_svcout.c","usr.bin/rpcgen/rpc_svcout.c","write_nettype_register",202,226
25,4,145,0,24,"write_rest@232-256@usr.bin/rpcgen/rpc_svcout.c","usr.bin/rpcgen/rpc_svcout.c","write_rest",232,256
16,5,102,1,19,"write_programs@259-278@usr.bin/rpcgen/rpc_svcout.c","usr.bin/rpcgen/rpc_svcout.c","write_programs",259,278
50,10,368,1,53,"write_real_program@285-338@usr.bin/rpcgen/rpc_svcout.c","usr.bin/rpcgen/rpc_svcout.c","write_real_program",285,338
137,21,891,2,148,"write_program@341-489@usr.bin/rpcgen/rpc_svcout.c","usr.bin/rpcgen/rpc_svcout.c","write_program",341,489
6,1,27,2,5,"printerr@492-497@usr.bin/rpcgen/rpc_svcout.c","usr.bin/rpcgen/rpc_svcout.c","printerr",492,497
9,1,45,4,8,"printif@500-508@usr.bin/rpcgen/rpc_svcout.c","usr.bin/rpcgen/rpc_svcout.c","printif",500,508
9,3,46,1,8,"nullproc@511-519@usr.bin/rpcgen/rpc_svcout.c","usr.bin/rpcgen/rpc_svcout.c","nullproc",511,519
27,1,164,1,26,"write_inetmost@522-548@usr.bin/rpcgen/rpc_svcout.c","usr.bin/rpcgen/rpc_svcout.c","write_inetmost",522,548
11,3,48,1,10,"print_return@551-561@usr.bin/rpcgen/rpc_svcout.c","usr.bin/rpcgen/rpc_svcout.c","print_return",551,561
17,4,101,1,17,"print_pmapunset@564-581@usr.bin/rpcgen/rpc_svcout.c","usr.bin/rpcgen/rpc_svcout.c","print_pmapunset",564,581
10,4,55,1,9,"print_err_message@584-593@usr.bin/rpcgen/rpc_svcout.c","usr.bin/rpcgen/rpc_svcout.c","print_err_message",584,593
10,4,35,1,9,"write_svc_aux@599-608@usr.bin/rpcgen/rpc_svcout.c","usr.bin/rpcgen/rpc_svcout.c","write_svc_aux",599,608
23,4,133,0,22,"write_msg_out@615-637@usr.bin/rpcgen/rpc_svcout.c","usr.bin/rpcgen/rpc_svcout.c","write_msg_out",615,637
30,4,177,0,29,"write_timeout_func@643-672@usr.bin/rpcgen/rpc_svcout.c","usr.bin/rpcgen/rpc_svcout.c","write_timeout_func",643,672
24,1,110,0,32,"write_caller_func@675-707@usr.bin/rpcgen/rpc_svcout.c","usr.bin/rpcgen/rpc_svcout.c","write_caller_func",675,707
75,10,485,2,81,"write_pm_most@713-794@usr.bin/rpcgen/rpc_svcout.c","usr.bin/rpcgen/rpc_svcout.c","write_pm_most",713,794
47,7,322,2,50,"write_rpc_svc_fg@800-850@usr.bin/rpcgen/rpc_svcout.c","usr.bin/rpcgen/rpc_svcout.c","write_rpc_svc_fg",800,850
12,3,58,2,12,"open_log_file@853-865@usr.bin/rpcgen/rpc_svcout.c","usr.bin/rpcgen/rpc_svcout.c","open_log_file",853,865
77,21,510,1,82,"write_inetd_register@871-953@usr.bin/rpcgen/rpc_svcout.c","usr.bin/rpcgen/rpc_svcout.c","write_inetd_register",871,953
11,3,61,0,11,"write_tables@63-74@usr.bin/rpcgen/rpc_tblout.c","usr.bin/rpcgen/rpc_tblout.c","write_tables",63,74
54,9,329,1,64,"write_table@77-141@usr.bin/rpcgen/rpc_tblout.c","usr.bin/rpcgen/rpc_tblout.c","write_table",77,141
18,2,121,2,22,"printit@144-166@usr.bin/rpcgen/rpc_tblout.c","usr.bin/rpcgen/rpc_tblout.c","printit",144,166
7,1,26,0,6,"reinitialize@70-76@usr.bin/rpcgen/rpc_util.c","usr.bin/rpcgen/rpc_util.c","reinitialize",70,76
6,1,28,2,5,"streq@82-87@usr.bin/rpcgen/rpc_util.c","usr.bin/rpcgen/rpc_util.c","streq",82,87
5,2,38,1,4,"for@99-103@usr.bin/rpcgen/rpc_util.c","usr.bin/rpcgen/rpc_util.c","for",99,103
17,3,97,2,17,"storeval@111-128@usr.bin/rpcgen/rpc_util.c","usr.bin/rpcgen/rpc_util.c","storeval",111,128
4,1,24,2,3,"findit@131-134@usr.bin/rpcgen/rpc_util.c","usr.bin/rpcgen/rpc_util.c","findit",131,134
16,5,102,2,16,"fixit@137-153@usr.bin/rpcgen/rpc_util.c","usr.bin/rpcgen/rpc_util.c","fixit",137,153
5,1,20,1,4,"fixtype@156-160@usr.bin/rpcgen/rpc_util.c","usr.bin/rpcgen/rpc_util.c","fixtype",156,160
9,2,34,1,8,"stringfix@163-171@usr.bin/rpcgen/rpc_util.c","usr.bin/rpcgen/rpc_util.c","stringfix",163,171
20,6,113,3,19,"ptype@174-193@usr.bin/rpcgen/rpc_util.c","usr.bin/rpcgen/rpc_util.c","ptype",174,193
7,3,48,2,6,"typedefed@196-202@usr.bin/rpcgen/rpc_util.c","usr.bin/rpcgen/rpc_util.c","typedefed",196,202
22,7,111,2,22,"isvectordef@205-227@usr.bin/rpcgen/rpc_util.c","usr.bin/rpcgen/rpc_util.c","isvectordef",205,227
11,4,70,1,11,"locase@230-241@usr.bin/rpcgen/rpc_util.c","usr.bin/rpcgen/rpc_util.c","locase",230,241
6,1,30,2,5,"pvname_svc@244-249@usr.bin/rpcgen/rpc_util.c","usr.bin/rpcgen/rpc_util.c","pvname_svc",244,249
6,1,30,2,5,"pvname@252-257@usr.bin/rpcgen/rpc_util.c","usr.bin/rpcgen/rpc_util.c","pvname",252,257
8,1,38,1,7,"error@263-270@usr.bin/rpcgen/rpc_util.c","usr.bin/rpcgen/rpc_util.c","error",263,270
8,2,39,0,8,"crash@277-285@usr.bin/rpcgen/rpc_util.c","usr.bin/rpcgen/rpc_util.c","crash",277,285
10,2,40,1,9,"record_open@288-297@usr.bin/rpcgen/rpc_util.c","usr.bin/rpcgen/rpc_util.c","record_open",288,297
7,1,29,1,6,"expected1@306-312@usr.bin/rpcgen/rpc_util.c","usr.bin/rpcgen/rpc_util.c","expected1",306,312
7,1,38,2,6,"expected2@318-324@usr.bin/rpcgen/rpc_util.c","usr.bin/rpcgen/rpc_util.c","expected2",318,324
7,1,47,3,6,"expected3@330-336@usr.bin/rpcgen/rpc_util.c","usr.bin/rpcgen/rpc_util.c","expected3",330,336
8,2,32,2,7,"tabify@339-346@usr.bin/rpcgen/rpc_util.c","usr.bin/rpcgen/rpc_util.c","tabify",339,346
7,3,40,1,7,"toktostr@386-393@usr.bin/rpcgen/rpc_util.c","usr.bin/rpcgen/rpc_util.c","toktostr",386,393
17,4,81,1,19,"printbuf@396-415@usr.bin/rpcgen/rpc_util.c","usr.bin/rpcgen/rpc_util.c","printbuf",396,415
19,4,94,0,19,"printwhere@418-437@usr.bin/rpcgen/rpc_util.c","usr.bin/rpcgen/rpc_util.c","printwhere",418,437
14,2,89,2,14,"make_argname@440-454@usr.bin/rpcgen/rpc_util.c","usr.bin/rpcgen/rpc_util.c","make_argname",440,454
20,3,100,2,21,"add_type@460-481@usr.bin/rpcgen/rpc_util.c","usr.bin/rpcgen/rpc_util.c","add_type",460,481
13,3,56,1,14,"find_type@484-498@usr.bin/rpcgen/rpc_util.c","usr.bin/rpcgen/rpc_util.c","find_type",484,498
89,28,386,2,108,"main@84-192@usr.bin/rpcinfo/rpcinfo.c","usr.bin/rpcinfo/rpcinfo.c","main",84,192
117,19,798,3,133,"udpping@195-328@usr.bin/rpcinfo/rpcinfo.c","usr.bin/rpcinfo/rpcinfo.c","udpping",195,328
105,17,724,3,120,"tcpping@331-451@usr.bin/rpcinfo/rpcinfo.c","usr.bin/rpcinfo/rpcinfo.c","tcpping",331,451
15,2,75,3,15,"pstatus@461-476@usr.bin/rpcinfo/rpcinfo.c","usr.bin/rpcinfo/rpcinfo.c","pstatus",461,476
59,11,383,2,60,"pmapdump@479-539@usr.bin/rpcinfo/rpcinfo.c","usr.bin/rpcinfo/rpcinfo.c","pmapdump",479,539
9,2,67,2,9,"reply_proc@548-557@usr.bin/rpcinfo/rpcinfo.c","usr.bin/rpcinfo/rpcinfo.c","reply_proc",548,557
19,6,134,2,20,"brdcst@560-580@usr.bin/rpcinfo/rpcinfo.c","usr.bin/rpcinfo/rpcinfo.c","brdcst",560,580
16,5,101,2,17,"deletereg@583-600@usr.bin/rpcinfo/rpcinfo.c","usr.bin/rpcinfo/rpcinfo.c","deletereg",583,600
28,8,194,2,29,"setreg@603-632@usr.bin/rpcinfo/rpcinfo.c","usr.bin/rpcinfo/rpcinfo.c","setreg",603,632
15,2,68,1,14,"usage@635-649@usr.bin/rpcinfo/rpcinfo.c","usr.bin/rpcinfo/rpcinfo.c","usage",635,649
15,3,74,2,15,"getprognum@652-667@usr.bin/rpcinfo/rpcinfo.c","usr.bin/rpcinfo/rpcinfo.c","getprognum",652,667
18,5,95,2,18,"getul@670-688@usr.bin/rpcinfo/rpcinfo.c","usr.bin/rpcinfo/rpcinfo.c","getul",670,688
14,3,102,2,14,"get_inet_address@691-705@usr.bin/rpcinfo/rpcinfo.c","usr.bin/rpcinfo/rpcinfo.c","get_inet_address",691,705
15,3,85,2,16,"main@101-117@usr.bin/rs/rs.c","usr.bin/rs/rs.c","main",101,117
66,24,373,1,66,"getfile@120-186@usr.bin/rs/rs.c","usr.bin/rs/rs.c","getfile",120,186
22,8,142,1,22,"putfile@189-211@usr.bin/rs/rs.c","usr.bin/rs/rs.c","putfile",189,211
11,5,73,2,11,"prints@214-225@usr.bin/rs/rs.c","usr.bin/rs/rs.c","prints",214,225
8,1,25,1,8,"usage@228-236@usr.bin/rs/rs.c","usr.bin/rs/rs.c","usage",228,236
69,28,471,1,69,"prepfile@239-308@usr.bin/rs/rs.c","usr.bin/rs/rs.c","prepfile",239,308
15,7,97,1,17,"get_line@311-328@usr.bin/rs/rs.c","usr.bin/rs/rs.c","get_line",311,328
14,3,86,1,15,"getptrs@331-346@usr.bin/rs/rs.c","usr.bin/rs/rs.c","getptrs",331,346
116,37,504,2,124,"getargs@349-473@usr.bin/rs/rs.c","usr.bin/rs/rs.c","getargs",349,473
36,7,202,2,38,"mbsavis@23-61@usr.bin/rs/utf8.c","usr.bin/rs/utf8.c","mbsavis",23,61
11,4,63,1,12,"search_host@60-72@usr.bin/rup/rup.c","usr.bin/rup/rup.c","search_host",60,72
10,2,58,1,11,"remember_host@75-86@usr.bin/rup/rup.c","usr.bin/rup/rup.c","remember_host",75,86
17,4,99,2,18,"compare@106-124@usr.bin/rup/rup.c","usr.bin/rup/rup.c","compare",106,124
19,4,113,2,21,"remember_rup_data@127-148@usr.bin/rup/rup.c","usr.bin/rup/rup.c","remember_rup_data",127,148
20,4,121,2,23,"rstat_reply@152-175@usr.bin/rup/rup.c","usr.bin/rup/rup.c","rstat_reply",152,175
47,11,355,2,55,"print_rup_data@179-234@usr.bin/rup/rup.c","usr.bin/rup/rup.c","print_rup_data",179,234
26,4,158,1,29,"onehost@238-267@usr.bin/rup/rup.c","usr.bin/rup/rup.c","onehost",238,267
16,4,93,1,17,"allhosts@270-287@usr.bin/rup/rup.c","usr.bin/rup/rup.c","allhosts",270,287
40,10,196,2,46,"main@290-336@usr.bin/rup/rup.c","usr.bin/rup/rup.c","main",290,336
5,1,18,1,4,"usage@340-344@usr.bin/rup/rup.c","usr.bin/rup/rup.c","usage",340,344
52,21,273,2,58,"main@114-172@usr.bin/rusers/rusers.c","usr.bin/rusers/rusers.c","main",114,172
18,6,122,1,21,"add_host@175-196@usr.bin/rusers/rusers.c","usr.bin/rusers/rusers.c","add_host",175,196
33,7,209,3,33,"fmt_idle@199-232@usr.bin/rusers/rusers.c","usr.bin/rusers/rusers.c","fmt_idle",199,232
48,14,390,2,52,"rusers_reply@235-287@usr.bin/rusers/rusers.c","usr.bin/rusers/rusers.c","rusers_reply",235,287
48,14,382,2,52,"rusers_reply_3@290-342@usr.bin/rusers/rusers.c","usr.bin/rusers/rusers.c","rusers_reply_3",290,342
52,7,332,1,59,"onehost@345-404@usr.bin/rusers/rusers.c","usr.bin/rusers/rusers.c","onehost",345,404
38,8,297,6,45,"get_reply@407-452@usr.bin/rusers/rusers.c","usr.bin/rusers/rusers.c","get_reply",407,452
21,5,190,6,25,"rpc_setup@455-480@usr.bin/rusers/rusers.c","usr.bin/rusers/rusers.c","rpc_setup",455,480
121,26,1024,1,145,"allhosts@483-628@usr.bin/rusers/rusers.c","usr.bin/rusers/rusers.c","allhosts",483,628
38,7,327,2,39,"print_entry@631-670@usr.bin/rusers/rusers.c","usr.bin/rusers/rusers.c","print_entry",631,670
23,5,179,1,24,"expandhosts@673-697@usr.bin/rusers/rusers.c","usr.bin/rusers/rusers.c","expandhosts",673,697
16,7,102,1,18,"sorthosts@700-718@usr.bin/rusers/rusers.c","usr.bin/rusers/rusers.c","sorthosts",700,718
17,6,136,2,20,"hcompare@721-741@usr.bin/rusers/rusers.c","usr.bin/rusers/rusers.c","hcompare",721,741
14,5,118,2,16,"icompare@744-760@usr.bin/rusers/rusers.c","usr.bin/rusers/rusers.c","icompare",744,760
14,5,118,2,16,"ucompare@763-779@usr.bin/rusers/rusers.c","usr.bin/rusers/rusers.c","ucompare",763,779
4,1,8,1,4,"alarmclock@782-786@usr.bin/rusers/rusers.c","usr.bin/rusers/rusers.c","alarmclock",782,786
11,3,85,2,13,"estrndup@789-802@usr.bin/rusers/rusers.c","usr.bin/rusers/rusers.c","estrndup",789,802
6,1,20,1,6,"usage@805-811@usr.bin/rusers/rusers.c","usr.bin/rusers/rusers.c","usage",805,811
23,5,146,2,41,"main@60-101@usr.bin/rwall/rwall.c","usr.bin/rwall/rwall.c","main",60,101
37,11,342,1,49,"makemsg@104-153@usr.bin/rwall/rwall.c","usr.bin/rwall/rwall.c","makemsg",104,153
88,26,545,2,98,"main@99-197@usr.bin/script/script.c","usr.bin/script/script.c","main",99,197
15,4,79,1,15,"finish@201-216@usr.bin/script/script.c","usr.bin/script/script.c","finish",201,216
12,3,72,1,12,"handlesigwinch@220-232@usr.bin/script/script.c","usr.bin/script/script.c","handlesigwinch",220,232
56,13,381,1,60,"dooutput@235-295@usr.bin/script/script.c","usr.bin/script/script.c","dooutput",235,295
4,1,11,1,3,"scriptflush@299-302@usr.bin/script/script.c","usr.bin/script/script.c","scriptflush",299,302
13,2,74,1,14,"doshell@305-319@usr.bin/script/script.c","usr.bin/script/script.c","doshell",305,319
5,1,21,1,5,"fail@322-327@usr.bin/script/script.c","usr.bin/script/script.c","fail",322,327
15,3,90,1,15,"done@330-345@usr.bin/script/script.c","usr.bin/script/script.c","done",330,345
6,2,30,1,5,"cleanup@15-20@usr.bin/sdiff/common.c","usr.bin/sdiff/common.c","cleanup",15,20
41,11,303,1,43,"editit@33-76@usr.bin/sdiff/edit.c","usr.bin/sdiff/edit.c","editit",33,76
84,27,511,3,124,"eparse@82-206@usr.bin/sdiff/edit.c","usr.bin/sdiff/edit.c","eparse",82,206
47,13,287,1,58,"mktmpcpy@96-154@usr.bin/sdiff/sdiff.c","usr.bin/sdiff/sdiff.c","mktmpcpy",96,154
155,50,989,2,216,"main@157-373@usr.bin/sdiff/sdiff.c","usr.bin/sdiff/sdiff.c","main",157,373
19,6,99,3,32,"printcol@382-414@usr.bin/sdiff/sdiff.c","usr.bin/sdiff/sdiff.c","printcol",382,414
45,14,204,2,75,"prompt@421-496@usr.bin/sdiff/sdiff.c","usr.bin/sdiff/sdiff.c","prompt",421,496
22,6,116,3,37,"println@508-545@usr.bin/sdiff/sdiff.c","usr.bin/sdiff/sdiff.c","println",508,545
13,4,81,1,17,"xfgets@552-569@usr.bin/sdiff/sdiff.c","usr.bin/sdiff/sdiff.c","xfgets",552,569
122,40,808,3,179,"parsecmd@577-756@usr.bin/sdiff/sdiff.c","usr.bin/sdiff/sdiff.c","parsecmd",577,756
10,2,71,3,10,"enqueue@762-772@usr.bin/sdiff/sdiff.c","usr.bin/sdiff/sdiff.c","enqueue",762,772
6,1,28,1,5,"freediff@778-783@usr.bin/sdiff/sdiff.c","usr.bin/sdiff/sdiff.c","freediff",778,783
27,5,179,2,59,"astrcat@790-849@usr.bin/sdiff/sdiff.c","usr.bin/sdiff/sdiff.c","astrcat",790,849
37,16,230,1,57,"processq@856-913@usr.bin/sdiff/sdiff.c","usr.bin/sdiff/sdiff.c","processq",856,913
10,3,59,2,11,"printa@919-930@usr.bin/sdiff/sdiff.c","usr.bin/sdiff/sdiff.c","printa",919,930
45,10,307,4,67,"printc@937-1004@usr.bin/sdiff/sdiff.c","usr.bin/sdiff/sdiff.c","printc",937,1004
10,3,59,2,11,"printd@1010-1021@usr.bin/sdiff/sdiff.c","usr.bin/sdiff/sdiff.c","printd",1010,1021
12,1,19,1,11,"int_usage@1027-1038@usr.bin/sdiff/sdiff.c","usr.bin/sdiff/sdiff.c","int_usage",1027,1038
8,1,25,1,8,"usage@1041-1049@usr.bin/sdiff/sdiff.c","usr.bin/sdiff/sdiff.c","usage",1041,1049
8,1,57,1,7,"compile@126-133@usr.bin/sed/compile.c","usr.bin/sed/compile.c","compile",126,133
186,45,1019,1,197,"compile_stream@143-340@usr.bin/sed/compile.c","usr.bin/sed/compile.c","compile_stream",143,340
36,18,251,3,36,"compile_delimited@352-388@usr.bin/sed/compile.c","usr.bin/sed/compile.c","compile_delimited",352,388
26,13,225,2,26,"compile_ccl@393-419@usr.bin/sed/compile.c","usr.bin/sed/compile.c","compile_ccl",393,419
19,6,150,2,19,"compile_re@431-450@usr.bin/sed/compile.c","usr.bin/sed/compile.c","compile_re",431,450
60,18,377,2,74,"compile_subst@458-532@usr.bin/sed/compile.c","usr.bin/sed/compile.c","compile_subst",458,532
74,29,391,2,76,"compile_flags@538-614@usr.bin/sed/compile.c","usr.bin/sed/compile.c","compile_flags",538,614
39,8,266,2,40,"compile_tr@620-660@usr.bin/sed/compile.c","usr.bin/sed/compile.c","compile_tr",620,660
32,9,212,1,32,"compile_text@666-698@usr.bin/sed/compile.c","usr.bin/sed/compile.c","compile_text",666,698
25,15,158,2,28,"compile_addr@705-733@usr.bin/sed/compile.c","usr.bin/sed/compile.c","compile_addr",705,733
23,9,160,3,23,"duptoeol@740-763@usr.bin/sed/compile.c","usr.bin/sed/compile.c","duptoeol",740,763
23,9,129,2,25,"fixuplabel@773-798@usr.bin/sed/compile.c","usr.bin/sed/compile.c","fixuplabel",773,798
18,5,167,1,18,"enterlabel@804-822@usr.bin/sed/compile.c","usr.bin/sed/compile.c","enterlabel",804,822
15,5,125,1,15,"findlabel@829-844@usr.bin/sed/compile.c","usr.bin/sed/compile.c","findlabel",829,844
14,4,80,1,14,"uselabel@851-865@usr.bin/sed/compile.c","usr.bin/sed/compile.c","uselabel",851,865
88,36,531,2,95,"main@111-206@usr.bin/sed/main.c","usr.bin/sed/main.c","main",111,206
92,23,519,2,94,"cu_fgets@213-307@usr.bin/sed/main.c","usr.bin/sed/main.c","cu_fgets",213,307
111,30,682,2,126,"mf_fgets@314-440@usr.bin/sed/main.c","usr.bin/sed/main.c","mf_fgets",314,440
10,1,58,2,10,"add_compunit@446-456@usr.bin/sed/main.c","usr.bin/sed/main.c","add_compunit",446,456
9,1,48,1,9,"add_file@462-471@usr.bin/sed/main.c","usr.bin/sed/main.c","add_file",462,471
18,4,96,0,23,"next_files_have_lines@475-498@usr.bin/sed/main.c","usr.bin/sed/main.c","next_files_have_lines",475,498
16,5,73,1,16,"lastline@501-517@usr.bin/sed/main.c","usr.bin/sed/main.c","lastline",501,517
7,2,41,1,7,"xmalloc@52-59@usr.bin/sed/misc.c","usr.bin/sed/misc.c","xmalloc",52,59
7,2,52,3,7,"xreallocarray@62-69@usr.bin/sed/misc.c","usr.bin/sed/misc.c","xreallocarray",62,69
6,2,43,2,6,"xrealloc@75-81@usr.bin/sed/misc.c","usr.bin/sed/misc.c","xrealloc",75,81
10,1,63,2,10,"strregerror@89-99@usr.bin/sed/misc.c","usr.bin/sed/misc.c","strregerror",89,99
14,2,89,3,14,"error@105-119@usr.bin/sed/misc.c","usr.bin/sed/misc.c","error",105,119
10,1,72,2,10,"warning@122-132@usr.bin/sed/misc.c","usr.bin/sed/misc.c","warning",122,132
175,58,959,1,176,"process@86-262@usr.bin/sed/process.c","usr.bin/sed/process.c","process",86,262
26,10,148,1,32,"applies@277-309@usr.bin/sed/process.c","usr.bin/sed/process.c","applies",277,309
7,4,49,1,7,"resetranges@315-322@usr.bin/sed/process.c","usr.bin/sed/process.c","resetranges",315,322
77,28,630,1,105,"substitute@331-436@usr.bin/sed/process.c","usr.bin/sed/process.c","substitute",331,436
23,8,182,1,31,"flush_appends@443-474@usr.bin/sed/process.c","usr.bin/sed/process.c","flush_appends",443,474
36,10,258,1,36,"lputs@477-513@usr.bin/sed/process.c","usr.bin/sed/process.c","lputs",477,513
21,6,131,6,24,"regexec_e@516-540@usr.bin/sed/process.c","usr.bin/sed/process.c","regexec_e",516,540
29,11,222,3,37,"regsub@547-584@usr.bin/sed/process.c","usr.bin/sed/process.c","regsub",547,584
14,3,113,4,18,"cspace@592-610@usr.bin/sed/process.c","usr.bin/sed/process.c","cspace",592,610
20,9,163,2,20,"cfclose@616-636@usr.bin/sed/process.c","usr.bin/sed/process.c","cfclose",616,636
28,7,158,4,28,"atomicio@39-67@usr.bin/sendbug/atomicio.c","usr.bin/sendbug/atomicio.c","atomicio",39,67
6,1,25,1,6,"usage@63-69@usr.bin/sendbug/sendbug.c","usr.bin/sendbug/sendbug.c","usage",63,69
5,4,24,0,4,"cleanup@72-76@usr.bin/sendbug/sendbug.c","usr.bin/sendbug/sendbug.c","cleanup",72,76
95,28,541,2,107,"main@80-187@usr.bin/sendbug/sendbug.c","usr.bin/sendbug/sendbug.c","main",80,187
32,10,189,1,36,"dmesg@190-226@usr.bin/sendbug/sendbug.c","usr.bin/sendbug/sendbug.c","dmesg",190,226
16,5,92,1,16,"usbdevs@229-245@usr.bin/sendbug/sendbug.c","usr.bin/sendbug/sendbug.c","usbdevs",229,245
42,11,305,1,44,"editit@254-298@usr.bin/sendbug/sendbug.c","usr.bin/sendbug/sendbug.c","editit",254,298
14,5,74,1,14,"prompt@301-315@usr.bin/sendbug/sendbug.c","usr.bin/sendbug/sendbug.c","prompt",301,315
42,8,230,1,43,"sendmail@318-361@usr.bin/sendbug/sendbug.c","usr.bin/sendbug/sendbug.c","sendmail",318,361
38,10,300,1,43,"init@364-407@usr.bin/sendbug/sendbug.c","usr.bin/sendbug/sendbug.c","init",364,407
57,14,365,2,65,"send_file@410-475@usr.bin/sendbug/sendbug.c","usr.bin/sendbug/sendbug.c","send_file",410,475
25,8,136,3,28,"matchline@482-510@usr.bin/sendbug/sendbug.c","usr.bin/sendbug/sendbug.c","matchline",482,510
30,12,190,1,30,"checkfile@516-546@usr.bin/sendbug/sendbug.c","usr.bin/sendbug/sendbug.c","checkfile",516,546
49,5,336,1,50,"template@549-599@usr.bin/sendbug/sendbug.c","usr.bin/sendbug/sendbug.c","template",549,599
29,9,189,1,31,"hwdump@602-633@usr.bin/sendbug/sendbug.c","usr.bin/sendbug/sendbug.c","hwdump",602,633
23,9,161,1,23,"debase@636-659@usr.bin/sendbug/sendbug.c","usr.bin/sendbug/sendbug.c","debase",636,659
122,25,660,2,132,"main@96-228@usr.bin/showmount/showmount.c","usr.bin/showmount/showmount.c","main",96,228
66,16,356,2,71,"xdr_mntdump@234-305@usr.bin/showmount/showmount.c","usr.bin/showmount/showmount.c","xdr_mntdump",234,305
38,11,242,2,38,"xdr_exports@311-349@usr.bin/showmount/showmount.c","usr.bin/showmount/showmount.c","xdr_exports",311,349
5,1,18,1,5,"usage@352-357@usr.bin/showmount/showmount.c","usr.bin/showmount/showmount.c","usage",352,357
26,6,154,1,26,"print_dump@363-389@usr.bin/showmount/showmount.c","usr.bin/showmount/showmount.c","print_dump",363,389
9,1,50,3,9,"crypto_hash_sha512@14-23@usr.bin/signify/crypto_api.c","usr.bin/signify/crypto_api.c","crypto_hash_sha512",14,23
4,2,31,2,3,"crypto_verify_32@26-29@usr.bin/signify/crypto_api.c","usr.bin/signify/crypto_api.c","crypto_verify_32",26,29
7,1,29,2,6,"equal@14-20@usr.bin/signify/fe25519.c","usr.bin/signify/fe25519.c","equal",14,20
8,1,36,2,7,"ge@22-29@usr.bin/signify/fe25519.c","usr.bin/signify/fe25519.c","ge",22,29
4,1,24,1,3,"times19@31-34@usr.bin/signify/fe25519.c","usr.bin/signify/fe25519.c","times19",31,34
4,1,29,1,3,"times38@36-39@usr.bin/signify/fe25519.c","usr.bin/signify/fe25519.c","times38",36,39
18,3,115,1,18,"reduce_add_sub@41-59@usr.bin/signify/fe25519.c","usr.bin/signify/fe25519.c","reduce_add_sub",41,59
18,3,115,1,18,"reduce_mul@61-79@usr.bin/signify/fe25519.c","usr.bin/signify/fe25519.c","reduce_mul",61,79
13,3,118,1,14,"fe25519_freeze@82-96@usr.bin/signify/fe25519.c","usr.bin/signify/fe25519.c","fe25519_freeze",82,96
6,2,53,2,5,"fe25519_unpack@98-103@usr.bin/signify/fe25519.c","usr.bin/signify/fe25519.c","fe25519_unpack",98,103
8,2,56,2,7,"fe25519_pack@106-113@usr.bin/signify/fe25519.c","usr.bin/signify/fe25519.c","fe25519_pack",106,113
11,2,71,1,10,"fe25519_iszero@115-125@usr.bin/signify/fe25519.c","usr.bin/signify/fe25519.c","fe25519_iszero",115,125
11,3,76,2,10,"fe25519_iseq_vartime@127-137@usr.bin/signify/fe25519.c","usr.bin/signify/fe25519.c","fe25519_iseq_vartime",127,137
7,2,68,3,6,"fe25519_cmov@139-145@usr.bin/signify/fe25519.c","usr.bin/signify/fe25519.c","fe25519_cmov",139,145
6,1,31,1,5,"fe25519_getparity@147-152@usr.bin/signify/fe25519.c","usr.bin/signify/fe25519.c","fe25519_getparity",147,152
6,2,42,1,5,"fe25519_setone@154-159@usr.bin/signify/fe25519.c","usr.bin/signify/fe25519.c","fe25519_setone",154,159
5,2,33,1,4,"fe25519_setzero@161-165@usr.bin/signify/fe25519.c","usr.bin/signify/fe25519.c","fe25519_setzero",161,165
8,2,61,2,7,"fe25519_neg@167-174@usr.bin/signify/fe25519.c","usr.bin/signify/fe25519.c","fe25519_neg",167,174
6,2,60,3,5,"fe25519_add@176-181@usr.bin/signify/fe25519.c","usr.bin/signify/fe25519.c","fe25519_add",176,181
10,3,119,3,9,"fe25519_sub@183-192@usr.bin/signify/fe25519.c","usr.bin/signify/fe25519.c","fe25519_sub",183,192
13,5,150,3,15,"fe25519_mul@194-209@usr.bin/signify/fe25519.c","usr.bin/signify/fe25519.c","fe25519_mul",194,209
4,1,22,2,3,"fe25519_square@211-214@usr.bin/signify/fe25519.c","usr.bin/signify/fe25519.c","fe25519_square",211,214
57,7,613,2,65,"fe25519_invert@216-281@usr.bin/signify/fe25519.c","usr.bin/signify/fe25519.c","fe25519_invert",216,281
44,8,456,2,52,"fe25519_pow2523@283-335@usr.bin/signify/fe25519.c","usr.bin/signify/fe25519.c","fe25519_pow2523",283,335
8,4,116,5,9,"get_hram@13-22@usr.bin/signify/mod_ed25519.c","usr.bin/signify/mod_ed25519.c","get_hram",13,22
21,2,120,2,23,"crypto_sign_ed25519_keypair@25-48@usr.bin/signify/mod_ed25519.c","usr.bin/signify/mod_ed25519.c","crypto_sign_ed25519_keypair",25,48
39,5,325,5,50,"crypto_sign_ed25519@50-100@usr.bin/signify/mod_ed25519.c","usr.bin/signify/mod_ed25519.c","crypto_sign_ed25519",50,100
34,6,233,5,41,"crypto_sign_ed25519_open@102-143@usr.bin/signify/mod_ed25519.c","usr.bin/signify/mod_ed25519.c","crypto_sign_ed25519_open",102,143
6,1,67,2,5,"p1p1_to_p2@70-75@usr.bin/signify/mod_ge25519.c","usr.bin/signify/mod_ge25519.c","p1p1_to_p2",70,75
5,1,42,2,4,"p1p1_to_p3@77-81@usr.bin/signify/mod_ge25519.c","usr.bin/signify/mod_ge25519.c","p1p1_to_p3",77,81
22,1,286,2,21,"ge25519_mixadd2@84-105@usr.bin/signify/mod_ge25519.c","usr.bin/signify/mod_ge25519.c","ge25519_mixadd2",84,105
18,1,229,3,18,"add_p1p1@108-126@usr.bin/signify/mod_ge25519.c","usr.bin/signify/mod_ge25519.c","add_p1p1",108,126
16,1,183,2,16,"dbl_p1p1@129-145@usr.bin/signify/mod_ge25519.c","usr.bin/signify/mod_ge25519.c","dbl_p1p1",129,145
5,1,47,3,4,"cmov_aff@149-153@usr.bin/signify/mod_ge25519.c","usr.bin/signify/mod_ge25519.c","cmov_aff",149,153
10,1,49,2,9,"equal@155-164@usr.bin/signify/mod_ge25519.c","usr.bin/signify/mod_ge25519.c","equal",155,164
6,1,23,1,5,"negative@166-171@usr.bin/signify/mod_ge25519.c","usr.bin/signify/mod_ge25519.c","negative",166,171
11,1,172,3,11,"choose_t@173-184@usr.bin/signify/mod_ge25519.c","usr.bin/signify/mod_ge25519.c","choose_t",173,184
7,1,40,1,6,"setneutral@187-193@usr.bin/signify/mod_ge25519.c","usr.bin/signify/mod_ge25519.c","setneutral",187,193
34,4,367,2,45,"ge25519_unpackneg_vartime@200-245@usr.bin/signify/mod_ge25519.c","usr.bin/signify/mod_ge25519.c","ge25519_unpackneg_vartime",200,245
9,1,84,2,8,"ge25519_pack@247-255@usr.bin/signify/mod_ge25519.c","usr.bin/signify/mod_ge25519.c","ge25519_pack",247,255
7,3,52,1,6,"ge25519_isneutral_vartime@257-263@usr.bin/signify/mod_ge25519.c","usr.bin/signify/mod_ge25519.c","ge25519_isneutral_vartime",257,263
38,4,578,5,42,"ge25519_double_scalarmult_vartime@266-308@usr.bin/signify/mod_ge25519.c","usr.bin/signify/mod_ge25519.c","ge25519_double_scalarmult_vartime",266,308
15,2,116,2,15,"ge25519_scalarmult_base@311-326@usr.bin/signify/mod_ge25519.c","usr.bin/signify/mod_ge25519.c","ge25519_scalarmult_base",311,326
7,1,32,2,6,"lt@19-25@usr.bin/signify/sc25519.c","usr.bin/signify/sc25519.c","lt",19,25
18,3,132,1,18,"reduce_add_sub@28-46@usr.bin/signify/sc25519.c","usr.bin/signify/sc25519.c","reduce_add_sub",28,46
39,12,368,2,49,"barrett_reduce@49-98@usr.bin/signify/sc25519.c","usr.bin/signify/sc25519.c","barrett_reduce",49,98
8,3,75,2,7,"sc25519_from32bytes@100-107@usr.bin/signify/sc25519.c","usr.bin/signify/sc25519.c","sc25519_from32bytes",100,107
5,2,44,2,4,"shortsc25519_from16bytes@109-113@usr.bin/signify/sc25519.c","usr.bin/signify/sc25519.c","shortsc25519_from16bytes",109,113
7,2,55,2,6,"sc25519_from64bytes@115-121@usr.bin/signify/sc25519.c","usr.bin/signify/sc25519.c","sc25519_from64bytes",115,121
8,3,67,2,7,"sc25519_from_shortsc@123-130@usr.bin/signify/sc25519.c","usr.bin/signify/sc25519.c","sc25519_from_shortsc",123,130
5,2,44,2,4,"sc25519_to32bytes@132-136@usr.bin/signify/sc25519.c","usr.bin/signify/sc25519.c","sc25519_to32bytes",132,136
7,3,42,1,6,"sc25519_iszero_vartime@138-144@usr.bin/signify/sc25519.c","usr.bin/signify/sc25519.c","sc25519_iszero_vartime",138,144
7,3,42,1,6,"sc25519_isshort_vartime@146-152@usr.bin/signify/sc25519.c","usr.bin/signify/sc25519.c","sc25519_isshort_vartime",146,152
10,4,73,2,9,"sc25519_lt_vartime@154-163@usr.bin/signify/sc25519.c","usr.bin/signify/sc25519.c","sc25519_lt_vartime",154,163
12,3,109,3,11,"sc25519_add@165-176@usr.bin/signify/sc25519.c","usr.bin/signify/sc25519.c","sc25519_add",165,176
12,2,84,3,11,"sc25519_sub_nored@178-189@usr.bin/signify/sc25519.c","usr.bin/signify/sc25519.c","sc25519_sub_nored",178,189
16,5,146,3,19,"sc25519_mul@191-210@usr.bin/signify/sc25519.c","usr.bin/signify/sc25519.c","sc25519_mul",191,210
6,1,39,3,5,"sc25519_mul_shortsc@212-217@usr.bin/signify/sc25519.c","usr.bin/signify/sc25519.c","sc25519_mul_shortsc",212,217
34,3,534,2,35,"sc25519_window3@219-254@usr.bin/signify/sc25519.c","usr.bin/signify/sc25519.c","sc25519_window3",219,254
34,3,534,2,35,"sc25519_window5@256-291@usr.bin/signify/sc25519.c","usr.bin/signify/sc25519.c","sc25519_window5",256,291
14,2,327,3,13,"sc25519_2interleave2@293-306@usr.bin/signify/sc25519.c","usr.bin/signify/sc25519.c","sc25519_2interleave2",293,306
12,2,42,1,13,"usage@75-88@usr.bin/signify/signify.c","usr.bin/signify/signify.c","usage",75,88
21,8,144,3,21,"xopen@91-112@usr.bin/signify/signify.c","usr.bin/signify/signify.c","xopen",91,112
7,2,35,1,7,"xmalloc@115-122@usr.bin/signify/signify.c","usr.bin/signify/signify.c","xmalloc",115,122
24,9,189,5,24,"parseb64file@125-149@usr.bin/signify/signify.c","usr.bin/signify/signify.c","parseb64file",125,149
12,2,111,4,12,"readb64file@152-164@usr.bin/signify/signify.c","usr.bin/signify/signify.c","readb64file",152,164
37,10,255,2,40,"readmsg@167-207@usr.bin/signify/signify.c","usr.bin/signify/signify.c","readmsg",167,207
10,3,72,4,10,"writeall@210-220@usr.bin/signify/signify.c","usr.bin/signify/signify.c","writeall",210,220
11,3,92,3,11,"createheader@224-235@usr.bin/signify/signify.c","usr.bin/signify/signify.c","createheader",224,235
11,1,92,6,11,"writekeyfile@238-249@usr.bin/signify/signify.c","usr.bin/signify/signify.c","writekeyfile",238,249
29,11,224,7,30,"kdf@252-282@usr.bin/signify/signify.c","usr.bin/signify/signify.c","kdf",252,282
10,1,67,4,10,"signmsg@285-295@usr.bin/signify/signify.c","usr.bin/signify/signify.c","signmsg",285,295
41,6,413,4,45,"generate@298-343@usr.bin/signify/signify.c","usr.bin/signify/signify.c","generate",298,343
27,9,166,2,31,"check_keyname_compliance@346-377@usr.bin/signify/signify.c","usr.bin/signify/signify.c","check_keyname_compliance",346,377
44,7,421,4,49,"createsig@380-429@usr.bin/signify/signify.c","usr.bin/signify/signify.c","createsig",380,429
17,2,122,4,20,"sign@432-452@usr.bin/signify/signify.c","usr.bin/signify/signify.c","sign",432,452
20,4,154,5,21,"verifymsg@456-477@usr.bin/signify/signify.c","usr.bin/signify/signify.c","verifymsg",456,477
16,4,96,2,17,"check_keytype@480-497@usr.bin/signify/signify.c","usr.bin/signify/signify.c","check_keytype",480,497
20,6,143,4,20,"readpubkey@500-520@usr.bin/signify/signify.c","usr.bin/signify/signify.c","readpubkey",500,520
14,1,107,5,17,"verifysimple@523-540@usr.bin/signify/signify.c","usr.bin/signify/signify.c","verifysimple",523,540
18,1,139,5,22,"verifyembedded@543-565@usr.bin/signify/signify.c","usr.bin/signify/signify.c","verifyembedded",543,565
17,2,118,6,17,"verify@568-585@usr.bin/signify/signify.c","usr.bin/signify/signify.c","verify",568,585
7,2,42,3,7,"ecalloc@596-603@usr.bin/signify/signify.c","usr.bin/signify/signify.c","ecalloc",596,603
4,1,17,2,3,"efree@606-609@usr.bin/signify/signify.c","usr.bin/signify/signify.c","efree",606,609
11,4,98,2,11,"recodehash@612-623@usr.bin/signify/signify.c","usr.bin/signify/signify.c","recodehash",612,623
20,7,148,2,20,"verifychecksum@626-646@usr.bin/signify/signify.c","usr.bin/signify/signify.c","verifychecksum",626,646
56,18,415,4,61,"verifychecksums@649-710@usr.bin/signify/signify.c","usr.bin/signify/signify.c","verifychecksums",649,710
9,1,69,5,10,"check@713-723@usr.bin/signify/signify.c","usr.bin/signify/signify.c","check",713,723
17,2,122,5,17,"verifyzdata@726-743@usr.bin/signify/signify.c","usr.bin/signify/signify.c","verifyzdata",726,743
148,53,734,2,166,"main@747-913@usr.bin/signify/signify.c","usr.bin/signify/signify.c","main",747,913
65,19,427,2,74,"readgz_header@56-130@usr.bin/signify/zsig.c","usr.bin/signify/zsig.c","readgz_header",56,130
38,11,251,6,43,"copy_blocks@133-176@usr.bin/signify/zsig.c","usr.bin/signify/zsig.c","copy_blocks",133,176
39,10,293,4,52,"zverify@179-231@usr.bin/signify/zsig.c","usr.bin/signify/zsig.c","zverify",179,231
67,12,488,3,78,"zsign@234-312@usr.bin/signify/zsig.c","usr.bin/signify/zsig.c","zsign",234,312
93,32,685,2,109,"main@39-148@usr.bin/skey/skey.c","usr.bin/skey/skey.c","main",39,148
7,1,21,1,6,"usage@151-157@usr.bin/skey/skey.c","usr.bin/skey/skey.c","usage",151,157
19,7,117,1,20,"sanitise_stdfd@44-64@usr.bin/skeyaudit/skeyaudit.c","usr.bin/skeyaudit/skeyaudit.c","sanitise_stdfd",44,64
80,26,498,2,96,"main@67-163@usr.bin/skeyaudit/skeyaudit.c","usr.bin/skeyaudit/skeyaudit.c","main",67,163
35,7,180,3,40,"notify@166-206@usr.bin/skeyaudit/skeyaudit.c","usr.bin/skeyaudit/skeyaudit.c","notify",166,206
30,6,214,2,37,"runsendmail@209-246@usr.bin/skeyaudit/skeyaudit.c","usr.bin/skeyaudit/skeyaudit.c","runsendmail",209,246
7,1,28,1,7,"usage@249-256@usr.bin/skeyaudit/skeyaudit.c","usr.bin/skeyaudit/skeyaudit.c","usage",249,256
51,17,333,2,58,"main@38-96@usr.bin/skeyinfo/skeyinfo.c","usr.bin/skeyinfo/skeyinfo.c","main",38,96
5,1,23,1,4,"usage@99-103@usr.bin/skeyinfo/skeyinfo.c","usr.bin/skeyinfo/skeyinfo.c","usage",99,103
233,83,1714,2,274,"main@47-321@usr.bin/skeyinit/skeyinit.c","usr.bin/skeyinit/skeyinit.c","main",47,321
76,21,518,6,83,"secure_mode@324-407@usr.bin/skeyinit/skeyinit.c","usr.bin/skeyinit/skeyinit.c","secure_mode",324,407
49,15,341,4,61,"normal_mode@410-471@usr.bin/skeyinit/skeyinit.c","usr.bin/skeyinit/skeyinit.c","normal_mode",410,471
14,8,112,1,15,"enable_db@474-489@usr.bin/skeyinit/skeyinit.c","usr.bin/skeyinit/skeyinit.c","enable_db",474,489
7,1,29,1,7,"usage@492-499@usr.bin/skeyinit/skeyinit.c","usr.bin/skeyinit/skeyinit.c","usage",492,499
8,1,40,1,7,"abuf_log@34-41@usr.bin/sndiod/abuf.c","usr.bin/sndiod/abuf.c","abuf_log",34,41
7,1,40,2,6,"abuf_init@45-51@usr.bin/sndiod/abuf.c","usr.bin/sndiod/abuf.c","abuf_init",45,51
12,4,61,1,13,"abuf_done@54-67@usr.bin/sndiod/abuf.c","usr.bin/sndiod/abuf.c","abuf_done",54,67
9,2,54,2,9,"abuf_rgetblk@73-82@usr.bin/sndiod/abuf.c","usr.bin/sndiod/abuf.c","abuf_rgetblk",73,82
13,5,75,2,14,"abuf_rdiscard@88-102@usr.bin/sndiod/abuf.c","usr.bin/sndiod/abuf.c","abuf_rdiscard",88,102
10,4,57,2,11,"abuf_wcommit@108-119@usr.bin/sndiod/abuf.c","usr.bin/sndiod/abuf.c","abuf_wcommit",108,119
13,3,84,2,13,"abuf_wgetblk@125-138@usr.bin/sndiod/abuf.c","usr.bin/sndiod/abuf.c","abuf_wgetblk",125,138
12,4,59,1,15,"dev_log@112-127@usr.bin/sndiod/dev.c","usr.bin/sndiod/dev.c","dev_log",112,127
21,5,119,1,24,"slot_log@130-154@usr.bin/sndiod/dev.c","usr.bin/sndiod/dev.c","slot_log",130,154
3,1,8,1,2,"zomb_onmove@157-159@usr.bin/sndiod/dev.c","usr.bin/sndiod/dev.c","zomb_onmove",157,159
3,1,8,1,2,"zomb_onvol@162-164@usr.bin/sndiod/dev.c","usr.bin/sndiod/dev.c","zomb_onvol",162,164
3,1,8,1,2,"zomb_fill@167-169@usr.bin/sndiod/dev.c","usr.bin/sndiod/dev.c","zomb_fill",167,169
3,1,8,1,2,"zomb_flush@172-174@usr.bin/sndiod/dev.c","usr.bin/sndiod/dev.c","zomb_flush",172,174
9,3,39,1,11,"zomb_eof@177-188@usr.bin/sndiod/dev.c","usr.bin/sndiod/dev.c","zomb_eof",177,188
8,3,33,1,10,"zomb_exit@191-201@usr.bin/sndiod/dev.c","usr.bin/sndiod/dev.c","zomb_exit",191,201
60,14,397,2,64,"dev_midi_qfr@207-271@usr.bin/sndiod/dev.c","usr.bin/sndiod/dev.c","dev_midi_qfr",207,271
41,5,397,1,44,"dev_midi_full@277-321@usr.bin/sndiod/dev.c","usr.bin/sndiod/dev.c","dev_midi_full",277,321
8,1,63,2,8,"dev_midi_vol@327-335@usr.bin/sndiod/dev.c","usr.bin/sndiod/dev.c","dev_midi_vol",327,335
14,1,109,1,14,"dev_midi_master@341-355@usr.bin/sndiod/dev.c","usr.bin/sndiod/dev.c","dev_midi_master",341,355
17,2,144,2,17,"dev_midi_slotdesc@361-378@usr.bin/sndiod/dev.c","usr.bin/sndiod/dev.c","dev_midi_slotdesc",361,378
18,2,124,1,18,"dev_midi_dump@381-399@usr.bin/sndiod/dev.c","usr.bin/sndiod/dev.c","dev_midi_dump",381,399
7,2,37,3,9,"dev_midi_imsg@402-411@usr.bin/sndiod/dev.c","usr.bin/sndiod/dev.c","dev_midi_imsg",402,411
82,28,465,3,82,"dev_midi_omsg@414-496@usr.bin/sndiod/dev.c","usr.bin/sndiod/dev.c","dev_midi_omsg",414,496
3,1,11,2,3,"dev_midi_fill@499-502@usr.bin/sndiod/dev.c","usr.bin/sndiod/dev.c","dev_midi_fill",499,502
10,3,46,1,10,"dev_midi_exit@505-515@usr.bin/sndiod/dev.c","usr.bin/sndiod/dev.c","dev_midi_exit",505,515
33,13,263,1,35,"slot_skip@518-553@usr.bin/sndiod/dev.c","usr.bin/sndiod/dev.c","slot_skip",518,553
25,4,238,4,27,"play_filt_resamp@556-583@usr.bin/sndiod/dev.c","usr.bin/sndiod/dev.c","play_filt_resamp",556,583
8,3,68,4,8,"play_filt_dec@586-594@usr.bin/sndiod/dev.c","usr.bin/sndiod/dev.c","play_filt_dec",586,594
16,3,123,2,18,"dev_mix_badd@601-619@usr.bin/sndiod/dev.c","usr.bin/sndiod/dev.c","dev_mix_badd",601,619
33,11,221,1,39,"dev_mix_adjvol@625-664@usr.bin/sndiod/dev.c","usr.bin/sndiod/dev.c","dev_mix_adjvol",625,664
24,5,232,4,26,"rec_filt_resamp@667-693@usr.bin/sndiod/dev.c","usr.bin/sndiod/dev.c","rec_filt_resamp",667,693
9,3,72,4,9,"rec_filt_enc@696-705@usr.bin/sndiod/dev.c","usr.bin/sndiod/dev.c","rec_filt_enc",696,705
19,5,154,2,21,"dev_sub_bcopy@711-732@usr.bin/sndiod/dev.c","usr.bin/sndiod/dev.c","dev_sub_bcopy",711,732
135,45,930,1,172,"dev_cycle@739-911@usr.bin/sndiod/dev.c","usr.bin/sndiod/dev.c","dev_cycle",739,911
16,4,127,2,20,"dev_onmove@917-937@usr.bin/sndiod/dev.c","usr.bin/sndiod/dev.c","dev_onmove",917,937
12,3,60,2,11,"dev_master@940-951@usr.bin/sndiod/dev.c","usr.bin/sndiod/dev.c","dev_master",940,951
4,2,25,1,3,"dev_getpos@957-960@usr.bin/sndiod/dev.c","usr.bin/sndiod/dev.c","dev_getpos",957,960
43,4,321,8,51,"dev_new@966-1017@usr.bin/sndiod/dev.c","usr.bin/sndiod/dev.c","dev_new",966,1017
13,5,78,4,12,"dev_adjpar@1023-1035@usr.bin/sndiod/dev.c","usr.bin/sndiod/dev.c","dev_adjpar",1023,1035
64,12,464,1,77,"dev_open@1042-1119@usr.bin/sndiod/dev.c","usr.bin/sndiod/dev.c","dev_open",1042,1119
27,9,163,1,29,"dev_close@1126-1155@usr.bin/sndiod/dev.c","usr.bin/sndiod/dev.c","dev_close",1126,1155
11,5,52,1,12,"dev_ref@1158-1170@usr.bin/sndiod/dev.c","usr.bin/sndiod/dev.c","dev_ref",1158,1170
10,5,51,1,11,"dev_unref@1173-1184@usr.bin/sndiod/dev.c","usr.bin/sndiod/dev.c","dev_unref",1173,1184
11,5,54,1,12,"dev_init@1190-1202@usr.bin/sndiod/dev.c","usr.bin/sndiod/dev.c","dev_init",1190,1202
11,5,51,1,12,"dev_done@1208-1220@usr.bin/sndiod/dev.c","usr.bin/sndiod/dev.c","dev_done",1208,1220
9,3,44,1,9,"dev_bynum@1223-1232@usr.bin/sndiod/dev.c","usr.bin/sndiod/dev.c","dev_bynum",1223,1232
21,7,118,1,25,"dev_del@1238-1263@usr.bin/sndiod/dev.c","usr.bin/sndiod/dev.c","dev_del",1238,1263
4,1,32,2,3,"dev_roundof@1266-1269@usr.bin/sndiod/dev.c","usr.bin/sndiod/dev.c","dev_roundof",1266,1269
18,4,87,1,23,"dev_wakeup@1275-1298@usr.bin/sndiod/dev.c","usr.bin/sndiod/dev.c","dev_wakeup",1275,1298
42,16,218,1,46,"dev_sync_attach@1305-1351@usr.bin/sndiod/dev.c","usr.bin/sndiod/dev.c","dev_sync_attach",1305,1351
12,4,51,1,13,"dev_mmcstart@1357-1370@usr.bin/sndiod/dev.c","usr.bin/sndiod/dev.c","dev_mmcstart",1357,1370
18,5,66,1,19,"dev_mmcstop@1376-1395@usr.bin/sndiod/dev.c","usr.bin/sndiod/dev.c","dev_mmcstop",1376,1395
14,4,75,2,13,"dev_mmcloc@1401-1414@usr.bin/sndiod/dev.c","usr.bin/sndiod/dev.c","dev_mmcloc",1401,1414
109,34,769,5,130,"slot_new@1420-1550@usr.bin/sndiod/dev.c","usr.bin/sndiod/dev.c","slot_new",1420,1550
18,6,73,1,18,"slot_del@1556-1574@usr.bin/sndiod/dev.c","usr.bin/sndiod/dev.c","slot_del",1556,1574
13,4,70,2,14,"slot_setvol@1580-1594@usr.bin/sndiod/dev.c","usr.bin/sndiod/dev.c","slot_setvol",1580,1594
102,20,876,1,136,"slot_attach@1600-1736@usr.bin/sndiod/dev.c","usr.bin/sndiod/dev.c","slot_attach",1600,1736
11,3,50,1,14,"slot_ready@1743-1757@usr.bin/sndiod/dev.c","usr.bin/sndiod/dev.c","slot_ready",1743,1757
52,12,336,1,61,"slot_start@1764-1825@usr.bin/sndiod/dev.c","usr.bin/sndiod/dev.c","slot_start",1764,1825
29,12,185,1,33,"slot_detach@1831-1864@usr.bin/sndiod/dev.c","usr.bin/sndiod/dev.c","slot_detach",1831,1864
36,12,202,1,40,"slot_stop@1871-1911@usr.bin/sndiod/dev.c","usr.bin/sndiod/dev.c","slot_stop",1871,1911
16,6,86,1,18,"slot_skip_update@1914-1932@usr.bin/sndiod/dev.c","usr.bin/sndiod/dev.c","slot_skip_update",1914,1932
12,5,69,1,13,"slot_write@1939-1952@usr.bin/sndiod/dev.c","usr.bin/sndiod/dev.c","slot_write",1939,1952
4,1,14,1,3,"slot_read@1958-1961@usr.bin/sndiod/dev.c","usr.bin/sndiod/dev.c","slot_read",1958,1961
23,9,177,2,23,"aparams_enctostr@46-69@usr.bin/sndiod/dsp.c","usr.bin/sndiod/dsp.c","aparams_enctostr",46,69
59,25,398,2,84,"aparams_strtoenc@77-161@usr.bin/sndiod/dsp.c","usr.bin/sndiod/dsp.c","aparams_strtoenc",77,161
8,1,42,1,7,"aparams_init@168-175@usr.bin/sndiod/dsp.c","usr.bin/sndiod/dsp.c","aparams_init",168,175
6,1,27,1,6,"aparams_log@181-187@usr.bin/sndiod/dsp.c","usr.bin/sndiod/dsp.c","aparams_log",181,187
6,6,56,1,5,"aparams_native@193-198@usr.bin/sndiod/dsp.c","usr.bin/sndiod/dsp.c","aparams_native",193,198
78,14,415,4,89,"resamp_do@204-293@usr.bin/sndiod/dsp.c","usr.bin/sndiod/dsp.c","resamp_do",204,293
19,4,111,4,21,"resamp_init@299-320@usr.bin/sndiod/dsp.c","usr.bin/sndiod/dsp.c","resamp_init",299,320
38,5,215,4,53,"enc_do@326-379@usr.bin/sndiod/dsp.c","usr.bin/sndiod/dsp.c","enc_do",326,379
33,5,186,3,44,"enc_sil_do@385-429@usr.bin/sndiod/dsp.c","usr.bin/sndiod/dsp.c","enc_sil_do",385,429
31,6,189,3,32,"enc_init@435-467@usr.bin/sndiod/dsp.c","usr.bin/sndiod/dsp.c","enc_init",435,467
38,5,210,4,49,"dec_do@473-522@usr.bin/sndiod/dsp.c","usr.bin/sndiod/dsp.c","dec_do",473,522
31,6,188,3,32,"dec_init@528-560@usr.bin/sndiod/dsp.c","usr.bin/sndiod/dsp.c","dec_init",528,560
34,7,209,5,40,"cmap_add@566-606@usr.bin/sndiod/dsp.c","usr.bin/sndiod/dsp.c","cmap_add",566,606
29,5,175,5,35,"cmap_copy@612-647@usr.bin/sndiod/dsp.c","usr.bin/sndiod/dsp.c","cmap_copy",612,647
42,11,242,9,46,"cmap_init@654-700@usr.bin/sndiod/dsp.c","usr.bin/sndiod/dsp.c","cmap_init",654,700
12,1,40,2,12,"fp24_mul@46-58@usr.bin/sndiod/dsp.h","usr.bin/sndiod/dsp.h","fp24_mul",46,58
11,1,46,3,11,"fp24_muldiv@61-72@usr.bin/sndiod/dsp.h","usr.bin/sndiod/dsp.h","fp24_muldiv",61,72
4,1,18,1,3,"fdpass_log@72-75@usr.bin/sndiod/fdpass.c","usr.bin/sndiod/fdpass.c","fdpass_log",72,75
61,9,354,5,63,"fdpass_send@78-141@usr.bin/sndiod/fdpass.c","usr.bin/sndiod/fdpass.c","fdpass_send",78,141
81,17,466,5,87,"fdpass_recv@144-231@usr.bin/sndiod/fdpass.c","usr.bin/sndiod/fdpass.c","fdpass_recv",144,231
15,4,77,2,15,"fdpass_waitret@234-249@usr.bin/sndiod/fdpass.c","usr.bin/sndiod/fdpass.c","fdpass_waitret",234,249
11,4,67,2,11,"fdpass_sio_open@252-263@usr.bin/sndiod/fdpass.c","usr.bin/sndiod/fdpass.c","fdpass_sio_open",252,263
11,4,67,2,11,"fdpass_mio_open@266-277@usr.bin/sndiod/fdpass.c","usr.bin/sndiod/fdpass.c","fdpass_mio_open",266,277
10,2,40,1,10,"fdpass_in_worker@280-290@usr.bin/sndiod/fdpass.c","usr.bin/sndiod/fdpass.c","fdpass_in_worker",280,290
39,10,222,1,39,"fdpass_in_helper@293-332@usr.bin/sndiod/fdpass.c","usr.bin/sndiod/fdpass.c","fdpass_in_helper",293,332
3,1,8,1,2,"fdpass_out@335-337@usr.bin/sndiod/fdpass.c","usr.bin/sndiod/fdpass.c","fdpass_out",335,337
9,2,38,1,9,"fdpass_hup@340-349@usr.bin/sndiod/fdpass.c","usr.bin/sndiod/fdpass.c","fdpass_hup",340,349
14,2,81,2,14,"fdpass_new@352-366@usr.bin/sndiod/fdpass.c","usr.bin/sndiod/fdpass.c","fdpass_new",352,366
7,1,32,1,6,"fdpass_close@369-375@usr.bin/sndiod/fdpass.c","usr.bin/sndiod/fdpass.c","fdpass_close",369,375
7,1,37,2,7,"fdpass_pollfd@378-385@usr.bin/sndiod/fdpass.c","usr.bin/sndiod/fdpass.c","fdpass_pollfd",378,385
4,1,18,2,3,"fdpass_revents@388-391@usr.bin/sndiod/fdpass.c","usr.bin/sndiod/fdpass.c","fdpass_revents",388,391
6,1,41,3,5,"timo_set@82-87@usr.bin/sndiod/file.c","usr.bin/sndiod/file.c","timo_set",82,87
25,6,134,2,27,"timo_add@94-121@usr.bin/sndiod/file.c","usr.bin/sndiod/file.c","timo_add",94,121
13,5,73,1,15,"timo_del@127-142@usr.bin/sndiod/file.c","usr.bin/sndiod/file.c","timo_del",127,142
15,3,69,1,27,"timo_update@150-177@usr.bin/sndiod/file.c","usr.bin/sndiod/file.c","timo_update",150,177
5,1,14,1,4,"timo_init@183-187@usr.bin/sndiod/file.c","usr.bin/sndiod/file.c","timo_init",183,187
8,3,32,1,9,"timo_done@193-202@usr.bin/sndiod/file.c","usr.bin/sndiod/file.c","timo_done",193,202
12,2,71,1,12,"file_log@206-218@usr.bin/sndiod/file.c","usr.bin/sndiod/file.c","file_log",206,218
25,6,135,4,29,"file_new@222-251@usr.bin/sndiod/file.c","usr.bin/sndiod/file.c","file_new",222,251
13,5,58,1,16,"file_del@254-270@usr.bin/sndiod/file.c","usr.bin/sndiod/file.c","file_del",254,270
27,15,222,2,33,"file_process@273-306@usr.bin/sndiod/file.c","usr.bin/sndiod/file.c","file_process",273,306
90,28,565,1,127,"file_poll@309-436@usr.bin/sndiod/file.c","usr.bin/sndiod/file.c","file_poll",309,436
14,2,68,1,14,"filelist_init@439-453@usr.bin/sndiod/file.c","usr.bin/sndiod/file.c","filelist_init",439,453
14,4,63,1,16,"filelist_done@456-472@usr.bin/sndiod/file.c","usr.bin/sndiod/file.c","filelist_done",456,472
17,5,99,1,20,"listen_close@57-77@usr.bin/sndiod/listen.c","usr.bin/sndiod/listen.c","listen_close",57,77
44,7,256,1,44,"listen_new_un@80-124@usr.bin/sndiod/listen.c","usr.bin/sndiod/listen.c","listen_new_un",80,124
58,9,382,2,66,"listen_new_tcp@127-193@usr.bin/sndiod/listen.c","usr.bin/sndiod/listen.c","listen_new_tcp",127,193
4,1,12,1,3,"listen_init@196-199@usr.bin/sndiod/listen.c","usr.bin/sndiod/listen.c","listen_init",196,199
10,2,52,2,10,"listen_pollfd@202-212@usr.bin/sndiod/listen.c","usr.bin/sndiod/listen.c","listen_pollfd",202,212
7,2,34,2,7,"listen_revents@215-222@usr.bin/sndiod/listen.c","usr.bin/sndiod/listen.c","listen_revents",215,222
34,9,184,1,34,"listen_in@225-259@usr.bin/sndiod/listen.c","usr.bin/sndiod/listen.c","listen_in",225,259
3,1,8,1,2,"listen_out@262-264@usr.bin/sndiod/listen.c","usr.bin/sndiod/listen.c","listen_out",262,264
5,1,20,1,5,"listen_hup@267-272@usr.bin/sndiod/listen.c","usr.bin/sndiod/listen.c","listen_hup",267,272
5,1,21,1,4,"midi_log@60-64@usr.bin/sndiod/midi.c","usr.bin/sndiod/midi.c","midi_log",60,64
3,1,6,1,2,"midi_init@67-69@usr.bin/sndiod/midi.c","usr.bin/sndiod/midi.c","midi_init",67,69
3,1,6,1,2,"midi_done@72-74@usr.bin/sndiod/midi.c","usr.bin/sndiod/midi.c","midi_done",72,74
25,5,151,3,29,"midi_new@77-106@usr.bin/sndiod/midi.c","usr.bin/sndiod/midi.c","midi_new",77,106
21,5,130,1,21,"midi_del@109-130@usr.bin/sndiod/midi.c","usr.bin/sndiod/midi.c","midi_del",109,130
15,5,81,2,17,"midi_link@136-153@usr.bin/sndiod/midi.c","usr.bin/sndiod/midi.c","midi_link",136,153
27,9,168,2,29,"midi_tag@159-188@usr.bin/sndiod/midi.c","usr.bin/sndiod/midi.c","midi_tag",159,188
31,11,196,3,35,"midi_send@194-229@usr.bin/sndiod/midi.c","usr.bin/sndiod/midi.c","midi_send",194,229
19,5,128,1,24,"midi_tickets@236-260@usr.bin/sndiod/midi.c","usr.bin/sndiod/midi.c","midi_tickets",236,260
10,3,53,1,10,"midi_fill@266-276@usr.bin/sndiod/midi.c","usr.bin/sndiod/midi.c","midi_fill",266,276
46,15,385,3,47,"midi_in@282-329@usr.bin/sndiod/midi.c","usr.bin/sndiod/midi.c","midi_in",282,329
35,10,207,3,41,"midi_out@335-376@usr.bin/sndiod/midi.c","usr.bin/sndiod/midi.c","midi_out",335,376
4,1,16,1,3,"port_log@379-382@usr.bin/sndiod/midi.c","usr.bin/sndiod/midi.c","port_log",379,382
5,1,34,3,5,"port_imsg@385-390@usr.bin/sndiod/midi.c","usr.bin/sndiod/midi.c","port_imsg",385,390
5,1,34,3,5,"port_omsg@394-399@usr.bin/sndiod/midi.c","usr.bin/sndiod/midi.c","port_omsg",394,399
3,1,11,2,3,"port_fill@402-405@usr.bin/sndiod/midi.c","usr.bin/sndiod/midi.c","port_fill",402,405
9,3,37,1,11,"port_exit@408-419@usr.bin/sndiod/midi.c","usr.bin/sndiod/midi.c","port_exit",408,419
13,1,86,3,13,"port_new@425-438@usr.bin/sndiod/midi.c","usr.bin/sndiod/midi.c","port_new",425,438
16,5,95,1,18,"port_del@444-462@usr.bin/sndiod/midi.c","usr.bin/sndiod/midi.c","port_del",444,462
10,5,47,1,11,"port_ref@465-476@usr.bin/sndiod/midi.c","usr.bin/sndiod/midi.c","port_ref",465,476
13,8,96,1,15,"port_unref@479-494@usr.bin/sndiod/midi.c","usr.bin/sndiod/midi.c","port_unref",479,494
9,3,44,1,9,"port_bynum@497-506@usr.bin/sndiod/midi.c","usr.bin/sndiod/midi.c","port_bynum",497,506
12,3,51,1,11,"port_open@509-520@usr.bin/sndiod/midi.c","usr.bin/sndiod/midi.c","port_open",509,520
19,6,113,1,21,"port_close@523-544@usr.bin/sndiod/midi.c","usr.bin/sndiod/midi.c","port_close",523,544
13,5,69,1,15,"port_drain@547-562@usr.bin/sndiod/midi.c","usr.bin/sndiod/midi.c","port_drain",547,562
6,2,24,1,5,"port_init@565-570@usr.bin/sndiod/midi.c","usr.bin/sndiod/midi.c","port_init",565,570
5,2,22,1,4,"port_done@573-577@usr.bin/sndiod/midi.c","usr.bin/sndiod/midi.c","port_done",573,577
8,2,71,1,7,"port_mio_open@49-56@usr.bin/sndiod/miofile.c","usr.bin/sndiod/miofile.c","port_mio_open",49,56
5,1,27,1,4,"port_mio_close@59-63@usr.bin/sndiod/miofile.c","usr.bin/sndiod/miofile.c","port_mio_close",59,63
11,4,82,2,11,"port_mio_pollfd@66-77@usr.bin/sndiod/miofile.c","usr.bin/sndiod/miofile.c","port_mio_pollfd",66,77
5,1,32,2,5,"port_mio_revents@80-85@usr.bin/sndiod/miofile.c","usr.bin/sndiod/miofile.c","port_mio_revents",80,85
13,3,73,1,13,"port_mio_in@88-101@usr.bin/sndiod/miofile.c","usr.bin/sndiod/miofile.c","port_mio_in",88,101
21,7,129,1,21,"port_mio_out@104-125@usr.bin/sndiod/miofile.c","usr.bin/sndiod/miofile.c","port_mio_out",104,125
5,1,20,1,5,"port_mio_hup@128-133@usr.bin/sndiod/miofile.c","usr.bin/sndiod/miofile.c","port_mio_hup",128,133
78,17,453,10,78,"opt_new@29-107@usr.bin/sndiod/opt.c","usr.bin/sndiod/opt.c","opt_new",29,107
11,4,66,2,11,"opt_byname@110-121@usr.bin/sndiod/opt.c","usr.bin/sndiod/opt.c","opt_byname",110,121
12,4,68,1,14,"opt_del@124-138@usr.bin/sndiod/opt.c","usr.bin/sndiod/opt.c","opt_del",124,138
19,5,129,2,21,"dev_sio_onmove@54-75@usr.bin/sndiod/siofile.c","usr.bin/sndiod/siofile.c","dev_sio_onmove",54,75
7,1,30,1,7,"dev_sio_timeout@78-85@usr.bin/sndiod/siofile.c","usr.bin/sndiod/siofile.c","dev_sio_timeout",78,85
118,32,834,1,130,"dev_sio_open@91-221@usr.bin/sndiod/siofile.c","usr.bin/sndiod/siofile.c","dev_sio_open",91,221
10,3,55,1,11,"dev_sio_close@224-235@usr.bin/sndiod/siofile.c","usr.bin/sndiod/siofile.c","dev_sio_close",224,235
28,6,178,1,29,"dev_sio_start@238-267@usr.bin/sndiod/siofile.c","usr.bin/sndiod/siofile.c","dev_sio_start",238,267
19,6,113,1,20,"dev_sio_stop@270-290@usr.bin/sndiod/siofile.c","usr.bin/sndiod/siofile.c","dev_sio_stop",270,290
7,2,53,2,7,"dev_sio_pollfd@293-300@usr.bin/sndiod/siofile.c","usr.bin/sndiod/siofile.c","dev_sio_pollfd",293,300
8,2,47,2,10,"dev_sio_revents@303-313@usr.bin/sndiod/siofile.c","usr.bin/sndiod/siofile.c","dev_sio_revents",303,313
141,39,960,1,168,"dev_sio_run@316-484@usr.bin/sndiod/siofile.c","usr.bin/sndiod/siofile.c","dev_sio_run",316,484
9,3,38,1,11,"dev_sio_hup@487-498@usr.bin/sndiod/siofile.c","usr.bin/sndiod/siofile.c","dev_sio_hup",487,498
6,2,20,1,5,"sigint@125-130@usr.bin/sndiod/sndiod.c","usr.bin/sndiod/sndiod.c","sigint",125,130
19,8,121,2,19,"opt_ch@133-152@usr.bin/sndiod/sndiod.c","usr.bin/sndiod/sndiod.c","opt_ch",133,152
7,3,43,1,7,"opt_enc@155-162@usr.bin/sndiod/sndiod.c","usr.bin/sndiod/sndiod.c","opt_enc",155,162
8,3,43,1,7,"opt_mmc@165-172@usr.bin/sndiod/sndiod.c","usr.bin/sndiod/sndiod.c","opt_mmc",165,172
8,3,43,1,7,"opt_onoff@175-182@usr.bin/sndiod/sndiod.c","usr.bin/sndiod/sndiod.c","opt_onoff",175,182
15,6,73,2,15,"getword@185-200@usr.bin/sndiod/sndiod.c","usr.bin/sndiod/sndiod.c","getword",185,200
23,8,130,1,23,"opt_mode@203-226@usr.bin/sndiod/sndiod.c","usr.bin/sndiod/sndiod.c","opt_mode",203,226
14,4,97,1,14,"setsig@229-243@usr.bin/sndiod/sndiod.c","usr.bin/sndiod/sndiod.c","setsig",229,243
13,4,93,1,13,"unsetsig@246-259@usr.bin/sndiod/sndiod.c","usr.bin/sndiod/sndiod.c","unsetsig",246,259
26,8,173,1,26,"getbasepath@262-288@usr.bin/sndiod/sndiod.c","usr.bin/sndiod/sndiod.c","getbasepath",262,288
20,8,149,8,20,"mkdev@291-311@usr.bin/sndiod/sndiod.c","usr.bin/sndiod/sndiod.c","mkdev",291,311
12,4,75,2,12,"mkport@314-326@usr.bin/sndiod/sndiod.c","usr.bin/sndiod/sndiod.c","mkport",314,326
12,2,99,10,12,"mkopt@329-341@usr.bin/sndiod/sndiod.c","usr.bin/sndiod/sndiod.c","mkopt",329,341
48,16,296,1,48,"start_helper@344-392@usr.bin/sndiod/sndiod.c","usr.bin/sndiod/sndiod.c","start_helper",344,392
5,2,15,1,4,"stop_helper@395-399@usr.bin/sndiod/sndiod.c","usr.bin/sndiod/sndiod.c","stop_helper",395,399
220,69,1317,2,229,"main@402-631@usr.bin/sndiod/sndiod.c","usr.bin/sndiod/sndiod.c","main",402,631
17,6,112,1,20,"sock_log@96-116@usr.bin/sndiod/sock.c","usr.bin/sndiod/sock.c","sock_log",96,116
33,10,178,1,38,"sock_close@119-157@usr.bin/sndiod/sock.c","usr.bin/sndiod/sock.c","sock_close",119,157
14,3,74,1,16,"sock_slot_fill@160-176@usr.bin/sndiod/sock.c","usr.bin/sndiod/sock.c","sock_slot_fill",160,176
12,3,68,1,14,"sock_slot_flush@179-193@usr.bin/sndiod/sock.c","usr.bin/sndiod/sock.c","sock_slot_flush",179,193
9,3,39,1,11,"sock_slot_eof@196-207@usr.bin/sndiod/sock.c","usr.bin/sndiod/sock.c","sock_slot_eof",196,207
14,4,74,1,16,"sock_slot_onmove@210-226@usr.bin/sndiod/sock.c","usr.bin/sndiod/sock.c","sock_slot_onmove",210,226
13,4,69,1,15,"sock_slot_onvol@229-244@usr.bin/sndiod/sock.c","usr.bin/sndiod/sock.c","sock_slot_onvol",229,244
5,1,34,3,5,"sock_midi_imsg@247-252@usr.bin/sndiod/sock.c","usr.bin/sndiod/sock.c","sock_midi_imsg",247,252
5,1,34,3,5,"sock_midi_omsg@255-260@usr.bin/sndiod/sock.c","usr.bin/sndiod/sock.c","sock_midi_omsg",255,260
5,1,24,2,5,"sock_midi_fill@263-268@usr.bin/sndiod/sock.c","usr.bin/sndiod/sock.c","sock_midi_fill",263,268
28,2,169,1,28,"sock_new@271-299@usr.bin/sndiod/sock.c","usr.bin/sndiod/sock.c","sock_new",271,299
9,3,43,1,11,"sock_exit@302-313@usr.bin/sndiod/sock.c","usr.bin/sndiod/sock.c","sock_exit",302,313
31,9,141,3,35,"sock_fdwrite@319-354@usr.bin/sndiod/sock.c","usr.bin/sndiod/sock.c","sock_fdwrite",319,354
31,9,141,3,35,"sock_fdread@360-395@usr.bin/sndiod/sock.c","usr.bin/sndiod/sock.c","sock_fdread",360,395
24,7,129,1,28,"sock_rmsg@401-429@usr.bin/sndiod/sock.c","usr.bin/sndiod/sock.c","sock_rmsg",401,429
23,7,125,1,27,"sock_wmsg@435-462@usr.bin/sndiod/sock.c","usr.bin/sndiod/sock.c","sock_wmsg",435,462
36,11,200,1,40,"sock_rdata@468-508@usr.bin/sndiod/sock.c","usr.bin/sndiod/sock.c","sock_rdata",468,508
49,19,303,1,59,"sock_wdata@514-573@usr.bin/sndiod/sock.c","usr.bin/sndiod/sock.c","sock_wdata",514,573
156,52,1028,1,175,"sock_setpar@576-751@usr.bin/sndiod/sock.c","usr.bin/sndiod/sock.c","sock_setpar",576,751
12,3,75,1,14,"sock_auth@754-768@usr.bin/sndiod/sock.c","usr.bin/sndiod/sock.c","sock_auth",754,768
116,32,726,1,123,"sock_hello@771-894@usr.bin/sndiod/sock.c","usr.bin/sndiod/sock.c","sock_hello",771,894
328,106,1896,1,382,"sock_execmsg@900-1282@usr.bin/sndiod/sock.c","usr.bin/sndiod/sock.c","sock_execmsg",900,1282
117,31,811,1,149,"sock_buildmsg@1289-1438@usr.bin/sndiod/sock.c","usr.bin/sndiod/sock.c","sock_buildmsg",1289,1438
43,15,207,1,48,"sock_read@1444-1492@usr.bin/sndiod/sock.c","usr.bin/sndiod/sock.c","sock_read",1444,1492
60,19,314,1,74,"sock_write@1498-1572@usr.bin/sndiod/sock.c","usr.bin/sndiod/sock.c","sock_write",1498,1572
17,8,103,2,26,"sock_pollfd@1575-1601@usr.bin/sndiod/sock.c","usr.bin/sndiod/sock.c","sock_pollfd",1575,1601
4,1,18,2,3,"sock_revents@1604-1607@usr.bin/sndiod/sock.c","usr.bin/sndiod/sock.c","sock_revents",1604,1607
6,2,23,1,6,"sock_in@1610-1616@usr.bin/sndiod/sock.c","usr.bin/sndiod/sock.c","sock_in",1610,1616
6,2,23,1,6,"sock_out@1619-1625@usr.bin/sndiod/sock.c","usr.bin/sndiod/sock.c","sock_out",1619,1625
5,1,20,1,5,"sock_hup@1628-1633@usr.bin/sndiod/sock.c","usr.bin/sndiod/sock.c","sock_hup",1628,1633
7,2,27,1,6,"log_flush@51-57@usr.bin/sndiod/utils.c","usr.bin/sndiod/utils.c","log_flush",51,57
10,4,48,1,10,"log_puts@63-73@usr.bin/sndiod/utils.c","usr.bin/sndiod/utils.c","log_puts",63,73
17,5,111,1,17,"log_putx@79-96@usr.bin/sndiod/utils.c","usr.bin/sndiod/utils.c","log_putx",79,96
14,4,90,1,14,"log_putu@102-116@usr.bin/sndiod/utils.c","usr.bin/sndiod/utils.c","log_putu",102,116
8,2,30,1,7,"log_puti@122-129@usr.bin/sndiod/utils.c","usr.bin/sndiod/utils.c","log_puti",122,129
6,1,27,1,5,"panic@135-140@usr.bin/sndiod/utils.c","usr.bin/sndiod/utils.c","panic",135,140
12,2,48,1,12,"xmalloc@146-158@usr.bin/sndiod/utils.c","usr.bin/sndiod/utils.c","xmalloc",146,158
8,3,30,1,9,"xfree@164-173@usr.bin/sndiod/utils.c","usr.bin/sndiod/utils.c","xfree",164,173
9,1,43,1,9,"xstrdup@179-188@usr.bin/sndiod/utils.c","usr.bin/sndiod/utils.c","xstrdup",179,188
55,13,366,1,57,"initialise_months@52-109@usr.bin/sort/bwstring.c","usr.bin/sort/bwstring.c","initialise_months",52,109
25,8,144,2,25,"wide_str_coll@115-140@usr.bin/sort/bwstring.c","usr.bin/sort/bwstring.c","wide_str_coll",115,140
7,2,64,4,6,"bwsprintf@145-151@usr.bin/sort/bwstring.c","usr.bin/sort/bwstring.c","bwsprintf",145,151
4,1,18,1,3,"bwsrawdata@154-157@usr.bin/sort/bwstring.c","usr.bin/sort/bwstring.c","bwsrawdata",154,157
4,2,28,1,3,"bwsrawlen@160-163@usr.bin/sort/bwstring.c","usr.bin/sort/bwstring.c","bwsrawlen",160,163
5,2,48,1,4,"bws_memsize@166-170@usr.bin/sort/bwstring.c","usr.bin/sort/bwstring.c","bws_memsize",166,170
10,5,66,2,9,"bws_setlen@173-182@usr.bin/sort/bwstring.c","usr.bin/sort/bwstring.c","bws_setlen",173,182
14,2,88,1,15,"bwsalloc@188-203@usr.bin/sort/bwstring.c","usr.bin/sort/bwstring.c","bwsalloc",188,203
13,3,84,1,16,"bwsdup@210-226@usr.bin/sort/bwstring.c","usr.bin/sort/bwstring.c","bwsdup",210,226
16,5,107,2,18,"bwssbdup@232-250@usr.bin/sort/bwstring.c","usr.bin/sort/bwstring.c","bwssbdup",232,250
42,10,270,2,51,"bwscsbdup@256-307@usr.bin/sort/bwstring.c","usr.bin/sort/bwstring.c","bwscsbdup",256,307
4,1,14,1,3,"bwsfree@313-316@usr.bin/sort/bwstring.c","usr.bin/sort/bwstring.c","bwsfree",313,316
16,3,122,2,18,"bwscpy@324-342@usr.bin/sort/bwstring.c","usr.bin/sort/bwstring.c","bwscpy",324,342
18,4,135,3,20,"bwsncpy@351-371@usr.bin/sort/bwstring.c","usr.bin/sort/bwstring.c","bwsncpy",351,371
25,5,174,4,25,"bwsnocpy@381-406@usr.bin/sort/bwstring.c","usr.bin/sort/bwstring.c","bwsnocpy",381,406
36,10,263,3,47,"bwsfwrite@414-461@usr.bin/sort/bwstring.c","usr.bin/sort/bwstring.c","bwsfwrite",414,461
86,27,536,4,106,"bwsfgetln@468-574@usr.bin/sort/bwstring.c","usr.bin/sort/bwstring.c","bwsfgetln",468,574
41,12,248,4,53,"bwsncmp@577-630@usr.bin/sort/bwstring.c","usr.bin/sort/bwstring.c","bwsncmp",577,630
20,5,110,3,26,"bwscmp@633-659@usr.bin/sort/bwstring.c","usr.bin/sort/bwstring.c","bwscmp",633,659
14,3,84,3,15,"bws_iterator_cmp@662-677@usr.bin/sort/bwstring.c","usr.bin/sort/bwstring.c","bws_iterator_cmp",662,677
123,48,717,3,159,"bwscoll@680-839@usr.bin/sort/bwstring.c","usr.bin/sort/bwstring.c","bwscoll",680,839
39,10,229,2,48,"bwstod@845-893@usr.bin/sort/bwstring.c","usr.bin/sort/bwstring.c","bwstod",845,893
28,12,195,1,34,"bws_month_score@901-935@usr.bin/sort/bwstring.c","usr.bin/sort/bwstring.c","bws_month_score",901,935
38,10,214,1,48,"ignore_leading_blanks@941-989@usr.bin/sort/bwstring.c","usr.bin/sort/bwstring.c","ignore_leading_blanks",941,989
41,6,189,1,46,"ignore_nonprinting@995-1041@usr.bin/sort/bwstring.c","usr.bin/sort/bwstring.c","ignore_nonprinting",995,1041
41,8,199,1,46,"dictionary_order@1048-1094@usr.bin/sort/bwstring.c","usr.bin/sort/bwstring.c","dictionary_order",1048,1094
21,4,110,1,24,"ignore_case@1100-1124@usr.bin/sort/bwstring.c","usr.bin/sort/bwstring.c","ignore_case",1100,1124
7,2,58,3,6,"bws_disorder_warnx@1127-1133@usr.bin/sort/bwstring.c","usr.bin/sort/bwstring.c","bws_disorder_warnx",1127,1133
4,1,22,1,4,"bws_begin@98-102@usr.bin/sort/bwstring.h","usr.bin/sort/bwstring.h","bws_begin",98,102
6,2,48,1,6,"bws_end@105-111@usr.bin/sort/bwstring.h","usr.bin/sort/bwstring.h","bws_end",105,111
7,2,40,2,7,"bws_iterator_inc@114-121@usr.bin/sort/bwstring.h","usr.bin/sort/bwstring.h","bws_iterator_inc",114,121
7,2,35,1,7,"bws_get_iter_value@124-131@usr.bin/sort/bwstring.h","usr.bin/sort/bwstring.h","bws_get_iter_value",124,131
8,1,32,1,9,"keys_array_alloc@67-76@usr.bin/sort/coll.c","usr.bin/sort/coll.c","keys_array_alloc",67,76
4,2,17,1,3,"key_hint_size@82-85@usr.bin/sort/coll.c","usr.bin/sort/coll.c","key_hint_size",82,85
4,1,21,1,3,"keys_array_size@91-94@usr.bin/sort/coll.c","usr.bin/sort/coll.c","keys_array_size",91,94
10,5,82,2,10,"clean_keys_array@100-110@usr.bin/sort/coll.c","usr.bin/sort/coll.c","clean_keys_array",100,110
10,4,65,3,11,"set_key_on_keys_array@116-127@usr.bin/sort/coll.c","usr.bin/sort/coll.c","set_key_on_keys_array",116,127
8,1,38,1,9,"sort_list_item_alloc@133-142@usr.bin/sort/coll.c","usr.bin/sort/coll.c","sort_list_item_alloc",133,142
16,5,105,1,18,"sort_list_item_size@145-163@usr.bin/sort/coll.c","usr.bin/sort/coll.c","sort_list_item_size",145,163
4,1,23,1,3,"sort_list_item_make_key@169-172@usr.bin/sort/coll.c","usr.bin/sort/coll.c","sort_list_item_make_key",169,172
16,4,81,2,16,"sort_list_item_set@179-195@usr.bin/sort/coll.c","usr.bin/sort/coll.c","sort_list_item_set",179,195
10,3,50,1,9,"sort_list_item_clean@201-210@usr.bin/sort/coll.c","usr.bin/sort/coll.c","sort_list_item_clean",201,210
16,8,101,5,19,"skip_cols_to_start@216-235@usr.bin/sort/coll.c","usr.bin/sort/coll.c","skip_cols_to_start",216,235
38,13,200,3,41,"skip_fields_to_start@241-282@usr.bin/sort/coll.c","usr.bin/sort/coll.c","skip_fields_to_start",241,282
10,2,78,6,9,"find_field_start@288-297@usr.bin/sort/coll.c","usr.bin/sort/coll.c","find_field_start",288,297
32,10,197,2,36,"find_field_end@303-339@usr.bin/sort/coll.c","usr.bin/sort/coll.c","find_field_end",303,339
25,6,148,2,30,"cut_field@345-375@usr.bin/sort/coll.c","usr.bin/sort/coll.c","cut_field",345,375
48,18,298,2,54,"preproc@383-437@usr.bin/sort/coll.c","usr.bin/sort/coll.c","preproc",383,437
17,7,72,1,16,"get_sort_func@440-456@usr.bin/sort/coll.c","usr.bin/sort/coll.c","get_sort_func",440,456
17,4,135,3,21,"key_coll@465-486@usr.bin/sort/coll.c","usr.bin/sort/coll.c","key_coll",465,486
10,2,52,2,11,"top_level_str_coll@493-504@usr.bin/sort/coll.c","usr.bin/sort/coll.c","top_level_str_coll",493,504
25,8,178,2,34,"str_list_coll@510-544@usr.bin/sort/coll.c","usr.bin/sort/coll.c","str_list_coll",510,544
21,7,166,3,25,"list_coll_offset@550-575@usr.bin/sort/coll.c","usr.bin/sort/coll.c","list_coll_offset",550,575
5,1,34,2,4,"list_coll@581-585@usr.bin/sort/coll.c","usr.bin/sort/coll.c","list_coll",581,585
12,2,72,1,13,"get_list_call_func@618-631@usr.bin/sort/coll.c","usr.bin/sort/coll.c","get_list_call_func",618,631
4,1,36,2,3,"list_coll_by_str_only@637-640@usr.bin/sort/coll.c","usr.bin/sort/coll.c","list_coll_by_str_only",637,640
32,10,118,2,31,"setsuffix@651-682@usr.bin/sort/coll.c","usr.bin/sort/coll.c","setsuffix",651,682
45,16,354,7,58,"read_number@692-750@usr.bin/sort/coll.c","usr.bin/sort/coll.c","read_number",692,750
12,3,98,3,13,"wstrcoll@756-769@usr.bin/sort/coll.c","usr.bin/sort/coll.c","wstrcoll",756,769
4,1,23,2,3,"cmpsuffix@775-778@usr.bin/sort/coll.c","usr.bin/sort/coll.c","cmpsuffix",775,778
111,57,933,4,149,"numcoll_impl@784-933@usr.bin/sort/coll.c","usr.bin/sort/coll.c","numcoll_impl",784,933
4,1,29,3,3,"numcoll@939-942@usr.bin/sort/coll.c","usr.bin/sort/coll.c","numcoll",939,942
4,1,29,3,3,"hnumcoll@948-951@usr.bin/sort/coll.c","usr.bin/sort/coll.c","hnumcoll",948,951
40,7,257,3,47,"randomcoll@957-1004@usr.bin/sort/coll.c","usr.bin/sort/coll.c","randomcoll",957,1004
14,3,83,3,17,"versioncoll@1010-1027@usr.bin/sort/coll.c","usr.bin/sort/coll.c","versioncoll",1010,1027
7,5,39,2,7,"huge_minus@1033-1040@usr.bin/sort/coll.c","usr.bin/sort/coll.c","huge_minus",1033,1040
7,5,36,2,7,"huge_plus@1046-1053@usr.bin/sort/coll.c","usr.bin/sort/coll.c","huge_plus",1046,1053
5,3,27,1,7,"is_nan@1059-1066@usr.bin/sort/coll.c","usr.bin/sort/coll.c","is_nan",1059,1066
6,3,29,2,5,"cmp_nans@1072-1077@usr.bin/sort/coll.c","usr.bin/sort/coll.c","cmp_nans",1072,1077
121,52,851,3,151,"gnumcoll@1083-1234@usr.bin/sort/coll.c","usr.bin/sort/coll.c","gnumcoll",1083,1234
36,10,257,3,43,"monthcoll@1240-1283@usr.bin/sort/coll.c","usr.bin/sort/coll.c","monthcoll",1240,1283
4,1,11,1,3,"init_tmp_files@106-109@usr.bin/sort/file.c","usr.bin/sort/file.c","init_tmp_files",106,109
11,1,76,1,12,"tmp_file_atexit@115-127@usr.bin/sort/file.c","usr.bin/sort/file.c","tmp_file_atexit",115,127
8,3,41,1,8,"clear_tmp_files@133-141@usr.bin/sort/file.c","usr.bin/sort/file.c","clear_tmp_files",133,141
9,3,50,1,10,"file_is_tmp@147-157@usr.bin/sort/file.c","usr.bin/sort/file.c","file_is_tmp",147,157
11,2,59,1,11,"new_tmp_file_name@163-174@usr.bin/sort/file.c","usr.bin/sort/file.c","new_tmp_file_name",163,174
7,1,36,2,6,"file_list_init@180-186@usr.bin/sort/file.c","usr.bin/sort/file.c","file_list_init",180,186
10,4,93,3,9,"file_list_add@192-201@usr.bin/sort/file.c","usr.bin/sort/file.c","file_list_add",192,201
6,2,47,4,6,"file_list_populate@207-213@usr.bin/sort/file.c","usr.bin/sort/file.c","file_list_populate",207,213
19,5,114,1,19,"file_list_clean@220-239@usr.bin/sort/file.c","usr.bin/sort/file.c","file_list_clean",220,239
7,1,37,1,6,"sort_list_init@245-251@usr.bin/sort/file.c","usr.bin/sort/file.c","sort_list_init",245,251
16,3,142,2,17,"sort_list_add@257-274@usr.bin/sort/file.c","usr.bin/sort/file.c","sort_list_add",257,274
20,4,111,1,22,"sort_list_clean@280-302@usr.bin/sort/file.c","usr.bin/sort/file.c","sort_list_clean",280,302
27,8,179,2,30,"sort_list_dump@308-338@usr.bin/sort/file.c","usr.bin/sort/file.c","sort_list_dump",308,338
86,26,486,1,109,"check@345-454@usr.bin/sort/file.c","usr.bin/sort/file.c","check",345,454
23,9,175,2,30,"openfile@461-491@usr.bin/sort/file.c","usr.bin/sort/file.c","openfile",461,491
16,7,84,2,15,"closefile@497-512@usr.bin/sort/file.c","usr.bin/sort/file.c","closefile",497,512
48,14,337,1,59,"file_reader_init@518-577@usr.bin/sort/file.c","usr.bin/sort/file.c","file_reader_init",518,577
89,22,592,1,106,"file_reader_readline@580-686@usr.bin/sort/file.c","usr.bin/sort/file.c","file_reader_readline",580,686
10,3,70,1,13,"file_reader_clean@689-702@usr.bin/sort/file.c","usr.bin/sort/file.c","file_reader_clean",689,702
5,1,19,1,4,"file_reader_free@705-709@usr.bin/sort/file.c","usr.bin/sort/file.c","file_reader_free",705,709
23,5,129,3,32,"procfile@712-744@usr.bin/sort/file.c","usr.bin/sort/file.c","procfile",712,744
14,7,102,2,15,"file_header_cmp@750-765@usr.bin/sort/file.c","usr.bin/sort/file.c","file_header_cmp",750,765
20,4,162,3,20,"file_header_init@771-791@usr.bin/sort/file.c","usr.bin/sort/file.c","file_header_init",771,791
14,3,90,1,13,"file_header_close@797-810@usr.bin/sort/file.c","usr.bin/sort/file.c","file_header_close",797,810
7,1,44,3,7,"file_header_swap@816-823@usr.bin/sort/file.c","usr.bin/sort/file.c","file_header_swap",816,823
11,3,69,2,13,"file_header_heap_swim@832-845@usr.bin/sort/file.c","usr.bin/sort/file.c","file_header_heap_swim",832,845
19,5,116,3,22,"file_header_heap_sink@851-873@usr.bin/sort/file.c","usr.bin/sort/file.c","file_header_heap_sink",851,873
4,1,21,2,3,"file_header_list_rearrange_from_header@881-884@usr.bin/sort/file.c","usr.bin/sort/file.c","file_header_list_rearrange_from_header",881,884
5,1,34,3,4,"file_header_list_push@890-894@usr.bin/sort/file.c","usr.bin/sort/file.c","file_header_list_push",890,894
12,5,111,3,11,"file_header_print@905-916@usr.bin/sort/file.c","usr.bin/sort/file.c","file_header_print",905,916
18,4,100,1,18,"file_header_read_next@922-940@usr.bin/sort/file.c","usr.bin/sort/file.c","file_header_read_next",922,940
15,4,113,3,24,"file_headers_merge@946-970@usr.bin/sort/file.c","usr.bin/sort/file.c","file_headers_merge",946,970
17,4,138,3,24,"merge_files_array@977-1001@usr.bin/sort/file.c","usr.bin/sort/file.c","merge_files_array",977,1001
31,6,189,1,37,"shrink_file_list@1007-1044@usr.bin/sort/file.c","usr.bin/sort/file.c","shrink_file_list",1007,1044
6,2,35,2,6,"merge_files@1050-1056@usr.bin/sort/file.c","usr.bin/sort/file.c","merge_files",1050,1056
11,4,44,1,10,"get_sort_method_name@1059-1069@usr.bin/sort/file.c","usr.bin/sort/file.c","get_sort_method_name",1059,1069
51,20,305,2,60,"sort_list_to_file@1075-1135@usr.bin/sort/file.c","usr.bin/sort/file.c","sort_list_to_file",1075,1135
7,2,34,1,7,"sort_malloc@40-47@usr.bin/sort/mem.c","usr.bin/sort/mem.c","sort_malloc",40,47
7,2,39,2,7,"sort_calloc@53-60@usr.bin/sort/mem.c","usr.bin/sort/mem.c","sort_calloc",53,60
4,1,13,1,3,"sort_free@66-69@usr.bin/sort/mem.c","usr.bin/sort/mem.c","sort_free",66,69
6,2,41,3,5,"sort_reallocarray@75-80@usr.bin/sort/mem.c","usr.bin/sort/mem.c","sort_reallocarray",75,80
7,2,36,1,7,"sort_strdup@83-90@usr.bin/sort/mem.c","usr.bin/sort/mem.c","sort_strdup",83,90
11,2,61,3,12,"sort_asprintf@93-105@usr.bin/sort/mem.c","usr.bin/sort/mem.c","sort_asprintf",93,105
8,1,41,1,9,"push_ls@82-91@usr.bin/sort/radixsort.c","usr.bin/sort/radixsort.c","push_ls",82,91
13,2,51,1,15,"pop_ls_st@97-112@usr.bin/sort/radixsort.c","usr.bin/sort/radixsort.c","pop_ls_st",97,112
17,3,138,3,21,"add_to_sublevel@115-136@usr.bin/sort/radixsort.c","usr.bin/sort/radixsort.c","add_to_sublevel",115,136
9,2,74,2,8,"add_leaf@139-147@usr.bin/sort/radixsort.c","usr.bin/sort/radixsort.c","add_leaf",139,147
8,2,58,2,9,"get_wc_index@150-159@usr.bin/sort/radixsort.c","usr.bin/sort/radixsort.c","get_wc_index",150,159
11,2,64,2,12,"place_item@162-174@usr.bin/sort/radixsort.c","usr.bin/sort/radixsort.c","place_item",162,174
19,5,102,1,24,"free_sort_level@177-201@usr.bin/sort/radixsort.c","usr.bin/sort/radixsort.c","free_sort_level",177,201
127,22,932,1,150,"run_sort_level_next@204-354@usr.bin/sort/radixsort.c","usr.bin/sort/radixsort.c","run_sort_level_next",204,354
11,3,39,1,11,"run_sort_cycle_st@360-371@usr.bin/sort/radixsort.c","usr.bin/sort/radixsort.c","run_sort_cycle_st",360,371
58,13,416,1,70,"run_top_sort_level@374-444@usr.bin/sort/radixsort.c","usr.bin/sort/radixsort.c","run_top_sort_level",374,444
10,1,58,2,12,"rxsort@447-459@usr.bin/sort/radixsort.c","usr.bin/sort/radixsort.c","rxsort",447,459
5,9,49,1,4,"sort_modifier_empty@150-154@usr.bin/sort/sort.c","usr.bin/sort/sort.c","sort_modifier_empty",150,154
7,2,28,1,6,"usage@160-166@usr.bin/sort/sort.c","usr.bin/sort/sort.c","usage",160,166
27,6,164,1,29,"read_fns_from_file0@172-201@usr.bin/sort/sort.c","usr.bin/sort/sort.c","read_fns_from_file0",172,201
26,6,166,1,32,"set_hw_params@207-239@usr.bin/sort/sort.c","usr.bin/sort/sort.c","set_hw_params",207,239
7,2,42,3,7,"conv_mbtowc@245-252@usr.bin/sort/sort.c","usr.bin/sort/sort.c","conv_mbtowc",245,252
36,8,200,1,43,"set_locale@258-301@usr.bin/sort/sort.c","usr.bin/sort/sort.c","set_locale",258,301
9,3,36,1,9,"set_tmpdir@307-316@usr.bin/sort/sort.c","usr.bin/sort/sort.c","set_tmpdir",307,316
61,27,284,1,70,"parse_memory_buffer_value@322-392@usr.bin/sort/sort.c","usr.bin/sort/sort.c","parse_memory_buffer_value",322,392
5,1,17,1,4,"sig_handler@398-402@usr.bin/sort/sort.c","usr.bin/sort/sort.c","sig_handler",398,402
16,3,122,1,17,"set_signal_handler@408-425@usr.bin/sort/sort.c","usr.bin/sort/sort.c","set_signal_handler",408,425
4,1,18,1,3,"unknown@431-434@usr.bin/sort/sort.c","usr.bin/sort/sort.c","unknown",431,434
29,6,131,2,31,"check_mutually_exclusive_flags@440-471@usr.bin/sort/sort.c","usr.bin/sort/sort.c","check_mutually_exclusive_flags",440,471
8,1,42,1,7,"set_sort_opts@477-484@usr.bin/sort/sort.c","usr.bin/sort/sort.c","set_sort_opts",477,484
51,12,194,2,51,"set_sort_modifier@490-541@usr.bin/sort/sort.c","usr.bin/sort/sort.c","set_sort_modifier",490,541
88,21,603,4,103,"parse_pos@547-650@usr.bin/sort/sort.c","usr.bin/sort/sort.c","parse_pos",547,650
29,5,190,2,37,"parse_k@656-693@usr.bin/sort/sort.c","usr.bin/sort/sort.c","parse_k",656,693
52,10,432,5,68,"parse_pos_obs@699-767@usr.bin/sort/sort.c","usr.bin/sort/sort.c","parse_pos_obs",699,767
46,9,312,2,53,"fix_obsolete_keys@773-826@usr.bin/sort/sort.c","usr.bin/sort/sort.c","fix_obsolete_keys",773,826
22,6,151,1,24,"set_random_seed@832-856@usr.bin/sort/sort.c","usr.bin/sort/sort.c","set_random_seed",832,856
320,97,1881,2,380,"main@862-1242@usr.bin/sort/sort.c","usr.bin/sort/sort.c","main",862,1242
4,2,20,1,3,"isdigit_clocale@40-43@usr.bin/sort/vsort.c","usr.bin/sort/vsort.c","isdigit_clocale",40,43
4,4,34,1,3,"isalpha_clocale@46-49@usr.bin/sort/vsort.c","usr.bin/sort/vsort.c","isalpha_clocale",46,49
5,6,46,1,4,"isalnum_clocale@52-56@usr.bin/sort/vsort.c","usr.bin/sort/vsort.c","isalnum_clocale",52,56
28,10,162,3,46,"find_suffix@63-109@usr.bin/sort/vsort.c","usr.bin/sort/vsort.c","find_suffix",63,109
18,13,126,2,23,"cmp_chars@112-135@usr.bin/sort/vsort.c","usr.bin/sort/vsort.c","cmp_chars",112,135
41,20,298,4,52,"cmpversions@138-190@usr.bin/sort/vsort.c","usr.bin/sort/vsort.c","cmpversions",138,190
49,24,369,2,64,"vcmp@196-260@usr.bin/sort/vsort.c","usr.bin/sort/vsort.c","vcmp",196,260
11,3,80,3,14,"look@48-62@usr.bin/spell/look.c","usr.bin/spell/look.c","look",48,62
15,4,97,3,20,"binary_search@106-126@usr.bin/spell/look.c","usr.bin/spell/look.c","binary_search",106,126
13,4,72,3,14,"linear_search@140-154@usr.bin/spell/look.c","usr.bin/spell/look.c","linear_search",140,154
14,6,81,3,15,"compare@157-172@usr.bin/spell/look.c","usr.bin/spell/look.c","compare",157,172
95,32,735,2,107,"main@242-349@usr.bin/spell/spellprog.c","usr.bin/spell/spellprog.c","main",242,349
9,5,55,1,9,"print_word@352-361@usr.bin/spell/spellprog.c","usr.bin/spell/spellprog.c","print_word",352,361
27,9,212,2,27,"suffix@368-395@usr.bin/spell/spellprog.c","usr.bin/spell/spellprog.c","suffix",368,395
4,1,24,4,4,"nop@398-402@usr.bin/spell/spellprog.c","usr.bin/spell/spellprog.c","nop",398,402
4,2,38,4,4,"strip@405-409@usr.bin/spell/spellprog.c","usr.bin/spell/spellprog.c","strip",405,409
8,4,66,4,8,"s@412-420@usr.bin/spell/spellprog.c","usr.bin/spell/spellprog.c","s",412,420
6,2,49,4,6,"an@423-429@usr.bin/spell/spellprog.c","usr.bin/spell/spellprog.c","an",423,429
5,1,39,4,5,"ize@432-437@usr.bin/spell/spellprog.c","usr.bin/spell/spellprog.c","ize",432,437
9,2,62,4,9,"y_to_e@440-449@usr.bin/spell/spellprog.c","usr.bin/spell/spellprog.c","y_to_e",440,449
7,2,58,4,7,"ily@452-459@usr.bin/spell/spellprog.c","usr.bin/spell/spellprog.c","ily",452,459
7,2,60,4,7,"ncy@462-469@usr.bin/spell/spellprog.c","usr.bin/spell/spellprog.c","ncy",462,469
5,1,39,4,5,"bility@472-477@usr.bin/spell/spellprog.c","usr.bin/spell/spellprog.c","bility",472,477
8,2,57,4,8,"i_to_y@480-488@usr.bin/spell/spellprog.c","usr.bin/spell/spellprog.c","i_to_y",480,488
16,7,90,4,17,"es@491-508@usr.bin/spell/spellprog.c","usr.bin/spell/spellprog.c","es",491,508
6,1,49,4,6,"metry@511-517@usr.bin/spell/spellprog.c","usr.bin/spell/spellprog.c","metry",511,517
11,4,69,4,11,"tion@520-531@usr.bin/spell/spellprog.c","usr.bin/spell/spellprog.c","tion",520,531
34,18,197,4,34,"CCe@537-571@usr.bin/spell/spellprog.c","usr.bin/spell/spellprog.c","CCe",537,571
16,6,116,4,16,"VCe@577-593@usr.bin/spell/spellprog.c","usr.bin/spell/spellprog.c","VCe",577,593
20,6,122,2,20,"lookuppref@596-616@usr.bin/spell/spellprog.c","usr.bin/spell/spellprog.c","lookuppref",596,616
27,6,172,3,27,"trypref@623-650@usr.bin/spell/spellprog.c","usr.bin/spell/spellprog.c","trypref",623,650
25,12,202,3,28,"tryword@653-681@usr.bin/spell/spellprog.c","usr.bin/spell/spellprog.c","tryword",653,681
11,8,86,2,11,"monosyl@684-695@usr.bin/spell/spellprog.c","usr.bin/spell/spellprog.c","monosyl",684,695
8,5,44,1,8,"skipv@698-706@usr.bin/spell/spellprog.c","usr.bin/spell/spellprog.c","skipv",698,706
13,7,45,1,13,"vowel@709-722@usr.bin/spell/spellprog.c","usr.bin/spell/spellprog.c","vowel",709,722
18,5,119,1,19,"ise@728-747@usr.bin/spell/spellprog.c","usr.bin/spell/spellprog.c","ise",728,747
6,3,29,1,6,"ztos@750-756@usr.bin/spell/spellprog.c","usr.bin/spell/spellprog.c","ztos",750,756
7,2,38,1,7,"estrdup@759-766@usr.bin/spell/spellprog.c","usr.bin/spell/spellprog.c","estrdup",759,766
16,4,108,2,16,"dict@773-789@usr.bin/spell/spellprog.c","usr.bin/spell/spellprog.c","dict",773,789
7,1,25,1,7,"usage@792-799@usr.bin/spell/spellprog.c","usr.bin/spell/spellprog.c","usage",792,799
92,51,625,2,102,"main@64-166@usr.bin/split/split.c","usr.bin/split/split.c","main",64,166
38,12,226,1,39,"split1@173-212@usr.bin/split/split.c","usr.bin/split/split.c","split1",173,212
33,11,201,1,48,"split2@219-267@usr.bin/split/split.c","usr.bin/split/split.c","split2",219,267
32,7,181,1,33,"newfile@274-307@usr.bin/split/split.c","usr.bin/split/split.c","newfile",274,307
8,1,30,1,8,"usage@310-318@usr.bin/split/split.c","usr.bin/split/split.c","usage",310,318
11,3,31,1,10,"addr_unicast_masklen@49-59@usr.bin/ssh/addrmatch.c","usr.bin/ssh/addrmatch.c","addr_unicast_masklen",49,59
11,5,48,2,10,"masklen_valid@62-72@usr.bin/ssh/addrmatch.c","usr.bin/ssh/addrmatch.c","masklen_valid",62,72
24,5,175,3,26,"addr_sa_to_xaddr@79-105@usr.bin/ssh/addrmatch.c","usr.bin/ssh/addrmatch.c","addr_sa_to_xaddr",79,105
25,10,180,3,26,"addr_netmask@113-139@usr.bin/ssh/addrmatch.c","usr.bin/ssh/addrmatch.c","addr_netmask",113,139
19,8,136,3,20,"addr_and@146-166@usr.bin/ssh/addrmatch.c","usr.bin/ssh/addrmatch.c","addr_and",146,166
21,12,180,2,22,"addr_cmp@173-195@usr.bin/ssh/addrmatch.c","usr.bin/ssh/addrmatch.c","addr_cmp",173,195
17,7,122,2,21,"addr_pton@202-223@usr.bin/ssh/addrmatch.c","usr.bin/ssh/addrmatch.c","addr_pton",202,223
17,5,95,1,18,"addr_invert@230-248@usr.bin/ssh/addrmatch.c","usr.bin/ssh/addrmatch.c","addr_invert",230,248
6,3,48,3,5,"addr_hostmask@256-261@usr.bin/ssh/addrmatch.c","usr.bin/ssh/addrmatch.c","addr_hostmask",256,261
15,6,87,1,15,"addr_is_all0s@268-283@usr.bin/ssh/addrmatch.c","usr.bin/ssh/addrmatch.c","addr_is_all0s",268,283
10,3,89,2,10,"addr_host_is_all0s@292-302@usr.bin/ssh/addrmatch.c","usr.bin/ssh/addrmatch.c","addr_host_is_all0s",292,302
28,13,225,3,34,"addr_pton_cidr@309-343@usr.bin/ssh/addrmatch.c","usr.bin/ssh/addrmatch.c","addr_pton_cidr",309,343
11,4,89,3,12,"addr_netmatch@346-358@usr.bin/ssh/addrmatch.c","usr.bin/ssh/addrmatch.c","addr_netmatch",346,358
45,14,258,2,48,"addr_match_list@373-421@usr.bin/ssh/addrmatch.c","usr.bin/ssh/addrmatch.c","addr_match_list",373,421
50,13,295,2,62,"addr_match_cidr_list@433-495@usr.bin/ssh/addrmatch.c","usr.bin/ssh/addrmatch.c","addr_match_cidr_list",433,495
33,9,200,6,33,"atomicio6@43-76@usr.bin/ssh/atomicio.c","usr.bin/ssh/atomicio.c","atomicio6",43,76
4,1,44,4,3,"atomicio@79-82@usr.bin/ssh/atomicio.c","usr.bin/ssh/atomicio.c","atomicio",79,82
53,18,361,6,58,"atomiciov6@88-146@usr.bin/ssh/atomicio.c","usr.bin/ssh/atomicio.c","atomiciov6",88,146
5,1,48,4,4,"atomiciov@149-153@usr.bin/ssh/atomicio.c","usr.bin/ssh/atomicio.c","atomiciov",149,153
4,1,11,1,3,"bsdauth_init_ctx@42-45@usr.bin/ssh/auth-bsdauth.c","usr.bin/ssh/auth-bsdauth.c","bsdauth_init_ctx",42,45
37,8,255,6,42,"bsdauth_query@48-90@usr.bin/ssh/auth-bsdauth.c","usr.bin/ssh/auth-bsdauth.c","bsdauth_query",48,90
15,5,104,3,19,"bsdauth_respond@93-112@usr.bin/ssh/auth-bsdauth.c","usr.bin/ssh/auth-bsdauth.c","bsdauth_respond",93,112
8,3,37,1,8,"bsdauth_free_ctx@115-123@usr.bin/ssh/auth-bsdauth.c","usr.bin/ssh/auth-bsdauth.c","bsdauth_free_ctx",115,123
12,3,62,1,12,"krb5_init@52-64@usr.bin/ssh/auth-krb5.c","usr.bin/ssh/auth-krb5.c","krb5_init",52,64
61,13,345,2,77,"auth_krb5_password@67-144@usr.bin/ssh/auth-krb5.c","usr.bin/ssh/auth-krb5.c","auth_krb5_password",67,144
16,4,84,1,15,"krb5_cleanup_proc@147-162@usr.bin/ssh/auth-krb5.c","usr.bin/ssh/auth-krb5.c","krb5_cleanup_proc",147,162
22,2,96,1,22,"auth_clear_options@64-86@usr.bin/ssh/auth-options.c","usr.bin/ssh/auth-options.c","auth_clear_options",64,86
19,7,120,4,19,"match_flag@97-116@usr.bin/ssh/auth-options.c","usr.bin/ssh/auth-options.c","match_flag",97,116
306,61,1664,4,326,"auth_parse_options@124-450@usr.bin/ssh/auth-options.c","usr.bin/ssh/auth-options.c","auth_parse_options",124,450
139,28,699,11,145,"parse_option_list@455-600@usr.bin/ssh/auth-options.c","usr.bin/ssh/auth-options.c","parse_option_list",455,600
44,7,234,3,52,"auth_cert_options@607-659@usr.bin/ssh/auth-options.c","usr.bin/ssh/auth-options.c","auth_cert_options",607,659
6,1,18,1,5,"disable_forwarding@69-74@usr.bin/ssh/auth-passwd.c","usr.bin/ssh/auth-passwd.c","disable_forwarding",69,74
17,12,122,2,21,"auth_password@81-102@usr.bin/ssh/auth-passwd.c","usr.bin/ssh/auth-passwd.c","auth_password",81,102
28,8,193,2,29,"warn_expiry@105-134@usr.bin/ssh/auth-passwd.c","usr.bin/ssh/auth-passwd.c","warn_expiry",105,134
22,4,124,2,22,"sys_auth_passwd@137-159@usr.bin/ssh/auth-passwd.c","usr.bin/ssh/auth-passwd.c","sys_auth_passwd",137,159
92,31,553,5,126,"check_rhosts_file@52-178@usr.bin/ssh/auth-rhosts.c","usr.bin/ssh/auth-rhosts.c","check_rhosts_file",52,178
90,22,542,4,134,"auth_rhosts2@186-320@usr.bin/ssh/auth-rhosts.c","usr.bin/ssh/auth-rhosts.c","auth_rhosts2",186,320
92,29,563,1,112,"allowed_user@83-195@usr.bin/ssh/auth.c","usr.bin/ssh/auth.c","allowed_user",83,195
29,9,200,1,30,"format_method_key@202-232@usr.bin/ssh/auth.c","usr.bin/ssh/auth.c","format_method_key",202,232
36,18,236,5,42,"auth_log@235-277@usr.bin/ssh/auth.c","usr.bin/ssh/auth.c","auth_log",235,277
11,2,48,1,12,"auth_maxtries_exceeded@280-292@usr.bin/ssh/auth.c","usr.bin/ssh/auth.c","auth_maxtries_exceeded",280,292
23,8,104,1,23,"auth_root_allowed@298-321@usr.bin/ssh/auth.c","usr.bin/ssh/auth.c","auth_root_allowed",298,321
14,4,117,2,20,"expand_authorized_keys@332-352@usr.bin/ssh/auth.c","usr.bin/ssh/auth.c","expand_authorized_keys",332,352
6,2,30,1,5,"authorized_principals_file@355-360@usr.bin/ssh/auth.c","usr.bin/ssh/auth.c","authorized_principals_file",355,360
40,9,249,5,42,"check_key_in_hostfiles@364-406@usr.bin/ssh/auth.c","usr.bin/ssh/auth.c","check_key_in_hostfiles",364,406
37,9,225,5,39,"auth_openfile@409-448@usr.bin/ssh/auth.c","usr.bin/ssh/auth.c","auth_openfile",409,448
4,1,31,3,3,"auth_openkeyfile@452-455@usr.bin/ssh/auth.c","usr.bin/ssh/auth.c","auth_openkeyfile",452,455
5,1,31,3,4,"auth_openprincipals@458-462@usr.bin/ssh/auth.c","usr.bin/ssh/auth.c","auth_openprincipals",458,462
34,9,231,1,35,"getpwnamallow@465-500@usr.bin/ssh/auth.c","usr.bin/ssh/auth.c","getpwnamallow",465,500
31,6,160,1,35,"auth_key_is_revoked@504-539@usr.bin/ssh/auth.c","usr.bin/ssh/auth.c","auth_key_is_revoked",504,539
11,2,61,2,12,"auth_debug_add@542-554@usr.bin/ssh/auth.c","usr.bin/ssh/auth.c","auth_debug_add",542,554
11,3,49,1,11,"auth_debug_send@557-568@usr.bin/ssh/auth.c","usr.bin/ssh/auth.c","auth_debug_send",557,568
9,2,29,1,8,"auth_debug_reset@571-579@usr.bin/ssh/auth.c","usr.bin/ssh/auth.c","auth_debug_reset",571,579
15,1,86,1,16,"fakepw@582-598@usr.bin/ssh/auth.c","usr.bin/ssh/auth.c","fakepw",582,598
51,9,376,1,76,"remote_hostname@611-687@usr.bin/ssh/auth.c","usr.bin/ssh/auth.c","remote_hostname",611,687
12,3,51,2,12,"auth_get_canonical_hostname@696-708@usr.bin/ssh/auth.c","usr.bin/ssh/auth.c","auth_get_canonical_hostname",696,708
26,5,180,1,27,"kbdint_alloc@64-91@usr.bin/ssh/auth2-chall.c","usr.bin/ssh/auth2-chall.c","kbdint_alloc",64,91
8,2,39,1,7,"kbdint_reset_device@93-100@usr.bin/ssh/auth2-chall.c","usr.bin/ssh/auth2-chall.c","kbdint_reset_device",93,100
8,2,42,1,7,"kbdint_free@102-109@usr.bin/ssh/auth2-chall.c","usr.bin/ssh/auth2-chall.c","kbdint_free",102,109
31,13,218,2,33,"kbdint_next_device@112-145@usr.bin/ssh/auth2-chall.c","usr.bin/ssh/auth2-chall.c","kbdint_next_device",112,145
12,6,79,2,12,"auth2_challenge@152-164@usr.bin/ssh/auth2-chall.c","usr.bin/ssh/auth2-chall.c","auth2_challenge",152,164
9,2,49,1,9,"auth2_challenge_stop@168-177@usr.bin/ssh/auth2-chall.c","usr.bin/ssh/auth2-chall.c","auth2_challenge_stop",168,177
25,5,139,1,28,"auth2_challenge_start@181-209@usr.bin/ssh/auth2-chall.c","usr.bin/ssh/auth2-chall.c","auth2_challenge_start",181,209
28,4,181,1,30,"send_userauth_info_request@212-242@usr.bin/ssh/auth2-chall.c","usr.bin/ssh/auth2-chall.c","send_userauth_info_request",212,242
56,16,339,3,65,"input_userauth_info_response@245-310@usr.bin/ssh/auth2-chall.c","usr.bin/ssh/auth2-chall.c","input_userauth_info_response",245,310
5,1,18,1,4,"privsep_challenge_enable@313-317@usr.bin/ssh/auth2-chall.c","usr.bin/ssh/auth2-chall.c","privsep_challenge_enable",313,317
53,12,317,1,67,"userauth_gssapi@56-123@usr.bin/ssh/auth2-gss.c","usr.bin/ssh/auth2-gss.c","userauth_gssapi",56,123
46,9,273,3,52,"input_gssapi_token@126-178@usr.bin/ssh/auth2-gss.c","usr.bin/ssh/auth2-gss.c","input_gssapi_token",126,178
22,4,144,3,32,"input_gssapi_errtok@181-213@usr.bin/ssh/auth2-gss.c","usr.bin/ssh/auth2-gss.c","input_gssapi_errtok",181,213
20,6,155,3,29,"input_gssapi_exchange_complete@222-251@usr.bin/ssh/auth2-gss.c","usr.bin/ssh/auth2-gss.c","input_gssapi_exchange_complete",222,251
35,7,265,3,43,"input_gssapi_mic@254-297@usr.bin/ssh/auth2-gss.c","usr.bin/ssh/auth2-gss.c","input_gssapi_mic",254,297
88,29,688,1,101,"userauth_hostbased@59-160@usr.bin/ssh/auth2-hostbased.c","usr.bin/ssh/auth2-hostbased.c","userauth_hostbased",59,160
75,17,473,4,85,"hostbased_key_allowed@164-249@usr.bin/ssh/auth2-hostbased.c","usr.bin/ssh/auth2-hostbased.c","hostbased_key_allowed",164,249
14,2,74,1,17,"userauth_kbdint@42-59@usr.bin/ssh/auth2-kbdint.c","usr.bin/ssh/auth2-kbdint.c","userauth_kbdint",42,59
10,4,71,1,10,"userauth_none@54-64@usr.bin/ssh/auth2-none.c","usr.bin/ssh/auth2-none.c","userauth_none",54,64
19,7,146,1,20,"userauth_passwd@49-69@usr.bin/ssh/auth2-passwd.c","usr.bin/ssh/auth2-passwd.c","userauth_passwd",49,69
146,47,1115,1,165,"userauth_pubkey@74-239@usr.bin/ssh/auth2-pubkey.c","usr.bin/ssh/auth2-pubkey.c","userauth_pubkey",74,239
15,3,80,2,17,"match_principals_option@242-259@usr.bin/ssh/auth2-pubkey.c","usr.bin/ssh/auth2-pubkey.c","match_principals_option",242,259
40,19,310,4,48,"process_principals@262-310@usr.bin/ssh/auth2-pubkey.c","usr.bin/ssh/auth2-pubkey.c","process_principals",262,310
15,2,90,3,15,"match_principals_file@313-328@usr.bin/ssh/auth2-pubkey.c","usr.bin/ssh/auth2-pubkey.c","match_principals_file",313,328
106,17,698,2,123,"match_principals_command@335-458@usr.bin/ssh/auth2-pubkey.c","usr.bin/ssh/auth2-pubkey.c","match_principals_command",335,458
98,38,631,4,111,"check_authkeys_file@464-575@usr.bin/ssh/auth2-pubkey.c","usr.bin/ssh/auth2-pubkey.c","check_authkeys_file",464,575
48,15,334,2,59,"user_cert_trusted_ca@579-638@usr.bin/ssh/auth2-pubkey.c","usr.bin/ssh/auth2-pubkey.c","user_cert_trusted_ca",579,638
13,2,85,3,16,"user_key_allowed2@645-661@usr.bin/ssh/auth2-pubkey.c","usr.bin/ssh/auth2-pubkey.c","user_key_allowed2",645,661
92,16,612,2,118,"user_key_command_allowed2@668-786@usr.bin/ssh/auth2-pubkey.c","usr.bin/ssh/auth2-pubkey.c","user_key_command_allowed2",668,786
25,9,160,3,31,"user_key_allowed@792-823@usr.bin/ssh/auth2-pubkey.c","usr.bin/ssh/auth2-pubkey.c","user_key_allowed",792,823
27,6,168,1,30,"auth2_read_banner@102-132@usr.bin/ssh/auth2.c","usr.bin/ssh/auth2.c","auth2_read_banner",102,132
15,4,79,1,17,"userauth_banner@135-152@usr.bin/ssh/auth2.c","usr.bin/ssh/auth2.c","userauth_banner",135,152
9,1,57,1,8,"do_authentication2@158-166@usr.bin/ssh/auth2.c","usr.bin/ssh/auth2.c","do_authentication2",158,166
27,5,141,3,31,"input_service_request@170-201@usr.bin/ssh/auth2.c","usr.bin/ssh/auth2.c","input_service_request",170,201
59,17,443,3,73,"input_userauth_request@205-278@usr.bin/ssh/auth2.c","usr.bin/ssh/auth2.c","input_userauth_request",205,278
49,20,306,4,61,"userauth_finish@281-342@usr.bin/ssh/auth2.c","usr.bin/ssh/auth2.c","userauth_finish",281,342
13,4,73,3,17,"auth2_method_allowed@350-367@usr.bin/ssh/auth2.c","usr.bin/ssh/auth2.c","auth2_method_allowed",350,367
25,8,177,1,25,"authmethods_get@370-395@usr.bin/ssh/auth2.c","usr.bin/ssh/auth2.c","authmethods_get",370,395
15,8,109,2,15,"authmethod_lookup@398-413@usr.bin/ssh/auth2.c","usr.bin/ssh/auth2.c","authmethod_lookup",398,413
39,11,223,2,39,"auth2_methods_valid@421-460@usr.bin/ssh/auth2.c","usr.bin/ssh/auth2.c","auth2_methods_valid",421,460
28,5,163,1,28,"auth2_setup_methods_lists@470-498@usr.bin/ssh/auth2.c","usr.bin/ssh/auth2.c","auth2_setup_methods_lists",470,498
24,7,129,3,24,"list_starts_with@501-525@usr.bin/ssh/auth2.c","usr.bin/ssh/auth2.c","list_starts_with",501,525
17,6,112,3,17,"remove_method@533-550@usr.bin/ssh/auth2.c","usr.bin/ssh/auth2.c","remove_method",533,550
21,5,130,3,22,"auth2_update_methods_lists@559-581@usr.bin/ssh/auth2.c","usr.bin/ssh/auth2.c","auth2_update_methods_lists",559,581
7,1,34,1,6,"auth2_authctxt_reset_info@584-590@usr.bin/ssh/auth2.c","usr.bin/ssh/auth2.c","auth2_authctxt_reset_info",584,590
12,3,79,3,14,"auth2_record_info@594-608@usr.bin/ssh/auth2.c","usr.bin/ssh/auth2.c","auth2_record_info",594,608
21,6,172,3,25,"auth2_record_key@616-641@usr.bin/ssh/auth2.c","usr.bin/ssh/auth2.c","auth2_record_key",616,641
17,4,108,2,17,"auth2_key_already_used@645-662@usr.bin/ssh/auth2.c","usr.bin/ssh/auth2.c","auth2_key_already_used",645,662
31,14,264,3,37,"auth2_update_session_info@669-706@usr.bin/ssh/auth2.c","usr.bin/ssh/auth2.c","auth2_update_session_info",669,706
9,3,31,1,8,"decode_reply@73-81@usr.bin/ssh/authfd.c","usr.bin/ssh/authfd.c","decode_reply",73,81
28,7,176,1,33,"ssh_get_authentication_socket@85-118@usr.bin/ssh/authfd.c","usr.bin/ssh/authfd.c","ssh_get_authentication_socket",85,118
29,9,201,3,40,"ssh_request_reply@122-162@usr.bin/ssh/authfd.c","usr.bin/ssh/authfd.c","ssh_request_reply",122,162
5,2,19,1,4,"ssh_close_authentication_socket@170-174@usr.bin/ssh/authfd.c","usr.bin/ssh/authfd.c","ssh_close_authentication_socket",170,174
19,7,134,3,19,"ssh_lock_agent@178-197@usr.bin/ssh/authfd.c","usr.bin/ssh/authfd.c","ssh_lock_agent",178,197
20,5,124,3,20,"deserialise_identity2@201-221@usr.bin/ssh/authfd.c","usr.bin/ssh/authfd.c","deserialise_identity2",201,221
59,17,366,2,71,"ssh_fetch_identitylist@227-298@usr.bin/ssh/authfd.c","usr.bin/ssh/authfd.c","ssh_fetch_identitylist",227,298
13,5,78,1,13,"ssh_free_identitylist@301-314@usr.bin/ssh/authfd.c","usr.bin/ssh/authfd.c","ssh_free_identitylist",301,314
10,5,61,2,9,"agent_encode_alg@326-335@usr.bin/ssh/authfd.c","usr.bin/ssh/authfd.c","agent_encode_alg",326,335
48,15,336,8,49,"ssh_agent_sign@339-388@usr.bin/ssh/authfd.c","usr.bin/ssh/authfd.c","ssh_agent_sign",339,388
9,3,56,3,9,"ssh_encode_identity_ssh2@394-403@usr.bin/ssh/authfd.c","usr.bin/ssh/authfd.c","ssh_encode_identity_ssh2",394,403
16,6,92,3,16,"encode_constraints@406-422@usr.bin/ssh/authfd.c","usr.bin/ssh/authfd.c","encode_constraints",406,422
40,18,219,5,43,"ssh_add_identity_constrained@429-472@usr.bin/ssh/authfd.c","usr.bin/ssh/authfd.c","ssh_add_identity_constrained",429,472
32,9,197,2,33,"ssh_remove_identity@479-512@usr.bin/ssh/authfd.c","usr.bin/ssh/authfd.c","ssh_remove_identity",479,512
30,11,201,6,31,"ssh_update_card@519-550@usr.bin/ssh/authfd.c","usr.bin/ssh/authfd.c","ssh_update_card",519,550
20,6,120,2,20,"ssh_remove_all_identities@561-581@usr.bin/ssh/authfd.c","usr.bin/ssh/authfd.c","ssh_remove_all_identities",561,581
16,3,102,2,16,"sshkey_save_private_blob@54-70@usr.bin/ssh/authfile.c","usr.bin/ssh/authfile.c","sshkey_save_private_blob",54,70
18,4,120,7,18,"sshkey_save_private@73-91@usr.bin/ssh/authfile.c","usr.bin/ssh/authfile.c","sshkey_save_private",73,91
37,12,223,2,38,"sshkey_load_file@95-133@usr.bin/ssh/authfile.c","usr.bin/ssh/authfile.c","sshkey_load_file",95,133
17,4,102,2,22,"sshkey_perm_ok@138-160@usr.bin/ssh/authfile.c","usr.bin/ssh/authfile.c","sshkey_perm_ok",138,160
26,8,155,6,28,"sshkey_load_private_type@164-192@usr.bin/ssh/authfile.c","usr.bin/ssh/authfile.c","sshkey_load_private_type",164,192
20,5,117,5,22,"sshkey_load_private_type_fd@195-217@usr.bin/ssh/authfile.c","usr.bin/ssh/authfile.c","sshkey_load_private_type_fd",195,217
29,8,170,4,31,"sshkey_load_private@221-252@usr.bin/ssh/authfile.c","usr.bin/ssh/authfile.c","sshkey_load_private",221,252
42,17,244,3,44,"sshkey_try_load_public@255-299@usr.bin/ssh/authfile.c","usr.bin/ssh/authfile.c","sshkey_try_load_public",255,299
38,10,215,3,41,"sshkey_load_public@303-344@usr.bin/ssh/authfile.c","usr.bin/ssh/authfile.c","sshkey_load_public",303,344
24,6,135,2,27,"sshkey_load_cert@348-375@usr.bin/ssh/authfile.c","usr.bin/ssh/authfile.c","sshkey_load_cert",348,375
38,14,206,5,45,"sshkey_load_private_cert@379-424@usr.bin/ssh/authfile.c","usr.bin/ssh/authfile.c","sshkey_load_private_cert",379,424
45,16,267,4,51,"sshkey_in_file@435-486@usr.bin/ssh/authfile.c","usr.bin/ssh/authfile.c","sshkey_in_file",435,486
15,4,71,2,24,"sshkey_check_revoked@496-520@usr.bin/ssh/authfile.c","usr.bin/ssh/authfile.c","sshkey_check_revoked",496,520
13,3,75,1,13,"bitmap_new@36-49@usr.bin/ssh/bitmap.c","usr.bin/ssh/bitmap.c","bitmap_new",36,49
9,3,46,1,8,"bitmap_free@52-60@usr.bin/ssh/bitmap.c","usr.bin/ssh/bitmap.c","bitmap_free",52,60
5,1,30,1,4,"bitmap_zero@63-67@usr.bin/ssh/bitmap.c","usr.bin/ssh/bitmap.c","bitmap_zero",63,67
8,4,67,2,7,"bitmap_test_bit@70-77@usr.bin/ssh/bitmap.c","usr.bin/ssh/bitmap.c","bitmap_test_bit",70,77
16,5,99,2,16,"reserve@80-96@usr.bin/ssh/bitmap.c","usr.bin/ssh/bitmap.c","reserve",80,96
12,3,78,2,12,"bitmap_set_bit@99-111@usr.bin/ssh/bitmap.c","usr.bin/ssh/bitmap.c","bitmap_set_bit",99,111
7,4,45,1,6,"retop@115-121@usr.bin/ssh/bitmap.c","usr.bin/ssh/bitmap.c","retop",115,121
11,4,73,2,12,"bitmap_clear_bit@124-136@usr.bin/ssh/bitmap.c","usr.bin/ssh/bitmap.c","bitmap_clear_bit",124,136
17,6,118,1,18,"bitmap_nbits@139-157@usr.bin/ssh/bitmap.c","usr.bin/ssh/bitmap.c","bitmap_nbits",139,157
4,1,21,1,3,"bitmap_nbytes@160-163@usr.bin/ssh/bitmap.c","usr.bin/ssh/bitmap.c","bitmap_nbytes",160,163
17,7,143,3,18,"bitmap_to_string@166-184@usr.bin/ssh/bitmap.c","usr.bin/ssh/bitmap.c","bitmap_to_string",166,184
25,6,188,3,25,"bitmap_from_string@187-212@usr.bin/ssh/bitmap.c","usr.bin/ssh/bitmap.c","bitmap_from_string",187,212
13,1,147,1,12,"load_bigendian@12-24@usr.bin/ssh/blocks.c","usr.bin/ssh/blocks.c","load_bigendian",12,24
11,1,103,2,10,"store_bigendian@26-36@usr.bin/ssh/blocks.c","usr.bin/ssh/blocks.c","store_bigendian",26,36
151,2,1055,3,166,"crypto_hashblocks_sha512@80-246@usr.bin/ssh/blocks.c","usr.bin/ssh/blocks.c","crypto_hashblocks_sha512",80,246
9,2,51,2,9,"buffer_get_short_ret@27-36@usr.bin/ssh/bufaux.c","usr.bin/ssh/bufaux.c","buffer_get_short_ret",27,36
7,2,36,1,8,"buffer_get_short@39-47@usr.bin/ssh/bufaux.c","usr.bin/ssh/bufaux.c","buffer_get_short",39,47
9,2,51,2,9,"buffer_get_int_ret@50-59@usr.bin/ssh/bufaux.c","usr.bin/ssh/bufaux.c","buffer_get_int_ret",50,59
7,2,36,1,8,"buffer_get_int@62-70@usr.bin/ssh/bufaux.c","usr.bin/ssh/bufaux.c","buffer_get_int",62,70
9,2,51,2,9,"buffer_get_int64_ret@73-82@usr.bin/ssh/bufaux.c","usr.bin/ssh/bufaux.c","buffer_get_int64_ret",73,82
7,2,36,1,8,"buffer_get_int64@85-93@usr.bin/ssh/bufaux.c","usr.bin/ssh/bufaux.c","buffer_get_int64",85,93
6,2,41,2,6,"buffer_put_short@96-102@usr.bin/ssh/bufaux.c","usr.bin/ssh/bufaux.c","buffer_put_short",96,102
6,2,41,2,6,"buffer_put_int@105-111@usr.bin/ssh/bufaux.c","usr.bin/ssh/bufaux.c","buffer_put_int",105,111
6,2,41,2,6,"buffer_put_int64@114-120@usr.bin/ssh/bufaux.c","usr.bin/ssh/bufaux.c","buffer_put_int64",114,120
13,3,72,2,13,"buffer_get_string_ret@123-136@usr.bin/ssh/bufaux.c","usr.bin/ssh/bufaux.c","buffer_get_string_ret",123,136
7,2,43,2,7,"buffer_get_string@139-146@usr.bin/ssh/bufaux.c","usr.bin/ssh/bufaux.c","buffer_get_string",139,146
13,3,72,2,13,"buffer_get_cstring_ret@149-162@usr.bin/ssh/bufaux.c","usr.bin/ssh/bufaux.c","buffer_get_cstring_ret",149,162
7,2,41,2,7,"buffer_get_cstring@165-172@usr.bin/ssh/bufaux.c","usr.bin/ssh/bufaux.c","buffer_get_cstring",165,172
13,3,73,2,13,"buffer_get_string_ptr_ret@175-188@usr.bin/ssh/bufaux.c","usr.bin/ssh/bufaux.c","buffer_get_string_ptr_ret",175,188
7,2,44,2,7,"buffer_get_string_ptr@191-198@usr.bin/ssh/bufaux.c","usr.bin/ssh/bufaux.c","buffer_get_string_ptr",191,198
6,2,48,3,6,"buffer_put_string@201-207@usr.bin/ssh/bufaux.c","usr.bin/ssh/bufaux.c","buffer_put_string",201,207
6,2,43,2,6,"buffer_put_cstring@210-216@usr.bin/ssh/bufaux.c","usr.bin/ssh/bufaux.c","buffer_put_cstring",210,216
9,2,55,2,9,"buffer_get_char_ret@219-228@usr.bin/ssh/bufaux.c","usr.bin/ssh/bufaux.c","buffer_get_char_ret",219,228
7,2,37,1,7,"buffer_get_char@231-238@usr.bin/ssh/bufaux.c","usr.bin/ssh/bufaux.c","buffer_get_char",231,238
6,2,41,2,6,"buffer_put_char@241-247@usr.bin/ssh/bufaux.c","usr.bin/ssh/bufaux.c","buffer_put_char",241,247
6,2,48,3,6,"buffer_put_bignum2_from_string@250-256@usr.bin/ssh/bufaux.c","usr.bin/ssh/bufaux.c","buffer_put_bignum2_from_string",250,256
9,2,52,2,9,"buffer_put_bignum2_ret@29-38@usr.bin/ssh/bufbn.c","usr.bin/ssh/bufbn.c","buffer_put_bignum2_ret",29,38
5,2,32,2,4,"buffer_put_bignum2@41-45@usr.bin/ssh/bufbn.c","usr.bin/ssh/bufbn.c","buffer_put_bignum2",41,45
9,2,51,2,9,"buffer_get_bignum2_ret@48-57@usr.bin/ssh/bufbn.c","usr.bin/ssh/bufbn.c","buffer_get_bignum2_ret",48,57
5,2,31,2,4,"buffer_get_bignum2@60-64@usr.bin/ssh/bufbn.c","usr.bin/ssh/bufbn.c","buffer_get_bignum2",60,64
10,2,59,3,10,"buffer_put_ecpoint_ret@28-38@usr.bin/ssh/bufec.c","usr.bin/ssh/bufec.c","buffer_put_ecpoint_ret",28,38
6,2,39,3,5,"buffer_put_ecpoint@41-46@usr.bin/ssh/bufec.c","usr.bin/ssh/bufec.c","buffer_put_ecpoint",41,46
10,2,58,3,10,"buffer_get_ecpoint_ret@49-59@usr.bin/ssh/bufec.c","usr.bin/ssh/bufec.c","buffer_get_ecpoint_ret",49,59
6,2,38,3,5,"buffer_get_ecpoint@62-67@usr.bin/ssh/bufec.c","usr.bin/ssh/bufec.c","buffer_get_ecpoint",62,67
6,2,48,3,6,"buffer_append@28-34@usr.bin/ssh/buffer.c","usr.bin/ssh/buffer.c","buffer_append",28,34
8,2,51,2,8,"buffer_append_space@37-45@usr.bin/ssh/buffer.c","usr.bin/ssh/buffer.c","buffer_append_space",37,45
9,3,51,2,9,"buffer_check_alloc@48-57@usr.bin/ssh/buffer.c","usr.bin/ssh/buffer.c","buffer_check_alloc",48,57
9,2,56,3,9,"buffer_get_ret@60-69@usr.bin/ssh/buffer.c","usr.bin/ssh/buffer.c","buffer_get_ret",60,69
5,2,36,3,4,"buffer_get@72-76@usr.bin/ssh/buffer.c","usr.bin/ssh/buffer.c","buffer_get",72,76
9,3,52,2,9,"buffer_consume_ret@79-88@usr.bin/ssh/buffer.c","usr.bin/ssh/buffer.c","buffer_consume_ret",79,88
5,2,30,2,4,"buffer_consume@91-95@usr.bin/ssh/buffer.c","usr.bin/ssh/buffer.c","buffer_consume",91,95
9,3,52,2,9,"buffer_consume_end_ret@98-107@usr.bin/ssh/buffer.c","usr.bin/ssh/buffer.c","buffer_consume_end_ret",98,107
5,2,30,2,4,"buffer_consume_end@110-114@usr.bin/ssh/buffer.c","usr.bin/ssh/buffer.c","buffer_consume_end",110,114
31,8,201,3,37,"get_socket_address@40-77@usr.bin/ssh/canohost.c","usr.bin/ssh/canohost.c","get_socket_address",40,77
7,2,37,1,7,"get_peer_ipaddr@80-87@usr.bin/ssh/canohost.c","usr.bin/ssh/canohost.c","get_peer_ipaddr",80,87
7,2,37,1,7,"get_local_ipaddr@90-97@usr.bin/ssh/canohost.c","usr.bin/ssh/canohost.c","get_local_ipaddr",90,97
13,3,85,1,17,"get_local_name@100-117@usr.bin/ssh/canohost.c","usr.bin/ssh/canohost.c","get_local_name",100,117
27,7,195,2,32,"get_sock_port@122-154@usr.bin/ssh/canohost.c","usr.bin/ssh/canohost.c","get_sock_port",122,154
4,1,15,1,3,"get_peer_port@157-160@usr.bin/ssh/canohost.c","usr.bin/ssh/canohost.c","get_peer_port",157,160
4,1,15,1,3,"get_local_port@163-166@usr.bin/ssh/canohost.c","usr.bin/ssh/canohost.c","get_local_port",163,166
22,2,212,3,22,"chacha_keysetup@54-76@usr.bin/ssh/chacha.c","usr.bin/ssh/chacha.c","chacha_keysetup",54,76
7,3,86,3,6,"chacha_ivsetup@79-85@usr.bin/ssh/chacha.c","usr.bin/ssh/chacha.c","chacha_ivsetup",79,85
122,10,1066,4,129,"chacha_encrypt_bytes@88-217@usr.bin/ssh/chacha.c","usr.bin/ssh/chacha.c","chacha_encrypt_bytes",88,217
15,4,124,1,16,"channel_init_channels@215-231@usr.bin/ssh/channels.c","usr.bin/ssh/channels.c","channel_init_channels",215,231
14,4,81,2,14,"channel_by_id@234-248@usr.bin/ssh/channels.c","usr.bin/ssh/channels.c","channel_by_id",234,248
11,5,71,2,11,"channel_by_remote_id@251-262@usr.bin/ssh/channels.c","usr.bin/ssh/channels.c","channel_by_remote_id",251,262
21,12,89,2,22,"channel_lookup@269-291@usr.bin/ssh/channels.c","usr.bin/ssh/channels.c","channel_lookup",269,291
29,13,245,8,35,"channel_register_fds@298-333@usr.bin/ssh/channels.c","usr.bin/ssh/channels.c","channel_register_fds",298,333
43,8,347,11,50,"channel_new@340-390@usr.bin/ssh/channels.c","usr.bin/ssh/channels.c","channel_new",340,390
15,3,94,1,15,"channel_find_maxfd@393-408@usr.bin/ssh/channels.c","usr.bin/ssh/channels.c","channel_find_maxfd",393,408
12,3,70,2,12,"channel_close_fd@411-423@usr.bin/ssh/channels.c","usr.bin/ssh/channels.c","channel_close_fd",411,423
7,1,53,2,6,"channel_close_fds@427-433@usr.bin/ssh/channels.c","usr.bin/ssh/channels.c","channel_close_fds",427,433
7,1,40,1,6,"fwd_perm_clear@436-442@usr.bin/ssh/channels.c","usr.bin/ssh/channels.c","fwd_perm_clear",436,442
31,4,242,8,35,"fwd_perm_list_add@447-482@usr.bin/ssh/channels.c","usr.bin/ssh/channels.c","fwd_perm_list_add",447,482
26,9,194,2,28,"mux_remove_remote_forwardings@485-513@usr.bin/ssh/channels.c","usr.bin/ssh/channels.c","mux_remove_remote_forwardings",485,513
51,12,390,2,55,"channel_free@517-572@usr.bin/ssh/channels.c","usr.bin/ssh/channels.c","channel_free",517,572
7,3,56,1,7,"channel_free_all@575-582@usr.bin/ssh/channels.c","usr.bin/ssh/channels.c","channel_free_all",575,582
7,3,56,1,7,"channel_close_all@589-596@usr.bin/ssh/channels.c","usr.bin/ssh/channels.c","channel_close_all",589,596
21,9,99,1,21,"channel_stop_listening@602-623@usr.bin/ssh/channels.c","usr.bin/ssh/channels.c","channel_stop_listening",602,623
17,5,105,1,17,"channel_not_very_much_buffered_data@630-647@usr.bin/ssh/channels.c","usr.bin/ssh/channels.c","channel_not_very_much_buffered_data",630,647
38,23,145,1,39,"channel_still_open@651-690@usr.bin/ssh/channels.c","usr.bin/ssh/channels.c","channel_still_open",651,690
37,24,149,1,38,"channel_find_open@694-732@usr.bin/ssh/channels.c","usr.bin/ssh/channels.c","channel_find_open",694,732
58,28,311,1,59,"channel_open_message@740-799@usr.bin/ssh/channels.c","usr.bin/ssh/channels.c","channel_open_message",740,799
11,6,117,4,11,"open_preamble@802-813@usr.bin/ssh/channels.c","usr.bin/ssh/channels.c","open_preamble",802,813
13,3,92,2,13,"channel_send_open@816-829@usr.bin/ssh/channels.c","usr.bin/ssh/channels.c","channel_send_open",816,829
18,7,155,4,19,"channel_request_start@832-851@usr.bin/ssh/channels.c","usr.bin/ssh/channels.c","channel_request_start",832,851
13,2,100,5,14,"channel_register_status_confirm@854-868@usr.bin/ssh/channels.c","usr.bin/ssh/channels.c","channel_register_status_confirm",854,868
11,2,62,4,11,"channel_register_open_confirm@871-882@usr.bin/ssh/channels.c","usr.bin/ssh/channels.c","channel_register_open_confirm",871,882
11,2,61,4,11,"channel_register_cleanup@885-896@usr.bin/ssh/channels.c","usr.bin/ssh/channels.c","channel_register_cleanup",885,896
10,2,54,2,10,"channel_cancel_cleanup@899-909@usr.bin/ssh/channels.c","usr.bin/ssh/channels.c","channel_cancel_cleanup",899,909
13,2,82,6,13,"channel_register_filter@912-925@usr.bin/ssh/channels.c","usr.bin/ssh/channels.c","channel_register_filter",912,925
18,8,191,9,20,"channel_set_fds@928-948@usr.bin/ssh/channels.c","usr.bin/ssh/channels.c","channel_set_fds",928,948
5,1,30,4,4,"channel_pre_listener@951-955@usr.bin/ssh/channels.c","usr.bin/ssh/channels.c","channel_pre_listener",951,955
6,1,39,4,5,"channel_pre_connecting@958-963@usr.bin/ssh/channels.c","usr.bin/ssh/channels.c","channel_pre_connecting",958,963
33,20,256,4,34,"channel_pre_open@966-1000@usr.bin/ssh/channels.c","usr.bin/ssh/channels.c","channel_pre_open",966,1000
48,12,350,2,64,"x11_open_helper@1012-1076@usr.bin/ssh/channels.c","usr.bin/ssh/channels.c","x11_open_helper",1012,1076
19,3,142,4,21,"channel_pre_x11_open@1079-1100@usr.bin/ssh/channels.c","usr.bin/ssh/channels.c","channel_pre_x11_open",1079,1100
19,9,137,4,20,"channel_pre_mux_client@1103-1123@usr.bin/ssh/channels.c","usr.bin/ssh/channels.c","channel_pre_mux_client",1103,1123
106,24,738,3,114,"channel_decode_socks4@1127-1241@usr.bin/ssh/channels.c","usr.bin/ssh/channels.c","channel_decode_socks4",1127,1241
125,31,847,3,133,"channel_decode_socks5@1253-1386@usr.bin/ssh/channels.c","usr.bin/ssh/channels.c","channel_decode_socks5",1253,1386
16,1,125,5,20,"channel_connect_stdio_fwd@1389-1409@usr.bin/ssh/channels.c","usr.bin/ssh/channels.c","channel_connect_stdio_fwd",1389,1409
36,7,216,4,43,"channel_pre_dynamic@1413-1456@usr.bin/ssh/channels.c","usr.bin/ssh/channels.c","channel_pre_dynamic",1413,1456
9,1,54,2,8,"rdynamic_close@1460-1468@usr.bin/ssh/channels.c","usr.bin/ssh/channels.c","rdynamic_close",1460,1468
52,16,369,2,59,"channel_before_prepare_select_rdynamic@1472-1531@usr.bin/ssh/channels.c","usr.bin/ssh/channels.c","channel_before_prepare_select_rdynamic",1472,1531
51,13,384,4,53,"channel_post_x11_listener@1535-1588@usr.bin/ssh/channels.c","usr.bin/ssh/channels.c","channel_post_x11_listener",1535,1588
59,17,496,3,68,"port_open_helper@1591-1659@usr.bin/ssh/channels.c","usr.bin/ssh/channels.c","port_open_helper",1591,1659
4,1,20,2,3,"channel_set_x11_refuse_time@1662-1665@usr.bin/ssh/channels.c","usr.bin/ssh/channels.c","channel_set_x11_refuse_time",1662,1665
49,15,334,4,53,"channel_post_port_listener@1671-1724@usr.bin/ssh/channels.c","usr.bin/ssh/channels.c","channel_post_port_listener",1671,1724
25,6,190,4,26,"channel_post_auth_listener@1731-1757@usr.bin/ssh/channels.c","usr.bin/ssh/channels.c","channel_post_auth_listener",1731,1757
68,20,544,4,72,"channel_post_connecting@1760-1832@usr.bin/ssh/channels.c","usr.bin/ssh/channels.c","channel_post_connecting",1760,1832
38,13,288,4,39,"channel_handle_rfd@1835-1874@usr.bin/ssh/channels.c","usr.bin/ssh/channels.c","channel_handle_rfd",1835,1874
69,28,522,4,81,"channel_handle_wfd@1877-1958@usr.bin/ssh/channels.c","usr.bin/ssh/channels.c","channel_handle_wfd",1877,1958
24,8,186,4,25,"channel_handle_efd_write@1961-1986@usr.bin/ssh/channels.c","usr.bin/ssh/channels.c","channel_handle_efd_write",1961,1986
27,8,192,4,28,"channel_handle_efd_read@1989-2017@usr.bin/ssh/channels.c","usr.bin/ssh/channels.c","channel_handle_efd_read",1989,2017
12,5,83,4,15,"channel_handle_efd@2020-2035@usr.bin/ssh/channels.c","usr.bin/ssh/channels.c","channel_handle_efd",2020,2035
28,11,199,2,28,"channel_check_window@2038-2066@usr.bin/ssh/channels.c","usr.bin/ssh/channels.c","channel_check_window",2038,2066
8,1,61,4,7,"channel_post_open@2069-2076@usr.bin/ssh/channels.c","usr.bin/ssh/channels.c","channel_post_open",2069,2076
23,7,176,3,23,"read_mux@2079-2102@usr.bin/ssh/channels.c","usr.bin/ssh/channels.c","read_mux",2079,2102
27,10,178,4,34,"channel_post_mux_client_read@2105-2139@usr.bin/ssh/channels.c","usr.bin/ssh/channels.c","channel_post_mux_client_read",2105,2139
19,9,148,4,20,"channel_post_mux_client_write@2142-2162@usr.bin/ssh/channels.c","usr.bin/ssh/channels.c","channel_post_mux_client_write",2142,2162
6,1,43,4,5,"channel_post_mux_client@2165-2170@usr.bin/ssh/channels.c","usr.bin/ssh/channels.c","channel_post_mux_client",2165,2170
41,8,291,4,49,"channel_post_mux_listener@2173-2222@usr.bin/ssh/channels.c","usr.bin/ssh/channels.c","channel_post_mux_listener",2173,2222
34,3,271,1,37,"channel_handler_init@2225-2262@usr.bin/ssh/channels.c","usr.bin/ssh/channels.c","channel_handler_init",2225,2262
18,6,118,2,18,"channel_garbage_collect@2266-2284@usr.bin/ssh/channels.c","usr.bin/ssh/channels.c","channel_garbage_collect",2266,2284
39,14,268,5,46,"channel_handler@2289-2335@usr.bin/ssh/channels.c","usr.bin/ssh/channels.c","channel_handler",2289,2335
13,4,80,1,13,"channel_before_prepare_select@2343-2356@usr.bin/ssh/channels.c","usr.bin/ssh/channels.c","channel_before_prepare_select",2343,2356
22,6,194,6,28,"channel_prepare_select@2363-2391@usr.bin/ssh/channels.c","usr.bin/ssh/channels.c","channel_prepare_select",2363,2391
4,1,30,3,3,"channel_after_select@2398-2401@usr.bin/ssh/channels.c","usr.bin/ssh/channels.c","channel_after_select",2398,2401
54,21,417,2,72,"channel_output_poll_input_open@2407-2479@usr.bin/ssh/channels.c","usr.bin/ssh/channels.c","channel_output_poll_input_open",2407,2479
30,12,256,2,31,"channel_output_poll_extended_read@2485-2516@usr.bin/ssh/channels.c","usr.bin/ssh/channels.c","channel_output_poll_extended_read",2485,2516
24,9,141,1,33,"channel_output_poll@2520-2553@usr.bin/ssh/channels.c","usr.bin/ssh/channels.c","channel_output_poll",2520,2553
137,39,991,2,145,"channel_proxy_downstream@2596-2741@usr.bin/ssh/channels.c","usr.bin/ssh/channels.c","channel_proxy_downstream",2596,2741
66,27,364,4,77,"channel_proxy_upstream@2750-2827@usr.bin/ssh/channels.c","usr.bin/ssh/channels.c","channel_proxy_upstream",2750,2827
14,3,101,3,14,"channel_parse_id@2833-2847@usr.bin/ssh/channels.c","usr.bin/ssh/channels.c","channel_parse_id",2833,2847
10,2,66,3,10,"channel_from_packet_id@2851-2861@usr.bin/ssh/channels.c","usr.bin/ssh/channels.c","channel_from_packet_id",2851,2861
45,14,309,3,59,"channel_input_data@2864-2923@usr.bin/ssh/channels.c","usr.bin/ssh/channels.c","channel_input_data",2864,2923
47,12,312,3,50,"channel_input_extended_data@2926-2976@usr.bin/ssh/channels.c","usr.bin/ssh/channels.c","channel_input_extended_data",2926,2976
15,5,106,3,18,"channel_input_ieof@2979-2997@usr.bin/ssh/channels.c","usr.bin/ssh/channels.c","channel_input_ieof",2979,2997
9,2,59,3,9,"channel_input_oclose@3000-3009@usr.bin/ssh/channels.c","usr.bin/ssh/channels.c","channel_input_oclose",3000,3009
30,7,231,3,35,"channel_input_open_confirmation@3012-3047@usr.bin/ssh/channels.c","usr.bin/ssh/channels.c","channel_input_open_confirmation",3012,3047
14,5,40,1,13,"reason2txt@3050-3063@usr.bin/ssh/channels.c","usr.bin/ssh/channels.c","reason2txt",3050,3063
34,10,266,3,36,"channel_input_open_failure@3066-3102@usr.bin/ssh/channels.c","usr.bin/ssh/channels.c","channel_input_open_failure",3066,3102
26,5,176,3,27,"channel_input_window_adjust@3105-3132@usr.bin/ssh/channels.c","usr.bin/ssh/channels.c","channel_input_window_adjust",3105,3132
22,4,167,3,25,"channel_input_status_confirm@3135-3160@usr.bin/ssh/channels.c","usr.bin/ssh/channels.c","channel_input_status_confirm",3135,3160
4,1,20,2,3,"channel_set_af@3165-3168@usr.bin/ssh/channels.c","usr.bin/ssh/channels.c","channel_set_af",3165,3168
34,21,229,4,45,"channel_fwd_bind_addr@3187-3232@usr.bin/ssh/channels.c","usr.bin/ssh/channels.c","channel_fwd_bind_addr",3187,3232
117,31,756,5,149,"channel_setup_fwd_listener_tcpip@3235-3384@usr.bin/ssh/channels.c","usr.bin/ssh/channels.c","channel_setup_fwd_listener_tcpip",3235,3384
64,10,358,4,71,"channel_setup_fwd_listener_streamlocal@3387-3458@usr.bin/ssh/channels.c","usr.bin/ssh/channels.c","channel_setup_fwd_listener_streamlocal",3387,3458
17,6,115,3,18,"channel_cancel_rport_listener_tcpip@3461-3479@usr.bin/ssh/channels.c","usr.bin/ssh/channels.c","channel_cancel_rport_listener_tcpip",3461,3479
18,6,116,2,19,"channel_cancel_rport_listener_streamlocal@3482-3501@usr.bin/ssh/channels.c","usr.bin/ssh/channels.c","channel_cancel_rport_listener_streamlocal",3482,3501
10,2,51,2,9,"channel_cancel_rport_listener@3504-3513@usr.bin/ssh/channels.c","usr.bin/ssh/channels.c","channel_cancel_rport_listener",3504,3513
31,14,206,5,33,"channel_cancel_lport_listener_tcpip@3516-3549@usr.bin/ssh/channels.c","usr.bin/ssh/channels.c","channel_cancel_lport_listener_tcpip",3516,3549
22,7,134,2,24,"channel_cancel_lport_listener_streamlocal@3552-3576@usr.bin/ssh/channels.c","usr.bin/ssh/channels.c","channel_cancel_lport_listener_streamlocal",3552,3576
11,2,63,4,10,"channel_cancel_lport_listener@3579-3589@usr.bin/ssh/channels.c","usr.bin/ssh/channels.c","channel_cancel_lport_listener",3579,3589
11,2,58,3,10,"channel_setup_local_fwd_listener@3593-3603@usr.bin/ssh/channels.c","usr.bin/ssh/channels.c","channel_setup_local_fwd_listener",3593,3603
12,2,62,4,11,"channel_setup_remote_fwd_listener@3607-3618@usr.bin/ssh/channels.c","usr.bin/ssh/channels.c","channel_setup_remote_fwd_listener",3607,3618
15,6,66,1,14,"channel_rfwd_bind_host@3625-3639@usr.bin/ssh/channels.c","usr.bin/ssh/channels.c","channel_rfwd_bind_host",3625,3639
52,19,390,2,55,"channel_request_remote_forwarding@3648-3703@usr.bin/ssh/channels.c","usr.bin/ssh/channels.c","channel_request_remote_forwarding",3648,3703
13,6,74,3,12,"open_match@3706-3718@usr.bin/ssh/channels.c","usr.bin/ssh/channels.c","open_match",3706,3718
19,9,100,4,19,"open_listen_match_tcpip@3727-3746@usr.bin/ssh/channels.c","usr.bin/ssh/channels.c","open_listen_match_tcpip",3727,3746
12,5,60,2,11,"open_listen_match_streamlocal@3749-3760@usr.bin/ssh/channels.c","usr.bin/ssh/channels.c","open_listen_match_streamlocal",3749,3760
27,10,202,3,29,"channel_request_rforward_cancel_tcpip@3767-3796@usr.bin/ssh/channels.c","usr.bin/ssh/channels.c","channel_request_rforward_cancel_tcpip",3767,3796
26,9,179,2,28,"channel_request_rforward_cancel_streamlocal@3803-3831@usr.bin/ssh/channels.c","usr.bin/ssh/channels.c","channel_request_rforward_cancel_streamlocal",3803,3831
11,3,59,2,10,"channel_request_rforward_cancel@3837-3847@usr.bin/ssh/channels.c","usr.bin/ssh/channels.c","channel_request_rforward_cancel",3837,3847
5,2,27,1,4,"channel_permit_all_opens@3855-3859@usr.bin/ssh/channels.c","usr.bin/ssh/channels.c","channel_permit_all_opens",3855,3859
7,1,59,3,7,"channel_add_permitted_opens@3862-3869@usr.bin/ssh/channels.c","usr.bin/ssh/channels.c","channel_add_permitted_opens",3862,3869
20,6,128,3,20,"channel_update_permitted_opens@3877-3897@usr.bin/ssh/channels.c","usr.bin/ssh/channels.c","channel_update_permitted_opens",3877,3897
6,1,45,3,5,"channel_add_adm_permitted_opens@3900-3905@usr.bin/ssh/channels.c","usr.bin/ssh/channels.c","channel_add_adm_permitted_opens",3900,3905
5,1,33,1,4,"channel_disable_adm_local_opens@3908-3912@usr.bin/ssh/channels.c","usr.bin/ssh/channels.c","channel_disable_adm_local_opens",3908,3912
7,1,49,1,7,"channel_clear_permitted_opens@3915-3922@usr.bin/ssh/channels.c","usr.bin/ssh/channels.c","channel_clear_permitted_opens",3915,3922
7,1,49,1,7,"channel_clear_adm_permitted_opens@3925-3932@usr.bin/ssh/channels.c","usr.bin/ssh/channels.c","channel_clear_adm_permitted_opens",3925,3932
9,3,46,1,9,"permitopen_port@3936-3945@usr.bin/ssh/channels.c","usr.bin/ssh/channels.c","permitopen_port",3936,3945
54,12,366,1,55,"connect_next@3949-4004@usr.bin/ssh/channels.c","usr.bin/ssh/channels.c","connect_next",3949,4004
11,3,62,1,10,"channel_connect_ctx_free@4007-4017@usr.bin/ssh/channels.c","usr.bin/ssh/channels.c","channel_connect_ctx_free",4007,4017
52,7,399,9,62,"connect_to_helper@4024-4086@usr.bin/ssh/channels.c","usr.bin/ssh/channels.c","connect_to_helper",4024,4086
20,2,143,5,21,"connect_to@4090-4111@usr.bin/ssh/channels.c","usr.bin/ssh/channels.c","connect_to",4090,4111
23,5,140,5,23,"channel_connect_by_listen_address@4118-4141@usr.bin/ssh/channels.c","usr.bin/ssh/channels.c","channel_connect_by_listen_address",4118,4141
18,3,104,4,18,"channel_connect_by_listen_path@4144-4162@usr.bin/ssh/channels.c","usr.bin/ssh/channels.c","channel_connect_by_listen_path",4144,4162
50,11,327,7,55,"channel_connect_to_port@4166-4221@usr.bin/ssh/channels.c","usr.bin/ssh/channels.c","channel_connect_to_port",4166,4221
33,9,198,4,35,"channel_connect_to_path@4225-4260@usr.bin/ssh/channels.c","usr.bin/ssh/channels.c","channel_connect_to_path",4225,4260
22,11,212,1,22,"channel_send_window_changes@4263-4285@usr.bin/ssh/channels.c","usr.bin/ssh/channels.c","channel_send_window_changes",4263,4285
18,6,162,3,23,"rdynamic_connect_prepare@4289-4312@usr.bin/ssh/channels.c","usr.bin/ssh/channels.c","rdynamic_connect_prepare",4289,4312
16,2,112,2,17,"rdynamic_connect_finish@4316-4333@usr.bin/ssh/channels.c","usr.bin/ssh/channels.c","rdynamic_connect_finish",4316,4333
81,17,538,6,87,"x11_create_display_inet@4343-4430@usr.bin/ssh/channels.c","usr.bin/ssh/channels.c","x11_create_display_inet",4343,4430
16,3,124,1,16,"connect_local_xsocket@4433-4449@usr.bin/ssh/channels.c","usr.bin/ssh/channels.c","connect_local_xsocket",4433,4449
70,13,441,1,97,"x11_connect_display@4452-4549@usr.bin/ssh/channels.c","usr.bin/ssh/channels.c","x11_connect_display",4452,4549
48,14,384,6,59,"x11_request_forwarding_with_spoofing@4557-4616@usr.bin/ssh/channels.c","usr.bin/ssh/channels.c","x11_request_forwarding_with_spoofing",4557,4616
16,4,130,2,21,"aesctr_inc@29-50@usr.bin/ssh/cipher-aesctr.c","usr.bin/ssh/cipher-aesctr.c","aesctr_inc",29,50
4,1,34,4,3,"aesctr_keysetup@53-56@usr.bin/ssh/cipher-aesctr.c","usr.bin/ssh/cipher-aesctr.c","aesctr_keysetup",53,56
4,1,24,2,3,"aesctr_ivsetup@59-62@usr.bin/ssh/cipher-aesctr.c","usr.bin/ssh/cipher-aesctr.c","aesctr_ivsetup",59,62
13,3,103,4,13,"aesctr_encrypt_bytes@65-78@usr.bin/ssh/cipher-aesctr.c","usr.bin/ssh/cipher-aesctr.c","aesctr_encrypt_bytes",65,78
9,2,59,3,8,"chachapoly_init@30-38@usr.bin/ssh/cipher-chachapoly.c","usr.bin/ssh/cipher-chachapoly.c","chachapoly_init",30,38
38,5,305,8,51,"chachapoly_crypt@50-101@usr.bin/ssh/cipher-chachapoly.c","usr.bin/ssh/cipher-chachapoly.c","chachapoly_crypt",50,101
12,2,88,5,12,"chachapoly_get_length@105-117@usr.bin/ssh/cipher-chachapoly.c","usr.bin/ssh/cipher-chachapoly.c","chachapoly_get_length",105,117
23,7,153,2,23,"cipher_alg_list@110-133@usr.bin/ssh/cipher.c","usr.bin/ssh/cipher.c","cipher_alg_list",110,133
4,1,17,1,3,"cipher_blocksize@136-139@usr.bin/ssh/cipher.c","usr.bin/ssh/cipher.c","cipher_blocksize",136,139
4,1,17,1,3,"cipher_keylen@142-145@usr.bin/ssh/cipher.c","usr.bin/ssh/cipher.c","cipher_keylen",142,145
6,2,32,1,5,"cipher_seclen@148-153@usr.bin/ssh/cipher.c","usr.bin/ssh/cipher.c","cipher_seclen",148,153
4,1,17,1,3,"cipher_authlen@156-159@usr.bin/ssh/cipher.c","usr.bin/ssh/cipher.c","cipher_authlen",156,159
5,3,37,1,8,"cipher_ivlen@162-170@usr.bin/ssh/cipher.c","usr.bin/ssh/cipher.c","cipher_ivlen",162,170
4,1,21,1,3,"cipher_is_cbc@173-176@usr.bin/ssh/cipher.c","usr.bin/ssh/cipher.c","cipher_is_cbc",173,176
4,1,14,1,3,"cipher_ctx_is_plaintext@179-182@usr.bin/ssh/cipher.c","usr.bin/ssh/cipher.c","cipher_ctx_is_plaintext",179,182
8,3,49,1,7,"cipher_by_name@185-192@usr.bin/ssh/cipher.c","usr.bin/ssh/cipher.c","cipher_by_name",185,192
20,8,138,1,20,"ciphers_valid@196-216@usr.bin/ssh/cipher.c","usr.bin/ssh/cipher.c","ciphers_valid",196,216
6,3,28,1,6,"cipher_warning_message@219-225@usr.bin/ssh/cipher.c","usr.bin/ssh/cipher.c","cipher_warning_message",219,225
76,21,499,7,87,"cipher_init@228-315@usr.bin/ssh/cipher.c","usr.bin/ssh/cipher.c","cipher_init",228,315
53,20,375,7,59,"cipher_crypt@328-387@usr.bin/ssh/cipher.c","usr.bin/ssh/cipher.c","cipher_crypt",328,387
11,3,75,5,10,"cipher_get_length@391-401@usr.bin/ssh/cipher.c","usr.bin/ssh/cipher.c","cipher_get_length",391,401
15,6,115,1,16,"cipher_free@404-420@usr.bin/ssh/cipher.c","usr.bin/ssh/cipher.c","cipher_free",404,420
10,4,69,1,13,"cipher_get_keyiv_len@428-441@usr.bin/ssh/cipher.c","usr.bin/ssh/cipher.c","cipher_get_keyiv_len",428,441
32,13,207,3,37,"cipher_get_keyiv@444-481@usr.bin/ssh/cipher.c","usr.bin/ssh/cipher.c","cipher_get_keyiv",444,481
19,8,131,2,25,"cipher_set_keyiv@484-509@usr.bin/ssh/cipher.c","usr.bin/ssh/cipher.c","cipher_set_keyiv",484,509
4,1,12,1,3,"cleanup_exit@27-30@usr.bin/ssh/cleanup.c","usr.bin/ssh/cleanup.c","cleanup_exit",27,30
7,2,24,1,6,"leave_non_blocking@188-194@usr.bin/ssh/clientloop.c","usr.bin/ssh/clientloop.c","leave_non_blocking",188,194
5,1,18,1,4,"window_change_handler@202-206@usr.bin/ssh/clientloop.c","usr.bin/ssh/clientloop.c","window_change_handler",202,206
5,1,15,1,4,"signal_handler@214-218@usr.bin/ssh/clientloop.c","usr.bin/ssh/clientloop.c","signal_handler",214,218
16,7,93,1,19,"set_control_persist_exit_time@227-246@usr.bin/ssh/clientloop.c","usr.bin/ssh/clientloop.c","set_control_persist_exit_time",227,246
15,5,89,1,16,"client_x11_display_valid@250-266@usr.bin/ssh/clientloop.c","usr.bin/ssh/clientloop.c","client_x11_display_valid",250,266
113,32,713,7,150,"client_x11_get_proto@271-421@usr.bin/ssh/clientloop.c","usr.bin/ssh/clientloop.c","client_x11_get_proto",271,421
8,2,32,1,10,"client_check_window_change@431-441@usr.bin/ssh/clientloop.c","usr.bin/ssh/clientloop.c","client_check_window_change",431,441
15,4,105,3,16,"client_global_request_reply@444-460@usr.bin/ssh/clientloop.c","usr.bin/ssh/clientloop.c","client_global_request_reply",444,460
12,2,56,1,12,"server_alive_check@463-475@usr.bin/ssh/clientloop.c","usr.bin/ssh/clientloop.c","server_alive_check",463,475
57,17,390,6,85,"client_wait_until_can_do_something@482-567@usr.bin/ssh/clientloop.c","usr.bin/ssh/clientloop.c","client_wait_until_can_do_something",482,567
16,3,120,3,23,"client_suspend_self@570-593@usr.bin/ssh/clientloop.c","usr.bin/ssh/clientloop.c","client_suspend_self",570,593
27,7,152,1,45,"client_process_net_input@596-641@usr.bin/ssh/clientloop.c","usr.bin/ssh/clientloop.c","client_process_net_input",596,641
41,15,275,4,57,"client_status_confirm@644-701@usr.bin/ssh/clientloop.c","usr.bin/ssh/clientloop.c","client_status_confirm",644,701
4,1,22,3,3,"client_abandon_status_confirm@704-707@usr.bin/ssh/clientloop.c","usr.bin/ssh/clientloop.c","client_abandon_status_confirm",704,707
9,1,62,4,10,"client_expect_confirm@710-720@usr.bin/ssh/clientloop.c","usr.bin/ssh/clientloop.c","client_expect_confirm",710,720
16,5,111,2,18,"client_register_global_confirm@723-741@usr.bin/ssh/clientloop.c","usr.bin/ssh/clientloop.c","client_register_global_confirm",723,741
106,26,565,1,115,"process_cmdline@744-859@usr.bin/ssh/clientloop.c","usr.bin/ssh/clientloop.c","process_cmdline",744,859
24,6,185,4,27,"print_escape_help@887-914@usr.bin/ssh/clientloop.c","usr.bin/ssh/clientloop.c","print_escape_help",887,914
155,41,881,7,208,"process_escapes@920-1128@usr.bin/ssh/clientloop.c","usr.bin/ssh/clientloop.c","process_escapes",920,1128
4,1,16,1,3,"client_process_buffered_input_packets@1143-1146@usr.bin/ssh/clientloop.c","usr.bin/ssh/clientloop.c","client_process_buffered_input_packets",1143,1146
8,1,44,1,8,"client_new_escape_filter_ctx@1152-1160@usr.bin/ssh/clientloop.c","usr.bin/ssh/clientloop.c","client_new_escape_filter_ctx",1152,1160
4,1,21,3,3,"client_filter_cleanup@1164-1167@usr.bin/ssh/clientloop.c","usr.bin/ssh/clientloop.c","client_filter_cleanup",1164,1167
7,2,55,4,7,"client_simple_escape_filter@1170-1177@usr.bin/ssh/clientloop.c","usr.bin/ssh/clientloop.c","client_simple_escape_filter",1170,1177
6,1,36,3,5,"client_channel_closed@1180-1185@usr.bin/ssh/clientloop.c","usr.bin/ssh/clientloop.c","client_channel_closed",1180,1185
157,47,1008,4,242,"client_loop@1194-1436@usr.bin/ssh/clientloop.c","usr.bin/ssh/clientloop.c","client_loop",1194,1436
44,15,333,5,50,"client_request_forwarded_tcpip@1441-1491@usr.bin/ssh/clientloop.c","usr.bin/ssh/clientloop.c","client_request_forwarded_tcpip",1441,1491
15,2,84,3,19,"client_request_forwarded_streamlocal@1494-1513@usr.bin/ssh/clientloop.c","usr.bin/ssh/clientloop.c","client_request_forwarded_streamlocal",1494,1513
37,6,186,3,38,"client_request_x11@1516-1554@usr.bin/ssh/clientloop.c","usr.bin/ssh/clientloop.c","client_request_x11",1516,1554
23,4,125,3,23,"client_request_agent@1557-1580@usr.bin/ssh/clientloop.c","usr.bin/ssh/clientloop.c","client_request_agent",1557,1580
27,3,167,4,33,"client_request_tun_fwd@1583-1616@usr.bin/ssh/clientloop.c","usr.bin/ssh/clientloop.c","client_request_tun_fwd",1583,1616
52,10,343,3,54,"client_input_channel_open@1620-1674@usr.bin/ssh/clientloop.c","usr.bin/ssh/clientloop.c","client_input_channel_open",1620,1674
47,13,289,3,51,"client_input_channel_req@1677-1728@usr.bin/ssh/clientloop.c","usr.bin/ssh/clientloop.c","client_input_channel_req",1677,1728
16,4,110,1,16,"hostkeys_update_ctx_free@1754-1770@usr.bin/ssh/clientloop.c","usr.bin/ssh/clientloop.c","hostkeys_update_ctx_free",1754,1770
26,6,217,2,30,"hostkeys_find@1773-1803@usr.bin/ssh/clientloop.c","usr.bin/ssh/clientloop.c","hostkeys_find",1773,1803
60,20,408,1,66,"update_known_hosts@1806-1872@usr.bin/ssh/clientloop.c","usr.bin/ssh/clientloop.c","update_known_hosts",1806,1872
54,13,371,4,65,"client_global_hostkeys_private_confirm@1875-1940@usr.bin/ssh/clientloop.c","usr.bin/ssh/clientloop.c","client_global_hostkeys_private_confirm",1875,1940
13,7,99,1,13,"key_accepted_by_hostkeyalgs@1947-1960@usr.bin/ssh/clientloop.c","usr.bin/ssh/clientloop.c","key_accepted_by_hostkeyalgs",1947,1960
122,33,878,1,147,"client_input_hostkeys@1968-2115@usr.bin/ssh/clientloop.c","usr.bin/ssh/clientloop.c","client_input_hostkeys",1968,2115
20,4,97,3,20,"client_input_global_request@2118-2138@usr.bin/ssh/clientloop.c","usr.bin/ssh/clientloop.c","client_input_global_request",2118,2138
82,16,584,9,96,"client_session2_setup@2141-2237@usr.bin/ssh/clientloop.c","usr.bin/ssh/clientloop.c","client_session2_setup",2141,2237
19,1,132,1,23,"client_init_dispatch@2240-2263@usr.bin/ssh/clientloop.c","usr.bin/ssh/clientloop.c","client_init_dispatch",2240,2263
9,5,45,1,12,"client_stop_mux@2266-2278@usr.bin/ssh/clientloop.c","usr.bin/ssh/clientloop.c","client_stop_mux",2266,2278
9,3,49,1,8,"cleanup_exit@2282-2290@usr.bin/ssh/clientloop.c","usr.bin/ssh/clientloop.c","cleanup_exit",2282,2290
159,3,569,1,160,"compat_datafellows@44-204@usr.bin/ssh/compat.c","usr.bin/ssh/compat.c","compat_datafellows",44,204
22,6,123,1,22,"proto_spec@208-230@usr.bin/ssh/compat.c","usr.bin/ssh/compat.c","proto_spec",208,230
12,4,73,1,11,"compat_cipher_proposal@233-244@usr.bin/ssh/compat.c","usr.bin/ssh/compat.c","compat_cipher_proposal",233,244
12,4,73,1,11,"compat_pkalg_proposal@247-258@usr.bin/ssh/compat.c","usr.bin/ssh/compat.c","compat_pkalg_proposal",247,258
20,7,121,1,19,"compat_kex_proposal@261-280@usr.bin/ssh/compat.c","usr.bin/ssh/compat.c","compat_kex_proposal",261,280
8,2,60,2,8,"ssh_crc32@98-106@usr.bin/ssh/crc32.c","usr.bin/ssh/crc32.c","ssh_crc32",98,106
89,37,640,3,97,"parse_prime@43-140@usr.bin/ssh/dh.c","usr.bin/ssh/dh.c","parse_prime",43,140
58,19,367,3,64,"choose_dh@143-207@usr.bin/ssh/dh.c","usr.bin/ssh/dh.c","choose_dh",143,207
36,9,208,2,42,"dh_pub_is_valid@212-254@usr.bin/ssh/dh.c","usr.bin/ssh/dh.c","dh_pub_is_valid",212,254
17,9,113,2,21,"dh_gen_key@257-278@usr.bin/ssh/dh.c","usr.bin/ssh/dh.c","dh_gen_key",257,278
12,4,74,2,12,"dh_new_group_asc@281-293@usr.bin/ssh/dh.c","usr.bin/ssh/dh.c","dh_new_group_asc",281,293
9,2,48,2,10,"dh_new_group@301-311@usr.bin/ssh/dh.c","usr.bin/ssh/dh.c","dh_new_group",301,311
11,1,59,1,11,"dh_new_group1@315-326@usr.bin/ssh/dh.c","usr.bin/ssh/dh.c","dh_new_group1",315,326
16,1,91,1,16,"dh_new_group14@330-346@usr.bin/ssh/dh.c","usr.bin/ssh/dh.c","dh_new_group14",330,346
27,1,155,1,27,"dh_new_group16@350-377@usr.bin/ssh/dh.c","usr.bin/ssh/dh.c","dh_new_group16",350,377
48,1,283,1,48,"dh_new_group18@381-429@usr.bin/ssh/dh.c","usr.bin/ssh/dh.c","dh_new_group18",381,429
13,3,63,1,12,"dh_new_group_fallback@433-445@usr.bin/ssh/dh.c","usr.bin/ssh/dh.c","dh_new_group_fallback",433,445
10,4,37,1,9,"dh_estimate@455-464@usr.bin/ssh/dh.c","usr.bin/ssh/dh.c","dh_estimate",455,464
8,4,43,1,7,"ssh_digest_by_alg@108-115@usr.bin/ssh/digest-libc.c","usr.bin/ssh/digest-libc.c","ssh_digest_by_alg",108,115
9,3,55,1,9,"ssh_digest_alg_by_name@118-127@usr.bin/ssh/digest-libc.c","usr.bin/ssh/digest-libc.c","ssh_digest_alg_by_name",118,127
5,2,29,1,5,"ssh_digest_alg_name@130-135@usr.bin/ssh/digest-libc.c","usr.bin/ssh/digest-libc.c","ssh_digest_alg_name",130,135
5,2,29,1,5,"ssh_digest_bytes@138-143@usr.bin/ssh/digest-libc.c","usr.bin/ssh/digest-libc.c","ssh_digest_bytes",138,143
5,2,33,1,5,"ssh_digest_blocksize@146-151@usr.bin/ssh/digest-libc.c","usr.bin/ssh/digest-libc.c","ssh_digest_blocksize",146,151
14,4,96,1,14,"ssh_digest_start@154-168@usr.bin/ssh/digest-libc.c","usr.bin/ssh/digest-libc.c","ssh_digest_start",154,168
8,3,62,2,8,"ssh_digest_copy_state@171-179@usr.bin/ssh/digest-libc.c","usr.bin/ssh/digest-libc.c","ssh_digest_copy_state",171,179
8,2,55,3,8,"ssh_digest_update@182-190@usr.bin/ssh/digest-libc.c","usr.bin/ssh/digest-libc.c","ssh_digest_update",182,190
4,1,31,2,3,"ssh_digest_update_buffer@193-196@usr.bin/ssh/digest-libc.c","usr.bin/ssh/digest-libc.c","ssh_digest_update_buffer",193,196
12,4,72,3,12,"ssh_digest_final@199-211@usr.bin/ssh/digest-libc.c","usr.bin/ssh/digest-libc.c","ssh_digest_final",199,211
13,3,72,1,13,"ssh_digest_free@214-227@usr.bin/ssh/digest-libc.c","usr.bin/ssh/digest-libc.c","ssh_digest_free",214,227
11,4,76,5,11,"ssh_digest_memory@230-241@usr.bin/ssh/digest-libc.c","usr.bin/ssh/digest-libc.c","ssh_digest_memory",230,241
4,1,40,4,3,"ssh_digest_buffer@244-247@usr.bin/ssh/digest-libc.c","usr.bin/ssh/digest-libc.c","ssh_digest_buffer",244,247
8,4,43,1,7,"ssh_digest_by_alg@52-59@usr.bin/ssh/digest-openssl.c","usr.bin/ssh/digest-openssl.c","ssh_digest_by_alg",52,59
9,3,61,1,9,"ssh_digest_alg_by_name@62-71@usr.bin/ssh/digest-openssl.c","usr.bin/ssh/digest-openssl.c","ssh_digest_alg_by_name",62,71
5,2,29,1,5,"ssh_digest_alg_name@74-79@usr.bin/ssh/digest-openssl.c","usr.bin/ssh/digest-openssl.c","ssh_digest_alg_name",74,79
5,2,29,1,5,"ssh_digest_bytes@82-87@usr.bin/ssh/digest-openssl.c","usr.bin/ssh/digest-openssl.c","ssh_digest_bytes",82,87
4,1,18,1,3,"ssh_digest_blocksize@90-93@usr.bin/ssh/digest-openssl.c","usr.bin/ssh/digest-openssl.c","ssh_digest_blocksize",90,93
14,4,98,1,14,"ssh_digest_start@96-110@usr.bin/ssh/digest-openssl.c","usr.bin/ssh/digest-openssl.c","ssh_digest_start",96,110
8,3,49,2,8,"ssh_digest_copy_state@113-121@usr.bin/ssh/digest-openssl.c","usr.bin/ssh/digest-openssl.c","ssh_digest_copy_state",113,121
6,2,39,3,5,"ssh_digest_update@124-129@usr.bin/ssh/digest-openssl.c","usr.bin/ssh/digest-openssl.c","ssh_digest_update",124,129
4,1,31,2,3,"ssh_digest_update_buffer@132-135@usr.bin/ssh/digest-openssl.c","usr.bin/ssh/digest-openssl.c","ssh_digest_update_buffer",132,135
14,6,92,3,14,"ssh_digest_final@138-152@usr.bin/ssh/digest-openssl.c","usr.bin/ssh/digest-openssl.c","ssh_digest_final",138,152
8,2,41,1,7,"ssh_digest_free@155-162@usr.bin/ssh/digest-openssl.c","usr.bin/ssh/digest-openssl.c","ssh_digest_free",155,162
15,5,98,5,15,"ssh_digest_memory@165-180@usr.bin/ssh/digest-openssl.c","usr.bin/ssh/digest-openssl.c","ssh_digest_memory",165,180
4,1,40,4,3,"ssh_digest_buffer@183-186@usr.bin/ssh/digest-openssl.c","usr.bin/ssh/digest-openssl.c","ssh_digest_buffer",183,186
11,5,89,3,11,"dispatch_protocol_error@39-50@usr.bin/ssh/dispatch.c","usr.bin/ssh/dispatch.c","dispatch_protocol_error",39,50
5,1,27,3,4,"dispatch_protocol_ignore@53-57@usr.bin/ssh/dispatch.c","usr.bin/ssh/dispatch.c","dispatch_protocol_ignore",53,57
6,2,38,2,5,"ssh_dispatch_init@60-65@usr.bin/ssh/dispatch.c","usr.bin/ssh/dispatch.c","ssh_dispatch_init",60,65
9,3,54,4,9,"ssh_dispatch_range@68-77@usr.bin/ssh/dispatch.c","usr.bin/ssh/dispatch.c","ssh_dispatch_range",68,77
4,1,25,3,3,"ssh_dispatch_set@80-83@usr.bin/ssh/dispatch.c","usr.bin/ssh/dispatch.c","ssh_dispatch_set",80,83
38,14,206,3,38,"ssh_dispatch_run@86-124@usr.bin/ssh/dispatch.c","usr.bin/ssh/dispatch.c","ssh_dispatch_run",86,124
6,2,46,3,6,"ssh_dispatch_run_fatal@127-133@usr.bin/ssh/dispatch.c","usr.bin/ssh/dispatch.c","ssh_dispatch_run_fatal",127,133
19,7,73,1,18,"dns_result_totext@54-72@usr.bin/ssh/dns.c","usr.bin/ssh/dns.c","dns_result_totext",54,72
53,14,239,5,56,"dns_read_key@78-134@usr.bin/ssh/dns.c","usr.bin/ssh/dns.c","dns_read_key",78,134
20,3,126,6,24,"dns_read_rdata@140-164@usr.bin/ssh/dns.c","usr.bin/ssh/dns.c","dns_read_rdata",140,164
16,3,89,1,23,"is_numeric_hostname@171-194@usr.bin/ssh/dns.c","usr.bin/ssh/dns.c","is_numeric_hostname",171,194
83,17,420,4,105,"verify_host_key_dns@201-306@usr.bin/ssh/dns.c","usr.bin/ssh/dns.c","verify_host_key_dns",201,306
33,6,188,4,36,"export_dns_rr@312-348@usr.bin/ssh/dns.c","usr.bin/ssh/dns.c","export_dns_rr",312,348
8,4,116,5,9,"get_hram@13-22@usr.bin/ssh/ed25519.c","usr.bin/ssh/ed25519.c","get_hram",13,22
21,2,120,2,23,"crypto_sign_ed25519_keypair@25-48@usr.bin/ssh/ed25519.c","usr.bin/ssh/ed25519.c","crypto_sign_ed25519_keypair",25,48
39,5,325,5,50,"crypto_sign_ed25519@50-100@usr.bin/ssh/ed25519.c","usr.bin/ssh/ed25519.c","crypto_sign_ed25519",50,100
34,6,233,5,41,"crypto_sign_ed25519_open@102-143@usr.bin/ssh/ed25519.c","usr.bin/ssh/ed25519.c","crypto_sign_ed25519_open",102,143
8,1,40,2,8,"fatal@35-43@usr.bin/ssh/fatal.c","usr.bin/ssh/fatal.c","fatal",35,43
7,1,29,2,6,"equal@14-20@usr.bin/ssh/fe25519.c","usr.bin/ssh/fe25519.c","equal",14,20
8,1,36,2,7,"ge@22-29@usr.bin/ssh/fe25519.c","usr.bin/ssh/fe25519.c","ge",22,29
4,1,24,1,3,"times19@31-34@usr.bin/ssh/fe25519.c","usr.bin/ssh/fe25519.c","times19",31,34
4,1,29,1,3,"times38@36-39@usr.bin/ssh/fe25519.c","usr.bin/ssh/fe25519.c","times38",36,39
18,3,115,1,18,"reduce_add_sub@41-59@usr.bin/ssh/fe25519.c","usr.bin/ssh/fe25519.c","reduce_add_sub",41,59
18,3,115,1,18,"reduce_mul@61-79@usr.bin/ssh/fe25519.c","usr.bin/ssh/fe25519.c","reduce_mul",61,79
13,3,118,1,14,"fe25519_freeze@82-96@usr.bin/ssh/fe25519.c","usr.bin/ssh/fe25519.c","fe25519_freeze",82,96
6,2,53,2,5,"fe25519_unpack@98-103@usr.bin/ssh/fe25519.c","usr.bin/ssh/fe25519.c","fe25519_unpack",98,103
8,2,56,2,7,"fe25519_pack@106-113@usr.bin/ssh/fe25519.c","usr.bin/ssh/fe25519.c","fe25519_pack",106,113
11,2,71,1,10,"fe25519_iszero@115-125@usr.bin/ssh/fe25519.c","usr.bin/ssh/fe25519.c","fe25519_iszero",115,125
11,3,76,2,10,"fe25519_iseq_vartime@127-137@usr.bin/ssh/fe25519.c","usr.bin/ssh/fe25519.c","fe25519_iseq_vartime",127,137
7,2,68,3,6,"fe25519_cmov@139-145@usr.bin/ssh/fe25519.c","usr.bin/ssh/fe25519.c","fe25519_cmov",139,145
6,1,31,1,5,"fe25519_getparity@147-152@usr.bin/ssh/fe25519.c","usr.bin/ssh/fe25519.c","fe25519_getparity",147,152
6,2,42,1,5,"fe25519_setone@154-159@usr.bin/ssh/fe25519.c","usr.bin/ssh/fe25519.c","fe25519_setone",154,159
5,2,33,1,4,"fe25519_setzero@161-165@usr.bin/ssh/fe25519.c","usr.bin/ssh/fe25519.c","fe25519_setzero",161,165
8,2,61,2,7,"fe25519_neg@167-174@usr.bin/ssh/fe25519.c","usr.bin/ssh/fe25519.c","fe25519_neg",167,174
6,2,60,3,5,"fe25519_add@176-181@usr.bin/ssh/fe25519.c","usr.bin/ssh/fe25519.c","fe25519_add",176,181
10,3,119,3,9,"fe25519_sub@183-192@usr.bin/ssh/fe25519.c","usr.bin/ssh/fe25519.c","fe25519_sub",183,192
13,5,150,3,15,"fe25519_mul@194-209@usr.bin/ssh/fe25519.c","usr.bin/ssh/fe25519.c","fe25519_mul",194,209
4,1,22,2,3,"fe25519_square@211-214@usr.bin/ssh/fe25519.c","usr.bin/ssh/fe25519.c","fe25519_square",211,214
57,7,613,2,65,"fe25519_invert@216-281@usr.bin/ssh/fe25519.c","usr.bin/ssh/fe25519.c","fe25519_invert",216,281
44,8,456,2,52,"fe25519_pow2523@283-335@usr.bin/ssh/fe25519.c","usr.bin/ssh/fe25519.c","fe25519_pow2523",283,335
6,1,67,2,5,"p1p1_to_p2@68-73@usr.bin/ssh/ge25519.c","usr.bin/ssh/ge25519.c","p1p1_to_p2",68,73
5,1,42,2,4,"p1p1_to_p3@75-79@usr.bin/ssh/ge25519.c","usr.bin/ssh/ge25519.c","p1p1_to_p3",75,79
22,1,286,2,21,"ge25519_mixadd2@81-102@usr.bin/ssh/ge25519.c","usr.bin/ssh/ge25519.c","ge25519_mixadd2",81,102
18,1,229,3,18,"add_p1p1@104-122@usr.bin/ssh/ge25519.c","usr.bin/ssh/ge25519.c","add_p1p1",104,122
16,1,183,2,16,"dbl_p1p1@125-141@usr.bin/ssh/ge25519.c","usr.bin/ssh/ge25519.c","dbl_p1p1",125,141
5,1,47,3,4,"cmov_aff@144-148@usr.bin/ssh/ge25519.c","usr.bin/ssh/ge25519.c","cmov_aff",144,148
10,1,49,2,9,"equal@150-159@usr.bin/ssh/ge25519.c","usr.bin/ssh/ge25519.c","equal",150,159
6,1,23,1,5,"negative@161-166@usr.bin/ssh/ge25519.c","usr.bin/ssh/ge25519.c","negative",161,166
11,1,172,3,11,"choose_t@168-179@usr.bin/ssh/ge25519.c","usr.bin/ssh/ge25519.c","choose_t",168,179
7,1,40,1,6,"setneutral@181-187@usr.bin/ssh/ge25519.c","usr.bin/ssh/ge25519.c","setneutral",181,187
34,4,367,2,45,"ge25519_unpackneg_vartime@194-239@usr.bin/ssh/ge25519.c","usr.bin/ssh/ge25519.c","ge25519_unpackneg_vartime",194,239
9,1,84,2,8,"ge25519_pack@241-249@usr.bin/ssh/ge25519.c","usr.bin/ssh/ge25519.c","ge25519_pack",241,249
7,3,52,1,6,"ge25519_isneutral_vartime@251-257@usr.bin/ssh/ge25519.c","usr.bin/ssh/ge25519.c","ge25519_isneutral_vartime",251,257
38,4,578,5,42,"ge25519_double_scalarmult_vartime@260-302@usr.bin/ssh/ge25519.c","usr.bin/ssh/ge25519.c","ge25519_double_scalarmult_vartime",260,302
15,2,116,2,15,"ge25519_scalarmult_base@304-319@usr.bin/ssh/ge25519.c","usr.bin/ssh/ge25519.c","ge25519_scalarmult_base",304,319
15,5,127,2,16,"ga_init@48-64@usr.bin/ssh/groupaccess.c","usr.bin/ssh/groupaccess.c","ga_init",48,64
9,4,65,2,9,"ga_match@71-80@usr.bin/ssh/groupaccess.c","usr.bin/ssh/groupaccess.c","ga_match",71,80
15,5,69,1,15,"ga_match_pattern_list@87-102@usr.bin/ssh/groupaccess.c","usr.bin/ssh/groupaccess.c","ga_match_pattern_list",87,102
9,3,42,1,9,"ga_free@108-117@usr.bin/ssh/groupaccess.c","usr.bin/ssh/groupaccess.c","ga_free",108,117
6,4,51,3,5,"ssh_gssapi_check_oid@46-51@usr.bin/ssh/gss-genr.c","usr.bin/ssh/gss-genr.c","ssh_gssapi_check_oid",46,51
11,2,87,3,10,"ssh_gssapi_set_oid_data@55-65@usr.bin/ssh/gss-genr.c","usr.bin/ssh/gss-genr.c","ssh_gssapi_set_oid_data",55,65
4,1,24,2,3,"ssh_gssapi_set_oid@69-72@usr.bin/ssh/gss-genr.c","usr.bin/ssh/gss-genr.c","ssh_gssapi_set_oid",69,72
7,1,35,1,7,"ssh_gssapi_error@76-83@usr.bin/ssh/gss-genr.c","usr.bin/ssh/gss-genr.c","ssh_gssapi_error",76,83
34,5,240,3,44,"ssh_gssapi_last_error@86-130@usr.bin/ssh/gss-genr.c","usr.bin/ssh/gss-genr.c","ssh_gssapi_last_error",86,130
10,1,75,1,9,"ssh_gssapi_build_ctx@139-148@usr.bin/ssh/gss-genr.c","usr.bin/ssh/gss-genr.c","ssh_gssapi_build_ctx",139,148
23,8,204,1,24,"ssh_gssapi_delete_ctx@152-176@usr.bin/ssh/gss-genr.c","usr.bin/ssh/gss-genr.c","ssh_gssapi_delete_ctx",152,176
16,3,111,5,19,"ssh_gssapi_init_ctx@185-204@usr.bin/ssh/gss-genr.c","usr.bin/ssh/gss-genr.c","ssh_gssapi_init_ctx",185,204
13,2,92,2,15,"ssh_gssapi_import_name@208-223@usr.bin/ssh/gss-genr.c","usr.bin/ssh/gss-genr.c","ssh_gssapi_import_name",208,223
7,2,52,3,7,"ssh_gssapi_sign@226-233@usr.bin/ssh/gss-genr.c","usr.bin/ssh/gss-genr.c","ssh_gssapi_sign",226,233
10,1,65,4,9,"ssh_gssapi_buildmic@236-245@usr.bin/ssh/gss-genr.c","usr.bin/ssh/gss-genr.c","ssh_gssapi_buildmic",236,245
23,6,178,3,27,"ssh_gssapi_check_mechanism@248-275@usr.bin/ssh/gss-genr.c","usr.bin/ssh/gss-genr.c","ssh_gssapi_check_mechanism",248,275
13,3,48,1,15,"ssh_gssapi_krb5_init@49-64@usr.bin/ssh/gss-serv-krb5.c","usr.bin/ssh/gss-serv-krb5.c","ssh_gssapi_krb5_init",49,64
23,4,131,2,25,"ssh_gssapi_krb5_userok@72-97@usr.bin/ssh/gss-serv-krb5.c","usr.bin/ssh/gss-serv-krb5.c","ssh_gssapi_krb5_userok",72,97
49,7,302,1,58,"ssh_gssapi_krb5_storecreds@104-162@usr.bin/ssh/gss-serv-krb5.c","usr.bin/ssh/gss-serv-krb5.c","ssh_gssapi_krb5_storecreds",104,162
4,1,12,1,3,"ssh_gssapi_prepare_supported_oids@74-77@usr.bin/ssh/gss-serv.c","usr.bin/ssh/gss-serv.c","ssh_gssapi_prepare_supported_oids",74,77
6,2,37,3,5,"ssh_gssapi_test_oid_supported@80-85@usr.bin/ssh/gss-serv.c","usr.bin/ssh/gss-serv.c","ssh_gssapi_test_oid_supported",80,85
28,5,180,1,32,"ssh_gssapi_acquire_cred@95-127@usr.bin/ssh/gss-serv.c","usr.bin/ssh/gss-serv.c","ssh_gssapi_acquire_cred",95,127
8,2,43,2,7,"ssh_gssapi_server_ctx@131-138@usr.bin/ssh/gss-serv.c","usr.bin/ssh/gss-serv.c","ssh_gssapi_server_ctx",131,138
19,4,112,1,21,"ssh_gssapi_supported_oids@142-163@usr.bin/ssh/gss-serv.c","usr.bin/ssh/gss-serv.c","ssh_gssapi_supported_oids",142,163
23,8,163,4,32,"ssh_gssapi_accept_ctx@173-205@usr.bin/ssh/gss-serv.c","usr.bin/ssh/gss-serv.c","ssh_gssapi_accept_ctx",173,205
28,10,216,3,53,"ssh_gssapi_parse_ename@213-266@usr.bin/ssh/gss-serv.c","usr.bin/ssh/gss-serv.c","ssh_gssapi_parse_ename",213,266
32,8,236,2,40,"ssh_gssapi_getclient@273-313@usr.bin/ssh/gss-serv.c","usr.bin/ssh/gss-serv.c","ssh_gssapi_getclient",273,313
8,2,38,1,8,"ssh_gssapi_cleanup_creds@317-325@usr.bin/ssh/gss-serv.c","usr.bin/ssh/gss-serv.c","ssh_gssapi_cleanup_creds",317,325
7,3,39,1,6,"ssh_gssapi_storecreds@329-335@usr.bin/ssh/gss-serv.c","usr.bin/ssh/gss-serv.c","ssh_gssapi_storecreds",329,335
10,3,69,2,10,"ssh_gssapi_do_child@342-352@usr.bin/ssh/gss-serv.c","usr.bin/ssh/gss-serv.c","ssh_gssapi_do_child",342,352
23,6,132,1,24,"ssh_gssapi_userok@356-380@usr.bin/ssh/gss-serv.c","usr.bin/ssh/gss-serv.c","ssh_gssapi_userok",356,380
6,1,43,3,6,"ssh_gssapi_checkmic@384-390@usr.bin/ssh/gss-serv.c","usr.bin/ssh/gss-serv.c","ssh_gssapi_checkmic",384,390
7,3,38,1,6,"ssh_gssapi_displayname@393-399@usr.bin/ssh/gss-serv.c","usr.bin/ssh/gss-serv.c","ssh_gssapi_displayname",393,399
41,7,398,3,46,"crypto_hash_sha512@28-74@usr.bin/ssh/hash.c","usr.bin/ssh/hash.c","crypto_hash_sha512",28,74
4,1,13,1,3,"ssh_hmac_bytes@35-38@usr.bin/ssh/hmac.c","usr.bin/ssh/hmac.c","ssh_hmac_bytes",35,38
18,6,130,1,18,"ssh_hmac_start@41-59@usr.bin/ssh/hmac.c","usr.bin/ssh/hmac.c","ssh_hmac_start",41,59
23,9,204,3,26,"ssh_hmac_init@62-88@usr.bin/ssh/hmac.c","usr.bin/ssh/hmac.c","ssh_hmac_init",62,88
4,1,29,3,3,"ssh_hmac_update@91-94@usr.bin/ssh/hmac.c","usr.bin/ssh/hmac.c","ssh_hmac_update",91,94
4,1,25,2,3,"ssh_hmac_update_buffer@97-100@usr.bin/ssh/hmac.c","usr.bin/ssh/hmac.c","ssh_hmac_update_buffer",97,100
13,6,101,3,14,"ssh_hmac_final@103-117@usr.bin/ssh/hmac.c","usr.bin/ssh/hmac.c","ssh_hmac_final",103,117
14,3,80,1,13,"ssh_hmac_free@120-133@usr.bin/ssh/hmac.c","usr.bin/ssh/hmac.c","ssh_hmac_free",120,133
19,7,159,6,20,"hmac_test@139-159@usr.bin/ssh/hmac.c","usr.bin/ssh/hmac.c","hmac_test",139,159
26,1,300,2,31,"main@162-193@usr.bin/ssh/hmac.c","usr.bin/ssh/hmac.c","main",162,193
40,8,264,4,44,"extract_salt@70-114@usr.bin/ssh/hostfile.c","usr.bin/ssh/hostfile.c","extract_salt",70,114
28,9,233,3,35,"host_hash@117-152@usr.bin/ssh/hostfile.c","usr.bin/ssh/hostfile.c","host_hash",117,152
15,7,103,3,21,"hostfile_read_key@160-181@usr.bin/ssh/hostfile.c","usr.bin/ssh/hostfile.c","hostfile_read_key",160,181
27,10,181,1,32,"check_markers@184-216@usr.bin/ssh/hostfile.c","usr.bin/ssh/hostfile.c","check_markers",184,216
6,1,31,1,6,"init_hostkeys@219-225@usr.bin/ssh/hostfile.c","usr.bin/ssh/hostfile.c","init_hostkeys",219,225
28,5,249,2,31,"record_hostkey@234-265@usr.bin/ssh/hostfile.c","usr.bin/ssh/hostfile.c","record_hostkey",234,265
17,5,117,3,18,"load_hostkeys@268-286@usr.bin/ssh/hostfile.c","usr.bin/ssh/hostfile.c","load_hostkeys",268,286
13,2,105,1,13,"free_hostkeys@289-302@usr.bin/ssh/hostfile.c","usr.bin/ssh/hostfile.c","free_hostkeys",289,302
16,6,106,2,16,"check_key_not_revoked@305-321@usr.bin/ssh/hostfile.c","usr.bin/ssh/hostfile.c","check_key_not_revoked",305,321
48,16,289,4,51,"check_hostkeys_by_key_or_type@339-390@usr.bin/ssh/hostfile.c","usr.bin/ssh/hostfile.c","check_hostkeys_by_key_or_type",339,390
7,2,43,3,6,"check_key_in_hostkeys@393-399@usr.bin/ssh/hostfile.c","usr.bin/ssh/hostfile.c","check_key_in_hostkeys",393,399
6,1,34,3,5,"lookup_key_in_hostkeys_by_type@402-407@usr.bin/ssh/hostfile.c","usr.bin/ssh/hostfile.c","lookup_key_in_hostkeys_by_type",402,407
27,5,181,5,28,"write_host_entry@410-438@usr.bin/ssh/hostfile.c","usr.bin/ssh/hostfile.c","write_host_entry",410,438
14,3,79,4,14,"add_host_to_hostfile@445-459@usr.bin/ssh/hostfile.c","usr.bin/ssh/hostfile.c","add_host_to_hostfile",445,459
33,11,265,2,46,"host_delete@472-518@usr.bin/ssh/hostfile.c","usr.bin/ssh/hostfile.c","host_delete",472,518
102,24,694,8,117,"hostfile_replace_entries@521-638@usr.bin/ssh/hostfile.c","usr.bin/ssh/hostfile.c","hostfile_replace_entries",521,638
15,5,106,3,15,"match_maybe_hashed@641-656@usr.bin/ssh/hostfile.c","usr.bin/ssh/hostfile.c","match_maybe_hashed",641,656
135,47,924,6,169,"hostkeys_foreach@659-828@usr.bin/ssh/hostfile.c","usr.bin/ssh/hostfile.c","hostkeys_foreach",659,828
19,4,124,1,19,"kex_alg_list@98-117@usr.bin/ssh/kex.c","usr.bin/ssh/kex.c","kex_alg_list",98,117
9,3,51,1,9,"kex_alg_by_name@120-129@usr.bin/ssh/kex.c","usr.bin/ssh/kex.c","kex_alg_by_name",120,129
19,7,131,1,19,"kex_names_valid@133-152@usr.bin/ssh/kex.c","usr.bin/ssh/kex.c","kex_names_valid",133,152
32,13,251,2,32,"kex_names_cat@159-191@usr.bin/ssh/kex.c","usr.bin/ssh/kex.c","kex_names_cat",159,191
20,8,132,2,21,"kex_assemble_names@200-221@usr.bin/ssh/kex.c","usr.bin/ssh/kex.c","kex_assemble_names",200,221
18,7,130,2,23,"kex_prop2buf@225-248@usr.bin/ssh/kex.c","usr.bin/ssh/kex.c","kex_prop2buf",225,248
36,11,255,3,38,"kex_buf2prop@252-290@usr.bin/ssh/kex.c","usr.bin/ssh/kex.c","kex_buf2prop",252,290
9,3,45,1,9,"kex_prop_free@293-302@usr.bin/ssh/kex.c","usr.bin/ssh/kex.c","kex_prop_free",293,302
10,4,72,3,10,"kex_protocol_error@306-316@usr.bin/ssh/kex.c","usr.bin/ssh/kex.c","kex_protocol_error",306,316
5,1,21,1,4,"kex_reset_dispatch@319-323@usr.bin/ssh/kex.c","usr.bin/ssh/kex.c","kex_reset_dispatch",319,323
17,7,120,1,18,"kex_send_ext_info@326-344@usr.bin/ssh/kex.c","usr.bin/ssh/kex.c","kex_send_ext_info",326,344
15,5,93,1,15,"kex_send_newkeys@347-362@usr.bin/ssh/kex.c","usr.bin/ssh/kex.c","kex_send_newkeys",347,362
42,9,278,3,43,"kex_input_ext_info@365-408@usr.bin/ssh/kex.c","usr.bin/ssh/kex.c","kex_input_ext_info",365,408
18,3,121,3,19,"kex_input_newkeys@411-430@usr.bin/ssh/kex.c","usr.bin/ssh/kex.c","kex_input_newkeys",411,430
23,8,148,1,26,"kex_send_kexinit@433-459@usr.bin/ssh/kex.c","usr.bin/ssh/kex.c","kex_send_kexinit",433,459
33,15,279,3,49,"kex_input_kexinit@463-512@usr.bin/ssh/kex.c","usr.bin/ssh/kex.c","kex_input_kexinit",463,512
24,6,157,3,24,"kex_new@515-539@usr.bin/ssh/kex.c","usr.bin/ssh/kex.c","kex_new",515,539
29,5,239,1,28,"kex_free_newkeys@542-570@usr.bin/ssh/kex.c","usr.bin/ssh/kex.c","kex_free_newkeys",542,570
21,5,133,1,23,"kex_free@573-596@usr.bin/ssh/kex.c","usr.bin/ssh/kex.c","kex_free",573,596
12,3,76,2,12,"kex_setup@599-611@usr.bin/ssh/kex.c","usr.bin/ssh/kex.c","kex_setup",599,611
13,3,65,1,12,"kex_start_rekex@618-630@usr.bin/ssh/kex.c","usr.bin/ssh/kex.c","kex_start_rekex",618,630
18,3,124,3,18,"choose_enc@633-651@usr.bin/ssh/kex.c","usr.bin/ssh/kex.c","choose_enc",633,651
16,4,100,4,17,"choose_mac@654-671@usr.bin/ssh/kex.c","usr.bin/ssh/kex.c","choose_mac",654,671
18,5,118,3,18,"choose_comp@674-692@usr.bin/ssh/kex.c","usr.bin/ssh/kex.c","choose_comp",674,692
14,4,107,3,15,"choose_kex@695-710@usr.bin/ssh/kex.c","usr.bin/ssh/kex.c","choose_kex",695,710
13,4,92,3,13,"choose_hostkeyalg@713-726@usr.bin/ssh/kex.c","usr.bin/ssh/kex.c","choose_hostkeyalg",713,726
21,5,163,2,21,"proposals_match@729-750@usr.bin/ssh/kex.c","usr.bin/ssh/kex.c","proposals_match",729,750
100,26,780,1,110,"kex_choose_conf@753-863@usr.bin/ssh/kex.c","usr.bin/ssh/kex.c","kex_choose_conf",753,863
50,16,343,7,60,"derive_key@866-926@usr.bin/ssh/kex.c","usr.bin/ssh/kex.c","derive_key",866,926
24,11,225,4,24,"kex_derive_keys@930-954@usr.bin/ssh/kex.c","usr.bin/ssh/kex.c","kex_derive_keys",930,954
12,3,80,4,12,"kex_derive_keys_bn@958-970@usr.bin/ssh/kex.c","usr.bin/ssh/kex.c","kex_derive_keys_bn",958,970
5,1,33,3,4,"dump_digest@976-980@usr.bin/ssh/kex.c","usr.bin/ssh/kex.c","dump_digest",976,980
6,1,44,2,6,"kexc25519_keygen@52-58@usr.bin/ssh/kexc25519.c","usr.bin/ssh/kexc25519.c","kexc25519_keygen",52,58
15,3,99,3,19,"kexc25519_shared_key@61-80@usr.bin/ssh/kexc25519.c","usr.bin/ssh/kexc25519.c","kexc25519_shared_key",61,80
43,18,350,15,48,"kex_c25519_hash@83-131@usr.bin/ssh/kexc25519.c","usr.bin/ssh/kexc25519.c","kex_c25519_hash",83,131
16,5,117,1,19,"kexc25519_client@48-67@usr.bin/ssh/kexc25519c.c","usr.bin/ssh/kexc25519c.c","kexc25519_client",48,67
82,20,554,3,97,"input_kex_c25519_reply@70-167@usr.bin/ssh/kexc25519c.c","usr.bin/ssh/kexc25519c.c","input_kex_c25519_reply",70,167
6,1,27,1,5,"kexc25519_server@45-50@usr.bin/ssh/kexc25519s.c","usr.bin/ssh/kexc25519s.c","kexc25519_server",45,50
87,22,624,3,103,"input_kex_c25519_init@53-156@usr.bin/ssh/kexc25519s.c","usr.bin/ssh/kexc25519s.c","input_kex_c25519_init",53,156
43,18,337,14,48,"kex_dh_hash@41-89@usr.bin/ssh/kexdh.c","usr.bin/ssh/kexdh.c","kex_dh_hash",41,89
42,12,238,1,45,"kexdh_client@50-95@usr.bin/ssh/kexdhc.c","usr.bin/ssh/kexdhc.c","kexdh_client",50,95
101,27,678,3,115,"input_kex_dh@98-213@usr.bin/ssh/kexdhc.c","usr.bin/ssh/kexdhc.c","input_kex_dh",98,213
34,8,158,1,36,"kexdh_server@50-86@usr.bin/ssh/kexdhs.c","usr.bin/ssh/kexdhs.c","kexdh_server",50,86
107,29,759,3,128,"input_kex_dh_init@89-217@usr.bin/ssh/kexdhs.c","usr.bin/ssh/kexdhs.c","input_kex_dh_init",89,217
44,18,346,15,49,"kex_ecdh_hash@46-95@usr.bin/ssh/kexecdh.c","usr.bin/ssh/kexecdh.c","kex_ecdh_hash",46,95
35,8,203,1,40,"kexecdh_client@51-91@usr.bin/ssh/kexecdhc.c","usr.bin/ssh/kexecdhc.c","kexecdh_client",51,91
110,28,699,3,127,"input_kex_ecdh_reply@94-221@usr.bin/ssh/kexecdhc.c","usr.bin/ssh/kexecdhc.c","input_kex_ecdh_reply",94,221
6,1,27,1,5,"kexecdh_server@49-54@usr.bin/ssh/kexecdhs.c","usr.bin/ssh/kexecdhs.c","kexecdh_server",49,54
122,32,804,3,144,"input_kex_ecdh_init@57-201@usr.bin/ssh/kexecdhs.c","usr.bin/ssh/kexecdhs.c","input_kex_ecdh_init",57,201
51,23,435,19,56,"kexgex_hash@41-97@usr.bin/ssh/kexgex.c","usr.bin/ssh/kexgex.c","kexgex_hash",41,97
27,8,201,1,31,"kexgex_client@53-84@usr.bin/ssh/kexgexc.c","usr.bin/ssh/kexgexc.c","kexgex_client",53,84
45,17,340,3,50,"input_kex_dh_gex_group@87-137@usr.bin/ssh/kexgexc.c","usr.bin/ssh/kexgexc.c","input_kex_dh_gex_group",87,137
106,28,726,3,120,"input_kex_dh_gex_reply@140-260@usr.bin/ssh/kexgexc.c","usr.bin/ssh/kexgexc.c","input_kex_dh_gex_reply",140,260
7,1,27,1,6,"kexgex_server@56-62@usr.bin/ssh/kexgexs.c","usr.bin/ssh/kexgexs.c","kexgex_server",56,62
43,15,354,3,49,"input_kex_dh_gex_request@65-114@usr.bin/ssh/kexgexs.c","usr.bin/ssh/kexgexs.c","input_kex_dh_gex_request",65,114
108,29,773,3,129,"input_kex_dh_gex_init@117-246@usr.bin/ssh/kexgexs.c","usr.bin/ssh/kexgexs.c","input_kex_dh_gex_init",117,246
7,5,47,3,6,"fatal_on_fatal_errors@22-28@usr.bin/ssh/key.c","usr.bin/ssh/key.c","fatal_on_fatal_errors",22,28
11,2,68,2,11,"key_from_blob@31-42@usr.bin/ssh/key.c","usr.bin/ssh/key.c","key_from_blob",31,42
22,7,134,3,22,"key_to_blob@45-67@usr.bin/ssh/key.c","usr.bin/ssh/key.c","key_to_blob",45,67
24,7,156,6,24,"key_sign@70-94@usr.bin/ssh/key.c","usr.bin/ssh/key.c","key_sign",70,94
12,3,87,5,12,"key_verify@97-109@usr.bin/ssh/key.c","usr.bin/ssh/key.c","key_verify",97,109
8,2,49,1,8,"key_demote@112-120@usr.bin/ssh/key.c","usr.bin/ssh/key.c","key_demote",112,120
10,2,54,1,10,"key_drop_cert@123-133@usr.bin/ssh/key.c","usr.bin/ssh/key.c","key_drop_cert",123,133
12,2,79,5,12,"key_cert_check_authority@136-148@usr.bin/ssh/key.c","usr.bin/ssh/key.c","key_cert_check_authority",136,148
14,3,82,1,16,"key_load_cert@153-169@usr.bin/ssh/key.c","usr.bin/ssh/key.c","key_load_cert",153,169
14,3,88,2,15,"key_load_public@172-187@usr.bin/ssh/key.c","usr.bin/ssh/key.c","key_load_public",172,187
16,4,99,3,17,"key_load_private@190-207@usr.bin/ssh/key.c","usr.bin/ssh/key.c","key_load_private",190,207
17,4,104,4,18,"key_load_private_cert@210-228@usr.bin/ssh/key.c","usr.bin/ssh/key.c","key_load_private_cert",210,228
17,4,112,5,18,"key_load_private_type@231-249@usr.bin/ssh/key.c","usr.bin/ssh/key.c","key_load_private_type",231,249
6,4,49,2,5,"serial_cmp@102-107@usr.bin/ssh/krl.c","usr.bin/ssh/krl.c","serial_cmp",102,107
4,1,26,2,3,"key_id_cmp@110-113@usr.bin/ssh/krl.c","usr.bin/ssh/krl.c","key_id_cmp",110,113
10,4,93,2,10,"blob_cmp@116-126@usr.bin/ssh/krl.c","usr.bin/ssh/krl.c","blob_cmp",116,126
10,2,60,1,10,"ssh_krl_init@129-139@usr.bin/ssh/krl.c","usr.bin/ssh/krl.c","ssh_krl_init",129,139
15,1,103,1,15,"revoked_certs_free@142-157@usr.bin/ssh/krl.c","usr.bin/ssh/krl.c","revoked_certs_free",142,157
22,2,150,1,23,"ssh_krl_free@160-183@usr.bin/ssh/krl.c","usr.bin/ssh/krl.c","ssh_krl_free",160,183
4,1,18,2,3,"ssh_krl_set_version@186-189@usr.bin/ssh/krl.c","usr.bin/ssh/krl.c","ssh_krl_set_version",186,189
7,2,42,2,6,"ssh_krl_set_comment@192-198@usr.bin/ssh/krl.c","usr.bin/ssh/krl.c","ssh_krl_set_comment",192,198
31,9,209,4,32,"revoked_certs_for_ca_key@205-237@usr.bin/ssh/krl.c","usr.bin/ssh/krl.c","revoked_certs_for_ca_key",205,237
54,15,455,3,70,"insert_serial_range@240-310@usr.bin/ssh/krl.c","usr.bin/ssh/krl.c","insert_serial_range",240,310
5,1,30,3,4,"ssh_krl_revoke_cert_by_serial@313-317@usr.bin/ssh/krl.c","usr.bin/ssh/krl.c","ssh_krl_revoke_cert_by_serial",313,317
11,4,78,4,11,"ssh_krl_revoke_cert_by_serial_range@320-331@usr.bin/ssh/krl.c","usr.bin/ssh/krl.c","ssh_krl_revoke_cert_by_serial_range",320,331
21,5,149,3,22,"ssh_krl_revoke_cert_by_key_id@334-356@usr.bin/ssh/krl.c","usr.bin/ssh/krl.c","ssh_krl_revoke_cert_by_key_id",334,356
16,4,96,3,16,"plain_key_blob@360-376@usr.bin/ssh/krl.c","usr.bin/ssh/krl.c","plain_key_blob",360,376
14,3,92,3,14,"revoke_blob@380-394@usr.bin/ssh/krl.c","usr.bin/ssh/krl.c","revoke_blob",380,394
10,2,72,2,10,"ssh_krl_revoke_key_explicit@397-407@usr.bin/ssh/krl.c","usr.bin/ssh/krl.c","ssh_krl_revoke_key_explicit",397,407
11,2,74,2,11,"ssh_krl_revoke_key_sha1@410-421@usr.bin/ssh/krl.c","usr.bin/ssh/krl.c","ssh_krl_revoke_key_sha1",410,421
14,3,82,2,14,"ssh_krl_revoke_key@424-438@usr.bin/ssh/krl.c","usr.bin/ssh/krl.c","ssh_krl_revoke_key",424,438
57,13,391,6,73,"choose_next_state@448-521@usr.bin/ssh/krl.c","usr.bin/ssh/krl.c","choose_next_state",448,521
16,3,89,2,16,"put_bitmap@524-540@usr.bin/ssh/krl.c","usr.bin/ssh/krl.c","put_bitmap",524,540
136,47,885,2,156,"revoked_certs_generate@544-700@usr.bin/ssh/krl.c","usr.bin/ssh/krl.c","revoked_certs_generate",544,700
71,26,615,4,81,"ssh_krl_to_blob@703-784@usr.bin/ssh/krl.c","usr.bin/ssh/krl.c","ssh_krl_to_blob",703,784
13,2,68,3,13,"format_timestamp@787-800@usr.bin/ssh/krl.c","usr.bin/ssh/krl.c","format_timestamp",787,800
104,32,644,2,110,"parse_revoked_certs@803-913@usr.bin/ssh/krl.c","usr.bin/ssh/krl.c","parse_revoked_certs",803,913
206,61,1299,4,238,"ssh_krl_from_blob@918-1156@usr.bin/ssh/krl.c","usr.bin/ssh/krl.c","ssh_krl_from_blob",918,1156
23,4,179,2,30,"is_cert_revoked@1160-1190@usr.bin/ssh/krl.c","usr.bin/ssh/krl.c","is_cert_revoked",1160,1190
42,12,325,2,50,"is_key_revoked@1194-1244@usr.bin/ssh/krl.c","usr.bin/ssh/krl.c","is_key_revoked",1194,1244
14,4,95,2,14,"ssh_krl_check_key@1247-1261@usr.bin/ssh/krl.c","usr.bin/ssh/krl.c","ssh_krl_check_key",1247,1261
31,8,193,2,32,"ssh_krl_file_contains_key@1264-1296@usr.bin/ssh/krl.c","usr.bin/ssh/krl.c","ssh_krl_file_contains_key",1264,1296
9,4,60,1,9,"log_facility_number@99-108@usr.bin/ssh/log.c","usr.bin/ssh/log.c","log_facility_number",99,108
8,3,48,1,8,"log_facility_name@111-119@usr.bin/ssh/log.c","usr.bin/ssh/log.c","log_facility_name",111,119
9,4,60,1,9,"log_level_number@122-131@usr.bin/ssh/log.c","usr.bin/ssh/log.c","log_level_number",122,131
8,3,50,1,8,"log_level_name@134-142@usr.bin/ssh/log.c","usr.bin/ssh/log.c","log_level_name",134,142
7,1,35,2,7,"error@147-154@usr.bin/ssh/log.c","usr.bin/ssh/log.c","error",147,154
8,1,40,2,8,"sigdie@157-165@usr.bin/ssh/log.c","usr.bin/ssh/log.c","sigdie",157,165
8,1,40,2,8,"logdie@168-176@usr.bin/ssh/log.c","usr.bin/ssh/log.c","logdie",168,176
7,1,35,2,7,"logit@181-188@usr.bin/ssh/log.c","usr.bin/ssh/log.c","logit",181,188
7,1,35,2,7,"verbose@193-200@usr.bin/ssh/log.c","usr.bin/ssh/log.c","verbose",193,200
7,1,35,2,7,"debug@205-212@usr.bin/ssh/log.c","usr.bin/ssh/log.c","debug",205,212
7,1,35,2,7,"debug2@215-222@usr.bin/ssh/log.c","usr.bin/ssh/log.c","debug2",215,222
7,1,35,2,7,"debug3@225-232@usr.bin/ssh/log.c","usr.bin/ssh/log.c","debug3",225,232
54,14,191,4,57,"log_init@239-296@usr.bin/ssh/log.c","usr.bin/ssh/log.c","log_init",239,296
19,10,59,1,20,"log_change_level@299-319@usr.bin/ssh/log.c","usr.bin/ssh/log.c","log_change_level",299,319
4,2,13,1,3,"log_is_on_stderr@322-325@usr.bin/ssh/log.c","usr.bin/ssh/log.c","log_is_on_stderr",322,325
10,2,59,1,10,"log_redirect_stderr_to@329-339@usr.bin/ssh/log.c","usr.bin/ssh/log.c","log_redirect_stderr_to",329,339
5,1,20,2,4,"set_log_handler@344-348@usr.bin/ssh/log.c","usr.bin/ssh/log.c","set_log_handler",344,348
7,1,38,3,7,"do_log2@351-358@usr.bin/ssh/log.c","usr.bin/ssh/log.c","do_log2",351,358
68,16,359,3,70,"do_log@361-431@usr.bin/ssh/log.c","usr.bin/ssh/log.c","do_log",361,431
19,4,124,1,19,"mac_alg_list@79-98@usr.bin/ssh/mac.c","usr.bin/ssh/mac.c","mac_alg_list",79,98
17,4,126,2,16,"mac_setup_by_alg@101-117@usr.bin/ssh/mac.c","usr.bin/ssh/mac.c","mac_setup_by_alg",101,117
12,4,71,2,12,"mac_setup@120-132@usr.bin/ssh/mac.c","usr.bin/ssh/mac.c","mac_setup",120,132
22,9,119,1,21,"mac_init@135-156@usr.bin/ssh/mac.c","usr.bin/ssh/mac.c","mac_init",135,156
41,11,268,6,43,"mac_compute@159-202@usr.bin/ssh/mac.c","usr.bin/ssh/mac.c","mac_compute",159,202
15,4,98,6,15,"mac_check@205-220@usr.bin/ssh/mac.c","usr.bin/ssh/mac.c","mac_check",205,220
13,6,88,1,12,"mac_clear@223-235@usr.bin/ssh/mac.c","usr.bin/ssh/mac.c","mac_clear",223,235
17,7,119,1,17,"mac_valid@240-257@usr.bin/ssh/mac.c","usr.bin/ssh/mac.c","mac_valid",240,257
29,15,156,2,55,"match_pattern@55-110@usr.bin/ssh/match.c","usr.bin/ssh/match.c","match_pattern",55,110
32,13,211,3,50,"match_pattern_list@119-169@usr.bin/ssh/match.c","usr.bin/ssh/match.c","match_pattern_list",119,169
9,1,50,2,9,"match_hostname@178-187@usr.bin/ssh/match.c","usr.bin/ssh/match.c","match_hostname",178,187
14,8,98,3,17,"match_host_and_ip@195-212@usr.bin/ssh/match.c","usr.bin/ssh/match.c","match_host_and_ip",195,212
21,8,164,4,26,"match_user@220-246@usr.bin/ssh/match.c","usr.bin/ssh/match.c","match_user",220,246
35,11,280,3,37,"match_list@255-292@usr.bin/ssh/match.c","usr.bin/ssh/match.c","match_list",255,292
23,6,149,2,24,"match_filter_list@299-323@usr.bin/ssh/match.c","usr.bin/ssh/match.c","match_filter_list",299,323
12,4,49,1,12,"chop@65-77@usr.bin/ssh/misc.c","usr.bin/ssh/misc.c","chop",65,77
21,4,115,1,21,"set_nonblock@81-102@usr.bin/ssh/misc.c","usr.bin/ssh/misc.c","set_nonblock",81,102
21,4,118,1,21,"unset_nonblock@105-126@usr.bin/ssh/misc.c","usr.bin/ssh/misc.c","unset_nonblock",105,126
6,3,29,1,5,"ssh_gai_strerror@129-134@usr.bin/ssh/misc.c","usr.bin/ssh/misc.c","ssh_gai_strerror",129,134
18,4,110,1,18,"set_nodelay@138-156@usr.bin/ssh/misc.c","usr.bin/ssh/misc.c","set_nodelay",138,156
9,2,55,1,9,"set_reuseaddr@160-169@usr.bin/ssh/misc.c","usr.bin/ssh/misc.c","set_reuseaddr",160,169
13,2,72,1,13,"get_rdomain@173-186@usr.bin/ssh/misc.c","usr.bin/ssh/misc.c","get_rdomain",173,186
19,4,112,2,21,"set_rdomain@189-210@usr.bin/ssh/misc.c","usr.bin/ssh/misc.c","set_rdomain",189,210
28,8,211,1,37,"strdelim@218-255@usr.bin/ssh/misc.c","usr.bin/ssh/misc.c","strdelim",218,255
15,1,126,1,15,"pwcopy@258-273@usr.bin/ssh/misc.c","usr.bin/ssh/misc.c","pwcopy",258,273
9,2,48,1,9,"a2port@281-290@usr.bin/ssh/misc.c","usr.bin/ssh/misc.c","a2port",281,290
25,6,175,2,28,"a2tun@293-321@usr.bin/ssh/misc.c","usr.bin/ssh/misc.c","a2tun",293,321
54,23,230,1,58,"convtime@351-409@usr.bin/ssh/misc.c","usr.bin/ssh/misc.c","convtime",351,409
10,4,73,2,10,"put_host_port@416-426@usr.bin/ssh/misc.c","usr.bin/ssh/misc.c","put_host_port",416,426
29,10,155,2,34,"hpdelim2@437-471@usr.bin/ssh/misc.c","usr.bin/ssh/misc.c","hpdelim2",437,471
4,1,16,1,3,"hpdelim@474-477@usr.bin/ssh/misc.c","usr.bin/ssh/misc.c","hpdelim",474,477
8,3,52,1,7,"cleanhostname@480-487@usr.bin/ssh/misc.c","usr.bin/ssh/misc.c","cleanhostname",480,487
19,12,118,1,20,"colon@490-510@usr.bin/ssh/misc.c","usr.bin/ssh/misc.c","colon",490,510
48,11,274,4,57,"parse_user_host_path@522-579@usr.bin/ssh/misc.c","usr.bin/ssh/misc.c","parse_user_host_path",522,579
45,16,290,4,50,"parse_user_host_port@590-640@usr.bin/ssh/misc.c","usr.bin/ssh/misc.c","parse_user_host_port",590,640
16,8,163,1,16,"hexchar@647-663@usr.bin/ssh/misc.c","usr.bin/ssh/misc.c","hexchar",647,663
28,7,151,1,29,"urldecode@670-699@usr.bin/ssh/misc.c","usr.bin/ssh/misc.c","urldecode",670,699
73,27,487,6,88,"parse_uri@714-802@usr.bin/ssh/misc.c","usr.bin/ssh/misc.c","parse_uri",714,802
22,4,156,3,24,"addargs@806-830@usr.bin/ssh/misc.c","usr.bin/ssh/misc.c","addargs",806,830
16,3,101,4,17,"replacearg@833-850@usr.bin/ssh/misc.c","usr.bin/ssh/misc.c","replacearg",833,850
11,3,69,1,11,"freeargs@853-864@usr.bin/ssh/misc.c","usr.bin/ssh/misc.c","freeargs",853,864
31,11,237,2,38,"tilde_expand_filename@871-909@usr.bin/ssh/misc.c","usr.bin/ssh/misc.c","tilde_expand_filename",871,909
49,15,344,2,55,"percent_expand@918-973@usr.bin/ssh/misc.c","usr.bin/ssh/misc.c","percent_expand",918,973
18,7,115,5,18,"read_keyfile_line@980-998@usr.bin/ssh/misc.c","usr.bin/ssh/misc.c","read_keyfile_line",980,998
56,15,389,3,68,"tun_open@1001-1069@usr.bin/ssh/misc.c","usr.bin/ssh/misc.c","tun_open",1001,1069
19,7,117,1,20,"sanitise_stdfd@1072-1092@usr.bin/ssh/misc.c","usr.bin/ssh/misc.c","sanitise_stdfd",1072,1092
15,3,113,2,16,"tohex@1095-1111@usr.bin/ssh/misc.c","usr.bin/ssh/misc.c","tohex",1095,1111
14,1,130,1,15,"get_u64@1114-1129@usr.bin/ssh/misc.c","usr.bin/ssh/misc.c","get_u64",1114,1129
10,1,78,1,11,"get_u32@1132-1143@usr.bin/ssh/misc.c","usr.bin/ssh/misc.c","get_u32",1132,1143
10,1,78,1,11,"get_u32_le@1146-1157@usr.bin/ssh/misc.c","usr.bin/ssh/misc.c","get_u32_le",1146,1157
8,1,52,1,9,"get_u16@1160-1169@usr.bin/ssh/misc.c","usr.bin/ssh/misc.c","get_u16",1160,1169
12,1,152,2,12,"put_u64@1172-1184@usr.bin/ssh/misc.c","usr.bin/ssh/misc.c","put_u64",1172,1184
8,1,84,2,8,"put_u32@1187-1195@usr.bin/ssh/misc.c","usr.bin/ssh/misc.c","put_u32",1187,1195
8,1,84,2,8,"put_u32_le@1198-1206@usr.bin/ssh/misc.c","usr.bin/ssh/misc.c","put_u32_le",1198,1206
6,1,50,2,6,"put_u16@1209-1215@usr.bin/ssh/misc.c","usr.bin/ssh/misc.c","put_u16",1209,1215
7,1,55,2,7,"ms_subtract_diff@1218-1225@usr.bin/ssh/misc.c","usr.bin/ssh/misc.c","ms_subtract_diff",1218,1225
7,2,42,2,6,"ms_to_timeval@1228-1234@usr.bin/ssh/misc.c","usr.bin/ssh/misc.c","ms_to_timeval",1228,1234
5,2,30,1,4,"monotime_ts@1237-1241@usr.bin/ssh/misc.c","usr.bin/ssh/misc.c","monotime_ts",1237,1241
7,1,37,1,7,"monotime_tv@1244-1251@usr.bin/ssh/misc.c","usr.bin/ssh/misc.c","monotime_tv",1244,1251
6,1,23,1,6,"monotime@1254-1260@usr.bin/ssh/misc.c","usr.bin/ssh/misc.c","monotime",1254,1260
6,1,35,1,6,"monotime_double@1263-1269@usr.bin/ssh/misc.c","usr.bin/ssh/misc.c","monotime_double",1263,1269
9,1,57,3,8,"bandwidth_limit_init@1272-1280@usr.bin/ssh/misc.c","usr.bin/ssh/misc.c","bandwidth_limit_init",1272,1280
40,11,311,2,49,"bandwidth_limit@1284-1333@usr.bin/ssh/misc.c","usr.bin/ssh/misc.c","bandwidth_limit",1284,1333
13,6,93,2,13,"mktemp_proto@1337-1350@usr.bin/ssh/misc.c","usr.bin/ssh/misc.c","mktemp_proto",1337,1350
16,8,112,1,17,"parse_ipqos@1385-1402@usr.bin/ssh/misc.c","usr.bin/ssh/misc.c","parse_ipqos",1385,1402
11,3,72,1,11,"iptos2str@1405-1416@usr.bin/ssh/misc.c","usr.bin/ssh/misc.c","iptos2str",1405,1416
5,2,29,1,4,"lowercase@1419-1423@usr.bin/ssh/misc.c","usr.bin/ssh/misc.c","lowercase",1419,1423
42,8,278,3,43,"unix_listener@1426-1469@usr.bin/ssh/misc.c","usr.bin/ssh/misc.c","unix_listener",1426,1469
8,7,60,2,7,"strcmp_maybe_null@1476-1483@usr.bin/ssh/misc.c","usr.bin/ssh/misc.c","strcmp_maybe_null",1476,1483
16,7,117,2,16,"forward_equals@1490-1506@usr.bin/ssh/misc.c","usr.bin/ssh/misc.c","forward_equals",1490,1506
6,3,26,2,5,"bind_permitted@1510-1515@usr.bin/ssh/misc.c","usr.bin/ssh/misc.c","bind_permitted",1510,1515
14,4,69,1,14,"daemonized@1519-1533@usr.bin/ssh/misc.c","usr.bin/ssh/misc.c","daemonized",1519,1533
57,25,450,3,67,"argv_split@1542-1609@usr.bin/ssh/misc.c","usr.bin/ssh/misc.c","argv_split",1542,1609
46,17,353,2,48,"argv_assemble@1616-1664@usr.bin/ssh/misc.c","usr.bin/ssh/misc.c","argv_assemble",1616,1664
118,28,920,7,140,"subprocess@1676-1816@usr.bin/ssh/misc.c","usr.bin/ssh/misc.c","subprocess",1676,1816
19,6,130,4,19,"exited_cleanly@1820-1839@usr.bin/ssh/misc.c","usr.bin/ssh/misc.c","exited_cleanly",1820,1839
44,18,319,6,55,"safe_path@1855-1910@usr.bin/ssh/misc.c","usr.bin/ssh/misc.c","safe_path",1855,1910
11,2,83,5,12,"safe_path_fd@1919-1931@usr.bin/ssh/misc.c","usr.bin/ssh/misc.c","safe_path_fd",1919,1931
31,8,245,4,42,"child_set_env@1938-1980@usr.bin/ssh/misc.c","usr.bin/ssh/misc.c","child_set_env",1938,1980
41,15,275,3,41,"valid_domain@1987-2028@usr.bin/ssh/misc.c","usr.bin/ssh/misc.c","valid_domain",1987,2028
20,4,154,7,25,"qfileout@147-172@usr.bin/ssh/moduli.c","usr.bin/ssh/moduli.c","qfileout",147,172
31,10,171,1,50,"sieve_large@179-229@usr.bin/ssh/moduli.c","usr.bin/ssh/moduli.c","sieve_large",179,229
124,32,872,4,203,"gen_candidates@237-440@usr.bin/ssh/moduli.c","usr.bin/ssh/moduli.c","gen_candidates",237,440
28,8,188,2,28,"write_checkpoint@443-471@usr.bin/ssh/moduli.c","usr.bin/ssh/moduli.c","write_checkpoint",443,471
13,3,75,1,13,"read_checkpoint@474-487@usr.bin/ssh/moduli.c","usr.bin/ssh/moduli.c","read_checkpoint",474,487
14,3,78,1,14,"count_lines@490-504@usr.bin/ssh/moduli.c","usr.bin/ssh/moduli.c","count_lines",490,504
13,2,93,1,13,"fmt_time@507-520@usr.bin/ssh/moduli.c","usr.bin/ssh/moduli.c","fmt_time",507,520
35,4,204,3,37,"print_progress@523-560@usr.bin/ssh/moduli.c","usr.bin/ssh/moduli.c","print_progress",523,560
161,43,974,7,231,"prime_test@569-800@usr.bin/ssh/moduli.c","usr.bin/ssh/moduli.c","prime_test",569,800
11,4,57,3,10,"monitor_permit@198-208@usr.bin/ssh/monitor.c","usr.bin/ssh/monitor.c","monitor_permit",198,208
11,4,53,1,11,"monitor_permit_authentications@211-222@usr.bin/ssh/monitor.c","usr.bin/ssh/monitor.c","monitor_permit_authentications",211,222
63,18,392,2,79,"monitor_child_preauth@225-304@usr.bin/ssh/monitor.c","usr.bin/ssh/monitor.c","monitor_child_preauth",225,304
4,1,11,1,3,"monitor_set_child_handler@307-310@usr.bin/ssh/monitor.c","usr.bin/ssh/monitor.c","monitor_set_child_handler",307,310
4,1,14,1,3,"monitor_child_handler@313-316@usr.bin/ssh/monitor.c","usr.bin/ssh/monitor.c","monitor_child_handler",313,316
19,3,124,1,24,"monitor_child_postauth@319-343@usr.bin/ssh/monitor.c","usr.bin/ssh/monitor.c","monitor_child_postauth",319,343
36,7,258,1,44,"monitor_read_log@346-390@usr.bin/ssh/monitor.c","usr.bin/ssh/monitor.c","monitor_read_log",346,390
52,15,352,3,68,"monitor_read@393-461@usr.bin/ssh/monitor.c","usr.bin/ssh/monitor.c","monitor_read",393,461
7,4,40,2,7,"monitor_allowed_key@465-472@usr.bin/ssh/monitor.c","usr.bin/ssh/monitor.c","monitor_allowed_key",465,472
11,1,41,1,11,"monitor_reset_key_state@475-486@usr.bin/ssh/monitor.c","usr.bin/ssh/monitor.c","monitor_reset_key_state",475,486
26,5,166,2,32,"mm_answer_moduli@490-522@usr.bin/ssh/monitor.c","usr.bin/ssh/monitor.c","mm_answer_moduli",490,522
70,25,587,2,97,"mm_answer_sign@526-623@usr.bin/ssh/monitor.c","usr.bin/ssh/monitor.c","mm_answer_sign",526,623
46,6,315,2,78,"mm_answer_pwnamallow@628-706@usr.bin/ssh/monitor.c","usr.bin/ssh/monitor.c","mm_answer_pwnamallow",628,706
10,2,58,2,11,"mm_answer_auth2_read_banner@708-719@usr.bin/ssh/monitor.c","usr.bin/ssh/monitor.c","mm_answer_auth2_read_banner",708,719
13,2,84,2,15,"mm_answer_authserv@722-737@usr.bin/ssh/monitor.c","usr.bin/ssh/monitor.c","mm_answer_authserv",722,737
24,5,134,2,30,"mm_answer_authpassword@740-770@usr.bin/ssh/monitor.c","usr.bin/ssh/monitor.c","mm_answer_authpassword",740,770
25,5,149,2,29,"mm_answer_bsdauthquery@773-802@usr.bin/ssh/monitor.c","usr.bin/ssh/monitor.c","mm_answer_bsdauthquery",773,802
22,4,140,2,27,"mm_answer_bsdauthrespond@805-832@usr.bin/ssh/monitor.c","usr.bin/ssh/monitor.c","mm_answer_bsdauthrespond",805,832
72,18,422,2,88,"mm_answer_keyallowed@835-923@usr.bin/ssh/monitor.c","usr.bin/ssh/monitor.c","mm_answer_keyallowed",835,923
57,17,357,2,58,"monitor_valid_userblob@926-984@usr.bin/ssh/monitor.c","usr.bin/ssh/monitor.c","monitor_valid_userblob",926,984
50,14,351,4,57,"monitor_valid_hostbasedblob@987-1044@usr.bin/ssh/monitor.c","usr.bin/ssh/monitor.c","monitor_valid_hostbasedblob",987,1044
48,13,360,2,59,"mm_answer_keyverify@1047-1106@usr.bin/ssh/monitor.c","usr.bin/ssh/monitor.c","mm_answer_keyverify",1047,1106
18,3,134,2,23,"mm_record_login@1109-1132@usr.bin/ssh/monitor.c","usr.bin/ssh/monitor.c","mm_record_login",1109,1132
9,2,64,1,8,"mm_session_close@1135-1143@usr.bin/ssh/monitor.c","usr.bin/ssh/monitor.c","mm_session_close",1135,1143
45,9,356,2,64,"mm_answer_pty@1146-1210@usr.bin/ssh/monitor.c","usr.bin/ssh/monitor.c","mm_answer_pty",1146,1210
12,2,68,2,13,"mm_answer_pty_cleanup@1213-1226@usr.bin/ssh/monitor.c","usr.bin/ssh/monitor.c","mm_answer_pty_cleanup",1213,1226
13,4,91,2,19,"mm_answer_term@1229-1248@usr.bin/ssh/monitor.c","usr.bin/ssh/monitor.c","mm_answer_term",1229,1248
8,1,39,1,8,"monitor_clear_keystate@1251-1259@usr.bin/ssh/monitor.c","usr.bin/ssh/monitor.c","monitor_clear_keystate",1251,1259
26,4,189,1,30,"monitor_apply_keystate@1262-1292@usr.bin/ssh/monitor.c","usr.bin/ssh/monitor.c","monitor_apply_keystate",1262,1292
9,2,53,1,9,"mm_get_keystate@1297-1306@usr.bin/ssh/monitor.c","usr.bin/ssh/monitor.c","mm_get_keystate",1297,1306
24,8,227,2,29,"monitor_openfds@1317-1346@usr.bin/ssh/monitor.c","usr.bin/ssh/monitor.c","monitor_openfds",1317,1346
7,1,34,1,8,"monitor_init@1351-1359@usr.bin/ssh/monitor.c","usr.bin/ssh/monitor.c","monitor_init",1351,1359
4,1,16,1,3,"monitor_reinit@1362-1365@usr.bin/ssh/monitor.c","usr.bin/ssh/monitor.c","monitor_reinit",1362,1365
17,2,105,2,25,"mm_answer_gss_setup_ctx@1369-1394@usr.bin/ssh/monitor.c","usr.bin/ssh/monitor.c","mm_answer_gss_setup_ctx",1369,1394
26,3,177,2,30,"mm_answer_gss_accept_ctx@1397-1427@usr.bin/ssh/monitor.c","usr.bin/ssh/monitor.c","mm_answer_gss_accept_ctx",1397,1427
21,3,142,2,28,"mm_answer_gss_checkmic@1430-1458@usr.bin/ssh/monitor.c","usr.bin/ssh/monitor.c","mm_answer_gss_checkmic",1430,1458
16,4,106,2,23,"mm_answer_gss_userok@1461-1484@usr.bin/ssh/monitor.c","usr.bin/ssh/monitor.c","mm_answer_gss_userok",1461,1484
43,6,297,2,46,"mm_send_fd@40-86@usr.bin/ssh/monitor_fdpass.c","usr.bin/ssh/monitor_fdpass.c","mm_send_fd",40,86
49,8,312,1,53,"mm_receive_fd@89-142@usr.bin/ssh/monitor_fdpass.c","usr.bin/ssh/monitor_fdpass.c","mm_receive_fd",89,142
16,3,141,3,23,"mm_log_handler@84-107@usr.bin/ssh/monitor_wrap.c","usr.bin/ssh/monitor_wrap.c","mm_log_handler",84,107
4,2,17,1,7,"mm_is_monitor@110-117@usr.bin/ssh/monitor_wrap.c","usr.bin/ssh/monitor_wrap.c","mm_is_monitor",110,117
12,3,120,3,13,"mm_request_send@120-133@usr.bin/ssh/monitor_wrap.c","usr.bin/ssh/monitor_wrap.c","mm_request_send",120,133
18,5,139,2,19,"mm_request_receive@136-155@usr.bin/ssh/monitor_wrap.c","usr.bin/ssh/monitor_wrap.c","mm_request_receive",136,155
10,2,58,3,11,"mm_request_receive_expect@158-169@usr.bin/ssh/monitor_wrap.c","usr.bin/ssh/monitor_wrap.c","mm_request_receive_expect",158,169
25,4,193,3,31,"mm_choose_dh@173-204@usr.bin/ssh/monitor_wrap.c","usr.bin/ssh/monitor_wrap.c","mm_choose_dh",173,204
17,1,144,6,21,"mm_key_sign@208-229@usr.bin/ssh/monitor_wrap.c","usr.bin/ssh/monitor_wrap.c","mm_key_sign",208,229
38,4,279,1,61,"mm_getpwnamallow@232-293@usr.bin/ssh/monitor_wrap.c","usr.bin/ssh/monitor_wrap.c","mm_getpwnamallow",232,293
18,2,97,1,22,"mm_auth2_read_banner@296-318@usr.bin/ssh/monitor_wrap.c","usr.bin/ssh/monitor_wrap.c","mm_auth2_read_banner",296,318
10,2,66,2,13,"mm_inform_authserv@323-336@usr.bin/ssh/monitor_wrap.c","usr.bin/ssh/monitor_wrap.c","mm_inform_authserv",323,336
16,2,104,2,21,"mm_auth_password@340-361@usr.bin/ssh/monitor_wrap.c","usr.bin/ssh/monitor_wrap.c","mm_auth_password",340,361
6,1,33,3,5,"mm_user_key_allowed@364-369@usr.bin/ssh/monitor_wrap.c","usr.bin/ssh/monitor_wrap.c","mm_user_key_allowed",364,369
5,1,40,4,4,"mm_hostbased_key_allowed@372-376@usr.bin/ssh/monitor_wrap.c","usr.bin/ssh/monitor_wrap.c","mm_hostbased_key_allowed",372,376
27,5,205,5,37,"mm_key_allowed@379-416@usr.bin/ssh/monitor_wrap.c","usr.bin/ssh/monitor_wrap.c","mm_key_allowed",379,416
24,3,168,6,32,"mm_sshkey_verify@425-457@usr.bin/ssh/monitor_wrap.c","usr.bin/ssh/monitor_wrap.c","mm_sshkey_verify",425,457
14,3,93,1,14,"mm_send_keystate@460-474@usr.bin/ssh/monitor_wrap.c","usr.bin/ssh/monitor_wrap.c","mm_send_keystate",460,474
38,8,291,4,47,"mm_pty_allocate@477-524@usr.bin/ssh/monitor_wrap.c","usr.bin/ssh/monitor_wrap.c","mm_pty_allocate",477,524
14,4,95,1,18,"mm_session_pty_cleanup2@527-545@usr.bin/ssh/monitor_wrap.c","usr.bin/ssh/monitor_wrap.c","mm_session_pty_cleanup2",527,545
7,1,33,1,7,"mm_terminate@550-557@usr.bin/ssh/monitor_wrap.c","usr.bin/ssh/monitor_wrap.c","mm_terminate",550,557
10,1,85,5,9,"mm_chall_setup@560-569@usr.bin/ssh/monitor_wrap.c","usr.bin/ssh/monitor_wrap.c","mm_chall_setup",560,569
24,2,164,6,31,"mm_bsdauth_query@572-603@usr.bin/ssh/monitor_wrap.c","usr.bin/ssh/monitor_wrap.c","mm_bsdauth_query",572,603
16,3,109,3,20,"mm_bsdauth_respond@606-626@usr.bin/ssh/monitor_wrap.c","usr.bin/ssh/monitor_wrap.c","mm_bsdauth_respond",606,626
13,1,85,2,18,"mm_ssh_gssapi_server_ctx@630-648@usr.bin/ssh/monitor_wrap.c","usr.bin/ssh/monitor_wrap.c","mm_ssh_gssapi_server_ctx",630,648
18,2,124,4,22,"mm_ssh_gssapi_accept_ctx@651-673@usr.bin/ssh/monitor_wrap.c","usr.bin/ssh/monitor_wrap.c","mm_ssh_gssapi_accept_ctx",651,673
14,1,97,3,16,"mm_ssh_gssapi_checkmic@676-692@usr.bin/ssh/monitor_wrap.c","usr.bin/ssh/monitor_wrap.c","mm_ssh_gssapi_checkmic",676,692
13,2,78,1,16,"mm_ssh_gssapi_userok@695-711@usr.bin/ssh/monitor_wrap.c","usr.bin/ssh/monitor_wrap.c","mm_ssh_gssapi_userok",695,711
17,3,132,3,18,"ssh_msg_send@43-61@usr.bin/ssh/msg.c","usr.bin/ssh/msg.c","ssh_msg_send",43,61
27,6,181,2,28,"ssh_msg_recv@64-92@usr.bin/ssh/msg.c","usr.bin/ssh/msg.c","ssh_msg_recv",64,92
17,4,132,3,17,"mux_master_session_cleanup_cb@193-210@usr.bin/ssh/mux.c","usr.bin/ssh/mux.c","mux_master_session_cleanup_cb",193,210
26,8,189,3,26,"mux_master_control_cleanup_cb@215-241@usr.bin/ssh/mux.c","usr.bin/ssh/mux.c","mux_master_control_cleanup_cb",215,241
16,7,132,1,18,"env_permitted@245-263@usr.bin/ssh/mux.c","usr.bin/ssh/mux.c","env_permitted",245,263
37,8,223,5,40,"process_mux_master_hello@268-308@usr.bin/ssh/mux.c","usr.bin/ssh/mux.c","process_mux_master_hello",268,308
145,32,1073,5,172,"process_mux_new_session@311-483@usr.bin/ssh/mux.c","usr.bin/ssh/mux.c","process_mux_new_session",311,483
9,1,64,5,11,"process_mux_alive_check@486-497@usr.bin/ssh/mux.c","usr.bin/ssh/mux.c","process_mux_alive_check",486,497
20,4,115,5,22,"process_mux_terminate@500-522@usr.bin/ssh/mux.c","usr.bin/ssh/mux.c","process_mux_terminate",500,522
33,13,213,2,33,"format_forward@525-558@usr.bin/ssh/mux.c","usr.bin/ssh/mux.c","format_forward",525,558
8,5,50,2,7,"compare_host@561-568@usr.bin/ssh/mux.c","usr.bin/ssh/mux.c","compare_host",561,568
16,7,111,2,16,"compare_forward@571-587@usr.bin/ssh/mux.c","usr.bin/ssh/mux.c","compare_forward",571,587
71,13,510,4,74,"mux_confirm_remote_forward@590-664@usr.bin/ssh/mux.c","usr.bin/ssh/mux.c","mux_confirm_remote_forward",590,664
158,45,944,5,169,"process_mux_open_fwd@667-836@usr.bin/ssh/mux.c","usr.bin/ssh/mux.c","process_mux_open_fwd",667,836
96,26,607,5,113,"process_mux_close_fwd@839-952@usr.bin/ssh/mux.c","usr.bin/ssh/mux.c","process_mux_close_fwd",839,952
76,13,526,5,96,"process_mux_stdio_fwd@955-1051@usr.bin/ssh/mux.c","usr.bin/ssh/mux.c","process_mux_stdio_fwd",955,1051
34,6,256,4,41,"mux_stdio_confirm@1055-1096@usr.bin/ssh/mux.c","usr.bin/ssh/mux.c","mux_stdio_confirm",1055,1096
27,5,153,5,31,"process_mux_stop_listening@1099-1130@usr.bin/ssh/mux.c","usr.bin/ssh/mux.c","process_mux_stop_listening",1099,1130
9,1,58,5,10,"process_mux_proxy@1133-1143@usr.bin/ssh/mux.c","usr.bin/ssh/mux.c","process_mux_proxy",1133,1143
67,11,452,2,78,"mux_master_read_cb@1147-1225@usr.bin/ssh/mux.c","usr.bin/ssh/mux.c","mux_master_read_cb",1147,1225
16,2,125,3,20,"mux_exit_message@1228-1248@usr.bin/ssh/mux.c","usr.bin/ssh/mux.c","mux_exit_message",1228,1248
14,2,112,2,18,"mux_tty_alloc_failed@1251-1269@usr.bin/ssh/mux.c","usr.bin/ssh/mux.c","mux_tty_alloc_failed",1251,1269
66,12,416,1,80,"muxserver_listen@1273-1353@usr.bin/ssh/mux.c","usr.bin/ssh/mux.c","muxserver_listen",1273,1353
64,14,486,4,78,"mux_session_confirm@1357-1435@usr.bin/ssh/mux.c","usr.bin/ssh/mux.c","mux_session_confirm",1357,1435
4,1,11,1,3,"control_client_sighandler@1441-1444@usr.bin/ssh/mux.c","usr.bin/ssh/mux.c","control_client_sighandler",1441,1444
7,2,29,1,8,"control_client_sigrelay@1451-1459@usr.bin/ssh/mux.c","usr.bin/ssh/mux.c","control_client_sigrelay",1451,1459
33,7,159,3,34,"mux_client_read@1462-1496@usr.bin/ssh/mux.c","usr.bin/ssh/mux.c","mux_client_read",1462,1496
43,7,224,2,46,"mux_client_write_packet@1499-1545@usr.bin/ssh/mux.c","usr.bin/ssh/mux.c","mux_client_write_packet",1499,1545
28,4,171,2,28,"mux_client_read_packet@1548-1576@usr.bin/ssh/mux.c","usr.bin/ssh/mux.c","mux_client_read_packet",1548,1576
42,6,238,1,51,"mux_client_hello_exchange@1579-1630@usr.bin/ssh/mux.c","usr.bin/ssh/mux.c","mux_client_hello_exchange",1579,1630
30,5,192,1,40,"mux_client_request_alive@1633-1673@usr.bin/ssh/mux.c","usr.bin/ssh/mux.c","mux_client_request_alive",1633,1673
40,8,226,1,47,"mux_client_request_terminate@1676-1723@usr.bin/ssh/mux.c","usr.bin/ssh/mux.c","mux_client_request_terminate",1676,1723
71,18,456,4,78,"mux_client_forward@1726-1804@usr.bin/ssh/mux.c","usr.bin/ssh/mux.c","mux_client_forward",1726,1804
20,7,136,2,22,"mux_client_forwards@1807-1829@usr.bin/ssh/mux.c","usr.bin/ssh/mux.c","mux_client_forwards",1807,1829
135,35,910,1,164,"mux_client_request_session@1832-1996@usr.bin/ssh/mux.c","usr.bin/ssh/mux.c","mux_client_request_session",1832,1996
28,5,173,1,32,"mux_client_proxy@1999-2031@usr.bin/ssh/mux.c","usr.bin/ssh/mux.c","mux_client_proxy",1999,2031
79,19,530,1,97,"mux_client_request_stdio_fwd@2034-2131@usr.bin/ssh/mux.c","usr.bin/ssh/mux.c","mux_client_request_stdio_fwd",2034,2131
35,7,208,1,41,"mux_client_request_stop_listening@2134-2175@usr.bin/ssh/mux.c","usr.bin/ssh/mux.c","mux_client_request_stop_listening",2134,2175
98,29,538,1,106,"muxclient@2179-2285@usr.bin/ssh/mux.c","usr.bin/ssh/mux.c","muxclient",2179,2285
8,3,61,2,7,"chan_set_istate@86-93@usr.bin/ssh/nchan.c","usr.bin/ssh/nchan.c","chan_set_istate",86,93
8,3,61,2,7,"chan_set_ostate@96-103@usr.bin/ssh/nchan.c","usr.bin/ssh/nchan.c","chan_set_ostate",96,103
14,2,66,2,13,"chan_read_failed@106-119@usr.bin/ssh/nchan.c","usr.bin/ssh/nchan.c","chan_read_failed",106,119
20,4,103,2,19,"chan_ibuf_empty@122-141@usr.bin/ssh/nchan.c","usr.bin/ssh/nchan.c","chan_ibuf_empty",122,141
19,3,88,2,18,"chan_obuf_empty@144-162@usr.bin/ssh/nchan.c","usr.bin/ssh/nchan.c","chan_obuf_empty",144,162
10,2,49,2,9,"chan_rcvd_eow@165-174@usr.bin/ssh/nchan.c","usr.bin/ssh/nchan.c","chan_rcvd_eow",165,174
21,6,132,2,21,"chan_send_eof2@177-198@usr.bin/ssh/nchan.c","usr.bin/ssh/nchan.c","chan_send_eof2",177,198
21,8,158,2,21,"chan_send_close2@201-222@usr.bin/ssh/nchan.c","usr.bin/ssh/nchan.c","chan_send_close2",201,222
20,9,154,2,20,"chan_send_eow2@225-245@usr.bin/ssh/nchan.c","usr.bin/ssh/nchan.c","chan_send_eow2",225,245
11,5,73,2,10,"chan_rcvd_ieof@250-260@usr.bin/ssh/nchan.c","usr.bin/ssh/nchan.c","chan_rcvd_ieof",250,260
31,8,161,2,35,"chan_rcvd_oclose@263-298@usr.bin/ssh/nchan.c","usr.bin/ssh/nchan.c","chan_rcvd_oclose",263,298
17,4,89,2,16,"chan_write_failed@301-317@usr.bin/ssh/nchan.c","usr.bin/ssh/nchan.c","chan_write_failed",301,317
4,1,19,2,3,"chan_mark_dead@320-323@usr.bin/ssh/nchan.c","usr.bin/ssh/nchan.c","chan_mark_dead",320,323
38,14,218,3,38,"chan_is_dead@326-364@usr.bin/ssh/nchan.c","usr.bin/ssh/nchan.c","chan_is_dead",326,364
18,5,118,2,18,"chan_shutdown_write@368-386@usr.bin/ssh/nchan.c","usr.bin/ssh/nchan.c","chan_shutdown_write",368,386
18,5,119,2,17,"chan_shutdown_read@389-406@usr.bin/ssh/nchan.c","usr.bin/ssh/nchan.c","chan_shutdown_read",389,406
6,2,42,2,6,"ssh_packet_start@13-19@usr.bin/ssh/opacket.c","usr.bin/ssh/opacket.c","ssh_packet_start",13,19
7,2,47,2,7,"ssh_packet_put_char@22-29@usr.bin/ssh/opacket.c","usr.bin/ssh/opacket.c","ssh_packet_put_char",22,29
6,2,42,2,6,"ssh_packet_put_int@32-38@usr.bin/ssh/opacket.c","usr.bin/ssh/opacket.c","ssh_packet_put_int",32,38
6,2,42,2,6,"ssh_packet_put_int64@41-47@usr.bin/ssh/opacket.c","usr.bin/ssh/opacket.c","ssh_packet_put_int64",41,47
6,2,49,3,6,"ssh_packet_put_string@50-56@usr.bin/ssh/opacket.c","usr.bin/ssh/opacket.c","ssh_packet_put_string",50,56
6,2,44,2,6,"ssh_packet_put_cstring@59-65@usr.bin/ssh/opacket.c","usr.bin/ssh/opacket.c","ssh_packet_put_cstring",59,65
6,2,49,3,6,"ssh_packet_put_raw@68-74@usr.bin/ssh/opacket.c","usr.bin/ssh/opacket.c","ssh_packet_put_raw",68,74
6,2,43,2,6,"ssh_packet_put_bignum2@79-85@usr.bin/ssh/opacket.c","usr.bin/ssh/opacket.c","ssh_packet_put_bignum2",79,85
7,2,51,3,7,"ssh_packet_put_ecpoint@88-95@usr.bin/ssh/opacket.c","usr.bin/ssh/opacket.c","ssh_packet_put_ecpoint",88,95
6,2,37,1,6,"ssh_packet_send@99-105@usr.bin/ssh/opacket.c","usr.bin/ssh/opacket.c","ssh_packet_send",99,105
8,2,46,1,8,"ssh_packet_get_char@108-116@usr.bin/ssh/opacket.c","usr.bin/ssh/opacket.c","ssh_packet_get_char",108,116
8,2,46,1,8,"ssh_packet_get_int@119-127@usr.bin/ssh/opacket.c","usr.bin/ssh/opacket.c","ssh_packet_get_int",119,127
8,2,46,1,8,"ssh_packet_get_int64@130-138@usr.bin/ssh/opacket.c","usr.bin/ssh/opacket.c","ssh_packet_get_int64",130,138
6,2,43,2,6,"ssh_packet_get_bignum2@143-149@usr.bin/ssh/opacket.c","usr.bin/ssh/opacket.c","ssh_packet_get_bignum2",143,149
6,2,50,3,6,"ssh_packet_get_ecpoint@152-158@usr.bin/ssh/opacket.c","usr.bin/ssh/opacket.c","ssh_packet_get_ecpoint",152,158
11,3,71,2,11,"ssh_packet_get_string@162-173@usr.bin/ssh/opacket.c","usr.bin/ssh/opacket.c","ssh_packet_get_string",162,173
11,3,72,2,11,"ssh_packet_get_string_ptr@176-187@usr.bin/ssh/opacket.c","usr.bin/ssh/opacket.c","ssh_packet_get_string_ptr",176,187
11,3,71,2,11,"ssh_packet_get_cstring@190-201@usr.bin/ssh/opacket.c","usr.bin/ssh/opacket.c","ssh_packet_get_cstring",190,201
6,2,34,2,5,"packet_set_connection@206-211@usr.bin/ssh/opacket.c","usr.bin/ssh/opacket.c","packet_set_connection",206,211
4,1,14,1,3,"packet_get_char@214-217@usr.bin/ssh/opacket.c","usr.bin/ssh/opacket.c","packet_get_char",214,217
4,1,14,1,3,"packet_get_int@220-223@usr.bin/ssh/opacket.c","usr.bin/ssh/opacket.c","packet_get_int",220,223
8,2,44,1,8,"packet_read_seqnr@226-234@usr.bin/ssh/opacket.c","usr.bin/ssh/opacket.c","packet_read_seqnr",226,234
8,2,42,1,8,"packet_read_poll_seqnr@237-245@usr.bin/ssh/opacket.c","usr.bin/ssh/opacket.c","packet_read_poll_seqnr",237,245
5,1,15,1,4,"packet_close@248-252@usr.bin/ssh/opacket.c","usr.bin/ssh/opacket.c","packet_close",248,252
6,2,41,2,6,"packet_process_incoming@255-261@usr.bin/ssh/opacket.c","usr.bin/ssh/opacket.c","packet_process_incoming",255,261
6,2,31,1,6,"packet_write_wait@264-270@usr.bin/ssh/opacket.c","usr.bin/ssh/opacket.c","packet_write_wait",264,270
6,2,31,1,6,"packet_write_poll@273-279@usr.bin/ssh/opacket.c","usr.bin/ssh/opacket.c","packet_write_poll",273,279
6,2,34,1,6,"packet_read_expect@282-288@usr.bin/ssh/opacket.c","usr.bin/ssh/opacket.c","packet_read_expect",282,288
34,8,242,1,38,"ssh_alloc_session_state@215-253@usr.bin/ssh/packet.c","usr.bin/ssh/packet.c","ssh_alloc_session_state",215,253
5,1,33,3,4,"ssh_packet_set_input_hook@256-260@usr.bin/ssh/packet.c","usr.bin/ssh/packet.c","ssh_packet_set_input_hook",256,260
5,3,32,1,4,"ssh_packet_is_rekeying@264-268@usr.bin/ssh/packet.c","usr.bin/ssh/packet.c","ssh_packet_is_rekeying",264,268
30,6,213,3,34,"ssh_packet_set_connection@274-308@usr.bin/ssh/packet.c","usr.bin/ssh/packet.c","ssh_packet_set_connection",274,308
12,4,74,3,12,"ssh_packet_set_timeout@311-323@usr.bin/ssh/packet.c","usr.bin/ssh/packet.c","ssh_packet_set_timeout",311,323
5,1,25,1,4,"ssh_packet_set_mux@326-330@usr.bin/ssh/packet.c","usr.bin/ssh/packet.c","ssh_packet_set_mux",326,330
4,1,16,1,3,"ssh_packet_get_mux@333-336@usr.bin/ssh/packet.c","usr.bin/ssh/packet.c","ssh_packet_get_mux",333,336
16,4,88,3,16,"ssh_packet_set_log_preamble@339-355@usr.bin/ssh/packet.c","usr.bin/ssh/packet.c","ssh_packet_set_log_preamble",339,355
23,5,149,1,24,"ssh_packet_stop_discard@358-382@usr.bin/ssh/packet.c","usr.bin/ssh/packet.c","ssh_packet_stop_discard",358,382
19,9,137,5,23,"ssh_packet_start_discard@385-408@usr.bin/ssh/packet.c","usr.bin/ssh/packet.c","ssh_packet_start_discard",385,408
25,10,193,1,27,"ssh_packet_connection_is_on_socket@413-440@usr.bin/ssh/packet.c","usr.bin/ssh/packet.c","ssh_packet_connection_is_on_socket",413,440
7,3,47,3,6,"ssh_packet_get_bytes@443-449@usr.bin/ssh/packet.c","usr.bin/ssh/packet.c","ssh_packet_get_bytes",443,449
10,2,66,1,10,"ssh_packet_connection_af@452-462@usr.bin/ssh/packet.c","usr.bin/ssh/packet.c","ssh_packet_connection_af",452,462
6,2,41,1,7,"ssh_packet_set_nonblocking@467-474@usr.bin/ssh/packet.c","usr.bin/ssh/packet.c","ssh_packet_set_nonblocking",467,474
4,1,16,1,3,"ssh_packet_get_connection_in@479-482@usr.bin/ssh/packet.c","usr.bin/ssh/packet.c","ssh_packet_get_connection_in",479,482
4,1,16,1,3,"ssh_packet_get_connection_out@487-490@usr.bin/ssh/packet.c","usr.bin/ssh/packet.c","ssh_packet_get_connection_out",487,490
18,3,112,1,19,"ssh_remote_ipaddr@498-517@usr.bin/ssh/packet.c","usr.bin/ssh/packet.c","ssh_remote_ipaddr",498,517
5,1,22,1,4,"ssh_remote_port@522-526@usr.bin/ssh/packet.c","usr.bin/ssh/packet.c","ssh_remote_port",522,526
5,1,22,1,4,"ssh_local_ipaddr@534-538@usr.bin/ssh/packet.c","usr.bin/ssh/packet.c","ssh_local_ipaddr",534,538
5,1,22,1,4,"ssh_local_port@543-547@usr.bin/ssh/packet.c","usr.bin/ssh/packet.c","ssh_local_port",543,547
9,3,51,1,8,"ssh_packet_rdomain_in@551-559@usr.bin/ssh/packet.c","usr.bin/ssh/packet.c","ssh_packet_rdomain_in",551,559
59,14,371,2,60,"ssh_packet_close_internal@564-624@usr.bin/ssh/packet.c","usr.bin/ssh/packet.c","ssh_packet_close_internal",564,624
4,1,16,1,3,"ssh_packet_close@627-630@usr.bin/ssh/packet.c","usr.bin/ssh/packet.c","ssh_packet_close",627,630
4,1,16,1,3,"ssh_packet_clear_keys@633-636@usr.bin/ssh/packet.c","usr.bin/ssh/packet.c","ssh_packet_clear_keys",633,636
4,1,20,2,3,"ssh_packet_set_protocol_flags@641-644@usr.bin/ssh/packet.c","usr.bin/ssh/packet.c","ssh_packet_set_protocol_flags",641,644
4,1,16,1,3,"ssh_packet_get_protocol_flags@649-652@usr.bin/ssh/packet.c","usr.bin/ssh/packet.c","ssh_packet_get_protocol_flags",649,652
7,2,40,1,6,"ssh_packet_init_compression@660-666@usr.bin/ssh/packet.c","usr.bin/ssh/packet.c","ssh_packet_init_compression",660,666
18,6,95,2,17,"start_compression_out@669-686@usr.bin/ssh/packet.c","usr.bin/ssh/packet.c","start_compression_out",669,686
15,4,70,1,14,"start_compression_in@689-703@usr.bin/ssh/packet.c","usr.bin/ssh/packet.c","start_compression_in",689,703
12,5,77,2,12,"ssh_packet_start_compression@706-718@usr.bin/ssh/packet.c","usr.bin/ssh/packet.c","ssh_packet_start_compression",706,718
33,9,209,3,43,"compress_buffer@722-765@usr.bin/ssh/packet.c","usr.bin/ssh/packet.c","compress_buffer",722,765
34,10,197,3,44,"uncompress_buffer@768-812@usr.bin/ssh/packet.c","usr.bin/ssh/packet.c","uncompress_buffer",768,812
7,3,52,2,6,"ssh_clear_newkeys@815-821@usr.bin/ssh/packet.c","usr.bin/ssh/packet.c","ssh_clear_newkeys",815,821
80,18,599,2,92,"ssh_set_newkeys@824-916@usr.bin/ssh/packet.c","usr.bin/ssh/packet.c","ssh_set_newkeys",824,916
25,14,186,2,44,"ssh_packet_need_rekeying@920-964@usr.bin/ssh/packet.c","usr.bin/ssh/packet.c","ssh_packet_need_rekeying",920,964
25,10,163,1,30,"ssh_packet_enable_delayed_compress@972-1002@usr.bin/ssh/packet.c","usr.bin/ssh/packet.c","ssh_packet_enable_delayed_compress",972,1002
11,4,30,1,10,"ssh_packet_log_type@1006-1016@usr.bin/ssh/packet.c","usr.bin/ssh/packet.c","ssh_packet_log_type",1006,1016
126,43,965,1,155,"ssh_packet_send2_wrapped@1022-1177@usr.bin/ssh/packet.c","usr.bin/ssh/packet.c","ssh_packet_send2_wrapped",1022,1177
9,5,28,1,8,"ssh_packet_type_is_kex@1181-1189@usr.bin/ssh/packet.c","usr.bin/ssh/packet.c","ssh_packet_type_is_kex",1181,1189
56,16,367,1,76,"ssh_packet_send2@1192-1268@usr.bin/ssh/packet.c","usr.bin/ssh/packet.c","ssh_packet_send2",1192,1268
65,18,392,3,84,"ssh_packet_read_seqnr@1277-1361@usr.bin/ssh/packet.c","usr.bin/ssh/packet.c","ssh_packet_read_seqnr",1277,1361
8,2,48,1,8,"ssh_packet_read@1364-1372@usr.bin/ssh/packet.c","usr.bin/ssh/packet.c","ssh_packet_read",1364,1372
15,4,75,2,15,"ssh_packet_read_expect@1380-1395@usr.bin/ssh/packet.c","usr.bin/ssh/packet.c","ssh_packet_read_expect",1380,1395
33,12,241,3,35,"ssh_packet_read_poll2_mux@1398-1433@usr.bin/ssh/packet.c","usr.bin/ssh/packet.c","ssh_packet_read_poll2_mux",1398,1433
183,70,1463,3,229,"ssh_packet_read_poll2@1436-1665@usr.bin/ssh/packet.c","usr.bin/ssh/packet.c","ssh_packet_read_poll2",1436,1665
52,16,299,3,53,"ssh_packet_read_poll_seqnr@1668-1721@usr.bin/ssh/packet.c","usr.bin/ssh/packet.c","ssh_packet_read_poll_seqnr",1668,1721
17,5,105,3,18,"ssh_packet_process_incoming@1729-1747@usr.bin/ssh/packet.c","usr.bin/ssh/packet.c","ssh_packet_process_incoming",1729,1747
4,1,19,1,3,"ssh_packet_remaining@1750-1753@usr.bin/ssh/packet.c","usr.bin/ssh/packet.c","ssh_packet_remaining",1750,1753
19,8,161,3,22,"ssh_packet_send_debug@1764-1786@usr.bin/ssh/packet.c","usr.bin/ssh/packet.c","ssh_packet_send_debug",1764,1786
7,3,53,3,6,"fmt_connection_id@1789-1795@usr.bin/ssh/packet.c","usr.bin/ssh/packet.c","fmt_connection_id",1789,1795
39,18,219,3,42,"sshpkt_fatal@1801-1843@usr.bin/ssh/packet.c","usr.bin/ssh/packet.c","sshpkt_fatal",1801,1843
21,4,157,3,36,"ssh_packet_disconnect@1852-1888@usr.bin/ssh/packet.c","usr.bin/ssh/packet.c","ssh_packet_disconnect",1852,1888
20,7,114,1,20,"ssh_packet_write_poll@1895-1915@usr.bin/ssh/packet.c","usr.bin/ssh/packet.c","ssh_packet_write_poll",1895,1915
52,14,309,1,53,"ssh_packet_write_wait@1922-1975@usr.bin/ssh/packet.c","usr.bin/ssh/packet.c","ssh_packet_write_wait",1922,1975
4,1,21,1,3,"ssh_packet_have_data_to_write@1980-1983@usr.bin/ssh/packet.c","usr.bin/ssh/packet.c","ssh_packet_have_data_to_write",1980,1983
7,2,44,1,6,"ssh_packet_not_very_much_data_to_write@1988-1994@usr.bin/ssh/packet.c","usr.bin/ssh/packet.c","ssh_packet_not_very_much_data_to_write",1988,1994
21,7,137,2,20,"ssh_packet_set_tos@1997-2017@usr.bin/ssh/packet.c","usr.bin/ssh/packet.c","ssh_packet_set_tos",1997,2017
13,4,75,4,17,"ssh_packet_set_interactive@2022-2039@usr.bin/ssh/packet.c","usr.bin/ssh/packet.c","ssh_packet_set_interactive",2022,2039
4,1,16,1,3,"ssh_packet_is_interactive@2044-2047@usr.bin/ssh/packet.c","usr.bin/ssh/packet.c","ssh_packet_is_interactive",2044,2047
17,4,93,2,17,"ssh_packet_set_maxsize@2050-2067@usr.bin/ssh/packet.c","usr.bin/ssh/packet.c","ssh_packet_set_maxsize",2050,2067
4,1,17,1,3,"ssh_packet_inc_alive_timeouts@2070-2073@usr.bin/ssh/packet.c","usr.bin/ssh/packet.c","ssh_packet_inc_alive_timeouts",2070,2073
4,1,20,2,3,"ssh_packet_set_alive_timeouts@2076-2079@usr.bin/ssh/packet.c","usr.bin/ssh/packet.c","ssh_packet_set_alive_timeouts",2076,2079
4,1,16,1,3,"ssh_packet_get_maxsize@2082-2085@usr.bin/ssh/packet.c","usr.bin/ssh/packet.c","ssh_packet_get_maxsize",2082,2085
7,1,49,3,6,"ssh_packet_set_rekey_limits@2088-2094@usr.bin/ssh/packet.c","usr.bin/ssh/packet.c","ssh_packet_set_rekey_limits",2088,2094
7,2,41,1,7,"ssh_packet_get_rekey_timeout@2097-2104@usr.bin/ssh/packet.c","usr.bin/ssh/packet.c","ssh_packet_get_rekey_timeout",2097,2104
4,1,17,1,3,"ssh_packet_set_server@2107-2110@usr.bin/ssh/packet.c","usr.bin/ssh/packet.c","ssh_packet_set_server",2107,2110
4,1,17,1,3,"ssh_packet_set_authenticated@2113-2116@usr.bin/ssh/packet.c","usr.bin/ssh/packet.c","ssh_packet_set_authenticated",2113,2116
4,1,20,1,3,"ssh_packet_get_input@2119-2122@usr.bin/ssh/packet.c","usr.bin/ssh/packet.c","ssh_packet_get_input",2119,2122
4,1,20,1,3,"ssh_packet_get_output@2125-2128@usr.bin/ssh/packet.c","usr.bin/ssh/packet.c","ssh_packet_get_output",2125,2128
10,2,54,1,11,"ssh_packet_set_postauth@2132-2143@usr.bin/ssh/packet.c","usr.bin/ssh/packet.c","ssh_packet_set_postauth",2132,2143
16,10,164,2,16,"kex_to_blob@2149-2165@usr.bin/ssh/packet.c","usr.bin/ssh/packet.c","kex_to_blob",2149,2165
40,16,359,3,40,"newkeys_to_blob@2169-2209@usr.bin/ssh/packet.c","usr.bin/ssh/packet.c","newkeys_to_blob",2169,2209
22,16,275,2,23,"ssh_packet_get_state@2213-2236@usr.bin/ssh/packet.c","usr.bin/ssh/packet.c","ssh_packet_get_state",2213,2236
60,19,480,3,63,"newkeys_from_blob@2240-2303@usr.bin/ssh/packet.c","usr.bin/ssh/packet.c","newkeys_from_blob",2240,2303
37,17,313,2,37,"kex_from_blob@2307-2344@usr.bin/ssh/packet.c","usr.bin/ssh/packet.c","kex_from_blob",2307,2344
38,22,428,2,46,"ssh_packet_set_state@2351-2397@usr.bin/ssh/packet.c","usr.bin/ssh/packet.c","ssh_packet_set_state",2351,2397
4,1,31,3,3,"sshpkt_put@2404-2407@usr.bin/ssh/packet.c","usr.bin/ssh/packet.c","sshpkt_put",2404,2407
4,1,27,2,3,"sshpkt_putb@2410-2413@usr.bin/ssh/packet.c","usr.bin/ssh/packet.c","sshpkt_putb",2410,2413
4,1,24,2,3,"sshpkt_put_u8@2416-2419@usr.bin/ssh/packet.c","usr.bin/ssh/packet.c","sshpkt_put_u8",2416,2419
4,1,24,2,3,"sshpkt_put_u32@2422-2425@usr.bin/ssh/packet.c","usr.bin/ssh/packet.c","sshpkt_put_u32",2422,2425
4,1,24,2,3,"sshpkt_put_u64@2428-2431@usr.bin/ssh/packet.c","usr.bin/ssh/packet.c","sshpkt_put_u64",2428,2431
4,1,31,3,3,"sshpkt_put_string@2434-2437@usr.bin/ssh/packet.c","usr.bin/ssh/packet.c","sshpkt_put_string",2434,2437
4,1,26,2,3,"sshpkt_put_cstring@2440-2443@usr.bin/ssh/packet.c","usr.bin/ssh/packet.c","sshpkt_put_cstring",2440,2443
4,1,27,2,3,"sshpkt_put_stringb@2446-2449@usr.bin/ssh/packet.c","usr.bin/ssh/packet.c","sshpkt_put_stringb",2446,2449
4,1,33,3,3,"sshpkt_put_ec@2453-2456@usr.bin/ssh/packet.c","usr.bin/ssh/packet.c","sshpkt_put_ec",2453,2456
4,1,26,2,3,"sshpkt_put_bignum2@2460-2463@usr.bin/ssh/packet.c","usr.bin/ssh/packet.c","sshpkt_put_bignum2",2460,2463
4,1,30,3,3,"sshpkt_get@2469-2472@usr.bin/ssh/packet.c","usr.bin/ssh/packet.c","sshpkt_get",2469,2472
4,1,25,2,3,"sshpkt_get_u8@2475-2478@usr.bin/ssh/packet.c","usr.bin/ssh/packet.c","sshpkt_get_u8",2475,2478
4,1,25,2,3,"sshpkt_get_u32@2481-2484@usr.bin/ssh/packet.c","usr.bin/ssh/packet.c","sshpkt_get_u32",2481,2484
4,1,25,2,3,"sshpkt_get_u64@2487-2490@usr.bin/ssh/packet.c","usr.bin/ssh/packet.c","sshpkt_get_u64",2487,2490
4,1,31,3,3,"sshpkt_get_string@2493-2496@usr.bin/ssh/packet.c","usr.bin/ssh/packet.c","sshpkt_get_string",2493,2496
4,1,32,3,3,"sshpkt_get_string_direct@2499-2502@usr.bin/ssh/packet.c","usr.bin/ssh/packet.c","sshpkt_get_string_direct",2499,2502
4,1,32,3,3,"sshpkt_peek_string_direct@2505-2508@usr.bin/ssh/packet.c","usr.bin/ssh/packet.c","sshpkt_peek_string_direct",2505,2508
4,1,31,3,3,"sshpkt_get_cstring@2511-2514@usr.bin/ssh/packet.c","usr.bin/ssh/packet.c","sshpkt_get_cstring",2511,2514
4,1,32,3,3,"sshpkt_get_ec@2518-2521@usr.bin/ssh/packet.c","usr.bin/ssh/packet.c","sshpkt_get_ec",2518,2521
4,1,25,2,3,"sshpkt_get_bignum2@2525-2528@usr.bin/ssh/packet.c","usr.bin/ssh/packet.c","sshpkt_get_bignum2",2525,2528
6,2,28,1,5,"sshpkt_get_end@2532-2537@usr.bin/ssh/packet.c","usr.bin/ssh/packet.c","sshpkt_get_end",2532,2537
6,2,41,2,5,"sshpkt_ptr@2540-2545@usr.bin/ssh/packet.c","usr.bin/ssh/packet.c","sshpkt_ptr",2540,2545
9,1,78,2,9,"sshpkt_start@2550-2559@usr.bin/ssh/packet.c","usr.bin/ssh/packet.c","sshpkt_start",2550,2559
25,7,142,1,27,"ssh_packet_send_mux@2562-2589@usr.bin/ssh/packet.c","usr.bin/ssh/packet.c","ssh_packet_send_mux",2562,2589
17,6,114,2,17,"sshpkt_msg_ignore@2603-2620@usr.bin/ssh/packet.c","usr.bin/ssh/packet.c","sshpkt_msg_ignore",2603,2620
6,3,33,1,5,"sshpkt_send@2625-2630@usr.bin/ssh/packet.c","usr.bin/ssh/packet.c","sshpkt_send",2625,2630
16,6,125,3,17,"sshpkt_disconnect@2633-2650@usr.bin/ssh/packet.c","usr.bin/ssh/packet.c","sshpkt_disconnect",2633,2650
5,1,23,2,4,"sshpkt_add_padding@2654-2658@usr.bin/ssh/packet.c","usr.bin/ssh/packet.c","sshpkt_add_padding",2654,2658
101,6,1431,4,126,"poly1305_auth@30-156@usr.bin/ssh/poly1305.c","usr.bin/ssh/poly1305.c","poly1305_auth",30,156
4,1,18,1,3,"can_output@80-83@usr.bin/ssh/progressmeter.c","usr.bin/ssh/progressmeter.c","can_output",80,83
16,5,120,3,16,"format_rate@86-102@usr.bin/ssh/progressmeter.c","usr.bin/ssh/progressmeter.c","format_rate",86,102
10,4,73,3,10,"format_size@105-115@usr.bin/ssh/progressmeter.c","usr.bin/ssh/progressmeter.c","format_size",105,115
86,18,540,1,107,"refresh_progress_meter@118-225@usr.bin/ssh/progressmeter.c","usr.bin/ssh/progressmeter.c","refresh_progress_meter",118,225
14,3,54,1,16,"update_progress_meter@229-245@usr.bin/ssh/progressmeter.c","usr.bin/ssh/progressmeter.c","update_progress_meter",229,245
17,2,86,3,18,"start_progress_meter@248-266@usr.bin/ssh/progressmeter.c","usr.bin/ssh/progressmeter.c","start_progress_meter",248,266
9,3,41,1,12,"stop_progress_meter@269-281@usr.bin/ssh/progressmeter.c","usr.bin/ssh/progressmeter.c","stop_progress_meter",269,281
4,1,11,1,3,"sig_winch@285-288@usr.bin/ssh/progressmeter.c","usr.bin/ssh/progressmeter.c","sig_winch",285,288
13,4,61,1,13,"setscreensize@291-304@usr.bin/ssh/progressmeter.c","usr.bin/ssh/progressmeter.c","setscreensize",291,304
23,5,167,2,25,"add_local_forward@303-328@usr.bin/ssh/readconf.c","usr.bin/ssh/readconf.c","add_local_forward",303,328
21,3,154,2,23,"add_remote_forward@336-359@usr.bin/ssh/readconf.c","usr.bin/ssh/readconf.c","add_remote_forward",336,359
27,5,205,1,27,"clear_forwardings@362-389@usr.bin/ssh/readconf.c","usr.bin/ssh/readconf.c","clear_forwardings",362,389
18,5,115,3,21,"add_certificate_file@392-413@usr.bin/ssh/readconf.c","usr.bin/ssh/readconf.c","add_certificate_file",392,413
24,7,163,4,28,"add_identity_file@416-444@usr.bin/ssh/readconf.c","usr.bin/ssh/readconf.c","add_identity_file",416,444
10,3,48,1,10,"default_ssh_port@447-457@usr.bin/ssh/readconf.c","usr.bin/ssh/readconf.c","default_ssh_port",447,457
45,12,336,1,60,"execute_in_shell@464-524@usr.bin/ssh/readconf.c","usr.bin/ssh/readconf.c","execute_in_shell",464,524
128,42,934,8,139,"match_cfg_line@530-669@usr.bin/ssh/readconf.c","usr.bin/ssh/readconf.c","match_cfg_line",530,669
14,5,99,4,14,"parse_token@675-689@usr.bin/ssh/readconf.c","usr.bin/ssh/readconf.c","parse_token",675,689
7,1,66,9,6,"process_config_line@778-784@usr.bin/ssh/readconf.c","usr.bin/ssh/readconf.c","process_config_line",778,784
742,294,4380,10,865,"process_config_line_depth@788-1653@usr.bin/ssh/readconf.c","usr.bin/ssh/readconf.c","process_config_line_depth",788,1653
7,1,57,6,7,"read_config_file@1661-1668@usr.bin/ssh/readconf.c","usr.bin/ssh/readconf.c","read_config_file",1661,1668
36,13,272,8,46,"read_config_file_depth@1672-1718@usr.bin/ssh/readconf.c","usr.bin/ssh/readconf.c","read_config_file_depth",1672,1718
4,2,23,1,3,"option_clear_or_none@1722-1725@usr.bin/ssh/readconf.c","usr.bin/ssh/readconf.c","option_clear_or_none",1722,1725
99,1,655,1,98,"initialize_options@1735-1833@usr.bin/ssh/readconf.c","usr.bin/ssh/readconf.c","initialize_options",1735,1833
9,4,53,1,8,"fill_default_options_for_canonicalization@1840-1848@usr.bin/ssh/readconf.c","usr.bin/ssh/readconf.c","fill_default_options_for_canonicalization",1840,1848
153,68,1135,1,171,"fill_default_options@1855-2026@usr.bin/ssh/readconf.c","usr.bin/ssh/readconf.c","fill_default_options",1855,2026
44,15,261,2,53,"parse_fwd_field@2041-2094@usr.bin/ssh/readconf.c","usr.bin/ssh/readconf.c","parse_fwd_field",2041,2094
112,37,859,4,128,"parse_forward@2107-2235@usr.bin/ssh/readconf.c","usr.bin/ssh/readconf.c","parse_forward",2107,2235
42,12,300,3,47,"parse_jump@2238-2285@usr.bin/ssh/readconf.c","usr.bin/ssh/readconf.c","parse_jump",2238,2285
9,3,64,4,9,"parse_ssh_uri@2288-2297@usr.bin/ssh/readconf.c","usr.bin/ssh/readconf.c","parse_ssh_uri",2288,2297
9,3,58,2,9,"fmt_multistate_int@2301-2310@usr.bin/ssh/readconf.c","usr.bin/ssh/readconf.c","fmt_multistate_int",2301,2310
33,13,140,2,32,"fmt_intarg@2313-2345@usr.bin/ssh/readconf.c","usr.bin/ssh/readconf.c","fmt_intarg",2313,2345
8,3,52,1,8,"lookup_opcode_name@2348-2356@usr.bin/ssh/readconf.c","usr.bin/ssh/readconf.c","lookup_opcode_name",2348,2356
4,1,22,2,3,"dump_cfg_int@2359-2362@usr.bin/ssh/readconf.c","usr.bin/ssh/readconf.c","dump_cfg_int",2359,2362
4,1,27,2,3,"dump_cfg_fmtint@2365-2368@usr.bin/ssh/readconf.c","usr.bin/ssh/readconf.c","dump_cfg_fmtint",2365,2368
6,2,32,2,5,"dump_cfg_string@2371-2376@usr.bin/ssh/readconf.c","usr.bin/ssh/readconf.c","dump_cfg_string",2371,2376
6,2,45,3,6,"dump_cfg_strarray@2379-2385@usr.bin/ssh/readconf.c","usr.bin/ssh/readconf.c","dump_cfg_strarray",2379,2385
8,2,55,3,8,"dump_cfg_strarray_oneline@2388-2396@usr.bin/ssh/readconf.c","usr.bin/ssh/readconf.c","dump_cfg_strarray_oneline",2388,2396
34,13,223,3,35,"dump_cfg_forwards@2399-2434@usr.bin/ssh/readconf.c","usr.bin/ssh/readconf.c","dump_cfg_forwards",2399,2434
133,25,1149,2,177,"dump_client_config@2437-2614@usr.bin/ssh/readconf.c","usr.bin/ssh/readconf.c","dump_client_config",2437,2614
55,16,412,2,59,"ssh_askpass@48-107@usr.bin/ssh/readpass.c","usr.bin/ssh/readpass.c","ssh_askpass",48,107
44,16,276,2,48,"read_passphrase@116-164@usr.bin/ssh/readpass.c","usr.bin/ssh/readpass.c","read_passphrase",116,164
17,5,108,2,23,"ask_permission@167-190@usr.bin/ssh/readpass.c","usr.bin/ssh/readpass.c","ask_permission",167,190
79,10,745,3,79,"rijndaelKeySetupEnc@627-706@usr.bin/ssh/rijndael.c","usr.bin/ssh/rijndael.c","rijndaelKeySetupEnc",627,706
36,3,527,3,40,"rijndaelKeySetupDec@715-755@usr.bin/ssh/rijndael.c","usr.bin/ssh/rijndael.c","rijndaelKeySetupDec",715,755
150,6,3242,4,181,"rijndaelEncrypt@759-940@usr.bin/ssh/rijndael.c","usr.bin/ssh/rijndael.c","rijndaelEncrypt",759,940
150,6,3246,4,181,"rijndaelDecrypt@944-1125@usr.bin/ssh/rijndael.c","usr.bin/ssh/rijndael.c","rijndaelDecrypt",944,1125
8,1,40,1,9,"ssh_sandbox_init@41-50@usr.bin/ssh/sandbox-pledge.c","usr.bin/ssh/sandbox-pledge.c","ssh_sandbox_init",41,50
5,2,28,1,4,"ssh_sandbox_child@53-57@usr.bin/ssh/sandbox-pledge.c","usr.bin/ssh/sandbox-pledge.c","ssh_sandbox_child",53,57
5,1,21,1,4,"ssh_sandbox_parent_finish@60-64@usr.bin/ssh/sandbox-pledge.c","usr.bin/ssh/sandbox-pledge.c","ssh_sandbox_parent_finish",60,64
4,1,18,2,4,"ssh_sandbox_parent_preauth@67-71@usr.bin/ssh/sandbox-pledge.c","usr.bin/ssh/sandbox-pledge.c","ssh_sandbox_parent_preauth",67,71
8,1,40,1,13,"ssh_sandbox_init@40-53@usr.bin/ssh/sandbox-rlimit.c","usr.bin/ssh/sandbox-rlimit.c","ssh_sandbox_init",40,53
14,4,98,1,15,"ssh_sandbox_child@56-71@usr.bin/ssh/sandbox-rlimit.c","usr.bin/ssh/sandbox-rlimit.c","ssh_sandbox_child",56,71
5,1,21,1,4,"ssh_sandbox_parent_finish@74-78@usr.bin/ssh/sandbox-rlimit.c","usr.bin/ssh/sandbox-rlimit.c","ssh_sandbox_parent_finish",74,78
4,1,18,2,4,"ssh_sandbox_parent_preauth@81-85@usr.bin/ssh/sandbox-rlimit.c","usr.bin/ssh/sandbox-rlimit.c","ssh_sandbox_parent_preauth",81,85
7,1,32,2,6,"lt@19-25@usr.bin/ssh/sc25519.c","usr.bin/ssh/sc25519.c","lt",19,25
18,3,132,1,18,"reduce_add_sub@28-46@usr.bin/ssh/sc25519.c","usr.bin/ssh/sc25519.c","reduce_add_sub",28,46
39,12,368,2,49,"barrett_reduce@49-98@usr.bin/ssh/sc25519.c","usr.bin/ssh/sc25519.c","barrett_reduce",49,98
8,3,75,2,7,"sc25519_from32bytes@100-107@usr.bin/ssh/sc25519.c","usr.bin/ssh/sc25519.c","sc25519_from32bytes",100,107
5,2,44,2,4,"shortsc25519_from16bytes@109-113@usr.bin/ssh/sc25519.c","usr.bin/ssh/sc25519.c","shortsc25519_from16bytes",109,113
7,2,55,2,6,"sc25519_from64bytes@115-121@usr.bin/ssh/sc25519.c","usr.bin/ssh/sc25519.c","sc25519_from64bytes",115,121
8,3,67,2,7,"sc25519_from_shortsc@123-130@usr.bin/ssh/sc25519.c","usr.bin/ssh/sc25519.c","sc25519_from_shortsc",123,130
5,2,44,2,4,"sc25519_to32bytes@132-136@usr.bin/ssh/sc25519.c","usr.bin/ssh/sc25519.c","sc25519_to32bytes",132,136
7,3,42,1,6,"sc25519_iszero_vartime@138-144@usr.bin/ssh/sc25519.c","usr.bin/ssh/sc25519.c","sc25519_iszero_vartime",138,144
7,3,42,1,6,"sc25519_isshort_vartime@146-152@usr.bin/ssh/sc25519.c","usr.bin/ssh/sc25519.c","sc25519_isshort_vartime",146,152
10,4,73,2,9,"sc25519_lt_vartime@154-163@usr.bin/ssh/sc25519.c","usr.bin/ssh/sc25519.c","sc25519_lt_vartime",154,163
12,3,109,3,11,"sc25519_add@165-176@usr.bin/ssh/sc25519.c","usr.bin/ssh/sc25519.c","sc25519_add",165,176
12,2,84,3,11,"sc25519_sub_nored@178-189@usr.bin/ssh/sc25519.c","usr.bin/ssh/sc25519.c","sc25519_sub_nored",178,189
16,5,146,3,19,"sc25519_mul@191-210@usr.bin/ssh/sc25519.c","usr.bin/ssh/sc25519.c","sc25519_mul",191,210
6,1,39,3,5,"sc25519_mul_shortsc@212-217@usr.bin/ssh/sc25519.c","usr.bin/ssh/sc25519.c","sc25519_mul_shortsc",212,217
34,3,534,2,35,"sc25519_window3@219-254@usr.bin/ssh/sc25519.c","usr.bin/ssh/sc25519.c","sc25519_window3",219,254
34,3,534,2,35,"sc25519_window5@256-291@usr.bin/ssh/sc25519.c","usr.bin/ssh/sc25519.c","sc25519_window5",256,291
14,2,327,3,13,"sc25519_2interleave2@293-306@usr.bin/ssh/sc25519.c","usr.bin/ssh/sc25519.c","sc25519_2interleave2",293,306
10,4,49,1,10,"killchild@145-155@usr.bin/ssh/scp.c","usr.bin/ssh/scp.c","killchild",145,155
11,4,54,1,11,"suspchild@158-169@usr.bin/ssh/scp.c","usr.bin/ssh/scp.c","suspchild",158,169
32,10,226,1,39,"do_local_cmd@172-211@usr.bin/ssh/scp.c","usr.bin/ssh/scp.c","do_local_cmd",172,211
56,11,425,6,73,"do_cmd@220-293@usr.bin/ssh/scp.c","usr.bin/ssh/scp.c","do_cmd",220,293
38,10,259,6,43,"do_cmd2@301-344@usr.bin/ssh/scp.c","usr.bin/ssh/scp.c","do_cmd2",301,344
154,47,880,2,180,"main@374-554@usr.bin/ssh/scp.c","usr.bin/ssh/scp.c","main",374,554
8,2,43,2,8,"scpio@558-566@usr.bin/ssh/scp.c","usr.bin/ssh/scp.c","scpio",558,566
14,4,147,3,15,"do_times@569-584@usr.bin/ssh/scp.c","usr.bin/ssh/scp.c","do_times",569,584
100,30,750,2,107,"toremote@587-694@usr.bin/ssh/scp.c","usr.bin/ssh/scp.c","toremote",587,694
52,12,370,2,54,"tolocal@697-751@usr.bin/ssh/scp.c","usr.bin/ssh/scp.c","tolocal",697,751
105,30,707,2,109,"source@754-863@usr.bin/ssh/scp.c","usr.bin/ssh/scp.c","source",754,863
46,12,340,2,46,"rsource@866-912@usr.bin/ssh/scp.c","usr.bin/ssh/scp.c","rsource",866,912
271,96,1801,2,294,"sink@920-1214@usr.bin/ssh/scp.c","usr.bin/ssh/scp.c","sink",920,1214
31,10,210,1,35,"response@1217-1252@usr.bin/ssh/scp.c","usr.bin/ssh/scp.c","response",1217,1252
7,1,22,1,6,"usage@1255-1261@usr.bin/ssh/scp.c","usr.bin/ssh/scp.c","usage",1255,1261
21,4,147,2,22,"run_err@1264-1286@usr.bin/ssh/scp.c","usr.bin/ssh/scp.c","run_err",1264,1286
11,3,57,1,11,"verifydir@1289-1300@usr.bin/ssh/scp.c","usr.bin/ssh/scp.c","verifydir",1289,1300
26,10,115,1,27,"okname@1303-1330@usr.bin/ssh/scp.c","usr.bin/ssh/scp.c","okname",1303,1330
17,4,114,3,17,"allocbuf@1333-1350@usr.bin/ssh/scp.c","usr.bin/ssh/scp.c","allocbuf",1333,1350
9,3,39,1,8,"lostconn@1353-1361@usr.bin/ssh/scp.c","usr.bin/ssh/scp.c","lostconn",1353,1361
95,1,627,1,94,"initialize_server_options@70-164@usr.bin/ssh/servconf.c","usr.bin/ssh/servconf.c","initialize_server_options",70,164
4,2,23,1,3,"option_clear_or_none@168-171@usr.bin/ssh/servconf.c","usr.bin/ssh/servconf.c","option_clear_or_none",168,171
12,7,87,1,11,"assemble_algorithms@174-185@usr.bin/ssh/servconf.c","usr.bin/ssh/servconf.c","assemble_algorithms",174,185
9,2,93,6,10,"array_append@188-198@usr.bin/ssh/servconf.c","usr.bin/ssh/servconf.c","array_append",188,198
8,1,57,4,8,"servconf_add_hostkey@201-209@usr.bin/ssh/servconf.c","usr.bin/ssh/servconf.c","servconf_add_hostkey",201,209
8,1,57,4,8,"servconf_add_hostcert@212-220@usr.bin/ssh/servconf.c","usr.bin/ssh/servconf.c","servconf_add_hostcert",212,220
164,67,1207,1,181,"fill_default_server_options@223-404@usr.bin/ssh/servconf.c","usr.bin/ssh/servconf.c","fill_default_server_options",223,404
13,3,90,4,14,"parse_token@589-603@usr.bin/ssh/servconf.c","usr.bin/ssh/servconf.c","parse_token",589,603
14,4,105,1,14,"derelativise_path@606-620@usr.bin/ssh/servconf.c","usr.bin/ssh/servconf.c","derelativise_path",606,620
13,3,77,4,13,"add_listen_addr@623-636@usr.bin/ssh/servconf.c","usr.bin/ssh/servconf.c","add_listen_addr",623,636
39,14,328,4,43,"add_one_listen_addr@639-682@usr.bin/ssh/servconf.c","usr.bin/ssh/servconf.c","add_one_listen_addr",639,682
21,4,139,1,25,"valid_rdomain@686-711@usr.bin/ssh/servconf.c","usr.bin/ssh/servconf.c","valid_rdomain",686,711
13,2,98,4,13,"queue_listen_addr@718-731@usr.bin/ssh/servconf.c","usr.bin/ssh/servconf.c","queue_listen_addr",718,731
18,4,128,1,19,"process_queued_listen_addrs@737-756@usr.bin/ssh/servconf.c","usr.bin/ssh/servconf.c","process_queued_listen_addrs",737,756
28,10,198,2,32,"process_permitopen@762-794@usr.bin/ssh/servconf.c","usr.bin/ssh/servconf.c","process_permitopen",762,794
13,2,82,2,13,"get_connection_info@797-810@usr.bin/ssh/servconf.c","usr.bin/ssh/servconf.c","get_connection_info",797,810
24,5,139,3,25,"match_cfg_line_group@846-871@usr.bin/ssh/servconf.c","usr.bin/ssh/servconf.c","match_cfg_line_group",846,871
5,1,24,2,4,"match_test_missing_fatal@874-878@usr.bin/ssh/servconf.c","usr.bin/ssh/servconf.c","match_test_missing_fatal",874,878
147,53,855,3,149,"match_cfg_line@886-1035@usr.bin/ssh/servconf.c","usr.bin/ssh/servconf.c","match_cfg_line",886,1035
794,332,4824,6,904,"process_server_config_line@1085-1989@usr.bin/ssh/servconf.c","usr.bin/ssh/servconf.c","process_server_config_line",1085,1989
24,5,187,2,30,"load_server_config@1994-2024@usr.bin/ssh/servconf.c","usr.bin/ssh/servconf.c","load_server_config",1994,2024
8,1,45,2,8,"parse_server_match_config@2027-2035@usr.bin/ssh/servconf.c","usr.bin/ssh/servconf.c","parse_server_match_config",2027,2035
29,10,247,2,29,"parse_server_match_testspec@2037-2066@usr.bin/ssh/servconf.c","usr.bin/ssh/servconf.c","parse_server_match_testspec",2037,2066
52,5,275,3,94,"copy_set_server_options@2076-2170@usr.bin/ssh/servconf.c","usr.bin/ssh/servconf.c","copy_set_server_options",2076,2170
21,6,156,4,22,"parse_server_config@2177-2199@usr.bin/ssh/servconf.c","usr.bin/ssh/servconf.c","parse_server_config",2177,2199
9,3,58,2,9,"fmt_multistate_int@2202-2211@usr.bin/ssh/servconf.c","usr.bin/ssh/servconf.c","fmt_multistate_int",2202,2211
30,11,126,2,29,"fmt_intarg@2214-2243@usr.bin/ssh/servconf.c","usr.bin/ssh/servconf.c","fmt_intarg",2214,2243
8,3,52,1,8,"lookup_opcode_name@2246-2254@usr.bin/ssh/servconf.c","usr.bin/ssh/servconf.c","lookup_opcode_name",2246,2254
4,1,22,2,3,"dump_cfg_int@2257-2260@usr.bin/ssh/servconf.c","usr.bin/ssh/servconf.c","dump_cfg_int",2257,2260
4,1,22,2,3,"dump_cfg_oct@2263-2266@usr.bin/ssh/servconf.c","usr.bin/ssh/servconf.c","dump_cfg_oct",2263,2266
4,1,27,2,3,"dump_cfg_fmtint@2269-2272@usr.bin/ssh/servconf.c","usr.bin/ssh/servconf.c","dump_cfg_fmtint",2269,2272
5,2,30,2,4,"dump_cfg_string@2275-2279@usr.bin/ssh/servconf.c","usr.bin/ssh/servconf.c","dump_cfg_string",2275,2279
6,2,45,3,6,"dump_cfg_strarray@2282-2288@usr.bin/ssh/servconf.c","usr.bin/ssh/servconf.c","dump_cfg_strarray",2282,2288
12,6,82,3,12,"dump_cfg_strarray_oneline@2291-2303@usr.bin/ssh/servconf.c","usr.bin/ssh/servconf.c","dump_cfg_strarray_oneline",2291,2303
31,8,208,1,36,"format_listen_addrs@2306-2342@usr.bin/ssh/servconf.c","usr.bin/ssh/servconf.c","format_listen_addrs",2306,2342
125,17,1056,1,148,"dump_config@2345-2493@usr.bin/ssh/servconf.c","usr.bin/ssh/servconf.c","dump_config",2345,2493
17,4,129,1,16,"notify_setup@107-123@usr.bin/ssh/serverloop.c","usr.bin/ssh/serverloop.c","notify_setup",107,123
5,2,31,1,4,"notify_parent@125-129@usr.bin/ssh/serverloop.c","usr.bin/ssh/serverloop.c","notify_parent",125,129
5,2,28,1,4,"notify_prepare@131-135@usr.bin/ssh/serverloop.c","usr.bin/ssh/serverloop.c","notify_prepare",131,135
7,4,54,1,7,"notify_done@137-144@usr.bin/ssh/serverloop.c","usr.bin/ssh/serverloop.c","notify_done",137,144
8,1,31,1,7,"sigchld_handler@148-155@usr.bin/ssh/serverloop.c","usr.bin/ssh/serverloop.c","sigchld_handler",148,155
4,1,11,1,3,"sigterm_handler@159-162@usr.bin/ssh/serverloop.c","usr.bin/ssh/serverloop.c","sigterm_handler",159,162
17,3,83,1,23,"client_alive_check@165-188@usr.bin/ssh/serverloop.c","usr.bin/ssh/serverloop.c","client_alive_check",165,188
56,20,369,8,89,"wait_until_can_do_something@197-286@usr.bin/ssh/serverloop.c","usr.bin/ssh/serverloop.c","wait_until_can_do_something",197,286
24,6,137,3,26,"process_input@293-319@usr.bin/ssh/serverloop.c","usr.bin/ssh/serverloop.c","process_input",293,319
5,2,24,2,5,"process_output@325-330@usr.bin/ssh/serverloop.c","usr.bin/ssh/serverloop.c","process_output",325,330
4,1,18,1,3,"process_buffered_input_packets@333-336@usr.bin/ssh/serverloop.c","usr.bin/ssh/serverloop.c","process_buffered_input_packets",333,336
18,6,114,1,19,"collect_children@339-358@usr.bin/ssh/serverloop.c","usr.bin/ssh/serverloop.c","collect_children",339,358
48,10,297,2,64,"server_loop2@361-425@usr.bin/ssh/serverloop.c","usr.bin/ssh/serverloop.c","server_loop2",361,425
6,1,32,3,10,"server_input_keep_alive@428-438@usr.bin/ssh/serverloop.c","usr.bin/ssh/serverloop.c","server_input_keep_alive",428,438
27,5,162,3,32,"server_request_direct_tcpip@441-473@usr.bin/ssh/serverloop.c","usr.bin/ssh/serverloop.c","server_request_direct_tcpip",441,473
28,8,158,1,34,"server_request_direct_streamlocal@476-510@usr.bin/ssh/serverloop.c","usr.bin/ssh/serverloop.c","server_request_direct_streamlocal",476,510
45,11,235,1,54,"server_request_tun@513-567@usr.bin/ssh/serverloop.c","usr.bin/ssh/serverloop.c","server_request_tun",513,567
20,3,114,1,28,"server_request_session@570-598@usr.bin/ssh/serverloop.c","usr.bin/ssh/serverloop.c","server_request_session",570,598
50,9,322,3,52,"server_input_channel_open@601-653@usr.bin/ssh/serverloop.c","usr.bin/ssh/serverloop.c","server_input_channel_open",601,653
56,13,422,2,66,"server_input_hostkeys_prove@656-722@usr.bin/ssh/serverloop.c","usr.bin/ssh/serverloop.c","server_input_hostkeys_prove",656,722
89,27,661,3,104,"server_input_global_request@725-829@usr.bin/ssh/serverloop.c","usr.bin/ssh/serverloop.c","server_input_global_request",725,829
31,10,208,3,33,"server_input_channel_req@832-865@usr.bin/ssh/serverloop.c","usr.bin/ssh/serverloop.c","server_input_channel_req",832,865
20,1,137,1,21,"server_init_dispatch@868-889@usr.bin/ssh/serverloop.c","usr.bin/ssh/serverloop.c","server_init_dispatch",868,889
10,2,40,1,9,"auth_sock_cleanup_proc@157-166@usr.bin/ssh/session.c","usr.bin/ssh/session.c","auth_sock_cleanup_proc",157,166
42,6,219,2,58,"auth_input_request_forwarding@169-227@usr.bin/ssh/session.c","usr.bin/ssh/session.c","auth_input_request_forwarding",169,227
8,2,49,1,7,"display_loginmsg@230-237@usr.bin/ssh/session.c","usr.bin/ssh/session.c","display_loginmsg",230,237
30,8,185,2,31,"prepare_auth_info_file@240-271@usr.bin/ssh/session.c","usr.bin/ssh/session.c","prepare_auth_info_file",240,271
13,4,82,2,19,"do_authenticated@274-293@usr.bin/ssh/session.c","usr.bin/ssh/session.c","do_authenticated",274,293
11,8,85,1,11,"xauth_valid_string@297-308@usr.bin/ssh/session.c","usr.bin/ssh/session.c","xauth_valid_string",297,308
98,21,750,3,151,"do_exec_no_pty@317-468@usr.bin/ssh/session.c","usr.bin/ssh/session.c","do_exec_no_pty",317,468
55,9,365,3,87,"do_exec_pty@477-564@usr.bin/ssh/session.c","usr.bin/ssh/session.c","do_exec_pty",477,564
56,16,344,3,70,"do_exec@571-641@usr.bin/ssh/session.c","usr.bin/ssh/session.c","do_exec",571,641
25,5,170,3,34,"do_login@646-680@usr.bin/ssh/session.c","usr.bin/ssh/session.c","do_login",646,680
14,4,74,1,14,"do_motd@686-700@usr.bin/ssh/session.c","usr.bin/ssh/session.c","do_motd",686,700
12,4,84,2,13,"check_quietlogin@707-720@usr.bin/ssh/session.c","usr.bin/ssh/session.c","check_quietlogin",707,720
30,10,190,3,37,"read_environment_file@729-766@usr.bin/ssh/session.c","usr.bin/ssh/session.c","read_environment_file",729,766
78,21,705,3,104,"do_setup_env@769-873@usr.bin/ssh/session.c","usr.bin/ssh/session.c","do_setup_env",769,873
63,19,376,2,66,"do_rc_files@880-946@usr.bin/ssh/session.c","usr.bin/ssh/session.c","do_rc_files",880,946
21,7,152,1,24,"do_nologin@949-973@usr.bin/ssh/session.c","usr.bin/ssh/session.c","do_nologin",949,973
39,14,290,2,48,"safely_chroot@980-1028@usr.bin/ssh/session.c","usr.bin/ssh/session.c","safely_chroot",980,1028
33,12,253,1,39,"do_setusercontext@1032-1071@usr.bin/ssh/session.c","usr.bin/ssh/session.c","do_setusercontext",1032,1071
15,2,71,1,14,"do_pwchange@1074-1088@usr.bin/ssh/session.c","usr.bin/ssh/session.c","do_pwchange",1074,1088
17,3,82,1,35,"child_close_fds@1091-1126@usr.bin/ssh/session.c","usr.bin/ssh/session.c","child_close_fds",1091,1126
93,20,674,3,169,"do_child@1135-1304@usr.bin/ssh/session.c","usr.bin/ssh/session.c","do_child",1135,1304
19,3,142,1,18,"session_unused@1307-1325@usr.bin/ssh/session.c","usr.bin/ssh/session.c","session_unused",1307,1325
35,7,180,1,38,"session_new@1328-1366@usr.bin/ssh/session.c","usr.bin/ssh/session.c","session_new",1328,1366
15,2,65,1,15,"session_dump@1369-1384@usr.bin/ssh/session.c","usr.bin/ssh/session.c","session_dump",1369,1384
16,4,98,2,15,"session_open@1387-1402@usr.bin/ssh/session.c","usr.bin/ssh/session.c","session_open",1387,1402
14,5,88,1,13,"session_by_tty@1405-1418@usr.bin/ssh/session.c","usr.bin/ssh/session.c","session_by_tty",1405,1418
15,4,75,1,14,"session_by_channel@1421-1435@usr.bin/ssh/session.c","usr.bin/ssh/session.c","session_by_channel",1421,1435
19,6,115,1,20,"session_by_x11_channel@1438-1458@usr.bin/ssh/session.c","usr.bin/ssh/session.c","session_by_x11_channel",1438,1458
13,4,77,1,12,"session_by_pid@1461-1473@usr.bin/ssh/session.c","usr.bin/ssh/session.c","session_by_pid",1461,1473
10,1,75,2,9,"session_window_change_req@1476-1485@usr.bin/ssh/session.c","usr.bin/ssh/session.c","session_window_change_req",1476,1485
41,7,283,2,50,"session_pty_req@1488-1538@usr.bin/ssh/session.c","usr.bin/ssh/session.c","session_pty_req",1488,1538
34,6,224,2,37,"session_subsystem_req@1541-1578@usr.bin/ssh/session.c","usr.bin/ssh/session.c","session_subsystem_req",1541,1578
28,6,156,2,29,"session_x11_req@1581-1610@usr.bin/ssh/session.c","usr.bin/ssh/session.c","session_x11_req",1581,1610
5,1,29,2,4,"session_shell_req@1613-1617@usr.bin/ssh/session.c","usr.bin/ssh/session.c","session_shell_req",1613,1617
9,1,53,2,9,"session_exec_req@1620-1629@usr.bin/ssh/session.c","usr.bin/ssh/session.c","session_exec_req",1620,1629
8,3,47,2,9,"session_break_req@1632-1641@usr.bin/ssh/session.c","usr.bin/ssh/session.c","session_break_req",1632,1641
28,4,202,2,32,"session_env_req@1644-1676@usr.bin/ssh/session.c","usr.bin/ssh/session.c","session_env_req",1644,1676
15,4,68,2,14,"session_auth_agent_req@1679-1693@usr.bin/ssh/session.c","usr.bin/ssh/session.c","session_auth_agent_req",1679,1693
33,12,291,3,39,"session_input_channel_req@1696-1735@usr.bin/ssh/session.c","usr.bin/ssh/session.c","session_input_channel_req",1696,1735
10,3,73,7,13,"session_set_fds@1738-1751@usr.bin/ssh/session.c","usr.bin/ssh/session.c","session_set_fds",1738,1751
18,7,120,1,30,"session_pty_cleanup2@1758-1788@usr.bin/ssh/session.c","usr.bin/ssh/session.c","session_pty_cleanup2",1758,1788
4,1,16,1,3,"session_pty_cleanup@1791-1794@usr.bin/ssh/session.c","usr.bin/ssh/session.c","session_pty_cleanup",1791,1794
17,1,75,1,18,"sig2name@1797-1815@usr.bin/ssh/session.c","usr.bin/ssh/session.c","sig2name",1797,1815
12,3,76,2,13,"session_close_x11@1818-1831@usr.bin/ssh/session.c","usr.bin/ssh/session.c","session_close_x11",1818,1831
25,4,188,3,29,"session_close_single_x11@1834-1863@usr.bin/ssh/session.c","usr.bin/ssh/session.c","session_close_single_x11",1834,1863
27,6,217,3,44,"session_exit_message@1866-1910@usr.bin/ssh/session.c","usr.bin/ssh/session.c","session_exit_message",1866,1910
27,4,174,2,28,"session_close@1913-1941@usr.bin/ssh/session.c","usr.bin/ssh/session.c","session_close",1913,1941
13,4,84,3,12,"session_close_by_pid@1944-1956@usr.bin/ssh/session.c","usr.bin/ssh/session.c","session_close_by_pid",1944,1956
25,6,174,3,33,"session_close_by_channel@1963-1996@usr.bin/ssh/session.c","usr.bin/ssh/session.c","session_close_by_channel",1963,1996
13,4,74,2,12,"session_destroy_all@1999-2011@usr.bin/ssh/session.c","usr.bin/ssh/session.c","session_destroy_all",1999,2011
17,6,123,1,16,"session_tty_list@2014-2030@usr.bin/ssh/session.c","usr.bin/ssh/session.c","session_tty_list",2014,2030
7,2,41,1,6,"session_proctitle@2033-2039@usr.bin/ssh/session.c","usr.bin/ssh/session.c","session_proctitle",2033,2039
50,10,328,2,58,"session_setup_x11fwd@2042-2100@usr.bin/ssh/session.c","usr.bin/ssh/session.c","session_setup_x11fwd",2042,2100
4,1,20,2,3,"do_authenticated2@2103-2106@usr.bin/ssh/session.c","usr.bin/ssh/session.c","do_authenticated2",2103,2106
27,13,134,2,46,"do_cleanup@2109-2155@usr.bin/ssh/session.c","usr.bin/ssh/session.c","do_cleanup",2109,2155
9,4,60,3,9,"session_get_remote_name_or_ip@2160-2169@usr.bin/ssh/session.c","usr.bin/ssh/session.c","session_get_remote_name_or_ip",2160,2169
11,1,91,4,11,"expand_proxy_command@77-88@usr.bin/ssh/sshconnect.c","usr.bin/ssh/sshconnect.c","expand_proxy_command",77,88
51,14,377,4,75,"ssh_proxy_fdpass_connect@95-170@usr.bin/ssh/sshconnect.c","usr.bin/ssh/sshconnect.c","ssh_proxy_fdpass_connect",95,170
48,11,347,4,72,"ssh_proxy_connect@176-248@usr.bin/ssh/sshconnect.c","usr.bin/ssh/sshconnect.c","ssh_proxy_connect",176,248
5,2,19,1,8,"ssh_kill_proxy_command@251-259@usr.bin/ssh/sshconnect.c","usr.bin/ssh/sshconnect.c","ssh_kill_proxy_command",251,259
49,11,303,2,56,"ssh_create_socket@265-321@usr.bin/ssh/sshconnect.c","usr.bin/ssh/sshconnect.c","ssh_create_socket",265,321
23,6,124,2,24,"waitrfd@329-353@usr.bin/ssh/sshconnect.c","usr.bin/ssh/sshconnect.c","waitrfd",329,353
26,7,165,4,32,"timeout_connect@356-388@usr.bin/ssh/sshconnect.c","usr.bin/ssh/sshconnect.c","timeout_connect",356,388
59,14,405,10,78,"ssh_connect_direct@402-480@usr.bin/ssh/sshconnect.c","usr.bin/ssh/sshconnect.c","ssh_connect_direct",402,480
19,5,152,10,18,"ssh_connect@483-501@usr.bin/ssh/sshconnect.c","usr.bin/ssh/sshconnect.c","ssh_connect",483,501
10,2,67,2,10,"send_client_banner@504-514@usr.bin/ssh/sshconnect.c","usr.bin/ssh/sshconnect.c","send_client_banner",504,514
77,21,440,1,87,"ssh_exchange_identification@521-608@usr.bin/ssh/sshconnect.c","usr.bin/ssh/sshconnect.c","ssh_exchange_identification",521,608
20,10,133,1,20,"confirm@612-632@usr.bin/ssh/sshconnect.c","usr.bin/ssh/sshconnect.c","confirm",612,632
14,3,79,2,14,"check_host_cert@635-649@usr.bin/ssh/sshconnect.c","usr.bin/ssh/sshconnect.c","check_host_cert",635,649
13,3,70,1,12,"sockaddr_is_local@652-664@usr.bin/ssh/sshconnect.c","usr.bin/ssh/sshconnect.c","sockaddr_is_local",652,664
24,6,152,5,35,"get_hostfile_hostname_ipaddr@671-706@usr.bin/ssh/sshconnect.c","usr.bin/ssh/sshconnect.c","get_hostfile_hostname_ipaddr",671,706
350,96,1925,9,439,"check_host_key@716-1155@usr.bin/ssh/sshconnect.c","usr.bin/ssh/sshconnect.c","check_host_key",716,1155
98,20,574,3,109,"verify_host_key@1159-1268@usr.bin/ssh/sshconnect.c","usr.bin/ssh/sshconnect.c","verify_host_key",1159,1268
16,2,118,6,25,"ssh_login@1278-1303@usr.bin/ssh/sshconnect.c","usr.bin/ssh/sshconnect.c","ssh_login",1278,1303
15,2,81,1,15,"ssh_put_password@1306-1321@usr.bin/ssh/sshconnect.c","usr.bin/ssh/sshconnect.c","ssh_put_password",1306,1321
37,7,214,2,37,"show_other_keys@1325-1362@usr.bin/ssh/sshconnect.c","usr.bin/ssh/sshconnect.c","show_other_keys",1325,1362
18,2,91,1,20,"warn_changed_key@1365-1385@usr.bin/ssh/sshconnect.c","usr.bin/ssh/sshconnect.c","warn_changed_key",1365,1385
30,11,222,1,34,"ssh_local_cmd@1391-1425@usr.bin/ssh/sshconnect.c","usr.bin/ssh/sshconnect.c","ssh_local_cmd",1391,1425
23,6,143,4,26,"maybe_add_key_to_agent@1428-1454@usr.bin/ssh/sshconnect.c","usr.bin/ssh/sshconnect.c","maybe_add_key_to_agent",1428,1454
10,1,50,1,9,"attrib_clear@50-59@usr.bin/ssh/sftp-common.c","usr.bin/ssh/sftp-common.c","attrib_clear",50,59
15,1,97,2,14,"stat_to_attrib@63-77@usr.bin/ssh/sftp-common.c","usr.bin/ssh/sftp-common.c","stat_to_attrib",63,77
16,5,111,2,16,"attrib_to_stat@81-97@usr.bin/ssh/sftp-common.c","usr.bin/ssh/sftp-common.c","attrib_to_stat",81,97
43,17,327,2,45,"decode_attrib@101-146@usr.bin/ssh/sftp-common.c","usr.bin/ssh/sftp-common.c","decode_attrib",101,146
25,12,190,2,25,"encode_attrib@150-175@usr.bin/ssh/sftp-common.c","usr.bin/ssh/sftp-common.c","encode_attrib",150,175
25,10,92,1,25,"fx2txt@179-204@usr.bin/ssh/sftp-common.c","usr.bin/ssh/sftp-common.c","fx2txt",179,204
44,7,409,4,44,"ls_file@210-254@usr.bin/ssh/sftp-common.c","usr.bin/ssh/sftp-common.c","ls_file",210,254
11,2,74,1,14,"fudge_opendir@45-59@usr.bin/ssh/sftp-glob.c","usr.bin/ssh/sftp-glob.c","fudge_opendir",45,59
10,2,77,1,12,"fudge_readdir@62-74@usr.bin/ssh/sftp-glob.c","usr.bin/ssh/sftp-glob.c","fudge_readdir",62,74
5,1,21,1,4,"fudge_closedir@77-81@usr.bin/ssh/sftp-glob.c","usr.bin/ssh/sftp-glob.c","fudge_closedir",77,81
8,2,58,2,10,"fudge_lstat@84-94@usr.bin/ssh/sftp-glob.c","usr.bin/ssh/sftp-glob.c","fudge_lstat",84,94
8,2,58,2,10,"fudge_stat@97-107@usr.bin/ssh/sftp-glob.c","usr.bin/ssh/sftp-glob.c","fudge_stat",97,107
12,1,121,5,13,"remote_glob@110-123@usr.bin/ssh/sftp-glob.c","usr.bin/ssh/sftp-glob.c","remote_glob",110,123
4,1,12,1,3,"cleanup_exit@30-33@usr.bin/ssh/sftp-server-main.c","usr.bin/ssh/sftp-server-main.c","cleanup_exit",30,33
12,2,70,2,15,"main@36-51@usr.bin/ssh/sftp-server-main.c","usr.bin/ssh/sftp-server-main.c","main",36,51
25,6,146,1,25,"request_permitted@147-172@usr.bin/ssh/sftp-server.c","usr.bin/ssh/sftp-server.c","request_permitted",147,172
31,12,92,1,31,"errno_to_portable@175-206@usr.bin/ssh/sftp-server.c","usr.bin/ssh/sftp-server.c","errno_to_portable",175,206
21,9,101,1,21,"flags_from_portable@209-230@usr.bin/ssh/sftp-server.c","usr.bin/ssh/sftp-server.c","flags_from_portable",209,230
18,7,82,1,26,"string_from_portable@233-259@usr.bin/ssh/sftp-server.c","usr.bin/ssh/sftp-server.c","string_from_portable",233,259
6,1,29,1,5,"handle_unused@284-289@usr.bin/ssh/sftp-server.c","usr.bin/ssh/sftp-server.c","handle_unused",284,289
20,3,150,5,23,"handle_new@292-315@usr.bin/ssh/sftp-server.c","usr.bin/ssh/sftp-server.c","handle_new",292,315
4,3,31,2,3,"handle_is_ok@318-321@usr.bin/ssh/sftp-server.c","usr.bin/ssh/sftp-server.c","handle_is_ok",318,321
9,3,59,3,8,"handle_to_string@324-332@usr.bin/ssh/sftp-server.c","usr.bin/ssh/sftp-server.c","handle_to_string",324,332
11,4,58,2,11,"handle_from_string@335-346@usr.bin/ssh/sftp-server.c","usr.bin/ssh/sftp-server.c","handle_from_string",335,346
7,3,34,1,6,"handle_to_name@349-355@usr.bin/ssh/sftp-server.c","usr.bin/ssh/sftp-server.c","handle_to_name",349,355
6,2,27,1,5,"handle_to_dir@358-363@usr.bin/ssh/sftp-server.c","usr.bin/ssh/sftp-server.c","handle_to_dir",358,363
6,2,28,1,5,"handle_to_fd@366-371@usr.bin/ssh/sftp-server.c","usr.bin/ssh/sftp-server.c","handle_to_fd",366,371
6,2,27,1,5,"handle_to_flags@374-379@usr.bin/ssh/sftp-server.c","usr.bin/ssh/sftp-server.c","handle_to_flags",374,379
5,3,32,2,4,"handle_update_read@382-386@usr.bin/ssh/sftp-server.c","usr.bin/ssh/sftp-server.c","handle_update_read",382,386
5,3,32,2,4,"handle_update_write@389-393@usr.bin/ssh/sftp-server.c","usr.bin/ssh/sftp-server.c","handle_update_write",389,393
6,2,29,1,5,"handle_bytes_read@396-401@usr.bin/ssh/sftp-server.c","usr.bin/ssh/sftp-server.c","handle_bytes_read",396,401
6,2,29,1,5,"handle_bytes_write@404-409@usr.bin/ssh/sftp-server.c","usr.bin/ssh/sftp-server.c","handle_bytes_write",404,409
16,3,100,1,16,"handle_close@412-428@usr.bin/ssh/sftp-server.c","usr.bin/ssh/sftp-server.c","handle_close",412,428
14,6,97,2,13,"handle_log_close@431-444@usr.bin/ssh/sftp-server.c","usr.bin/ssh/sftp-server.c","handle_log_close",431,444
7,3,40,1,7,"handle_log_exit@447-454@usr.bin/ssh/sftp-server.c","usr.bin/ssh/sftp-server.c","handle_log_exit",447,454
13,3,75,2,13,"get_handle@457-470@usr.bin/ssh/sftp-server.c","usr.bin/ssh/sftp-server.c","get_handle",457,470
7,2,44,1,7,"send_msg@475-482@usr.bin/ssh/sftp-server.c","usr.bin/ssh/sftp-server.c","send_msg",475,482
16,1,49,1,15,"status_to_message@485-500@usr.bin/ssh/sftp-server.c","usr.bin/ssh/sftp-server.c","status_to_message",485,500
23,11,186,2,23,"send_status@503-526@usr.bin/ssh/sftp-server.c","usr.bin/ssh/sftp-server.c","send_status",503,526
13,5,110,4,13,"send_data_or_handle@528-541@usr.bin/ssh/sftp-server.c","usr.bin/ssh/sftp-server.c","send_data_or_handle",528,541
5,1,35,3,4,"send_data@544-548@usr.bin/ssh/sftp-server.c","usr.bin/ssh/sftp-server.c","send_data",544,548
9,1,53,2,9,"send_handle@551-560@usr.bin/ssh/sftp-server.c","usr.bin/ssh/sftp-server.c","send_handle",551,560
20,9,200,3,20,"send_names@563-583@usr.bin/ssh/sftp-server.c","usr.bin/ssh/sftp-server.c","send_names",563,583
14,5,113,2,14,"send_attrib@586-600@usr.bin/ssh/sftp-server.c","usr.bin/ssh/sftp-server.c","send_attrib",586,600
26,17,283,2,27,"send_statvfs@603-630@usr.bin/ssh/sftp-server.c","usr.bin/ssh/sftp-server.c","send_statvfs",603,630
25,15,248,1,30,"process_init@635-665@usr.bin/ssh/sftp-server.c","usr.bin/ssh/sftp-server.c","process_init",635,665
38,11,265,1,39,"process_open@668-707@usr.bin/ssh/sftp-server.c","usr.bin/ssh/sftp-server.c","process_open",668,707
11,3,92,1,12,"process_close@710-722@usr.bin/ssh/sftp-server.c","usr.bin/ssh/sftp-server.c","process_close",710,722
37,10,254,1,38,"process_read@725-763@usr.bin/ssh/sftp-server.c","usr.bin/ssh/sftp-server.c","process_read",725,763
37,9,248,1,40,"process_write@766-806@usr.bin/ssh/sftp-server.c","usr.bin/ssh/sftp-server.c","process_write",766,806
22,7,161,2,23,"process_do_stat@809-832@usr.bin/ssh/sftp-server.c","usr.bin/ssh/sftp-server.c","process_do_stat",809,832
4,1,14,1,3,"process_stat@835-838@usr.bin/ssh/sftp-server.c","usr.bin/ssh/sftp-server.c","process_stat",835,838
4,1,14,1,3,"process_lstat@841-844@usr.bin/ssh/sftp-server.c","usr.bin/ssh/sftp-server.c","process_lstat",841,844
23,5,144,1,23,"process_fstat@847-870@usr.bin/ssh/sftp-server.c","usr.bin/ssh/sftp-server.c","process_fstat",847,870
9,1,60,1,9,"attrib_to_tv@873-882@usr.bin/ssh/sftp-server.c","usr.bin/ssh/sftp-server.c","attrib_to_tv",873,882
42,11,322,1,44,"process_setstat@885-929@usr.bin/ssh/sftp-server.c","usr.bin/ssh/sftp-server.c","process_setstat",885,929
47,12,345,1,50,"process_fsetstat@932-982@usr.bin/ssh/sftp-server.c","usr.bin/ssh/sftp-server.c","process_fsetstat",932,982
25,5,155,1,27,"process_opendir@985-1012@usr.bin/ssh/sftp-server.c","usr.bin/ssh/sftp-server.c","process_opendir",985,1012
48,11,351,1,53,"process_readdir@1015-1068@usr.bin/ssh/sftp-server.c","usr.bin/ssh/sftp-server.c","process_readdir",1015,1068
13,3,97,1,14,"process_remove@1071-1085@usr.bin/ssh/sftp-server.c","usr.bin/ssh/sftp-server.c","process_remove",1071,1085
17,5,138,1,18,"process_mkdir@1088-1106@usr.bin/ssh/sftp-server.c","usr.bin/ssh/sftp-server.c","process_mkdir",1088,1106
13,3,95,1,14,"process_rmdir@1109-1123@usr.bin/ssh/sftp-server.c","usr.bin/ssh/sftp-server.c","process_rmdir",1109,1123
23,4,149,1,24,"process_realpath@1126-1150@usr.bin/ssh/sftp-server.c","usr.bin/ssh/sftp-server.c","process_realpath",1126,1150
42,12,283,1,50,"process_rename@1153-1203@usr.bin/ssh/sftp-server.c","usr.bin/ssh/sftp-server.c","process_rename",1153,1203
20,3,145,1,22,"process_readlink@1206-1228@usr.bin/ssh/sftp-server.c","usr.bin/ssh/sftp-server.c","process_readlink",1206,1228
15,4,123,1,17,"process_symlink@1231-1248@usr.bin/ssh/sftp-server.c","usr.bin/ssh/sftp-server.c","process_symlink",1231,1248
15,4,123,1,16,"process_extended_posix_rename@1251-1267@usr.bin/ssh/sftp-server.c","usr.bin/ssh/sftp-server.c","process_extended_posix_rename",1251,1267
15,3,98,1,16,"process_extended_statvfs@1270-1286@usr.bin/ssh/sftp-server.c","usr.bin/ssh/sftp-server.c","process_extended_statvfs",1270,1286
17,4,115,1,17,"process_extended_fstatvfs@1289-1306@usr.bin/ssh/sftp-server.c","usr.bin/ssh/sftp-server.c","process_extended_fstatvfs",1289,1306
15,4,123,1,16,"process_extended_hardlink@1309-1325@usr.bin/ssh/sftp-server.c","usr.bin/ssh/sftp-server.c","process_extended_hardlink",1309,1325
15,5,124,1,15,"process_extended_fsync@1328-1343@usr.bin/ssh/sftp-server.c","usr.bin/ssh/sftp-server.c","process_extended_fsync",1328,1343
21,6,148,1,21,"process_extended@1346-1367@usr.bin/ssh/sftp-server.c","usr.bin/ssh/sftp-server.c","process_extended",1346,1367
70,19,434,1,72,"process@1372-1444@usr.bin/ssh/sftp-server.c","usr.bin/ssh/sftp-server.c","process",1372,1444
9,3,39,1,8,"sftp_server_cleanup_exit@1448-1456@usr.bin/ssh/sftp-server.c","usr.bin/ssh/sftp-server.c","sftp_server_cleanup_exit",1448,1456
11,1,30,1,11,"sftp_server_usage@1459-1470@usr.bin/ssh/sftp-server.c","usr.bin/ssh/sftp-server.c","sftp_server_usage",1459,1470
158,49,1080,3,191,"sftp_server_main@1473-1664@usr.bin/ssh/sftp-server.c","usr.bin/ssh/sftp-server.c","sftp_server_main",1473,1664
8,2,36,1,8,"killchild@200-208@usr.bin/ssh/sftp.c","usr.bin/ssh/sftp.c","killchild",200,208
9,4,51,1,8,"suspchild@212-220@usr.bin/ssh/sftp.c","usr.bin/ssh/sftp.c","suspchild",212,220
8,1,45,1,8,"cmd_interrupt@224-232@usr.bin/ssh/sftp.c","usr.bin/ssh/sftp.c","cmd_interrupt",224,232
36,1,43,1,35,"help@235-270@usr.bin/ssh/sftp.c","usr.bin/ssh/sftp.c","help",235,270
31,11,218,1,35,"local_do_shell@273-308@usr.bin/ssh/sftp.c","usr.bin/ssh/sftp.c","local_do_shell",273,308
12,3,73,1,13,"local_do_ls@311-324@usr.bin/ssh/sftp.c","usr.bin/ssh/sftp.c","local_do_ls",311,324
13,5,92,2,15,"path_strip@328-343@usr.bin/ssh/sftp.c","usr.bin/ssh/sftp.c","path_strip",328,343
10,3,55,2,11,"make_absolute@346-357@usr.bin/ssh/sftp.c","usr.bin/ssh/sftp.c","make_absolute",346,357
31,8,159,7,33,"parse_getput_flags@360-393@usr.bin/ssh/sftp.c","usr.bin/ssh/sftp.c","parse_getput_flags",360,393
19,3,102,4,21,"parse_link_flags@396-417@usr.bin/ssh/sftp.c","usr.bin/ssh/sftp.c","parse_link_flags",396,417
19,3,102,4,21,"parse_rename_flags@420-441@usr.bin/ssh/sftp.c","usr.bin/ssh/sftp.c","parse_rename_flags",420,441
48,11,202,3,50,"parse_ls_flags@444-494@usr.bin/ssh/sftp.c","usr.bin/ssh/sftp.c","parse_ls_flags",444,494
22,4,119,5,24,"parse_df_flags@497-521@usr.bin/ssh/sftp.c","usr.bin/ssh/sftp.c","parse_df_flags",497,521
15,2,83,3,17,"parse_no_flags@524-541@usr.bin/ssh/sftp.c","usr.bin/ssh/sftp.c","parse_no_flags",524,541
7,2,41,1,9,"is_dir@544-553@usr.bin/ssh/sftp.c","usr.bin/ssh/sftp.c","is_dir",544,553
9,3,66,2,10,"remote_is_dir@556-566@usr.bin/ssh/sftp.c","usr.bin/ssh/sftp.c","remote_is_dir",556,566
5,2,31,1,5,"pathname_is_dir@570-575@usr.bin/ssh/sftp.c","usr.bin/ssh/sftp.c","pathname_is_dir",570,575
73,26,514,8,83,"process_get@578-661@usr.bin/ssh/sftp.c","usr.bin/ssh/sftp.c","process_get",578,661
78,28,549,8,89,"process_put@664-753@usr.bin/ssh/sftp.c","usr.bin/ssh/sftp.c","process_put",664,753
13,5,129,2,15,"sdirent_comp@756-771@usr.bin/ssh/sftp.c","usr.bin/ssh/sftp.c","sdirent_comp",756,771
66,18,522,4,82,"do_ls_dir@775-857@usr.bin/ssh/sftp.c","usr.bin/ssh/sftp.c","do_ls_dir",775,857
17,5,171,2,19,"sglob_comp@860-879@usr.bin/ssh/sftp.c","usr.bin/ssh/sftp.c","sglob_comp",860,879
81,24,606,4,103,"do_globbed_ls@883-986@usr.bin/ssh/sftp.c","usr.bin/ssh/sftp.c","do_globbed_ls",883,986
55,6,481,4,55,"do_df@989-1044@usr.bin/ssh/sftp.c","usr.bin/ssh/sftp.c","do_df",989,1044
31,9,152,1,32,"undo_glob_escape@1052-1084@usr.bin/ssh/sftp.c","usr.bin/ssh/sftp.c","undo_glob_escape",1052,1084
122,48,854,5,144,"makeargv@1105-1249@usr.bin/ssh/sftp.c","usr.bin/ssh/sftp.c","makeargv",1105,1249
164,63,1043,13,190,"parse_args@1252-1442@usr.bin/ssh/sftp.c","usr.bin/ssh/sftp.c","parse_args",1252,1442
239,73,1440,5,255,"parse_dispatch_command@1445-1700@usr.bin/ssh/sftp.c","usr.bin/ssh/sftp.c","parse_dispatch_command",1445,1700
4,1,13,1,3,"prompt@1703-1706@usr.bin/ssh/sftp.c","usr.bin/ssh/sftp.c","prompt",1703,1706
28,7,224,2,32,"complete_display@1710-1742@usr.bin/ssh/sftp.c","usr.bin/ssh/sftp.c","complete_display",1710,1742
21,7,141,3,28,"complete_ambiguous@1750-1778@usr.bin/ssh/sftp.c","usr.bin/ssh/sftp.c","complete_ambiguous",1750,1778
54,18,429,5,68,"complete_cmd_parse@1782-1850@usr.bin/ssh/sftp.c","usr.bin/ssh/sftp.c","complete_cmd_parse",1782,1850
10,4,76,1,12,"complete_is_remote@1857-1869@usr.bin/ssh/sftp.c","usr.bin/ssh/sftp.c","complete_is_remote",1857,1869
102,45,743,8,123,"complete_match@1873-1996@usr.bin/ssh/sftp.c","usr.bin/ssh/sftp.c","complete_match",1873,1996
47,15,395,2,60,"complete@2000-2060@usr.bin/ssh/sftp.c","usr.bin/ssh/sftp.c","complete",2000,2060
121,30,838,3,141,"interactive_loop@2063-2204@usr.bin/ssh/sftp.c","usr.bin/ssh/sftp.c","interactive_loop",2063,2204
35,6,268,4,46,"connect_to_server@2207-2253@usr.bin/ssh/sftp.c","usr.bin/ssh/sftp.c","connect_to_server",2207,2253
13,1,30,1,13,"usage@2256-2269@usr.bin/ssh/sftp.c","usr.bin/ssh/sftp.c","usage",2256,2269
192,57,1121,2,218,"main@2272-2490@usr.bin/ssh/sftp.c","usr.bin/ssh/sftp.c","main",2272,2490
8,2,99,3,7,"add@11-18@usr.bin/ssh/smult_curve25519_ref.c","usr.bin/ssh/smult_curve25519_ref.c","add",11,18
13,2,101,3,12,"sub@20-32@usr.bin/ssh/smult_curve25519_ref.c","usr.bin/ssh/smult_curve25519_ref.c","sub",20,32
11,3,136,1,10,"squeeze@34-44@usr.bin/ssh/smult_curve25519_ref.c","usr.bin/ssh/smult_curve25519_ref.c","squeeze",34,44
10,3,107,1,10,"freeze@50-60@usr.bin/ssh/smult_curve25519_ref.c","usr.bin/ssh/smult_curve25519_ref.c","freeze",50,60
13,4,130,3,13,"mult@62-75@usr.bin/ssh/smult_curve25519_ref.c","usr.bin/ssh/smult_curve25519_ref.c","mult",62,75
11,3,148,2,11,"mult121665@77-88@usr.bin/ssh/smult_curve25519_ref.c","usr.bin/ssh/smult_curve25519_ref.c","mult121665",77,88
18,5,182,2,18,"square@90-108@usr.bin/ssh/smult_curve25519_ref.c","usr.bin/ssh/smult_curve25519_ref.c","square",90,108
12,2,111,5,12,"select@110-122@usr.bin/ssh/smult_curve25519_ref.c","usr.bin/ssh/smult_curve25519_ref.c","select",110,122
51,6,486,2,54,"mainloop@124-178@usr.bin/ssh/smult_curve25519_ref.c","usr.bin/ssh/smult_curve25519_ref.c","mainloop",124,178
57,7,553,2,65,"recip@180-245@usr.bin/ssh/smult_curve25519_ref.c","usr.bin/ssh/smult_curve25519_ref.c","recip",180,245
19,4,172,3,18,"crypto_scalarmult_curve25519@247-265@usr.bin/ssh/smult_curve25519_ref.c","usr.bin/ssh/smult_curve25519_ref.c","crypto_scalarmult_curve25519",247,265
8,2,31,1,7,"clear_pass@87-94@usr.bin/ssh/ssh-add.c","usr.bin/ssh/ssh-add.c","clear_pass",87,94
48,11,308,4,55,"delete_file@97-152@usr.bin/ssh/ssh-add.c","usr.bin/ssh/ssh-add.c","delete_file",97,152
12,3,59,1,20,"delete_all@156-176@usr.bin/ssh/ssh-add.c","usr.bin/ssh/ssh-add.c","delete_all",156,176
131,35,829,4,150,"add_file@179-329@usr.bin/ssh/ssh-add.c","usr.bin/ssh/ssh-add.c","add_file",179,329
22,7,140,3,23,"update_card@332-355@usr.bin/ssh/ssh-add.c","usr.bin/ssh/ssh-add.c","update_card",332,355
34,7,216,2,34,"list_identities@358-392@usr.bin/ssh/ssh-add.c","usr.bin/ssh/ssh-add.c","list_identities",358,392
29,7,202,2,29,"lock_agent@395-424@usr.bin/ssh/ssh-add.c","usr.bin/ssh/ssh-add.c","lock_agent",395,424
11,4,72,5,10,"do_file@427-437@usr.bin/ssh/ssh-add.c","usr.bin/ssh/ssh-add.c","do_file",427,437
18,1,113,1,17,"usage@440-457@usr.bin/ssh/ssh-add.c","usr.bin/ssh/ssh-add.c","usage",440,457
135,40,720,2,146,"main@460-606@usr.bin/ssh/ssh-add.c","usr.bin/ssh/ssh-add.c","main",460,606
9,1,49,1,8,"close_socket@151-159@usr.bin/ssh/ssh-agent.c","usr.bin/ssh/ssh-agent.c","close_socket",151,159
6,1,33,1,5,"idtab_init@162-167@usr.bin/ssh/ssh-agent.c","usr.bin/ssh/ssh-agent.c","idtab_init",162,167
7,1,34,1,6,"free_identity@170-176@usr.bin/ssh/ssh-agent.c","usr.bin/ssh/ssh-agent.c","free_identity",170,176
9,2,47,1,9,"lookup_identity@180-189@usr.bin/ssh/ssh-agent.c","usr.bin/ssh/ssh-agent.c","lookup_identity",180,189
12,3,62,1,13,"confirm_key@193-206@usr.bin/ssh/ssh-agent.c","usr.bin/ssh/ssh-agent.c","confirm_key",193,206
8,4,62,2,8,"send_status@209-217@usr.bin/ssh/ssh-agent.c","usr.bin/ssh/ssh-agent.c","send_status",209,217
22,7,176,1,22,"process_request_identities@221-243@usr.bin/ssh/ssh-agent.c","usr.bin/ssh/ssh-agent.c","process_request_identities",221,243
10,4,44,2,9,"agent_decode_alg@247-256@usr.bin/ssh/ssh-agent.c","usr.bin/ssh/ssh-agent.c","agent_decode_alg",247,256
47,15,391,1,51,"process_sign_request2@260-311@usr.bin/ssh/ssh-agent.c","usr.bin/ssh/ssh-agent.c","process_sign_request2",260,311
24,4,145,1,25,"process_remove_identity@315-340@usr.bin/ssh/ssh-agent.c","usr.bin/ssh/ssh-agent.c","process_remove_identity",315,340
11,2,68,1,16,"process_remove_all_identities@343-359@usr.bin/ssh/ssh-agent.c","usr.bin/ssh/ssh-agent.c","process_remove_all_identities",343,359
22,7,147,1,22,"reaper@363-385@usr.bin/ssh/ssh-agent.c","usr.bin/ssh/ssh-agent.c","reaper",363,385
60,12,360,1,63,"process_add_identity@388-451@usr.bin/ssh/ssh-agent.c","usr.bin/ssh/ssh-agent.c","process_add_identity",388,451
43,11,298,2,49,"process_lock_agent@455-504@usr.bin/ssh/ssh-agent.c","usr.bin/ssh/ssh-agent.c","process_lock_agent",455,504
12,5,95,1,12,"no_identities@507-519@usr.bin/ssh/ssh-agent.c","usr.bin/ssh/ssh-agent.c","no_identities",507,519
73,14,475,1,75,"process_add_smartcard_key@523-598@usr.bin/ssh/ssh-agent.c","usr.bin/ssh/ssh-agent.c","process_add_smartcard_key",523,598
35,8,245,1,38,"process_remove_smartcard_key@601-639@usr.bin/ssh/ssh-agent.c","usr.bin/ssh/ssh-agent.c","process_remove_smartcard_key",601,639
84,25,408,1,97,"process_message@645-742@usr.bin/ssh/ssh-agent.c","usr.bin/ssh/ssh-agent.c","process_message",645,742
33,11,293,2,35,"new_socket@745-780@usr.bin/ssh/ssh-agent.c","usr.bin/ssh/ssh-agent.c","new_socket",745,780
27,5,167,1,27,"handle_socket_read@783-810@usr.bin/ssh/ssh-agent.c","usr.bin/ssh/ssh-agent.c","handle_socket_read",783,810
21,6,145,1,21,"handle_conn_read@813-834@usr.bin/ssh/ssh-agent.c","usr.bin/ssh/ssh-agent.c","handle_conn_read",813,834
22,7,152,1,22,"handle_conn_write@837-859@usr.bin/ssh/ssh-agent.c","usr.bin/ssh/ssh-agent.c","handle_conn_write",837,859
39,16,259,2,41,"after_poll@862-903@usr.bin/ssh/ssh-agent.c","usr.bin/ssh/ssh-agent.c","after_poll",862,903
52,14,313,3,55,"prepare_poll@906-961@usr.bin/ssh/ssh-agent.c","usr.bin/ssh/ssh-agent.c","prepare_poll",906,961
10,5,51,1,9,"cleanup_socket@964-973@usr.bin/ssh/ssh-agent.c","usr.bin/ssh/ssh-agent.c","cleanup_socket",964,973
5,1,16,1,4,"cleanup_exit@976-980@usr.bin/ssh/ssh-agent.c","usr.bin/ssh/ssh-agent.c","cleanup_exit",976,980
6,2,20,1,7,"cleanup_handler@984-991@usr.bin/ssh/ssh-agent.c","usr.bin/ssh/ssh-agent.c","cleanup_handler",984,991
7,3,30,1,11,"check_parent_exists@994-1005@usr.bin/ssh/ssh-agent.c","usr.bin/ssh/ssh-agent.c","check_parent_exists",994,1005
8,1,20,1,7,"usage@1008-1015@usr.bin/ssh/ssh-agent.c","usr.bin/ssh/ssh-agent.c","usage",1008,1015
208,64,1256,2,247,"main@1018-1265@usr.bin/ssh/ssh-agent.c","usr.bin/ssh/ssh-agent.c","main",1018,1265
71,22,472,6,77,"ssh_dss_sign@44-121@usr.bin/ssh/ssh-dss.c","usr.bin/ssh/ssh-dss.c","ssh_dss_sign",44,121
79,25,478,6,89,"ssh_dss_verify@124-213@usr.bin/ssh/ssh-dss.c","usr.bin/ssh/ssh-dss.c","ssh_dss_verify",124,213
55,20,399,6,59,"ssh_ecdsa_sign@44-103@usr.bin/ssh/ssh-ecdsa.c","usr.bin/ssh/ssh-ecdsa.c","ssh_ecdsa_sign",44,103
69,21,409,6,76,"ssh_ecdsa_verify@107-183@usr.bin/ssh/ssh-ecdsa.c","usr.bin/ssh/ssh-ecdsa.c","ssh_ecdsa_verify",107,183
51,17,324,6,56,"ssh_ed25519_sign@33-89@usr.bin/ssh/ssh-ed25519.c","usr.bin/ssh/ssh-ed25519.c","ssh_ed25519_sign",33,89
69,21,417,6,72,"ssh_ed25519_verify@92-164@usr.bin/ssh/ssh-ed25519.c","usr.bin/ssh/ssh-ed25519.c","ssh_ed25519_verify",92,164
37,18,194,3,43,"type_bits_valid@199-242@usr.bin/ssh/ssh-keygen.c","usr.bin/ssh/ssh-keygen.c","type_bits_valid",199,242
39,12,195,2,39,"ask_filename@245-284@usr.bin/ssh/ssh-keygen.c","usr.bin/ssh/ssh-keygen.c","ask_filename",245,284
20,5,132,1,20,"load_identity@287-307@usr.bin/ssh/ssh-keygen.c","usr.bin/ssh/ssh-keygen.c","load_identity",287,307
20,2,138,2,22,"do_convert_to_ssh2@316-338@usr.bin/ssh/ssh-keygen.c","usr.bin/ssh/ssh-keygen.c","do_convert_to_ssh2",316,338
20,7,105,1,19,"do_convert_to_pkcs8@341-360@usr.bin/ssh/ssh-keygen.c","usr.bin/ssh/ssh-keygen.c","do_convert_to_pkcs8",341,360
16,6,83,1,18,"do_convert_to_pem@363-381@usr.bin/ssh/ssh-keygen.c","usr.bin/ssh/ssh-keygen.c","do_convert_to_pem",363,381
26,7,138,1,26,"do_convert_to@384-410@usr.bin/ssh/ssh-keygen.c","usr.bin/ssh/ssh-keygen.c","do_convert_to",384,410
15,5,132,2,15,"buffer_get_bignum_bits@417-432@usr.bin/ssh/ssh-keygen.c","usr.bin/ssh/ssh-keygen.c","buffer_get_bignum_bits",417,432
99,25,769,2,104,"do_convert_private_ssh2_from_blob@435-539@usr.bin/ssh/ssh-keygen.c","usr.bin/ssh/ssh-keygen.c","do_convert_private_ssh2_from_blob",435,539
22,8,131,3,23,"get_line@542-565@usr.bin/ssh/ssh-keygen.c","usr.bin/ssh/ssh-keygen.c","get_line",542,565
44,17,343,3,46,"do_convert_from_ssh2@568-614@usr.bin/ssh/ssh-keygen.c","usr.bin/ssh/ssh-keygen.c","do_convert_from_ssh2",568,614
38,9,271,2,38,"do_convert_from_pkcs8@617-655@usr.bin/ssh/ssh-keygen.c","usr.bin/ssh/ssh-keygen.c","do_convert_from_pkcs8",617,655
26,8,196,2,31,"do_convert_from_pem@658-689@usr.bin/ssh/ssh-keygen.c","usr.bin/ssh/ssh-keygen.c","do_convert_from_pem",658,689
51,13,290,1,54,"do_convert_from@692-746@usr.bin/ssh/ssh-keygen.c","usr.bin/ssh/ssh-keygen.c","do_convert_from",692,746
16,4,106,1,16,"do_print_public@750-766@usr.bin/ssh/ssh-keygen.c","usr.bin/ssh/ssh-keygen.c","do_print_public",750,766
37,10,241,1,41,"do_download@769-810@usr.bin/ssh/ssh-keygen.c","usr.bin/ssh/ssh-keygen.c","do_download",769,810
11,3,60,1,12,"try_read_key@813-825@usr.bin/ssh/ssh-keygen.c","usr.bin/ssh/ssh-keygen.c","try_read_key",813,825
18,7,134,2,18,"fingerprint_one_key@828-846@usr.bin/ssh/ssh-keygen.c","usr.bin/ssh/ssh-keygen.c","fingerprint_one_key",828,846
20,4,145,1,21,"fingerprint_private@849-870@usr.bin/ssh/ssh-keygen.c","usr.bin/ssh/ssh-keygen.c","fingerprint_private",849,870
63,29,459,1,89,"do_fingerprint@873-962@usr.bin/ssh/ssh-keygen.c","usr.bin/ssh/ssh-keygen.c","do_fingerprint",873,962
117,19,774,1,131,"do_gen_all_hostkeys@965-1096@usr.bin/ssh/ssh-keygen.c","usr.bin/ssh/ssh-keygen.c","do_gen_all_hostkeys",965,1096
37,14,282,2,48,"known_hosts_hash@1107-1155@usr.bin/ssh/ssh-keygen.c","usr.bin/ssh/ssh-keygen.c","known_hosts_hash",1107,1155
47,15,301,2,55,"known_hosts_find_delete@1158-1213@usr.bin/ssh/ssh-keygen.c","usr.bin/ssh/ssh-keygen.c","known_hosts_find_delete",1158,1213
79,30,573,2,93,"do_known_hosts@1216-1309@usr.bin/ssh/ssh-keygen.c","usr.bin/ssh/ssh-keygen.c","do_known_hosts",1216,1309
68,11,399,1,78,"do_change_passphrase@1316-1394@usr.bin/ssh/ssh-keygen.c","usr.bin/ssh/ssh-keygen.c","do_change_passphrase",1316,1394
21,5,138,3,21,"do_print_resource_record@1400-1421@usr.bin/ssh/ssh-keygen.c","usr.bin/ssh/ssh-keygen.c","do_print_resource_record",1400,1421
88,18,591,1,96,"do_change_comment@1427-1523@usr.bin/ssh/ssh-keygen.c","usr.bin/ssh/ssh-keygen.c","do_change_comment",1427,1523
8,3,68,2,8,"add_flag_option@1526-1534@usr.bin/ssh/ssh-keygen.c","usr.bin/ssh/ssh-keygen.c","add_flag_option",1526,1534
13,5,115,3,14,"add_string_option@1537-1551@usr.bin/ssh/ssh-keygen.c","usr.bin/ssh/ssh-keygen.c","add_string_option",1537,1551
37,21,286,2,37,"prepare_options_buf@1556-1593@usr.bin/ssh/ssh-keygen.c","usr.bin/ssh/ssh-keygen.c","prepare_options_buf",1556,1593
23,6,156,1,27,"load_pkcs11_key@1596-1623@usr.bin/ssh/ssh-keygen.c","usr.bin/ssh/ssh-keygen.c","load_pkcs11_key",1596,1623
8,1,69,8,8,"agent_signer@1627-1635@usr.bin/ssh/ssh-keygen.c","usr.bin/ssh/ssh-keygen.c","agent_signer",1627,1635
120,37,969,3,142,"do_ca_sign@1638-1780@usr.bin/ssh/ssh-keygen.c","usr.bin/ssh/ssh-keygen.c","do_ca_sign",1638,1780
10,5,82,2,11,"parse_relative_time@1783-1794@usr.bin/ssh/ssh-keygen.c","usr.bin/ssh/ssh-keygen.c","parse_relative_time",1783,1794
25,5,178,1,31,"parse_absolute_time@1797-1828@usr.bin/ssh/ssh-keygen.c","usr.bin/ssh/ssh-keygen.c","parse_absolute_time",1797,1828
33,14,246,1,47,"parse_cert_times@1831-1878@usr.bin/ssh/ssh-keygen.c","usr.bin/ssh/ssh-keygen.c","parse_cert_times",1831,1878
57,23,447,1,57,"add_cert_option@1881-1938@usr.bin/ssh/ssh-keygen.c","usr.bin/ssh/ssh-keygen.c","add_cert_option",1881,1938
41,16,296,2,41,"show_options@1941-1982@usr.bin/ssh/ssh-keygen.c","usr.bin/ssh/ssh-keygen.c","show_options",1941,1982
42,7,301,1,43,"print_cert@1985-2028@usr.bin/ssh/ssh-keygen.c","usr.bin/ssh/ssh-keygen.c","print_cert",1985,2028
48,15,342,1,51,"do_show_cert@2031-2082@usr.bin/ssh/ssh-keygen.c","usr.bin/ssh/ssh-keygen.c","do_show_cert",2031,2082
16,6,138,2,17,"load_krl@2086-2103@usr.bin/ssh/ssh-keygen.c","usr.bin/ssh/ssh-keygen.c","load_krl",2086,2103
115,40,818,5,122,"update_krl_from_file@2106-2228@usr.bin/ssh/ssh-keygen.c","usr.bin/ssh/ssh-keygen.c","update_krl_from_file",2106,2228
52,17,399,4,56,"do_gen_krl@2231-2287@usr.bin/ssh/ssh-keygen.c","usr.bin/ssh/ssh-keygen.c","do_gen_krl",2231,2287
25,8,184,3,25,"do_check_krl@2290-2315@usr.bin/ssh/ssh-keygen.c","usr.bin/ssh/ssh-keygen.c","do_check_krl",2290,2315
32,3,54,1,35,"usage@2319-2354@usr.bin/ssh/ssh-keygen.c","usr.bin/ssh/ssh-keygen.c","usage",2319,2354
449,150,2428,2,509,"main@2360-2869@usr.bin/ssh/ssh-keygen.c","usr.bin/ssh/ssh-keygen.c","main",2360,2869
10,5,63,1,10,"fdlim_get@108-118@usr.bin/ssh/ssh-keyscan.c","usr.bin/ssh/ssh-keyscan.c","fdlim_get",108,118
12,4,70,1,12,"fdlim_set@121-133@usr.bin/ssh/ssh-keyscan.c","usr.bin/ssh/ssh-keyscan.c","fdlim_set",121,133
12,3,70,2,15,"xstrsep@141-156@usr.bin/ssh/ssh-keyscan.c","usr.bin/ssh/ssh-keyscan.c","xstrsep",141,156
8,3,43,2,8,"strnnsep@163-171@usr.bin/ssh/ssh-keyscan.c","usr.bin/ssh/ssh-keyscan.c","strnnsep",163,171
7,2,42,2,8,"key_print_wrapper@175-183@usr.bin/ssh/ssh-keyscan.c","usr.bin/ssh/ssh-keyscan.c","key_print_wrapper",175,183
14,4,43,2,13,"ssh2_capable@186-199@usr.bin/ssh/ssh-keyscan.c","usr.bin/ssh/ssh-keyscan.c","ssh2_capable",186,199
47,11,294,1,53,"keygrab_ssh2@202-255@usr.bin/ssh/ssh-keyscan.c","usr.bin/ssh/ssh-keyscan.c","keygrab_ssh2",202,255
15,4,105,2,15,"keyprint_one@258-273@usr.bin/ssh/ssh-keyscan.c","usr.bin/ssh/ssh-keyscan.c","keyprint_one",258,273
15,7,105,2,15,"keyprint@276-291@usr.bin/ssh/ssh-keyscan.c","usr.bin/ssh/ssh-keyscan.c","keyprint",276,291
32,7,234,1,32,"tcpconnect@294-326@usr.bin/ssh/ssh-keyscan.c","usr.bin/ssh/ssh-keyscan.c","tcpconnect",294,326
34,5,276,3,37,"conalloc@329-366@usr.bin/ssh/ssh-keyscan.c","usr.bin/ssh/ssh-keyscan.c","conalloc",329,366
20,5,158,1,19,"confree@369-388@usr.bin/ssh/ssh-keyscan.c","usr.bin/ssh/ssh-keyscan.c","confree",369,388
7,1,57,1,6,"contouch@391-397@usr.bin/ssh/ssh-keyscan.c","usr.bin/ssh/ssh-keyscan.c","contouch",391,397
8,1,47,1,8,"conrecycle@400-408@usr.bin/ssh/ssh-keyscan.c","usr.bin/ssh/ssh-keyscan.c","conrecycle",400,408
70,18,461,1,72,"congreet@411-483@usr.bin/ssh/ssh-keyscan.c","usr.bin/ssh/ssh-keyscan.c","congreet",411,483
30,5,190,1,32,"conread@486-518@usr.bin/ssh/ssh-keyscan.c","usr.bin/ssh/ssh-keyscan.c","conread",486,518
43,16,349,1,49,"conloop@521-570@usr.bin/ssh/ssh-keyscan.c","usr.bin/ssh/ssh-keyscan.c","conloop",521,570
14,6,79,1,14,"do_host@573-587@usr.bin/ssh/ssh-keyscan.c","usr.bin/ssh/ssh-keyscan.c","do_host",573,587
8,1,40,2,8,"fatal@590-598@usr.bin/ssh/ssh-keyscan.c","usr.bin/ssh/ssh-keyscan.c","fatal",590,598
8,1,21,1,7,"usage@601-608@usr.bin/ssh/ssh-keyscan.c","usr.bin/ssh/ssh-keyscan.c","usage",601,608
136,46,739,2,156,"main@611-767@usr.bin/ssh/ssh-keyscan.c","usr.bin/ssh/ssh-keyscan.c","main",611,767
73,29,634,5,96,"valid_request@61-157@usr.bin/ssh/ssh-keysign.c","usr.bin/ssh/ssh-keysign.c","valid_request",61,157
105,36,869,2,129,"main@160-289@usr.bin/ssh/ssh-keysign.c","usr.bin/ssh/ssh-keysign.c","main",160,289
11,3,78,1,11,"send_msg@45-56@usr.bin/ssh/ssh-pkcs11-client.c","usr.bin/ssh/ssh-pkcs11-client.c","send_msg",45,56
25,6,155,1,26,"recv_msg@59-85@usr.bin/ssh/ssh-pkcs11-client.c","usr.bin/ssh/ssh-pkcs11-client.c","recv_msg",59,85
4,1,12,1,3,"pkcs11_init@88-91@usr.bin/ssh/ssh-pkcs11-client.c","usr.bin/ssh/ssh-pkcs11-client.c","pkcs11_init",88,91
4,1,11,1,3,"pkcs11_terminate@94-97@usr.bin/ssh/ssh-pkcs11-client.c","usr.bin/ssh/ssh-pkcs11-client.c","pkcs11_terminate",94,97
33,5,221,5,34,"pkcs11_rsa_private_encrypt@100-134@usr.bin/ssh/ssh-pkcs11-client.c","usr.bin/ssh/ssh-pkcs11-client.c","pkcs11_rsa_private_encrypt",100,134
9,1,52,1,9,"wrap_key@138-147@usr.bin/ssh/ssh-pkcs11-client.c","usr.bin/ssh/ssh-pkcs11-client.c","wrap_key",138,147
28,6,205,1,28,"pkcs11_start_helper@150-178@usr.bin/ssh/ssh-pkcs11-client.c","usr.bin/ssh/ssh-pkcs11-client.c","pkcs11_start_helper",150,178
32,5,218,3,34,"pkcs11_add_provider@181-215@usr.bin/ssh/ssh-pkcs11-client.c","usr.bin/ssh/ssh-pkcs11-client.c","pkcs11_add_provider",181,215
15,2,84,1,16,"pkcs11_del_provider@218-234@usr.bin/ssh/ssh-pkcs11-client.c","usr.bin/ssh/ssh-pkcs11-client.c","pkcs11_del_provider",218,234
8,1,55,2,8,"add_key@56-64@usr.bin/ssh/ssh-pkcs11-helper.c","usr.bin/ssh/ssh-pkcs11-helper.c","add_key",56,64
13,3,86,1,13,"del_keys_by_name@67-80@usr.bin/ssh/ssh-pkcs11-helper.c","usr.bin/ssh/ssh-pkcs11-helper.c","del_keys_by_name",67,80
10,2,59,1,10,"lookup_key@84-94@usr.bin/ssh/ssh-pkcs11-helper.c","usr.bin/ssh/ssh-pkcs11-helper.c","lookup_key",84,94
7,1,44,1,7,"send_msg@97-104@usr.bin/ssh/ssh-pkcs11-helper.c","usr.bin/ssh/ssh-pkcs11-helper.c","send_msg",97,104
31,4,195,1,31,"process_add@107-138@usr.bin/ssh/ssh-pkcs11-helper.c","usr.bin/ssh/ssh-pkcs11-helper.c","process_add",107,138
17,2,89,1,17,"process_del@141-158@usr.bin/ssh/ssh-pkcs11-helper.c","usr.bin/ssh/ssh-pkcs11-helper.c","process_del",141,158
36,6,227,1,40,"process_sign@161-201@usr.bin/ssh/ssh-pkcs11-helper.c","usr.bin/ssh/ssh-pkcs11-helper.c","process_sign",161,201
50,10,232,1,51,"process@204-255@usr.bin/ssh/ssh-pkcs11-helper.c","usr.bin/ssh/ssh-pkcs11-helper.c","process",204,255
4,1,12,1,4,"cleanup_exit@258-262@usr.bin/ssh/ssh-pkcs11-helper.c","usr.bin/ssh/ssh-pkcs11-helper.c","cleanup_exit",258,262
65,15,429,2,88,"main@265-353@usr.bin/ssh/ssh-pkcs11-helper.c","usr.bin/ssh/ssh-pkcs11-helper.c","main",265,353
6,1,22,1,5,"pkcs11_init@70-75@usr.bin/ssh/ssh-pkcs11.c","usr.bin/ssh/ssh-pkcs11.c","pkcs11_init",70,75
20,6,139,1,22,"pkcs11_provider_finalize@84-106@usr.bin/ssh/ssh-pkcs11.c","usr.bin/ssh/ssh-pkcs11.c","pkcs11_provider_finalize",84,106
11,3,63,1,10,"pkcs11_provider_unref@113-123@usr.bin/ssh/ssh-pkcs11.c","usr.bin/ssh/ssh-pkcs11.c","pkcs11_provider_unref",113,123
9,2,47,1,9,"pkcs11_terminate@127-136@usr.bin/ssh/ssh-pkcs11.c","usr.bin/ssh/ssh-pkcs11.c","pkcs11_terminate",127,136
10,2,57,1,10,"pkcs11_provider_lookup@140-150@usr.bin/ssh/ssh-pkcs11.c","usr.bin/ssh/ssh-pkcs11.c","pkcs11_provider_lookup",140,150
11,2,59,1,11,"pkcs11_del_provider@154-165@usr.bin/ssh/ssh-pkcs11.c","usr.bin/ssh/ssh-pkcs11.c","pkcs11_del_provider",154,165
14,4,79,1,14,"pkcs11_rsa_finish@169-183@usr.bin/ssh/ssh-pkcs11.c","usr.bin/ssh/ssh-pkcs11.c","pkcs11_rsa_finish",169,183
24,5,168,5,24,"pkcs11_find@187-211@usr.bin/ssh/ssh-pkcs11.c","usr.bin/ssh/ssh-pkcs11.c","pkcs11_find",187,211
76,18,558,5,78,"pkcs11_rsa_private_encrypt@215-293@usr.bin/ssh/ssh-pkcs11.c","usr.bin/ssh/ssh-pkcs11.c","pkcs11_rsa_private_encrypt",215,293
5,1,29,5,4,"pkcs11_rsa_private_decrypt@296-300@usr.bin/ssh/ssh-pkcs11.c","usr.bin/ssh/ssh-pkcs11.c","pkcs11_rsa_private_decrypt",296,300
24,2,187,4,25,"pkcs11_rsa_wrap@304-329@usr.bin/ssh/ssh-pkcs11.c","usr.bin/ssh/ssh-pkcs11.c","pkcs11_rsa_wrap",304,329
11,5,61,2,11,"rmspace@333-344@usr.bin/ssh/ssh-pkcs11.c","usr.bin/ssh/ssh-pkcs11.c","rmspace",333,344
32,10,225,3,32,"pkcs11_open_session@351-383@usr.bin/ssh/ssh-pkcs11.c","usr.bin/ssh/ssh-pkcs11.c","pkcs11_open_session",351,383
28,3,179,4,28,"pkcs11_fetch_keys@395-423@usr.bin/ssh/ssh-pkcs11.c","usr.bin/ssh/ssh-pkcs11.c","pkcs11_fetch_keys",395,423
8,3,61,3,8,"pkcs11_key_included@426-434@usr.bin/ssh/ssh-pkcs11.c","usr.bin/ssh/ssh-pkcs11.c","pkcs11_key_included",426,434
101,30,739,6,116,"pkcs11_fetch_keys_filter@437-553@usr.bin/ssh/ssh-pkcs11.c","usr.bin/ssh/ssh-pkcs11.c","pkcs11_fetch_keys_filter",437,553
119,18,830,3,123,"pkcs11_add_provider@558-681@usr.bin/ssh/ssh-pkcs11.c","usr.bin/ssh/ssh-pkcs11.c","pkcs11_add_provider",558,681
5,1,29,3,4,"pkcs11_add_provider@684-688@usr.bin/ssh/ssh-pkcs11.c","usr.bin/ssh/ssh-pkcs11.c","pkcs11_add_provider",684,688
12,4,34,1,11,"rsa_hash_alg_ident@35-46@usr.bin/ssh/ssh-rsa.c","usr.bin/ssh/ssh-rsa.c","rsa_hash_alg_ident",35,46
11,5,64,1,10,"rsa_hash_alg_from_ident@49-59@usr.bin/ssh/ssh-rsa.c","usr.bin/ssh/ssh-rsa.c","rsa_hash_alg_from_ident",49,59
13,4,37,1,12,"rsa_hash_alg_nid@62-74@usr.bin/ssh/ssh-rsa.c","usr.bin/ssh/ssh-rsa.c","rsa_hash_alg_nid",62,74
29,10,196,1,31,"ssh_rsa_generate_additional_parameters@78-109@usr.bin/ssh/ssh-rsa.c","usr.bin/ssh/ssh-rsa.c","ssh_rsa_generate_additional_parameters",78,109
73,25,495,6,79,"ssh_rsa_sign@113-192@usr.bin/ssh/ssh-rsa.c","usr.bin/ssh/ssh-rsa.c","ssh_rsa_sign",113,192
67,18,429,5,70,"ssh_rsa_verify@195-265@usr.bin/ssh/ssh-rsa.c","usr.bin/ssh/ssh-rsa.c","ssh_rsa_verify",195,265
20,4,84,3,19,"rsa_hash_alg_oid@317-336@usr.bin/ssh/ssh-rsa.c","usr.bin/ssh/ssh-rsa.c","rsa_hash_alg_oid",317,336
48,14,290,6,48,"openssh_RSA_verify@339-387@usr.bin/ssh/ssh-rsa.c","usr.bin/ssh/ssh-rsa.c","openssh_RSA_verify",339,387
13,1,24,1,12,"usage@185-197@usr.bin/ssh/ssh.c","usr.bin/ssh/ssh.c","usage",185,197
10,2,60,2,10,"tilde_expand_paths@205-215@usr.bin/ssh/ssh.c","usr.bin/ssh/ssh.c","tilde_expand_paths",205,215
31,12,237,5,32,"resolve_host@224-256@usr.bin/ssh/ssh.c","usr.bin/ssh/ssh.c","resolve_host",224,256
45,9,296,4,45,"resolve_addr@265-310@usr.bin/ssh/ssh.c","usr.bin/ssh/ssh.c","resolve_addr",265,310
26,10,174,3,30,"check_follow_cname@318-348@usr.bin/ssh/ssh.c","usr.bin/ssh/ssh.c","check_follow_cname",318,348
69,16,451,2,83,"resolve_canonicalize@357-440@usr.bin/ssh/ssh.c","usr.bin/ssh/ssh.c","resolve_canonicalize",357,440
22,9,172,3,24,"process_config_files@447-471@usr.bin/ssh/ssh.c","usr.bin/ssh/ssh.c","process_config_files",447,471
16,4,89,2,16,"set_addrinfo_port@475-491@usr.bin/ssh/ssh.c","usr.bin/ssh/ssh.c","set_addrinfo_port",475,491
735,227,4540,2,947,"main@497-1444@usr.bin/ssh/ssh.c","usr.bin/ssh/ssh.c","main",497,1444
36,10,227,1,44,"control_persist_detach@1447-1491@usr.bin/ssh/ssh.c","usr.bin/ssh/ssh.c","control_persist_detach",1447,1491
9,3,44,1,8,"fork_postauth@1495-1503@usr.bin/ssh/ssh.c","usr.bin/ssh/ssh.c","fork_postauth",1495,1503
45,16,274,4,47,"ssh_confirm_remote_forward@1507-1554@usr.bin/ssh/ssh.c","usr.bin/ssh/ssh.c","ssh_confirm_remote_forward",1507,1554
5,1,26,3,4,"client_cleanup_stdio_fwd@1557-1561@usr.bin/ssh/ssh.c","usr.bin/ssh/ssh.c","client_cleanup_stdio_fwd",1557,1561
5,2,29,4,4,"ssh_stdio_confirm@1564-1568@usr.bin/ssh/ssh.c","usr.bin/ssh/ssh.c","ssh_stdio_confirm",1564,1568
17,5,130,1,19,"ssh_init_stdio_forwarding@1571-1590@usr.bin/ssh/ssh.c","usr.bin/ssh/ssh.c","ssh_init_stdio_forwarding",1571,1590
62,20,447,2,67,"ssh_init_forwarding@1593-1660@usr.bin/ssh/ssh.c","usr.bin/ssh/ssh.c","ssh_init_forwarding",1593,1660
12,4,54,1,13,"check_agent_present@1663-1676@usr.bin/ssh/ssh.c","usr.bin/ssh/ssh.c","check_agent_present",1663,1676
32,7,218,4,39,"ssh_session2_setup@1679-1718@usr.bin/ssh/ssh.c","usr.bin/ssh/ssh.c","ssh_session2_setup",1679,1718
36,10,215,1,43,"ssh_session2_open@1722-1765@usr.bin/ssh/ssh.c","usr.bin/ssh/ssh.c","ssh_session2_open",1722,1765
79,24,453,2,116,"ssh_session2@1768-1884@usr.bin/ssh/ssh.c","usr.bin/ssh/ssh.c","ssh_session2",1768,1884
115,23,810,1,131,"load_public_identity_files@1888-2019@usr.bin/ssh/ssh.c","usr.bin/ssh/ssh.c","load_public_identity_files",1888,2019
11,4,59,1,12,"main_sigchld_handler@2022-2034@usr.bin/ssh/ssh.c","usr.bin/ssh/ssh.c","main_sigchld_handler",2022,2034
5,1,37,7,4,"mm_sshkey_sign@56-60@usr.bin/ssh/ssh_api.c","usr.bin/ssh/ssh_api.c","mm_sshkey_sign",56,60
4,1,18,3,3,"mm_choose_dh@63-66@usr.bin/ssh/ssh_api.c","usr.bin/ssh/ssh_api.c","mm_choose_dh",63,66
49,9,389,3,56,"ssh_init@71-127@usr.bin/ssh/ssh_api.c","usr.bin/ssh/ssh_api.c","ssh_init",71,127
18,6,126,1,22,"ssh_free@130-152@usr.bin/ssh/ssh_api.c","usr.bin/ssh/ssh_api.c","ssh_free",130,152
4,1,19,2,3,"ssh_set_app_data@155-158@usr.bin/ssh/ssh_api.c","usr.bin/ssh/ssh_api.c","ssh_set_app_data",155,158
4,1,14,1,3,"ssh_get_app_data@161-164@usr.bin/ssh/ssh_api.c","usr.bin/ssh/ssh_api.c","ssh_get_app_data",161,164
28,6,200,2,31,"ssh_add_hostkey@168-199@usr.bin/ssh/ssh_api.c","usr.bin/ssh/ssh_api.c","ssh_add_hostkey",168,199
8,3,50,2,9,"ssh_set_verify_host_key_callback@202-211@usr.bin/ssh/ssh_api.c","usr.bin/ssh/ssh_api.c","ssh_set_verify_host_key_callback",202,211
4,1,30,3,3,"ssh_input_append@214-217@usr.bin/ssh/ssh_api.c","usr.bin/ssh/ssh_api.c","ssh_input_append",214,217
23,11,148,2,38,"ssh_packet_next@220-258@usr.bin/ssh/ssh_api.c","usr.bin/ssh/ssh_api.c","ssh_packet_next",220,258
4,1,21,2,3,"ssh_packet_payload@261-264@usr.bin/ssh/ssh_api.c","usr.bin/ssh/ssh_api.c","ssh_packet_payload",261,264
9,4,70,4,9,"ssh_packet_put@267-276@usr.bin/ssh/ssh_api.c","usr.bin/ssh/ssh_api.c","ssh_packet_put",267,276
6,1,37,2,6,"ssh_output_ptr@279-285@usr.bin/ssh/ssh_api.c","usr.bin/ssh/ssh_api.c","ssh_output_ptr",279,285
4,1,23,2,3,"ssh_output_consume@288-291@usr.bin/ssh/ssh_api.c","usr.bin/ssh/ssh_api.c","ssh_output_consume",288,291
4,1,27,2,3,"ssh_output_space@294-297@usr.bin/ssh/ssh_api.c","usr.bin/ssh/ssh_api.c","ssh_output_space",294,297
4,1,27,2,3,"ssh_input_space@300-303@usr.bin/ssh/ssh_api.c","usr.bin/ssh/ssh_api.c","ssh_input_space",300,303
58,16,392,2,64,"_ssh_read_banner@307-371@usr.bin/ssh/ssh_api.c","usr.bin/ssh/ssh_api.c","_ssh_read_banner",307,371
13,3,92,2,13,"_ssh_send_banner@375-388@usr.bin/ssh/ssh_api.c","usr.bin/ssh/ssh_api.c","_ssh_send_banner",375,388
30,15,191,1,36,"_ssh_exchange_banner@391-427@usr.bin/ssh/ssh_api.c","usr.bin/ssh/ssh_api.c","_ssh_exchange_banner",391,427
12,4,92,3,12,"_ssh_host_public_key@430-442@usr.bin/ssh/ssh_api.c","usr.bin/ssh/ssh_api.c","_ssh_host_public_key",430,442
12,4,92,3,12,"_ssh_host_private_key@445-457@usr.bin/ssh/ssh_api.c","usr.bin/ssh/ssh_api.c","_ssh_host_private_key",445,457
11,2,80,2,11,"_ssh_verify_host_key@460-471@usr.bin/ssh/ssh_api.c","usr.bin/ssh/ssh_api.c","_ssh_verify_host_key",460,471
48,12,336,1,49,"_ssh_order_hostkeyalgs@475-524@usr.bin/ssh/ssh_api.c","usr.bin/ssh/ssh_api.c","_ssh_order_hostkeyalgs",475,524
6,1,56,8,5,"_ssh_host_key_sign@527-532@usr.bin/ssh/ssh_api.c","usr.bin/ssh/ssh_api.c","_ssh_host_key_sign",527,532
10,4,69,3,10,"sshbuf_get@30-40@usr.bin/ssh/sshbuf-getput-basic.c","usr.bin/ssh/sshbuf-getput-basic.c","sshbuf_get",30,40
10,3,61,2,10,"sshbuf_get_u64@43-53@usr.bin/ssh/sshbuf-getput-basic.c","usr.bin/ssh/sshbuf-getput-basic.c","sshbuf_get_u64",43,53
10,3,61,2,10,"sshbuf_get_u32@56-66@usr.bin/ssh/sshbuf-getput-basic.c","usr.bin/ssh/sshbuf-getput-basic.c","sshbuf_get_u32",56,66
10,3,61,2,10,"sshbuf_get_u16@69-79@usr.bin/ssh/sshbuf-getput-basic.c","usr.bin/ssh/sshbuf-getput-basic.c","sshbuf_get_u16",69,79
10,3,62,2,10,"sshbuf_get_u8@82-92@usr.bin/ssh/sshbuf-getput-basic.c","usr.bin/ssh/sshbuf-getput-basic.c","sshbuf_get_u8",82,92
24,8,148,3,24,"sshbuf_get_string@95-119@usr.bin/ssh/sshbuf-getput-basic.c","usr.bin/ssh/sshbuf-getput-basic.c","sshbuf_get_string",95,119
22,7,127,3,23,"sshbuf_get_string_direct@122-145@usr.bin/ssh/sshbuf-getput-basic.c","usr.bin/ssh/sshbuf-getput-basic.c","sshbuf_get_string_direct",122,145
28,8,152,3,28,"sshbuf_peek_string_direct@148-176@usr.bin/ssh/sshbuf-getput-basic.c","usr.bin/ssh/sshbuf-getput-basic.c","sshbuf_peek_string_direct",148,176
31,11,212,3,32,"sshbuf_get_cstring@179-211@usr.bin/ssh/sshbuf-getput-basic.c","usr.bin/ssh/sshbuf-getput-basic.c","sshbuf_get_cstring",179,211
12,5,92,2,17,"sshbuf_get_stringb@214-231@usr.bin/ssh/sshbuf-getput-basic.c","usr.bin/ssh/sshbuf-getput-basic.c","sshbuf_get_stringb",214,231
10,3,63,3,10,"sshbuf_put@234-244@usr.bin/ssh/sshbuf-getput-basic.c","usr.bin/ssh/sshbuf-getput-basic.c","sshbuf_put",234,244
4,1,31,2,3,"sshbuf_putb@247-250@usr.bin/ssh/sshbuf-getput-basic.c","usr.bin/ssh/sshbuf-getput-basic.c","sshbuf_putb",247,250
9,1,48,3,9,"sshbuf_putf@253-262@usr.bin/ssh/sshbuf-getput-basic.c","usr.bin/ssh/sshbuf-getput-basic.c","sshbuf_putf",253,262
29,6,183,3,30,"sshbuf_putfv@265-295@usr.bin/ssh/sshbuf-getput-basic.c","usr.bin/ssh/sshbuf-getput-basic.c","sshbuf_putfv",265,295
9,2,50,2,9,"sshbuf_put_u64@298-307@usr.bin/ssh/sshbuf-getput-basic.c","usr.bin/ssh/sshbuf-getput-basic.c","sshbuf_put_u64",298,307
9,2,50,2,9,"sshbuf_put_u32@310-319@usr.bin/ssh/sshbuf-getput-basic.c","usr.bin/ssh/sshbuf-getput-basic.c","sshbuf_put_u32",310,319
9,2,50,2,9,"sshbuf_put_u16@322-331@usr.bin/ssh/sshbuf-getput-basic.c","usr.bin/ssh/sshbuf-getput-basic.c","sshbuf_put_u16",322,331
9,2,50,2,9,"sshbuf_put_u8@334-343@usr.bin/ssh/sshbuf-getput-basic.c","usr.bin/ssh/sshbuf-getput-basic.c","sshbuf_put_u8",334,343
15,4,94,3,15,"sshbuf_put_string@346-361@usr.bin/ssh/sshbuf-getput-basic.c","usr.bin/ssh/sshbuf-getput-basic.c","sshbuf_put_string",346,361
4,2,33,2,3,"sshbuf_put_cstring@364-367@usr.bin/ssh/sshbuf-getput-basic.c","usr.bin/ssh/sshbuf-getput-basic.c","sshbuf_put_cstring",364,367
4,1,31,2,3,"sshbuf_put_stringb@370-373@usr.bin/ssh/sshbuf-getput-basic.c","usr.bin/ssh/sshbuf-getput-basic.c","sshbuf_put_stringb",370,373
21,7,136,2,21,"sshbuf_froms@376-397@usr.bin/ssh/sshbuf-getput-basic.c","usr.bin/ssh/sshbuf-getput-basic.c","sshbuf_froms",376,397
21,8,161,3,26,"sshbuf_put_bignum2_bytes@400-426@usr.bin/ssh/sshbuf-getput-basic.c","usr.bin/ssh/sshbuf-getput-basic.c","sshbuf_put_bignum2_bytes",400,426
29,12,174,3,33,"sshbuf_get_bignum2_bytes_direct@429-462@usr.bin/ssh/sshbuf-getput-basic.c","usr.bin/ssh/sshbuf-getput-basic.c","sshbuf_get_bignum2_bytes_direct",429,462
11,4,69,2,11,"sshbuf_get_bignum2@31-42@usr.bin/ssh/sshbuf-getput-crypto.c","usr.bin/ssh/sshbuf-getput-crypto.c","sshbuf_get_bignum2",31,42
22,7,136,2,23,"sshbuf_get_bignum1@45-68@usr.bin/ssh/sshbuf-getput-crypto.c","usr.bin/ssh/sshbuf-getput-crypto.c","sshbuf_get_bignum1",45,68
10,6,71,4,11,"get_ec@71-82@usr.bin/ssh/sshbuf-getput-crypto.c","usr.bin/ssh/sshbuf-getput-crypto.c","get_ec",71,82
16,4,105,3,18,"sshbuf_get_ec@85-103@usr.bin/ssh/sshbuf-getput-crypto.c","usr.bin/ssh/sshbuf-getput-crypto.c","sshbuf_get_ec",85,103
30,6,173,2,32,"sshbuf_get_eckey@106-138@usr.bin/ssh/sshbuf-getput-crypto.c","usr.bin/ssh/sshbuf-getput-crypto.c","sshbuf_get_eckey",106,138
18,7,142,2,19,"sshbuf_put_bignum2@141-160@usr.bin/ssh/sshbuf-getput-crypto.c","usr.bin/ssh/sshbuf-getput-crypto.c","sshbuf_put_bignum2",141,160
19,6,146,2,19,"sshbuf_put_bignum1@163-182@usr.bin/ssh/sshbuf-getput-crypto.c","usr.bin/ssh/sshbuf-getput-crypto.c","sshbuf_put_bignum1",163,182
23,4,138,3,23,"sshbuf_put_ec@185-208@usr.bin/ssh/sshbuf-getput-crypto.c","usr.bin/ssh/sshbuf-getput-crypto.c","sshbuf_put_ec",185,208
5,1,30,2,4,"sshbuf_put_eckey@211-215@usr.bin/ssh/sshbuf-getput-crypto.c","usr.bin/ssh/sshbuf-getput-crypto.c","sshbuf_put_eckey",211,215
24,8,178,3,24,"sshbuf_dump_data@35-59@usr.bin/ssh/sshbuf-misc.c","usr.bin/ssh/sshbuf-misc.c","sshbuf_dump_data",35,59
5,1,42,2,4,"sshbuf_dump@62-66@usr.bin/ssh/sshbuf-misc.c","usr.bin/ssh/sshbuf-misc.c","sshbuf_dump",62,66
17,5,145,1,17,"sshbuf_dtob16@69-86@usr.bin/ssh/sshbuf-misc.c","usr.bin/ssh/sshbuf-misc.c","sshbuf_dtob16",69,86
18,5,126,1,18,"sshbuf_dtob64@89-107@usr.bin/ssh/sshbuf-misc.c","usr.bin/ssh/sshbuf-misc.c","sshbuf_dtob64",89,107
23,5,139,2,23,"sshbuf_b64tod@110-133@usr.bin/ssh/sshbuf-misc.c","usr.bin/ssh/sshbuf-misc.c","sshbuf_b64tod",110,133
19,7,131,1,20,"sshbuf_dup_string@136-156@usr.bin/ssh/sshbuf-misc.c","usr.bin/ssh/sshbuf-misc.c","sshbuf_dup_string",136,156
19,14,132,1,19,"sshbuf_check_sanity@30-49@usr.bin/ssh/sshbuf.c","usr.bin/ssh/sshbuf.c","sshbuf_check_sanity",30,49
14,7,112,2,13,"sshbuf_maybe_pack@52-65@usr.bin/ssh/sshbuf.c","usr.bin/ssh/sshbuf.c","sshbuf_maybe_pack",52,65
16,3,99,1,16,"sshbuf_new@68-84@usr.bin/ssh/sshbuf.c","usr.bin/ssh/sshbuf.c","sshbuf_new",68,84
14,4,94,2,14,"sshbuf_from@87-101@usr.bin/ssh/sshbuf.c","usr.bin/ssh/sshbuf.c","sshbuf_from",87,101
10,3,60,2,10,"sshbuf_set_parent@104-114@usr.bin/ssh/sshbuf.c","usr.bin/ssh/sshbuf.c","sshbuf_set_parent",104,114
13,4,74,1,13,"sshbuf_fromb@117-130@usr.bin/ssh/sshbuf.c","usr.bin/ssh/sshbuf.c","sshbuf_fromb",117,130
11,2,79,1,10,"sshbuf_init@133-143@usr.bin/ssh/sshbuf.c","usr.bin/ssh/sshbuf.c","sshbuf_init",133,143
21,6,115,1,36,"sshbuf_free@146-182@usr.bin/ssh/sshbuf.c","usr.bin/ssh/sshbuf.c","sshbuf_free",146,182
18,5,115,1,19,"sshbuf_reset@185-204@usr.bin/ssh/sshbuf.c","usr.bin/ssh/sshbuf.c","sshbuf_reset",185,204
4,1,15,1,3,"sshbuf_max_size@207-210@usr.bin/ssh/sshbuf.c","usr.bin/ssh/sshbuf.c","sshbuf_max_size",207,210
4,1,15,1,3,"sshbuf_alloc@213-216@usr.bin/ssh/sshbuf.c","usr.bin/ssh/sshbuf.c","sshbuf_alloc",213,216
4,1,15,1,3,"sshbuf_parent@219-222@usr.bin/ssh/sshbuf.c","usr.bin/ssh/sshbuf.c","sshbuf_parent",219,222
4,1,15,1,3,"sshbuf_refcount@225-228@usr.bin/ssh/sshbuf.c","usr.bin/ssh/sshbuf.c","sshbuf_refcount",225,228
34,12,221,2,35,"sshbuf_set_max_size@231-266@usr.bin/ssh/sshbuf.c","usr.bin/ssh/sshbuf.c","sshbuf_set_max_size",231,266
6,2,31,1,5,"sshbuf_len@269-274@usr.bin/ssh/sshbuf.c","usr.bin/ssh/sshbuf.c","sshbuf_len",269,274
6,4,47,1,5,"sshbuf_avail@277-282@usr.bin/ssh/sshbuf.c","usr.bin/ssh/sshbuf.c","sshbuf_avail",277,282
6,2,31,1,5,"sshbuf_ptr@285-290@usr.bin/ssh/sshbuf.c","usr.bin/ssh/sshbuf.c","sshbuf_ptr",285,290
6,4,41,1,5,"sshbuf_mutable_ptr@293-298@usr.bin/ssh/sshbuf.c","usr.bin/ssh/sshbuf.c","sshbuf_mutable_ptr",293,298
12,6,80,2,13,"sshbuf_check_reserve@301-314@usr.bin/ssh/sshbuf.c","usr.bin/ssh/sshbuf.c","sshbuf_check_reserve",301,314
30,6,228,2,40,"sshbuf_allocate@317-357@usr.bin/ssh/sshbuf.c","usr.bin/ssh/sshbuf.c","sshbuf_allocate",317,357
15,4,93,3,17,"sshbuf_reserve@360-377@usr.bin/ssh/sshbuf.c","usr.bin/ssh/sshbuf.c","sshbuf_reserve",360,377
16,5,95,2,17,"sshbuf_consume@380-397@usr.bin/ssh/sshbuf.c","usr.bin/ssh/sshbuf.c","sshbuf_consume",380,397
14,4,75,2,14,"sshbuf_consume_end@400-414@usr.bin/ssh/sshbuf.c","usr.bin/ssh/sshbuf.c","sshbuf_consume_end",400,414
7,2,35,1,7,"close_listen_socks@230-237@usr.bin/ssh/sshd.c","usr.bin/ssh/sshd.c","close_listen_socks",230,237
8,4,46,1,8,"close_startup_pipes@240-248@usr.bin/ssh/sshd.c","usr.bin/ssh/sshd.c","close_startup_pipes",240,248
7,1,27,1,7,"sighup_handler@258-265@usr.bin/ssh/sshd.c","usr.bin/ssh/sshd.c","sighup_handler",258,265
14,2,76,1,13,"sighup_restart@272-285@usr.bin/ssh/sshd.c","usr.bin/ssh/sshd.c","sighup_restart",272,285
4,1,11,1,3,"sigterm_handler@292-295@usr.bin/ssh/sshd.c","usr.bin/ssh/sshd.c","sigterm_handler",292,295
11,4,59,1,12,"main_sigchld_handler@303-315@usr.bin/ssh/sshd.c","usr.bin/ssh/sshd.c","main_sigchld_handler",303,315
11,5,72,1,17,"grace_alarm_handler@322-339@usr.bin/ssh/sshd.c","usr.bin/ssh/sshd.c","grace_alarm_handler",322,339
89,17,560,3,103,"sshd_exchange_identification@342-445@usr.bin/ssh/sshd.c","usr.bin/ssh/sshd.c","sshd_exchange_identification",342,445
14,4,86,1,14,"destroy_sensitive_data@449-463@usr.bin/ssh/sshd.c","usr.bin/ssh/sshd.c","destroy_sensitive_data",449,463
12,3,73,1,13,"demote_sensitive_data@467-480@usr.bin/ssh/sshd.c","usr.bin/ssh/sshd.c","demote_sensitive_data",467,480
27,9,185,1,43,"privsep_preauth_child@483-526@usr.bin/ssh/sshd.c","usr.bin/ssh/sshd.c","privsep_preauth_child",483,526
55,14,318,1,66,"privsep_preauth@529-595@usr.bin/ssh/sshd.c","usr.bin/ssh/sshd.c","privsep_preauth",529,595
25,4,134,1,44,"privsep_postauth@598-642@usr.bin/ssh/sshd.c","usr.bin/ssh/sshd.c","privsep_postauth",598,642
56,18,320,1,60,"list_hostkey_types@645-705@usr.bin/ssh/sshd.c","usr.bin/ssh/sshd.c","list_hostkey_types",645,705
25,13,144,4,25,"get_hostkey_by_type@708-733@usr.bin/ssh/sshd.c","usr.bin/ssh/sshd.c","get_hostkey_by_type",708,733
4,1,27,3,3,"get_hostkey_public_by_type@736-739@usr.bin/ssh/sshd.c","usr.bin/ssh/sshd.c","get_hostkey_public_by_type",736,739
4,1,27,3,3,"get_hostkey_private_by_type@742-745@usr.bin/ssh/sshd.c","usr.bin/ssh/sshd.c","get_hostkey_private_by_type",742,745
6,3,37,1,5,"get_hostkey_by_index@748-753@usr.bin/ssh/sshd.c","usr.bin/ssh/sshd.c","get_hostkey_by_index",748,753
6,3,42,2,5,"get_hostkey_public_by_index@756-761@usr.bin/ssh/sshd.c","usr.bin/ssh/sshd.c","get_hostkey_public_by_index",756,761
23,15,172,3,23,"get_hostkey_index@764-787@usr.bin/ssh/sshd.c","usr.bin/ssh/sshd.c","get_hostkey_index",764,787
39,10,243,1,41,"notify_hostkeys@791-832@usr.bin/ssh/sshd.c","usr.bin/ssh/sshd.c","notify_hostkeys",791,832
17,5,104,1,19,"drop_connection@841-860@usr.bin/ssh/sshd.c","usr.bin/ssh/sshd.c","drop_connection",841,860
14,2,35,1,16,"usage@863-879@usr.bin/ssh/sshd.c","usr.bin/ssh/sshd.c","usage",863,879
15,4,113,2,22,"send_rexec_state@882-904@usr.bin/ssh/sshd.c","usr.bin/ssh/sshd.c","send_rexec_state",882,904
18,4,117,2,23,"recv_rexec_state@907-930@usr.bin/ssh/sshd.c","usr.bin/ssh/sshd.c","recv_rexec_state",907,930
25,7,154,2,30,"server_accept_inetd@934-964@usr.bin/ssh/sshd.c","usr.bin/ssh/sshd.c","server_accept_inetd",934,964
57,15,365,1,65,"listen_on_addrs@970-1035@usr.bin/ssh/sshd.c","usr.bin/ssh/sshd.c","listen_on_addrs",970,1035
16,3,113,1,17,"server_listen@1038-1055@usr.bin/ssh/sshd.c","usr.bin/ssh/sshd.c","server_listen",1038,1055
146,41,950,4,196,"server_accept_loop@1062-1258@usr.bin/ssh/sshd.c","usr.bin/ssh/sshd.c","server_accept_loop",1062,1258
24,6,190,1,26,"check_ip_options@1272-1298@usr.bin/ssh/sshd.c","usr.bin/ssh/sshd.c","check_ip_options",1272,1298
18,7,132,2,21,"set_process_rdomain@1302-1323@usr.bin/ssh/sshd.c","usr.bin/ssh/sshd.c","set_process_rdomain",1302,1323
462,142,2862,2,654,"main@1329-1983@usr.bin/ssh/sshd.c","usr.bin/ssh/sshd.c","main",1329,1983
26,8,181,8,26,"sshd_hostkey_sign@1986-2012@usr.bin/ssh/sshd.c","usr.bin/ssh/sshd.c","sshd_hostkey_sign",1986,2012
50,7,334,1,63,"do_ssh2_kex@2016-2079@usr.bin/ssh/sshd.c","usr.bin/ssh/sshd.c","do_ssh2_kex",2016,2079
16,8,92,1,16,"cleanup_exit@2083-2099@usr.bin/ssh/sshd.c","usr.bin/ssh/sshd.c","cleanup_exit",2083,2099
6,2,36,2,5,"verify_host_key_callback@90-95@usr.bin/ssh/sshconnect2.c","usr.bin/ssh/sshconnect2.c","verify_host_key_callback",90,95
38,10,314,3,51,"order_hostkeyalgs@98-149@usr.bin/ssh/sshconnect2.c","usr.bin/ssh/sshconnect2.c","order_hostkeyalgs",98,149
62,11,442,3,78,"ssh_kex2@152-230@usr.bin/ssh/sshconnect2.c","usr.bin/ssh/sshconnect2.c","ssh_kex2",152,230
42,8,323,4,48,"ssh_userauth2@357-405@usr.bin/ssh/sshconnect2.c","usr.bin/ssh/sshconnect2.c","ssh_userauth2",357,405
25,4,157,3,29,"input_userauth_service_accept@409-438@usr.bin/ssh/sshconnect2.c","usr.bin/ssh/sshconnect2.c","input_userauth_service_accept",409,438
4,1,25,3,3,"input_userauth_ext_info@442-445@usr.bin/ssh/sshconnect2.c","usr.bin/ssh/sshconnect2.c","input_userauth_ext_info",442,445
29,7,170,2,33,"userauth@448-481@usr.bin/ssh/sshconnect2.c","usr.bin/ssh/sshconnect2.c","userauth",448,481
6,1,26,3,5,"input_userauth_error@485-490@usr.bin/ssh/sshconnect2.c","usr.bin/ssh/sshconnect2.c","input_userauth_error",485,490
13,3,81,3,13,"input_userauth_banner@494-507@usr.bin/ssh/sshconnect2.c","usr.bin/ssh/sshconnect2.c","input_userauth_banner",494,507
14,4,94,3,14,"input_userauth_success@511-525@usr.bin/ssh/sshconnect2.c","usr.bin/ssh/sshconnect2.c","input_userauth_success",511,525
9,2,50,3,10,"input_userauth_success_unexpected@528-538@usr.bin/ssh/sshconnect2.c","usr.bin/ssh/sshconnect2.c","input_userauth_success_unexpected",528,538
18,3,95,3,22,"input_userauth_failure@542-564@usr.bin/ssh/sshconnect2.c","usr.bin/ssh/sshconnect2.c","input_userauth_failure",542,564
59,10,348,3,70,"input_userauth_pk_ok@568-638@usr.bin/ssh/sshconnect2.c","usr.bin/ssh/sshconnect2.c","input_userauth_pk_ok",568,638
39,7,252,1,54,"userauth_gssapi@642-696@usr.bin/ssh/sshconnect2.c","usr.bin/ssh/sshconnect2.c","userauth_gssapi",642,696
41,6,250,2,51,"process_gssapi_token@699-750@usr.bin/ssh/sshconnect2.c","usr.bin/ssh/sshconnect2.c","process_gssapi_token",699,750
29,7,165,3,37,"input_gssapi_response@754-791@usr.bin/ssh/sshconnect2.c","usr.bin/ssh/sshconnect2.c","input_gssapi_response",754,791
19,3,102,3,25,"input_gssapi_token@795-820@usr.bin/ssh/sshconnect2.c","usr.bin/ssh/sshconnect2.c","input_gssapi_token",795,820
20,2,117,3,27,"input_gssapi_errtok@824-851@usr.bin/ssh/sshconnect2.c","usr.bin/ssh/sshconnect2.c","input_gssapi_errtok",824,851
14,1,75,3,16,"input_gssapi_error@855-871@usr.bin/ssh/sshconnect2.c","usr.bin/ssh/sshconnect2.c","input_gssapi_error",855,871
9,1,43,1,9,"userauth_none@875-884@usr.bin/ssh/sshconnect2.c","usr.bin/ssh/sshconnect2.c","userauth_none",875,884
28,4,164,1,32,"userauth_passwd@887-919@usr.bin/ssh/sshconnect2.c","usr.bin/ssh/sshconnect2.c","userauth_passwd",887,919
60,7,371,3,64,"input_userauth_passwd_changereq@926-990@usr.bin/ssh/sshconnect2.c","usr.bin/ssh/sshconnect2.c","input_userauth_passwd_changereq",926,990
13,4,55,1,13,"key_sign_encode@993-1006@usr.bin/ssh/sshconnect2.c","usr.bin/ssh/sshconnect2.c","key_sign_encode",993,1006
24,9,213,6,32,"identity_sign@1009-1041@usr.bin/ssh/sshconnect2.c","usr.bin/ssh/sshconnect2.c","identity_sign",1009,1041
16,7,148,2,16,"id_filename_matches@1044-1060@usr.bin/ssh/sshconnect2.c","usr.bin/ssh/sshconnect2.c","id_filename_matches",1044,1060
105,23,710,2,133,"sign_and_send_pubkey@1063-1196@usr.bin/ssh/sshconnect2.c","usr.bin/ssh/sshconnect2.c","sign_and_send_pubkey",1063,1196
22,3,134,2,26,"send_pubkey_test@1199-1225@usr.bin/ssh/sshconnect2.c","usr.bin/ssh/sshconnect2.c","send_pubkey_test",1199,1225
62,20,356,1,63,"load_identity_file@1228-1291@usr.bin/ssh/sshconnect2.c","usr.bin/ssh/sshconnect2.c","load_identity_file",1228,1291
117,30,911,1,131,"pubkey_prepare@1302-1433@usr.bin/ssh/sshconnect2.c","usr.bin/ssh/sshconnect2.c","pubkey_prepare",1302,1433
13,3,85,1,13,"pubkey_cleanup@1436-1449@usr.bin/ssh/sshconnect2.c","usr.bin/ssh/sshconnect2.c","pubkey_cleanup",1436,1449
6,1,29,1,6,"pubkey_reset@1452-1458@usr.bin/ssh/sshconnect2.c","usr.bin/ssh/sshconnect2.c","pubkey_reset",1452,1458
12,4,67,1,11,"try_identity@1461-1472@usr.bin/ssh/sshconnect2.c","usr.bin/ssh/sshconnect2.c","try_identity",1461,1472
43,9,245,1,49,"userauth_pubkey@1475-1524@usr.bin/ssh/sshconnect2.c","usr.bin/ssh/sshconnect2.c","userauth_pubkey",1475,1524
22,5,120,1,25,"userauth_kbdint@1530-1555@usr.bin/ssh/sshconnect2.c","usr.bin/ssh/sshconnect2.c","userauth_kbdint",1530,1555
38,6,244,3,52,"input_userauth_info_req@1561-1613@usr.bin/ssh/sshconnect2.c","usr.bin/ssh/sshconnect2.c","input_userauth_info_req",1561,1613
105,22,777,5,112,"ssh_keysign@1616-1728@usr.bin/ssh/sshconnect2.c","usr.bin/ssh/sshconnect2.c","ssh_keysign",1616,1728
120,41,964,1,143,"userauth_hostbased@1731-1874@usr.bin/ssh/sshconnect2.c","usr.bin/ssh/sshconnect2.c","userauth_hostbased",1731,1874
10,6,56,1,11,"authmethod_is_enabled@1883-1894@usr.bin/ssh/sshconnect2.c","usr.bin/ssh/sshconnect2.c","authmethod_is_enabled",1883,1894
10,5,66,1,9,"authmethod_lookup@1897-1906@usr.bin/ssh/sshconnect2.c","usr.bin/ssh/sshconnect2.c","authmethod_lookup",1897,1906
34,11,208,1,37,"authmethod_get@1919-1956@usr.bin/ssh/sshconnect2.c","usr.bin/ssh/sshconnect2.c","authmethod_get",1919,1956
18,5,118,1,18,"authmethods_get@1959-1977@usr.bin/ssh/sshconnect2.c","usr.bin/ssh/sshconnect2.c","authmethods_get",1959,1977
123,59,369,1,122,"ssh_err@23-145@usr.bin/ssh/ssherr.c","usr.bin/ssh/ssherr.c","ssh_err",23,145
9,3,52,1,9,"sshkey_type@107-116@usr.bin/ssh/sshkey.c","usr.bin/ssh/sshkey.c","sshkey_type",107,116
9,5,64,2,9,"sshkey_ssh_name_from_type_nid@119-128@usr.bin/ssh/sshkey.c","usr.bin/ssh/sshkey.c","sshkey_ssh_name_from_type_nid",119,128
9,3,47,1,9,"sshkey_type_is_cert@131-140@usr.bin/ssh/sshkey.c","usr.bin/ssh/sshkey.c","sshkey_type_is_cert",131,140
4,1,22,1,3,"sshkey_ssh_name@143-146@usr.bin/ssh/sshkey.c","usr.bin/ssh/sshkey.c","sshkey_ssh_name",143,146
5,1,25,1,4,"sshkey_ssh_name_plain@149-153@usr.bin/ssh/sshkey.c","usr.bin/ssh/sshkey.c","sshkey_ssh_name_plain",149,153
10,6,80,1,11,"sshkey_type_from_name@156-167@usr.bin/ssh/sshkey.c","usr.bin/ssh/sshkey.c","sshkey_type_from_name",156,167
11,6,77,1,11,"sshkey_ecdsa_nid_from_name@170-181@usr.bin/ssh/sshkey.c","usr.bin/ssh/sshkey.c","sshkey_ecdsa_nid_from_name",170,181
25,11,176,4,25,"sshkey_alg_list@184-209@usr.bin/ssh/sshkey.c","usr.bin/ssh/sshkey.c","sshkey_alg_list",184,209
29,11,185,2,34,"sshkey_names_valid2@212-246@usr.bin/ssh/sshkey.c","usr.bin/ssh/ssh