11,4,68,1,12,"file@105-117@usr.sbin/ac/ac.c","usr.sbin/ac/ac.c","file",105,117
21,4,136,1,22,"add_tty@120-142@usr.sbin/ac/ac.c","usr.sbin/ac/ac.c","add_tty",120,142
17,6,111,1,17,"do_tty@148-165@usr.sbin/ac/ac.c","usr.sbin/ac/ac.c","do_tty",148,165
20,5,144,3,24,"update_user@171-195@usr.sbin/ac/ac.c","usr.sbin/ac/ac.c","update_user",171,195
46,16,218,2,57,"main@198-255@usr.sbin/ac/ac.c","usr.sbin/ac/ac.c","main",198,255
5,1,32,2,4,"show@261-265@usr.sbin/ac/ac.c","usr.sbin/ac/ac.c","show",261,265
6,2,39,1,6,"show_users@268-274@usr.sbin/ac/ac.c","usr.sbin/ac/ac.c","show_users",268,274
22,4,172,3,25,"show_today@280-305@usr.sbin/ac/ac.c","usr.sbin/ac/ac.c","show_today",280,305
28,8,222,2,33,"log_out@313-346@usr.sbin/ac/ac.c","usr.sbin/ac/ac.c","log_out",313,346
21,7,172,2,42,"log_in@353-395@usr.sbin/ac/ac.c","usr.sbin/ac/ac.c","log_in",353,395
73,21,486,1,91,"ac@398-489@usr.sbin/ac/ac.c","usr.sbin/ac/ac.c","ac",398,489
7,1,29,1,6,"usage@492-498@usr.sbin/ac/ac.c","usr.sbin/ac/ac.c","usage",492,498
5,1,18,1,4,"usage@40-44@usr.sbin/accton/accton.c","usr.sbin/accton/accton.c","usage",40,44
25,7,116,2,26,"main@47-73@usr.sbin/accton/accton.c","usr.sbin/accton/accton.c","main",47,73
21,4,119,1,27,"bn2string@40-67@usr.sbin/acme-client/acctproc.c","usr.sbin/acme-client/acctproc.c","bn2string",40,67
16,5,122,1,17,"op_thumb_rsa@74-91@usr.sbin/acme-client/acctproc.c","usr.sbin/acme-client/acctproc.c","op_thumb_rsa",74,91
45,11,289,2,57,"op_thumbprint@97-154@usr.sbin/acme-client/acctproc.c","usr.sbin/acme-client/acctproc.c","op_thumbprint",97,154
23,6,175,4,31,"op_sign_rsa@157-188@usr.sbin/acme-client/acctproc.c","usr.sbin/acme-client/acctproc.c","op_sign_rsa",157,188
77,17,527,2,105,"op_sign@195-300@usr.sbin/acme-client/acctproc.c","usr.sbin/acme-client/acctproc.c","op_sign",195,300
72,21,390,3,98,"acctproc@303-401@usr.sbin/acme-client/acctproc.c","usr.sbin/acme-client/acctproc.c","acctproc",303,401
4,1,20,1,4,"base64len@30-34@usr.sbin/acme-client/base64.c","usr.sbin/acme-client/base64.c","base64len",30,34
22,6,116,2,25,"base64buf_url@42-67@usr.sbin/acme-client/base64.c","usr.sbin/acme-client/base64.c","base64buf_url",42,67
28,6,164,2,38,"x509buf@39-77@usr.sbin/acme-client/certproc.c","usr.sbin/acme-client/certproc.c","x509buf",39,77
110,32,740,2,164,"certproc@80-244@usr.sbin/acme-client/certproc.c","usr.sbin/acme-client/certproc.c","certproc",80,244
87,22,585,2,121,"chngproc@30-151@usr.sbin/acme-client/chngproc.c","usr.sbin/acme-client/chngproc.c","chngproc",30,151
9,2,41,2,10,"doddbg@25-35@usr.sbin/acme-client/dbg.c","usr.sbin/acme-client/dbg.c","doddbg",25,35
9,2,40,2,10,"dodbg@38-48@usr.sbin/acme-client/dbg.c","usr.sbin/acme-client/dbg.c","dodbg",38,48
44,10,276,2,56,"host_dns@54-110@usr.sbin/acme-client/dnsproc.c","usr.sbin/acme-client/dnsproc.c","host_dns",54,110
55,16,331,1,73,"dnsproc@113-186@usr.sbin/acme-client/dnsproc.c","usr.sbin/acme-client/dnsproc.c","dnsproc",113,186
25,7,190,6,31,"serialise@30-61@usr.sbin/acme-client/fileproc.c","usr.sbin/acme-client/fileproc.c","serialise",30,61
105,33,627,5,158,"fileproc@64-222@usr.sbin/acme-client/fileproc.c","usr.sbin/acme-client/fileproc.c","fileproc",64,222
8,2,53,3,8,"dosysread@72-80@usr.sbin/acme-client/http.c","usr.sbin/acme-client/http.c","dosysread",72,80
8,2,54,3,8,"dosyswrite@83-91@usr.sbin/acme-client/http.c","usr.sbin/acme-client/http.c","dosyswrite",83,91
11,4,74,3,12,"dotlsread@94-106@usr.sbin/acme-client/http.c","usr.sbin/acme-client/http.c","dotlsread",94,106
11,4,75,3,12,"dotlswrite@109-121@usr.sbin/acme-client/http.c","usr.sbin/acme-client/http.c","dotlswrite",109,121
23,5,100,0,28,"http_init@124-152@usr.sbin/acme-client/http.c","usr.sbin/acme-client/http.c","http_init",124,152
15,5,86,3,16,"http_read@155-171@usr.sbin/acme-client/http.c","usr.sbin/acme-client/http.c","http_read",155,171
12,3,72,3,12,"http_write@174-186@usr.sbin/acme-client/http.c","usr.sbin/acme-client/http.c","http_write",174,186
19,7,123,1,23,"http_disconnect@189-212@usr.sbin/acme-client/http.c","usr.sbin/acme-client/http.c","http_disconnect",189,212
10,2,50,1,10,"http_free@215-225@usr.sbin/acme-client/http.c","usr.sbin/acme-client/http.c","http_free",215,225
88,16,673,5,107,"http_alloc@228-335@usr.sbin/acme-client/http.c","usr.sbin/acme-client/http.c","http_alloc",228,335
35,7,183,3,37,"http_open@338-375@usr.sbin/acme-client/http.c","usr.sbin/acme-client/http.c","http_open",338,375
10,2,50,1,10,"http_close@378-388@usr.sbin/acme-client/http.c","usr.sbin/acme-client/http.c","http_close",378,388
34,8,219,3,41,"http_body_read@398-439@usr.sbin/acme-client/http.c","usr.sbin/acme-client/http.c","http_body_read",398,439
10,3,61,3,10,"http_head_get@442-452@usr.sbin/acme-client/http.c","usr.sbin/acme-client/http.c","http_head_get",442,452
19,4,122,3,20,"http_head_status@459-479@usr.sbin/acme-client/http.c","usr.sbin/acme-client/http.c","http_head_status",459,479
57,13,358,3,80,"http_head_parse@494-574@usr.sbin/acme-client/http.c","usr.sbin/acme-client/http.c","http_head_parse",494,574
54,12,373,3,83,"http_head_read@584-667@usr.sbin/acme-client/http.c","usr.sbin/acme-client/http.c","http_head_read",584,667
8,2,36,1,8,"http_get_free@670-678@usr.sbin/acme-client/http.c","usr.sbin/acme-client/http.c","http_get_free",670,678
52,8,357,7,57,"http_get@681-738@usr.sbin/acme-client/http.c","usr.sbin/acme-client/http.c","http_get",681,738
29,6,223,1,41,"main@742-783@usr.sbin/acme-client/http.c","usr.sbin/acme-client/http.c","main",742,783
12,3,70,3,13,"jsmn_alloc_token@27-40@usr.sbin/acme-client/jsmn.c","usr.sbin/acme-client/jsmn.c","jsmn_alloc_token",27,40
7,1,41,4,6,"jsmn_fill_token@45-51@usr.sbin/acme-client/jsmn.c","usr.sbin/acme-client/jsmn.c","jsmn_fill_token",45,51
34,17,214,5,44,"jsmn_parse_primitive@56-100@usr.sbin/acme-client/jsmn.c","usr.sbin/acme-client/jsmn.c","jsmn_parse_primitive",56,100
49,27,354,5,62,"jsmn_parse_string@105-167@usr.sbin/acme-client/jsmn.c","usr.sbin/acme-client/jsmn.c","jsmn_parse_string",105,167
126,77,880,5,149,"jsmn_parse@172-321@usr.sbin/acme-client/jsmn.c","usr.sbin/acme-client/jsmn.c","jsmn_parse",172,321
5,1,27,1,4,"jsmn_init@327-331@usr.sbin/acme-client/jsmn.c","usr.sbin/acme-client/jsmn.c","jsmn_init",327,331
67,16,447,5,71,"build@71-142@usr.sbin/acme-client/json.c","usr.sbin/acme-client/json.c","build",71,142
27,8,131,1,27,"jsmnparse_free@149-176@usr.sbin/acme-client/json.c","usr.sbin/acme-client/json.c","jsmnparse_free",149,176
21,5,130,3,25,"jsmntree_alloc@184-209@usr.sbin/acme-client/json.c","usr.sbin/acme-client/json.c","jsmntree_alloc",184,209
5,2,22,1,5,"json_free@215-220@usr.sbin/acme-client/json.c","usr.sbin/acme-client/json.c","json_free",215,220
4,2,20,1,4,"json_getarrayobj@226-230@usr.sbin/acme-client/json.c","usr.sbin/acme-client/json.c","json_getarrayobj",226,230
19,8,149,2,19,"json_getarray@238-257@usr.sbin/acme-client/json.c","usr.sbin/acme-client/json.c","json_getarray",238,257
19,8,149,2,19,"json_getobj@265-284@usr.sbin/acme-client/json.c","usr.sbin/acme-client/json.c","json_getobj",265,284
24,10,190,2,25,"json_getstr@292-317@usr.sbin/acme-client/json.c","usr.sbin/acme-client/json.c","json_getstr",292,317
6,1,33,1,6,"json_free_challenge@323-329@usr.sbin/acme-client/json.c","usr.sbin/acme-client/json.c","json_free_challenge",323,329
17,5,90,1,19,"json_parse_response@336-355@usr.sbin/acme-client/json.c","usr.sbin/acme-client/json.c","json_parse_response",336,355
28,8,173,2,31,"json_parse_challenge@363-394@usr.sbin/acme-client/json.c","usr.sbin/acme-client/json.c","json_parse_challenge",363,394
16,7,132,2,20,"json_parse_capaths@401-421@usr.sbin/acme-client/json.c","usr.sbin/acme-client/json.c","json_parse_capaths",401,421
9,1,57,1,9,"json_free_capaths@427-436@usr.sbin/acme-client/json.c","usr.sbin/acme-client/json.c","json_free_capaths",427,436
29,5,153,2,37,"json_parse@443-480@usr.sbin/acme-client/json.c","usr.sbin/acme-client/json.c","json_parse",443,480
15,2,52,1,15,"json_fmt_newreg@486-501@usr.sbin/acme-client/json.c","usr.sbin/acme-client/json.c","json_fmt_newreg",486,501
16,2,53,1,16,"json_fmt_newauthz@507-523@usr.sbin/acme-client/json.c","usr.sbin/acme-client/json.c","json_fmt_newauthz",507,523
15,2,59,2,15,"json_fmt_challenge@529-544@usr.sbin/acme-client/json.c","usr.sbin/acme-client/json.c","json_fmt_challenge",529,544
15,2,52,1,15,"json_fmt_revokecert@550-565@usr.sbin/acme-client/json.c","usr.sbin/acme-client/json.c","json_fmt_revokecert",550,565
15,2,52,1,15,"json_fmt_newcert@571-586@usr.sbin/acme-client/json.c","usr.sbin/acme-client/json.c","json_fmt_newcert",571,586
16,2,60,2,16,"json_fmt_header_rsa@592-608@usr.sbin/acme-client/json.c","usr.sbin/acme-client/json.c","json_fmt_header_rsa",592,608
17,2,68,3,17,"json_fmt_protected_rsa@614-631@usr.sbin/acme-client/json.c","usr.sbin/acme-client/json.c","json_fmt_protected_rsa",614,631
18,2,75,4,18,"json_fmt_signed@637-655@usr.sbin/acme-client/json.c","usr.sbin/acme-client/json.c","json_fmt_signed",637,655
12,2,56,2,14,"json_fmt_thumb_rsa@664-678@usr.sbin/acme-client/json.c","usr.sbin/acme-client/json.c","json_fmt_thumb_rsa",664,678
17,3,100,3,28,"add_ext@40-68@usr.sbin/acme-client/keyproc.c","usr.sbin/acme-client/keyproc.c","add_ext",40,68
133,32,861,5,187,"keyproc@77-264@usr.sbin/acme-client/keyproc.c","usr.sbin/acme-client/keyproc.c","keyproc",77,264
301,84,2323,2,396,"main@36-432@usr.sbin/acme-client/main.c","usr.sbin/acme-client/main.c","main",36,432
21,7,164,1,22,"buf_dump@61-83@usr.sbin/acme-client/netproc.c","usr.sbin/acme-client/netproc.c","buf_dump",61,83
31,7,192,3,38,"url2host@91-129@usr.sbin/acme-client/netproc.c","usr.sbin/acme-client/netproc.c","url2host",91,129
30,10,228,3,33,"urlresolve@138-171@usr.sbin/acme-client/netproc.c","usr.sbin/acme-client/netproc.c","urlresolve",138,171
34,5,234,2,40,"nreq@179-219@usr.sbin/acme-client/netproc.c","usr.sbin/acme-client/netproc.c","nreq",179,219
72,14,553,3,93,"sreq@227-320@usr.sbin/acme-client/netproc.c","usr.sbin/acme-client/netproc.c","sreq",227,320
21,9,166,2,23,"donewreg@328-351@usr.sbin/acme-client/netproc.c","usr.sbin/acme-client/netproc.c","donewreg",328,351
26,9,213,4,28,"dochngreq@359-387@usr.sbin/acme-client/netproc.c","usr.sbin/acme-client/netproc.c","dochngreq",359,387
19,8,149,3,21,"dochngresp@393-414@usr.sbin/acme-client/netproc.c","usr.sbin/acme-client/netproc.c","dochngresp",393,414
27,8,213,2,29,"dochngcheck@422-451@usr.sbin/acme-client/netproc.c","usr.sbin/acme-client/netproc.c","dochngcheck",422,451
21,9,151,3,24,"dorevoke@454-478@usr.sbin/acme-client/netproc.c","usr.sbin/acme-client/netproc.c","dorevoke",454,478
21,9,158,3,23,"docert@485-508@usr.sbin/acme-client/netproc.c","usr.sbin/acme-client/netproc.c","docert",485,508
21,8,161,3,23,"dodirs@514-537@usr.sbin/acme-client/netproc.c","usr.sbin/acme-client/netproc.c","dodirs",514,537
15,6,97,2,17,"dofullchain@543-560@usr.sbin/acme-client/netproc.c","usr.sbin/acme-client/netproc.c","dofullchain",543,560
136,44,982,11,227,"netproc@568-795@usr.sbin/acme-client/netproc.c","usr.sbin/acme-client/netproc.c","netproc",568,795
39,7,393,1,47,"X509expires@44-91@usr.sbin/acme-client/revokeproc.c","usr.sbin/acme-client/revokeproc.c","X509expires",44,91
183,54,1228,7,256,"revokeproc@94-350@usr.sbin/acme-client/revokeproc.c","usr.sbin/acme-client/revokeproc.c","revokeproc",94,350
29,8,177,2,35,"rsa_key_create@37-72@usr.sbin/acme-client/rsa.c","usr.sbin/acme-client/rsa.c","rsa_key_create",37,72
13,3,78,2,14,"rsa_key_load@76-90@usr.sbin/acme-client/rsa.c","usr.sbin/acme-client/rsa.c","rsa_key_load",76,90
5,1,16,1,5,"sigpipe@75-80@usr.sbin/acme-client/util.c","usr.sbin/acme-client/util.c","sigpipe",75,80
15,5,93,2,16,"readop@88-104@usr.sbin/acme-client/util.c","usr.sbin/acme-client/util.c","readop",88,104
5,1,25,2,5,"readstr@107-112@usr.sbin/acme-client/util.c","usr.sbin/acme-client/util.c","readstr",107,112
37,9,249,3,42,"readbuf@121-163@usr.sbin/acme-client/util.c","usr.sbin/acme-client/util.c","readbuf",121,163
19,5,136,3,23,"writeop@170-193@usr.sbin/acme-client/util.c","usr.sbin/acme-client/util.c","writeop",170,193
23,7,193,4,35,"writebuf@200-235@usr.sbin/acme-client/util.c","usr.sbin/acme-client/util.c","writebuf",200,235
4,1,31,3,4,"writestr@238-242@usr.sbin/acme-client/util.c","usr.sbin/acme-client/util.c","writestr",238,242
21,6,154,2,22,"checkexit@250-272@usr.sbin/acme-client/util.c","usr.sbin/acme-client/util.c","checkexit",250,272
23,7,163,3,28,"checkexit_ext@281-309@usr.sbin/acme-client/util.c","usr.sbin/acme-client/util.c","checkexit_ext",281,309
10,2,42,2,11,"acpi_checksum@199-210@usr.sbin/acpidump/acpidump.c","usr.sbin/acpidump/acpidump.c","acpi_checksum",199,210
21,6,177,2,31,"acpi_user_find_mapping@213-244@usr.sbin/acpidump/acpidump.c","usr.sbin/acpidump/acpidump.c","acpi_user_find_mapping",213,244
6,1,39,2,6,"acpi_map_physical@247-253@usr.sbin/acpidump/acpidump.c","usr.sbin/acpidump/acpidump.c","acpi_map_physical",247,253
9,3,44,1,8,"acpi_user_init@256-264@usr.sbin/acpidump/acpidump.c","usr.sbin/acpidump/acpidump.c","acpi_user_init",256,264
30,7,223,1,35,"acpi_find_rsd_ptr@267-302@usr.sbin/acpidump/acpidump.c","usr.sbin/acpidump/acpidump.c","acpi_find_rsd_ptr",267,302
10,5,63,2,12,"acpi_print_string@305-317@usr.sbin/acpidump/acpidump.c","usr.sbin/acpidump/acpidump.c","acpi_print_string",305,317
8,1,54,1,7,"acpi_print_rsd_ptr@320-327@usr.sbin/acpidump/acpidump.c","usr.sbin/acpidump/acpidump.c","acpi_print_rsd_ptr",320,327
7,1,41,1,7,"acpi_map_sdt@330-337@usr.sbin/acpidump/acpidump.c","usr.sbin/acpidump/acpidump.c","acpi_map_sdt",330,337
19,3,146,1,21,"aml_dump@340-361@usr.sbin/acpidump/acpidump.c","usr.sbin/acpidump/acpidump.c","aml_dump",340,361
18,2,148,1,17,"acpi_print_sdt@364-381@usr.sbin/acpidump/acpidump.c","usr.sbin/acpidump/acpidump.c","acpi_print_sdt",364,381
15,3,104,1,15,"acpi_print_rsdt@384-399@usr.sbin/acpidump/acpidump.c","usr.sbin/acpidump/acpidump.c","acpi_print_rsdt",384,399
67,10,459,1,69,"acpi_print_facp@402-471@usr.sbin/acpidump/acpidump.c","usr.sbin/acpidump/acpidump.c","acpi_print_facp",402,471
4,1,14,1,3,"acpi_print_dsdt@474-477@usr.sbin/acpidump/acpidump.c","usr.sbin/acpidump/acpidump.c","acpi_print_dsdt",474,477
8,1,44,1,9,"acpi_handle_dsdt@480-489@usr.sbin/acpidump/acpidump.c","usr.sbin/acpidump/acpidump.c","acpi_handle_dsdt",480,489
10,2,61,1,10,"acpi_handle_facp@492-502@usr.sbin/acpidump/acpidump.c","usr.sbin/acpidump/acpidump.c","acpi_handle_facp",492,502
20,4,138,1,20,"acpi_handle_rsdt@505-525@usr.sbin/acpidump/acpidump.c","usr.sbin/acpidump/acpidump.c","acpi_handle_rsdt",505,525
24,7,163,1,31,"asl_dump_from_devmem@528-559@usr.sbin/acpidump/acpidump.c","usr.sbin/acpidump/acpidump.c","asl_dump_from_devmem",528,559
6,1,25,1,6,"usage@562-568@usr.sbin/acpidump/acpidump.c","usr.sbin/acpidump/acpidump.c","usage",562,568
21,6,105,2,25,"main@571-596@usr.sbin/acpidump/acpidump.c","usr.sbin/acpidump/acpidump.c","main",571,596
24,6,165,1,26,"bios_acpi_addr@599-625@usr.sbin/acpidump/acpidump.c","usr.sbin/acpidump/acpidump.c","bios_acpi_addr",599,625
15,4,82,1,22,"afs_match@65-87@usr.sbin/amd/amd/afs_ops.c","usr.sbin/amd/amd/afs_ops.c","afs_match",65,87
64,15,476,2,119,"mount_toplvl@97-216@usr.sbin/amd/amd/afs_ops.c","usr.sbin/amd/amd/afs_ops.c","mount_toplvl",97,216
10,3,56,1,13,"afs_mkcacheref@219-232@usr.sbin/amd/amd/afs_ops.c","usr.sbin/amd/amd/afs_ops.c","afs_mkcacheref",219,232
8,1,51,1,9,"root_mount@238-247@usr.sbin/amd/amd/afs_ops.c","usr.sbin/amd/amd/afs_ops.c","root_mount",238,247
17,5,139,1,52,"afs_mount@253-305@usr.sbin/amd/amd/afs_ops.c","usr.sbin/amd/amd/afs_ops.c","afs_mount",253,305
33,8,191,1,48,"toplvl_mount@311-359@usr.sbin/amd/amd/afs_ops.c","usr.sbin/amd/amd/afs_ops.c","toplvl_mount",311,359
4,1,13,1,3,"toplvl_mounted@362-365@usr.sbin/amd/amd/afs_ops.c","usr.sbin/amd/amd/afs_ops.c","toplvl_mounted",362,365
13,3,74,2,12,"create_union_node@372-384@usr.sbin/amd/amd/afs_ops.c","usr.sbin/amd/amd/afs_ops.c","create_union_node",372,384
15,5,107,1,30,"union_mounted@387-417@usr.sbin/amd/amd/afs_ops.c","usr.sbin/amd/amd/afs_ops.c","union_mounted",387,417
4,1,11,1,3,"afs_umount@424-427@usr.sbin/amd/amd/afs_ops.c","usr.sbin/amd/amd/afs_ops.c","afs_umount",424,427
16,4,81,1,30,"toplvl_umount@433-463@usr.sbin/amd/amd/afs_ops.c","usr.sbin/amd/amd/afs_ops.c","toplvl_umount",433,463
5,3,29,1,8,"afs_umounted@469-477@usr.sbin/amd/amd/afs_ops.c","usr.sbin/amd/amd/afs_ops.c","afs_umounted",469,477
12,2,70,1,11,"free_continuation@517-528@usr.sbin/amd/amd/afs_ops.c","usr.sbin/amd/amd/afs_ops.c","free_continuation",517,528
13,3,76,1,27,"assign_error_mntfs@537-564@usr.sbin/amd/amd/afs_ops.c","usr.sbin/amd/amd/afs_ops.c","assign_error_mntfs",537,564
30,4,181,3,61,"afs_cont@572-633@usr.sbin/amd/amd/afs_ops.c","usr.sbin/amd/amd/afs_ops.c","afs_cont",572,633
17,6,120,3,30,"afs_retry@639-669@usr.sbin/amd/amd/afs_ops.c","usr.sbin/amd/amd/afs_ops.c","afs_retry",639,669
17,6,99,1,32,"try_mount@676-708@usr.sbin/amd/amd/afs_ops.c","usr.sbin/amd/amd/afs_ops.c","try_mount",676,708
185,69,1276,2,342,"afs_bgmount@770-1112@usr.sbin/amd/amd/afs_ops.c","usr.sbin/amd/amd/afs_ops.c","afs_bgmount",770,1112
191,55,1140,4,387,"afs_lookuppn@1118-1505@usr.sbin/amd/amd/afs_ops.c","usr.sbin/amd/amd/afs_ops.c","afs_lookuppn",1118,1505
13,6,67,1,20,"next_nonerror_node@1512-1532@usr.sbin/amd/amd/afs_ops.c","usr.sbin/amd/amd/afs_ops.c","next_nonerror_node",1512,1532
68,18,486,5,112,"afs_readdir@1535-1647@usr.sbin/amd/amd/afs_ops.c","usr.sbin/amd/amd/afs_ops.c","afs_readdir",1535,1647
19,5,103,2,20,"dfs_readlink@1650-1670@usr.sbin/amd/amd/afs_ops.c","usr.sbin/amd/amd/afs_ops.c","dfs_readlink",1650,1670
11,4,91,1,11,"ops_showfstypes@76-87@usr.sbin/amd/amd/am_ops.c","usr.sbin/amd/amd/am_ops.c","ops_showfstypes",76,87
14,4,116,6,14,"sunos4_match@97-111@usr.sbin/amd/amd/am_ops.c","usr.sbin/amd/amd/am_ops.c","sunos4_match",97,111
29,9,224,6,50,"ops_match@116-166@usr.sbin/amd/amd/am_ops.c","usr.sbin/amd/amd/am_ops.c","ops_match",116,166
15,4,54,1,18,"sigterm@94-112@usr.sbin/amd/amd/amd.c","usr.sbin/amd/amd/amd.c","sigterm",94,112
7,4,28,1,12,"sighup@119-131@usr.sbin/amd/amd/amd.c","usr.sbin/amd/amd/amd.c","sighup",119,131
4,1,12,1,3,"parent_exit@134-137@usr.sbin/amd/amd/amd.c","usr.sbin/amd/amd/amd.c","parent_exit",134,137
29,9,151,1,44,"daemon_mode@140-184@usr.sbin/amd/amd/amd.c","usr.sbin/amd/amd/amd.c","daemon_mode",140,184
55,12,370,2,140,"main@187-327@usr.sbin/amd/amd/amd.c","usr.sbin/amd/amd/amd.c","main",187,327
5,1,21,2,5,"amqproc_null_57_svc@49-54@usr.sbin/amd/amd/amq_subr.c","usr.sbin/amd/amd/amq_subr.c","amqproc_null_57_svc",49,54
6,1,34,2,6,"amqproc_mnttree_57_svc@60-66@usr.sbin/amd/amd/amq_subr.c","usr.sbin/amd/amd/amq_subr.c","amqproc_mnttree_57_svc",60,66
8,2,40,2,9,"amqproc_umnt_57_svc@72-81@usr.sbin/amd/amd/amq_subr.c","usr.sbin/amd/amd/amq_subr.c","amqproc_umnt_57_svc",72,81
4,1,21,2,3,"amqproc_stats_57_svc@87-90@usr.sbin/amd/amd/amq_subr.c","usr.sbin/amd/amd/amq_subr.c","amqproc_stats_57_svc",87,90
7,1,41,2,8,"amqproc_export_57_svc@96-104@usr.sbin/amd/amd/amq_subr.c","usr.sbin/amd/amd/amq_subr.c","amqproc_export_57_svc",96,104
30,11,132,2,39,"amqproc_setopt_57_svc@107-146@usr.sbin/amd/amd/amq_subr.c","usr.sbin/amd/amd/amq_subr.c","amqproc_setopt_57_svc",107,146
5,1,25,2,4,"amqproc_getmntfs_57_svc@149-153@usr.sbin/amd/amd/amq_subr.c","usr.sbin/amd/amd/amq_subr.c","amqproc_getmntfs_57_svc",149,153
6,1,25,2,6,"amqproc_getvers_57_svc@156-162@usr.sbin/amd/amd/amq_subr.c","usr.sbin/amd/amd/amq_subr.c","amqproc_getvers_57_svc",156,162
7,2,36,2,6,"xdr_amq_string@168-174@usr.sbin/amd/amd/amq_subr.c","usr.sbin/amd/amd/amq_subr.c","xdr_amq_string",168,174
10,3,63,2,9,"xdr_amq_setopt@177-186@usr.sbin/amd/amd/amq_subr.c","usr.sbin/amd/amd/amq_subr.c","xdr_amq_setopt",177,186
39,13,284,2,39,"xdr_amq_mount_tree_node@192-231@usr.sbin/amd/amd/amq_subr.c","usr.sbin/amd/amd/amq_subr.c","xdr_amq_mount_tree_node",192,231
14,4,106,2,14,"xdr_amq_mount_subtree@234-248@usr.sbin/amd/amd/amq_subr.c","usr.sbin/amd/amd/amq_subr.c","xdr_amq_mount_subtree",234,248
15,4,110,2,15,"xdr_amq_mount_tree@251-266@usr.sbin/amd/amd/amq_subr.c","usr.sbin/amd/amd/amq_subr.c","xdr_amq_mount_tree",251,266
7,2,45,2,6,"xdr_amq_mount_tree_p@269-275@usr.sbin/amd/amd/amq_subr.c","usr.sbin/amd/amd/amq_subr.c","xdr_amq_mount_tree_p",269,275
19,6,117,2,18,"xdr_amq_mount_stats@279-297@usr.sbin/amd/amd/amq_subr.c","usr.sbin/amd/amd/amq_subr.c","xdr_amq_mount_stats",279,297
7,2,59,2,6,"xdr_amq_mount_tree_list@301-307@usr.sbin/amd/amd/amq_subr.c","usr.sbin/amd/amd/amq_subr.c","xdr_amq_mount_tree_list",301,307
46,15,344,2,55,"xdr_amq_mount_info_list@310-365@usr.sbin/amd/amd/amq_subr.c","usr.sbin/amd/amd/amq_subr.c","xdr_amq_mount_info_list",310,365
10,2,36,1,9,"alloc_callout@78-87@usr.sbin/amd/amd/clock.c","usr.sbin/amd/amd/clock.c","alloc_callout",78,87
10,2,37,1,9,"free_callout@90-99@usr.sbin/amd/amd/clock.c","usr.sbin/amd/amd/clock.c","free_callout",90,99
18,4,128,3,34,"timeout@107-141@usr.sbin/amd/amd/clock.c","usr.sbin/amd/amd/clock.c","timeout",107,141
11,3,60,1,10,"untimeout@147-157@usr.sbin/amd/amd/clock.c","usr.sbin/amd/amd/clock.c","untimeout",147,157
12,5,82,2,14,"reschedule_timeouts@163-177@usr.sbin/amd/amd/clock.c","usr.sbin/amd/amd/clock.c","reschedule_timeouts",163,177
20,7,116,1,45,"softclock@183-228@usr.sbin/amd/amd/clock.c","usr.sbin/amd/amd/clock.c","softclock",183,228
4,1,14,1,3,"efs_match@54-57@usr.sbin/amd/amd/efs_ops.c","usr.sbin/amd/amd/efs_ops.c","efs_match",54,57
4,1,11,1,3,"efs_fmount@60-63@usr.sbin/amd/amd/efs_ops.c","usr.sbin/amd/amd/efs_ops.c","efs_fmount",60,63
4,1,11,1,7,"efs_fumount@66-73@usr.sbin/amd/amd/efs_ops.c","usr.sbin/amd/amd/efs_ops.c","efs_fumount",66,73
5,1,27,4,4,"efs_lookuppn@81-85@usr.sbin/amd/amd/efs_ops.c","usr.sbin/amd/amd/efs_ops.c","efs_lookuppn",81,85
5,1,25,5,4,"efs_readdir@93-97@usr.sbin/amd/amd/efs_ops.c","usr.sbin/amd/amd/efs_ops.c","efs_readdir",93,97
4,1,19,1,3,"debug_option@89-92@usr.sbin/amd/amd/get_args.c","usr.sbin/amd/amd/get_args.c","debug_option",89,92
145,47,690,2,203,"get_args@96-299@usr.sbin/amd/amd/get_args.c","usr.sbin/amd/amd/get_args.c","get_args",96,299
10,4,49,1,16,"host_match@80-96@usr.sbin/amd/amd/host_ops.c","usr.sbin/amd/amd/host_ops.c","host_match",80,96
6,2,27,1,5,"host_init@99-104@usr.sbin/amd/amd/host_ops.c","usr.sbin/amd/amd/host_ops.c","host_init",99,104
6,1,34,2,6,"xdr_pri_free@119-125@usr.sbin/amd/amd/host_ops.c","usr.sbin/amd/amd/host_ops.c","xdr_pri_free",119,125
11,5,97,5,16,"do_mount@128-144@usr.sbin/amd/amd/host_ops.c","usr.sbin/amd/amd/host_ops.c","do_mount",128,144
5,1,44,2,4,"sortfun@147-151@usr.sbin/amd/amd/host_ops.c","usr.sbin/amd/amd/host_ops.c","sortfun",147,151
21,5,125,3,36,"fetch_fhandle@157-193@usr.sbin/amd/amd/host_ops.c","usr.sbin/amd/amd/host_ops.c","fetch_fhandle",157,193
8,3,51,2,8,"already_mounted@199-207@usr.sbin/amd/amd/host_ops.c","usr.sbin/amd/amd/host_ops.c","already_mounted",199,207
92,23,679,1,162,"host_fmount@213-375@usr.sbin/amd/amd/host_ops.c","usr.sbin/amd/amd/host_ops.c","host_fmount",213,375
9,4,58,2,8,"directory_prefix@384-392@usr.sbin/amd/amd/host_ops.c","usr.sbin/amd/amd/host_ops.c","directory_prefix",384,392
41,13,217,1,74,"host_fumount@398-472@usr.sbin/amd/amd/host_ops.c","usr.sbin/amd/amd/host_ops.c","host_fumount",398,472
3,1,8,1,2,"host_umounted@480-482@usr.sbin/amd/amd/host_ops.c","usr.sbin/amd/amd/host_ops.c","host_umounted",480,482
35,8,247,4,54,"host_exec@488-542@usr.sbin/amd/amd/host_ops.c","usr.sbin/amd/amd/host_ops.c","host_exec",488,542
5,1,36,1,5,"host_mount@545-550@usr.sbin/amd/amd/host_ops.c","usr.sbin/amd/amd/host_ops.c","host_mount",545,550
5,1,34,1,5,"host_umount@553-558@usr.sbin/amd/amd/host_ops.c","usr.sbin/amd/amd/host_ops.c","host_umount",553,558
5,1,18,1,4,"ifs_match@55-59@usr.sbin/amd/amd/ifs_ops.c","usr.sbin/amd/amd/ifs_ops.c","ifs_match",55,59
15,4,100,1,19,"ifs_init@62-81@usr.sbin/amd/amd/ifs_ops.c","usr.sbin/amd/amd/ifs_ops.c","ifs_init",62,81
16,3,100,1,39,"ifs_inherit@84-123@usr.sbin/amd/amd/ifs_ops.c","usr.sbin/amd/amd/ifs_ops.c","ifs_inherit",84,123
12,3,57,1,15,"ifs_mount@126-141@usr.sbin/amd/amd/ifs_ops.c","usr.sbin/amd/amd/ifs_ops.c","ifs_mount",126,141
7,3,37,1,6,"ifs_fmount@144-150@usr.sbin/amd/amd/ifs_ops.c","usr.sbin/amd/amd/ifs_ops.c","ifs_fmount",144,150
4,1,11,1,6,"ifs_fumount@153-159@usr.sbin/amd/amd/ifs_ops.c","usr.sbin/amd/amd/ifs_ops.c","ifs_fumount",153,159
24,10,157,3,29,"read_line@50-79@usr.sbin/amd/amd/info_file.c","usr.sbin/amd/amd/info_file.c","read_line",50,79
63,24,407,6,100,"search_or_reload_file@85-185@usr.sbin/amd/amd/info_file.c","usr.sbin/amd/amd/info_file.c","search_or_reload_file",85,185
12,4,68,2,13,"file_open@188-201@usr.sbin/amd/amd/info_file.c","usr.sbin/amd/amd/info_file.c","file_open",188,201
9,2,43,2,9,"file_init@204-213@usr.sbin/amd/amd/info_file.c","usr.sbin/amd/amd/info_file.c","file_init",204,213
10,2,81,3,11,"file_reload@216-227@usr.sbin/amd/amd/info_file.c","usr.sbin/amd/amd/info_file.c","file_reload",216,227
17,3,101,5,18,"file_search@230-248@usr.sbin/amd/amd/info_file.c","usr.sbin/amd/amd/info_file.c","file_search",230,248
9,2,43,2,10,"file_mtime@251-261@usr.sbin/amd/amd/info_file.c","usr.sbin/amd/amd/info_file.c","file_mtime",251,261
12,2,71,3,12,"search_ndbm@51-63@usr.sbin/amd/amd/info_ndbm.c","usr.sbin/amd/amd/info_ndbm.c","search_ndbm",51,63
19,4,119,5,21,"ndbm_search@66-87@usr.sbin/amd/amd/info_ndbm.c","usr.sbin/amd/amd/info_ndbm.c","ndbm_search",66,87
15,3,78,2,17,"ndbm_init@90-107@usr.sbin/amd/amd/info_ndbm.c","usr.sbin/amd/amd/info_ndbm.c","ndbm_init",90,107
19,4,87,1,24,"determine_nis_domain@59-83@usr.sbin/amd/amd/info_nis.c","usr.sbin/amd/amd/info_nis.c","determine_nis_domain",59,83
19,4,140,6,37,"callback@96-133@usr.sbin/amd/amd/info_nis.c","usr.sbin/amd/amd/info_nis.c","callback",96,133
21,4,131,3,25,"nis_reload@136-161@usr.sbin/amd/amd/info_nis.c","usr.sbin/amd/amd/info_nis.c","nis_reload",136,161
44,11,257,5,71,"nis_search@167-238@usr.sbin/amd/amd/info_nis.c","usr.sbin/amd/amd/info_nis.c","nis_search",167,238
30,7,141,2,41,"nis_init@241-282@usr.sbin/amd/amd/info_nis.c","usr.sbin/amd/amd/info_nis.c","nis_init",241,282
5,2,31,2,4,"passwd_init@55-59@usr.sbin/amd/amd/info_passwd.c","usr.sbin/amd/amd/info_passwd.c","passwd_init",55,59
50,12,323,5,82,"passwd_search@67-149@usr.sbin/amd/amd/info_passwd.c","usr.sbin/amd/amd/info_passwd.c","passwd_search",67,149
5,2,33,2,4,"union_init@58-62@usr.sbin/amd/amd/info_union.c","usr.sbin/amd/amd/info_union.c","union_init",58,62
13,2,113,5,13,"union_search@65-78@usr.sbin/amd/amd/info_union.c","usr.sbin/amd/amd/info_union.c","union_search",65,78
39,10,327,3,55,"union_reload@81-136@usr.sbin/amd/amd/info_union.c","usr.sbin/amd/amd/info_union.c","union_reload",81,136
11,4,65,1,16,"exported_ap_realloc_map@91-107@usr.sbin/amd/amd/map.c","usr.sbin/amd/amd/map.c","exported_ap_realloc_map",91,107
18,8,114,1,41,"exported_ap_alloc@120-161@usr.sbin/amd/amd/map.c","usr.sbin/amd/amd/map.c","exported_ap_alloc",120,161
12,7,67,1,32,"exported_ap_free@167-199@usr.sbin/amd/amd/map.c","usr.sbin/amd/amd/map.c","exported_ap_free",167,199
10,3,58,2,16,"insert_am@209-225@usr.sbin/amd/amd/map.c","usr.sbin/amd/amd/map.c","insert_am",209,225
12,7,87,1,22,"remove_am@231-253@usr.sbin/amd/amd/map.c","usr.sbin/amd/amd/map.c","remove_am",231,253
7,1,42,1,7,"new_ttl@259-266@usr.sbin/amd/amd/map.c","usr.sbin/amd/amd/map.c","new_ttl",259,266
20,3,108,2,19,"mk_fattr@269-288@usr.sbin/amd/amd/map.c","usr.sbin/amd/amd/map.c","mk_fattr",269,288
17,1,141,2,28,"init_map@297-325@usr.sbin/amd/amd/map.c","usr.sbin/amd/amd/map.c","init_map",297,325
11,2,59,1,13,"free_map@332-345@usr.sbin/amd/amd/map.c","usr.sbin/amd/amd/map.c","free_map",332,345
55,21,327,3,123,"fh_to_mp3@352-475@usr.sbin/amd/amd/map.c","usr.sbin/amd/amd/map.c","fh_to_mp3",352,475
5,1,20,1,4,"fh_to_mp@478-482@usr.sbin/amd/amd/map.c","usr.sbin/amd/amd/map.c","fh_to_mp",478,482
7,1,47,2,22,"mp_to_fh@489-511@usr.sbin/amd/amd/map.c","usr.sbin/amd/amd/map.c","mp_to_fh",489,511
16,6,97,2,18,"find_ap2@514-532@usr.sbin/amd/amd/map.c","usr.sbin/amd/amd/map.c","find_ap2",514,532
13,5,71,1,14,"find_ap@541-555@usr.sbin/amd/amd/map.c","usr.sbin/amd/amd/map.c","find_ap",541,555
10,4,51,1,10,"find_mf@562-572@usr.sbin/amd/amd/map.c","usr.sbin/amd/amd/map.c","find_mf",562,572
16,4,91,1,24,"root_fh@580-604@usr.sbin/amd/amd/map.c","usr.sbin/amd/amd/map.c","root_fh",580,604
7,3,36,2,7,"root_ap@607-614@usr.sbin/amd/amd/map.c","usr.sbin/amd/amd/map.c","root_ap",607,614
15,6,93,1,15,"map_flush_srvr@621-636@usr.sbin/amd/amd/map.c","usr.sbin/amd/amd/map.c","map_flush_srvr",621,636
10,2,62,2,10,"mount_auto_node@645-655@usr.sbin/amd/amd/map.c","usr.sbin/amd/amd/map.c","mount_auto_node",645,655
4,1,27,1,6,"mount_exported@662-668@usr.sbin/amd/amd/map.c","usr.sbin/amd/amd/map.c","mount_exported",662,668
13,2,102,1,30,"make_root_node@674-704@usr.sbin/amd/amd/map.c","usr.sbin/amd/amd/map.c","make_root_node",674,704
29,12,183,1,53,"umount_exported@711-764@usr.sbin/amd/amd/map.c","usr.sbin/amd/amd/map.c","umount_exported",711,764
18,8,110,1,29,"unmount_node@767-796@usr.sbin/amd/amd/map.c","usr.sbin/amd/amd/map.c","unmount_node",767,796
15,6,101,1,15,"flush_kernel_name_cache@800-815@usr.sbin/amd/amd/map.c","usr.sbin/amd/amd/map.c","flush_kernel_name_cache",800,815
12,5,86,1,47,"unmount_node_wrap@819-866@usr.sbin/amd/amd/map.c","usr.sbin/amd/amd/map.c","unmount_node_wrap",819,866
28,7,161,3,47,"free_map_if_success@869-916@usr.sbin/amd/amd/map.c","usr.sbin/amd/amd/map.c","free_map_if_success",869,916
30,11,213,1,51,"unmount_mp@919-970@usr.sbin/amd/amd/map.c","usr.sbin/amd/amd/map.c","unmount_mp",919,970
53,25,329,1,120,"timeout_mp@973-1093@usr.sbin/amd/amd/map.c","usr.sbin/amd/amd/map.c","timeout_mp",973,1093
6,2,25,0,5,"reschedule_timeout_mp@1098-1103@usr.sbin/amd/amd/map.c","usr.sbin/amd/amd/map.c","reschedule_timeout_mp",1098,1103
7,2,38,1,8,"kvhash_of@211-219@usr.sbin/amd/amd/mapc.c","usr.sbin/amd/amd/mapc.c","kvhash_of",211,219
9,2,63,1,9,"mapc_showtypes@222-231@usr.sbin/amd/amd/mapc.c","usr.sbin/amd/amd/mapc.c","mapc_showtypes",222,231
35,5,214,3,45,"mapc_add_kv@238-283@usr.sbin/amd/amd/mapc.c","usr.sbin/amd/amd/mapc.c","mapc_add_kv",238,283
13,4,83,3,22,"mapc_repl_kv@286-308@usr.sbin/amd/amd/mapc.c","usr.sbin/amd/amd/mapc.c","mapc_repl_kv",286,308
12,3,81,3,13,"search_map@315-328@usr.sbin/amd/amd/mapc.c","usr.sbin/amd/amd/mapc.c","search_map",315,328
6,2,35,1,9,"mapc_find_wildcard@335-344@usr.sbin/amd/amd/mapc.c","usr.sbin/amd/amd/mapc.c","mapc_find_wildcard",335,344
14,5,83,1,17,"mapc_reload_map@355-372@usr.sbin/amd/amd/mapc.c","usr.sbin/amd/amd/mapc.c","mapc_reload_map",355,372
48,13,320,2,67,"mapc_create@378-445@usr.sbin/amd/amd/mapc.c","usr.sbin/amd/amd/mapc.c","mapc_create",378,445
19,4,109,1,29,"mapc_clear@451-480@usr.sbin/amd/amd/mapc.c","usr.sbin/amd/amd/mapc.c","mapc_clear",451,480
10,2,65,2,18,"mapc_find@486-504@usr.sbin/amd/amd/mapc.c","usr.sbin/amd/amd/mapc.c","mapc_find",486,504
10,3,52,1,14,"mapc_free@510-524@usr.sbin/amd/amd/mapc.c","usr.sbin/amd/amd/mapc.c","mapc_free",510,524
69,27,453,4,120,"mapc_meta_search@532-652@usr.sbin/amd/amd/mapc.c","usr.sbin/amd/amd/mapc.c","mapc_meta_search",532,652
4,1,28,3,3,"mapc_search@655-658@usr.sbin/amd/amd/mapc.c","usr.sbin/amd/amd/mapc.c","mapc_search",655,658
11,5,57,1,14,"mapc_sync@664-678@usr.sbin/amd/amd/mapc.c","usr.sbin/amd/amd/mapc.c","mapc_sync",664,678
6,1,24,1,12,"mapc_reload@684-696@usr.sbin/amd/amd/mapc.c","usr.sbin/amd/amd/mapc.c","mapc_reload",684,696
5,2,33,2,4,"root_init@708-712@usr.sbin/amd/amd/mapc.c","usr.sbin/amd/amd/mapc.c","root_init",708,712
13,4,90,3,20,"root_newmap@722-742@usr.sbin/amd/amd/mapc.c","usr.sbin/amd/amd/mapc.c","root_newmap",722,742
14,3,89,3,15,"mapc_keyiter@745-760@usr.sbin/amd/amd/mapc.c","usr.sbin/amd/amd/mapc.c","mapc_keyiter",745,760
10,3,54,2,11,"root_keyiter@769-780@usr.sbin/amd/amd/mapc.c","usr.sbin/amd/amd/mapc.c","root_keyiter",769,780
6,1,29,2,5,"error_init@786-791@usr.sbin/amd/amd/mapc.c","usr.sbin/amd/amd/mapc.c","error_init",786,791
4,1,27,5,3,"error_search@794-797@usr.sbin/amd/amd/mapc.c","usr.sbin/amd/amd/mapc.c","error_search",794,797
4,1,19,3,3,"error_reload@800-803@usr.sbin/amd/amd/mapc.c","usr.sbin/amd/amd/mapc.c","error_reload",800,803
5,1,20,2,4,"error_mtime@806-810@usr.sbin/amd/amd/mapc.c","usr.sbin/amd/amd/mapc.c","error_mtime",806,810
11,1,76,4,13,"rpc_msg_init@50-63@usr.sbin/amd/amd/misc_rpc.c","usr.sbin/amd/amd/misc_rpc.c","rpc_msg_init",50,63
31,5,187,4,37,"pickup_rpc_reply@69-106@usr.sbin/amd/amd/misc_rpc.c","usr.sbin/amd/amd/misc_rpc.c","pickup_rpc_reply",69,106
18,5,130,7,36,"make_rpc_packet@109-145@usr.sbin/amd/amd/misc_rpc.c","usr.sbin/amd/amd/misc_rpc.c","make_rpc_packet",109,145
12,4,58,1,13,"dup_mntfs@69-82@usr.sbin/amd/amd/mntfs.c","usr.sbin/amd/amd/mntfs.c","dup_mntfs",69,82
28,3,227,8,30,"init_mntfs@85-115@usr.sbin/amd/amd/mntfs.c","usr.sbin/amd/amd/mntfs.c","init_mntfs",85,115
9,1,77,7,9,"alloc_mntfs@118-127@usr.sbin/amd/amd/mntfs.c","usr.sbin/amd/amd/mntfs.c","alloc_mntfs",118,127
44,14,355,7,67,"find_mntfs@130-197@usr.sbin/amd/amd/mntfs.c","usr.sbin/amd/amd/mntfs.c","find_mntfs",130,197
4,1,28,0,3,"new_mntfs@200-203@usr.sbin/amd/amd/mntfs.c","usr.sbin/amd/amd/mntfs.c","new_mntfs",200,203
18,7,121,2,28,"uninit_mntfs@206-234@usr.sbin/amd/amd/mntfs.c","usr.sbin/amd/amd/mntfs.c","uninit_mntfs",206,234
8,1,37,1,12,"discard_mntfs@237-249@usr.sbin/amd/amd/mntfs.c","usr.sbin/amd/amd/mntfs.c","discard_mntfs",237,249
11,4,66,1,11,"flush_mntfs@252-263@usr.sbin/amd/amd/mntfs.c","usr.sbin/amd/amd/mntfs.c","flush_mntfs",252,263
32,11,200,1,41,"free_mntfs@266-307@usr.sbin/amd/amd/mntfs.c","usr.sbin/amd/amd/mntfs.c","free_mntfs",266,307
17,7,132,8,27,"realloc_mntfs@310-337@usr.sbin/amd/amd/mntfs.c","usr.sbin/amd/amd/mntfs.c","realloc_mntfs",310,337
9,3,54,1,13,"compute_mount_flags@57-70@usr.sbin/amd/amd/mount_fs.c","usr.sbin/amd/amd/mount_fs.c","compute_mount_flags",57,70
22,8,131,5,34,"mount_fs@73-107@usr.sbin/amd/amd/mount_fs.c","usr.sbin/amd/amd/mount_fs.c","mount_fs",73,107
16,5,74,1,30,"nextmntopt@119-149@usr.sbin/amd/amd/mount_fs.c","usr.sbin/amd/amd/mount_fs.c","nextmntopt",119,149
12,3,89,2,14,"hasmntopt@152-166@usr.sbin/amd/amd/mount_fs.c","usr.sbin/amd/amd/mount_fs.c","hasmntopt",152,166
8,1,42,1,7,"mnt_free@44-51@usr.sbin/amd/amd/mtab.c","usr.sbin/amd/amd/mtab.c","mnt_free",44,51
10,3,46,1,10,"discard_mntlist@57-67@usr.sbin/amd/amd/mtab.c","usr.sbin/amd/amd/mtab.c","discard_mntlist",57,67
4,1,13,1,3,"free_mntlist@73-76@usr.sbin/amd/amd/mtab.c","usr.sbin/amd/amd/mtab.c","free_mntlist",73,76
12,3,68,2,12,"hasmntval@84-96@usr.sbin/amd/amd/mtab.c","usr.sbin/amd/amd/mtab.c","hasmntval",84,96
11,1,76,1,12,"mnt_dup@99-111@usr.sbin/amd/amd/mtab.c","usr.sbin/amd/amd/mtab.c","mnt_dup",99,111
18,3,112,1,36,"read_mtab@117-153@usr.sbin/amd/amd/mtab.c","usr.sbin/amd/amd/mtab.c","read_mtab",117,153
21,6,106,2,27,"find_nfs_fhandle_cache@110-137@usr.sbin/amd/amd/nfs_ops.c","usr.sbin/amd/amd/nfs_ops.c","find_nfs_fhandle_cache",110,137
17,6,119,6,23,"got_nfs_fh@143-166@usr.sbin/amd/amd/nfs_ops.c","usr.sbin/amd/amd/nfs_ops.c","got_nfs_fh",143,166
10,3,55,1,9,"flush_nfs_fhandle_cache@169-178@usr.sbin/amd/amd/nfs_ops.c","usr.sbin/amd/amd/nfs_ops.c","flush_nfs_fhandle_cache",169,178
9,2,56,1,11,"discard_fh@181-192@usr.sbin/amd/amd/nfs_ops.c","usr.sbin/amd/amd/nfs_ops.c","discard_fh",181,192
72,15,462,4,118,"prime_nfs_fhandle_cache@198-316@usr.sbin/amd/amd/nfs_ops.c","usr.sbin/amd/amd/nfs_ops.c","prime_nfs_fhandle_cache",198,316
8,2,39,1,13,"make_nfs_auth@319-332@usr.sbin/amd/amd/nfs_ops.c","usr.sbin/amd/amd/nfs_ops.c","make_nfs_auth",319,332
31,6,210,4,48,"call_mountd@335-383@usr.sbin/amd/amd/nfs_ops.c","usr.sbin/amd/amd/nfs_ops.c","call_mountd",335,383
20,6,141,1,25,"nfs_match@393-418@usr.sbin/amd/amd/nfs_ops.c","usr.sbin/amd/amd/nfs_ops.c","nfs_match",393,418
19,4,106,1,21,"nfs_init@424-445@usr.sbin/amd/amd/nfs_ops.c","usr.sbin/amd/amd/nfs_ops.c","nfs_init",424,445
94,38,782,5,166,"mount_nfs_fh@448-614@usr.sbin/amd/amd/nfs_ops.c","usr.sbin/amd/amd/nfs_ops.c","mount_nfs_fh",448,614
18,6,135,4,26,"mount_nfs@617-643@usr.sbin/amd/amd/nfs_ops.c","usr.sbin/amd/amd/nfs_ops.c","mount_nfs",617,643
10,3,48,1,13,"nfs_fmount@646-659@usr.sbin/amd/amd/nfs_ops.c","usr.sbin/amd/amd/nfs_ops.c","nfs_fmount",646,659
4,1,18,1,3,"nfs_fumount@662-665@usr.sbin/amd/amd/nfs_ops.c","usr.sbin/amd/amd/nfs_ops.c","nfs_fumount",662,665
16,8,108,1,27,"nfs_umounted@668-695@usr.sbin/amd/amd/nfs_ops.c","usr.sbin/amd/amd/nfs_ops.c","nfs_umounted",668,695
21,3,121,1,27,"checkup@68-95@usr.sbin/amd/amd/nfs_start.c","usr.sbin/amd/amd/nfs_start.c","checkup",68,95
30,6,158,5,48,"do_select@99-147@usr.sbin/amd/amd/nfs_start.c","usr.sbin/amd/amd/nfs_start.c","do_select",99,147
24,4,147,1,25,"rpc_pending_now@154-179@usr.sbin/amd/amd/nfs_start.c","usr.sbin/amd/amd/nfs_start.c","rpc_pending_now",154,179
84,21,462,1,134,"run_rpc@182-316@usr.sbin/amd/amd/nfs_start.c","usr.sbin/amd/amd/nfs_start.c","run_rpc",182,316
8,2,35,1,7,"bindnfs_port@319-326@usr.sbin/amd/amd/nfs_start.c","usr.sbin/amd/amd/nfs_start.c","bindnfs_port",319,326
5,2,20,1,6,"unregister_amq@329-335@usr.sbin/amd/amd/nfs_start.c","usr.sbin/amd/amd/nfs_start.c","unregister_amq",329,335
74,22,438,1,129,"mount_automounter@338-467@usr.sbin/amd/amd/nfs_start.c","usr.sbin/amd/amd/nfs_start.c","mount_automounter",338,467
20,5,113,3,26,"do_readlink@53-79@usr.sbin/amd/amd/nfs_subr.c","usr.sbin/amd/amd/nfs_subr.c","do_readlink",53,79
5,1,21,2,5,"nfsproc_null_2_svc@82-87@usr.sbin/amd/amd/nfs_subr.c","usr.sbin/amd/amd/nfs_subr.c","nfsproc_null_2_svc",82,87
27,7,161,2,38,"nfsproc_getattr_2_svc@91-129@usr.sbin/amd/amd/nfs_subr.c","usr.sbin/amd/amd/nfs_subr.c","nfsproc_getattr_2_svc",91,129
9,2,53,2,10,"nfsproc_setattr_2_svc@133-143@usr.sbin/amd/amd/nfs_subr.c","usr.sbin/amd/amd/nfs_subr.c","nfsproc_setattr_2_svc",133,143
5,1,21,2,5,"nfsproc_root_2_svc@147-152@usr.sbin/amd/amd/nfs_subr.c","usr.sbin/amd/amd/nfs_subr.c","nfsproc_root_2_svc",147,152
34,8,214,2,43,"nfsproc_lookup_2_svc@156-199@usr.sbin/amd/amd/nfs_subr.c","usr.sbin/amd/amd/nfs_subr.c","nfsproc_lookup_2_svc",156,199
26,7,152,2,32,"nfsproc_readlink_2_svc@203-235@usr.sbin/amd/amd/nfs_subr.c","usr.sbin/amd/amd/nfs_subr.c","nfsproc_readlink_2_svc",203,235
7,1,43,2,9,"nfsproc_read_2_svc@239-248@usr.sbin/amd/amd/nfs_subr.c","usr.sbin/amd/amd/nfs_subr.c","nfsproc_read_2_svc",239,248
5,1,21,2,5,"nfsproc_writecache_2_svc@252-257@usr.sbin/amd/amd/nfs_subr.c","usr.sbin/amd/amd/nfs_subr.c","nfsproc_writecache_2_svc",252,257
9,2,52,2,10,"nfsproc_write_2_svc@261-271@usr.sbin/amd/amd/nfs_subr.c","usr.sbin/amd/amd/nfs_subr.c","nfsproc_write_2_svc",261,271
9,2,54,2,10,"nfsproc_create_2_svc@275-285@usr.sbin/amd/amd/nfs_subr.c","usr.sbin/amd/amd/nfs_subr.c","nfsproc_create_2_svc",275,285
32,8,188,3,43,"unlink_or_rmdir@289-332@usr.sbin/amd/amd/nfs_subr.c","usr.sbin/amd/amd/nfs_subr.c","unlink_or_rmdir",289,332
4,1,24,2,3,"nfsproc_remove_2_svc@336-339@usr.sbin/amd/amd/nfs_subr.c","usr.sbin/amd/amd/nfs_subr.c","nfsproc_remove_2_svc",336,339
11,4,82,2,17,"nfsproc_rename_2_svc@342-359@usr.sbin/amd/amd/nfs_subr.c","usr.sbin/amd/amd/nfs_subr.c","nfsproc_rename_2_svc",342,359
9,3,58,2,9,"nfsproc_link_2_svc@363-372@usr.sbin/amd/amd/nfs_subr.c","usr.sbin/amd/amd/nfs_subr.c","nfsproc_link_2_svc",363,372
9,2,49,2,9,"nfsproc_symlink_2_svc@376-385@usr.sbin/amd/amd/nfs_subr.c","usr.sbin/amd/amd/nfs_subr.c","nfsproc_symlink_2_svc",376,385
9,2,54,2,9,"nfsproc_mkdir_2_svc@389-398@usr.sbin/amd/amd/nfs_subr.c","usr.sbin/amd/amd/nfs_subr.c","nfsproc_mkdir_2_svc",389,398
4,1,24,2,3,"nfsproc_rmdir_2_svc@402-405@usr.sbin/amd/amd/nfs_subr.c","usr.sbin/amd/amd/nfs_subr.c","nfsproc_rmdir_2_svc",402,405
22,5,148,2,28,"nfsproc_readdir_2_svc@409-437@usr.sbin/amd/amd/nfs_subr.c","usr.sbin/amd/amd/nfs_subr.c","nfsproc_readdir_2_svc",409,437
27,5,150,2,39,"nfsproc_statfs_2_svc@440-479@usr.sbin/amd/amd/nfs_subr.c","usr.sbin/amd/amd/nfs_subr.c","nfsproc_statfs_2_svc",440,479
38,11,272,1,63,"nfsx_match@66-129@usr.sbin/amd/amd/nfsx_ops.c","usr.sbin/amd/amd/nfsx_ops.c","nfsx_match",66,129
12,3,74,1,13,"nfsx_prfree@132-145@usr.sbin/amd/amd/nfsx_ops.c","usr.sbin/amd/amd/nfsx_ops.c","nfsx_prfree",132,145
76,15,515,1,119,"nfsx_init@148-267@usr.sbin/amd/amd/nfsx_ops.c","usr.sbin/amd/amd/nfsx_ops.c","nfsx_init",148,267
31,5,208,3,49,"nfsx_cont@270-319@usr.sbin/amd/amd/nfsx_ops.c","usr.sbin/amd/amd/nfsx_ops.c","nfsx_cont",270,319
9,1,50,1,9,"try_nfsx_mount@322-331@usr.sbin/amd/amd/nfsx_ops.c","usr.sbin/amd/amd/nfsx_ops.c","try_nfsx_mount",322,331
48,20,343,2,66,"nfsx_remount@334-400@usr.sbin/amd/amd/nfsx_ops.c","usr.sbin/amd/amd/nfsx_ops.c","nfsx_remount",334,400
4,1,16,1,3,"nfsx_fmount@403-406@usr.sbin/amd/amd/nfsx_ops.c","usr.sbin/amd/amd/nfsx_ops.c","nfsx_fmount",403,406
41,10,262,1,68,"nfsx_fumount@414-482@usr.sbin/amd/amd/nfsx_ops.c","usr.sbin/amd/amd/nfsx_ops.c","nfsx_fumount",414,482
25,10,125,1,41,"opt@163-204@usr.sbin/amd/amd/opts.c","usr.sbin/amd/amd/opts.c","opt",163,204
71,22,432,2,103,"eval_opts@207-310@usr.sbin/amd/amd/opts.c","usr.sbin/amd/amd/opts.c","eval_opts",207,310
7,2,35,2,6,"free_op@316-322@usr.sbin/amd/amd/opts.c","usr.sbin/amd/amd/opts.c","free_op",316,322
22,9,130,1,33,"normalize_slash@328-361@usr.sbin/amd/amd/opts.c","usr.sbin/amd/amd/opts.c","normalize_slash",328,361
165,41,965,2,278,"expand_op@370-648@usr.sbin/amd/amd/opts.c","usr.sbin/amd/amd/opts.c","expand_op",370,648
10,3,64,2,14,"expand_opts@654-668@usr.sbin/amd/amd/opts.c","usr.sbin/amd/amd/opts.c","expand_opts",654,668
6,2,47,3,5,"apply_opts@674-679@usr.sbin/amd/amd/opts.c","usr.sbin/amd/amd/opts.c","apply_opts",674,679
5,1,22,1,11,"free_opts@685-696@usr.sbin/amd/amd/opts.c","usr.sbin/amd/amd/opts.c","free_opts",685,696
7,1,35,1,8,"expand_key@702-710@usr.sbin/amd/amd/opts.c","usr.sbin/amd/amd/opts.c","expand_key",702,710
8,5,45,1,7,"deslashify@717-724@usr.sbin/amd/amd/opts.c","usr.sbin/amd/amd/opts.c","deslashify",717,724
26,7,196,6,81,"eval_fs_opts@727-808@usr.sbin/amd/amd/opts.c","usr.sbin/amd/amd/opts.c","eval_fs_opts",727,808
10,4,61,1,10,"pfs_match@52-62@usr.sbin/amd/amd/pfs_ops.c","usr.sbin/amd/amd/pfs_ops.c","pfs_match",52,62
8,2,40,1,10,"pfs_init@65-75@usr.sbin/amd/amd/pfs_ops.c","usr.sbin/amd/amd/pfs_ops.c","pfs_init",65,75
34,7,208,1,54,"pfs_exec@78-132@usr.sbin/amd/amd/pfs_ops.c","usr.sbin/amd/amd/pfs_ops.c","pfs_exec",78,132
4,1,18,1,3,"pfs_fmount@135-138@usr.sbin/amd/amd/pfs_ops.c","usr.sbin/amd/amd/pfs_ops.c","pfs_fmount",135,138
4,1,20,1,3,"pfs_fumount@141-144@usr.sbin/amd/amd/pfs_ops.c","usr.sbin/amd/amd/pfs_ops.c","pfs_fumount",141,144
64,14,461,0,117,"restart@50-167@usr.sbin/amd/amd/restart.c","usr.sbin/amd/amd/restart.c","restart",50,167
22,7,134,0,49,"fwd_alloc@87-136@usr.sbin/amd/amd/rpc_fwd.c","usr.sbin/amd/amd/rpc_fwd.c","fwd_alloc",87,136
5,3,21,1,10,"fwd_free@144-154@usr.sbin/amd/amd/rpc_fwd.c","usr.sbin/amd/amd/rpc_fwd.c","fwd_free",144,154
11,3,62,0,18,"fwd_init@159-177@usr.sbin/amd/amd/rpc_fwd.c","usr.sbin/amd/amd/rpc_fwd.c","fwd_init",159,177
9,2,36,1,10,"fwd_locate@183-193@usr.sbin/amd/amd/rpc_fwd.c","usr.sbin/amd/amd/rpc_fwd.c","fwd_locate",183,193
47,15,316,7,91,"fwd_packet@204-295@usr.sbin/amd/amd/rpc_fwd.c","usr.sbin/amd/amd/rpc_fwd.c","fwd_packet",204,295
57,22,355,0,110,"fwd_reply@301-411@usr.sbin/amd/amd/rpc_fwd.c","usr.sbin/amd/amd/rpc_fwd.c","fwd_reply",301,411
8,1,44,2,7,"ins_que@69-76@usr.sbin/amd/amd/sched.c","usr.sbin/amd/amd/sched.c","ins_que",69,76
7,1,36,1,6,"rem_que@79-85@usr.sbin/amd/amd/sched.c","usr.sbin/amd/amd/sched.c","rem_que",79,85
8,1,46,2,13,"sched_job@88-101@usr.sbin/amd/amd/sched.c","usr.sbin/amd/amd/sched.c","sched_job",88,101
15,2,106,4,19,"run_task@104-123@usr.sbin/amd/amd/sched.c","usr.sbin/amd/amd/sched.c","run_task",104,123
8,2,60,3,12,"sched_task@129-141@usr.sbin/amd/amd/sched.c","usr.sbin/amd/amd/sched.c","sched_task",129,141
6,1,30,1,5,"wakeupjob@144-149@usr.sbin/amd/amd/sched.c","usr.sbin/amd/amd/sched.c","wakeupjob",144,149
17,9,95,1,31,"wakeup@152-183@usr.sbin/amd/amd/sched.c","usr.sbin/amd/amd/sched.c","wakeup",152,183
4,1,19,3,3,"wakeup_task@186-189@usr.sbin/amd/amd/sched.c","usr.sbin/amd/amd/sched.c","wakeup_task",186,189
29,9,180,1,37,"sigchld@193-230@usr.sbin/amd/amd/sched.c","usr.sbin/amd/amd/sched.c","sigchld",193,230
13,5,104,1,27,"do_task_notify@237-264@usr.sbin/amd/amd/sched.c","usr.sbin/amd/amd/sched.c","do_task_notify",237,264
23,5,136,1,40,"sfs_match@58-98@usr.sbin/amd/amd/sfs_ops.c","usr.sbin/amd/amd/sfs_ops.c","sfs_match",58,98
12,3,55,1,22,"sfsx_mount@103-125@usr.sbin/amd/amd/sfs_ops.c","usr.sbin/amd/amd/sfs_ops.c","sfsx_mount",103,125
4,1,11,1,7,"sfs_fmount@130-137@usr.sbin/amd/amd/sfs_ops.c","usr.sbin/amd/amd/sfs_ops.c","sfs_fmount",130,137
4,1,11,1,3,"sfs_fumount@142-145@usr.sbin/amd/amd/sfs_ops.c","usr.sbin/amd/amd/sfs_ops.c","sfs_fumount",142,145
21,2,115,1,26,"find_afs_srvr@53-79@usr.sbin/amd/amd/srvr_afs.c","usr.sbin/amd/amd/srvr_afs.c","find_afs_srvr",53,79
5,1,19,1,4,"wakeup_srvr@88-92@usr.sbin/amd/amd/srvr_afs.c","usr.sbin/amd/amd/srvr_afs.c","wakeup_srvr",88,92
15,6,95,1,40,"timeout_srvr@98-138@usr.sbin/amd/amd/srvr_afs.c","usr.sbin/amd/amd/srvr_afs.c","timeout_srvr",98,138
14,5,95,1,30,"free_srvr@144-174@usr.sbin/amd/amd/srvr_afs.c","usr.sbin/amd/amd/srvr_afs.c","free_srvr",144,174
5,1,16,1,4,"dup_srvr@180-184@usr.sbin/amd/amd/srvr_afs.c","usr.sbin/amd/amd/srvr_afs.c","dup_srvr",180,184
4,1,29,2,3,"srvrlog@189-192@usr.sbin/amd/amd/srvr_afs.c","usr.sbin/amd/amd/srvr_afs.c","srvrlog",189,192
11,2,54,1,11,"flush_srvr_nfs_cache@91-102@usr.sbin/amd/amd/srvr_nfs.c","usr.sbin/amd/amd/srvr_nfs.c","flush_srvr_nfs_cache",91,102
13,2,80,1,29,"start_ping@108-137@usr.sbin/amd/amd/srvr_nfs.c","usr.sbin/amd/amd/srvr_nfs.c","start_ping",108,137
29,13,205,6,50,"got_portmap@144-194@usr.sbin/amd/amd/srvr_nfs.c","usr.sbin/amd/amd/srvr_nfs.c","got_portmap",144,194
27,2,179,5,27,"call_portmap@200-227@usr.sbin/amd/amd/srvr_nfs.c","usr.sbin/amd/amd/srvr_nfs.c","call_portmap",200,227
15,3,70,1,16,"recompute_portmap@232-248@usr.sbin/amd/amd/srvr_nfs.c","usr.sbin/amd/amd/srvr_nfs.c","recompute_portmap",232,248
49,17,304,6,95,"nfs_pinged@256-351@usr.sbin/amd/amd/srvr_nfs.c","usr.sbin/amd/amd/srvr_nfs.c","nfs_pinged",256,351
31,12,207,1,67,"nfs_timed_out@357-424@usr.sbin/amd/amd/srvr_nfs.c","usr.sbin/amd/amd/srvr_nfs.c","nfs_timed_out",357,424
39,13,207,1,79,"nfs_keepalive@430-509@usr.sbin/amd/amd/srvr_nfs.c","usr.sbin/amd/amd/srvr_nfs.c","nfs_keepalive",430,509
26,8,154,3,41,"nfs_srvr_port@512-553@usr.sbin/amd/amd/srvr_nfs.c","usr.sbin/amd/amd/srvr_nfs.c","nfs_srvr_port",512,553
17,5,90,2,18,"start_nfs_pings@556-574@usr.sbin/amd/amd/srvr_nfs.c","usr.sbin/amd/amd/srvr_nfs.c","start_nfs_pings",556,574
69,12,436,1,118,"find_nfs_srvr@580-698@usr.sbin/amd/amd/srvr_nfs.c","usr.sbin/amd/amd/srvr_nfs.c","find_nfs_srvr",580,698
10,3,48,1,16,"ufs_match@53-69@usr.sbin/amd/amd/ufs_ops.c","usr.sbin/amd/amd/ufs_ops.c","ufs_match",53,69
17,1,114,3,31,"mount_ufs@72-103@usr.sbin/amd/amd/ufs_ops.c","usr.sbin/amd/amd/ufs_ops.c","mount_ufs",72,103
11,2,51,1,12,"ufs_fmount@106-118@usr.sbin/amd/amd/ufs_ops.c","usr.sbin/amd/amd/ufs_ops.c","ufs_fmount",106,118
4,1,16,1,3,"ufs_fumount@121-124@usr.sbin/amd/amd/ufs_ops.c","usr.sbin/amd/amd/ufs_ops.c","ufs_fumount",121,124
23,8,89,1,32,"umount_fs@41-73@usr.sbin/amd/amd/umount_fs.c","usr.sbin/amd/amd/umount_fs.c","umount_fs",41,73
7,1,42,2,8,"strnsave@50-58@usr.sbin/amd/amd/util.c","usr.sbin/amd/amd/util.c","strnsave",50,58
13,3,119,4,13,"str3cat@65-78@usr.sbin/amd/amd/util.c","usr.sbin/amd/amd/util.c","str3cat",65,78
9,2,57,2,10,"strealloc@81-91@usr.sbin/amd/amd/util.c","usr.sbin/amd/amd/util.c","strealloc",81,91
39,18,262,3,70,"strsplit@94-164@usr.sbin/amd/amd/util.c","usr.sbin/amd/amd/util.c","strsplit",94,164
18,9,139,2,22,"domain_strip@178-200@usr.sbin/amd/amd/util.c","usr.sbin/amd/amd/util.c","domain_strip",178,200
13,5,76,1,19,"host_normalize@206-225@usr.sbin/amd/amd/util.c","usr.sbin/amd/amd/util.c","host_normalize",206,225
10,1,77,3,9,"inet_dquad@233-242@usr.sbin/amd/amd/util.c","usr.sbin/amd/amd/util.c","inet_dquad",233,242
7,3,30,1,6,"valid_key@250-256@usr.sbin/amd/amd/util.c","usr.sbin/amd/amd/util.c","valid_key",250,256
16,6,63,1,18,"going_down@259-277@usr.sbin/amd/amd/util.c","usr.sbin/amd/amd/util.c","going_down",259,277
11,3,66,2,12,"bind_resv_port@281-293@usr.sbin/amd/amd/util.c","usr.sbin/amd/amd/util.c","bind_resv_port",281,293
14,5,98,1,16,"forcibly_timeout_mp@296-312@usr.sbin/amd/amd/util.c","usr.sbin/amd/amd/util.c","forcibly_timeout_mp",296,312
19,6,117,1,33,"mf_mounted@315-348@usr.sbin/amd/amd/util.c","usr.sbin/amd/amd/util.c","mf_mounted",315,348
28,13,258,1,53,"am_mounted@351-404@usr.sbin/amd/amd/util.c","usr.sbin/amd/amd/util.c","am_mounted",351,404
14,4,83,1,16,"mount_node@407-423@usr.sbin/amd/amd/util.c","usr.sbin/amd/amd/util.c","mount_node",407,423
11,6,74,1,24,"am_unmounted@426-450@usr.sbin/amd/amd/util.c","usr.sbin/amd/amd/util.c","am_unmounted",426,450
5,1,29,1,4,"auto_fmount@453-457@usr.sbin/amd/amd/util.c","usr.sbin/amd/amd/util.c","auto_fmount",453,457
5,1,29,1,4,"auto_fumount@460-464@usr.sbin/amd/amd/util.c","usr.sbin/amd/amd/util.c","auto_fumount",460,464
15,3,54,1,17,"dofork@472-489@usr.sbin/amd/amd/util.c","usr.sbin/amd/amd/util.c","dofork",472,489
9,3,33,1,11,"background@492-503@usr.sbin/amd/amd/util.c","usr.sbin/amd/amd/util.c","background",492,503
24,8,146,2,42,"mkdirs@509-551@usr.sbin/amd/amd/util.c","usr.sbin/amd/amd/util.c","mkdirs",509,551
26,12,139,1,33,"rmdirs@560-593@usr.sbin/amd/amd/util.c","usr.sbin/amd/amd/util.c","rmdirs",560,593
36,10,246,1,50,"getwire@71-121@usr.sbin/amd/amd/wire.c","usr.sbin/amd/amd/wire.c","getwire",71,121
11,4,76,1,14,"islocalnet@128-142@usr.sbin/amd/amd/wire.c","usr.sbin/amd/amd/wire.c","islocalnet",128,142
6,1,22,1,5,"xmallocfailure@73-78@usr.sbin/amd/amd/xutil.c","usr.sbin/amd/amd/xutil.c","xmallocfailure",73,78
14,4,65,1,16,"xmalloc@81-97@usr.sbin/amd/amd/xutil.c","usr.sbin/amd/amd/xutil.c","xmalloc",81,97
7,2,40,3,7,"xreallocarray@100-107@usr.sbin/amd/amd/xutil.c","usr.sbin/amd/amd/xutil.c","xreallocarray",100,107
22,6,164,3,22,"expand_error@116-138@usr.sbin/amd/amd/xutil.c","usr.sbin/amd/amd/xutil.c","expand_error",116,138
29,12,169,1,36,"show_time_host_and_name@144-180@usr.sbin/amd/amd/xutil.c","usr.sbin/amd/amd/xutil.c","show_time_host_and_name",144,180
31,11,199,3,38,"plog@183-221@usr.sbin/amd/amd/xutil.c","usr.sbin/amd/amd/xutil.c","plog",183,221
11,2,74,2,14,"show_opts@224-238@usr.sbin/amd/amd/xutil.c","usr.sbin/amd/amd/xutil.c","show_opts",224,238
43,16,244,3,61,"cmdoption@241-302@usr.sbin/amd/amd/xutil.c","usr.sbin/amd/amd/xutil.c","cmdoption",241,302
15,3,61,1,18,"switch_option@308-326@usr.sbin/amd/amd/xutil.c","usr.sbin/amd/amd/xutil.c","switch_option",308,326
28,9,150,1,39,"switch_to_logfile@332-371@usr.sbin/amd/amd/xutil.c","usr.sbin/amd/amd/xutil.c","switch_to_logfile",332,371
9,2,42,1,11,"clocktime@377-388@usr.sbin/amd/amd/xutil.c","usr.sbin/amd/amd/xutil.c","clocktime",377,388
55,13,404,5,63,"show_mti@75-138@usr.sbin/amd/amq/amq.c","usr.sbin/amd/amq/amq.c","show_mti",75,138
9,2,64,5,8,"show_mt@144-152@usr.sbin/amd/amq/amq.c","usr.sbin/amd/amq/amq.c","show_mt",144,152
43,12,283,5,45,"show_mi@155-200@usr.sbin/amd/amq/amq.c","usr.sbin/amd/amq/amq.c","show_mi",155,200
7,1,35,1,6,"show_ms@206-212@usr.sbin/amd/amq/amq.c","usr.sbin/amd/amq/amq.c","show_ms",206,212
6,1,34,2,6,"xdr_pri_free@215-221@usr.sbin/amd/amq/amq.c","usr.sbin/amd/amq/amq.c","xdr_pri_free",215,221
233,52,1233,2,296,"main@227-523@usr.sbin/amd/amq/amq.c","usr.sbin/amd/amq/amq.c","main",227,523
21,5,139,1,22,"inetresport@531-553@usr.sbin/amd/amq/amq.c","usr.sbin/amd/amq/amq.c","inetresport",531,553
9,2,34,1,10,"privsock@562-572@usr.sbin/amd/amq/amq.c","usr.sbin/amd/amq/amq.c","privsock",562,572
9,2,72,2,9,"amqproc_null_57@13-22@usr.sbin/amd/rpcx/amq_clnt.c","usr.sbin/amd/rpcx/amq_clnt.c","amqproc_null_57",13,22
9,2,68,2,9,"amqproc_mnttree_57@25-34@usr.sbin/amd/rpcx/amq_clnt.c","usr.sbin/amd/rpcx/amq_clnt.c","amqproc_mnttree_57",25,34
9,2,72,2,9,"amqproc_umnt_57@37-46@usr.sbin/amd/rpcx/amq_clnt.c","usr.sbin/amd/rpcx/amq_clnt.c","amqproc_umnt_57",37,46
9,2,68,2,9,"amqproc_stats_57@49-58@usr.sbin/amd/rpcx/amq_clnt.c","usr.sbin/amd/rpcx/amq_clnt.c","amqproc_stats_57",49,58
9,2,68,2,9,"amqproc_export_57@61-70@usr.sbin/amd/rpcx/amq_clnt.c","usr.sbin/amd/rpcx/amq_clnt.c","amqproc_export_57",61,70
9,2,68,2,9,"amqproc_setopt_57@73-82@usr.sbin/amd/rpcx/amq_clnt.c","usr.sbin/amd/rpcx/amq_clnt.c","amqproc_setopt_57",73,82
9,2,68,2,9,"amqproc_getmntfs_57@85-94@usr.sbin/amd/rpcx/amq_clnt.c","usr.sbin/amd/rpcx/amq_clnt.c","amqproc_getmntfs_57",85,94
9,2,68,2,9,"amqproc_getvers_57@97-106@usr.sbin/amd/rpcx/amq_clnt.c","usr.sbin/amd/rpcx/amq_clnt.c","amqproc_getvers_57",97,106
79,14,533,2,89,"amq_program_57@42-131@usr.sbin/amd/rpcx/amq_svc.c","usr.sbin/amd/rpcx/amq_svc.c","amq_program_57",42,131
6,2,34,2,6,"xdr_amq_string@9-15@usr.sbin/amd/rpcx/amq_xdr.c","usr.sbin/amd/rpcx/amq_xdr.c","xdr_amq_string",9,15
6,2,32,2,6,"xdr_time_type@18-24@usr.sbin/amd/rpcx/amq_xdr.c","usr.sbin/amd/rpcx/amq_xdr.c","xdr_time_type",18,24
30,14,279,2,31,"xdr_amq_mount_tree@27-58@usr.sbin/amd/rpcx/amq_xdr.c","usr.sbin/amd/rpcx/amq_xdr.c","xdr_amq_mount_tree",27,58
6,2,46,2,6,"xdr_amq_mount_tree_p@61-67@usr.sbin/amd/rpcx/amq_xdr.c","usr.sbin/amd/rpcx/amq_xdr.c","xdr_amq_mount_tree_p",61,67
18,8,143,2,19,"xdr_amq_mount_info@70-89@usr.sbin/amd/rpcx/amq_xdr.c","usr.sbin/amd/rpcx/amq_xdr.c","xdr_amq_mount_info",70,89
8,2,60,2,8,"xdr_amq_mount_info_list@92-100@usr.sbin/amd/rpcx/amq_xdr.c","usr.sbin/amd/rpcx/amq_xdr.c","xdr_amq_mount_info_list",92,100
8,2,60,2,8,"xdr_amq_mount_tree_list@103-111@usr.sbin/amd/rpcx/amq_xdr.c","usr.sbin/amd/rpcx/amq_xdr.c","xdr_amq_mount_tree_list",103,111
14,6,107,2,15,"xdr_amq_mount_stats@114-129@usr.sbin/amd/rpcx/amq_xdr.c","usr.sbin/amd/rpcx/amq_xdr.c","xdr_amq_mount_stats",114,129
6,2,36,2,6,"xdr_amq_opt@132-138@usr.sbin/amd/rpcx/amq_xdr.c","usr.sbin/amd/rpcx/amq_xdr.c","xdr_amq_opt",132,138
8,3,53,2,9,"xdr_amq_setopt@141-150@usr.sbin/amd/rpcx/amq_xdr.c","usr.sbin/amd/rpcx/amq_xdr.c","xdr_amq_setopt",141,150
34,16,245,2,39,"xdr_fhstatus@46-85@usr.sbin/amd/rpcx/mount_xdr.c","usr.sbin/amd/rpcx/mount_xdr.c","xdr_fhstatus",46,85
7,2,36,2,6,"xdr_dirpath@88-94@usr.sbin/amd/rpcx/mount_xdr.c","usr.sbin/amd/rpcx/mount_xdr.c","xdr_dirpath",88,94
7,2,36,2,6,"xdr_name@97-103@usr.sbin/amd/rpcx/mount_xdr.c","usr.sbin/amd/rpcx/mount_xdr.c","xdr_name",97,103
7,2,46,2,6,"xdr_mountlist@106-112@usr.sbin/amd/rpcx/mount_xdr.c","usr.sbin/amd/rpcx/mount_xdr.c","xdr_mountlist",106,112
13,4,77,2,12,"xdr_mountbody@115-127@usr.sbin/amd/rpcx/mount_xdr.c","usr.sbin/amd/rpcx/mount_xdr.c","xdr_mountbody",115,127
7,2,46,2,6,"xdr_groups@130-136@usr.sbin/amd/rpcx/mount_xdr.c","usr.sbin/amd/rpcx/mount_xdr.c","xdr_groups",130,136
10,3,57,2,9,"xdr_groupnode@139-148@usr.sbin/amd/rpcx/mount_xdr.c","usr.sbin/amd/rpcx/mount_xdr.c","xdr_groupnode",139,148
7,2,46,2,6,"xdr_exports@151-157@usr.sbin/amd/rpcx/mount_xdr.c","usr.sbin/amd/rpcx/mount_xdr.c","xdr_exports",151,157
13,4,77,2,12,"xdr_exportnode@160-172@usr.sbin/amd/rpcx/mount_xdr.c","usr.sbin/amd/rpcx/mount_xdr.c","xdr_exportnode",160,172
132,23,905,2,150,"nfs_program_2@42-192@usr.sbin/amd/rpcx/nfs_prot_svc.c","usr.sbin/amd/rpcx/nfs_prot_svc.c","nfs_program_2",42,192
6,2,36,2,7,"xdr_nfs_fh@9-16@usr.sbin/amd/rpcx/nfs_prot_xdr.c","usr.sbin/amd/rpcx/nfs_prot_xdr.c","xdr_nfs_fh",9,16
8,3,53,2,9,"xdr_nfstime@19-28@usr.sbin/amd/rpcx/nfs_prot_xdr.c","usr.sbin/amd/rpcx/nfs_prot_xdr.c","xdr_nfstime",19,28
32,15,269,2,33,"xdr_fattr@31-64@usr.sbin/amd/rpcx/nfs_prot_xdr.c","usr.sbin/amd/rpcx/nfs_prot_xdr.c","xdr_fattr",31,64
16,7,125,2,17,"xdr_sattr@67-84@usr.sbin/amd/rpcx/nfs_prot_xdr.c","usr.sbin/amd/rpcx/nfs_prot_xdr.c","xdr_sattr",67,84
6,2,34,2,6,"xdr_filename@87-93@usr.sbin/amd/rpcx/nfs_prot_xdr.c","usr.sbin/amd/rpcx/nfs_prot_xdr.c","xdr_filename",87,93
6,2,34,2,6,"xdr_nfspath@96-102@usr.sbin/amd/rpcx/nfs_prot_xdr.c","usr.sbin/amd/rpcx/nfs_prot_xdr.c","xdr_nfspath",96,102
14,4,72,2,14,"xdr_attrstat@105-119@usr.sbin/amd/rpcx/nfs_prot_xdr.c","usr.sbin/amd/rpcx/nfs_prot_xdr.c","xdr_attrstat",105,119
8,3,53,2,9,"xdr_sattrargs@122-131@usr.sbin/amd/rpcx/nfs_prot_xdr.c","usr.sbin/amd/rpcx/nfs_prot_xdr.c","xdr_sattrargs",122,131
8,3,53,2,9,"xdr_diropargs@134-143@usr.sbin/amd/rpcx/nfs_prot_xdr.c","usr.sbin/amd/rpcx/nfs_prot_xdr.c","xdr_diropargs",134,143
8,3,53,2,9,"xdr_diropokres@146-155@usr.sbin/amd/rpcx/nfs_prot_xdr.c","usr.sbin/amd/rpcx/nfs_prot_xdr.c","xdr_diropokres",146,155
14,4,72,2,14,"xdr_diropres@158-172@usr.sbin/amd/rpcx/nfs_prot_xdr.c","usr.sbin/amd/rpcx/nfs_prot_xdr.c","xdr_diropres",158,172
14,4,72,2,14,"xdr_readlinkres@175-189@usr.sbin/amd/rpcx/nfs_prot_xdr.c","usr.sbin/amd/rpcx/nfs_prot_xdr.c","xdr_readlinkres",175,189
12,5,89,2,13,"xdr_readargs@192-205@usr.sbin/amd/rpcx/nfs_prot_xdr.c","usr.sbin/amd/rpcx/nfs_prot_xdr.c","xdr_readargs",192,205
10,3,72,2,11,"xdr_readokres@208-219@usr.sbin/amd/rpcx/nfs_prot_xdr.c","usr.sbin/amd/rpcx/nfs_prot_xdr.c","xdr_readokres",208,219
14,4,72,2,14,"xdr_readres@222-236@usr.sbin/amd/rpcx/nfs_prot_xdr.c","usr.sbin/amd/rpcx/nfs_prot_xdr.c","xdr_readres",222,236
16,6,126,2,17,"xdr_writeargs@239-256@usr.sbin/amd/rpcx/nfs_prot_xdr.c","usr.sbin/amd/rpcx/nfs_prot_xdr.c","xdr_writeargs",239,256
8,3,53,2,9,"xdr_createargs@259-268@usr.sbin/amd/rpcx/nfs_prot_xdr.c","usr.sbin/amd/rpcx/nfs_prot_xdr.c","xdr_createargs",259,268
8,3,53,2,9,"xdr_renameargs@271-280@usr.sbin/amd/rpcx/nfs_prot_xdr.c","usr.sbin/amd/rpcx/nfs_prot_xdr.c","xdr_renameargs",271,280
8,3,53,2,9,"xdr_linkargs@283-292@usr.sbin/amd/rpcx/nfs_prot_xdr.c","usr.sbin/amd/rpcx/nfs_prot_xdr.c","xdr_linkargs",283,292
10,4,71,2,11,"xdr_symlinkargs@295-306@usr.sbin/amd/rpcx/nfs_prot_xdr.c","usr.sbin/amd/rpcx/nfs_prot_xdr.c","xdr_symlinkargs",295,306
6,2,33,2,6,"xdr_nfscookie@309-315@usr.sbin/amd/rpcx/nfs_prot_xdr.c","usr.sbin/amd/rpcx/nfs_prot_xdr.c","xdr_nfscookie",309,315
10,4,70,2,11,"xdr_readdirargs@318-329@usr.sbin/amd/rpcx/nfs_prot_xdr.c","usr.sbin/amd/rpcx/nfs_prot_xdr.c","xdr_readdirargs",318,329
12,5,102,2,13,"xdr_entry@332-345@usr.sbin/amd/rpcx/nfs_prot_xdr.c","usr.sbin/amd/rpcx/nfs_prot_xdr.c","xdr_entry",332,345
8,3,67,2,9,"xdr_dirlist@348-357@usr.sbin/amd/rpcx/nfs_prot_xdr.c","usr.sbin/amd/rpcx/nfs_prot_xdr.c","xdr_dirlist",348,357
14,4,72,2,14,"xdr_readdirres@360-374@usr.sbin/amd/rpcx/nfs_prot_xdr.c","usr.sbin/amd/rpcx/nfs_prot_xdr.c","xdr_readdirres",360,374
14,6,107,2,15,"xdr_statfsokres@377-392@usr.sbin/amd/rpcx/nfs_prot_xdr.c","usr.sbin/amd/rpcx/nfs_prot_xdr.c","xdr_statfsokres",377,392
14,4,72,2,14,"xdr_statfsres@395-409@usr.sbin/amd/rpcx/nfs_prot_xdr.c","usr.sbin/amd/rpcx/nfs_prot_xdr.c","xdr_statfsres",395,409
6,1,20,1,5,"usage@61-66@usr.sbin/apm/apm.c","usr.sbin/apm/apm.c","usage",61,66
6,1,20,1,5,"zzusage@69-74@usr.sbin/apm/apm.c","usr.sbin/apm/apm.c","zzusage",69,74
14,3,101,3,15,"send_command@77-92@usr.sbin/apm/apm.c","usr.sbin/apm/apm.c","send_command",77,92
25,5,104,2,26,"do_zzz@95-121@usr.sbin/apm/apm.c","usr.sbin/apm/apm.c","do_zzz",95,121
17,3,113,1,18,"open_socket@124-142@usr.sbin/apm/apm.c","usr.sbin/apm/apm.c","open_socket",124,142
252,90,1233,2,274,"main@145-419@usr.sbin/apm/apm.c","usr.sbin/apm/apm.c","main",145,419
5,1,16,1,4,"sigexit@87-91@usr.sbin/apmd/apmd.c","usr.sbin/apmd/apmd.c","sigexit",87,91
7,1,21,1,6,"usage@94-100@usr.sbin/apmd/apmd.c","usr.sbin/apmd/apmd.c","usage",94,100
12,2,74,2,12,"error@103-115@usr.sbin/apmd/apmd.c","usr.sbin/apmd/apmd.c","error",103,115
5,2,32,2,4,"set_driver_messages@122-126@usr.sbin/apmd/apmd.c","usr.sbin/apmd/apmd.c","set_driver_messages",122,126
48,16,260,3,63,"power_status@129-192@usr.sbin/apmd/apmd.c","usr.sbin/apmd/apmd.c","power_status",129,192
5,2,18,1,4,"sockunlink@197-201@usr.sbin/apmd/apmd.c","usr.sbin/apmd/apmd.c","sockunlink",197,201
22,5,174,1,28,"bind_socket@204-232@usr.sbin/apmd/apmd.c","usr.sbin/apmd/apmd.c","bind_socket",204,232
69,13,388,2,77,"handle_client@235-312@usr.sbin/apmd/apmd.c","usr.sbin/apmd/apmd.c","handle_client",235,312
8,1,37,1,7,"suspend@315-322@usr.sbin/apmd/apmd.c","usr.sbin/apmd/apmd.c","suspend",315,322
8,1,37,1,7,"stand_by@325-332@usr.sbin/apmd/apmd.c","usr.sbin/apmd/apmd.c","stand_by",325,332
8,1,37,1,7,"hibernate@335-342@usr.sbin/apmd/apmd.c","usr.sbin/apmd/apmd.c","hibernate",335,342
230,73,1221,2,260,"main@347-607@usr.sbin/apmd/apmd.c","usr.sbin/apmd/apmd.c","main",347,607
21,5,155,1,23,"setperfpolicy@610-633@usr.sbin/apmd/apmd.c","usr.sbin/apmd/apmd.c","setperfpolicy",610,633
32,6,165,1,38,"do_etc_file@636-674@usr.sbin/apmd/apmd.c","usr.sbin/apmd/apmd.c","do_etc_file",636,674
19,7,54,1,18,"battstate@37-55@usr.sbin/apmd/apmsubr.c","usr.sbin/apmd/apmsubr.c","battstate",37,55
15,5,42,1,14,"ac_state@58-72@usr.sbin/apmd/apmsubr.c","usr.sbin/apmd/apmsubr.c","ac_state",58,72
13,4,36,1,12,"perf_mode@75-87@usr.sbin/apmd/apmsubr.c","usr.sbin/apmd/apmsubr.c","perf_mode",75,87
96,40,462,2,98,"main@106-204@usr.sbin/arp/arp.c","usr.sbin/arp/arp.c","main",106,204
29,6,243,1,29,"file@210-239@usr.sbin/arp/arp.c","usr.sbin/arp/arp.c","file",210,239
13,5,90,1,14,"getsocket@242-256@usr.sbin/arp/arp.c","usr.sbin/arp/arp.c","getsocket",242,256
83,23,495,2,92,"set@273-365@usr.sbin/arp/arp.c","usr.sbin/arp/arp.c","set",273,365
18,3,115,1,20,"get@375-395@usr.sbin/arp/arp.c","usr.sbin/arp/arp.c","get",375,395
49,17,265,1,51,"delete@401-452@usr.sbin/arp/arp.c","usr.sbin/arp/arp.c","delete",401,452
46,11,328,2,46,"search@458-504@usr.sbin/arp/arp.c","usr.sbin/arp/arp.c","search",458,504
7,1,40,1,7,"dump@510-517@usr.sbin/arp/arp.c","usr.sbin/arp/arp.c","dump",510,517
42,12,336,3,47,"print_entry@523-570@usr.sbin/arp/arp.c","usr.sbin/arp/arp.c","print_entry",523,570
7,1,47,3,7,"nuke_entry@576-583@usr.sbin/arp/arp.c","usr.sbin/arp/arp.c","nuke_entry",576,583
12,2,99,1,13,"ether_str@586-599@usr.sbin/arp/arp.c","usr.sbin/arp/arp.c","ether_str",586,599
9,1,34,1,8,"usage@602-610@usr.sbin/arp/arp.c","usr.sbin/arp/arp.c","usage",602,610
58,14,356,1,72,"rtmsg@613-685@usr.sbin/arp/arp.c","usr.sbin/arp/arp.c","rtmsg",613,685
35,9,200,2,39,"rtget@688-727@usr.sbin/arp/arp.c","usr.sbin/arp/arp.c","rtget",688,727
12,3,88,2,12,"getinetaddr@730-742@usr.sbin/arp/arp.c","usr.sbin/arp/arp.c","getinetaddr",730,742
36,12,240,1,38,"sec2str@745-783@usr.sbin/arp/arp.c","usr.sbin/arp/arp.c","sec2str",745,783
28,11,201,2,39,"wake@818-857@usr.sbin/arp/arp.c","usr.sbin/arp/arp.c","wake",818,857
11,4,86,3,11,"do_wakeup@860-871@usr.sbin/arp/arp.c","usr.sbin/arp/arp.c","do_wakeup",860,871
15,5,99,2,15,"bind_if_to_bpf@874-889@usr.sbin/arp/arp.c","usr.sbin/arp/arp.c","bind_if_to_bpf",874,889
13,3,62,2,15,"get_ether@892-907@usr.sbin/arp/arp.c","usr.sbin/arp/arp.c","get_ether",892,907
19,3,173,2,19,"send_frame@913-932@usr.sbin/arp/arp.c","usr.sbin/arp/arp.c","send_frame",913,932
206,51,1372,2,272,"main@82-354@usr.sbin/authpf/authpf.c","usr.sbin/authpf/authpf.c","main",82,354
54,24,415,1,61,"read_config@360-421@usr.sbin/authpf/authpf.c","usr.sbin/authpf/authpf.c","read_config",360,421
16,5,96,1,17,"print_message@430-447@usr.sbin/authpf/authpf.c","usr.sbin/authpf/authpf.c","print_message",430,447
73,15,431,1,104,"allowed_luser@462-566@usr.sbin/authpf/authpf.c","usr.sbin/authpf/authpf.c","allowed_luser",462,566
36,8,220,2,51,"check_luser@579-630@usr.sbin/authpf/authpf.c","usr.sbin/authpf/authpf.c","check_luser",579,630
36,15,245,1,38,"remove_stale_rulesets@637-675@usr.sbin/authpf/authpf.c","usr.sbin/authpf/authpf.c","remove_stale_rulesets",637,675
47,13,336,2,55,"recursive_ruleset_purge@678-733@usr.sbin/authpf/authpf.c","usr.sbin/authpf/authpf.c","recursive_ruleset_purge",678,733
93,21,615,3,102,"change_filter@739-841@usr.sbin/authpf/authpf.c","usr.sbin/authpf/authpf.c","change_filter",739,841
32,9,234,2,34,"change_table@847-881@usr.sbin/authpf/authpf.c","usr.sbin/authpf/authpf.c","change_table",847,881
28,5,288,1,33,"authpf_kill_states@891-924@usr.sbin/authpf/authpf.c","usr.sbin/authpf/authpf.c","authpf_kill_states",891,924
4,1,11,1,3,"need_death@928-931@usr.sbin/authpf/authpf.c","usr.sbin/authpf/authpf.c","need_death",928,931
15,6,80,1,15,"do_death@937-952@usr.sbin/authpf/authpf.c","usr.sbin/authpf/authpf.c","do_death",937,952
7,1,25,1,7,"usage@110-117@usr.sbin/bgpctl/bgpctl.c","usr.sbin/bgpctl/bgpctl.c","usage",110,117
370,127,2450,2,394,"main@120-514@usr.sbin/bgpctl/bgpctl.c","usr.sbin/bgpctl/bgpctl.c","main",120,514
21,11,161,4,23,"fmt_peer@517-540@usr.sbin/bgpctl/bgpctl.c","usr.sbin/bgpctl/bgpctl.c","fmt_peer",517,540
5,1,25,1,4,"show_summary_head@543-547@usr.sbin/bgpctl/bgpctl.c","usr.sbin/bgpctl/bgpctl.c","show_summary_head",543,547
46,8,316,2,50,"show_summary_msg@550-600@usr.sbin/bgpctl/bgpctl.c","usr.sbin/bgpctl/bgpctl.c","show_summary_msg",550,600
20,4,121,2,21,"show_summary_terse_msg@603-624@usr.sbin/bgpctl/bgpctl.c","usr.sbin/bgpctl/bgpctl.c","show_summary_terse_msg",603,624
26,3,154,1,27,"show_neighbor_terse@627-654@usr.sbin/bgpctl/bgpctl.c","usr.sbin/bgpctl/bgpctl.c","show_neighbor_terse",627,654
18,7,52,1,17,"print_auth_method@657-674@usr.sbin/bgpctl/bgpctl.c","usr.sbin/bgpctl/bgpctl.c","print_auth_method",657,674
138,42,976,2,142,"show_neighbor_msg@677-819@usr.sbin/bgpctl/bgpctl.c","usr.sbin/bgpctl/bgpctl.c","show_neighbor_msg",677,819
10,4,67,1,10,"print_neighbor_capa_mp@822-832@usr.sbin/bgpctl/bgpctl.c","usr.sbin/bgpctl/bgpctl.c","print_neighbor_capa_mp",822,832
19,8,148,1,19,"print_neighbor_capa_restart@835-854@usr.sbin/bgpctl/bgpctl.c","usr.sbin/bgpctl/bgpctl.c","print_neighbor_capa_restart",835,854
30,1,260,1,29,"print_neighbor_msgstats@857-886@usr.sbin/bgpctl/bgpctl.c","usr.sbin/bgpctl/bgpctl.c","print_neighbor_msgstats",857,886
8,2,43,2,8,"print_timer@889-897@usr.sbin/bgpctl/bgpctl.c","usr.sbin/bgpctl/bgpctl.c","print_timer",889,897
7,2,32,1,6,"fmt_timeframe@903-909@usr.sbin/bgpctl/bgpctl.c","usr.sbin/bgpctl/bgpctl.c","fmt_timeframe",903,909
27,4,168,1,31,"fmt_timeframe_core@912-943@usr.sbin/bgpctl/bgpctl.c","usr.sbin/bgpctl/bgpctl.c","fmt_timeframe_core",912,943
9,1,28,1,8,"show_fib_head@946-954@usr.sbin/bgpctl/bgpctl.c","usr.sbin/bgpctl/bgpctl.c","show_fib_head",946,954
4,1,17,1,3,"show_fib_tables_head@957-960@usr.sbin/bgpctl/bgpctl.c","usr.sbin/bgpctl/bgpctl.c","show_fib_tables_head",957,960
5,1,16,1,4,"show_network_head@963-967@usr.sbin/bgpctl/bgpctl.c","usr.sbin/bgpctl/bgpctl.c","show_network_head",963,967
34,12,161,1,38,"show_fib_flags@970-1008@usr.sbin/bgpctl/bgpctl.c","usr.sbin/bgpctl/bgpctl.c","show_fib_flags",970,1008
38,11,245,1,45,"show_fib_msg@1011-1056@usr.sbin/bgpctl/bgpctl.c","usr.sbin/bgpctl/bgpctl.c","show_fib_msg",1011,1056
6,1,26,1,5,"show_nexthop_head@1059-1064@usr.sbin/bgpctl/bgpctl.c","usr.sbin/bgpctl/bgpctl.c","show_nexthop_head",1059,1064
68,17,450,1,69,"show_nexthop_msg@1067-1136@usr.sbin/bgpctl/bgpctl.c","usr.sbin/bgpctl/bgpctl.c","show_nexthop_msg",1067,1136
5,1,19,1,4,"show_interface_head@1140-1144@usr.sbin/bgpctl/bgpctl.c","usr.sbin/bgpctl/bgpctl.c","show_interface_head",1140,1144
15,5,52,1,14,"ift2ifm@1152-1166@usr.sbin/bgpctl/bgpctl.c","usr.sbin/bgpctl/bgpctl.c","ift2ifm",1152,1166
8,3,48,1,9,"get_media_descr@1169-1178@usr.sbin/bgpctl/bgpctl.c","usr.sbin/bgpctl/bgpctl.c","get_media_descr",1169,1178
11,3,77,2,11,"get_linkstate@1181-1192@usr.sbin/bgpctl/bgpctl.c","usr.sbin/bgpctl/bgpctl.c","get_linkstate",1181,1192
17,4,132,2,18,"get_baudrate@1195-1213@usr.sbin/bgpctl/bgpctl.c","usr.sbin/bgpctl/bgpctl.c","get_baudrate",1195,1213
25,8,168,1,29,"show_interface_msg@1216-1245@usr.sbin/bgpctl/bgpctl.c","usr.sbin/bgpctl/bgpctl.c","show_interface_msg",1216,1245
8,1,34,1,7,"show_rib_summary_head@1248-1255@usr.sbin/bgpctl/bgpctl.c","usr.sbin/bgpctl/bgpctl.c","show_rib_summary_head",1248,1255
9,2,65,3,9,"print_prefix@1258-1267@usr.sbin/bgpctl/bgpctl.c","usr.sbin/bgpctl/bgpctl.c","print_prefix",1258,1267
13,8,63,2,12,"print_origin@1270-1282@usr.sbin/bgpctl/bgpctl.c","usr.sbin/bgpctl/bgpctl.c","print_origin",1270,1282
32,12,164,2,32,"print_flags@1285-1317@usr.sbin/bgpctl/bgpctl.c","usr.sbin/bgpctl/bgpctl.c","print_flags",1285,1317
18,3,86,1,19,"show_rib_summary_msg@1320-1339@usr.sbin/bgpctl/bgpctl.c","usr.sbin/bgpctl/bgpctl.c","show_rib_summary_msg",1320,1339
26,5,143,3,27,"show_rib_detail_msg@1342-1369@usr.sbin/bgpctl/bgpctl.c","usr.sbin/bgpctl/bgpctl.c","show_rib_detail_msg",1342,1369
13,3,118,2,15,"show_rib_brief@1372-1387@usr.sbin/bgpctl/bgpctl.c","usr.sbin/bgpctl/bgpctl.c","show_rib_brief",1372,1387
30,4,264,4,35,"show_rib_detail@1390-1425@usr.sbin/bgpctl/bgpctl.c","usr.sbin/bgpctl/bgpctl.c","show_rib_detail",1390,1425
85,19,520,3,93,"show_attr@1428-1521@usr.sbin/bgpctl/bgpctl.c","usr.sbin/bgpctl/bgpctl.c","show_attr",1428,1521
41,11,197,2,43,"show_community@1524-1567@usr.sbin/bgpctl/bgpctl.c","usr.sbin/bgpctl/bgpctl.c","show_community",1524,1567
18,4,139,2,20,"show_large_community@1570-1590@usr.sbin/bgpctl/bgpctl.c","usr.sbin/bgpctl/bgpctl.c","show_large_community",1570,1590
61,13,416,2,64,"show_ext_community@1593-1657@usr.sbin/bgpctl/bgpctl.c","usr.sbin/bgpctl/bgpctl.c","show_ext_community",1593,1657
7,2,49,1,8,"fmt_mem@1660-1668@usr.sbin/bgpctl/bgpctl.c","usr.sbin/bgpctl/bgpctl.c","fmt_mem",1660,1668
49,4,369,1,50,"show_rib_memory_msg@1673-1723@usr.sbin/bgpctl/bgpctl.c","usr.sbin/bgpctl/bgpctl.c","show_rib_memory_msg",1673,1723
10,2,70,2,10,"send_filterset@1726-1736@usr.sbin/bgpctl/bgpctl.c","usr.sbin/bgpctl/bgpctl.c","send_filterset",1726,1736
30,15,158,2,32,"get_errstr@1739-1771@usr.sbin/bgpctl/bgpctl.c","usr.sbin/bgpctl/bgpctl.c","get_errstr",1739,1771
17,4,103,1,19,"show_result@1774-1793@usr.sbin/bgpctl/bgpctl.c","usr.sbin/bgpctl/bgpctl.c","show_result",1774,1793
49,8,344,1,52,"network_bulk@1796-1848@usr.sbin/bgpctl/bgpctl.c","usr.sbin/bgpctl/bgpctl.c","network_bulk",1796,1848
54,16,449,3,62,"show_mrt_dump@1851-1913@usr.sbin/bgpctl/bgpctl.c","usr.sbin/bgpctl/bgpctl.c","show_mrt_dump",1851,1913
69,21,619,3,79,"network_mrt_dump@1916-1995@usr.sbin/bgpctl/bgpctl.c","usr.sbin/bgpctl/bgpctl.c","network_mrt_dump",1916,1995
9,1,85,2,9,"show_mrt_state@1998-2007@usr.sbin/bgpctl/bgpctl.c","usr.sbin/bgpctl/bgpctl.c","show_mrt_state",1998,2007
8,1,75,2,8,"show_mrt_msg@2010-2018@usr.sbin/bgpctl/bgpctl.c","usr.sbin/bgpctl/bgpctl.c","show_mrt_msg",2010,2018
17,4,116,2,16,"mrt_to_bgpd_addr@2021-2037@usr.sbin/bgpctl/bgpctl.c","usr.sbin/bgpctl/bgpctl.c","mrt_to_bgpd_addr",2021,2037
6,2,35,1,5,"msg_type@2040-2045@usr.sbin/bgpctl/bgpctl.c","usr.sbin/bgpctl/bgpctl.c","msg_type",2040,2045
14,3,102,1,16,"asset_expand@52-68@usr.sbin/bgpctl/irr_asset.c","usr.sbin/bgpctl/irr_asset.c","asset_expand",52,68
41,12,276,1,57,"asset_get@71-128@usr.sbin/bgpctl/irr_asset.c","usr.sbin/bgpctl/irr_asset.c","asset_get",71,128
16,8,129,1,21,"asset_membertype@131-152@usr.sbin/bgpctl/irr_asset.c","usr.sbin/bgpctl/irr_asset.c","asset_membertype",131,152
19,5,144,1,31,"asset_resolve@155-186@usr.sbin/bgpctl/irr_asset.c","usr.sbin/bgpctl/irr_asset.c","asset_resolve",155,186
23,12,205,2,27,"asset_merge@189-216@usr.sbin/bgpctl/irr_asset.c","usr.sbin/bgpctl/irr_asset.c","asset_merge",189,216
17,4,142,1,20,"asset_addmember@219-239@usr.sbin/bgpctl/irr_asset.c","usr.sbin/bgpctl/irr_asset.c","asset_addmember",219,239
13,3,96,2,15,"asset_add_as@242-257@usr.sbin/bgpctl/irr_asset.c","usr.sbin/bgpctl/irr_asset.c","asset_add_as",242,257
13,3,96,2,15,"asset_add_asset@260-275@usr.sbin/bgpctl/irr_asset.c","usr.sbin/bgpctl/irr_asset.c","asset_add_asset",260,275
4,1,28,2,3,"as_set_compare@279-282@usr.sbin/bgpctl/irr_asset.c","usr.sbin/bgpctl/irr_asset.c","as_set_compare",279,282
6,1,32,1,6,"as_set_find@285-291@usr.sbin/bgpctl/irr_asset.c","usr.sbin/bgpctl/irr_asset.c","as_set_find",285,291
37,11,284,1,42,"write_filters@45-87@usr.sbin/bgpctl/irr_output.c","usr.sbin/bgpctl/irr_output.c","write_filters",45,87
15,2,92,2,18,"process_policies@90-108@usr.sbin/bgpctl/irr_output.c","usr.sbin/bgpctl/irr_output.c","process_policies",90,108
14,5,102,2,13,"policy_prettyprint@111-124@usr.sbin/bgpctl/irr_output.c","usr.sbin/bgpctl/irr_output.c","policy_prettyprint",111,124
20,6,172,2,23,"policy_torule@127-150@usr.sbin/bgpctl/irr_output.c","usr.sbin/bgpctl/irr_output.c","policy_torule",127,150
34,10,241,1,39,"action_torule@154-193@usr.sbin/bgpctl/irr_output.c","usr.sbin/bgpctl/irr_output.c","action_torule",154,193
44,10,343,4,50,"print_rule@196-246@usr.sbin/bgpctl/irr_output.c","usr.sbin/bgpctl/irr_output.c","print_rule",196,246
41,12,239,2,45,"parse_response@50-95@usr.sbin/bgpctl/irr_parser.c","usr.sbin/bgpctl/irr_parser.c","parse_response",50,95
12,3,65,1,13,"grow_parsebuf@98-111@usr.sbin/bgpctl/irr_parser.c","usr.sbin/bgpctl/irr_parser.c","grow_parsebuf",98,111
68,25,340,1,76,"irr_getln@114-190@usr.sbin/bgpctl/irr_parser.c","usr.sbin/bgpctl/irr_parser.c","irr_getln",114,190
137,56,782,2,152,"parse_policy@210-362@usr.sbin/bgpctl/irr_parser.c","usr.sbin/bgpctl/irr_parser.c","parse_policy",210,362
16,6,133,2,19,"policy_additem@365-384@usr.sbin/bgpctl/irr_parser.c","usr.sbin/bgpctl/irr_parser.c","policy_additem",365,384
12,4,72,2,14,"parse_asset@391-405@usr.sbin/bgpctl/irr_parser.c","usr.sbin/bgpctl/irr_parser.c","parse_asset",391,405
9,6,88,2,12,"parse_route@411-423@usr.sbin/bgpctl/irr_parser.c","usr.sbin/bgpctl/irr_parser.c","parse_route",411,423
27,11,216,1,32,"prefixset_get@46-78@usr.sbin/bgpctl/irr_prefix.c","usr.sbin/bgpctl/irr_prefix.c","prefixset_get",46,78
49,10,373,1,56,"prefixset_addmember@81-137@usr.sbin/bgpctl/irr_prefix.c","usr.sbin/bgpctl/irr_prefix.c","prefixset_addmember",81,137
41,12,284,1,47,"prefixset_aggregate@140-187@usr.sbin/bgpctl/irr_prefix.c","usr.sbin/bgpctl/irr_prefix.c","prefixset_aggregate",140,187
40,13,353,2,47,"prefix_aggregate@190-237@usr.sbin/bgpctl/irr_prefix.c","usr.sbin/bgpctl/irr_prefix.c","prefix_aggregate",190,237
29,10,272,2,33,"irr_prefix_cmp@240-273@usr.sbin/bgpctl/irr_prefix.c","usr.sbin/bgpctl/irr_prefix.c","irr_prefix_cmp",240,273
4,1,28,2,3,"prefix_set_compare@277-280@usr.sbin/bgpctl/irr_prefix.c","usr.sbin/bgpctl/irr_prefix.c","prefix_set_compare",277,280
6,1,32,1,6,"prefix_set_find@283-289@usr.sbin/bgpctl/irr_prefix.c","usr.sbin/bgpctl/irr_prefix.c","prefix_set_find",283,289
20,5,138,3,26,"irr_main@29-55@usr.sbin/bgpctl/irrfilter.c","usr.sbin/bgpctl/irrfilter.c","irr_main",29,55
14,4,122,2,16,"mrt_read_msg@55-71@usr.sbin/bgpctl/mrtparser.c","usr.sbin/bgpctl/mrtparser.c","mrt_read_msg",55,71
17,5,93,3,18,"mrt_read_buf@74-92@usr.sbin/bgpctl/mrtparser.c","usr.sbin/bgpctl/mrtparser.c","mrt_read_buf",74,92
132,59,628,3,132,"mrt_parse@95-227@usr.sbin/bgpctl/mrtparser.c","usr.sbin/bgpctl/mrtparser.c","mrt_parse",95,227
85,15,621,2,99,"mrt_parse_v2_peer@230-329@usr.sbin/bgpctl/mrtparser.c","usr.sbin/bgpctl/mrtparser.c","mrt_parse_v2_peer",230,329
90,16,646,2,106,"mrt_parse_v2_rib@332-438@usr.sbin/bgpctl/mrtparser.c","usr.sbin/bgpctl/mrtparser.c","mrt_parse_v2_rib",332,438
92,18,696,4,104,"mrt_parse_dump@441-545@usr.sbin/bgpctl/mrtparser.c","usr.sbin/bgpctl/mrtparser.c","mrt_parse_dump",441,545
155,33,1086,4,188,"mrt_parse_dump_mp@548-736@usr.sbin/bgpctl/mrtparser.c","usr.sbin/bgpctl/mrtparser.c","mrt_parse_dump_mp",548,736
126,30,796,5,140,"mrt_extract_attr@739-879@usr.sbin/bgpctl/mrtparser.c","usr.sbin/bgpctl/mrtparser.c","mrt_extract_attr",739,879
6,1,28,1,5,"mrt_free_peers@882-887@usr.sbin/bgpctl/mrtparser.c","usr.sbin/bgpctl/mrtparser.c","mrt_free_peers",882,887
12,4,108,1,13,"mrt_free_rib@890-903@usr.sbin/bgpctl/mrtparser.c","usr.sbin/bgpctl/mrtparser.c","mrt_free_rib",890,903
4,1,14,1,3,"mrt_free_bgp_state@906-909@usr.sbin/bgpctl/mrtparser.c","usr.sbin/bgpctl/mrtparser.c","mrt_free_bgp_state",906,909
5,1,21,1,4,"mrt_free_bgp_msg@912-916@usr.sbin/bgpctl/mrtparser.c","usr.sbin/bgpctl/mrtparser.c","mrt_free_bgp_msg",912,916
30,6,208,3,36,"mrt_aspath_inflate@919-955@usr.sbin/bgpctl/mrtparser.c","usr.sbin/bgpctl/mrtparser.c","mrt_aspath_inflate",919,955
30,7,248,4,30,"mrt_extract_addr@958-988@usr.sbin/bgpctl/mrtparser.c","usr.sbin/bgpctl/mrtparser.c","mrt_extract_addr",958,988
84,10,562,2,100,"mrt_parse_state@991-1091@usr.sbin/bgpctl/mrtparser.c","usr.sbin/bgpctl/mrtparser.c","mrt_parse_state",991,1091
83,12,544,2,99,"mrt_parse_msg@1094-1193@usr.sbin/bgpctl/mrtparser.c","usr.sbin/bgpctl/mrtparser.c","mrt_parse_msg",1094,1193
33,7,227,2,39,"parse@484-523@usr.sbin/bgpctl/parser.c","usr.sbin/bgpctl/parser.c","parse",484,523
226,97,1330,3,233,"match_token@526-759@usr.sbin/bgpctl/parser.c","usr.sbin/bgpctl/parser.c","match_token",526,759
73,30,300,1,73,"show_valid_args@762-835@usr.sbin/bgpctl/parser.c","usr.sbin/bgpctl/parser.c","show_valid_args",762,835
24,4,169,2,28,"parse_addr@838-866@usr.sbin/bgpctl/parser.c","usr.sbin/bgpctl/parser.c","parse_addr",838,866
43,12,302,4,50,"parse_prefix@869-919@usr.sbin/bgpctl/parser.c","usr.sbin/bgpctl/parser.c","parse_prefix",869,919
25,9,198,3,28,"parse_asnum@922-950@usr.sbin/bgpctl/parser.c","usr.sbin/bgpctl/parser.c","parse_asnum",922,950
51,12,279,3,56,"parse_number@953-1009@usr.sbin/bgpctl/parser.c","usr.sbin/bgpctl/parser.c","parse_number",953,1009
11,3,67,1,13,"getcommunity@1012-1025@usr.sbin/bgpctl/parser.c","usr.sbin/bgpctl/parser.c","getcommunity",1012,1025
61,16,362,2,69,"parse_community@1028-1097@usr.sbin/bgpctl/parser.c","usr.sbin/bgpctl/parser.c","parse_community",1028,1097
17,5,102,3,17,"parsesubtype@1100-1117@usr.sbin/bgpctl/parser.c","usr.sbin/bgpctl/parser.c","parsesubtype",1100,1117
45,8,272,2,48,"parseextvalue@1120-1168@usr.sbin/bgpctl/parser.c","usr.sbin/bgpctl/parser.c","parseextvalue",1120,1168
98,25,615,2,104,"parseextcommunity@1171-1275@usr.sbin/bgpctl/parser.c","usr.sbin/bgpctl/parser.c","parseextcommunity",1171,1275
11,3,67,1,13,"getlargecommunity@1278-1291@usr.sbin/bgpctl/parser.c","usr.sbin/bgpctl/parser.c","getlargecommunity",1278,1291
31,8,271,2,37,"parse_largecommunity@1294-1331@usr.sbin/bgpctl/parser.c","usr.sbin/bgpctl/parser.c","parse_largecommunity",1294,1331
20,6,151,2,22,"parse_nexthop@1334-1356@usr.sbin/bgpctl/parser.c","usr.sbin/bgpctl/parser.c","parse_nexthop",1334,1356
28,6,170,3,32,"bgpctl_getopt@1359-1391@usr.sbin/bgpctl/parser.c","usr.sbin/bgpctl/parser.c","bgpctl_getopt",1359,1391
64,16,433,2,70,"whois@79-149@usr.sbin/bgpctl/whois.c","usr.sbin/bgpctl/whois.c","whois",79,149
16,6,46,1,15,"sighdlr@64-79@usr.sbin/bgpd/bgpd.c","usr.sbin/bgpd/bgpd.c","sighdlr",64,79
7,1,25,1,7,"usage@82-89@usr.sbin/bgpd/bgpd.c","usr.sbin/bgpd/bgpd.c","usage",82,89
221,60,1315,2,276,"main@100-376@usr.sbin/bgpd/bgpd.c","usr.sbin/bgpd/bgpd.c","main",100,376
35,9,181,5,38,"start_child@379-417@usr.sbin/bgpd/bgpd.c","usr.sbin/bgpd/bgpd.c","start_child",379,417
9,2,65,2,9,"send_filterset@420-429@usr.sbin/bgpd/bgpd.c","usr.sbin/bgpd/bgpd.c","send_filterset",420,429
101,26,839,3,130,"reconfigure@432-562@usr.sbin/bgpd/bgpd.c","usr.sbin/bgpd/bgpd.c","reconfigure",432,562
157,54,819,3,165,"dispatch_imsg@565-730@usr.sbin/bgpd/bgpd.c","usr.sbin/bgpd/bgpd.c","dispatch_imsg",565,730
18,7,130,1,21,"send_nexthop_update@733-754@usr.sbin/bgpd/bgpd.c","usr.sbin/bgpd/bgpd.c","send_nexthop_update",733,754
4,1,35,4,3,"send_imsg_session@757-760@usr.sbin/bgpd/bgpd.c","usr.sbin/bgpd/bgpd.c","send_imsg_session",757,760
13,5,113,3,14,"send_network@763-777@usr.sbin/bgpd/bgpd.c","usr.sbin/bgpd/bgpd.c","send_network",763,777
20,17,137,2,23,"bgpd_filternexthop@780-803@usr.sbin/bgpd/bgpd.c","usr.sbin/bgpd/bgpd.c","bgpd_filternexthop",780,803
41,16,291,1,43,"control_setup@806-849@usr.sbin/bgpd/bgpd.c","usr.sbin/bgpd/bgpd.c","control_setup",806,849
11,4,68,2,10,"set_pollfd@852-862@usr.sbin/bgpd/bgpd.c","usr.sbin/bgpd/bgpd.c","set_pollfd",852,862
28,9,172,2,30,"handle_pollfd@865-895@usr.sbin/bgpd/bgpd.c","usr.sbin/bgpd/bgpd.c","handle_pollfd",865,895
24,7,207,2,27,"imsg_send_sockets@898-925@usr.sbin/bgpd/bgpd.c","usr.sbin/bgpd/bgpd.c","imsg_send_sockets",898,925
8,2,44,1,9,"carp_group_find@47-56@usr.sbin/bgpd/carp.c","usr.sbin/bgpd/carp.c","carp_group_find",47,56
25,7,162,2,29,"carp_demote_init@59-88@usr.sbin/bgpd/carp.c","usr.sbin/bgpd/carp.c","carp_demote_init",59,88
11,4,73,1,12,"carp_demote_shutdown@91-103@usr.sbin/bgpd/carp.c","usr.sbin/bgpd/carp.c","carp_demote_shutdown",91,103
21,4,140,1,24,"carp_demote_get@106-130@usr.sbin/bgpd/carp.c","usr.sbin/bgpd/carp.c","carp_demote_get",106,130
18,7,118,2,24,"carp_demote_set@133-157@usr.sbin/bgpd/carp.c","usr.sbin/bgpd/carp.c","carp_demote_set",133,157
21,5,156,2,24,"carp_demote_ioctl@160-184@usr.sbin/bgpd/carp.c","usr.sbin/bgpd/carp.c","carp_demote_ioctl",160,184
26,6,209,1,33,"new_config@46-79@usr.sbin/bgpd/config.c","usr.sbin/bgpd/config.c","new_config",46,79
9,2,53,1,9,"free_networks@82-91@usr.sbin/bgpd/config.c","usr.sbin/bgpd/config.c","free_networks",82,91
11,2,65,1,11,"free_rdomains@94-105@usr.sbin/bgpd/config.c","usr.sbin/bgpd/config.c","free_rdomains",94,105
21,3,137,1,25,"free_config@108-133@usr.sbin/bgpd/config.c","usr.sbin/bgpd/config.c","free_config",108,133
74,14,580,3,112,"merge_config@136-248@usr.sbin/bgpd/config.c","usr.sbin/bgpd/config.c","merge_config",136,248
19,6,131,1,22,"get_bgpid@251-273@usr.sbin/bgpd/config.c","usr.sbin/bgpd/config.c","get_bgpid",251,273
30,7,223,3,37,"host@276-313@usr.sbin/bgpd/config.c","usr.sbin/bgpd/config.c","host",276,313
17,4,129,3,19,"host_v4@316-335@usr.sbin/bgpd/config.c","usr.sbin/bgpd/config.c","host_v4",316,335
14,2,93,2,15,"host_v6@338-353@usr.sbin/bgpd/config.c","usr.sbin/bgpd/config.c","host_v6",338,353
72,14,570,1,77,"prepare_listeners@356-433@usr.sbin/bgpd/config.c","usr.sbin/bgpd/config.c","prepare_listeners",356,433
20,3,143,1,22,"get_mpe_label@436-458@usr.sbin/bgpd/config.c","usr.sbin/bgpd/config.c","get_mpe_label",436,458
46,8,308,2,53,"control_init@41-94@usr.sbin/bgpd/control.c","usr.sbin/bgpd/control.c","control_init",41,94
8,3,42,1,8,"control_listen@97-105@usr.sbin/bgpd/control.c","usr.sbin/bgpd/control.c","control_listen",97,105
4,1,12,1,3,"control_shutdown@108-111@usr.sbin/bgpd/control.c","usr.sbin/bgpd/control.c","control_shutdown",108,111
5,2,18,1,4,"control_cleanup@114-118@usr.sbin/bgpd/control.c","usr.sbin/bgpd/control.c","control_cleanup",114,118
28,8,178,2,32,"control_accept@121-153@usr.sbin/bgpd/control.c","usr.sbin/bgpd/control.c","control_accept",121,153
9,2,40,1,10,"control_connbyfd@156-166@usr.sbin/bgpd/control.c","usr.sbin/bgpd/control.c","control_connbyfd",156,166
9,2,40,1,10,"control_connbypid@169-179@usr.sbin/bgpd/control.c","usr.sbin/bgpd/control.c","control_connbypid",169,179
14,2,82,1,16,"control_close@182-198@usr.sbin/bgpd/control.c","usr.sbin/bgpd/control.c","control_close",182,198
288,91,1713,2,312,"control_dispatch_msg@201-513@usr.sbin/bgpd/control.c","usr.sbin/bgpd/control.c","control_dispatch_msg",201,513
12,5,121,1,14,"control_imsg_relay@516-530@usr.sbin/bgpd/control.c","usr.sbin/bgpd/control.c","control_imsg_relay",516,530
5,1,41,2,4,"control_result@533-537@usr.sbin/bgpd/control.c","usr.sbin/bgpd/control.c","control_result",533,537
14,3,98,1,16,"imsg_read_nofd@541-557@usr.sbin/bgpd/control.c","usr.sbin/bgpd/control.c","imsg_read_nofd",541,557
36,9,245,1,45,"kr_init@197-242@usr.sbin/bgpd/kroute.c","usr.sbin/bgpd/kroute.c","kr_init",197,242
46,8,334,6,57,"ktable_new@245-302@usr.sbin/bgpd/kroute.c","usr.sbin/bgpd/kroute.c","ktable_new",245,302
13,5,90,2,25,"ktable_free@305-330@usr.sbin/bgpd/kroute.c","usr.sbin/bgpd/kroute.c","ktable_free",305,330
10,1,63,2,12,"ktable_destroy@333-345@usr.sbin/bgpd/kroute.c","usr.sbin/bgpd/kroute.c","ktable_destroy",333,345
6,2,26,1,5,"ktable_get@348-353@usr.sbin/bgpd/kroute.c","usr.sbin/bgpd/kroute.c","ktable_get",348,353
38,12,271,5,47,"ktable_update@356-403@usr.sbin/bgpd/kroute.c","usr.sbin/bgpd/kroute.c","ktable_update",356,403
10,3,50,1,10,"ktable_preload@406-416@usr.sbin/bgpd/kroute.c","usr.sbin/bgpd/kroute.c","ktable_preload",406,416
13,5,81,1,13,"ktable_postload@419-432@usr.sbin/bgpd/kroute.c","usr.sbin/bgpd/kroute.c","ktable_postload",419,432
22,4,134,2,25,"ktable_exists@435-460@usr.sbin/bgpd/kroute.c","usr.sbin/bgpd/kroute.c","ktable_exists",435,460
16,5,104,3,17,"kr_change@463-480@usr.sbin/bgpd/kroute.c","usr.sbin/bgpd/kroute.c","kr_change",463,480
46,10,380,3,54,"kr4_change@483-537@usr.sbin/bgpd/kroute.c","usr.sbin/bgpd/kroute.c","kr4_change",483,537
48,10,403,3,56,"kr6_change@540-596@usr.sbin/bgpd/kroute.c","usr.sbin/bgpd/kroute.c","kr6_change",540,596
58,11,499,3,69,"krVPN4_change@599-668@usr.sbin/bgpd/kroute.c","usr.sbin/bgpd/kroute.c","krVPN4_change",599,668
16,5,106,3,18,"kr_delete@671-689@usr.sbin/bgpd/kroute.c","usr.sbin/bgpd/kroute.c","kr_delete",671,689
15,5,133,3,20,"kr4_delete@692-712@usr.sbin/bgpd/kroute.c","usr.sbin/bgpd/kroute.c","kr4_delete",692,712
15,5,132,3,20,"kr6_delete@715-735@usr.sbin/bgpd/kroute.c","usr.sbin/bgpd/kroute.c","kr6_delete",715,735
15,5,135,3,20,"krVPN4_delete@738-758@usr.sbin/bgpd/kroute.c","usr.sbin/bgpd/kroute.c","krVPN4_delete",738,758
7,2,36,1,7,"kr_shutdown@761-768@usr.sbin/bgpd/kroute.c","usr.sbin/bgpd/kroute.c","kr_shutdown",761,768
20,5,149,2,24,"kr_fib_couple@771-795@usr.sbin/bgpd/kroute.c","usr.sbin/bgpd/kroute.c","kr_fib_couple",771,795
6,2,32,1,6,"kr_fib_couple_all@798-804@usr.sbin/bgpd/kroute.c","usr.sbin/bgpd/kroute.c","kr_fib_couple_all",798,804
21,5,150,2,25,"kr_fib_decouple@807-832@usr.sbin/bgpd/kroute.c","usr.sbin/bgpd/kroute.c","kr_fib_decouple",807,832
6,2,32,1,6,"kr_fib_decouple_all@835-841@usr.sbin/bgpd/kroute.c","usr.sbin/bgpd/kroute.c","kr_fib_decouple_all",835,841
14,4,102,2,16,"kr_fib_update_prio@844-860@usr.sbin/bgpd/kroute.c","usr.sbin/bgpd/kroute.c","kr_fib_update_prio",844,860
6,2,32,1,6,"kr_fib_update_prio_all@863-869@usr.sbin/bgpd/kroute.c","usr.sbin/bgpd/kroute.c","kr_fib_update_prio_all",863,869
4,1,13,1,3,"kr_dispatch_msg@872-875@usr.sbin/bgpd/kroute.c","usr.sbin/bgpd/kroute.c","kr_dispatch_msg",872,875
23,6,163,3,27,"kr_nexthop_add@878-905@usr.sbin/bgpd/kroute.c","usr.sbin/bgpd/kroute.c","kr_nexthop_add",878,905
16,4,87,3,18,"kr_nexthop_delete@908-926@usr.sbin/bgpd/kroute.c","usr.sbin/bgpd/kroute.c","kr_nexthop_delete",908,926
143,31,955,1,148,"kr_show_route@929-1077@usr.sbin/bgpd/kroute.c","usr.sbin/bgpd/kroute.c","kr_show_route",929,1077
10,2,59,1,10,"kr_ifinfo@1080-1090@usr.sbin/bgpd/kroute.c","usr.sbin/bgpd/kroute.c","kr_ifinfo",1080,1090
5,1,24,1,4,"kr_net_delete@1093-1097@usr.sbin/bgpd/kroute.c","usr.sbin/bgpd/kroute.c","kr_net_delete",1093,1097
30,12,162,2,32,"kr_net_match@1100-1132@usr.sbin/bgpd/kroute.c","usr.sbin/bgpd/kroute.c","kr_net_match",1100,1132
31,12,171,2,33,"kr_net_match6@1135-1168@usr.sbin/bgpd/kroute.c","usr.sbin/bgpd/kroute.c","kr_net_match6",1135,1168
14,5,112,2,14,"kr_net_find@1171-1185@usr.sbin/bgpd/kroute.c","usr.sbin/bgpd/kroute.c","kr_net_find",1171,1185
36,8,273,2,40,"kr_net_reload@1188-1228@usr.sbin/bgpd/kroute.c","usr.sbin/bgpd/kroute.c","kr_net_reload",1188,1228
41,14,302,3,61,"kr_redistribute@1231-1292@usr.sbin/bgpd/kroute.c","usr.sbin/bgpd/kroute.c","kr_redistribute",1231,1292
45,18,340,3,66,"kr_redistribute6@1295-1361@usr.sbin/bgpd/kroute.c","usr.sbin/bgpd/kroute.c","kr_redistribute6",1295,1361
30,6,197,1,35,"kr_reload@1364-1399@usr.sbin/bgpd/kroute.c","usr.sbin/bgpd/kroute.c","kr_reload",1364,1399
16,1,136,1,18,"kr_tofull@1402-1420@usr.sbin/bgpd/kroute.c","usr.sbin/bgpd/kroute.c","kr_tofull",1402,1420
16,1,150,1,18,"kr6_tofull@1423-1441@usr.sbin/bgpd/kroute.c","usr.sbin/bgpd/kroute.c","kr6_tofull",1423,1441
18,9,179,2,19,"kroute_compare@1448-1467@usr.sbin/bgpd/kroute.c","usr.sbin/bgpd/kroute.c","kroute_compare",1448,1467
21,10,197,2,24,"kroute6_compare@1470-1494@usr.sbin/bgpd/kroute.c","usr.sbin/bgpd/kroute.c","kroute6_compare",1470,1494
25,9,211,2,27,"knexthop_compare@1497-1524@usr.sbin/bgpd/kroute.c","usr.sbin/bgpd/kroute.c","knexthop_compare",1497,1524
4,1,29,2,3,"kif_compare@1527-1530@usr.sbin/bgpd/kroute.c","usr.sbin/bgpd/kroute.c","kif_compare",1527,1530
21,5,139,4,22,"kroute_find@1538-1560@usr.sbin/bgpd/kroute.c","usr.sbin/bgpd/kroute.c","kroute_find",1538,1560
15,4,77,2,17,"kroute_matchgw@1563-1580@usr.sbin/bgpd/kroute.c","usr.sbin/bgpd/kroute.c","kroute_matchgw",1563,1580
26,9,207,2,32,"kroute_insert@1583-1615@usr.sbin/bgpd/kroute.c","usr.sbin/bgpd/kroute.c","kroute_insert",1583,1615
48,16,359,2,57,"kroute_remove@1619-1676@usr.sbin/bgpd/kroute.c","usr.sbin/bgpd/kroute.c","kroute_remove",1619,1676
6,2,39,1,6,"kroute_clear@1679-1685@usr.sbin/bgpd/kroute.c","usr.sbin/bgpd/kroute.c","kroute_clear",1679,1685
21,5,150,4,22,"kroute6_find@1688-1710@usr.sbin/bgpd/kroute.c","usr.sbin/bgpd/kroute.c","kroute6_find",1688,1710
15,4,96,2,17,"kroute6_matchgw@1713-1730@usr.sbin/bgpd/kroute.c","usr.sbin/bgpd/kroute.c","kroute6_matchgw",1713,1730
28,9,225,2,35,"kroute6_insert@1733-1768@usr.sbin/bgpd/kroute.c","usr.sbin/bgpd/kroute.c","kroute6_insert",1733,1768
49,16,363,2,58,"kroute6_remove@1771-1829@usr.sbin/bgpd/kroute.c","usr.sbin/bgpd/kroute.c","kroute6_remove",1771,1829
6,2,39,1,6,"kroute6_clear@1832-1838@usr.sbin/bgpd/kroute.c","usr.sbin/bgpd/kroute.c","kroute6_clear",1832,1838
7,1,62,2,8,"knexthop_find@1841-1849@usr.sbin/bgpd/kroute.c","usr.sbin/bgpd/kroute.c","knexthop_find",1841,1849
11,2,68,2,12,"knexthop_insert@1852-1864@usr.sbin/bgpd/kroute.c","usr.sbin/bgpd/kroute.c","knexthop_insert",1852,1864
11,2,68,2,12,"knexthop_remove@1867-1879@usr.sbin/bgpd/kroute.c","usr.sbin/bgpd/kroute.c","knexthop_remove",1867,1879
6,2,39,1,6,"knexthop_clear@1882-1888@usr.sbin/bgpd/kroute.c","usr.sbin/bgpd/kroute.c","knexthop_clear",1882,1888
7,1,44,1,8,"kif_find@1891-1899@usr.sbin/bgpd/kroute.c","usr.sbin/bgpd/kroute.c","kif_find",1891,1899
11,2,62,1,12,"kif_insert@1902-1914@usr.sbin/bgpd/kroute.c","usr.sbin/bgpd/kroute.c","kif_insert",1902,1914
27,5,177,1,30,"kif_remove@1917-1947@usr.sbin/bgpd/kroute.c","usr.sbin/bgpd/kroute.c","kif_remove",1917,1947
6,2,32,1,6,"kif_clear@1950-1956@usr.sbin/bgpd/kroute.c","usr.sbin/bgpd/kroute.c","kif_clear",1950,1956
22,5,144,1,27,"kif_kr_insert@1959-1986@usr.sbin/bgpd/kroute.c","usr.sbin/bgpd/kroute.c","kif_kr_insert",1959,1986
22,6,139,1,26,"kif_kr_remove@1989-2015@usr.sbin/bgpd/kroute.c","usr.sbin/bgpd/kroute.c","kif_kr_remove",1989,2015
22,5,144,1,27,"kif_kr6_insert@2018-2045@usr.sbin/bgpd/kroute.c","usr.sbin/bgpd/kroute.c","kif_kr6_insert",2018,2045
22,6,139,1,26,"kif_kr6_remove@2048-2074@usr.sbin/bgpd/kroute.c","usr.sbin/bgpd/kroute.c","kif_kr6_remove",2048,2074
8,3,43,1,15,"kif_validate@2081-2096@usr.sbin/bgpd/kroute.c","usr.sbin/bgpd/kroute.c","kif_validate",2081,2096
15,4,91,1,17,"kroute_validate@2099-2116@usr.sbin/bgpd/kroute.c","usr.sbin/bgpd/kroute.c","kroute_validate",2099,2116
15,4,92,1,17,"kroute6_validate@2119-2136@usr.sbin/bgpd/kroute.c","usr.sbin/bgpd/kroute.c","kroute6_validate",2119,2136
28,7,156,2,38,"knexthop_validate@2139-2177@usr.sbin/bgpd/kroute.c","usr.sbin/bgpd/kroute.c","knexthop_validate",2139,2177
7,2,42,2,7,"knexthop_track@2180-2187@usr.sbin/bgpd/kroute.c","usr.sbin/bgpd/kroute.c","knexthop_track",2180,2187
47,8,349,1,49,"knexthop_send_update@2190-2239@usr.sbin/bgpd/kroute.c","usr.sbin/bgpd/kroute.c","knexthop_send_update",2190,2239
16,8,139,3,21,"kroute_match@2242-2263@usr.sbin/bgpd/kroute.c","usr.sbin/bgpd/kroute.c","kroute_match",2242,2263
16,8,141,3,20,"kroute6_match@2266-2286@usr.sbin/bgpd/kroute.c","usr.sbin/bgpd/kroute.c","kroute6_match",2266,2286
24,7,128,2,31,"kroute_detach_nexthop@2289-2320@usr.sbin/bgpd/kroute.c","usr.sbin/bgpd/kroute.c","kroute_detach_nexthop",2289,2320
24,5,203,1,30,"protect_lo@2327-2357@usr.sbin/bgpd/kroute.c","usr.sbin/bgpd/kroute.c","protect_lo",2327,2357
13,5,60,1,14,"prefixlen_classful@2360-2374@usr.sbin/bgpd/kroute.c","usr.sbin/bgpd/kroute.c","prefixlen_classful",2360,2374
7,2,32,1,6,"mask2prefixlen@2377-2383@usr.sbin/bgpd/kroute.c","usr.sbin/bgpd/kroute.c","mask2prefixlen",2377,2383
39,11,175,1,45,"mask2prefixlen6@2386-2431@usr.sbin/bgpd/kroute.c","usr.sbin/bgpd/kroute.c","mask2prefixlen6",2386,2431
12,3,80,1,13,"prefixlen2mask6@2434-2447@usr.sbin/bgpd/kroute.c","usr.sbin/bgpd/kroute.c","prefixlen2mask6",2434,2447
12,3,87,3,12,"get_rtaddrs@2453-2465@usr.sbin/bgpd/kroute.c","usr.sbin/bgpd/kroute.c","get_rtaddrs",2453,2465
40,7,268,3,50,"if_change@2468-2518@usr.sbin/bgpd/kroute.c","usr.sbin/bgpd/kroute.c","if_change",2468,2518
21,4,119,1,23,"if_announce@2521-2544@usr.sbin/bgpd/kroute.c","usr.sbin/bgpd/kroute.c","if_announce",2521,2544
111,13,848,5,135,"send_rtmsg@2551-2686@usr.sbin/bgpd/kroute.c","usr.sbin/bgpd/kroute.c","send_rtmsg",2551,2686
87,11,717,5,105,"send_rt6msg@2689-2794@usr.sbin/bgpd/kroute.c","usr.sbin/bgpd/kroute.c","send_rt6msg",2689,2794
179,45,1242,2,199,"fetchtable@2797-2996@usr.sbin/bgpd/kroute.c","usr.sbin/bgpd/kroute.c","fetchtable",2797,2996
63,12,495,1,71,"fetchifs@2999-3070@usr.sbin/bgpd/kroute.c","usr.sbin/bgpd/kroute.c","fetchifs",2999,3070
58,19,350,1,67,"dispatch_rtmsg@3073-3140@usr.sbin/bgpd/kroute.c","usr.sbin/bgpd/kroute.c","dispatch_rtmsg",3073,3140
272,78,1705,3,296,"dispatch_rtmsg_addr@3143-3439@usr.sbin/bgpd/kroute.c","usr.sbin/bgpd/kroute.c","dispatch_rtmsg_addr",3143,3439
10,2,48,2,12,"log_init@34-46@usr.sbin/bgpd/log.c","usr.sbin/bgpd/log.c","log_init",34,46
5,2,19,1,4,"log_procinit@49-53@usr.sbin/bgpd/log.c","usr.sbin/bgpd/log.c","log_procinit",49,53
4,1,11,1,3,"log_setverbose@56-59@usr.sbin/bgpd/log.c","usr.sbin/bgpd/log.c","log_setverbose",56,59
4,1,11,1,3,"log_getverbose@62-65@usr.sbin/bgpd/log.c","usr.sbin/bgpd/log.c","log_getverbose",62,65
7,1,38,3,7,"logit@68-75@usr.sbin/bgpd/log.c","usr.sbin/bgpd/log.c","logit",68,75
17,3,99,3,19,"vlog@78-97@usr.sbin/bgpd/log.c","usr.sbin/bgpd/log.c","vlog",78,97
21,3,120,2,25,"log_warn@100-125@usr.sbin/bgpd/log.c","usr.sbin/bgpd/log.c","log_warn",100,125
7,1,35,2,7,"log_warnx@128-135@usr.sbin/bgpd/log.c","usr.sbin/bgpd/log.c","log_warnx",128,135
7,1,35,2,7,"log_info@138-145@usr.sbin/bgpd/log.c","usr.sbin/bgpd/log.c","log_info",138,145
9,2,41,2,9,"log_debug@148-157@usr.sbin/bgpd/log.c","usr.sbin/bgpd/log.c","log_debug",148,157
17,3,106,3,17,"vfatalc@160-177@usr.sbin/bgpd/log.c","usr.sbin/bgpd/log.c","vfatalc",160,177
8,1,40,2,8,"fatal@180-188@usr.sbin/bgpd/log.c","usr.sbin/bgpd/log.c","fatal",180,188
8,1,40,2,8,"fatalx@191-199@usr.sbin/bgpd/log.c","usr.sbin/bgpd/log.c","fatalx",191,199
25,10,181,1,26,"log_fmt_peer@32-58@usr.sbin/bgpd/logmsg.c","usr.sbin/bgpd/logmsg.c","log_fmt_peer",32,58
13,2,87,3,13,"log_peer_info@61-74@usr.sbin/bgpd/logmsg.c","usr.sbin/bgpd/logmsg.c","log_peer_info",61,74
19,4,128,3,19,"log_peer_warn@77-96@usr.sbin/bgpd/logmsg.c","usr.sbin/bgpd/logmsg.c","log_peer_warn",77,96
13,2,87,3,13,"log_peer_warnx@99-112@usr.sbin/bgpd/logmsg.c","usr.sbin/bgpd/logmsg.c","log_peer_warnx",99,112
16,7,108,3,18,"log_statechange@115-133@usr.sbin/bgpd/logmsg.c","usr.sbin/bgpd/logmsg.c","log_statechange",115,133
61,15,331,6,62,"log_notification@136-198@usr.sbin/bgpd/logmsg.c","usr.sbin/bgpd/logmsg.c","log_notification",136,198
16,4,99,2,17,"log_conn_attempt@201-218@usr.sbin/bgpd/logmsg.c","usr.sbin/bgpd/logmsg.c","log_conn_attempt",201,218
20,6,129,4,25,"mrt_dump_bgp_msg@94-119@usr.sbin/bgpd/mrt.c","usr.sbin/bgpd/mrt.c","mrt_dump_bgp_msg",94,119
17,3,105,4,21,"mrt_dump_state@122-143@usr.sbin/bgpd/mrt.c","usr.sbin/bgpd/mrt.c","mrt_dump_state",122,143
88,26,634,4,103,"mrt_attr_dump@146-249@usr.sbin/bgpd/mrt.c","usr.sbin/bgpd/mrt.c","mrt_attr_dump",146,249
96,15,632,4,111,"mrt_dump_entry_mp@252-363@usr.sbin/bgpd/mrt.c","usr.sbin/bgpd/mrt.c","mrt_dump_entry_mp",252,363
71,14,488,4,80,"mrt_dump_entry@366-446@usr.sbin/bgpd/mrt.c","usr.sbin/bgpd/mrt.c","mrt_dump_entry",366,446
86,12,578,3,96,"mrt_dump_entry_v2@449-545@usr.sbin/bgpd/mrt.c","usr.sbin/bgpd/mrt.c","mrt_dump_entry_v2",449,545
46,7,308,3,51,"mrt_dump_v2_hdr@548-599@usr.sbin/bgpd/mrt.c","usr.sbin/bgpd/mrt.c","mrt_dump_v2_hdr",548,599
35,8,191,2,39,"mrt_dump_peer@602-641@usr.sbin/bgpd/mrt.c","usr.sbin/bgpd/mrt.c","mrt_dump_peer",602,641
17,3,107,2,23,"mrt_dump_upcall@644-667@usr.sbin/bgpd/mrt.c","usr.sbin/bgpd/mrt.c","mrt_dump_upcall",644,667
5,1,21,1,5,"mrt_done@670-675@usr.sbin/bgpd/mrt.c","usr.sbin/bgpd/mrt.c","mrt_done",670,675
91,24,551,6,100,"mrt_dump_hdr_se@678-778@usr.sbin/bgpd/mrt.c","usr.sbin/bgpd/mrt.c","mrt_dump_hdr_se",678,778
39,7,173,4,42,"mrt_dump_hdr_rde@781-823@usr.sbin/bgpd/mrt.c","usr.sbin/bgpd/mrt.c","mrt_dump_hdr_rde",781,823
9,3,49,1,9,"mrt_write@826-835@usr.sbin/bgpd/mrt.c","usr.sbin/bgpd/mrt.c","mrt_write",826,835
10,2,68,1,10,"mrt_clean@838-848@usr.sbin/bgpd/mrt.c","usr.sbin/bgpd/mrt.c","mrt_clean",838,848
5,1,28,2,4,"mrt_init@853-857@usr.sbin/bgpd/mrt.c","usr.sbin/bgpd/mrt.c","mrt_init",853,857
24,5,178,2,28,"mrt_open@860-888@usr.sbin/bgpd/mrt.c","usr.sbin/bgpd/mrt.c","mrt_open",860,888
20,6,129,1,20,"mrt_timeout@891-911@usr.sbin/bgpd/mrt.c","usr.sbin/bgpd/mrt.c","mrt_timeout",891,911
27,8,182,1,27,"mrt_reconfigure@914-941@usr.sbin/bgpd/mrt.c","usr.sbin/bgpd/mrt.c","mrt_reconfigure",914,941
18,7,103,1,18,"mrt_handler@944-962@usr.sbin/bgpd/mrt.c","usr.sbin/bgpd/mrt.c","mrt_handler",944,962
14,5,84,2,14,"mrt_get@965-979@usr.sbin/bgpd/mrt.c","usr.sbin/bgpd/mrt.c","mrt_get",965,979
29,6,223,2,37,"mrt_mergeconfig@982-1019@usr.sbin/bgpd/mrt.c","usr.sbin/bgpd/mrt.c","mrt_mergeconfig",982,1019
4,1,20,1,3,"rtlabel_name2id@50-53@usr.sbin/bgpd/name2id.c","usr.sbin/bgpd/name2id.c","rtlabel_name2id",50,53
4,1,18,1,3,"rtlabel_id2name@56-59@usr.sbin/bgpd/name2id.c","usr.sbin/bgpd/name2id.c","rtlabel_id2name",56,59
4,1,15,1,3,"rtlabel_unref@62-65@usr.sbin/bgpd/name2id.c","usr.sbin/bgpd/name2id.c","rtlabel_unref",62,65
4,1,15,1,3,"rtlabel_ref@68-71@usr.sbin/bgpd/name2id.c","usr.sbin/bgpd/name2id.c","rtlabel_ref",68,71
4,1,20,1,3,"pftable_name2id@74-77@usr.sbin/bgpd/name2id.c","usr.sbin/bgpd/name2id.c","pftable_name2id",74,77
4,1,18,1,3,"pftable_id2name@80-83@usr.sbin/bgpd/name2id.c","usr.sbin/bgpd/name2id.c","pftable_id2name",80,83
4,1,15,1,3,"pftable_unref@86-89@usr.sbin/bgpd/name2id.c","usr.sbin/bgpd/name2id.c","pftable_unref",86,89
4,1,15,1,3,"pftable_ref@92-95@usr.sbin/bgpd/name2id.c","usr.sbin/bgpd/name2id.c","pftable_ref",92,95
35,10,238,2,47,"_name2id@98-145@usr.sbin/bgpd/name2id.c","usr.sbin/bgpd/name2id.c","_name2id",98,145
10,3,56,2,12,"_id2name@148-160@usr.sbin/bgpd/name2id.c","usr.sbin/bgpd/name2id.c","_id2name",148,160
17,5,100,2,18,"_unref@163-181@usr.sbin/bgpd/name2id.c","usr.sbin/bgpd/name2id.c","_unref",163,181
11,3,50,2,12,"_ref@184-196@usr.sbin/bgpd/name2id.c","usr.sbin/bgpd/name2id.c","_ref",184,196
298,43,2124,15,341,"pfkey_send@62-403@usr.sbin/bgpd/pfkey.c","usr.sbin/bgpd/pfkey.c","pfkey_send",62,403
23,10,155,2,28,"pfkey_read@406-434@usr.sbin/bgpd/pfkey.c","usr.sbin/bgpd/pfkey.c","pfkey_read",406,434
53,11,326,2,56,"pfkey_reply@437-493@usr.sbin/bgpd/pfkey.c","usr.sbin/bgpd/pfkey.c","pfkey_reply",437,493
15,5,151,5,14,"pfkey_sa_add@496-510@usr.sbin/bgpd/pfkey.c","usr.sbin/bgpd/pfkey.c","pfkey_sa_add",496,510
10,3,89,3,9,"pfkey_sa_remove@513-522@usr.sbin/bgpd/pfkey.c","usr.sbin/bgpd/pfkey.c","pfkey_sa_remove",513,522
16,5,147,1,17,"pfkey_md5sig_establish@525-542@usr.sbin/bgpd/pfkey.c","usr.sbin/bgpd/pfkey.c","pfkey_md5sig_establish",525,542
13,5,108,1,13,"pfkey_md5sig_remove@545-558@usr.sbin/bgpd/pfkey.c","usr.sbin/bgpd/pfkey.c","pfkey_md5sig_remove",545,558
68,18,531,1,73,"pfkey_ipsec_establish@561-634@usr.sbin/bgpd/pfkey.c","usr.sbin/bgpd/pfkey.c","pfkey_ipsec_establish",561,634
56,18,457,1,62,"pfkey_ipsec_remove@637-699@usr.sbin/bgpd/pfkey.c","usr.sbin/bgpd/pfkey.c","pfkey_ipsec_remove",637,699
14,3,119,1,21,"pfkey_establish@702-723@usr.sbin/bgpd/pfkey.c","usr.sbin/bgpd/pfkey.c","pfkey_establish",702,723
9,3,51,1,8,"pfkey_remove@726-734@usr.sbin/bgpd/pfkey.c","usr.sbin/bgpd/pfkey.c","pfkey_remove",726,734
13,3,69,1,12,"pfkey_init@737-749@usr.sbin/bgpd/pfkey.c","usr.sbin/bgpd/pfkey.c","pfkey_init",737,749
22,6,168,1,28,"pftable_change@58-86@usr.sbin/bgpd/pftable.c","usr.sbin/bgpd/pftable.c","pftable_change",58,86
14,3,104,1,17,"pftable_clear@89-106@usr.sbin/bgpd/pftable.c","usr.sbin/bgpd/pftable.c","pftable_clear",89,106
16,3,123,1,19,"pftable_exists@109-128@usr.sbin/bgpd/pftable.c","usr.sbin/bgpd/pftable.c","pftable_exists",109,128
19,4,140,1,24,"pftable_add@131-155@usr.sbin/bgpd/pftable.c","usr.sbin/bgpd/pftable.c","pftable_add",131,155
13,2,73,1,14,"pftable_clear_all@158-172@usr.sbin/bgpd/pftable.c","usr.sbin/bgpd/pftable.c","pftable_clear_all",158,172
43,13,325,4,54,"pftable_add_work@175-229@usr.sbin/bgpd/pftable.c","usr.sbin/bgpd/pftable.c","pftable_add_work",175,229
4,1,30,1,3,"pftable_addr_add@233-236@usr.sbin/bgpd/pftable.c","usr.sbin/bgpd/pftable.c","pftable_addr_add",233,236
4,1,30,1,3,"pftable_addr_remove@239-242@usr.sbin/bgpd/pftable.c","usr.sbin/bgpd/pftable.c","pftable_addr_remove",239,242
14,3,81,1,15,"pftable_commit@245-260@usr.sbin/bgpd/pftable.c","usr.sbin/bgpd/pftable.c","pftable_commit",245,260
32,9,103,1,31,"print_op@57-88@usr.sbin/bgpd/printconf.c","usr.sbin/bgpd/printconf.c","print_op",57,88
19,7,100,2,19,"print_community@91-110@usr.sbin/bgpd/printconf.c","usr.sbin/bgpd/printconf.c","print_community",91,110
27,10,142,3,29,"print_largecommunity@113-142@usr.sbin/bgpd/printconf.c","usr.sbin/bgpd/printconf.c","print_largecommunity",113,142
37,10,196,1,37,"print_extcommunity@146-183@usr.sbin/bgpd/printconf.c","usr.sbin/bgpd/printconf.c","print_extcommunity",146,183
11,4,50,1,10,"print_origin@186-196@usr.sbin/bgpd/printconf.c","usr.sbin/bgpd/printconf.c","print_origin",186,196
99,26,495,1,101,"print_set@199-300@usr.sbin/bgpd/printconf.c","usr.sbin/bgpd/printconf.c","print_set",199,300
35,13,255,1,42,"print_mainconf@303-345@usr.sbin/bgpd/printconf.c","usr.sbin/bgpd/printconf.c","print_mainconf",303,345
9,1,51,2,8,"print_rdomain_targets@348-356@usr.sbin/bgpd/printconf.c","usr.sbin/bgpd/printconf.c","print_rdomain_targets",348,356
18,3,125,1,22,"print_rdomain@359-381@usr.sbin/bgpd/printconf.c","usr.sbin/bgpd/printconf.c","print_rdomain",359,381
8,3,37,1,12,"print_af@384-396@usr.sbin/bgpd/printconf.c","usr.sbin/bgpd/printconf.c","print_af",384,396
23,5,144,2,22,"print_network@399-421@usr.sbin/bgpd/printconf.c","usr.sbin/bgpd/printconf.c","print_network",399,421
112,44,891,3,120,"print_peer@424-544@usr.sbin/bgpd/printconf.c","usr.sbin/bgpd/printconf.c","print_peer",424,544
11,3,36,1,10,"print_auth_alg@547-557@usr.sbin/bgpd/printconf.c","usr.sbin/bgpd/printconf.c","print_auth_alg",547,557
11,3,36,1,10,"print_enc_alg@560-570@usr.sbin/bgpd/printconf.c","usr.sbin/bgpd/printconf.c","print_enc_alg",560,570
7,3,53,2,7,"print_announce@573-580@usr.sbin/bgpd/printconf.c","usr.sbin/bgpd/printconf.c","print_announce",573,580
19,4,136,1,18,"print_as@582-600@usr.sbin/bgpd/printconf.c","usr.sbin/bgpd/printconf.c","print_as",582,600
99,34,754,2,110,"print_rule@603-713@usr.sbin/bgpd/printconf.c","usr.sbin/bgpd/printconf.c","print_rule",603,713
22,9,64,1,21,"mrt_type@716-737@usr.sbin/bgpd/printconf.c","usr.sbin/bgpd/printconf.c","mrt_type",716,737
20,8,155,5,21,"print_mrt@740-761@usr.sbin/bgpd/printconf.c","usr.sbin/bgpd/printconf.c","print_mrt",740,761
36,9,254,2,43,"print_groups@764-807@usr.sbin/bgpd/printconf.c","usr.sbin/bgpd/printconf.c","print_groups",764,807
8,1,55,2,9,"peer_compare@810-819@usr.sbin/bgpd/printconf.c","usr.sbin/bgpd/printconf.c","peer_compare",810,819
35,4,229,7,35,"print_config@822-857@usr.sbin/bgpd/printconf.c","usr.sbin/bgpd/printconf.c","print_config",822,857
9,3,25,1,8,"rde_sighdlr@159-167@usr.sbin/bgpd/rde.c","usr.sbin/bgpd/rde.c","rde_sighdlr",159,167
149,38,1029,2,178,"rde_main@175-353@usr.sbin/bgpd/rde.c","usr.sbin/bgpd/rde.c","rde_main",175,353
283,69,1652,1,288,"rde_dispatch_imsg_session@359-647@usr.sbin/bgpd/rde.c","usr.sbin/bgpd/rde.c","rde_dispatch_imsg_session",359,647
230,59,1354,1,240,"rde_dispatch_imsg_parent@650-890@usr.sbin/bgpd/rde.c","usr.sbin/bgpd/rde.c","rde_dispatch_imsg_parent",650,890
351,62,2049,1,427,"rde_update_dispatch@894-1321@usr.sbin/bgpd/rde.c","usr.sbin/bgpd/rde.c","rde_update_dispatch",894,1321
30,8,226,4,37,"rde_update_update@1324-1361@usr.sbin/bgpd/rde.c","usr.sbin/bgpd/rde.c","rde_update_update",1324,1361
16,5,118,3,19,"rde_update_withdraw@1364-1383@usr.sbin/bgpd/rde.c","usr.sbin/bgpd/rde.c","rde_update_withdraw",1364,1383
270,81,1550,5,333,"rde_attr_parse@1401-1734@usr.sbin/bgpd/rde.c","usr.sbin/bgpd/rde.c","rde_attr_parse",1401,1734
28,7,183,3,32,"rde_attr_add@1737-1769@usr.sbin/bgpd/rde.c","usr.sbin/bgpd/rde.c","rde_attr_add",1737,1769
17,10,130,3,18,"rde_attr_missing@1775-1793@usr.sbin/bgpd/rde.c","usr.sbin/bgpd/rde.c","rde_attr_missing",1775,1793
41,8,231,4,74,"rde_get_mp_nexthop@1796-1870@usr.sbin/bgpd/rde.c","usr.sbin/bgpd/rde.c","rde_get_mp_nexthop",1796,1870
23,5,141,5,23,"rde_update_extract_prefix@1873-1896@usr.sbin/bgpd/rde.c","usr.sbin/bgpd/rde.c","rde_update_extract_prefix",1873,1896
17,3,112,4,21,"rde_update_get_prefix@1899-1920@usr.sbin/bgpd/rde.c","usr.sbin/bgpd/rde.c","rde_update_get_prefix",1899,1920
17,3,112,4,21,"rde_update_get_prefix6@1923-1944@usr.sbin/bgpd/rde.c","usr.sbin/bgpd/rde.c","rde_update_get_prefix6",1923,1944
42,10,346,4,52,"rde_update_get_vpn4@1947-1999@usr.sbin/bgpd/rde.c","usr.sbin/bgpd/rde.c","rde_update_get_vpn4",1947,1999
14,5,139,5,14,"rde_update_err@2002-2016@usr.sbin/bgpd/rde.c","usr.sbin/bgpd/rde.c","rde_update_err",2002,2016
23,8,190,6,25,"rde_update_log@2019-2044@usr.sbin/bgpd/rde.c","usr.sbin/bgpd/rde.c","rde_update_log",2019,2044
42,14,250,2,58,"rde_as4byte_fixup@2053-2111@usr.sbin/bgpd/rde.c","usr.sbin/bgpd/rde.c","rde_as4byte_fixup",2053,2111
48,15,382,2,57,"rde_reflector@2118-2175@usr.sbin/bgpd/rde.c","usr.sbin/bgpd/rde.c","rde_reflector",2118,2175
74,19,629,4,77,"rde_dump_rib_as@2181-2258@usr.sbin/bgpd/rde.c","usr.sbin/bgpd/rde.c","rde_dump_rib_as",2181,2258
20,5,141,3,23,"rde_dump_filterout@2261-2284@usr.sbin/bgpd/rde.c","usr.sbin/bgpd/rde.c","rde_dump_filterout",2261,2284
35,19,290,2,36,"rde_dump_filter@2287-2323@usr.sbin/bgpd/rde.c","usr.sbin/bgpd/rde.c","rde_dump_filter",2287,2323
7,1,46,2,7,"rde_dump_upcall@2326-2333@usr.sbin/bgpd/rde.c","usr.sbin/bgpd/rde.c","rde_dump_upcall",2326,2333
16,4,121,2,16,"rde_dump_prefix_upcall@2336-2352@usr.sbin/bgpd/rde.c","usr.sbin/bgpd/rde.c","rde_dump_prefix_upcall",2336,2352
74,16,437,3,75,"rde_dump_ctx_new@2355-2430@usr.sbin/bgpd/rde.c","usr.sbin/bgpd/rde.c","rde_dump_ctx_new",2355,2430
10,2,46,2,10,"rde_dump_ctx_throttle@2433-2443@usr.sbin/bgpd/rde.c","usr.sbin/bgpd/rde.c","rde_dump_ctx_throttle",2433,2443
9,3,58,1,9,"rde_dump_runner@2446-2455@usr.sbin/bgpd/rde.c","usr.sbin/bgpd/rde.c","rde_dump_runner",2446,2455
8,2,37,1,10,"rde_dump_pending@2458-2468@usr.sbin/bgpd/rde.c","usr.sbin/bgpd/rde.c","rde_dump_pending",2458,2468
8,1,49,1,8,"rde_dump_done@2471-2479@usr.sbin/bgpd/rde.c","usr.sbin/bgpd/rde.c","rde_dump_done",2471,2479
9,3,61,1,9,"rde_dump_rib_free@2482-2491@usr.sbin/bgpd/rde.c","usr.sbin/bgpd/rde.c","rde_dump_rib_free",2482,2491
30,4,231,3,32,"rde_dump_mrt_new@2494-2526@usr.sbin/bgpd/rde.c","usr.sbin/bgpd/rde.c","rde_dump_mrt_new",2494,2526
9,3,64,1,9,"rde_dump_mrt_free@2529-2538@usr.sbin/bgpd/rde.c","usr.sbin/bgpd/rde.c","rde_dump_mrt_free",2529,2538
6,1,33,1,7,"rde_rib_free@2541-2548@usr.sbin/bgpd/rde.c","usr.sbin/bgpd/rde.c","rde_rib_free",2541,2548
9,2,58,2,9,"rde_rdomain_import@2554-2563@usr.sbin/bgpd/rde.c","usr.sbin/bgpd/rde.c","rde_rdomain_import",2554,2563
54,16,402,3,66,"rde_send_kroute@2566-2632@usr.sbin/bgpd/rde.c","usr.sbin/bgpd/rde.c","rde_send_kroute",2566,2632
15,6,90,3,21,"rde_generate_updates@2638-2659@usr.sbin/bgpd/rde.c","usr.sbin/bgpd/rde.c","rde_generate_updates",2638,2659
9,3,59,2,9,"rde_up_dump_upcall@2664-2673@usr.sbin/bgpd/rde.c","usr.sbin/bgpd/rde.c","rde_up_dump_upcall",2664,2673
51,11,274,1,63,"rde_update_queue_runner@2676-2739@usr.sbin/bgpd/rde.c","usr.sbin/bgpd/rde.c","rde_update_queue_runner",2676,2739
54,14,313,1,61,"rde_update6_queue_runner@2742-2803@usr.sbin/bgpd/rde.c","usr.sbin/bgpd/rde.c","rde_update6_queue_runner",2742,2803
17,5,129,4,21,"rde_send_pftable@2809-2830@usr.sbin/bgpd/rde.c","usr.sbin/bgpd/rde.c","rde_send_pftable",2809,2830
8,3,44,1,9,"rde_send_pftable_commit@2833-2842@usr.sbin/bgpd/rde.c","usr.sbin/bgpd/rde.c","rde_send_pftable_commit",2833,2842
11,3,64,2,12,"rde_send_nexthop@2848-2860@usr.sbin/bgpd/rde.c","usr.sbin/bgpd/rde.c","rde_send_nexthop",2848,2860
101,20,645,1,125,"rde_reload_done@2866-2991@usr.sbin/bgpd/rde.c","usr.sbin/bgpd/rde.c","rde_reload_done",2866,2991
42,14,335,2,57,"rde_softreconfig_in@2994-3051@usr.sbin/bgpd/rde.c","usr.sbin/bgpd/rde.c","rde_softreconfig_in",2994,3051
35,15,301,2,47,"rde_softreconfig_out@3054-3101@usr.sbin/bgpd/rde.c","usr.sbin/bgpd/rde.c","rde_softreconfig_out",3054,3101
22,5,153,2,29,"rde_softreconfig_unload_peer@3104-3133@usr.sbin/bgpd/rde.c","usr.sbin/bgpd/rde.c","rde_softreconfig_unload_peer",3104,3133
4,1,13,1,3,"rde_local_as@3139-3142@usr.sbin/bgpd/rde.c","usr.sbin/bgpd/rde.c","rde_local_as",3139,3142
6,2,24,1,7,"rde_noevaluate@3145-3152@usr.sbin/bgpd/rde.c","usr.sbin/bgpd/rde.c","rde_noevaluate",3145,3152
4,1,15,1,3,"rde_decisionflags@3155-3158@usr.sbin/bgpd/rde.c","usr.sbin/bgpd/rde.c","rde_decisionflags",3155,3158
4,1,18,1,3,"rde_as4byte@3161-3164@usr.sbin/bgpd/rde.c","usr.sbin/bgpd/rde.c","rde_as4byte",3161,3164
20,5,152,1,25,"peer_init@3178-3203@usr.sbin/bgpd/rde.c","usr.sbin/bgpd/rde.c","peer_init",3178,3203
8,3,50,1,9,"peer_shutdown@3206-3215@usr.sbin/bgpd/rde.c","usr.sbin/bgpd/rde.c","peer_shutdown",3206,3215
11,2,54,1,12,"peer_get@3218-3230@usr.sbin/bgpd/rde.c","usr.sbin/bgpd/rde.c","peer_get",3218,3230
24,4,178,2,29,"peer_add@3233-3262@usr.sbin/bgpd/rde.c","usr.sbin/bgpd/rde.c","peer_add",3233,3262
42,15,290,2,50,"peer_localaddrs@3265-3315@usr.sbin/bgpd/rde.c","usr.sbin/bgpd/rde.c","peer_localaddrs",3265,3315
38,10,265,2,51,"peer_up@3318-3369@usr.sbin/bgpd/rde.c","usr.sbin/bgpd/rde.c","peer_up",3318,3369
23,3,134,1,28,"peer_down@3372-3400@usr.sbin/bgpd/rde.c","usr.sbin/bgpd/rde.c","peer_down",3372,3400
16,3,101,2,22,"peer_flush@3407-3429@usr.sbin/bgpd/rde.c","usr.sbin/bgpd/rde.c","peer_flush",3407,3429
16,4,90,2,20,"peer_stale@3432-3452@usr.sbin/bgpd/rde.c","usr.sbin/bgpd/rde.c","peer_stale",3432,3452
15,4,89,2,16,"peer_dump@3455-3471@usr.sbin/bgpd/rde.c","usr.sbin/bgpd/rde.c","peer_dump",3455,3471
9,2,72,2,18,"peer_recv_eor@3475-3493@usr.sbin/bgpd/rde.c","usr.sbin/bgpd/rde.c","peer_recv_eor",3475,3493
35,5,264,2,41,"peer_send_eor@3496-3537@usr.sbin/bgpd/rde.c","usr.sbin/bgpd/rde.c","peer_send_eor",3496,3537
65,10,456,2,67,"network_add@3543-3610@usr.sbin/bgpd/rde.c","usr.sbin/bgpd/rde.c","network_add",3543,3610
41,7,290,2,43,"network_delete@3613-3656@usr.sbin/bgpd/rde.c","usr.sbin/bgpd/rde.c","network_delete",3613,3656
28,6,230,2,29,"network_dump_upcall@3659-3688@usr.sbin/bgpd/rde.c","usr.sbin/bgpd/rde.c","network_dump_upcall",3659,3688
20,5,125,1,31,"rde_shutdown@3692-3723@usr.sbin/bgpd/rde.c","usr.sbin/bgpd/rde.c","rde_shutdown",3692,3723
29,8,189,2,35,"sa_cmp@3726-3761@usr.sbin/bgpd/rde.c","usr.sbin/bgpd/rde.c","sa_cmp",3726,3761
4,1,26,1,3,"re_rib@443-446@usr.sbin/bgpd/rde.h","usr.sbin/bgpd/rde.h","re_rib",443,446
26,5,154,6,30,"attr_write@37-67@usr.sbin/bgpd/rde_attr.c","usr.sbin/bgpd/rde_attr.c","attr_write",37,67
20,5,144,5,22,"attr_writebuf@70-92@usr.sbin/bgpd/rde_attr.c","usr.sbin/bgpd/rde_attr.c","attr_writebuf",70,92
13,4,99,1,15,"attr_init@111-126@usr.sbin/bgpd/rde_attr.c","usr.sbin/bgpd/rde_attr.c","attr_init",111,126
8,3,50,1,9,"attr_shutdown@129-138@usr.sbin/bgpd/rde_attr.c","usr.sbin/bgpd/rde_attr.c","attr_shutdown",129,138
40,11,295,5,52,"attr_optadd@141-193@usr.sbin/bgpd/rde_attr.c","usr.sbin/bgpd/rde_attr.c","attr_optadd",141,193
13,5,89,2,13,"attr_optget@196-209@usr.sbin/bgpd/rde_attr.c","usr.sbin/bgpd/rde_attr.c","attr_optget",196,209
20,6,144,2,23,"attr_copy@212-235@usr.sbin/bgpd/rde_attr.c","usr.sbin/bgpd/rde_attr.c","attr_copy",212,235
27,11,183,2,28,"attr_diff@238-266@usr.sbin/bgpd/rde_attr.c","usr.sbin/bgpd/rde_attr.c","attr_diff",238,266
18,10,173,2,20,"attr_compare@269-289@usr.sbin/bgpd/rde_attr.c","usr.sbin/bgpd/rde_attr.c","attr_compare",269,289
12,4,100,2,14,"attr_free@292-306@usr.sbin/bgpd/rde_attr.c","usr.sbin/bgpd/rde_attr.c","attr_free",292,306
9,2,56,1,10,"attr_freeall@309-319@usr.sbin/bgpd/rde_attr.c","usr.sbin/bgpd/rde_attr.c","attr_freeall",309,319
29,4,228,4,33,"attr_alloc@322-355@usr.sbin/bgpd/rde_attr.c","usr.sbin/bgpd/rde_attr.c","attr_alloc",322,355
22,6,173,4,24,"attr_lookup@358-382@usr.sbin/bgpd/rde_attr.c","usr.sbin/bgpd/rde_attr.c","attr_lookup",358,382
15,4,78,1,19,"attr_put@385-404@usr.sbin/bgpd/rde_attr.c","usr.sbin/bgpd/rde_attr.c","attr_put",385,404
32,15,203,3,47,"aspath_verify@424-471@usr.sbin/bgpd/rde_attr.c","usr.sbin/bgpd/rde_attr.c","aspath_verify",424,471
13,4,99,1,15,"aspath_init@474-489@usr.sbin/bgpd/rde_attr.c","usr.sbin/bgpd/rde_attr.c","aspath_init",474,489
8,3,50,1,9,"aspath_shutdown@492-501@usr.sbin/bgpd/rde_attr.c","usr.sbin/bgpd/rde_attr.c","aspath_shutdown",492,501
23,3,148,2,29,"aspath_get@504-533@usr.sbin/bgpd/rde_attr.c","usr.sbin/bgpd/rde_attr.c","aspath_get",504,533
13,3,62,1,17,"aspath_put@536-553@usr.sbin/bgpd/rde_attr.c","usr.sbin/bgpd/rde_attr.c","aspath_put",536,553
30,6,208,3,36,"aspath_inflate@556-592@usr.sbin/bgpd/rde_attr.c","usr.sbin/bgpd/rde_attr.c","aspath_inflate",556,592
39,7,265,3,46,"aspath_deflate@596-642@usr.sbin/bgpd/rde_attr.c","usr.sbin/bgpd/rde_attr.c","aspath_deflate",596,642
28,7,239,2,36,"aspath_merge@645-681@usr.sbin/bgpd/rde_attr.c","usr.sbin/bgpd/rde_attr.c","aspath_merge",645,681
4,1,16,1,3,"aspath_dump@684-687@usr.sbin/bgpd/rde_attr.c","usr.sbin/bgpd/rde_attr.c","aspath_dump",684,687
4,1,16,1,3,"aspath_length@690-693@usr.sbin/bgpd/rde_attr.c","usr.sbin/bgpd/rde_attr.c","aspath_length",690,693
20,4,108,2,22,"aspath_count@696-718@usr.sbin/bgpd/rde_attr.c","usr.sbin/bgpd/rde_attr.c","aspath_count",696,718
28,9,178,3,33,"aspath_countlength@721-754@usr.sbin/bgpd/rde_attr.c","usr.sbin/bgpd/rde_attr.c","aspath_countlength",721,754
34,8,203,5,40,"aspath_countcopy@757-797@usr.sbin/bgpd/rde_attr.c","usr.sbin/bgpd/rde_attr.c","aspath_countcopy",757,797
6,2,36,1,6,"aspath_neighbor@800-806@usr.sbin/bgpd/rde_attr.c","usr.sbin/bgpd/rde_attr.c","aspath_neighbor",800,806
18,5,119,2,20,"aspath_loopfree@809-829@usr.sbin/bgpd/rde_attr.c","usr.sbin/bgpd/rde_attr.c","aspath_loopfree",809,829
14,5,93,2,14,"aspath_compare@832-846@usr.sbin/bgpd/rde_attr.c","usr.sbin/bgpd/rde_attr.c","aspath_compare",832,846
13,3,85,2,14,"aspath_lookup@849-863@usr.sbin/bgpd/rde_attr.c","usr.sbin/bgpd/rde_attr.c","aspath_lookup",849,863
57,14,402,4,71,"aspath_prepend@870-941@usr.sbin/bgpd/rde_attr.c","usr.sbin/bgpd/rde_attr.c","aspath_prepend",870,941
29,7,180,3,33,"aspath_lenmatch@944-977@usr.sbin/bgpd/rde_attr.c","usr.sbin/bgpd/rde_attr.c","aspath_lenmatch",944,977
22,7,148,3,24,"community_match@986-1010@usr.sbin/bgpd/rde_attr.c","usr.sbin/bgpd/rde_attr.c","community_match",986,1010
34,10,275,3,44,"community_set@1013-1057@usr.sbin/bgpd/rde_attr.c","usr.sbin/bgpd/rde_attr.c","community_set",1013,1057
50,15,352,3,61,"community_delete@1060-1121@usr.sbin/bgpd/rde_attr.c","usr.sbin/bgpd/rde_attr.c","community_delete",1060,1121
19,4,121,3,22,"community_ext_match@1124-1146@usr.sbin/bgpd/rde_attr.c","usr.sbin/bgpd/rde_attr.c","community_ext_match",1124,1146
35,8,263,3,45,"community_ext_set@1149-1194@usr.sbin/bgpd/rde_attr.c","usr.sbin/bgpd/rde_attr.c","community_ext_set",1149,1194
38,10,269,3,48,"community_ext_delete@1197-1245@usr.sbin/bgpd/rde_attr.c","usr.sbin/bgpd/rde_attr.c","community_ext_delete",1197,1245
34,5,236,3,36,"community_ext_conv@1248-1284@usr.sbin/bgpd/rde_attr.c","usr.sbin/bgpd/rde_attr.c","community_ext_conv",1248,1284
68,19,469,3,76,"community_ext_matchone@1287-1363@usr.sbin/bgpd/rde_attr.c","usr.sbin/bgpd/rde_attr.c","community_ext_matchone",1287,1363
25,9,169,4,28,"community_large_match@1366-1394@usr.sbin/bgpd/rde_attr.c","usr.sbin/bgpd/rde_attr.c","community_large_match",1366,1394
36,9,266,4,46,"community_large_set@1397-1443@usr.sbin/bgpd/rde_attr.c","usr.sbin/bgpd/rde_attr.c","community_large_set",1397,1443
50,19,361,4,61,"community_large_delete@1446-1507@usr.sbin/bgpd/rde_attr.c","usr.sbin/bgpd/rde_attr.c","community_large_delete",1446,1507
24,7,174,3,28,"community_ext_delete_non_trans@1511-1539@usr.sbin/bgpd/rde_attr.c","usr.sbin/bgpd/rde_attr.c","community_ext_delete_non_trans",1511,1539
78,32,710,2,125,"prefix_cmp@110-235@usr.sbin/bgpd/rde_decide.c","usr.sbin/bgpd/rde_decide.c","prefix_cmp",110,235
42,17,315,2,56,"prefix_evaluate@243-299@usr.sbin/bgpd/rde_decide.c","usr.sbin/bgpd/rde_decide.c","prefix_evaluate",243,299
278,76,1422,5,293,"rde_apply_set@36-329@usr.sbin/bgpd/rde_filter.c","usr.sbin/bgpd/rde_filter.c","rde_apply_set",36,329
159,61,1062,6,178,"rde_filter_match@332-510@usr.sbin/bgpd/rde_filter.c","usr.sbin/bgpd/rde_filter.c","rde_filter_match",332,510
57,42,511,3,68,"rde_filter_equal@513-581@usr.sbin/bgpd/rde_filter.c","usr.sbin/bgpd/rde_filter.c","rde_filter_equal",513,581
12,3,64,1,13,"filterlist_free@584-597@usr.sbin/bgpd/rde_filter.c","usr.sbin/bgpd/rde_filter.c","filterlist_free",584,597
21,7,131,1,22,"filterset_free@601-623@usr.sbin/bgpd/rde_filter.c","usr.sbin/bgpd/rde_filter.c","filterset_free",601,623
34,13,316,2,47,"filterset_cmp@633-680@usr.sbin/bgpd/rde_filter.c","usr.sbin/bgpd/rde_filter.c","filterset_cmp",633,680
11,3,65,2,13,"filterset_move@683-696@usr.sbin/bgpd/rde_filter.c","usr.sbin/bgpd/rde_filter.c","filterset_move",683,696
106,54,629,2,111,"filterset_equal@699-810@usr.sbin/bgpd/rde_filter.c","usr.sbin/bgpd/rde_filter.c","filterset_equal",699,810
45,25,166,1,45,"filterset_name@813-858@usr.sbin/bgpd/rde_filter.c","usr.sbin/bgpd/rde_filter.c","filterset_name",813,858
23,8,161,1,26,"rde_filter_calc_skip_steps@906-932@usr.sbin/bgpd/rde_filter.c","usr.sbin/bgpd/rde_filter.c","rde_filter_calc_skip_steps",906,932
45,14,307,7,54,"rde_filter@943-997@usr.sbin/bgpd/rde_filter.c","usr.sbin/bgpd/rde_filter.c","rde_filter",943,997
4,1,12,1,3,"pt_init@59-62@usr.sbin/bgpd/rde_prefix.c","usr.sbin/bgpd/rde_prefix.c","pt_init",59,62
5,2,20,1,4,"pt_shutdown@65-69@usr.sbin/bgpd/rde_prefix.c","usr.sbin/bgpd/rde_prefix.c","pt_shutdown",65,69
24,4,182,2,24,"pt_getaddr@72-96@usr.sbin/bgpd/rde_prefix.c","usr.sbin/bgpd/rde_prefix.c","pt_getaddr",72,96
43,7,305,2,43,"pt_fill@99-142@usr.sbin/bgpd/rde_prefix.c","usr.sbin/bgpd/rde_prefix.c","pt_fill",99,142
6,1,37,2,6,"pt_get@145-151@usr.sbin/bgpd/rde_prefix.c","usr.sbin/bgpd/rde_prefix.c","pt_get",145,151
9,2,59,2,11,"pt_add@154-165@usr.sbin/bgpd/rde_prefix.c","usr.sbin/bgpd/rde_prefix.c","pt_add",154,165
8,3,46,1,8,"pt_remove@168-176@usr.sbin/bgpd/rde_prefix.c","usr.sbin/bgpd/rde_prefix.c","pt_remove",168,176
22,6,90,1,22,"pt_lookup@179-201@usr.sbin/bgpd/rde_prefix.c","usr.sbin/bgpd/rde_prefix.c","pt_lookup",179,201
57,20,464,2,59,"pt_prefix_cmp@204-263@usr.sbin/bgpd/rde_prefix.c","usr.sbin/bgpd/rde_prefix.c","pt_prefix_cmp",204,263
10,2,66,1,11,"pt_alloc@270-281@usr.sbin/bgpd/rde_prefix.c","usr.sbin/bgpd/rde_prefix.c","pt_alloc",270,281
5,1,24,1,4,"pt_free@284-288@usr.sbin/bgpd/rde_prefix.c","usr.sbin/bgpd/rde_prefix.c","pt_free",284,288
4,1,29,1,3,"re_lock@51-54@usr.sbin/bgpd/rde_rib.c","usr.sbin/bgpd/rde_rib.c","re_lock",51,54
4,1,29,1,3,"re_unlock@57-60@usr.sbin/bgpd/rde_rib.c","usr.sbin/bgpd/rde_rib.c","re_unlock",57,60
4,1,21,1,3,"re_is_locked@63-66@usr.sbin/bgpd/rde_rib.c","usr.sbin/bgpd/rde_rib.c","re_is_locked",63,66
4,1,17,1,3,"rib_tree@69-72@usr.sbin/bgpd/rde_rib.c","usr.sbin/bgpd/rde_rib.c","rib_tree",69,72
29,6,247,3,34,"rib_new@76-110@usr.sbin/bgpd/rde_rib.c","usr.sbin/bgpd/rde_rib.c","rib_new",76,110
11,5,79,1,13,"rib_find@113-126@usr.sbin/bgpd/rde_rib.c","usr.sbin/bgpd/rde_rib.c","rib_find",113,126
4,1,20,1,3,"rib_desc@129-132@usr.sbin/bgpd/rde_rib.c","usr.sbin/bgpd/rde_rib.c","rib_desc",129,132
25,5,185,1,34,"rib_free@135-169@usr.sbin/bgpd/rde_rib.c","usr.sbin/bgpd/rde_rib.c","rib_free",135,169
4,1,30,2,3,"rib_compare@172-175@usr.sbin/bgpd/rde_rib.c","usr.sbin/bgpd/rde_rib.c","rib_compare",172,175
9,1,68,3,10,"rib_get@178-188@usr.sbin/bgpd/rde_rib.c","usr.sbin/bgpd/rde_rib.c","rib_get",178,188
25,8,129,2,25,"rib_lookup@191-216@usr.sbin/bgpd/rde_rib.c","usr.sbin/bgpd/rde_rib.c","rib_lookup",191,216
21,4,143,3,27,"rib_add@220-247@usr.sbin/bgpd/rde_rib.c","usr.sbin/bgpd/rde_rib.c","rib_add",220,247
14,5,88,1,18,"rib_remove@250-268@usr.sbin/bgpd/rde_rib.c","usr.sbin/bgpd/rde_rib.c","rib_remove",250,268
4,1,18,1,3,"rib_empty@271-274@usr.sbin/bgpd/rde_rib.c","usr.sbin/bgpd/rde_rib.c","rib_empty",271,274
12,2,88,4,12,"rib_dump@277-289@usr.sbin/bgpd/rde_rib.c","usr.sbin/bgpd/rde_rib.c","rib_dump",277,289
25,9,157,1,28,"rib_dump_r@292-320@usr.sbin/bgpd/rde_rib.c","usr.sbin/bgpd/rde_rib.c","rib_dump_r",292,320
12,4,72,1,16,"rib_restart@323-339@usr.sbin/bgpd/rde_rib.c","usr.sbin/bgpd/rde_rib.c","rib_restart",323,339
13,4,99,1,15,"path_init@361-376@usr.sbin/bgpd/rde_rib.c","usr.sbin/bgpd/rde_rib.c","path_init",361,376
8,3,50,1,9,"path_shutdown@379-388@usr.sbin/bgpd/rde_rib.c","usr.sbin/bgpd/rde_rib.c","path_shutdown",379,388
25,6,178,5,39,"path_update@391-430@usr.sbin/bgpd/rde_rib.c","usr.sbin/bgpd/rde_rib.c","path_update",391,430
40,18,315,2,42,"path_compare@433-475@usr.sbin/bgpd/rde_rib.c","usr.sbin/bgpd/rde_rib.c","path_compare",433,475
11,3,70,2,12,"path_lookup@478-490@usr.sbin/bgpd/rde_rib.c","usr.sbin/bgpd/rde_rib.c","path_lookup",478,490
14,3,95,1,16,"path_remove@493-509@usr.sbin/bgpd/rde_rib.c","usr.sbin/bgpd/rde_rib.c","path_remove",493,509
25,7,168,2,32,"path_remove_stale@514-546@usr.sbin/bgpd/rde_rib.c","usr.sbin/bgpd/rde_rib.c","path_remove_stale",514,546
12,3,70,1,14,"path_destroy@551-565@usr.sbin/bgpd/rde_rib.c","usr.sbin/bgpd/rde_rib.c","path_destroy",551,565
4,1,18,1,3,"path_empty@568-571@usr.sbin/bgpd/rde_rib.c","usr.sbin/bgpd/rde_rib.c","path_empty",568,571
10,1,66,2,11,"path_link@581-592@usr.sbin/bgpd/rde_rib.c","usr.sbin/bgpd/rde_rib.c","path_link",581,592
22,2,142,1,24,"path_copy@598-622@usr.sbin/bgpd/rde_rib.c","usr.sbin/bgpd/rde_rib.c","path_copy",598,622
12,2,65,1,17,"path_get@626-643@usr.sbin/bgpd/rde_rib.c","usr.sbin/bgpd/rde_rib.c","path_get",626,643
13,3,66,1,14,"path_put@647-661@usr.sbin/bgpd/rde_rib.c","usr.sbin/bgpd/rde_rib.c","path_put",647,661
9,2,64,5,9,"prefix_get@675-684@usr.sbin/bgpd/rde_rib.c","usr.sbin/bgpd/rde_rib.c","prefix_get",675,684
21,4,138,4,24,"prefix_add@690-714@usr.sbin/bgpd/rde_rib.c","usr.sbin/bgpd/rde_rib.c","prefix_add",690,714
25,3,169,2,50,"prefix_move@720-770@usr.sbin/bgpd/rde_rib.c","usr.sbin/bgpd/rde_rib.c","prefix_move",720,770
20,4,125,5,26,"prefix_remove@777-803@usr.sbin/bgpd/rde_rib.c","usr.sbin/bgpd/rde_rib.c","prefix_remove",777,803
29,6,234,4,31,"prefix_write@807-838@usr.sbin/bgpd/rde_rib.c","usr.sbin/bgpd/rde_rib.c","prefix_write",807,838
22,6,130,3,23,"prefix_writebuf@841-864@usr.sbin/bgpd/rde_rib.c","usr.sbin/bgpd/rde_rib.c","prefix_writebuf",841,864
14,4,85,3,14,"prefix_bypeer@871-885@usr.sbin/bgpd/rde_rib.c","usr.sbin/bgpd/rde_rib.c","prefix_bypeer",871,885
19,7,138,3,39,"prefix_updateall@888-927@usr.sbin/bgpd/rde_rib.c","usr.sbin/bgpd/rde_rib.c","prefix_updateall",888,927
9,2,42,1,10,"prefix_destroy@931-941@usr.sbin/bgpd/rde_rib.c","usr.sbin/bgpd/rde_rib.c","prefix_destroy",931,941
19,6,139,3,19,"prefix_network_clean@947-966@usr.sbin/bgpd/rde_rib.c","usr.sbin/bgpd/rde_rib.c","prefix_network_clean",947,966
11,1,81,3,13,"prefix_link@972-985@usr.sbin/bgpd/rde_rib.c","usr.sbin/bgpd/rde_rib.c","prefix_link",972,985
16,3,102,1,26,"prefix_unlink@991-1017@usr.sbin/bgpd/rde_rib.c","usr.sbin/bgpd/rde_rib.c","prefix_unlink",991,1017
9,2,43,1,9,"prefix_alloc@1021-1030@usr.sbin/bgpd/rde_rib.c","usr.sbin/bgpd/rde_rib.c","prefix_alloc",1021,1030
5,1,19,1,4,"prefix_free@1034-1038@usr.sbin/bgpd/rde_rib.c","usr.sbin/bgpd/rde_rib.c","prefix_free",1034,1038
13,4,99,1,15,"nexthop_init@1063-1078@usr.sbin/bgpd/rde_rib.c","usr.sbin/bgpd/rde_rib.c","nexthop_init",1063,1078
16,4,108,1,17,"nexthop_shutdown@1081-1098@usr.sbin/bgpd/rde_rib.c","usr.sbin/bgpd/rde_rib.c","nexthop_shutdown",1081,1098
34,6,205,1,45,"nexthop_update@1101-1146@usr.sbin/bgpd/rde_rib.c","usr.sbin/bgpd/rde_rib.c","nexthop_update",1101,1146
32,10,144,4,33,"nexthop_modify@1149-1182@usr.sbin/bgpd/rde_rib.c","usr.sbin/bgpd/rde_rib.c","nexthop_modify",1149,1182
6,2,33,1,6,"nexthop_link@1185-1191@usr.sbin/bgpd/rde_rib.c","usr.sbin/bgpd/rde_rib.c","nexthop_link",1185,1191
10,2,51,1,14,"nexthop_unlink@1194-1208@usr.sbin/bgpd/rde_rib.c","usr.sbin/bgpd/rde_rib.c","nexthop_unlink",1194,1208
12,4,76,1,16,"nexthop_delete@1211-1227@usr.sbin/bgpd/rde_rib.c","usr.sbin/bgpd/rde_rib.c","nexthop_delete",1211,1227
18,3,106,1,21,"nexthop_get@1230-1251@usr.sbin/bgpd/rde_rib.c","usr.sbin/bgpd/rde_rib.c","nexthop_get",1230,1251
27,9,196,2,30,"nexthop_compare@1254-1284@usr.sbin/bgpd/rde_rib.c","usr.sbin/bgpd/rde_rib.c","nexthop_compare",1254,1284
10,2,57,1,10,"nexthop_lookup@1287-1297@usr.sbin/bgpd/rde_rib.c","usr.sbin/bgpd/rde_rib.c","nexthop_lookup",1287,1297
17,3,97,1,17,"nexthop_hash@1300-1317@usr.sbin/bgpd/rde_rib.c","usr.sbin/bgpd/rde_rib.c","nexthop_hash",1300,1317
15,2,99,1,15,"up_init@70-85@usr.sbin/bgpd/rde_update.c","usr.sbin/bgpd/rde_update.c","up_init",70,85
19,4,131,2,20,"up_clear@88-108@usr.sbin/bgpd/rde_update.c","usr.sbin/bgpd/rde_update.c","up_clear",88,108
12,2,84,1,14,"up_down@111-125@usr.sbin/bgpd/rde_update.c","usr.sbin/bgpd/rde_update.c","up_down",111,125
50,20,455,2,51,"up_prefix_cmp@128-179@usr.sbin/bgpd/rde_update.c","usr.sbin/bgpd/rde_update.c","up_prefix_cmp",128,179
13,5,126,2,13,"up_attr_cmp@182-195@usr.sbin/bgpd/rde_update.c","usr.sbin/bgpd/rde_update.c","up_attr_cmp",182,195
58,8,391,3,74,"up_add@198-272@usr.sbin/bgpd/rde_update.c","usr.sbin/bgpd/rde_update.c","up_add",198,272
52,25,358,2,87,"up_test_update@275-362@usr.sbin/bgpd/rde_update.c","usr.sbin/bgpd/rde_update.c","up_test_update",275,362
30,7,218,4,38,"up_generate@365-403@usr.sbin/bgpd/rde_update.c","usr.sbin/bgpd/rde_update.c","up_generate",365,403
38,11,251,4,46,"up_generate_updates@406-452@usr.sbin/bgpd/rde_update.c","usr.sbin/bgpd/rde_update.c","up_generate_updates",406,452
25,4,162,3,40,"up_generate_default@456-496@usr.sbin/bgpd/rde_update.c","usr.sbin/bgpd/rde_update.c","up_generate_default",456,496
26,4,178,2,33,"up_generate_marker@500-533@usr.sbin/bgpd/rde_update.c","usr.sbin/bgpd/rde_update.c","up_generate_marker",500,533
33,11,279,2,52,"up_get_nexthop@539-591@usr.sbin/bgpd/rde_update.c","usr.sbin/bgpd/rde_update.c","up_get_nexthop",539,591
111,29,943,4,132,"up_generate_mp_reach@594-726@usr.sbin/bgpd/rde_update.c","usr.sbin/bgpd/rde_update.c","up_generate_mp_reach",594,726
175,51,1287,4,219,"up_generate_attr@729-948@usr.sbin/bgpd/rde_update.c","usr.sbin/bgpd/rde_update.c","up_generate_attr",729,948
28,6,187,4,28,"up_dump_prefix@952-980@usr.sbin/bgpd/rde_update.c","usr.sbin/bgpd/rde_update.c","up_dump_prefix",952,980
42,9,314,3,63,"up_dump_attrnlri@983-1046@usr.sbin/bgpd/rde_update.c","usr.sbin/bgpd/rde_update.c","up_dump_attrnlri",983,1046
43,6,320,4,65,"up_dump_mp_unreach@1049-1114@usr.sbin/bgpd/rde_update.c","usr.sbin/bgpd/rde_update.c","up_dump_mp_unreach",1049,1114
70,14,512,4,93,"up_dump_mp_reach@1117-1210@usr.sbin/bgpd/rde_update.c","usr.sbin/bgpd/rde_update.c","up_dump_mp_reach",1117,1210
9,3,25,1,8,"session_sighdlr@122-130@usr.sbin/bgpd/session.c","usr.sbin/bgpd/session.c","session_sighdlr",122,130
46,10,284,1,56,"setup_listeners@133-189@usr.sbin/bgpd/session.c","usr.sbin/bgpd/session.c","setup_listeners",133,189
336,85,2204,2,402,"session_main@192-594@usr.sbin/bgpd/session.c","usr.sbin/bgpd/session.c","session_main",192,594
7,3,35,1,6,"init_conf@597-603@usr.sbin/bgpd/session.c","usr.sbin/bgpd/session.c","init_conf",597,603
18,5,141,1,26,"init_peer@606-632@usr.sbin/bgpd/session.c","usr.sbin/bgpd/session.c","init_peer",606,632
216,50,1008,2,232,"bgp_fsm@635-867@usr.sbin/bgpd/session.c","usr.sbin/bgpd/session.c","bgp_fsm",635,867
7,2,36,1,6,"start_timer_holdtime@870-876@usr.sbin/bgpd/session.c","usr.sbin/bgpd/session.c","start_timer_holdtime",870,876
7,2,38,1,6,"start_timer_keepalive@879-885@usr.sbin/bgpd/session.c","usr.sbin/bgpd/session.c","start_timer_keepalive",879,885
8,2,44,1,7,"session_close_connection@888-895@usr.sbin/bgpd/session.c","usr.sbin/bgpd/session.c","session_close_connection",888,895
91,33,612,3,109,"change_state@898-1007@usr.sbin/bgpd/session.c","usr.sbin/bgpd/session.c","change_state",898,1007
76,26,447,1,84,"session_accept@1010-1094@usr.sbin/bgpd/session.c","usr.sbin/bgpd/session.c","session_accept",1010,1094
57,14,416,1,70,"session_connect@1097-1167@usr.sbin/bgpd/session.c","usr.sbin/bgpd/session.c","session_connect",1097,1167
77,20,474,1,90,"session_setup_socket@1170-1260@usr.sbin/bgpd/session.c","usr.sbin/bgpd/session.c","session_setup_socket",1170,1260
12,3,90,1,12,"session_tcp_established@1263-1275@usr.sbin/bgpd/session.c","usr.sbin/bgpd/session.c","session_tcp_established",1263,1275
4,1,28,1,3,"session_capa_ann_none@1278-1281@usr.sbin/bgpd/session.c","usr.sbin/bgpd/session.c","session_capa_ann_none",1278,1281
7,1,55,3,7,"session_capa_add@1284-1291@usr.sbin/bgpd/session.c","usr.sbin/bgpd/session.c","session_capa_add",1284,1291
13,2,105,2,14,"session_capa_add_mp@1294-1308@usr.sbin/bgpd/session.c","usr.sbin/bgpd/session.c","session_capa_add_mp",1294,1308
19,3,138,3,21,"session_capa_add_gr@1311-1332@usr.sbin/bgpd/session.c","usr.sbin/bgpd/session.c","session_capa_add_gr",1311,1332
23,4,193,2,28,"session_newmsg@1335-1363@usr.sbin/bgpd/session.c","usr.sbin/bgpd/session.c","session_newmsg",1335,1363
22,12,200,2,24,"session_sendmsg@1366-1390@usr.sbin/bgpd/session.c","usr.sbin/bgpd/session.c","session_sendmsg",1366,1390
103,22,785,1,127,"session_open@1393-1520@usr.sbin/bgpd/session.c","usr.sbin/bgpd/session.c","session_open",1393,1520
11,3,62,1,12,"session_keepalive@1523-1535@usr.sbin/bgpd/session.c","usr.sbin/bgpd/session.c","session_keepalive",1523,1535
27,6,157,3,32,"session_update@1538-1570@usr.sbin/bgpd/session.c","usr.sbin/bgpd/session.c","session_update",1538,1570
31,6,211,5,38,"session_notification@1573-1611@usr.sbin/bgpd/session.c","usr.sbin/bgpd/session.c","session_notification",1573,1611
11,4,71,1,13,"session_neighbor_rrefresh@1614-1627@usr.sbin/bgpd/session.c","usr.sbin/bgpd/session.c","session_neighbor_rrefresh",1614,1627
28,5,194,2,33,"session_rrefresh@1630-1663@usr.sbin/bgpd/session.c","usr.sbin/bgpd/session.c","session_rrefresh",1630,1663
24,6,203,1,25,"session_graceful_restart@1666-1691@usr.sbin/bgpd/session.c","usr.sbin/bgpd/session.c","session_graceful_restart",1666,1691
15,4,119,1,20,"session_graceful_stop@1694-1714@usr.sbin/bgpd/session.c","usr.sbin/bgpd/session.c","session_graceful_stop",1694,1714
80,28,546,2,85,"session_dispatch_msg@1717-1802@usr.sbin/bgpd/session.c","usr.sbin/bgpd/session.c","session_dispatch_msg",1717,1802
71,22,430,1,81,"session_process_msg@1805-1886@usr.sbin/bgpd/session.c","usr.sbin/bgpd/session.c","session_process_msg",1805,1886
89,14,556,4,93,"parse_header@1889-1982@usr.sbin/bgpd/session.c","usr.sbin/bgpd/session.c","parse_header",1889,1982
152,23,1003,1,179,"parse_open@1985-2164@usr.sbin/bgpd/session.c","usr.sbin/bgpd/session.c","parse_open",1985,2164
16,2,102,1,24,"parse_update@2167-2191@usr.sbin/bgpd/session.c","usr.sbin/bgpd/session.c","parse_update",2167,2191
22,3,149,1,35,"parse_refresh@2194-2229@usr.sbin/bgpd/session.c","usr.sbin/bgpd/session.c","parse_refresh",2194,2229
120,20,656,1,131,"parse_notification@2232-2363@usr.sbin/bgpd/session.c","usr.sbin/bgpd/session.c","parse_notification",2232,2363
135,20,801,4,140,"parse_capabilities@2366-2506@usr.sbin/bgpd/session.c","usr.sbin/bgpd/session.c","parse_capabilities",2366,2506
41,13,409,1,59,"capa_neg_calc@2509-2568@usr.sbin/bgpd/session.c","usr.sbin/bgpd/session.c","capa_neg_calc",2509,2568
388,107,2303,3,418,"session_dispatch_imsg@2571-2989@usr.sbin/bgpd/session.c","usr.sbin/bgpd/session.c","session_dispatch_imsg",2571,2989
29,8,204,2,32,"la_cmp@2992-3024@usr.sbin/bgpd/session.c","usr.sbin/bgpd/session.c","la_cmp",2992,3024
9,3,57,1,11,"getpeerbyaddr@3027-3038@usr.sbin/bgpd/session.c","usr.sbin/bgpd/session.c","getpeerbyaddr",3027,3038
17,5,94,1,19,"getpeerbydesc@3041-3060@usr.sbin/bgpd/session.c","usr.sbin/bgpd/session.c","getpeerbydesc",3041,3060
42,16,320,1,49,"getpeerbyip@3063-3112@usr.sbin/bgpd/session.c","usr.sbin/bgpd/session.c","getpeerbyip",3063,3112
27,6,199,4,32,"session_template_clone@3115-3147@usr.sbin/bgpd/session.c","usr.sbin/bgpd/session.c","session_template_clone",3115,3147
18,5,140,2,19,"session_match_mask@3150-3169@usr.sbin/bgpd/session.c","usr.sbin/bgpd/session.c","session_match_mask",3150,3169
8,3,42,1,10,"getpeerbyid@3172-3182@usr.sbin/bgpd/session.c","usr.sbin/bgpd/session.c","getpeerbyid",3172,3182
8,2,71,1,7,"session_down@3185-3192@usr.sbin/bgpd/session.c","usr.sbin/bgpd/session.c","session_down",3185,3192
16,3,174,1,18,"session_up@3195-3213@usr.sbin/bgpd/session.c","usr.sbin/bgpd/session.c","session_up",3195,3213
5,1,41,5,4,"imsg_ctl_parent@3216-3220@usr.sbin/bgpd/session.c","usr.sbin/bgpd/session.c","imsg_ctl_parent",3216,3220
4,1,38,4,7,"imsg_ctl_rde@3223-3230@usr.sbin/bgpd/session.c","usr.sbin/bgpd/session.c","imsg_ctl_rde",3223,3230
11,2,84,2,12,"session_demote@3233-3245@usr.sbin/bgpd/session.c","usr.sbin/bgpd/session.c","session_demote",3233,3245
28,9,147,2,31,"session_stop@3248-3279@usr.sbin/bgpd/session.c","usr.sbin/bgpd/session.c","session_stop",3248,3279
9,4,48,3,10,"session_link_state_is_up@3288-3298@usr.sbin/bgpd/session.c","usr.sbin/bgpd/session.c","session_link_state_is_up",3288,3298
7,2,34,1,8,"getmonotime@29-37@usr.sbin/bgpd/timer.c","usr.sbin/bgpd/timer.c","getmonotime",29,37
8,2,44,2,9,"timer_get@40-49@usr.sbin/bgpd/timer.c","usr.sbin/bgpd/timer.c","timer_get",40,49
8,4,54,1,8,"timer_nextisdue@52-60@usr.sbin/bgpd/timer.c","usr.sbin/bgpd/timer.c","timer_nextisdue",52,60
7,3,58,1,7,"timer_nextduein@63-70@usr.sbin/bgpd/timer.c","usr.sbin/bgpd/timer.c","timer_nextduein",63,70
10,4,70,3,10,"timer_running@73-83@usr.sbin/bgpd/timer.c","usr.sbin/bgpd/timer.c","timer_running",73,83
21,7,166,3,23,"timer_set@86-109@usr.sbin/bgpd/timer.c","usr.sbin/bgpd/timer.c","timer_set",86,109
9,2,63,2,9,"timer_stop@112-121@usr.sbin/bgpd/timer.c","usr.sbin/bgpd/timer.c","timer_stop",112,121
8,2,50,2,8,"timer_remove@124-132@usr.sbin/bgpd/timer.c","usr.sbin/bgpd/timer.c","timer_remove",124,132
8,2,49,1,8,"timer_remove_all@135-143@usr.sbin/bgpd/timer.c","usr.sbin/bgpd/timer.c","timer_remove_all",135,143
21,6,137,1,21,"log_addr@36-57@usr.sbin/bgpd/util.c","usr.sbin/bgpd/util.c","log_addr",36,57
17,3,146,1,20,"log_in6addr@60-80@usr.sbin/bgpd/util.c","usr.sbin/bgpd/util.c","log_in6addr",60,80
9,2,51,1,9,"log_sockaddr@83-92@usr.sbin/bgpd/util.c","usr.sbin/bgpd/util.c","log_sockaddr",83,92
7,2,43,1,8,"log_as@95-103@usr.sbin/bgpd/util.c","usr.sbin/bgpd/util.c","log_as",95,103
29,4,181,1,29,"log_rd@106-135@usr.sbin/bgpd/util.c","usr.sbin/bgpd/util.c","log_rd",106,135
11,4,80,2,11,"log_ext_subtype@142-153@usr.sbin/bgpd/util.c","usr.sbin/bgpd/util.c","log_ext_subtype",142,153
5,1,43,1,6,"log_shutcomm@156-162@usr.sbin/bgpd/util.c","usr.sbin/bgpd/util.c","log_shutcomm",156,162
29,9,129,2,29,"aspath_delim@165-194@usr.sbin/bgpd/util.c","usr.sbin/bgpd/util.c","aspath_delim",165,194
32,6,220,4,50,"aspath_snprint@197-247@usr.sbin/bgpd/util.c","usr.sbin/bgpd/util.c","aspath_snprint",197,247
16,3,98,3,18,"aspath_asprint@250-268@usr.sbin/bgpd/util.c","usr.sbin/bgpd/util.c","aspath_asprint",250,268
33,9,183,2,38,"aspath_strlen@271-309@usr.sbin/bgpd/util.c","usr.sbin/bgpd/util.c","aspath_strlen",271,309
44,14,298,4,55,"aspath_match@313-368@usr.sbin/bgpd/util.c","usr.sbin/bgpd/util.c","aspath_match",313,368
13,12,101,5,12,"as_compare@371-383@usr.sbin/bgpd/util.c","usr.sbin/bgpd/util.c","as_compare",371,383
8,1,54,2,8,"aspath_extract@391-399@usr.sbin/bgpd/util.c","usr.sbin/bgpd/util.c","aspath_extract",391,399
58,20,500,3,59,"prefix_compare@406-465@usr.sbin/bgpd/util.c","usr.sbin/bgpd/util.c","prefix_compare",406,465
6,2,30,1,6,"prefixlen2mask@468-474@usr.sbin/bgpd/util.c","usr.sbin/bgpd/util.c","prefixlen2mask",468,474
13,4,118,3,14,"inet6applymask@477-491@usr.sbin/bgpd/util.c","usr.sbin/bgpd/util.c","inet6applymask",477,491
6,2,28,1,5,"aid2str@497-502@usr.sbin/bgpd/util.c","usr.sbin/bgpd/util.c","aid2str",497,502
9,2,54,3,8,"aid2afi@505-513@usr.sbin/bgpd/util.c","usr.sbin/bgpd/util.c","aid2afi",505,513
10,4,68,3,11,"afi2aid@516-527@usr.sbin/bgpd/util.c","usr.sbin/bgpd/util.c","afi2aid",516,527
6,2,28,1,5,"aid2af@530-535@usr.sbin/bgpd/util.c","usr.sbin/bgpd/util.c","aid2af",530,535
12,5,78,3,14,"af2aid@538-552@usr.sbin/bgpd/util.c","usr.sbin/bgpd/util.c","af2aid",538,552
26,4,186,2,28,"addr2sa@555-583@usr.sbin/bgpd/util.c","usr.sbin/bgpd/util.c","addr2sa",555,583
17,3,127,2,17,"sa2addr@586-603@usr.sbin/bgpd/util.c","usr.sbin/bgpd/util.c","sa2addr",586,603
6,1,17,1,5,"print_usage@117-122@usr.sbin/bind/bin/dig/dig.c","usr.sbin/bind/bin/dig/dig.c","print_usage",117,122
6,1,24,1,5,"usage@125-130@usr.sbin/bind/bin/dig/dig.c","usr.sbin/bind/bin/dig/dig.c","usage",125,130
3,1,15,1,2,"version@134-136@usr.sbin/bind/bin/dig/dig.c","usr.sbin/bind/bin/dig/dig.c","version",134,136
67,3,79,1,70,"help@140-210@usr.sbin/bind/bin/dig/dig.c","usr.sbin/bind/bin/dig/dig.c","help",140,210
40,11,266,3,43,"received@216-259@usr.sbin/bind/bin/dig/dig.c","usr.sbin/bind/bin/dig/dig.c","received",216,259
4,1,22,2,3,"trying@267-270@usr.sbin/bind/bin/dig/dig.c","usr.sbin/bind/bin/dig/dig.c","trying",267,270
24,5,177,3,24,"say_message@276-300@usr.sbin/bind/bin/dig/dig.c","usr.sbin/bind/bin/dig/dig.c","say_message",276,300
42,8,243,4,47,"short_answer@306-353@usr.sbin/bind/bin/dig/dig.c","usr.sbin/bind/bin/dig/dig.c","short_answer",306,353
37,13,233,3,41,"printrdataset@356-397@usr.sbin/bind/bin/dig/dig.c","usr.sbin/bind/bin/dig/dig.c","printrdataset",356,397
183,60,1077,3,200,"printmessage@404-604@usr.sbin/bind/bin/dig/dig.c","usr.sbin/bind/bin/dig/dig.c","printmessage",404,604
32,10,236,3,32,"printgreeting@610-642@usr.sbin/bind/bin/dig/dig.c","usr.sbin/bind/bin/dig/dig.c","printgreeting",610,642
10,4,73,3,10,"parse_uint@645-655@usr.sbin/bind/bin/dig/dig.c","usr.sbin/bind/bin/dig/dig.c","parse_uint",645,655
363,90,1544,3,386,"plus_option@665-1051@usr.sbin/bind/bin/dig/dig.c","usr.sbin/bind/bin/dig/dig.c","plus_option",665,1051
308,67,1876,9,315,"dash_option@1059-1374@usr.sbin/bind/bin/dig/dig.c","usr.sbin/bind/bin/dig/dig.c","dash_option",1059,1374
21,5,123,2,21,"preparse_args@1386-1407@usr.sbin/bind/bin/dig/dig.c","usr.sbin/bind/bin/dig/dig.c","preparse_args",1386,1407
20,3,140,2,21,"getaddresses@1410-1431@usr.sbin/bind/bin/dig/dig.c","usr.sbin/bind/bin/dig/dig.c","getaddresses",1410,1431
221,53,1328,4,262,"parse_args@1434-1696@usr.sbin/bind/bin/dig/dig.c","usr.sbin/bind/bin/dig/dig.c","parse_args",1434,1696
40,9,234,1,44,"dighost_shutdown@1704-1748@usr.sbin/bind/bin/dig/dig.c","usr.sbin/bind/bin/dig/dig.c","dighost_shutdown",1704,1748
40,7,221,2,46,"main@1752-1798@usr.sbin/bind/bin/dig/dig.c","usr.sbin/bind/bin/dig/dig.c","main",1752,1798
3,1,21,2,2,"mem_alloc@360-362@usr.sbin/bind/bin/dig/dighost.c","usr.sbin/bind/bin/dig/dighost.c","mem_alloc",360,362
3,1,24,3,2,"mem_free@365-367@usr.sbin/bind/bin/dig/dighost.c","usr.sbin/bind/bin/dig/dighost.c","mem_free",365,367
9,3,50,2,9,"next_token@370-379@usr.sbin/bind/bin/dig/dighost.c","usr.sbin/bind/bin/dig/dighost.c","next_token",370,379
11,3,48,1,11,"count_dots@382-393@usr.sbin/bind/bin/dig/dighost.c","usr.sbin/bind/bin/dig/dighost.c","count_dots",382,393
13,4,87,1,14,"hex_dump@396-410@usr.sbin/bind/bin/dig/dighost.c","usr.sbin/bind/bin/dig/dighost.c","hex_dump",396,410
7,2,54,4,6,"append@417-423@usr.sbin/bind/bin/dig/dighost.c","usr.sbin/bind/bin/dig/dighost.c","append",417,423
17,4,120,3,16,"reverse_octets@426-442@usr.sbin/bind/bin/dig/dighost.c","usr.sbin/bind/bin/dig/dighost.c","reverse_octets",426,442
35,8,227,5,46,"get_reverse@445-491@usr.sbin/bind/bin/dig/dighost.c","usr.sbin/bind/bin/dig/dighost.c","get_reverse",445,491
13,3,76,2,13,"fatal@494-507@usr.sbin/bind/bin/dig/dighost.c","usr.sbin/bind/bin/dig/dighost.c","fatal",494,507
9,2,48,2,9,"debug@510-519@usr.sbin/bind/bin/dig/dighost.c","usr.sbin/bind/bin/dig/dighost.c","debug",510,519
5,2,32,2,4,"check_result@522-526@usr.sbin/bind/bin/dig/dighost.c","usr.sbin/bind/bin/dig/dighost.c","check_result",522,526
14,2,103,3,15,"make_server@534-549@usr.sbin/bind/bin/dig/dighost.c","usr.sbin/bind/bin/dig/dighost.c","make_server",534,549
13,3,41,1,15,"addr2af@552-567@usr.sbin/bind/bin/dig/dighost.c","usr.sbin/bind/bin/dig/dighost.c","addr2af",552,567
15,2,121,2,16,"copy_server_list@574-590@usr.sbin/bind/bin/dig/dighost.c","usr.sbin/bind/bin/dig/dighost.c","copy_server_list",574,590
11,2,62,1,11,"flush_server_list@593-604@usr.sbin/bind/bin/dig/dighost.c","usr.sbin/bind/bin/dig/dighost.c","flush_server_list",593,604
24,5,152,1,27,"set_nameserver@607-634@usr.sbin/bind/bin/dig/dighost.c","usr.sbin/bind/bin/dig/dighost.c","set_nameserver",607,634
22,5,141,3,25,"add_nameserver@637-662@usr.sbin/bind/bin/dig/dighost.c","usr.sbin/bind/bin/dig/dighost.c","add_nameserver",637,662
12,2,81,2,12,"clone_server_list@669-681@usr.sbin/bind/bin/dig/dighost.c","usr.sbin/bind/bin/dig/dighost.c","clone_server_list",669,681
69,4,418,1,75,"make_empty_lookup@690-765@usr.sbin/bind/bin/dig/dighost.c","usr.sbin/bind/bin/dig/dighost.c","make_empty_lookup",690,765
55,5,425,2,64,"clone_lookup@775-839@usr.sbin/bind/bin/dig/dighost.c","usr.sbin/bind/bin/dig/dighost.c","clone_lookup",775,839
15,2,100,2,18,"requeue_lookup@850-868@usr.sbin/bind/bin/dig/dighost.c","usr.sbin/bind/bin/dig/dighost.c","requeue_lookup",850,868
40,5,244,1,44,"setup_text_key@872-916@usr.sbin/bind/bin/dig/dighost.c","usr.sbin/bind/bin/dig/dighost.c","setup_text_key",872,916
48,10,206,1,49,"setup_file_key@919-968@usr.sbin/bind/bin/dig/dighost.c","usr.sbin/bind/bin/dig/dighost.c","setup_file_key",919,968
10,2,63,1,9,"make_searchlist_entry@971-980@usr.sbin/bind/bin/dig/dighost.c","usr.sbin/bind/bin/dig/dighost.c","make_searchlist_entry",971,980
10,2,63,1,11,"create_search_list@983-994@usr.sbin/bind/bin/dig/dighost.c","usr.sbin/bind/bin/dig/dighost.c","create_search_list",983,994
50,19,304,1,72,"setup_system@1001-1073@usr.sbin/bind/bin/dig/dighost.c","usr.sbin/bind/bin/dig/dighost.c","setup_system",1001,1073
7,2,41,1,6,"clear_searchlist@1076-1082@usr.sbin/bind/bin/dig/dighost.c","usr.sbin/bind/bin/dig/dighost.c","clear_searchlist",1076,1082
6,1,32,1,6,"set_search_domain@1088-1094@usr.sbin/bind/bin/dig/dighost.c","usr.sbin/bind/bin/dig/dighost.c","set_search_domain",1088,1094
35,5,250,1,51,"setup_libs@1100-1151@usr.sbin/bind/bin/dig/dighost.c","usr.sbin/bind/bin/dig/dighost.c","setup_libs",1100,1151
30,2,196,4,31,"add_opt@1158-1189@usr.sbin/bind/bin/dig/dighost.c","usr.sbin/bind/bin/dig/dighost.c","add_opt",1158,1189
13,1,76,4,13,"add_question@1196-1209@usr.sbin/bind/bin/dig/dighost.c","usr.sbin/bind/bin/dig/dighost.c","add_question",1196,1209
11,5,65,1,10,"check_if_done@1220-1230@usr.sbin/bind/bin/dig/dighost.c","usr.sbin/bind/bin/dig/dighost.c","check_if_done",1220,1230
28,6,191,1,32,"clear_query@1237-1269@usr.sbin/bind/bin/dig/dighost.c","usr.sbin/bind/bin/dig/dighost.c","clear_query",1237,1269
17,4,95,1,24,"try_clear_lookup@1277-1301@usr.sbin/bind/bin/dig/dighost.c","usr.sbin/bind/bin/dig/dighost.c","try_clear_lookup",1277,1301
27,7,181,1,29,"destroy_lookup@1304-1333@usr.sbin/bind/bin/dig/dighost.c","usr.sbin/bind/bin/dig/dighost.c","destroy_lookup",1304,1333
79,10,435,1,104,"start_lookup@1342-1446@usr.sbin/bind/bin/dig/dighost.c","usr.sbin/bind/bin/dig/dighost.c","start_lookup",1342,1446
12,3,58,1,14,"check_next_lookup@1453-1467@usr.sbin/bind/bin/dig/dighost.c","usr.sbin/bind/bin/dig/dighost.c","check_next_lookup",1453,1467
114,25,709,3,134,"followup_lookup@1476-1610@usr.sbin/bind/bin/dig/dighost.c","usr.sbin/bind/bin/dig/dighost.c","followup_lookup",1476,1610
25,8,185,2,35,"next_origin@1619-1654@usr.sbin/bind/bin/dig/dighost.c","usr.sbin/bind/bin/dig/dighost.c","next_origin",1619,1654
49,1,368,1,59,"insert_soa@1661-1720@usr.sbin/bind/bin/dig/dighost.c","usr.sbin/bind/bin/dig/dighost.c","insert_soa",1661,1720
264,54,1833,1,337,"setup_lookup@1729-2066@usr.sbin/bind/bin/dig/dighost.c","usr.sbin/bind/bin/dig/dighost.c","setup_lookup",1729,2066
31,6,193,2,40,"send_done@2073-2113@usr.sbin/bind/bin/dig/dighost.c","usr.sbin/bind/bin/dig/dighost.c","send_done",2073,2113
20,4,111,1,20,"cancel_lookup@2121-2141@usr.sbin/bind/bin/dig/dighost.c","usr.sbin/bind/bin/dig/dighost.c","cancel_lookup",2121,2141
23,4,136,2,28,"bringup_timer@2144-2172@usr.sbin/bind/bin/dig/dighost.c","usr.sbin/bind/bin/dig/dighost.c","bringup_timer",2144,2172
63,12,369,1,71,"send_tcp_connect@2183-2254@usr.sbin/bind/bin/dig/dighost.c","usr.sbin/bind/bin/dig/dighost.c","send_tcp_connect",2183,2254
57,5,383,1,63,"send_udp@2262-2325@usr.sbin/bind/bin/dig/dighost.c","usr.sbin/bind/bin/dig/dighost.c","send_udp",2262,2325
46,8,265,2,51,"connect_timeout@2333-2384@usr.sbin/bind/bin/dig/dighost.c","usr.sbin/bind/bin/dig/dighost.c","connect_timeout",2333,2384
66,4,399,2,77,"tcp_length_done@2391-2468@usr.sbin/bind/bin/dig/dighost.c","usr.sbin/bind/bin/dig/dighost.c","tcp_length_done",2391,2468
46,5,319,2,52,"launch_next_query@2475-2527@usr.sbin/bind/bin/dig/dighost.c","usr.sbin/bind/bin/dig/dighost.c","launch_next_query",2475,2527
64,7,362,2,72,"connect_done@2535-2607@usr.sbin/bind/bin/dig/dighost.c","usr.sbin/bind/bin/dig/dighost.c","connect_done",2535,2607
104,19,529,3,135,"check_for_more_data@2616-2751@usr.sbin/bind/bin/dig/dighost.c","usr.sbin/bind/bin/dig/dighost.c","check_for_more_data",2616,2751
394,111,2315,2,471,"recv_done@2758-3229@usr.sbin/bind/bin/dig/dighost.c","usr.sbin/bind/bin/dig/dighost.c","recv_done",2758,3229
11,2,70,3,11,"get_address@3237-3248@usr.sbin/bind/bin/dig/dighost.c","usr.sbin/bind/bin/dig/dighost.c","get_address",3237,3248
9,2,53,1,10,"do_lookup@3254-3264@usr.sbin/bind/bin/dig/dighost.c","usr.sbin/bind/bin/dig/dighost.c","do_lookup",3254,3264
7,1,31,2,7,"onrun_callback@3270-3277@usr.sbin/bind/bin/dig/dighost.c","usr.sbin/bind/bin/dig/dighost.c","onrun_callback",3270,3277
36,7,177,1,37,"cancel_all@3284-3321@usr.sbin/bind/bin/dig/dighost.c","usr.sbin/bind/bin/dig/dighost.c","cancel_all",3284,3321
88,24,490,1,120,"destroy_libs@3328-3448@usr.sbin/bind/bin/dig/dighost.c","usr.sbin/bind/bin/dig/dighost.c","destroy_libs",3328,3448
11,3,59,1,17,"initialize_idn@3452-3469@usr.sbin/bind/bin/dig/dighost.c","usr.sbin/bind/bin/dig/dighost.c","initialize_idn",3452,3469
32,12,247,3,48,"output_filter@3472-3520@usr.sbin/bind/bin/dig/dighost.c","usr.sbin/bind/bin/dig/dighost.c","output_filter",3472,3520
13,5,98,3,18,"append_textname@3523-3541@usr.sbin/bind/bin/dig/dighost.c","usr.sbin/bind/bin/dig/dighost.c","append_textname",3523,3541
6,2,36,2,5,"idn_check_result@3544-3549@usr.sbin/bind/bin/dig/dighost.c","usr.sbin/bind/bin/dig/dighost.c","idn_check_result",3544,3549
14,1,88,1,18,"print_type@3554-3572@usr.sbin/bind/bin/dig/dighost.c","usr.sbin/bind/bin/dig/dighost.c","print_type",3554,3572
16,3,102,2,18,"dump_database_section@3575-3593@usr.sbin/bind/bin/dig/dighost.c","usr.sbin/bind/bin/dig/dighost.c","dump_database_section",3575,3593
15,5,100,1,17,"dump_database@3596-3613@usr.sbin/bind/bin/dig/dighost.c","usr.sbin/bind/bin/dig/dighost.c","dump_database",3596,3613
31,9,207,3,32,"search_type@3617-3649@usr.sbin/bind/bin/dig/dighost.c","usr.sbin/bind/bin/dig/dighost.c","search_type",3617,3649
17,4,100,5,18,"chase_scanname_section@3652-3670@usr.sbin/bind/bin/dig/dighost.c","usr.sbin/bind/bin/dig/dighost.c","chase_scanname_section",3652,3670
32,8,176,3,33,"chase_scanname@3674-3707@usr.sbin/bind/bin/dig/dighost.c","usr.sbin/bind/bin/dig/dighost.c","chase_scanname",3674,3707
43,6,275,4,50,"sigchase_scanname@3710-3760@usr.sbin/bind/bin/dig/dighost.c","usr.sbin/bind/bin/dig/dighost.c","sigchase_scanname",3710,3760
9,3,40,1,9,"insert_trustedkey@3763-3772@usr.sbin/bind/bin/dig/dighost.c","usr.sbin/bind/bin/dig/dighost.c","insert_trustedkey",3763,3772
13,3,69,0,13,"clean_trustedkey@3775-3788@usr.sbin/bind/bin/dig/dighost.c","usr.sbin/bind/bin/dig/dighost.c","clean_trustedkey",3775,3788
17,2,105,2,22,"removetmpkey@3794-3816@usr.sbin/bind/bin/dig/dighost.c","usr.sbin/bind/bin/dig/dighost.c","removetmpkey",3794,3816
59,11,348,4,69,"opentmpkey@3819-3888@usr.sbin/bind/bin/dig/dighost.c","usr.sbin/bind/bin/dig/dighost.c","opentmpkey",3819,3888
56,11,306,1,60,"get_trusted_key@3892-3952@usr.sbin/bind/bin/dig/dighost.c","usr.sbin/bind/bin/dig/dighost.c","get_trusted_key",3892,3952
18,2,131,2,22,"nameFromString@3956-3978@usr.sbin/bind/bin/dig/dighost.c","usr.sbin/bind/bin/dig/dighost.c","nameFromString",3956,3978
104,9,704,1,138,"prepare_lookup@3983-4121@usr.sbin/bind/bin/dig/dighost.c","usr.sbin/bind/bin/dig/dighost.c","prepare_lookup",3983,4121
23,3,126,3,24,"child_of_zone@4125-4149@usr.sbin/bind/bin/dig/dighost.c","usr.sbin/bind/bin/dig/dighost.c","child_of_zone",4125,4149
22,3,132,2,29,"grandfather_pb_test@4152-4181@usr.sbin/bind/bin/dig/dighost.c","usr.sbin/bind/bin/dig/dighost.c","grandfather_pb_test",4152,4181
17,2,83,1,19,"initialization@4185-4204@usr.sbin/bind/bin/dig/dighost.c","usr.sbin/bind/bin/dig/dighost.c","initialization",4185,4204
13,1,90,3,18,"print_rdataset@4208-4226@usr.sbin/bind/bin/dig/dighost.c","usr.sbin/bind/bin/dig/dighost.c","print_rdataset",4208,4226
7,2,51,3,7,"dup_name@4230-4237@usr.sbin/bind/bin/dig/dighost.c","usr.sbin/bind/bin/dig/dighost.c","dup_name",4230,4237
4,1,26,2,3,"free_name@4240-4243@usr.sbin/bind/bin/dig/dighost.c","usr.sbin/bind/bin/dig/dighost.c","free_name",4240,4243
47,9,253,4,56,"contains_trusted_key@4256-4312@usr.sbin/bind/bin/dig/dighost.c","usr.sbin/bind/bin/dig/dighost.c","contains_trusted_key",4256,4312
29,3,165,5,34,"sigchase_verify_sig@4315-4349@usr.sbin/bind/bin/dig/dighost.c","usr.sbin/bind/bin/dig/dighost.c","sigchase_verify_sig",4315,4349
35,4,214,5,49,"sigchase_verify_sig_key@4352-4401@usr.sbin/bind/bin/dig/dighost.c","usr.sbin/bind/bin/dig/dighost.c","sigchase_verify_sig_key",4352,4401
75,8,397,4,95,"sigchase_verify_ds@4405-4500@usr.sbin/bind/bin/dig/dighost.c","usr.sbin/bind/bin/dig/dighost.c","sigchase_verify_ds",4405,4500
18,4,95,5,20,"advanced_rrsearch@4514-4534@usr.sbin/bind/bin/dig/dighost.c","usr.sbin/bind/bin/dig/dighost.c","advanced_rrsearch",4514,4534
302,42,1277,1,338,"sigchase_td@4540-4878@usr.sbin/bind/bin/dig/dighost.c","usr.sbin/bind/bin/dig/dighost.c","sigchase_td",4540,4878
137,23,714,1,159,"getneededrr@4886-5045@usr.sbin/bind/bin/dig/dighost.c","usr.sbin/bind/bin/dig/dighost.c","getneededrr",4886,5045
118,13,558,1,136,"sigchase_bu@5050-5186@usr.sbin/bind/bin/dig/dighost.c","usr.sbin/bind/bin/dig/dighost.c","sigchase_bu",5050,5186
8,4,30,1,11,"sigchase@5190-5201@usr.sbin/bind/bin/dig/dighost.c","usr.sbin/bind/bin/dig/dighost.c","sigchase",5190,5201
32,8,182,2,36,"inf_name@5211-5247@usr.sbin/bind/bin/dig/dighost.c","usr.sbin/bind/bin/dig/dighost.c","inf_name",5211,5247
65,10,342,5,75,"prove_nx_domain@5255-5330@usr.sbin/bind/bin/dig/dighost.c","usr.sbin/bind/bin/dig/dighost.c","prove_nx_domain",5255,5330
28,3,151,8,33,"prove_nx_type@5340-5373@usr.sbin/bind/bin/dig/dighost.c","usr.sbin/bind/bin/dig/dighost.c","prove_nx_type",5340,5373
37,4,184,7,40,"prove_nx@5382-5422@usr.sbin/bind/bin/dig/dighost.c","usr.sbin/bind/bin/dig/dighost.c","prove_nx",5382,5422
24,1,37,1,23,"show_usage@129-152@usr.sbin/bind/bin/dig/host.c","usr.sbin/bind/bin/dig/host.c","show_usage",129,152
3,1,10,1,2,"dighost_shutdown@155-157@usr.sbin/bind/bin/dig/host.c","usr.sbin/bind/bin/dig/host.c","dighost_shutdown",155,157
12,2,81,3,12,"received@160-172@usr.sbin/bind/bin/dig/host.c","usr.sbin/bind/bin/dig/host.c","received",160,172
5,2,29,2,5,"trying@175-180@usr.sbin/bind/bin/dig/host.c","usr.sbin/bind/bin/dig/host.c","trying",175,180
32,4,198,4,32,"say_message@183-215@usr.sbin/bind/bin/dig/host.c","usr.sbin/bind/bin/dig/host.c","say_message",183,215
8,1,36,3,7,"printrdataset@219-226@usr.sbin/bind/bin/dig/host.c","usr.sbin/bind/bin/dig/host.c","printrdataset",219,226
104,27,557,5,117,"printsection@229-346@usr.sbin/bind/bin/dig/host.c","usr.sbin/bind/bin/dig/host.c","printsection",229,346
19,3,129,5,22,"printrdata@349-371@usr.sbin/bind/bin/dig/host.c","usr.sbin/bind/bin/dig/host.c","printrdata",349,371
23,3,145,2,23,"chase_cnamechain@374-397@usr.sbin/bind/bin/dig/host.c","usr.sbin/bind/bin/dig/host.c","chase_cnamechain",374,397
161,45,1075,3,174,"printmessage@400-574@usr.sbin/bind/bin/dig/host.c","usr.sbin/bind/bin/dig/host.c","printmessage",400,574
41,25,206,2,42,"pre_parse_args@579-621@usr.sbin/bind/bin/dig/host.c","usr.sbin/bind/bin/dig/host.c","pre_parse_args",579,621
179,43,875,3,201,"parse_args@624-825@usr.sbin/bind/bin/dig/host.c","usr.sbin/bind/bin/dig/host.c","parse_args",624,825
32,5,187,2,40,"main@828-868@usr.sbin/bind/bin/dig/host.c","usr.sbin/bind/bin/dig/host.c","main",828,868
10,2,42,1,12,"dighost_shutdown@136-148@usr.sbin/bind/bin/dig/nslookup.c","usr.sbin/bind/bin/dig/nslookup.c","dighost_shutdown",136,148
17,1,134,1,18,"printsoa@151-169@usr.sbin/bind/bin/dig/nslookup.c","usr.sbin/bind/bin/dig/nslookup.c","printsoa",151,169
10,1,79,1,10,"printa@172-182@usr.sbin/bind/bin/dig/nslookup.c","usr.sbin/bind/bin/dig/nslookup.c","printa",172,182
8,1,36,3,7,"printrdataset@186-193@usr.sbin/bind/bin/dig/nslookup.c","usr.sbin/bind/bin/dig/nslookup.c","printrdataset",186,193
24,6,159,1,25,"printrdata@196-221@usr.sbin/bind/bin/dig/nslookup.c","usr.sbin/bind/bin/dig/nslookup.c","printrdata",196,221
61,11,318,4,63,"printsection@224-287@usr.sbin/bind/bin/dig/nslookup.c","usr.sbin/bind/bin/dig/nslookup.c","printsection",224,287
77,15,377,4,82,"detailsection@290-372@usr.sbin/bind/bin/dig/nslookup.c","usr.sbin/bind/bin/dig/nslookup.c","detailsection",290,372
6,1,30,3,5,"received@375-380@usr.sbin/bind/bin/dig/nslookup.c","usr.sbin/bind/bin/dig/nslookup.c","received",375,380
4,1,22,2,4,"trying@383-387@usr.sbin/bind/bin/dig/nslookup.c","usr.sbin/bind/bin/dig/nslookup.c","trying",383,387
43,8,309,3,50,"printmessage@390-440@usr.sbin/bind/bin/dig/nslookup.c","usr.sbin/bind/bin/dig/nslookup.c","printmessage",390,440
40,12,239,2,43,"show_settings@443-486@usr.sbin/bind/bin/dig/nslookup.c","usr.sbin/bind/bin/dig/nslookup.c","show_settings",443,486
14,2,69,1,14,"testtype@489-503@usr.sbin/bind/bin/dig/nslookup.c","usr.sbin/bind/bin/dig/nslookup.c","testtype",489,503
14,2,69,1,14,"testclass@506-520@usr.sbin/bind/bin/dig/nslookup.c","usr.sbin/bind/bin/dig/nslookup.c","testclass",506,520
3,1,24,3,2,"safecpy@523-525@usr.sbin/bind/bin/dig/nslookup.c","usr.sbin/bind/bin/dig/nslookup.c","safecpy",523,525
14,4,86,4,13,"parse_uint@528-541@usr.sbin/bind/bin/dig/nslookup.c","usr.sbin/bind/bin/dig/nslookup.c","parse_uint",528,541
7,2,42,1,6,"set_port@544-550@usr.sbin/bind/bin/dig/nslookup.c","usr.sbin/bind/bin/dig/nslookup.c","set_port",544,550
6,2,37,1,5,"set_timeout@553-558@usr.sbin/bind/bin/dig/nslookup.c","usr.sbin/bind/bin/dig/nslookup.c","set_timeout",553,558
6,2,37,1,5,"set_tries@561-566@usr.sbin/bind/bin/dig/nslookup.c","usr.sbin/bind/bin/dig/nslookup.c","set_tries",561,566
82,41,920,1,82,"setoption@569-651@usr.sbin/bind/bin/dig/nslookup.c","usr.sbin/bind/bin/dig/nslookup.c","setoption",569,651
60,5,379,1,60,"addlookup@654-714@usr.sbin/bind/bin/dig/nslookup.c","usr.sbin/bind/bin/dig/nslookup.c","addlookup",654,714
50,15,320,1,50,"get_next_command@717-767@usr.sbin/bind/bin/dig/nslookup.c","usr.sbin/bind/bin/dig/nslookup.c","get_next_command",717,767
22,5,134,2,22,"parse_args@770-792@usr.sbin/bind/bin/dig/nslookup.c","usr.sbin/bind/bin/dig/nslookup.c","parse_args",770,792
44,9,300,1,45,"flush_lookup_list@795-840@usr.sbin/bind/bin/dig/nslookup.c","usr.sbin/bind/bin/dig/nslookup.c","flush_lookup_list",795,840
13,4,58,2,12,"getinput@843-855@usr.sbin/bind/bin/dig/nslookup.c","usr.sbin/bind/bin/dig/nslookup.c","getinput",843,855
39,6,222,2,49,"main@858-907@usr.sbin/bind/bin/dig/nslookup.c","usr.sbin/bind/bin/dig/nslookup.c","main",858,907
5,1,36,4,4,"freekey@54-58@usr.sbin/bind/lib/bind9/check.c","usr.sbin/bind/lib/bind9/check.c","freekey",54,58
72,14,466,2,80,"check_orderent@61-141@usr.sbin/bind/lib/bind9/check.c","usr.sbin/bind/lib/bind9/check.c","check_orderent",61,141
17,4,101,2,18,"check_order@144-162@usr.sbin/bind/lib/bind9/check.c","usr.sbin/bind/lib/bind9/check.c","check_order",144,162
55,9,331,2,57,"check_dual_stack@165-222@usr.sbin/bind/lib/bind9/check.c","usr.sbin/bind/lib/bind9/check.c","check_dual_stack",165,222
12,3,86,2,13,"check_forward@225-238@usr.sbin/bind/lib/bind9/check.c","usr.sbin/bind/lib/bind9/check.c","check_forward",225,238
45,5,278,2,49,"disabled_algorithms@241-290@usr.sbin/bind/lib/bind9/check.c","usr.sbin/bind/lib/bind9/check.c","disabled_algorithms",241,290
30,5,196,7,31,"nameexist@293-324@usr.sbin/bind/lib/bind9/check.c","usr.sbin/bind/lib/bind9/check.c","nameexist",293,324
29,2,183,4,29,"mustbesecure@327-356@usr.sbin/bind/lib/bind9/check.c","usr.sbin/bind/lib/bind9/check.c","mustbesecure",327,356
27,9,192,7,27,"checkacl@359-386@usr.sbin/bind/lib/bind9/check.c","usr.sbin/bind/lib/bind9/check.c","checkacl",359,386
16,3,113,5,17,"check_viewacls@389-406@usr.sbin/bind/lib/bind9/check.c","usr.sbin/bind/lib/bind9/check.c","check_viewacls",389,406
225,39,1460,3,257,"check_options@415-672@usr.sbin/bind/lib/bind9/check.c","usr.sbin/bind/lib/bind9/check.c","check_options",415,672
21,4,136,3,23,"get_masters_def@675-698@usr.sbin/bind/lib/bind9/check.c","usr.sbin/bind/lib/bind9/check.c","get_masters_def",675,698
88,14,491,5,93,"validate_masters@701-794@usr.sbin/bind/lib/bind9/check.c","usr.sbin/bind/lib/bind9/check.c","validate_masters",701,794
66,9,439,2,71,"check_update_policy@797-868@usr.sbin/bind/lib/bind9/check.c","usr.sbin/bind/lib/bind9/check.c","check_update_policy",797,868
252,52,1676,8,299,"check_zoneconf@884-1183@usr.sbin/bind/lib/bind9/check.c","usr.sbin/bind/lib/bind9/check.c","check_zoneconf",884,1183
75,17,490,2,79,"bind9_check_key@1192-1271@usr.sbin/bind/lib/bind9/check.c","usr.sbin/bind/lib/bind9/check.c","bind9_check_key",1192,1271
36,6,220,3,40,"check_keylist@1274-1314@usr.sbin/bind/lib/bind9/check.c","usr.sbin/bind/lib/bind9/check.c","check_keylist",1274,1314
59,10,400,2,64,"check_servers@1327-1391@usr.sbin/bind/lib/bind9/check.c","usr.sbin/bind/lib/bind9/check.c","check_servers",1327,1391
120,35,787,5,159,"check_viewconf@1394-1553@usr.sbin/bind/lib/bind9/check.c","usr.sbin/bind/lib/bind9/check.c","check_viewconf",1394,1553
99,16,599,3,105,"bind9_check_logging@1565-1670@usr.sbin/bind/lib/bind9/check.c","usr.sbin/bind/lib/bind9/check.c","bind9_check_logging",1565,1670
17,4,100,2,17,"key_exists@1673-1690@usr.sbin/bind/lib/bind9/check.c","usr.sbin/bind/lib/bind9/check.c","key_exists",1673,1690
24,4,135,3,25,"bind9_check_controlskeys@1693-1718@usr.sbin/bind/lib/bind9/check.c","usr.sbin/bind/lib/bind9/check.c","bind9_check_controlskeys",1693,1718
84,15,520,3,94,"bind9_check_controls@1721-1815@usr.sbin/bind/lib/bind9/check.c","usr.sbin/bind/lib/bind9/check.c","bind9_check_controls",1721,1815
198,45,1241,3,225,"bind9_check_namedconf@1818-2043@usr.sbin/bind/lib/bind9/check.c","usr.sbin/bind/lib/bind9/check.c","bind9_check_namedconf",1818,2043
132,41,806,5,181,"bind9_getaddresses@50-231@usr.sbin/bind/lib/bind9/getaddresses.c","usr.sbin/bind/lib/bind9/getaddresses.c","bind9_getaddresses",50,231
64,12,523,1,101,"fromtext_any_tsig@29-130@usr.sbin/bind/lib/dns/rdata/any_255/tsig_250.c","usr.sbin/bind/lib/dns/rdata/any_255/tsig_250.c","fromtext_any_tsig",29,130
76,5,666,1,112,"totext_any_tsig@133-245@usr.sbin/bind/lib/dns/rdata/any_255/tsig_250.c","usr.sbin/bind/lib/dns/rdata/any_255/tsig_250.c","totext_any_tsig",133,245
38,7,296,1,60,"fromwire_any_tsig@248-308@usr.sbin/bind/lib/dns/rdata/any_255/tsig_250.c","usr.sbin/bind/lib/dns/rdata/any_255/tsig_250.c","fromwire_any_tsig",248,308
15,1,115,1,16,"towire_any_tsig@311-327@usr.sbin/bind/lib/dns/rdata/any_255/tsig_250.c","usr.sbin/bind/lib/dns/rdata/any_255/tsig_250.c","towire_any_tsig",311,327
25,2,187,1,26,"compare_any_tsig@330-356@usr.sbin/bind/lib/dns/rdata/any_255/tsig_250.c","usr.sbin/bind/lib/dns/rdata/any_255/tsig_250.c","compare_any_tsig",330,356
29,3,262,1,68,"fromstruct_any_tsig@359-427@usr.sbin/bind/lib/dns/rdata/any_255/tsig_250.c","usr.sbin/bind/lib/dns/rdata/any_255/tsig_250.c","fromstruct_any_tsig",359,427
53,6,487,1,94,"tostruct_any_tsig@430-524@usr.sbin/bind/lib/dns/rdata/any_255/tsig_250.c","usr.sbin/bind/lib/dns/rdata/any_255/tsig_250.c","tostruct_any_tsig",430,524
14,4,111,1,16,"freestruct_any_tsig@527-543@usr.sbin/bind/lib/dns/rdata/any_255/tsig_250.c","usr.sbin/bind/lib/dns/rdata/any_255/tsig_250.c","freestruct_any_tsig",527,543
8,1,44,1,9,"additionaldata_any_tsig@546-555@usr.sbin/bind/lib/dns/rdata/any_255/tsig_250.c","usr.sbin/bind/lib/dns/rdata/any_255/tsig_250.c","additionaldata_any_tsig",546,555
8,1,44,1,10,"digest_any_tsig@558-568@usr.sbin/bind/lib/dns/rdata/any_255/tsig_250.c","usr.sbin/bind/lib/dns/rdata/any_255/tsig_250.c","digest_any_tsig",558,568
9,1,45,1,11,"checkowner_any_tsig@571-582@usr.sbin/bind/lib/dns/rdata/any_255/tsig_250.c","usr.sbin/bind/lib/dns/rdata/any_255/tsig_250.c","checkowner_any_tsig",571,582
8,1,44,1,10,"checknames_any_tsig@585-595@usr.sbin/bind/lib/dns/rdata/any_255/tsig_250.c","usr.sbin/bind/lib/dns/rdata/any_255/tsig_250.c","checknames_any_tsig",585,595
28,9,217,1,34,"fromtext_ch_a@30-64@usr.sbin/bind/lib/dns/rdata/ch_3/a_1.c","usr.sbin/bind/lib/dns/rdata/ch_3/a_1.c","fromtext_ch_a",30,64
22,1,172,1,26,"totext_ch_a@67-93@usr.sbin/bind/lib/dns/rdata/ch_3/a_1.c","usr.sbin/bind/lib/dns/rdata/ch_3/a_1.c","totext_ch_a",67,93
22,3,145,1,29,"fromwire_ch_a@96-125@usr.sbin/bind/lib/dns/rdata/ch_3/a_1.c","usr.sbin/bind/lib/dns/rdata/ch_3/a_1.c","fromwire_ch_a",96,125
21,2,148,1,27,"towire_ch_a@128-155@usr.sbin/bind/lib/dns/rdata/ch_3/a_1.c","usr.sbin/bind/lib/dns/rdata/ch_3/a_1.c","towire_ch_a",128,155
28,4,214,1,33,"compare_ch_a@158-191@usr.sbin/bind/lib/dns/rdata/ch_3/a_1.c","usr.sbin/bind/lib/dns/rdata/ch_3/a_1.c","compare_ch_a",158,191
13,1,98,1,16,"fromstruct_ch_a@194-210@usr.sbin/bind/lib/dns/rdata/ch_3/a_1.c","usr.sbin/bind/lib/dns/rdata/ch_3/a_1.c","fromstruct_ch_a",194,210
20,1,162,1,24,"tostruct_ch_a@213-237@usr.sbin/bind/lib/dns/rdata/ch_3/a_1.c","usr.sbin/bind/lib/dns/rdata/ch_3/a_1.c","tostruct_ch_a",213,237
9,2,58,1,11,"freestruct_ch_a@240-251@usr.sbin/bind/lib/dns/rdata/ch_3/a_1.c","usr.sbin/bind/lib/dns/rdata/ch_3/a_1.c","freestruct_ch_a",240,251
8,1,44,1,10,"additionaldata_ch_a@254-264@usr.sbin/bind/lib/dns/rdata/ch_3/a_1.c","usr.sbin/bind/lib/dns/rdata/ch_3/a_1.c","additionaldata_ch_a",254,264
12,1,93,1,14,"digest_ch_a@267-281@usr.sbin/bind/lib/dns/rdata/ch_3/a_1.c","usr.sbin/bind/lib/dns/rdata/ch_3/a_1.c","digest_ch_a",267,281
6,1,35,1,8,"checkowner_ch_a@284-292@usr.sbin/bind/lib/dns/rdata/ch_3/a_1.c","usr.sbin/bind/lib/dns/rdata/ch_3/a_1.c","checkowner_ch_a",284,292
16,3,97,1,19,"checknames_ch_a@295-314@usr.sbin/bind/lib/dns/rdata/ch_3/a_1.c","usr.sbin/bind/lib/dns/rdata/ch_3/a_1.c","checknames_ch_a",295,314
29,8,216,1,38,"fromtext_afsdb@30-68@usr.sbin/bind/lib/dns/rdata/generic/afsdb_18.c","usr.sbin/bind/lib/dns/rdata/generic/afsdb_18.c","fromtext_afsdb",30,68
20,1,150,1,22,"totext_afsdb@71-93@usr.sbin/bind/lib/dns/rdata/generic/afsdb_18.c","usr.sbin/bind/lib/dns/rdata/generic/afsdb_18.c","totext_afsdb",71,93
20,3,133,1,24,"fromwire_afsdb@96-120@usr.sbin/bind/lib/dns/rdata/generic/afsdb_18.c","usr.sbin/bind/lib/dns/rdata/generic/afsdb_18.c","fromwire_afsdb",96,120
19,2,130,1,22,"towire_afsdb@123-145@usr.sbin/bind/lib/dns/rdata/generic/afsdb_18.c","usr.sbin/bind/lib/dns/rdata/generic/afsdb_18.c","towire_afsdb",123,145
24,3,181,1,30,"compare_afsdb@148-178@usr.sbin/bind/lib/dns/rdata/generic/afsdb_18.c","usr.sbin/bind/lib/dns/rdata/generic/afsdb_18.c","compare_afsdb",148,178
13,1,95,1,15,"fromstruct_afsdb@181-196@usr.sbin/bind/lib/dns/rdata/generic/afsdb_18.c","usr.sbin/bind/lib/dns/rdata/generic/afsdb_18.c","fromstruct_afsdb",181,196
20,1,153,1,26,"tostruct_afsdb@199-225@usr.sbin/bind/lib/dns/rdata/generic/afsdb_18.c","usr.sbin/bind/lib/dns/rdata/generic/afsdb_18.c","tostruct_afsdb",199,225
9,2,58,1,11,"freestruct_afsdb@228-239@usr.sbin/bind/lib/dns/rdata/generic/afsdb_18.c","usr.sbin/bind/lib/dns/rdata/generic/afsdb_18.c","freestruct_afsdb",228,239
11,1,72,1,13,"additionaldata_afsdb@242-255@usr.sbin/bind/lib/dns/rdata/generic/afsdb_18.c","usr.sbin/bind/lib/dns/rdata/generic/afsdb_18.c","additionaldata_afsdb",242,255
13,1,92,1,15,"digest_afsdb@258-273@usr.sbin/bind/lib/dns/rdata/generic/afsdb_18.c","usr.sbin/bind/lib/dns/rdata/generic/afsdb_18.c","digest_afsdb",258,273
8,1,38,1,10,"checkowner_afsdb@276-286@usr.sbin/bind/lib/dns/rdata/generic/afsdb_18.c","usr.sbin/bind/lib/dns/rdata/generic/afsdb_18.c","checkowner_afsdb",276,286
16,3,96,1,18,"checknames_afsdb@289-307@usr.sbin/bind/lib/dns/rdata/generic/afsdb_18.c","usr.sbin/bind/lib/dns/rdata/generic/afsdb_18.c","checknames_afsdb",289,307
25,2,189,1,39,"fromtext_cert@30-69@usr.sbin/bind/lib/dns/rdata/generic/cert_37.c","usr.sbin/bind/lib/dns/rdata/generic/cert_37.c","fromtext_cert",30,69
27,3,237,1,45,"totext_cert@72-117@usr.sbin/bind/lib/dns/rdata/generic/cert_37.c","usr.sbin/bind/lib/dns/rdata/generic/cert_37.c","totext_cert",72,117
13,2,82,1,16,"fromwire_cert@120-136@usr.sbin/bind/lib/dns/rdata/generic/cert_37.c","usr.sbin/bind/lib/dns/rdata/generic/cert_37.c","fromwire_cert",120,136
8,1,56,1,10,"towire_cert@139-149@usr.sbin/bind/lib/dns/rdata/generic/cert_37.c","usr.sbin/bind/lib/dns/rdata/generic/cert_37.c","towire_cert",139,149
12,1,89,1,13,"compare_cert@152-165@usr.sbin/bind/lib/dns/rdata/generic/cert_37.c","usr.sbin/bind/lib/dns/rdata/generic/cert_37.c","compare_cert",152,165
13,1,110,1,16,"fromstruct_cert@168-184@usr.sbin/bind/lib/dns/rdata/generic/cert_37.c","usr.sbin/bind/lib/dns/rdata/generic/cert_37.c","fromstruct_cert",168,184
23,2,181,1,28,"tostruct_cert@187-215@usr.sbin/bind/lib/dns/rdata/generic/cert_37.c","usr.sbin/bind/lib/dns/rdata/generic/cert_37.c","tostruct_cert",187,215
10,3,65,1,12,"freestruct_cert@218-230@usr.sbin/bind/lib/dns/rdata/generic/cert_37.c","usr.sbin/bind/lib/dns/rdata/generic/cert_37.c","freestruct_cert",218,230
7,1,35,1,8,"additionaldata_cert@233-241@usr.sbin/bind/lib/dns/rdata/generic/cert_37.c","usr.sbin/bind/lib/dns/rdata/generic/cert_37.c","additionaldata_cert",233,241
6,1,39,1,8,"digest_cert@244-252@usr.sbin/bind/lib/dns/rdata/generic/cert_37.c","usr.sbin/bind/lib/dns/rdata/generic/cert_37.c","digest_cert",244,252
8,1,38,1,10,"checkowner_cert@255-265@usr.sbin/bind/lib/dns/rdata/generic/cert_37.c","usr.sbin/bind/lib/dns/rdata/generic/cert_37.c","checkowner_cert",255,265
7,1,35,1,9,"checknames_cert@268-277@usr.sbin/bind/lib/dns/rdata/generic/cert_37.c","usr.sbin/bind/lib/dns/rdata/generic/cert_37.c","checknames_cert",268,277
16,2,108,1,19,"fromtext_cname@29-48@usr.sbin/bind/lib/dns/rdata/generic/cname_5.c","usr.sbin/bind/lib/dns/rdata/generic/cname_5.c","fromtext_cname",29,48
14,1,97,1,18,"totext_cname@51-69@usr.sbin/bind/lib/dns/rdata/generic/cname_5.c","usr.sbin/bind/lib/dns/rdata/generic/cname_5.c","totext_cname",51,69
9,1,58,1,12,"fromwire_cname@72-84@usr.sbin/bind/lib/dns/rdata/generic/cname_5.c","usr.sbin/bind/lib/dns/rdata/generic/cname_5.c","fromwire_cname",72,84
12,1,78,1,15,"towire_cname@87-102@usr.sbin/bind/lib/dns/rdata/generic/cname_5.c","usr.sbin/bind/lib/dns/rdata/generic/cname_5.c","towire_cname",87,102
18,1,129,1,22,"compare_cname@105-127@usr.sbin/bind/lib/dns/rdata/generic/cname_5.c","usr.sbin/bind/lib/dns/rdata/generic/cname_5.c","compare_cname",105,127
12,1,83,1,14,"fromstruct_cname@130-144@usr.sbin/bind/lib/dns/rdata/generic/cname_5.c","usr.sbin/bind/lib/dns/rdata/generic/cname_5.c","fromstruct_cname",130,144
18,1,135,1,20,"tostruct_cname@147-167@usr.sbin/bind/lib/dns/rdata/generic/cname_5.c","usr.sbin/bind/lib/dns/rdata/generic/cname_5.c","tostruct_cname",147,167
8,2,47,1,10,"freestruct_cname@170-180@usr.sbin/bind/lib/dns/rdata/generic/cname_5.c","usr.sbin/bind/lib/dns/rdata/generic/cname_5.c","freestruct_cname",170,180
7,1,35,1,8,"additionaldata_cname@183-191@usr.sbin/bind/lib/dns/rdata/generic/cname_5.c","usr.sbin/bind/lib/dns/rdata/generic/cname_5.c","additionaldata_cname",183,191
9,1,59,1,11,"digest_cname@194-205@usr.sbin/bind/lib/dns/rdata/generic/cname_5.c","usr.sbin/bind/lib/dns/rdata/generic/cname_5.c","digest_cname",194,205
8,1,38,1,10,"checkowner_cname@208-218@usr.sbin/bind/lib/dns/rdata/generic/cname_5.c","usr.sbin/bind/lib/dns/rdata/generic/cname_5.c","checkowner_cname",208,218
7,1,35,1,9,"checknames_cname@221-230@usr.sbin/bind/lib/dns/rdata/generic/cname_5.c","usr.sbin/bind/lib/dns/rdata/generic/cname_5.c","checknames_cname",221,230
34,6,232,1,51,"fromtext_dlv@33-84@usr.sbin/bind/lib/dns/rdata/generic/dlv_32769.c","usr.sbin/bind/lib/dns/rdata/generic/dlv_32769.c","fromtext_dlv",33,84
28,3,255,1,46,"totext_dlv@87-133@usr.sbin/bind/lib/dns/rdata/generic/dlv_32769.c","usr.sbin/bind/lib/dns/rdata/generic/dlv_32769.c","totext_dlv",87,133
21,8,159,1,34,"fromwire_dlv@136-170@usr.sbin/bind/lib/dns/rdata/generic/dlv_32769.c","usr.sbin/bind/lib/dns/rdata/generic/dlv_32769.c","fromwire_dlv",136,170
8,1,56,1,10,"towire_dlv@173-183@usr.sbin/bind/lib/dns/rdata/generic/dlv_32769.c","usr.sbin/bind/lib/dns/rdata/generic/dlv_32769.c","towire_dlv",173,183
12,1,89,1,13,"compare_dlv@186-199@usr.sbin/bind/lib/dns/rdata/generic/dlv_32769.c","usr.sbin/bind/lib/dns/rdata/generic/dlv_32769.c","compare_dlv",186,199
21,3,146,1,24,"fromstruct_dlv@202-226@usr.sbin/bind/lib/dns/rdata/generic/dlv_32769.c","usr.sbin/bind/lib/dns/rdata/generic/dlv_32769.c","fromstruct_dlv",202,226
23,2,181,1,28,"tostruct_dlv@229-257@usr.sbin/bind/lib/dns/rdata/generic/dlv_32769.c","usr.sbin/bind/lib/dns/rdata/generic/dlv_32769.c","tostruct_dlv",229,257
10,3,65,1,12,"freestruct_dlv@260-272@usr.sbin/bind/lib/dns/rdata/generic/dlv_32769.c","usr.sbin/bind/lib/dns/rdata/generic/dlv_32769.c","freestruct_dlv",260,272
7,1,35,1,8,"additionaldata_dlv@275-283@usr.sbin/bind/lib/dns/rdata/generic/dlv_32769.c","usr.sbin/bind/lib/dns/rdata/generic/dlv_32769.c","additionaldata_dlv",275,283
6,1,39,1,8,"digest_dlv@286-294@usr.sbin/bind/lib/dns/rdata/generic/dlv_32769.c","usr.sbin/bind/lib/dns/rdata/generic/dlv_32769.c","digest_dlv",286,294
8,1,38,1,10,"checkowner_dlv@297-307@usr.sbin/bind/lib/dns/rdata/generic/dlv_32769.c","usr.sbin/bind/lib/dns/rdata/generic/dlv_32769.c","checkowner_dlv",297,307
7,1,35,1,9,"checknames_dlv@310-319@usr.sbin/bind/lib/dns/rdata/generic/dlv_32769.c","usr.sbin/bind/lib/dns/rdata/generic/dlv_32769.c","checknames_dlv",310,319
16,2,108,1,19,"fromtext_dname@30-49@usr.sbin/bind/lib/dns/rdata/generic/dname_39.c","usr.sbin/bind/lib/dns/rdata/generic/dname_39.c","fromtext_dname",30,49
14,1,97,1,18,"totext_dname@52-70@usr.sbin/bind/lib/dns/rdata/generic/dname_39.c","usr.sbin/bind/lib/dns/rdata/generic/dname_39.c","totext_dname",52,70
9,1,58,1,12,"fromwire_dname@73-85@usr.sbin/bind/lib/dns/rdata/generic/dname_39.c","usr.sbin/bind/lib/dns/rdata/generic/dname_39.c","fromwire_dname",73,85
12,1,78,1,14,"towire_dname@88-102@usr.sbin/bind/lib/dns/rdata/generic/dname_39.c","usr.sbin/bind/lib/dns/rdata/generic/dname_39.c","towire_dname",88,102
18,1,129,1,22,"compare_dname@105-127@usr.sbin/bind/lib/dns/rdata/generic/dname_39.c","usr.sbin/bind/lib/dns/rdata/generic/dname_39.c","compare_dname",105,127
12,1,83,1,14,"fromstruct_dname@130-144@usr.sbin/bind/lib/dns/rdata/generic/dname_39.c","usr.sbin/bind/lib/dns/rdata/generic/dname_39.c","fromstruct_dname",130,144
18,1,135,1,20,"tostruct_dname@147-167@usr.sbin/bind/lib/dns/rdata/generic/dname_39.c","usr.sbin/bind/lib/dns/rdata/generic/dname_39.c","tostruct_dname",147,167
9,2,58,1,11,"freestruct_dname@170-181@usr.sbin/bind/lib/dns/rdata/generic/dname_39.c","usr.sbin/bind/lib/dns/rdata/generic/dname_39.c","freestruct_dname",170,181
7,1,35,1,8,"additionaldata_dname@184-192@usr.sbin/bind/lib/dns/rdata/generic/dname_39.c","usr.sbin/bind/lib/dns/rdata/generic/dname_39.c","additionaldata_dname",184,192
9,1,59,1,11,"digest_dname@195-206@usr.sbin/bind/lib/dns/rdata/generic/dname_39.c","usr.sbin/bind/lib/dns/rdata/generic/dname_39.c","digest_dname",195,206
8,1,38,1,10,"checkowner_dname@209-219@usr.sbin/bind/lib/dns/rdata/generic/dname_39.c","usr.sbin/bind/lib/dns/rdata/generic/dname_39.c","checkowner_dname",209,219
7,1,35,1,9,"checknames_dname@222-231@usr.sbin/bind/lib/dns/rdata/generic/dname_39.c","usr.sbin/bind/lib/dns/rdata/generic/dname_39.c","checknames_dname",222,231
27,2,207,1,37,"fromtext_dnskey@34-71@usr.sbin/bind/lib/dns/rdata/generic/dnskey_48.c","usr.sbin/bind/lib/dns/rdata/generic/dnskey_48.c","fromtext_dnskey",34,71
43,7,399,1,58,"totext_dnskey@74-132@usr.sbin/bind/lib/dns/rdata/generic/dnskey_48.c","usr.sbin/bind/lib/dns/rdata/generic/dnskey_48.c","totext_dnskey",74,132
13,2,82,1,16,"fromwire_dnskey@135-151@usr.sbin/bind/lib/dns/rdata/generic/dnskey_48.c","usr.sbin/bind/lib/dns/rdata/generic/dnskey_48.c","fromwire_dnskey",135,151
8,1,56,1,10,"towire_dnskey@154-164@usr.sbin/bind/lib/dns/rdata/generic/dnskey_48.c","usr.sbin/bind/lib/dns/rdata/generic/dnskey_48.c","towire_dnskey",154,164
12,1,89,1,13,"compare_dnskey@167-180@usr.sbin/bind/lib/dns/rdata/generic/dnskey_48.c","usr.sbin/bind/lib/dns/rdata/generic/dnskey_48.c","compare_dnskey",167,180
13,1,110,1,22,"fromstruct_dnskey@183-205@usr.sbin/bind/lib/dns/rdata/generic/dnskey_48.c","usr.sbin/bind/lib/dns/rdata/generic/dnskey_48.c","fromstruct_dnskey",183,205
29,5,220,1,40,"tostruct_dnskey@208-248@usr.sbin/bind/lib/dns/rdata/generic/dnskey_48.c","usr.sbin/bind/lib/dns/rdata/generic/dnskey_48.c","tostruct_dnskey",208,248
10,3,69,1,12,"freestruct_dnskey@251-263@usr.sbin/bind/lib/dns/rdata/generic/dnskey_48.c","usr.sbin/bind/lib/dns/rdata/generic/dnskey_48.c","freestruct_dnskey",251,263
7,1,35,1,8,"additionaldata_dnskey@266-274@usr.sbin/bind/lib/dns/rdata/generic/dnskey_48.c","usr.sbin/bind/lib/dns/rdata/generic/dnskey_48.c","additionaldata_dnskey",266,274
6,1,39,1,8,"digest_dnskey@277-285@usr.sbin/bind/lib/dns/rdata/generic/dnskey_48.c","usr.sbin/bind/lib/dns/rdata/generic/dnskey_48.c","digest_dnskey",277,285
8,1,38,1,10,"checkowner_dnskey@288-298@usr.sbin/bind/lib/dns/rdata/generic/dnskey_48.c","usr.sbin/bind/lib/dns/rdata/generic/dnskey_48.c","checkowner_dnskey",288,298
7,1,35,1,9,"checknames_dnskey@301-310@usr.sbin/bind/lib/dns/rdata/generic/dnskey_48.c","usr.sbin/bind/lib/dns/rdata/generic/dnskey_48.c","checknames_dnskey",301,310
33,5,231,1,50,"fromtext_ds@34-84@usr.sbin/bind/lib/dns/rdata/generic/ds_43.c","usr.sbin/bind/lib/dns/rdata/generic/ds_43.c","fromtext_ds",34,84
28,3,255,1,46,"totext_ds@87-133@usr.sbin/bind/lib/dns/rdata/generic/ds_43.c","usr.sbin/bind/lib/dns/rdata/generic/ds_43.c","totext_ds",87,133
21,8,159,1,34,"fromwire_ds@136-170@usr.sbin/bind/lib/dns/rdata/generic/ds_43.c","usr.sbin/bind/lib/dns/rdata/generic/ds_43.c","fromwire_ds",136,170
8,1,56,1,10,"towire_ds@173-183@usr.sbin/bind/lib/dns/rdata/generic/ds_43.c","usr.sbin/bind/lib/dns/rdata/generic/ds_43.c","towire_ds",173,183
12,1,89,1,13,"compare_ds@186-199@usr.sbin/bind/lib/dns/rdata/generic/ds_43.c","usr.sbin/bind/lib/dns/rdata/generic/ds_43.c","compare_ds",186,199
21,3,146,1,24,"fromstruct_ds@202-226@usr.sbin/bind/lib/dns/rdata/generic/ds_43.c","usr.sbin/bind/lib/dns/rdata/generic/ds_43.c","fromstruct_ds",202,226
23,2,181,1,28,"tostruct_ds@229-257@usr.sbin/bind/lib/dns/rdata/generic/ds_43.c","usr.sbin/bind/lib/dns/rdata/generic/ds_43.c","tostruct_ds",229,257
10,3,65,1,12,"freestruct_ds@260-272@usr.sbin/bind/lib/dns/rdata/generic/ds_43.c","usr.sbin/bind/lib/dns/rdata/generic/ds_43.c","freestruct_ds",260,272
7,1,35,1,8,"additionaldata_ds@275-283@usr.sbin/bind/lib/dns/rdata/generic/ds_43.c","usr.sbin/bind/lib/dns/rdata/generic/ds_43.c","additionaldata_ds",275,283
6,1,39,1,8,"digest_ds@286-294@usr.sbin/bind/lib/dns/rdata/generic/ds_43.c","usr.sbin/bind/lib/dns/rdata/generic/ds_43.c","digest_ds",286,294
8,1,38,1,10,"checkowner_ds@297-307@usr.sbin/bind/lib/dns/rdata/generic/ds_43.c","usr.sbin/bind/lib/dns/rdata/generic/ds_43.c","checkowner_ds",297,307
7,1,35,1,9,"checknames_ds@310-319@usr.sbin/bind/lib/dns/rdata/generic/ds_43.c","usr.sbin/bind/lib/dns/rdata/generic/ds_43.c","checknames_ds",310,319
17,2,94,1,19,"fromtext_gpos@30-49@usr.sbin/bind/lib/dns/rdata/generic/gpos_27.c","usr.sbin/bind/lib/dns/rdata/generic/gpos_27.c","fromtext_gpos",30,49
14,3,90,1,18,"totext_gpos@52-70@usr.sbin/bind/lib/dns/rdata/generic/gpos_27.c","usr.sbin/bind/lib/dns/rdata/generic/gpos_27.c","totext_gpos",52,70
11,2,64,1,13,"fromwire_gpos@73-86@usr.sbin/bind/lib/dns/rdata/generic/gpos_27.c","usr.sbin/bind/lib/dns/rdata/generic/gpos_27.c","fromwire_gpos",73,86
6,1,45,1,8,"towire_gpos@89-97@usr.sbin/bind/lib/dns/rdata/generic/gpos_27.c","usr.sbin/bind/lib/dns/rdata/generic/gpos_27.c","towire_gpos",89,97
12,1,89,1,13,"compare_gpos@100-113@usr.sbin/bind/lib/dns/rdata/generic/gpos_27.c","usr.sbin/bind/lib/dns/rdata/generic/gpos_27.c","compare_gpos",100,113
15,1,142,1,17,"fromstruct_gpos@116-133@usr.sbin/bind/lib/dns/rdata/generic/gpos_27.c","usr.sbin/bind/lib/dns/rdata/generic/gpos_27.c","fromstruct_gpos",116,133
41,9,317,1,48,"tostruct_gpos@136-184@usr.sbin/bind/lib/dns/rdata/generic/gpos_27.c","usr.sbin/bind/lib/dns/rdata/generic/gpos_27.c","tostruct_gpos",136,184
14,5,103,1,16,"freestruct_gpos@187-203@usr.sbin/bind/lib/dns/rdata/generic/gpos_27.c","usr.sbin/bind/lib/dns/rdata/generic/gpos_27.c","freestruct_gpos",187,203
7,1,35,1,8,"additionaldata_gpos@206-214@usr.sbin/bind/lib/dns/rdata/generic/gpos_27.c","usr.sbin/bind/lib/dns/rdata/generic/gpos_27.c","additionaldata_gpos",206,214
6,1,39,1,8,"digest_gpos@217-225@usr.sbin/bind/lib/dns/rdata/generic/gpos_27.c","usr.sbin/bind/lib/dns/rdata/generic/gpos_27.c","digest_gpos",217,225
8,1,38,1,10,"checkowner_gpos@228-238@usr.sbin/bind/lib/dns/rdata/generic/gpos_27.c","usr.sbin/bind/lib/dns/rdata/generic/gpos_27.c","checkowner_gpos",228,238
7,1,35,1,9,"checknames_gpos@241-250@usr.sbin/bind/lib/dns/rdata/generic/gpos_27.c","usr.sbin/bind/lib/dns/rdata/generic/gpos_27.c","checknames_gpos",241,250
17,2,94,1,19,"fromtext_hinfo@30-49@usr.sbin/bind/lib/dns/rdata/generic/hinfo_13.c","usr.sbin/bind/lib/dns/rdata/generic/hinfo_13.c","fromtext_hinfo",30,49
10,1,72,1,12,"totext_hinfo@52-64@usr.sbin/bind/lib/dns/rdata/generic/hinfo_13.c","usr.sbin/bind/lib/dns/rdata/generic/hinfo_13.c","totext_hinfo",52,64
9,1,53,1,11,"fromwire_hinfo@67-78@usr.sbin/bind/lib/dns/rdata/generic/hinfo_13.c","usr.sbin/bind/lib/dns/rdata/generic/hinfo_13.c","fromwire_hinfo",67,78
6,1,45,1,8,"towire_hinfo@81-89@usr.sbin/bind/lib/dns/rdata/generic/hinfo_13.c","usr.sbin/bind/lib/dns/rdata/generic/hinfo_13.c","towire_hinfo",81,89
12,1,89,1,13,"compare_hinfo@92-105@usr.sbin/bind/lib/dns/rdata/generic/hinfo_13.c","usr.sbin/bind/lib/dns/rdata/generic/hinfo_13.c","compare_hinfo",92,105
13,1,114,1,15,"fromstruct_hinfo@108-123@usr.sbin/bind/lib/dns/rdata/generic/hinfo_13.c","usr.sbin/bind/lib/dns/rdata/generic/hinfo_13.c","fromstruct_hinfo",108,123
28,5,221,1,33,"tostruct_hinfo@126-159@usr.sbin/bind/lib/dns/rdata/generic/hinfo_13.c","usr.sbin/bind/lib/dns/rdata/generic/hinfo_13.c","tostruct_hinfo",126,159
11,4,73,1,13,"freestruct_hinfo@162-175@usr.sbin/bind/lib/dns/rdata/generic/hinfo_13.c","usr.sbin/bind/lib/dns/rdata/generic/hinfo_13.c","freestruct_hinfo",162,175
7,1,35,1,8,"additionaldata_hinfo@178-186@usr.sbin/bind/lib/dns/rdata/generic/hinfo_13.c","usr.sbin/bind/lib/dns/rdata/generic/hinfo_13.c","additionaldata_hinfo",178,186
6,1,39,1,8,"digest_hinfo@189-197@usr.sbin/bind/lib/dns/rdata/generic/hinfo_13.c","usr.sbin/bind/lib/dns/rdata/generic/hinfo_13.c","digest_hinfo",189,197
8,1,38,1,10,"checkowner_hinfo@200-210@usr.sbin/bind/lib/dns/rdata/generic/hinfo_13.c","usr.sbin/bind/lib/dns/rdata/generic/hinfo_13.c","checkowner_hinfo",200,210
7,1,35,1,9,"checknames_hinfo@213-222@usr.sbin/bind/lib/dns/rdata/generic/hinfo_13.c","usr.sbin/bind/lib/dns/rdata/generic/hinfo_13.c","checknames_hinfo",213,222
63,14,443,1,88,"fromtext_ipseckey@29-117@usr.sbin/bind/lib/dns/rdata/generic/ipseckey_45.c","usr.sbin/bind/lib/dns/rdata/generic/ipseckey_45.c","fromtext_ipseckey",29,117
57,9,432,1,84,"totext_ipseckey@120-204@usr.sbin/bind/lib/dns/rdata/generic/ipseckey_45.c","usr.sbin/bind/lib/dns/rdata/generic/ipseckey_45.c","totext_ipseckey",120,204
35,8,258,1,44,"fromwire_ipseckey@207-251@usr.sbin/bind/lib/dns/rdata/generic/ipseckey_45.c","usr.sbin/bind/lib/dns/rdata/generic/ipseckey_45.c","fromwire_ipseckey",207,251
8,1,56,1,10,"towire_ipseckey@254-264@usr.sbin/bind/lib/dns/rdata/generic/ipseckey_45.c","usr.sbin/bind/lib/dns/rdata/generic/ipseckey_45.c","towire_ipseckey",254,264
12,1,89,1,14,"compare_ipseckey@267-281@usr.sbin/bind/lib/dns/rdata/generic/ipseckey_45.c","usr.sbin/bind/lib/dns/rdata/generic/ipseckey_45.c","compare_ipseckey",267,281
32,6,216,1,40,"fromstruct_ipseckey@284-324@usr.sbin/bind/lib/dns/rdata/generic/ipseckey_45.c","usr.sbin/bind/lib/dns/rdata/generic/ipseckey_45.c","fromstruct_ipseckey",284,324
55,9,375,1,67,"tostruct_ipseckey@327-394@usr.sbin/bind/lib/dns/rdata/generic/ipseckey_45.c","usr.sbin/bind/lib/dns/rdata/generic/ipseckey_45.c","tostruct_ipseckey",327,394
12,4,85,1,16,"freestruct_ipseckey@397-413@usr.sbin/bind/lib/dns/rdata/generic/ipseckey_45.c","usr.sbin/bind/lib/dns/rdata/generic/ipseckey_45.c","freestruct_ipseckey",397,413
7,1,35,1,9,"additionaldata_ipseckey@416-425@usr.sbin/bind/lib/dns/rdata/generic/ipseckey_45.c","usr.sbin/bind/lib/dns/rdata/generic/ipseckey_45.c","additionaldata_ipseckey",416,425
6,1,39,1,7,"digest_ipseckey@428-435@usr.sbin/bind/lib/dns/rdata/generic/ipseckey_45.c","usr.sbin/bind/lib/dns/rdata/generic/ipseckey_45.c","digest_ipseckey",428,435
8,1,38,1,10,"checkowner_ipseckey@438-448@usr.sbin/bind/lib/dns/rdata/generic/ipseckey_45.c","usr.sbin/bind/lib/dns/rdata/generic/ipseckey_45.c","checkowner_ipseckey",438,448
7,1,35,1,9,"checknames_ipseckey@451-460@usr.sbin/bind/lib/dns/rdata/generic/ipseckey_45.c","usr.sbin/bind/lib/dns/rdata/generic/ipseckey_45.c","checknames_ipseckey",451,460
21,3,135,1,26,"fromtext_isdn@30-56@usr.sbin/bind/lib/dns/rdata/generic/isdn_20.c","usr.sbin/bind/lib/dns/rdata/generic/isdn_20.c","fromtext_isdn",30,56
12,2,85,1,14,"totext_isdn@59-73@usr.sbin/bind/lib/dns/rdata/generic/isdn_20.c","usr.sbin/bind/lib/dns/rdata/generic/isdn_20.c","totext_isdn",59,73
11,2,65,1,12,"fromwire_isdn@76-88@usr.sbin/bind/lib/dns/rdata/generic/isdn_20.c","usr.sbin/bind/lib/dns/rdata/generic/isdn_20.c","fromwire_isdn",76,88
6,1,45,1,7,"towire_isdn@91-98@usr.sbin/bind/lib/dns/rdata/generic/isdn_20.c","usr.sbin/bind/lib/dns/rdata/generic/isdn_20.c","towire_isdn",91,98
12,1,89,1,13,"compare_isdn@101-114@usr.sbin/bind/lib/dns/rdata/generic/isdn_20.c","usr.sbin/bind/lib/dns/rdata/generic/isdn_20.c","compare_isdn",101,114
13,1,114,1,15,"fromstruct_isdn@117-132@usr.sbin/bind/lib/dns/rdata/generic/isdn_20.c","usr.sbin/bind/lib/dns/rdata/generic/isdn_20.c","fromstruct_isdn",117,132
28,5,221,1,34,"tostruct_isdn@135-169@usr.sbin/bind/lib/dns/rdata/generic/isdn_20.c","usr.sbin/bind/lib/dns/rdata/generic/isdn_20.c","tostruct_isdn",135,169
11,4,73,1,13,"freestruct_isdn@172-185@usr.sbin/bind/lib/dns/rdata/generic/isdn_20.c","usr.sbin/bind/lib/dns/rdata/generic/isdn_20.c","freestruct_isdn",172,185
7,1,35,1,8,"additionaldata_isdn@188-196@usr.sbin/bind/lib/dns/rdata/generic/isdn_20.c","usr.sbin/bind/lib/dns/rdata/generic/isdn_20.c","additionaldata_isdn",188,196
6,1,39,1,8,"digest_isdn@199-207@usr.sbin/bind/lib/dns/rdata/generic/isdn_20.c","usr.sbin/bind/lib/dns/rdata/generic/isdn_20.c","digest_isdn",199,207
8,1,38,1,10,"checkowner_isdn@210-220@usr.sbin/bind/lib/dns/rdata/generic/isdn_20.c","usr.sbin/bind/lib/dns/rdata/generic/isdn_20.c","checkowner_isdn",210,220
7,1,35,1,9,"checknames_isdn@223-232@usr.sbin/bind/lib/dns/rdata/generic/isdn_20.c","usr.sbin/bind/lib/dns/rdata/generic/isdn_20.c","checknames_isdn",223,232
27,2,207,1,37,"fromtext_key@34-71@usr.sbin/bind/lib/dns/rdata/generic/key_25.c","usr.sbin/bind/lib/dns/rdata/generic/key_25.c","fromtext_key",34,71
43,7,399,1,58,"totext_key@74-132@usr.sbin/bind/lib/dns/rdata/generic/key_25.c","usr.sbin/bind/lib/dns/rdata/generic/key_25.c","totext_key",74,132
13,2,82,1,16,"fromwire_key@135-151@usr.sbin/bind/lib/dns/rdata/generic/key_25.c","usr.sbin/bind/lib/dns/rdata/generic/key_25.c","fromwire_key",135,151
8,1,56,1,10,"towire_key@154-164@usr.sbin/bind/lib/dns/rdata/generic/key_25.c","usr.sbin/bind/lib/dns/rdata/generic/key_25.c","towire_key",154,164
12,1,89,1,13,"compare_key@167-180@usr.sbin/bind/lib/dns/rdata/generic/key_25.c","usr.sbin/bind/lib/dns/rdata/generic/key_25.c","compare_key",167,180
13,1,110,1,22,"fromstruct_key@183-205@usr.sbin/bind/lib/dns/rdata/generic/key_25.c","usr.sbin/bind/lib/dns/rdata/generic/key_25.c","fromstruct_key",183,205
29,5,220,1,40,"tostruct_key@208-248@usr.sbin/bind/lib/dns/rdata/generic/key_25.c","usr.sbin/bind/lib/dns/rdata/generic/key_25.c","tostruct_key",208,248
10,3,69,1,12,"freestruct_key@251-263@usr.sbin/bind/lib/dns/rdata/generic/key_25.c","usr.sbin/bind/lib/dns/rdata/generic/key_25.c","freestruct_key",251,263
7,1,35,1,8,"additionaldata_key@266-274@usr.sbin/bind/lib/dns/rdata/generic/key_25.c","usr.sbin/bind/lib/dns/rdata/generic/key_25.c","additionaldata_key",266,274
6,1,39,1,8,"digest_key@277-285@usr.sbin/bind/lib/dns/rdata/generic/key_25.c","usr.sbin/bind/lib/dns/rdata/generic/key_25.c","digest_key",277,285
8,1,38,1,10,"checkowner_key@288-298@usr.sbin/bind/lib/dns/rdata/generic/key_25.c","usr.sbin/bind/lib/dns/rdata/generic/key_25.c","checkowner_key",288,298
7,1,35,1,9,"checknames_key@301-310@usr.sbin/bind/lib/dns/rdata/generic/key_25.c","usr.sbin/bind/lib/dns/rdata/generic/key_25.c","checknames_key",301,310
355,140,2444,1,424,"fromtext_loc@30-454@usr.sbin/bind/lib/dns/rdata/generic/loc_29.c","usr.sbin/bind/lib/dns/rdata/generic/loc_29.c","fromtext_loc",30,454
93,10,700,1,102,"totext_loc@457-559@usr.sbin/bind/lib/dns/rdata/generic/loc_29.c","usr.sbin/bind/lib/dns/rdata/generic/loc_29.c","totext_loc",457,559
43,20,381,1,71,"fromwire_loc@562-633@usr.sbin/bind/lib/dns/rdata/generic/loc_29.c","usr.sbin/bind/lib/dns/rdata/generic/loc_29.c","fromwire_loc",562,633
6,1,45,1,7,"towire_loc@636-643@usr.sbin/bind/lib/dns/rdata/generic/loc_29.c","usr.sbin/bind/lib/dns/rdata/generic/loc_29.c","towire_loc",636,643
12,1,89,1,13,"compare_loc@646-659@usr.sbin/bind/lib/dns/rdata/generic/loc_29.c","usr.sbin/bind/lib/dns/rdata/generic/loc_29.c","compare_loc",646,659
34,15,421,1,41,"fromstruct_loc@662-703@usr.sbin/bind/lib/dns/rdata/generic/loc_29.c","usr.sbin/bind/lib/dns/rdata/generic/loc_29.c","fromstruct_loc",662,703
31,2,260,1,35,"tostruct_loc@706-741@usr.sbin/bind/lib/dns/rdata/generic/loc_29.c","usr.sbin/bind/lib/dns/rdata/generic/loc_29.c","tostruct_loc",706,741
7,1,40,1,8,"freestruct_loc@744-752@usr.sbin/bind/lib/dns/rdata/generic/loc_29.c","usr.sbin/bind/lib/dns/rdata/generic/loc_29.c","freestruct_loc",744,752
7,1,35,1,8,"additionaldata_loc@755-763@usr.sbin/bind/lib/dns/rdata/generic/loc_29.c","usr.sbin/bind/lib/dns/rdata/generic/loc_29.c","additionaldata_loc",755,763
6,1,39,1,8,"digest_loc@766-774@usr.sbin/bind/lib/dns/rdata/generic/loc_29.c","usr.sbin/bind/lib/dns/rdata/generic/loc_29.c","digest_loc",766,774
8,1,38,1,10,"checkowner_loc@777-787@usr.sbin/bind/lib/dns/rdata/generic/loc_29.c","usr.sbin/bind/lib/dns/rdata/generic/loc_29.c","checkowner_loc",777,787
7,1,35,1,9,"checknames_loc@790-799@usr.sbin/bind/lib/dns/rdata/generic/loc_29.c","usr.sbin/bind/lib/dns/rdata/generic/loc_29.c","checknames_loc",790,799
16,2,108,1,19,"fromtext_mb@28-47@usr.sbin/bind/lib/dns/rdata/generic/mb_7.c","usr.sbin/bind/lib/dns/rdata/generic/mb_7.c","fromtext_mb",28,47
14,1,97,1,18,"totext_mb@50-68@usr.sbin/bind/lib/dns/rdata/generic/mb_7.c","usr.sbin/bind/lib/dns/rdata/generic/mb_7.c","totext_mb",50,68
9,1,58,1,12,"fromwire_mb@71-83@usr.sbin/bind/lib/dns/rdata/generic/mb_7.c","usr.sbin/bind/lib/dns/rdata/generic/mb_7.c","fromwire_mb",71,83
12,1,78,1,15,"towire_mb@86-101@usr.sbin/bind/lib/dns/rdata/generic/mb_7.c","usr.sbin/bind/lib/dns/rdata/generic/mb_7.c","towire_mb",86,101
18,1,129,1,22,"compare_mb@104-126@usr.sbin/bind/lib/dns/rdata/generic/mb_7.c","usr.sbin/bind/lib/dns/rdata/generic/mb_7.c","compare_mb",104,126
12,1,83,1,14,"fromstruct_mb@129-143@usr.sbin/bind/lib/dns/rdata/generic/mb_7.c","usr.sbin/bind/lib/dns/rdata/generic/mb_7.c","fromstruct_mb",129,143
18,1,135,1,20,"tostruct_mb@146-166@usr.sbin/bind/lib/dns/rdata/generic/mb_7.c","usr.sbin/bind/lib/dns/rdata/generic/mb_7.c","tostruct_mb",146,166
8,2,47,1,10,"freestruct_mb@169-179@usr.sbin/bind/lib/dns/rdata/generic/mb_7.c","usr.sbin/bind/lib/dns/rdata/generic/mb_7.c","freestruct_mb",169,179
10,1,64,1,12,"additionaldata_mb@182-194@usr.sbin/bind/lib/dns/rdata/generic/mb_7.c","usr.sbin/bind/lib/dns/rdata/generic/mb_7.c","additionaldata_mb",182,194
9,1,59,1,11,"digest_mb@197-208@usr.sbin/bind/lib/dns/rdata/generic/mb_7.c","usr.sbin/bind/lib/dns/rdata/generic/mb_7.c","digest_mb",197,208
7,1,36,1,9,"checkowner_mb@211-220@usr.sbin/bind/lib/dns/rdata/generic/mb_7.c","usr.sbin/bind/lib/dns/rdata/generic/mb_7.c","checkowner_mb",211,220
7,1,35,1,9,"checknames_mb@223-232@usr.sbin/bind/lib/dns/rdata/generic/mb_7.c","usr.sbin/bind/lib/dns/rdata/generic/mb_7.c","checknames_mb",223,232
16,2,108,1,19,"fromtext_md@28-47@usr.sbin/bind/lib/dns/rdata/generic/md_3.c","usr.sbin/bind/lib/dns/rdata/generic/md_3.c","fromtext_md",28,47
14,1,97,1,18,"totext_md@50-68@usr.sbin/bind/lib/dns/rdata/generic/md_3.c","usr.sbin/bind/lib/dns/rdata/generic/md_3.c","totext_md",50,68
9,1,58,1,12,"fromwire_md@71-83@usr.sbin/bind/lib/dns/rdata/generic/md_3.c","usr.sbin/bind/lib/dns/rdata/generic/md_3.c","fromwire_md",71,83
12,1,78,1,15,"towire_md@86-101@usr.sbin/bind/lib/dns/rdata/generic/md_3.c","usr.sbin/bind/lib/dns/rdata/generic/md_3.c","towire_md",86,101
18,1,129,1,22,"compare_md@104-126@usr.sbin/bind/lib/dns/rdata/generic/md_3.c","usr.sbin/bind/lib/dns/rdata/generic/md_3.c","compare_md",104,126
12,1,83,1,14,"fromstruct_md@129-143@usr.sbin/bind/lib/dns/rdata/generic/md_3.c","usr.sbin/bind/lib/dns/rdata/generic/md_3.c","fromstruct_md",129,143
18,1,135,1,20,"tostruct_md@146-166@usr.sbin/bind/lib/dns/rdata/generic/md_3.c","usr.sbin/bind/lib/dns/rdata/generic/md_3.c","tostruct_md",146,166
9,2,58,1,11,"freestruct_md@169-180@usr.sbin/bind/lib/dns/rdata/generic/md_3.c","usr.sbin/bind/lib/dns/rdata/generic/md_3.c","freestruct_md",169,180
10,1,64,1,12,"additionaldata_md@183-195@usr.sbin/bind/lib/dns/rdata/generic/md_3.c","usr.sbin/bind/lib/dns/rdata/generic/md_3.c","additionaldata_md",183,195
9,1,59,1,11,"digest_md@198-209@usr.sbin/bind/lib/dns/rdata/generic/md_3.c","usr.sbin/bind/lib/dns/rdata/generic/md_3.c","digest_md",198,209
8,1,38,1,10,"checkowner_md@212-222@usr.sbin/bind/lib/dns/rdata/generic/md_3.c","usr.sbin/bind/lib/dns/rdata/generic/md_3.c","checkowner_md",212,222
7,1,35,1,9,"checknames_md@225-234@usr.sbin/bind/lib/dns/rdata/generic/md_3.c","usr.sbin/bind/lib/dns/rdata/generic/md_3.c","checknames_md",225,234
16,2,108,1,19,"fromtext_mf@28-47@usr.sbin/bind/lib/dns/rdata/generic/mf_4.c","usr.sbin/bind/lib/dns/rdata/generic/mf_4.c","fromtext_mf",28,47
14,1,97,1,18,"totext_mf@50-68@usr.sbin/bind/lib/dns/rdata/generic/mf_4.c","usr.sbin/bind/lib/dns/rdata/generic/mf_4.c","totext_mf",50,68
9,1,58,1,12,"fromwire_mf@71-83@usr.sbin/bind/lib/dns/rdata/generic/mf_4.c","usr.sbin/bind/lib/dns/rdata/generic/mf_4.c","fromwire_mf",71,83
12,1,78,1,15,"towire_mf@86-101@usr.sbin/bind/lib/dns/rdata/generic/mf_4.c","usr.sbin/bind/lib/dns/rdata/generic/mf_4.c","towire_mf",86,101
18,1,129,1,22,"compare_mf@104-126@usr.sbin/bind/lib/dns/rdata/generic/mf_4.c","usr.sbin/bind/lib/dns/rdata/generic/mf_4.c","compare_mf",104,126
12,1,83,1,14,"fromstruct_mf@129-143@usr.sbin/bind/lib/dns/rdata/generic/mf_4.c","usr.sbin/bind/lib/dns/rdata/generic/mf_4.c","fromstruct_mf",129,143
18,1,135,1,20,"tostruct_mf@146-166@usr.sbin/bind/lib/dns/rdata/generic/mf_4.c","usr.sbin/bind/lib/dns/rdata/generic/mf_4.c","tostruct_mf",146,166
9,2,58,1,10,"freestruct_mf@169-179@usr.sbin/bind/lib/dns/rdata/generic/mf_4.c","usr.sbin/bind/lib/dns/rdata/generic/mf_4.c","freestruct_mf",169,179
10,1,64,1,12,"additionaldata_mf@182-194@usr.sbin/bind/lib/dns/rdata/generic/mf_4.c","usr.sbin/bind/lib/dns/rdata/generic/mf_4.c","additionaldata_mf",182,194
9,1,59,1,11,"digest_mf@197-208@usr.sbin/bind/lib/dns/rdata/generic/mf_4.c","usr.sbin/bind/lib/dns/rdata/generic/mf_4.c","digest_mf",197,208
8,1,38,1,10,"checkowner_mf@211-221@usr.sbin/bind/lib/dns/rdata/generic/mf_4.c","usr.sbin/bind/lib/dns/rdata/generic/mf_4.c","checkowner_mf",211,221
7,1,35,1,9,"checknames_mf@224-233@usr.sbin/bind/lib/dns/rdata/generic/mf_4.c","usr.sbin/bind/lib/dns/rdata/generic/mf_4.c","checknames_mf",224,233
16,2,108,1,19,"fromtext_mg@28-47@usr.sbin/bind/lib/dns/rdata/generic/mg_8.c","usr.sbin/bind/lib/dns/rdata/generic/mg_8.c","fromtext_mg",28,47
14,1,97,1,18,"totext_mg@50-68@usr.sbin/bind/lib/dns/rdata/generic/mg_8.c","usr.sbin/bind/lib/dns/rdata/generic/mg_8.c","totext_mg",50,68
9,1,58,1,12,"fromwire_mg@71-83@usr.sbin/bind/lib/dns/rdata/generic/mg_8.c","usr.sbin/bind/lib/dns/rdata/generic/mg_8.c","fromwire_mg",71,83
12,1,78,1,15,"towire_mg@86-101@usr.sbin/bind/lib/dns/rdata/generic/mg_8.c","usr.sbin/bind/lib/dns/rdata/generic/mg_8.c","towire_mg",86,101
18,1,129,1,22,"compare_mg@104-126@usr.sbin/bind/lib/dns/rdata/generic/mg_8.c","usr.sbin/bind/lib/dns/rdata/generic/mg_8.c","compare_mg",104,126
12,1,83,1,14,"fromstruct_mg@129-143@usr.sbin/bind/lib/dns/rdata/generic/mg_8.c","usr.sbin/bind/lib/dns/rdata/generic/mg_8.c","fromstruct_mg",129,143
18,1,135,1,20,"tostruct_mg@146-166@usr.sbin/bind/lib/dns/rdata/generic/mg_8.c","usr.sbin/bind/lib/dns/rdata/generic/mg_8.c","tostruct_mg",146,166
9,2,58,1,10,"freestruct_mg@169-179@usr.sbin/bind/lib/dns/rdata/generic/mg_8.c","usr.sbin/bind/lib/dns/rdata/generic/mg_8.c","freestruct_mg",169,179
7,1,35,1,8,"additionaldata_mg@182-190@usr.sbin/bind/lib/dns/rdata/generic/mg_8.c","usr.sbin/bind/lib/dns/rdata/generic/mg_8.c","additionaldata_mg",182,190
9,1,59,1,11,"digest_mg@193-204@usr.sbin/bind/lib/dns/rdata/generic/mg_8.c","usr.sbin/bind/lib/dns/rdata/generic/mg_8.c","digest_mg",193,204
7,1,36,1,9,"checkowner_mg@207-216@usr.sbin/bind/lib/dns/rdata/generic/mg_8.c","usr.sbin/bind/lib/dns/rdata/generic/mg_8.c","checkowner_mg",207,216
7,1,35,1,9,"checknames_mg@219-228@usr.sbin/bind/lib/dns/rdata/generic/mg_8.c","usr.sbin/bind/lib/dns/rdata/generic/mg_8.c","checknames_mg",219,228
29,8,188,1,31,"fromtext_minfo@28-59@usr.sbin/bind/lib/dns/rdata/generic/minfo_14.c","usr.sbin/bind/lib/dns/rdata/generic/minfo_14.c","fromtext_minfo",28,59
22,1,175,1,30,"totext_minfo@62-92@usr.sbin/bind/lib/dns/rdata/generic/minfo_14.c","usr.sbin/bind/lib/dns/rdata/generic/minfo_14.c","totext_minfo",62,92
12,1,86,1,16,"fromwire_minfo@95-111@usr.sbin/bind/lib/dns/rdata/generic/minfo_14.c","usr.sbin/bind/lib/dns/rdata/generic/minfo_14.c","fromwire_minfo",95,111
19,1,136,1,26,"towire_minfo@114-140@usr.sbin/bind/lib/dns/rdata/generic/minfo_14.c","usr.sbin/bind/lib/dns/rdata/generic/minfo_14.c","towire_minfo",114,140
29,2,216,1,37,"compare_minfo@143-180@usr.sbin/bind/lib/dns/rdata/generic/minfo_14.c","usr.sbin/bind/lib/dns/rdata/generic/minfo_14.c","compare_minfo",143,180
14,1,105,1,16,"fromstruct_minfo@183-199@usr.sbin/bind/lib/dns/rdata/generic/minfo_14.c","usr.sbin/bind/lib/dns/rdata/generic/minfo_14.c","fromstruct_minfo",183,199
29,3,216,1,33,"tostruct_minfo@202-235@usr.sbin/bind/lib/dns/rdata/generic/minfo_14.c","usr.sbin/bind/lib/dns/rdata/generic/minfo_14.c","tostruct_minfo",202,235
10,2,70,1,12,"freestruct_minfo@238-250@usr.sbin/bind/lib/dns/rdata/generic/minfo_14.c","usr.sbin/bind/lib/dns/rdata/generic/minfo_14.c","freestruct_minfo",238,250
7,1,35,1,8,"additionaldata_minfo@253-261@usr.sbin/bind/lib/dns/rdata/generic/minfo_14.c","usr.sbin/bind/lib/dns/rdata/generic/minfo_14.c","additionaldata_minfo",253,261
16,2,114,1,18,"digest_minfo@264-282@usr.sbin/bind/lib/dns/rdata/generic/minfo_14.c","usr.sbin/bind/lib/dns/rdata/generic/minfo_14.c","digest_minfo",264,282
8,1,38,1,10,"checkowner_minfo@285-295@usr.sbin/bind/lib/dns/rdata/generic/minfo_14.c","usr.sbin/bind/lib/dns/rdata/generic/minfo_14.c","checkowner_minfo",285,295
22,5,137,1,24,"checknames_minfo@298-322@usr.sbin/bind/lib/dns/rdata/generic/minfo_14.c","usr.sbin/bind/lib/dns/rdata/generic/minfo_14.c","checknames_minfo",298,322
16,2,108,1,19,"fromtext_mr@28-47@usr.sbin/bind/lib/dns/rdata/generic/mr_9.c","usr.sbin/bind/lib/dns/rdata/generic/mr_9.c","fromtext_mr",28,47
14,1,97,1,18,"totext_mr@50-68@usr.sbin/bind/lib/dns/rdata/generic/mr_9.c","usr.sbin/bind/lib/dns/rdata/generic/mr_9.c","totext_mr",50,68
9,1,58,1,12,"fromwire_mr@71-83@usr.sbin/bind/lib/dns/rdata/generic/mr_9.c","usr.sbin/bind/lib/dns/rdata/generic/mr_9.c","fromwire_mr",71,83
12,1,78,1,15,"towire_mr@86-101@usr.sbin/bind/lib/dns/rdata/generic/mr_9.c","usr.sbin/bind/lib/dns/rdata/generic/mr_9.c","towire_mr",86,101
18,1,129,1,22,"compare_mr@104-126@usr.sbin/bind/lib/dns/rdata/generic/mr_9.c","usr.sbin/bind/lib/dns/rdata/generic/mr_9.c","compare_mr",104,126
12,1,83,1,14,"fromstruct_mr@129-143@usr.sbin/bind/lib/dns/rdata/generic/mr_9.c","usr.sbin/bind/lib/dns/rdata/generic/mr_9.c","fromstruct_mr",129,143
18,1,135,1,20,"tostruct_mr@146-166@usr.sbin/bind/lib/dns/rdata/generic/mr_9.c","usr.sbin/bind/lib/dns/rdata/generic/mr_9.c","tostruct_mr",146,166
9,2,58,1,10,"freestruct_mr@169-179@usr.sbin/bind/lib/dns/rdata/generic/mr_9.c","usr.sbin/bind/lib/dns/rdata/generic/mr_9.c","freestruct_mr",169,179
7,1,35,1,8,"additionaldata_mr@182-190@usr.sbin/bind/lib/dns/rdata/generic/mr_9.c","usr.sbin/bind/lib/dns/rdata/generic/mr_9.c","additionaldata_mr",182,190
9,1,59,1,11,"digest_mr@193-204@usr.sbin/bind/lib/dns/rdata/generic/mr_9.c","usr.sbin/bind/lib/dns/rdata/generic/mr_9.c","digest_mr",193,204
8,1,38,1,10,"checkowner_mr@207-217@usr.sbin/bind/lib/dns/rdata/generic/mr_9.c","usr.sbin/bind/lib/dns/rdata/generic/mr_9.c","checkowner_mr",207,217
7,1,35,1,9,"checknames_mr@220-229@usr.sbin/bind/lib/dns/rdata/generic/mr_9.c","usr.sbin/bind/lib/dns/rdata/generic/mr_9.c","checknames_mr",220,229
13,5,113,1,15,"check_mx@32-47@usr.sbin/bind/lib/dns/rdata/generic/mx_15.c","usr.sbin/bind/lib/dns/rdata/generic/mx_15.c","check_mx",32,47
36,13,275,1,41,"fromtext_mx@50-91@usr.sbin/bind/lib/dns/rdata/generic/mx_15.c","usr.sbin/bind/lib/dns/rdata/generic/mx_15.c","fromtext_mx",50,91
21,1,160,1,25,"totext_mx@94-119@usr.sbin/bind/lib/dns/rdata/generic/mx_15.c","usr.sbin/bind/lib/dns/rdata/generic/mx_15.c","totext_mx",94,119
15,2,103,1,19,"fromwire_mx@122-141@usr.sbin/bind/lib/dns/rdata/generic/mx_15.c","usr.sbin/bind/lib/dns/rdata/generic/mx_15.c","fromwire_mx",122,141
14,1,100,1,18,"towire_mx@144-162@usr.sbin/bind/lib/dns/rdata/generic/mx_15.c","usr.sbin/bind/lib/dns/rdata/generic/mx_15.c","towire_mx",144,162
24,3,181,1,30,"compare_mx@165-195@usr.sbin/bind/lib/dns/rdata/generic/mx_15.c","usr.sbin/bind/lib/dns/rdata/generic/mx_15.c","compare_mx",165,195
13,1,95,1,15,"fromstruct_mx@198-213@usr.sbin/bind/lib/dns/rdata/generic/mx_15.c","usr.sbin/bind/lib/dns/rdata/generic/mx_15.c","fromstruct_mx",198,213
20,1,153,1,22,"tostruct_mx@216-238@usr.sbin/bind/lib/dns/rdata/generic/mx_15.c","usr.sbin/bind/lib/dns/rdata/generic/mx_15.c","tostruct_mx",216,238
9,2,58,1,11,"freestruct_mx@241-252@usr.sbin/bind/lib/dns/rdata/generic/mx_15.c","usr.sbin/bind/lib/dns/rdata/generic/mx_15.c","freestruct_mx",241,252
11,1,72,1,13,"additionaldata_mx@255-268@usr.sbin/bind/lib/dns/rdata/generic/mx_15.c","usr.sbin/bind/lib/dns/rdata/generic/mx_15.c","additionaldata_mx",255,268
13,1,92,1,14,"digest_mx@271-285@usr.sbin/bind/lib/dns/rdata/generic/mx_15.c","usr.sbin/bind/lib/dns/rdata/generic/mx_15.c","digest_mx",271,285
6,1,33,1,8,"checkowner_mx@288-296@usr.sbin/bind/lib/dns/rdata/generic/mx_15.c","usr.sbin/bind/lib/dns/rdata/generic/mx_15.c","checkowner_mx",288,296
16,3,96,1,18,"checknames_mx@299-317@usr.sbin/bind/lib/dns/rdata/generic/mx_15.c","usr.sbin/bind/lib/dns/rdata/generic/mx_15.c","checknames_mx",299,317
24,7,172,1,27,"fromtext_ns@28-55@usr.sbin/bind/lib/dns/rdata/generic/ns_2.c","usr.sbin/bind/lib/dns/rdata/generic/ns_2.c","fromtext_ns",28,55
14,1,97,1,18,"totext_ns@58-76@usr.sbin/bind/lib/dns/rdata/generic/ns_2.c","usr.sbin/bind/lib/dns/rdata/generic/ns_2.c","totext_ns",58,76
9,1,58,1,12,"fromwire_ns@79-91@usr.sbin/bind/lib/dns/rdata/generic/ns_2.c","usr.sbin/bind/lib/dns/rdata/generic/ns_2.c","fromwire_ns",79,91
12,1,78,1,15,"towire_ns@94-109@usr.sbin/bind/lib/dns/rdata/generic/ns_2.c","usr.sbin/bind/lib/dns/rdata/generic/ns_2.c","towire_ns",94,109
18,1,129,1,22,"compare_ns@112-134@usr.sbin/bind/lib/dns/rdata/generic/ns_2.c","usr.sbin/bind/lib/dns/rdata/generic/ns_2.c","compare_ns",112,134
12,1,83,1,14,"fromstruct_ns@137-151@usr.sbin/bind/lib/dns/rdata/generic/ns_2.c","usr.sbin/bind/lib/dns/rdata/generic/ns_2.c","fromstruct_ns",137,151
18,1,135,1,20,"tostruct_ns@154-174@usr.sbin/bind/lib/dns/rdata/generic/ns_2.c","usr.sbin/bind/lib/dns/rdata/generic/ns_2.c","tostruct_ns",154,174
8,2,47,1,10,"freestruct_ns@177-187@usr.sbin/bind/lib/dns/rdata/generic/ns_2.c","usr.sbin/bind/lib/dns/rdata/generic/ns_2.c","freestruct_ns",177,187
10,1,64,1,12,"additionaldata_ns@190-202@usr.sbin/bind/lib/dns/rdata/generic/ns_2.c","usr.sbin/bind/lib/dns/rdata/generic/ns_2.c","additionaldata_ns",190,202
9,1,59,1,11,"digest_ns@205-216@usr.sbin/bind/lib/dns/rdata/generic/ns_2.c","usr.sbin/bind/lib/dns/rdata/generic/ns_2.c","digest_ns",205,216
8,1,38,1,10,"checkowner_ns@219-229@usr.sbin/bind/lib/dns/rdata/generic/ns_2.c","usr.sbin/bind/lib/dns/rdata/generic/ns_2.c","checkowner_ns",219,229
15,3,88,1,17,"checknames_ns@232-249@usr.sbin/bind/lib/dns/rdata/generic/ns_2.c","usr.sbin/bind/lib/dns/rdata/generic/ns_2.c","checknames_ns",232,249
71,12,568,1,88,"fromtext_nsec3@46-134@usr.sbin/bind/lib/dns/rdata/generic/nsec3_50.c","usr.sbin/bind/lib/dns/rdata/generic/nsec3_50.c","fromtext_nsec3",46,134
83,14,673,1,102,"totext_nsec3@137-239@usr.sbin/bind/lib/dns/rdata/generic/nsec3_50.c","usr.sbin/bind/lib/dns/rdata/generic/nsec3_50.c","totext_nsec3",137,239
51,14,351,1,74,"fromwire_nsec3@242-316@usr.sbin/bind/lib/dns/rdata/generic/nsec3_50.c","usr.sbin/bind/lib/dns/rdata/generic/nsec3_50.c","fromwire_nsec3",242,316
8,1,56,1,10,"towire_nsec3@319-329@usr.sbin/bind/lib/dns/rdata/generic/nsec3_50.c","usr.sbin/bind/lib/dns/rdata/generic/nsec3_50.c","towire_nsec3",319,329
12,1,89,1,13,"compare_nsec3@332-345@usr.sbin/bind/lib/dns/rdata/generic/nsec3_50.c","usr.sbin/bind/lib/dns/rdata/generic/nsec3_50.c","compare_nsec3",332,345
33,5,315,1,39,"fromstruct_nsec3@348-387@usr.sbin/bind/lib/dns/rdata/generic/nsec3_50.c","usr.sbin/bind/lib/dns/rdata/generic/nsec3_50.c","fromstruct_nsec3",348,387
36,5,294,1,43,"tostruct_nsec3@390-433@usr.sbin/bind/lib/dns/rdata/generic/nsec3_50.c","usr.sbin/bind/lib/dns/rdata/generic/nsec3_50.c","tostruct_nsec3",390,433
14,5,103,1,16,"freestruct_nsec3@436-452@usr.sbin/bind/lib/dns/rdata/generic/nsec3_50.c","usr.sbin/bind/lib/dns/rdata/generic/nsec3_50.c","freestruct_nsec3",436,452
7,1,35,1,8,"additionaldata_nsec3@455-463@usr.sbin/bind/lib/dns/rdata/generic/nsec3_50.c","usr.sbin/bind/lib/dns/rdata/generic/nsec3_50.c","additionaldata_nsec3",455,463
6,1,39,1,7,"digest_nsec3@466-473@usr.sbin/bind/lib/dns/rdata/generic/nsec3_50.c","usr.sbin/bind/lib/dns/rdata/generic/nsec3_50.c","digest_nsec3",466,473
15,2,95,1,21,"checkowner_nsec3@476-497@usr.sbin/bind/lib/dns/rdata/generic/nsec3_50.c","usr.sbin/bind/lib/dns/rdata/generic/nsec3_50.c","checkowner_nsec3",476,497
7,1,35,1,9,"checknames_nsec3@500-509@usr.sbin/bind/lib/dns/rdata/generic/nsec3_50.c","usr.sbin/bind/lib/dns/rdata/generic/nsec3_50.c","checknames_nsec3",500,509
3,1,16,1,2,"casecompare_nsec3@512-514@usr.sbin/bind/lib/dns/rdata/generic/nsec3_50.c","usr.sbin/bind/lib/dns/rdata/generic/nsec3_50.c","casecompare_nsec3",512,514
37,5,281,1,47,"fromtext_nsec3param@46-93@usr.sbin/bind/lib/dns/rdata/generic/nsec3param_51.c","usr.sbin/bind/lib/dns/rdata/generic/nsec3param_51.c","fromtext_nsec3param",46,93
35,2,264,1,46,"totext_nsec3param@96-142@usr.sbin/bind/lib/dns/rdata/generic/nsec3param_51.c","usr.sbin/bind/lib/dns/rdata/generic/nsec3param_51.c","totext_nsec3param",96,142
21,3,135,1,26,"fromwire_nsec3param@145-171@usr.sbin/bind/lib/dns/rdata/generic/nsec3param_51.c","usr.sbin/bind/lib/dns/rdata/generic/nsec3param_51.c","fromwire_nsec3param",145,171
8,1,56,1,10,"towire_nsec3param@174-184@usr.sbin/bind/lib/dns/rdata/generic/nsec3param_51.c","usr.sbin/bind/lib/dns/rdata/generic/nsec3param_51.c","towire_nsec3param",174,184
12,1,89,1,13,"compare_nsec3param@187-200@usr.sbin/bind/lib/dns/rdata/generic/nsec3param_51.c","usr.sbin/bind/lib/dns/rdata/generic/nsec3param_51.c","compare_nsec3param",187,200
16,1,127,1,18,"fromstruct_nsec3param@203-221@usr.sbin/bind/lib/dns/rdata/generic/nsec3param_51.c","usr.sbin/bind/lib/dns/rdata/generic/nsec3param_51.c","fromstruct_nsec3param",203,221
23,2,177,1,27,"tostruct_nsec3param@224-251@usr.sbin/bind/lib/dns/rdata/generic/nsec3param_51.c","usr.sbin/bind/lib/dns/rdata/generic/nsec3param_51.c","tostruct_nsec3param",224,251
10,3,65,1,12,"freestruct_nsec3param@254-266@usr.sbin/bind/lib/dns/rdata/generic/nsec3param_51.c","usr.sbin/bind/lib/dns/rdata/generic/nsec3param_51.c","freestruct_nsec3param",254,266
7,1,35,1,8,"additionaldata_nsec3param@269-277@usr.sbin/bind/lib/dns/rdata/generic/nsec3param_51.c","usr.sbin/bind/lib/dns/rdata/generic/nsec3param_51.c","additionaldata_nsec3param",269,277
6,1,39,1,7,"digest_nsec3param@280-287@usr.sbin/bind/lib/dns/rdata/generic/nsec3param_51.c","usr.sbin/bind/lib/dns/rdata/generic/nsec3param_51.c","digest_nsec3param",280,287
8,1,38,1,10,"checkowner_nsec3param@290-300@usr.sbin/bind/lib/dns/rdata/generic/nsec3param_51.c","usr.sbin/bind/lib/dns/rdata/generic/nsec3param_51.c","checkowner_nsec3param",290,300
7,1,35,1,9,"checknames_nsec3param@303-312@usr.sbin/bind/lib/dns/rdata/generic/nsec3param_51.c","usr.sbin/bind/lib/dns/rdata/generic/nsec3param_51.c","checknames_nsec3param",303,312
3,1,16,1,2,"casecompare_nsec3param@315-317@usr.sbin/bind/lib/dns/rdata/generic/nsec3param_51.c","usr.sbin/bind/lib/dns/rdata/generic/nsec3param_51.c","casecompare_nsec3param",315,317
41,8,306,1,50,"fromtext_nsec@34-84@usr.sbin/bind/lib/dns/rdata/generic/nsec_47.c","usr.sbin/bind/lib/dns/rdata/generic/nsec_47.c","fromtext_nsec",34,84
44,8,352,1,47,"totext_nsec@87-134@usr.sbin/bind/lib/dns/rdata/generic/nsec_47.c","usr.sbin/bind/lib/dns/rdata/generic/nsec_47.c","totext_nsec",87,134
39,11,271,1,58,"fromwire_nsec@137-195@usr.sbin/bind/lib/dns/rdata/generic/nsec_47.c","usr.sbin/bind/lib/dns/rdata/generic/nsec_47.c","fromwire_nsec",137,195
14,1,106,1,16,"towire_nsec@198-214@usr.sbin/bind/lib/dns/rdata/generic/nsec_47.c","usr.sbin/bind/lib/dns/rdata/generic/nsec_47.c","towire_nsec",198,214
12,1,89,1,13,"compare_nsec@217-230@usr.sbin/bind/lib/dns/rdata/generic/nsec_47.c","usr.sbin/bind/lib/dns/rdata/generic/nsec_47.c","compare_nsec",217,230
29,5,245,1,34,"fromstruct_nsec@233-267@usr.sbin/bind/lib/dns/rdata/generic/nsec_47.c","usr.sbin/bind/lib/dns/rdata/generic/nsec_47.c","fromstruct_nsec",233,267
27,3,206,1,32,"tostruct_nsec@270-302@usr.sbin/bind/lib/dns/rdata/generic/nsec_47.c","usr.sbin/bind/lib/dns/rdata/generic/nsec_47.c","tostruct_nsec",270,302
11,3,77,1,13,"freestruct_nsec@305-318@usr.sbin/bind/lib/dns/rdata/generic/nsec_47.c","usr.sbin/bind/lib/dns/rdata/generic/nsec_47.c","freestruct_nsec",305,318
7,1,35,1,8,"additionaldata_nsec@321-329@usr.sbin/bind/lib/dns/rdata/generic/nsec_47.c","usr.sbin/bind/lib/dns/rdata/generic/nsec_47.c","additionaldata_nsec",321,329
6,1,39,1,7,"digest_nsec@332-339@usr.sbin/bind/lib/dns/rdata/generic/nsec_47.c","usr.sbin/bind/lib/dns/rdata/generic/nsec_47.c","digest_nsec",332,339
8,1,38,1,10,"checkowner_nsec@342-352@usr.sbin/bind/lib/dns/rdata/generic/nsec_47.c","usr.sbin/bind/lib/dns/rdata/generic/nsec_47.c","checkowner_nsec",342,352
7,1,35,1,9,"checknames_nsec@355-364@usr.sbin/bind/lib/dns/rdata/generic/nsec_47.c","usr.sbin/bind/lib/dns/rdata/generic/nsec_47.c","checknames_nsec",355,364
11,1,53,1,12,"fromtext_null@28-40@usr.sbin/bind/lib/dns/rdata/generic/null_10.c","usr.sbin/bind/lib/dns/rdata/generic/null_10.c","fromtext_null",28,40
7,1,35,1,8,"totext_null@43-51@usr.sbin/bind/lib/dns/rdata/generic/null_10.c","usr.sbin/bind/lib/dns/rdata/generic/null_10.c","totext_null",43,51
11,1,69,1,13,"fromwire_null@54-67@usr.sbin/bind/lib/dns/rdata/generic/null_10.c","usr.sbin/bind/lib/dns/rdata/generic/null_10.c","fromwire_null",54,67
5,1,36,1,6,"towire_null@70-76@usr.sbin/bind/lib/dns/rdata/generic/null_10.c","usr.sbin/bind/lib/dns/rdata/generic/null_10.c","towire_null",70,76
10,1,71,1,11,"compare_null@79-90@usr.sbin/bind/lib/dns/rdata/generic/null_10.c","usr.sbin/bind/lib/dns/rdata/generic/null_10.c","compare_null",79,90
11,2,89,1,13,"fromstruct_null@93-106@usr.sbin/bind/lib/dns/rdata/generic/null_10.c","usr.sbin/bind/lib/dns/rdata/generic/null_10.c","fromstruct_null",93,106
16,2,118,1,19,"tostruct_null@109-128@usr.sbin/bind/lib/dns/rdata/generic/null_10.c","usr.sbin/bind/lib/dns/rdata/generic/null_10.c","tostruct_null",109,128
10,3,65,1,12,"freestruct_null@131-143@usr.sbin/bind/lib/dns/rdata/generic/null_10.c","usr.sbin/bind/lib/dns/rdata/generic/null_10.c","freestruct_null",131,143
7,1,35,1,8,"additionaldata_null@146-154@usr.sbin/bind/lib/dns/rdata/generic/null_10.c","usr.sbin/bind/lib/dns/rdata/generic/null_10.c","additionaldata_null",146,154
6,1,39,1,8,"digest_null@157-165@usr.sbin/bind/lib/dns/rdata/generic/null_10.c","usr.sbin/bind/lib/dns/rdata/generic/null_10.c","digest_null",157,165
8,1,38,1,10,"checkowner_null@168-178@usr.sbin/bind/lib/dns/rdata/generic/null_10.c","usr.sbin/bind/lib/dns/rdata/generic/null_10.c","checkowner_null",168,178
7,1,35,1,9,"checknames_null@181-190@usr.sbin/bind/lib/dns/rdata/generic/null_10.c","usr.sbin/bind/lib/dns/rdata/generic/null_10.c","checknames_null",181,190
45,12,326,1,54,"fromtext_nxt@34-88@usr.sbin/bind/lib/dns/rdata/generic/nxt_30.c","usr.sbin/bind/lib/dns/rdata/generic/nxt_30.c","fromtext_nxt",34,88
35,6,257,1,37,"totext_nxt@91-128@usr.sbin/bind/lib/dns/rdata/generic/nxt_30.c","usr.sbin/bind/lib/dns/rdata/generic/nxt_30.c","totext_nxt",91,128
17,5,148,1,21,"fromwire_nxt@131-152@usr.sbin/bind/lib/dns/rdata/generic/nxt_30.c","usr.sbin/bind/lib/dns/rdata/generic/nxt_30.c","fromwire_nxt",131,152
14,1,106,1,16,"towire_nxt@155-171@usr.sbin/bind/lib/dns/rdata/generic/nxt_30.c","usr.sbin/bind/lib/dns/rdata/generic/nxt_30.c","towire_nxt",155,171
22,2,154,1,24,"compare_nxt@174-198@usr.sbin/bind/lib/dns/rdata/generic/nxt_30.c","usr.sbin/bind/lib/dns/rdata/generic/nxt_30.c","compare_nxt",174,198
18,4,162,1,21,"fromstruct_nxt@201-222@usr.sbin/bind/lib/dns/rdata/generic/nxt_30.c","usr.sbin/bind/lib/dns/rdata/generic/nxt_30.c","fromstruct_nxt",201,222
27,3,206,1,32,"tostruct_nxt@225-257@usr.sbin/bind/lib/dns/rdata/generic/nxt_30.c","usr.sbin/bind/lib/dns/rdata/generic/nxt_30.c","tostruct_nxt",225,257
11,3,77,1,13,"freestruct_nxt@260-273@usr.sbin/bind/lib/dns/rdata/generic/nxt_30.c","usr.sbin/bind/lib/dns/rdata/generic/nxt_30.c","freestruct_nxt",260,273
7,1,35,1,8,"additionaldata_nxt@276-284@usr.sbin/bind/lib/dns/rdata/generic/nxt_30.c","usr.sbin/bind/lib/dns/rdata/generic/nxt_30.c","additionaldata_nxt",276,284
14,2,97,1,16,"digest_nxt@287-303@usr.sbin/bind/lib/dns/rdata/generic/nxt_30.c","usr.sbin/bind/lib/dns/rdata/generic/nxt_30.c","digest_nxt",287,303
8,1,38,1,10,"checkowner_nxt@306-316@usr.sbin/bind/lib/dns/rdata/generic/nxt_30.c","usr.sbin/bind/lib/dns/rdata/generic/nxt_30.c","checkowner_nxt",306,316
7,1,35,1,9,"checknames_nxt@319-328@usr.sbin/bind/lib/dns/rdata/generic/nxt_30.c","usr.sbin/bind/lib/dns/rdata/generic/nxt_30.c","checknames_nxt",319,328
11,1,53,1,16,"fromtext_opt@32-48@usr.sbin/bind/lib/dns/rdata/generic/opt_41.c","usr.sbin/bind/lib/dns/rdata/generic/opt_41.c","fromtext_opt",32,48
33,6,247,1,39,"totext_opt@51-90@usr.sbin/bind/lib/dns/rdata/generic/opt_41.c","usr.sbin/bind/lib/dns/rdata/generic/opt_41.c","totext_opt",51,90
33,5,195,1,41,"fromwire_opt@93-134@usr.sbin/bind/lib/dns/rdata/generic/opt_41.c","usr.sbin/bind/lib/dns/rdata/generic/opt_41.c","fromwire_opt",93,134
5,1,36,1,7,"towire_opt@137-144@usr.sbin/bind/lib/dns/rdata/generic/opt_41.c","usr.sbin/bind/lib/dns/rdata/generic/opt_41.c","towire_opt",137,144
10,1,71,1,11,"compare_opt@147-158@usr.sbin/bind/lib/dns/rdata/generic/opt_41.c","usr.sbin/bind/lib/dns/rdata/generic/opt_41.c","compare_opt",147,158
25,5,179,1,28,"fromstruct_opt@161-189@usr.sbin/bind/lib/dns/rdata/generic/opt_41.c","usr.sbin/bind/lib/dns/rdata/generic/opt_41.c","fromstruct_opt",161,189
17,2,124,1,20,"tostruct_opt@192-212@usr.sbin/bind/lib/dns/rdata/generic/opt_41.c","usr.sbin/bind/lib/dns/rdata/generic/opt_41.c","tostruct_opt",192,212
10,3,65,1,12,"freestruct_opt@215-227@usr.sbin/bind/lib/dns/rdata/generic/opt_41.c","usr.sbin/bind/lib/dns/rdata/generic/opt_41.c","freestruct_opt",215,227
7,1,35,1,8,"additionaldata_opt@230-238@usr.sbin/bind/lib/dns/rdata/generic/opt_41.c","usr.sbin/bind/lib/dns/rdata/generic/opt_41.c","additionaldata_opt",230,238
7,1,35,1,13,"digest_opt@241-254@usr.sbin/bind/lib/dns/rdata/generic/opt_41.c","usr.sbin/bind/lib/dns/rdata/generic/opt_41.c","digest_opt",241,254
7,1,38,1,9,"checkowner_opt@257-266@usr.sbin/bind/lib/dns/rdata/generic/opt_41.c","usr.sbin/bind/lib/dns/rdata/generic/opt_41.c","checkowner_opt",257,266
7,1,35,1,9,"checknames_opt@269-278@usr.sbin/bind/lib/dns/rdata/generic/opt_41.c","usr.sbin/bind/lib/dns/rdata/generic/opt_41.c","checknames_opt",269,278
26,9,182,1,29,"fromtext_ptr@28-57@usr.sbin/bind/lib/dns/rdata/generic/ptr_12.c","usr.sbin/bind/lib/dns/rdata/generic/ptr_12.c","fromtext_ptr",28,57
14,1,97,1,18,"totext_ptr@60-78@usr.sbin/bind/lib/dns/rdata/generic/ptr_12.c","usr.sbin/bind/lib/dns/rdata/generic/ptr_12.c","totext_ptr",60,78
9,1,58,1,12,"fromwire_ptr@81-93@usr.sbin/bind/lib/dns/rdata/generic/ptr_12.c","usr.sbin/bind/lib/dns/rdata/generic/ptr_12.c","fromwire_ptr",81,93
12,1,78,1,15,"towire_ptr@96-111@usr.sbin/bind/lib/dns/rdata/generic/ptr_12.c","usr.sbin/bind/lib/dns/rdata/generic/ptr_12.c","towire_ptr",96,111
18,1,129,1,22,"compare_ptr@114-136@usr.sbin/bind/lib/dns/rdata/generic/ptr_12.c","usr.sbin/bind/lib/dns/rdata/generic/ptr_12.c","compare_ptr",114,136
12,1,83,1,14,"fromstruct_ptr@139-153@usr.sbin/bind/lib/dns/rdata/generic/ptr_12.c","usr.sbin/bind/lib/dns/rdata/generic/ptr_12.c","fromstruct_ptr",139,153
18,1,135,1,20,"tostruct_ptr@156-176@usr.sbin/bind/lib/dns/rdata/generic/ptr_12.c","usr.sbin/bind/lib/dns/rdata/generic/ptr_12.c","tostruct_ptr",156,176
9,2,58,1,11,"freestruct_ptr@179-190@usr.sbin/bind/lib/dns/rdata/generic/ptr_12.c","usr.sbin/bind/lib/dns/rdata/generic/ptr_12.c","freestruct_ptr",179,190
7,1,35,1,8,"additionaldata_ptr@193-201@usr.sbin/bind/lib/dns/rdata/generic/ptr_12.c","usr.sbin/bind/lib/dns/rdata/generic/ptr_12.c","additionaldata_ptr",193,201
9,1,59,1,11,"digest_ptr@204-215@usr.sbin/bind/lib/dns/rdata/generic/ptr_12.c","usr.sbin/bind/lib/dns/rdata/generic/ptr_12.c","digest_ptr",204,215
8,1,38,1,10,"checkowner_ptr@218-228@usr.sbin/bind/lib/dns/rdata/generic/ptr_12.c","usr.sbin/bind/lib/dns/rdata/generic/ptr_12.c","checkowner_ptr",218,228
20,7,124,1,22,"checknames_ptr@267-289@usr.sbin/bind/lib/dns/rdata/generic/ptr_12.c","usr.sbin/bind/lib/dns/rdata/generic/ptr_12.c","checknames_ptr",267,289
29,9,192,1,32,"fromtext_rp@28-60@usr.sbin/bind/lib/dns/rdata/generic/rp_17.c","usr.sbin/bind/lib/dns/rdata/generic/rp_17.c","fromtext_rp",28,60
22,1,175,1,29,"totext_rp@63-92@usr.sbin/bind/lib/dns/rdata/generic/rp_17.c","usr.sbin/bind/lib/dns/rdata/generic/rp_17.c","totext_rp",63,92
12,1,86,1,16,"fromwire_rp@95-111@usr.sbin/bind/lib/dns/rdata/generic/rp_17.c","usr.sbin/bind/lib/dns/rdata/generic/rp_17.c","fromwire_rp",95,111
19,1,134,1,25,"towire_rp@114-139@usr.sbin/bind/lib/dns/rdata/generic/rp_17.c","usr.sbin/bind/lib/dns/rdata/generic/rp_17.c","towire_rp",114,139
28,2,212,1,36,"compare_rp@142-178@usr.sbin/bind/lib/dns/rdata/generic/rp_17.c","usr.sbin/bind/lib/dns/rdata/generic/rp_17.c","compare_rp",142,178
14,1,105,1,16,"fromstruct_rp@181-197@usr.sbin/bind/lib/dns/rdata/generic/rp_17.c","usr.sbin/bind/lib/dns/rdata/generic/rp_17.c","fromstruct_rp",181,197
29,3,216,1,33,"tostruct_rp@200-233@usr.sbin/bind/lib/dns/rdata/generic/rp_17.c","usr.sbin/bind/lib/dns/rdata/generic/rp_17.c","tostruct_rp",200,233
10,2,70,1,12,"freestruct_rp@236-248@usr.sbin/bind/lib/dns/rdata/generic/rp_17.c","usr.sbin/bind/lib/dns/rdata/generic/rp_17.c","freestruct_rp",236,248
7,1,35,1,8,"additionaldata_rp@251-259@usr.sbin/bind/lib/dns/rdata/generic/rp_17.c","usr.sbin/bind/lib/dns/rdata/generic/rp_17.c","additionaldata_rp",251,259
13,1,101,1,17,"digest_rp@262-279@usr.sbin/bind/lib/dns/rdata/generic/rp_17.c","usr.sbin/bind/lib/dns/rdata/generic/rp_17.c","digest_rp",262,279
8,1,38,1,10,"checkowner_rp@282-292@usr.sbin/bind/lib/dns/rdata/generic/rp_17.c","usr.sbin/bind/lib/dns/rdata/generic/rp_17.c","checkowner_rp",282,292
15,3,86,1,17,"checknames_rp@295-312@usr.sbin/bind/lib/dns/rdata/generic/rp_17.c","usr.sbin/bind/lib/dns/rdata/generic/rp_17.c","checknames_rp",295,312
58,8,474,1,95,"fromtext_rrsig@30-125@usr.sbin/bind/lib/dns/rdata/generic/rrsig_46.c","usr.sbin/bind/lib/dns/rdata/generic/rrsig_46.c","fromtext_rrsig",30,125
65,5,572,1,108,"totext_rrsig@128-236@usr.sbin/bind/lib/dns/rdata/generic/rrsig_46.c","usr.sbin/bind/lib/dns/rdata/generic/rrsig_46.c","totext_rrsig",128,236
18,2,136,1,39,"fromwire_rrsig@239-278@usr.sbin/bind/lib/dns/rdata/generic/rrsig_46.c","usr.sbin/bind/lib/dns/rdata/generic/rrsig_46.c","fromwire_rrsig",239,278
16,1,128,1,34,"towire_rrsig@281-315@usr.sbin/bind/lib/dns/rdata/generic/rrsig_46.c","usr.sbin/bind/lib/dns/rdata/generic/rrsig_46.c","towire_rrsig",281,315
12,1,89,1,13,"compare_rrsig@318-331@usr.sbin/bind/lib/dns/rdata/generic/rrsig_46.c","usr.sbin/bind/lib/dns/rdata/generic/rrsig_46.c","compare_rrsig",318,331
19,2,186,1,56,"fromstruct_rrsig@334-390@usr.sbin/bind/lib/dns/rdata/generic/rrsig_46.c","usr.sbin/bind/lib/dns/rdata/generic/rrsig_46.c","fromstruct_rrsig",334,390
41,3,334,1,79,"tostruct_rrsig@393-472@usr.sbin/bind/lib/dns/rdata/generic/rrsig_46.c","usr.sbin/bind/lib/dns/rdata/generic/rrsig_46.c","tostruct_rrsig",393,472
11,3,81,1,13,"freestruct_rrsig@475-488@usr.sbin/bind/lib/dns/rdata/generic/rrsig_46.c","usr.sbin/bind/lib/dns/rdata/generic/rrsig_46.c","freestruct_rrsig",475,488
7,1,35,1,8,"additionaldata_rrsig@491-499@usr.sbin/bind/lib/dns/rdata/generic/rrsig_46.c","usr.sbin/bind/lib/dns/rdata/generic/rrsig_46.c","additionaldata_rrsig",491,499
7,1,35,1,9,"digest_rrsig@502-511@usr.sbin/bind/lib/dns/rdata/generic/rrsig_46.c","usr.sbin/bind/lib/dns/rdata/generic/rrsig_46.c","digest_rrsig",502,511
8,1,44,1,10,"covers_rrsig@514-524@usr.sbin/bind/lib/dns/rdata/generic/rrsig_46.c","usr.sbin/bind/lib/dns/rdata/generic/rrsig_46.c","covers_rrsig",514,524
8,1,38,1,10,"checkowner_rrsig@527-537@usr.sbin/bind/lib/dns/rdata/generic/rrsig_46.c","usr.sbin/bind/lib/dns/rdata/generic/rrsig_46.c","checkowner_rrsig",527,537
7,1,35,1,9,"checknames_rrsig@540-549@usr.sbin/bind/lib/dns/rdata/generic/rrsig_46.c","usr.sbin/bind/lib/dns/rdata/generic/rrsig_46.c","checknames_rrsig",540,549
29,8,216,1,33,"fromtext_rt@30-63@usr.sbin/bind/lib/dns/rdata/generic/rt_21.c","usr.sbin/bind/lib/dns/rdata/generic/rt_21.c","fromtext_rt",30,63
21,1,160,1,23,"totext_rt@66-89@usr.sbin/bind/lib/dns/rdata/generic/rt_21.c","usr.sbin/bind/lib/dns/rdata/generic/rt_21.c","totext_rt",66,89
20,3,133,1,24,"fromwire_rt@92-116@usr.sbin/bind/lib/dns/rdata/generic/rt_21.c","usr.sbin/bind/lib/dns/rdata/generic/rt_21.c","fromwire_rt",92,116
19,2,130,1,22,"towire_rt@119-141@usr.sbin/bind/lib/dns/rdata/generic/rt_21.c","usr.sbin/bind/lib/dns/rdata/generic/rt_21.c","towire_rt",119,141
24,3,181,1,30,"compare_rt@144-174@usr.sbin/bind/lib/dns/rdata/generic/rt_21.c","usr.sbin/bind/lib/dns/rdata/generic/rt_21.c","compare_rt",144,174
13,1,95,1,15,"fromstruct_rt@177-192@usr.sbin/bind/lib/dns/rdata/generic/rt_21.c","usr.sbin/bind/lib/dns/rdata/generic/rt_21.c","fromstruct_rt",177,192
20,1,153,1,23,"tostruct_rt@195-218@usr.sbin/bind/lib/dns/rdata/generic/rt_21.c","usr.sbin/bind/lib/dns/rdata/generic/rt_21.c","tostruct_rt",195,218
9,2,58,1,11,"freestruct_rt@221-232@usr.sbin/bind/lib/dns/rdata/generic/rt_21.c","usr.sbin/bind/lib/dns/rdata/generic/rt_21.c","freestruct_rt",221,232
18,3,125,1,20,"additionaldata_rt@235-255@usr.sbin/bind/lib/dns/rdata/generic/rt_21.c","usr.sbin/bind/lib/dns/rdata/generic/rt_21.c","additionaldata_rt",235,255
16,2,105,1,17,"digest_rt@258-275@usr.sbin/bind/lib/dns/rdata/generic/rt_21.c","usr.sbin/bind/lib/dns/rdata/generic/rt_21.c","digest_rt",258,275
8,1,38,1,10,"checkowner_rt@278-288@usr.sbin/bind/lib/dns/rdata/generic/rt_21.c","usr.sbin/bind/lib/dns/rdata/generic/rt_21.c","checkowner_rt",278,288
16,3,96,1,18,"checknames_rt@291-309@usr.sbin/bind/lib/dns/rdata/generic/rt_21.c","usr.sbin/bind/lib/dns/rdata/generic/rt_21.c","checknames_rt",291,309
58,8,474,1,95,"fromtext_sig@30-125@usr.sbin/bind/lib/dns/rdata/generic/sig_24.c","usr.sbin/bind/lib/dns/rdata/generic/sig_24.c","fromtext_sig",30,125
65,5,572,1,108,"totext_sig@128-236@usr.sbin/bind/lib/dns/rdata/generic/sig_24.c","usr.sbin/bind/lib/dns/rdata/generic/sig_24.c","totext_sig",128,236
18,2,136,1,39,"fromwire_sig@239-278@usr.sbin/bind/lib/dns/rdata/generic/sig_24.c","usr.sbin/bind/lib/dns/rdata/generic/sig_24.c","fromwire_sig",239,278
16,1,128,1,34,"towire_sig@281-315@usr.sbin/bind/lib/dns/rdata/generic/sig_24.c","usr.sbin/bind/lib/dns/rdata/generic/sig_24.c","towire_sig",281,315
35,3,262,1,40,"compare_sig@318-358@usr.sbin/bind/lib/dns/rdata/generic/sig_24.c","usr.sbin/bind/lib/dns/rdata/generic/sig_24.c","compare_sig",318,358
19,2,186,1,56,"fromstruct_sig@361-417@usr.sbin/bind/lib/dns/rdata/generic/sig_24.c","usr.sbin/bind/lib/dns/rdata/generic/sig_24.c","fromstruct_sig",361,417
41,3,334,1,79,"tostruct_sig@420-499@usr.sbin/bind/lib/dns/rdata/generic/sig_24.c","usr.sbin/bind/lib/dns/rdata/generic/sig_24.c","tostruct_sig",420,499
11,3,81,1,13,"freestruct_sig@502-515@usr.sbin/bind/lib/dns/rdata/generic/sig_24.c","usr.sbin/bind/lib/dns/rdata/generic/sig_24.c","freestruct_sig",502,515
7,1,35,1,8,"additionaldata_sig@518-526@usr.sbin/bind/lib/dns/rdata/generic/sig_24.c","usr.sbin/bind/lib/dns/rdata/generic/sig_24.c","additionaldata_sig",518,526
7,1,35,1,9,"digest_sig@529-538@usr.sbin/bind/lib/dns/rdata/generic/sig_24.c","usr.sbin/bind/lib/dns/rdata/generic/sig_24.c","digest_sig",529,538
8,1,44,1,10,"covers_sig@541-551@usr.sbin/bind/lib/dns/rdata/generic/sig_24.c","usr.sbin/bind/lib/dns/rdata/generic/sig_24.c","covers_sig",541,551
8,1,38,1,10,"checkowner_sig@554-564@usr.sbin/bind/lib/dns/rdata/generic/sig_24.c","usr.sbin/bind/lib/dns/rdata/generic/sig_24.c","checkowner_sig",554,564
7,1,35,1,9,"checknames_sig@567-576@usr.sbin/bind/lib/dns/rdata/generic/sig_24.c","usr.sbin/bind/lib/dns/rdata/generic/sig_24.c","checknames_sig",567,576
47,11,302,1,55,"fromtext_soa@28-83@usr.sbin/bind/lib/dns/rdata/generic/soa_6.c","usr.sbin/bind/lib/dns/rdata/generic/soa_6.c","fromtext_soa",28,83
56,9,464,1,69,"totext_soa@90-159@usr.sbin/bind/lib/dns/rdata/generic/soa_6.c","usr.sbin/bind/lib/dns/rdata/generic/soa_6.c","totext_soa",90,159
24,3,166,1,32,"fromwire_soa@162-194@usr.sbin/bind/lib/dns/rdata/generic/soa_6.c","usr.sbin/bind/lib/dns/rdata/generic/soa_6.c","fromwire_soa",162,194
26,2,187,1,33,"towire_soa@197-230@usr.sbin/bind/lib/dns/rdata/generic/soa_6.c","usr.sbin/bind/lib/dns/rdata/generic/soa_6.c","towire_soa",197,230
33,3,258,1,43,"compare_soa@233-276@usr.sbin/bind/lib/dns/rdata/generic/soa_6.c","usr.sbin/bind/lib/dns/rdata/generic/soa_6.c","compare_soa",233,276
19,1,165,1,21,"fromstruct_soa@279-300@usr.sbin/bind/lib/dns/rdata/generic/soa_6.c","usr.sbin/bind/lib/dns/rdata/generic/soa_6.c","fromstruct_soa",279,300
39,3,310,1,51,"tostruct_soa@303-354@usr.sbin/bind/lib/dns/rdata/generic/soa_6.c","usr.sbin/bind/lib/dns/rdata/generic/soa_6.c","tostruct_soa",303,354
10,2,70,1,12,"freestruct_soa@357-369@usr.sbin/bind/lib/dns/rdata/generic/soa_6.c","usr.sbin/bind/lib/dns/rdata/generic/soa_6.c","freestruct_soa",357,369
7,1,35,1,8,"additionaldata_soa@372-380@usr.sbin/bind/lib/dns/rdata/generic/soa_6.c","usr.sbin/bind/lib/dns/rdata/generic/soa_6.c","additionaldata_soa",372,380
15,1,126,1,19,"digest_soa@383-402@usr.sbin/bind/lib/dns/rdata/generic/soa_6.c","usr.sbin/bind/lib/dns/rdata/generic/soa_6.c","digest_soa",383,402
8,1,38,1,10,"checkowner_soa@405-415@usr.sbin/bind/lib/dns/rdata/generic/soa_6.c","usr.sbin/bind/lib/dns/rdata/generic/soa_6.c","checkowner_soa",405,415
22,5,139,1,24,"checknames_soa@418-442@usr.sbin/bind/lib/dns/rdata/generic/soa_6.c","usr.sbin/bind/lib/dns/rdata/generic/soa_6.c","checknames_soa",418,442
23,5,123,1,26,"fromtext_spf@28-54@usr.sbin/bind/lib/dns/rdata/generic/spf_99.c","usr.sbin/bind/lib/dns/rdata/generic/spf_99.c","fromtext_spf",28,54
12,3,75,1,16,"totext_spf@57-73@usr.sbin/bind/lib/dns/rdata/generic/spf_99.c","usr.sbin/bind/lib/dns/rdata/generic/spf_99.c","totext_spf",57,73
14,3,73,1,16,"fromwire_spf@76-92@usr.sbin/bind/lib/dns/rdata/generic/spf_99.c","usr.sbin/bind/lib/dns/rdata/generic/spf_99.c","fromwire_spf",76,92
11,2,75,1,14,"towire_spf@95-109@usr.sbin/bind/lib/dns/rdata/generic/spf_99.c","usr.sbin/bind/lib/dns/rdata/generic/spf_99.c","towire_spf",95,109
10,1,71,1,11,"compare_spf@112-123@usr.sbin/bind/lib/dns/rdata/generic/spf_99.c","usr.sbin/bind/lib/dns/rdata/generic/spf_99.c","compare_spf",112,123
22,4,158,1,25,"fromstruct_spf@126-151@usr.sbin/bind/lib/dns/rdata/generic/spf_99.c","usr.sbin/bind/lib/dns/rdata/generic/spf_99.c","fromstruct_spf",126,151
17,2,124,1,20,"tostruct_spf@154-174@usr.sbin/bind/lib/dns/rdata/generic/spf_99.c","usr.sbin/bind/lib/dns/rdata/generic/spf_99.c","tostruct_spf",154,174
10,3,65,1,12,"freestruct_spf@177-189@usr.sbin/bind/lib/dns/rdata/generic/spf_99.c","usr.sbin/bind/lib/dns/rdata/generic/spf_99.c","freestruct_spf",177,189
7,1,35,1,8,"additionaldata_spf@192-200@usr.sbin/bind/lib/dns/rdata/generic/spf_99.c","usr.sbin/bind/lib/dns/rdata/generic/spf_99.c","additionaldata_spf",192,200
6,1,39,1,8,"digest_spf@203-211@usr.sbin/bind/lib/dns/rdata/generic/spf_99.c","usr.sbin/bind/lib/dns/rdata/generic/spf_99.c","digest_spf",203,211
8,1,38,1,10,"checkowner_spf@214-224@usr.sbin/bind/lib/dns/rdata/generic/spf_99.c","usr.sbin/bind/lib/dns/rdata/generic/spf_99.c","checkowner_spf",214,224
7,1,35,1,9,"checknames_spf@227-236@usr.sbin/bind/lib/dns/rdata/generic/spf_99.c","usr.sbin/bind/lib/dns/rdata/generic/spf_99.c","checknames_spf",227,236
21,3,153,1,34,"fromtext_sshfp@28-62@usr.sbin/bind/lib/dns/rdata/generic/sshfp_44.c","usr.sbin/bind/lib/dns/rdata/generic/sshfp_44.c","fromtext_sshfp",28,62
24,3,215,1,38,"totext_sshfp@65-103@usr.sbin/bind/lib/dns/rdata/generic/sshfp_44.c","usr.sbin/bind/lib/dns/rdata/generic/sshfp_44.c","totext_sshfp",65,103
13,2,82,1,16,"fromwire_sshfp@106-122@usr.sbin/bind/lib/dns/rdata/generic/sshfp_44.c","usr.sbin/bind/lib/dns/rdata/generic/sshfp_44.c","fromwire_sshfp",106,122
8,1,56,1,10,"towire_sshfp@125-135@usr.sbin/bind/lib/dns/rdata/generic/sshfp_44.c","usr.sbin/bind/lib/dns/rdata/generic/sshfp_44.c","towire_sshfp",125,135
12,1,89,1,13,"compare_sshfp@138-151@usr.sbin/bind/lib/dns/rdata/generic/sshfp_44.c","usr.sbin/bind/lib/dns/rdata/generic/sshfp_44.c","compare_sshfp",138,151
12,1,98,1,15,"fromstruct_sshfp@154-169@usr.sbin/bind/lib/dns/rdata/generic/sshfp_44.c","usr.sbin/bind/lib/dns/rdata/generic/sshfp_44.c","fromstruct_sshfp",154,169
21,2,163,1,26,"tostruct_sshfp@172-198@usr.sbin/bind/lib/dns/rdata/generic/sshfp_44.c","usr.sbin/bind/lib/dns/rdata/generic/sshfp_44.c","tostruct_sshfp",172,198
10,3,65,1,12,"freestruct_sshfp@201-213@usr.sbin/bind/lib/dns/rdata/generic/sshfp_44.c","usr.sbin/bind/lib/dns/rdata/generic/sshfp_44.c","freestruct_sshfp",201,213
7,1,35,1,8,"additionaldata_sshfp@216-224@usr.sbin/bind/lib/dns/rdata/generic/sshfp_44.c","usr.sbin/bind/lib/dns/rdata/generic/sshfp_44.c","additionaldata_sshfp",216,224
6,1,39,1,8,"digest_sshfp@227-235@usr.sbin/bind/lib/dns/rdata/generic/sshfp_44.c","usr.sbin/bind/lib/dns/rdata/generic/sshfp_44.c","digest_sshfp",227,235
8,1,38,1,10,"checkowner_sshfp@238-248@usr.sbin/bind/lib/dns/rdata/generic/sshfp_44.c","usr.sbin/bind/lib/dns/rdata/generic/sshfp_44.c","checkowner_sshfp",238,248
7,1,35,1,9,"checknames_sshfp@251-260@usr.sbin/bind/lib/dns/rdata/generic/sshfp_44.c","usr.sbin/bind/lib/dns/rdata/generic/sshfp_44.c","checknames_sshfp",251,260
54,9,434,1,92,"fromtext_tkey@32-124@usr.sbin/bind/lib/dns/rdata/generic/tkey_249.c","usr.sbin/bind/lib/dns/rdata/generic/tkey_249.c","fromtext_tkey",32,124
72,7,625,1,109,"totext_tkey@127-236@usr.sbin/bind/lib/dns/rdata/generic/tkey_249.c","usr.sbin/bind/lib/dns/rdata/generic/tkey_249.c","totext_tkey",127,236
32,6,247,1,53,"fromwire_tkey@239-292@usr.sbin/bind/lib/dns/rdata/generic/tkey_249.c","usr.sbin/bind/lib/dns/rdata/generic/tkey_249.c","fromwire_tkey",239,292
14,1,106,1,19,"towire_tkey@295-314@usr.sbin/bind/lib/dns/rdata/generic/tkey_249.c","usr.sbin/bind/lib/dns/rdata/generic/tkey_249.c","towire_tkey",295,314
23,2,178,1,27,"compare_tkey@317-344@usr.sbin/bind/lib/dns/rdata/generic/tkey_249.c","usr.sbin/bind/lib/dns/rdata/generic/tkey_249.c","compare_tkey",317,344
18,1,175,1,55,"fromstruct_tkey@347-402@usr.sbin/bind/lib/dns/rdata/generic/tkey_249.c","usr.sbin/bind/lib/dns/rdata/generic/tkey_249.c","fromstruct_tkey",347,402
44,6,367,1,84,"tostruct_tkey@405-489@usr.sbin/bind/lib/dns/rdata/generic/tkey_249.c","usr.sbin/bind/lib/dns/rdata/generic/tkey_249.c","tostruct_tkey",405,489
12,4,89,1,14,"freestruct_tkey@492-506@usr.sbin/bind/lib/dns/rdata/generic/tkey_249.c","usr.sbin/bind/lib/dns/rdata/generic/tkey_249.c","freestruct_tkey",492,506
7,1,35,1,8,"additionaldata_tkey@509-517@usr.sbin/bind/lib/dns/rdata/generic/tkey_249.c","usr.sbin/bind/lib/dns/rdata/generic/tkey_249.c","additionaldata_tkey",509,517
7,1,35,1,8,"digest_tkey@520-528@usr.sbin/bind/lib/dns/rdata/generic/tkey_249.c","usr.sbin/bind/lib/dns/rdata/generic/tkey_249.c","digest_tkey",520,528
8,1,38,1,10,"checkowner_tkey@531-541@usr.sbin/bind/lib/dns/rdata/generic/tkey_249.c","usr.sbin/bind/lib/dns/rdata/generic/tkey_249.c","checkowner_tkey",531,541
7,1,35,1,9,"checknames_tkey@544-553@usr.sbin/bind/lib/dns/rdata/generic/tkey_249.c","usr.sbin/bind/lib/dns/rdata/generic/tkey_249.c","checknames_tkey",544,553
25,4,186,1,42,"fromtext_tlsa@27-69@usr.sbin/bind/lib/dns/rdata/generic/tlsa_52.c","usr.sbin/bind/lib/dns/rdata/generic/tlsa_52.c","fromtext_tlsa",27,69
32,4,273,1,50,"totext_tlsa@72-122@usr.sbin/bind/lib/dns/rdata/generic/tlsa_52.c","usr.sbin/bind/lib/dns/rdata/generic/tlsa_52.c","totext_tlsa",72,122
13,2,82,1,17,"fromwire_tlsa@125-142@usr.sbin/bind/lib/dns/rdata/generic/tlsa_52.c","usr.sbin/bind/lib/dns/rdata/generic/tlsa_52.c","fromwire_tlsa",125,142
8,1,56,1,10,"towire_tlsa@145-155@usr.sbin/bind/lib/dns/rdata/generic/tlsa_52.c","usr.sbin/bind/lib/dns/rdata/generic/tlsa_52.c","towire_tlsa",145,155
12,1,89,1,13,"compare_tlsa@158-171@usr.sbin/bind/lib/dns/rdata/generic/tlsa_52.c","usr.sbin/bind/lib/dns/rdata/generic/tlsa_52.c","compare_tlsa",158,171
13,1,110,1,16,"fromstruct_tlsa@174-190@usr.sbin/bind/lib/dns/rdata/generic/tlsa_52.c","usr.sbin/bind/lib/dns/rdata/generic/tlsa_52.c","fromstruct_tlsa",174,190
23,2,181,1,28,"tostruct_tlsa@193-221@usr.sbin/bind/lib/dns/rdata/generic/tlsa_52.c","usr.sbin/bind/lib/dns/rdata/generic/tlsa_52.c","tostruct_tlsa",193,221
10,3,65,1,12,"freestruct_tlsa@224-236@usr.sbin/bind/lib/dns/rdata/generic/tlsa_52.c","usr.sbin/bind/lib/dns/rdata/generic/tlsa_52.c","freestruct_tlsa",224,236
7,1,35,1,8,"additionaldata_tlsa@239-247@usr.sbin/bind/lib/dns/rdata/generic/tlsa_52.c","usr.sbin/bind/lib/dns/rdata/generic/tlsa_52.c","additionaldata_tlsa",239,247
6,1,39,1,8,"digest_tlsa@250-258@usr.sbin/bind/lib/dns/rdata/generic/tlsa_52.c","usr.sbin/bind/lib/dns/rdata/generic/tlsa_52.c","digest_tlsa",250,258
8,1,38,1,10,"checkowner_tlsa@261-271@usr.sbin/bind/lib/dns/rdata/generic/tlsa_52.c","usr.sbin/bind/lib/dns/rdata/generic/tlsa_52.c","checkowner_tlsa",261,271
7,1,35,1,9,"checknames_tlsa@274-283@usr.sbin/bind/lib/dns/rdata/generic/tlsa_52.c","usr.sbin/bind/lib/dns/rdata/generic/tlsa_52.c","checknames_tlsa",274,283
3,1,16,1,2,"casecompare_tlsa@286-288@usr.sbin/bind/lib/dns/rdata/generic/tlsa_52.c","usr.sbin/bind/lib/dns/rdata/generic/tlsa_52.c","casecompare_tlsa",286,288
23,5,123,1,26,"fromtext_txt@28-54@usr.sbin/bind/lib/dns/rdata/generic/txt_16.c","usr.sbin/bind/lib/dns/rdata/generic/txt_16.c","fromtext_txt",28,54
12,3,75,1,16,"totext_txt@57-73@usr.sbin/bind/lib/dns/rdata/generic/txt_16.c","usr.sbin/bind/lib/dns/rdata/generic/txt_16.c","totext_txt",57,73
14,3,73,1,16,"fromwire_txt@76-92@usr.sbin/bind/lib/dns/rdata/generic/txt_16.c","usr.sbin/bind/lib/dns/rdata/generic/txt_16.c","fromwire_txt",76,92
11,2,75,1,14,"towire_txt@95-109@usr.sbin/bind/lib/dns/rdata/generic/txt_16.c","usr.sbin/bind/lib/dns/rdata/generic/txt_16.c","towire_txt",95,109
10,1,71,1,11,"compare_txt@112-123@usr.sbin/bind/lib/dns/rdata/generic/txt_16.c","usr.sbin/bind/lib/dns/rdata/generic/txt_16.c","compare_txt",112,123
22,4,158,1,25,"fromstruct_txt@126-151@usr.sbin/bind/lib/dns/rdata/generic/txt_16.c","usr.sbin/bind/lib/dns/rdata/generic/txt_16.c","fromstruct_txt",126,151
17,2,124,1,20,"tostruct_txt@154-174@usr.sbin/bind/lib/dns/rdata/generic/txt_16.c","usr.sbin/bind/lib/dns/rdata/generic/txt_16.c","tostruct_txt",154,174
10,3,65,1,12,"freestruct_txt@177-189@usr.sbin/bind/lib/dns/rdata/generic/txt_16.c","usr.sbin/bind/lib/dns/rdata/generic/txt_16.c","freestruct_txt",177,189
7,1,35,1,8,"additionaldata_txt@192-200@usr.sbin/bind/lib/dns/rdata/generic/txt_16.c","usr.sbin/bind/lib/dns/rdata/generic/txt_16.c","additionaldata_txt",192,200
6,1,39,1,8,"digest_txt@203-211@usr.sbin/bind/lib/dns/rdata/generic/txt_16.c","usr.sbin/bind/lib/dns/rdata/generic/txt_16.c","digest_txt",203,211
8,1,38,1,10,"checkowner_txt@214-224@usr.sbin/bind/lib/dns/rdata/generic/txt_16.c","usr.sbin/bind/lib/dns/rdata/generic/txt_16.c","checkowner_txt",214,224
7,1,35,1,9,"checknames_txt@227-236@usr.sbin/bind/lib/dns/rdata/generic/txt_16.c","usr.sbin/bind/lib/dns/rdata/generic/txt_16.c","checknames_txt",227,236
9,1,48,1,11,"fromtext_unspec@26-37@usr.sbin/bind/lib/dns/rdata/generic/unspec_103.c","usr.sbin/bind/lib/dns/rdata/generic/unspec_103.c","fromtext_unspec",26,37
5,1,36,1,7,"totext_unspec@40-47@usr.sbin/bind/lib/dns/rdata/generic/unspec_103.c","usr.sbin/bind/lib/dns/rdata/generic/unspec_103.c","totext_unspec",40,47
11,1,69,1,13,"fromwire_unspec@50-63@usr.sbin/bind/lib/dns/rdata/generic/unspec_103.c","usr.sbin/bind/lib/dns/rdata/generic/unspec_103.c","fromwire_unspec",50,63
5,1,36,1,7,"towire_unspec@66-73@usr.sbin/bind/lib/dns/rdata/generic/unspec_103.c","usr.sbin/bind/lib/dns/rdata/generic/unspec_103.c","towire_unspec",66,73
10,1,71,1,11,"compare_unspec@76-87@usr.sbin/bind/lib/dns/rdata/generic/unspec_103.c","usr.sbin/bind/lib/dns/rdata/generic/unspec_103.c","compare_unspec",76,87
11,2,89,1,13,"fromstruct_unspec@90-103@usr.sbin/bind/lib/dns/rdata/generic/unspec_103.c","usr.sbin/bind/lib/dns/rdata/generic/unspec_103.c","fromstruct_unspec",90,103
16,2,118,1,19,"tostruct_unspec@106-125@usr.sbin/bind/lib/dns/rdata/generic/unspec_103.c","usr.sbin/bind/lib/dns/rdata/generic/unspec_103.c","tostruct_unspec",106,125
10,3,65,1,12,"freestruct_unspec@128-140@usr.sbin/bind/lib/dns/rdata/generic/unspec_103.c","usr.sbin/bind/lib/dns/rdata/generic/unspec_103.c","freestruct_unspec",128,140
7,1,35,1,8,"additionaldata_unspec@143-151@usr.sbin/bind/lib/dns/rdata/generic/unspec_103.c","usr.sbin/bind/lib/dns/rdata/generic/unspec_103.c","additionaldata_unspec",143,151
6,1,39,1,8,"digest_unspec@154-162@usr.sbin/bind/lib/dns/rdata/generic/unspec_103.c","usr.sbin/bind/lib/dns/rdata/generic/unspec_103.c","digest_unspec",154,162
8,1,38,1,10,"checkowner_unspec@165-175@usr.sbin/bind/lib/dns/rdata/generic/unspec_103.c","usr.sbin/bind/lib/dns/rdata/generic/unspec_103.c","checkowner_unspec",165,175
7,1,35,1,9,"checknames_unspec@178-187@usr.sbin/bind/lib/dns/rdata/generic/unspec_103.c","usr.sbin/bind/lib/dns/rdata/generic/unspec_103.c","checknames_unspec",178,187
19,4,140,1,21,"fromtext_x25@30-51@usr.sbin/bind/lib/dns/rdata/generic/x25_19.c","usr.sbin/bind/lib/dns/rdata/generic/x25_19.c","fromtext_x25",30,51
8,1,51,1,10,"totext_x25@54-64@usr.sbin/bind/lib/dns/rdata/generic/x25_19.c","usr.sbin/bind/lib/dns/rdata/generic/x25_19.c","totext_x25",54,64
12,2,67,1,14,"fromwire_x25@67-81@usr.sbin/bind/lib/dns/rdata/generic/x25_19.c","usr.sbin/bind/lib/dns/rdata/generic/x25_19.c","fromwire_x25",67,81
6,1,45,1,7,"towire_x25@84-91@usr.sbin/bind/lib/dns/rdata/generic/x25_19.c","usr.sbin/bind/lib/dns/rdata/generic/x25_19.c","towire_x25",84,91
12,1,89,1,13,"compare_x25@94-107@usr.sbin/bind/lib/dns/rdata/generic/x25_19.c","usr.sbin/bind/lib/dns/rdata/generic/x25_19.c","compare_x25",94,107
18,5,152,1,22,"fromstruct_x25@110-132@usr.sbin/bind/lib/dns/rdata/generic/x25_19.c","usr.sbin/bind/lib/dns/rdata/generic/x25_19.c","fromstruct_x25",110,132
18,2,137,1,21,"tostruct_x25@135-156@usr.sbin/bind/lib/dns/rdata/generic/x25_19.c","usr.sbin/bind/lib/dns/rdata/generic/x25_19.c","tostruct_x25",135,156
10,3,65,1,11,"freestruct_x25@159-170@usr.sbin/bind/lib/dns/rdata/generic/x25_19.c","usr.sbin/bind/lib/dns/rdata/generic/x25_19.c","freestruct_x25",159,170
7,1,35,1,8,"additionaldata_x25@173-181@usr.sbin/bind/lib/dns/rdata/generic/x25_19.c","usr.sbin/bind/lib/dns/rdata/generic/x25_19.c","additionaldata_x25",173,181
6,1,39,1,8,"digest_x25@184-192@usr.sbin/bind/lib/dns/rdata/generic/x25_19.c","usr.sbin/bind/lib/dns/rdata/generic/x25_19.c","digest_x25",184,192
8,1,38,1,10,"checkowner_x25@195-205@usr.sbin/bind/lib/dns/rdata/generic/x25_19.c","usr.sbin/bind/lib/dns/rdata/generic/x25_19.c","checkowner_x25",195,205
7,1,35,1,9,"checknames_x25@208-217@usr.sbin/bind/lib/dns/rdata/generic/x25_19.c","usr.sbin/bind/lib/dns/rdata/generic/x25_19.c","checknames_x25",208,217
21,3,134,1,24,"fromtext_hs_a@30-54@usr.sbin/bind/lib/dns/rdata/hs_4/a_1.c","usr.sbin/bind/lib/dns/rdata/hs_4/a_1.c","fromtext_hs_a",30,54
9,1,62,1,11,"totext_hs_a@57-68@usr.sbin/bind/lib/dns/rdata/hs_4/a_1.c","usr.sbin/bind/lib/dns/rdata/hs_4/a_1.c","totext_hs_a",57,68
20,3,120,1,23,"fromwire_hs_a@71-94@usr.sbin/bind/lib/dns/rdata/hs_4/a_1.c","usr.sbin/bind/lib/dns/rdata/hs_4/a_1.c","fromwire_hs_a",71,94
13,2,91,1,15,"towire_hs_a@97-112@usr.sbin/bind/lib/dns/rdata/hs_4/a_1.c","usr.sbin/bind/lib/dns/rdata/hs_4/a_1.c","towire_hs_a",97,112
13,3,106,1,15,"compare_hs_a@115-130@usr.sbin/bind/lib/dns/rdata/hs_4/a_1.c","usr.sbin/bind/lib/dns/rdata/hs_4/a_1.c","compare_hs_a",115,130
13,1,89,1,16,"fromstruct_hs_a@133-149@usr.sbin/bind/lib/dns/rdata/hs_4/a_1.c","usr.sbin/bind/lib/dns/rdata/hs_4/a_1.c","fromstruct_hs_a",133,149
16,1,112,1,20,"tostruct_hs_a@152-172@usr.sbin/bind/lib/dns/rdata/hs_4/a_1.c","usr.sbin/bind/lib/dns/rdata/hs_4/a_1.c","tostruct_hs_a",152,172
4,1,18,1,4,"freestruct_hs_a@175-179@usr.sbin/bind/lib/dns/rdata/hs_4/a_1.c","usr.sbin/bind/lib/dns/rdata/hs_4/a_1.c","freestruct_hs_a",175,179
8,1,44,1,9,"additionaldata_hs_a@182-191@usr.sbin/bind/lib/dns/rdata/hs_4/a_1.c","usr.sbin/bind/lib/dns/rdata/hs_4/a_1.c","additionaldata_hs_a",182,191
7,1,48,1,9,"digest_hs_a@194-203@usr.sbin/bind/lib/dns/rdata/hs_4/a_1.c","usr.sbin/bind/lib/dns/rdata/hs_4/a_1.c","digest_hs_a",194,203
9,1,45,1,11,"checkowner_hs_a@206-217@usr.sbin/bind/lib/dns/rdata/hs_4/a_1.c","usr.sbin/bind/lib/dns/rdata/hs_4/a_1.c","checkowner_hs_a",206,217
8,1,44,1,10,"checknames_hs_a@220-230@usr.sbin/bind/lib/dns/rdata/hs_4/a_1.c","usr.sbin/bind/lib/dns/rdata/hs_4/a_1.c","checknames_hs_a",220,230
48,11,350,1,66,"fromtext_in_a6@30-96@usr.sbin/bind/lib/dns/rdata/in_1/a6_38.c","usr.sbin/bind/lib/dns/rdata/in_1/a6_38.c","fromtext_in_a6",30,96
40,3,314,1,44,"totext_in_a6@99-143@usr.sbin/bind/lib/dns/rdata/in_1/a6_38.c","usr.sbin/bind/lib/dns/rdata/in_1/a6_38.c","totext_in_a6",99,143
34,6,230,1,46,"fromwire_in_a6@146-192@usr.sbin/bind/lib/dns/rdata/in_1/a6_38.c","usr.sbin/bind/lib/dns/rdata/in_1/a6_38.c","fromwire_in_a6",146,192
22,2,154,1,26,"towire_in_a6@195-221@usr.sbin/bind/lib/dns/rdata/in_1/a6_38.c","usr.sbin/bind/lib/dns/rdata/in_1/a6_38.c","towire_in_a6",195,221
42,7,291,1,51,"compare_in_a6@224-275@usr.sbin/bind/lib/dns/rdata/in_1/a6_38.c","usr.sbin/bind/lib/dns/rdata/in_1/a6_38.c","compare_in_a6",224,275
36,6,237,1,42,"fromstruct_in_a6@278-320@usr.sbin/bind/lib/dns/rdata/in_1/a6_38.c","usr.sbin/bind/lib/dns/rdata/in_1/a6_38.c","fromstruct_in_a6",278,320
31,3,252,1,42,"tostruct_in_a6@323-365@usr.sbin/bind/lib/dns/rdata/in_1/a6_38.c","usr.sbin/bind/lib/dns/rdata/in_1/a6_38.c","tostruct_in_a6",323,365
11,3,79,1,13,"freestruct_in_a6@368-381@usr.sbin/bind/lib/dns/rdata/in_1/a6_38.c","usr.sbin/bind/lib/dns/rdata/in_1/a6_38.c","freestruct_in_a6",368,381
8,1,44,1,9,"additionaldata_in_a6@384-393@usr.sbin/bind/lib/dns/rdata/in_1/a6_38.c","usr.sbin/bind/lib/dns/rdata/in_1/a6_38.c","additionaldata_in_a6",384,393
22,3,150,1,25,"digest_in_a6@396-421@usr.sbin/bind/lib/dns/rdata/in_1/a6_38.c","usr.sbin/bind/lib/dns/rdata/in_1/a6_38.c","digest_in_a6",396,421
7,1,40,1,9,"checkowner_in_a6@424-433@usr.sbin/bind/lib/dns/rdata/in_1/a6_38.c","usr.sbin/bind/lib/dns/rdata/in_1/a6_38.c","checkowner_in_a6",424,433
21,4,134,1,23,"checknames_in_a6@436-459@usr.sbin/bind/lib/dns/rdata/in_1/a6_38.c","usr.sbin/bind/lib/dns/rdata/in_1/a6_38.c","checknames_in_a6",436,459
21,3,134,1,24,"fromtext_in_a@32-56@usr.sbin/bind/lib/dns/rdata/in_1/a_1.c","usr.sbin/bind/lib/dns/rdata/in_1/a_1.c","fromtext_in_a",32,56
9,1,62,1,11,"totext_in_a@59-70@usr.sbin/bind/lib/dns/rdata/in_1/a_1.c","usr.sbin/bind/lib/dns/rdata/in_1/a_1.c","totext_in_a",59,70
20,3,120,1,23,"fromwire_in_a@73-96@usr.sbin/bind/lib/dns/rdata/in_1/a_1.c","usr.sbin/bind/lib/dns/rdata/in_1/a_1.c","fromwire_in_a",73,96
13,2,91,1,15,"towire_in_a@99-114@usr.sbin/bind/lib/dns/rdata/in_1/a_1.c","usr.sbin/bind/lib/dns/rdata/in_1/a_1.c","towire_in_a",99,114
13,1,98,1,14,"compare_in_a@117-131@usr.sbin/bind/lib/dns/rdata/in_1/a_1.c","usr.sbin/bind/lib/dns/rdata/in_1/a_1.c","compare_in_a",117,131
13,1,89,1,16,"fromstruct_in_a@134-150@usr.sbin/bind/lib/dns/rdata/in_1/a_1.c","usr.sbin/bind/lib/dns/rdata/in_1/a_1.c","fromstruct_in_a",134,150
16,1,112,1,20,"tostruct_in_a@154-174@usr.sbin/bind/lib/dns/rdata/in_1/a_1.c","usr.sbin/bind/lib/dns/rdata/in_1/a_1.c","tostruct_in_a",154,174
7,1,46,1,8,"freestruct_in_a@177-185@usr.sbin/bind/lib/dns/rdata/in_1/a_1.c","usr.sbin/bind/lib/dns/rdata/in_1/a_1.c","freestruct_in_a",177,185
8,1,44,1,9,"additionaldata_in_a@188-197@usr.sbin/bind/lib/dns/rdata/in_1/a_1.c","usr.sbin/bind/lib/dns/rdata/in_1/a_1.c","additionaldata_in_a",188,197
7,1,48,1,9,"digest_in_a@200-209@usr.sbin/bind/lib/dns/rdata/in_1/a_1.c","usr.sbin/bind/lib/dns/rdata/in_1/a_1.c","digest_in_a",200,209
7,1,40,1,9,"checkowner_in_a@212-221@usr.sbin/bind/lib/dns/rdata/in_1/a_1.c","usr.sbin/bind/lib/dns/rdata/in_1/a_1.c","checkowner_in_a",212,221
8,1,44,1,10,"checknames_in_a@224-234@usr.sbin/bind/lib/dns/rdata/in_1/a_1.c","usr.sbin/bind/lib/dns/rdata/in_1/a_1.c","checknames_in_a",224,234
22,3,138,1,25,"fromtext_in_aaaa@32-57@usr.sbin/bind/lib/dns/rdata/in_1/aaaa_28.c","usr.sbin/bind/lib/dns/rdata/in_1/aaaa_28.c","fromtext_in_aaaa",32,57
9,1,62,1,11,"totext_in_aaaa@60-71@usr.sbin/bind/lib/dns/rdata/in_1/aaaa_28.c","usr.sbin/bind/lib/dns/rdata/in_1/aaaa_28.c","totext_in_aaaa",60,71
20,3,120,1,23,"fromwire_in_aaaa@74-97@usr.sbin/bind/lib/dns/rdata/in_1/aaaa_28.c","usr.sbin/bind/lib/dns/rdata/in_1/aaaa_28.c","fromwire_in_aaaa",74,97
13,2,91,1,15,"towire_in_aaaa@100-115@usr.sbin/bind/lib/dns/rdata/in_1/aaaa_28.c","usr.sbin/bind/lib/dns/rdata/in_1/aaaa_28.c","towire_in_aaaa",100,115
13,1,98,1,14,"compare_in_aaaa@118-132@usr.sbin/bind/lib/dns/rdata/in_1/aaaa_28.c","usr.sbin/bind/lib/dns/rdata/in_1/aaaa_28.c","compare_in_aaaa",118,132
11,1,81,1,13,"fromstruct_in_aaaa@135-148@usr.sbin/bind/lib/dns/rdata/in_1/aaaa_28.c","usr.sbin/bind/lib/dns/rdata/in_1/aaaa_28.c","fromstruct_in_aaaa",135,148
16,1,121,1,20,"tostruct_in_aaaa@151-171@usr.sbin/bind/lib/dns/rdata/in_1/aaaa_28.c","usr.sbin/bind/lib/dns/rdata/in_1/aaaa_28.c","tostruct_in_aaaa",151,171
7,1,46,1,8,"freestruct_in_aaaa@174-182@usr.sbin/bind/lib/dns/rdata/in_1/aaaa_28.c","usr.sbin/bind/lib/dns/rdata/in_1/aaaa_28.c","freestruct_in_aaaa",174,182
8,1,44,1,9,"additionaldata_in_aaaa@185-194@usr.sbin/bind/lib/dns/rdata/in_1/aaaa_28.c","usr.sbin/bind/lib/dns/rdata/in_1/aaaa_28.c","additionaldata_in_aaaa",185,194
7,1,48,1,9,"digest_in_aaaa@197-206@usr.sbin/bind/lib/dns/rdata/in_1/aaaa_28.c","usr.sbin/bind/lib/dns/rdata/in_1/aaaa_28.c","digest_in_aaaa",197,206
7,1,40,1,9,"checkowner_in_aaaa@209-218@usr.sbin/bind/lib/dns/rdata/in_1/aaaa_28.c","usr.sbin/bind/lib/dns/rdata/in_1/aaaa_28.c","checkowner_in_aaaa",209,218
8,1,44,1,10,"checknames_in_aaaa@221-231@usr.sbin/bind/lib/dns/rdata/in_1/aaaa_28.c","usr.sbin/bind/lib/dns/rdata/in_1/aaaa_28.c","checknames_in_aaaa",221,231
70,20,443,1,80,"fromtext_in_apl@28-108@usr.sbin/bind/lib/dns/rdata/in_1/apl_42.c","usr.sbin/bind/lib/dns/rdata/in_1/apl_42.c","fromtext_in_apl",28,108
57,7,426,1,62,"totext_in_apl@111-173@usr.sbin/bind/lib/dns/rdata/in_1/apl_42.c","usr.sbin/bind/lib/dns/rdata/in_1/apl_42.c","totext_in_apl",111,173
44,13,277,1,48,"fromwire_in_apl@176-224@usr.sbin/bind/lib/dns/rdata/in_1/apl_42.c","usr.sbin/bind/lib/dns/rdata/in_1/apl_42.c","fromwire_in_apl",176,224
6,1,45,1,7,"towire_in_apl@227-234@usr.sbin/bind/lib/dns/rdata/in_1/apl_42.c","usr.sbin/bind/lib/dns/rdata/in_1/apl_42.c","towire_in_apl",227,234
11,1,80,1,12,"compare_in_apl@237-249@usr.sbin/bind/lib/dns/rdata/in_1/apl_42.c","usr.sbin/bind/lib/dns/rdata/in_1/apl_42.c","compare_in_apl",237,249
14,2,126,1,15,"fromstruct_in_apl@252-267@usr.sbin/bind/lib/dns/rdata/in_1/apl_42.c","usr.sbin/bind/lib/dns/rdata/in_1/apl_42.c","fromstruct_in_apl",252,267
17,2,126,1,20,"tostruct_in_apl@270-290@usr.sbin/bind/lib/dns/rdata/in_1/apl_42.c","usr.sbin/bind/lib/dns/rdata/in_1/apl_42.c","tostruct_in_apl",270,290
11,3,76,1,12,"freestruct_in_apl@293-305@usr.sbin/bind/lib/dns/rdata/in_1/apl_42.c","usr.sbin/bind/lib/dns/rdata/in_1/apl_42.c","freestruct_in_apl",293,305
7,3,66,1,7,"dns_rdata_apl_first@308-315@usr.sbin/bind/lib/dns/rdata/in_1/apl_42.c","usr.sbin/bind/lib/dns/rdata/in_1/apl_42.c","dns_rdata_apl_first",308,315
9,4,96,1,9,"dns_rdata_apl_next@318-327@usr.sbin/bind/lib/dns/rdata/in_1/apl_42.c","usr.sbin/bind/lib/dns/rdata/in_1/apl_42.c","dns_rdata_apl_next",318,327
17,4,192,2,19,"dns_rdata_apl_current@330-349@usr.sbin/bind/lib/dns/rdata/in_1/apl_42.c","usr.sbin/bind/lib/dns/rdata/in_1/apl_42.c","dns_rdata_apl_current",330,349
7,1,39,1,8,"additionaldata_in_apl@352-360@usr.sbin/bind/lib/dns/rdata/in_1/apl_42.c","usr.sbin/bind/lib/dns/rdata/in_1/apl_42.c","additionaldata_in_apl",352,360
7,1,48,1,9,"digest_in_apl@363-372@usr.sbin/bind/lib/dns/rdata/in_1/apl_42.c","usr.sbin/bind/lib/dns/rdata/in_1/apl_42.c","digest_in_apl",363,372
9,1,45,1,11,"checkowner_in_apl@375-386@usr.sbin/bind/lib/dns/rdata/in_1/apl_42.c","usr.sbin/bind/lib/dns/rdata/in_1/apl_42.c","checkowner_in_apl",375,386
8,1,44,1,10,"checknames_in_apl@390-400@usr.sbin/bind/lib/dns/rdata/in_1/apl_42.c","usr.sbin/bind/lib/dns/rdata/in_1/apl_42.c","checknames_in_apl",390,400
22,3,159,1,25,"fromtext_in_kx@30-55@usr.sbin/bind/lib/dns/rdata/in_1/kx_36.c","usr.sbin/bind/lib/dns/rdata/in_1/kx_36.c","fromtext_in_kx",30,55
22,1,169,1,26,"totext_in_kx@58-84@usr.sbin/bind/lib/dns/rdata/in_1/kx_36.c","usr.sbin/bind/lib/dns/rdata/in_1/kx_36.c","totext_in_kx",58,84
16,2,110,1,20,"fromwire_in_kx@87-107@usr.sbin/bind/lib/dns/rdata/in_1/kx_36.c","usr.sbin/bind/lib/dns/rdata/in_1/kx_36.c","fromwire_in_kx",87,107
15,1,109,1,18,"towire_in_kx@110-128@usr.sbin/bind/lib/dns/rdata/in_1/kx_36.c","usr.sbin/bind/lib/dns/rdata/in_1/kx_36.c","towire_in_kx",110,128
25,3,190,1,31,"compare_in_kx@131-162@usr.sbin/bind/lib/dns/rdata/in_1/kx_36.c","usr.sbin/bind/lib/dns/rdata/in_1/kx_36.c","compare_in_kx",131,162
14,1,102,1,16,"fromstruct_in_kx@165-181@usr.sbin/bind/lib/dns/rdata/in_1/kx_36.c","usr.sbin/bind/lib/dns/rdata/in_1/kx_36.c","fromstruct_in_kx",165,181
21,1,162,1,25,"tostruct_in_kx@184-209@usr.sbin/bind/lib/dns/rdata/in_1/kx_36.c","usr.sbin/bind/lib/dns/rdata/in_1/kx_36.c","tostruct_in_kx",184,209
10,2,69,1,12,"freestruct_in_kx@212-224@usr.sbin/bind/lib/dns/rdata/in_1/kx_36.c","usr.sbin/bind/lib/dns/rdata/in_1/kx_36.c","freestruct_in_kx",212,224
12,1,81,1,14,"additionaldata_in_kx@227-241@usr.sbin/bind/lib/dns/rdata/in_1/kx_36.c","usr.sbin/bind/lib/dns/rdata/in_1/kx_36.c","additionaldata_in_kx",227,241
14,1,101,1,15,"digest_in_kx@244-259@usr.sbin/bind/lib/dns/rdata/in_1/kx_36.c","usr.sbin/bind/lib/dns/rdata/in_1/kx_36.c","digest_in_kx",244,259
9,1,45,1,11,"checkowner_in_kx@262-273@usr.sbin/bind/lib/dns/rdata/in_1/kx_36.c","usr.sbin/bind/lib/dns/rdata/in_1/kx_36.c","checkowner_in_kx",262,273
8,1,44,1,10,"checknames_in_kx@276-286@usr.sbin/bind/lib/dns/rdata/in_1/kx_36.c","usr.sbin/bind/lib/dns/rdata/in_1/kx_36.c","checknames_in_kx",276,286
36,4,293,1,61,"fromtext_in_naptr@30-91@usr.sbin/bind/lib/dns/rdata/in_1/naptr_35.c","usr.sbin/bind/lib/dns/rdata/in_1/naptr_35.c","fromtext_in_naptr",30,91
33,1,282,1,59,"totext_in_naptr@94-153@usr.sbin/bind/lib/dns/rdata/in_1/naptr_35.c","usr.sbin/bind/lib/dns/rdata/in_1/naptr_35.c","totext_in_naptr",94,153
19,2,140,1,42,"fromwire_in_naptr@156-198@usr.sbin/bind/lib/dns/rdata/in_1/naptr_35.c","usr.sbin/bind/lib/dns/rdata/in_1/naptr_35.c","fromwire_in_naptr",156,198
21,1,217,1,41,"towire_in_naptr@201-242@usr.sbin/bind/lib/dns/rdata/in_1/naptr_35.c","usr.sbin/bind/lib/dns/rdata/in_1/naptr_35.c","towire_in_naptr",201,242
43,9,444,1,66,"compare_in_naptr@245-311@usr.sbin/bind/lib/dns/rdata/in_1/naptr_35.c","usr.sbin/bind/lib/dns/rdata/in_1/naptr_35.c","compare_in_naptr",245,311
24,4,243,1,26,"fromstruct_in_naptr@314-340@usr.sbin/bind/lib/dns/rdata/in_1/naptr_35.c","usr.sbin/bind/lib/dns/rdata/in_1/naptr_35.c","fromstruct_in_naptr",314,340
58,11,480,1,68,"tostruct_in_naptr@343-411@usr.sbin/bind/lib/dns/rdata/in_1/naptr_35.c","usr.sbin/bind/lib/dns/rdata/in_1/naptr_35.c","tostruct_in_naptr",343,411
16,5,126,1,18,"freestruct_in_naptr@414-432@usr.sbin/bind/lib/dns/rdata/in_1/naptr_35.c","usr.sbin/bind/lib/dns/rdata/in_1/naptr_35.c","freestruct_in_naptr",414,432
33,7,230,1,55,"additionaldata_in_naptr@435-490@usr.sbin/bind/lib/dns/rdata/in_1/naptr_35.c","usr.sbin/bind/lib/dns/rdata/in_1/naptr_35.c","additionaldata_in_naptr",435,490
29,2,197,1,56,"digest_in_naptr@493-549@usr.sbin/bind/lib/dns/rdata/in_1/naptr_35.c","usr.sbin/bind/lib/dns/rdata/in_1/naptr_35.c","digest_in_naptr",493,549
9,1,45,1,11,"checkowner_in_naptr@552-563@usr.sbin/bind/lib/dns/rdata/in_1/naptr_35.c","usr.sbin/bind/lib/dns/rdata/in_1/naptr_35.c","checkowner_in_naptr",552,563
8,1,44,1,10,"checknames_in_naptr@566-576@usr.sbin/bind/lib/dns/rdata/in_1/naptr_35.c","usr.sbin/bind/lib/dns/rdata/in_1/naptr_35.c","checknames_in_naptr",566,576
17,2,115,1,20,"fromtext_in_nsap_ptr@30-50@usr.sbin/bind/lib/dns/rdata/in_1/nsap-ptr_23.c","usr.sbin/bind/lib/dns/rdata/in_1/nsap-ptr_23.c","fromtext_in_nsap_ptr",30,50
15,1,106,1,19,"totext_in_nsap_ptr@53-72@usr.sbin/bind/lib/dns/rdata/in_1/nsap-ptr_23.c","usr.sbin/bind/lib/dns/rdata/in_1/nsap-ptr_23.c","totext_in_nsap_ptr",53,72
10,1,65,1,13,"fromwire_in_nsap_ptr@75-88@usr.sbin/bind/lib/dns/rdata/in_1/nsap-ptr_23.c","usr.sbin/bind/lib/dns/rdata/in_1/nsap-ptr_23.c","fromwire_in_nsap_ptr",75,88
13,1,87,1,15,"towire_in_nsap_ptr@91-106@usr.sbin/bind/lib/dns/rdata/in_1/nsap-ptr_23.c","usr.sbin/bind/lib/dns/rdata/in_1/nsap-ptr_23.c","towire_in_nsap_ptr",91,106
19,1,138,1,23,"compare_in_nsap_ptr@109-132@usr.sbin/bind/lib/dns/rdata/in_1/nsap-ptr_23.c","usr.sbin/bind/lib/dns/rdata/in_1/nsap-ptr_23.c","compare_in_nsap_ptr",109,132
13,1,90,1,15,"fromstruct_in_nsap_ptr@135-150@usr.sbin/bind/lib/dns/rdata/in_1/nsap-ptr_23.c","usr.sbin/bind/lib/dns/rdata/in_1/nsap-ptr_23.c","fromstruct_in_nsap_ptr",135,150
19,1,144,1,21,"tostruct_in_nsap_ptr@153-174@usr.sbin/bind/lib/dns/rdata/in_1/nsap-ptr_23.c","usr.sbin/bind/lib/dns/rdata/in_1/nsap-ptr_23.c","tostruct_in_nsap_ptr",153,174
10,2,69,1,12,"freestruct_in_nsap_ptr@177-189@usr.sbin/bind/lib/dns/rdata/in_1/nsap-ptr_23.c","usr.sbin/bind/lib/dns/rdata/in_1/nsap-ptr_23.c","freestruct_in_nsap_ptr",177,189
8,1,44,1,9,"additionaldata_in_nsap_ptr@192-201@usr.sbin/bind/lib/dns/rdata/in_1/nsap-ptr_23.c","usr.sbin/bind/lib/dns/rdata/in_1/nsap-ptr_23.c","additionaldata_in_nsap_ptr",192,201
10,1,68,1,12,"digest_in_nsap_ptr@204-216@usr.sbin/bind/lib/dns/rdata/in_1/nsap-ptr_23.c","usr.sbin/bind/lib/dns/rdata/in_1/nsap-ptr_23.c","digest_in_nsap_ptr",204,216
9,1,45,1,11,"checkowner_in_nsap_ptr@219-230@usr.sbin/bind/lib/dns/rdata/in_1/nsap-ptr_23.c","usr.sbin/bind/lib/dns/rdata/in_1/nsap-ptr_23.c","checkowner_in_nsap_ptr",219,230
8,1,44,1,10,"checknames_in_nsap_ptr@233-243@usr.sbin/bind/lib/dns/rdata/in_1/nsap-ptr_23.c","usr.sbin/bind/lib/dns/rdata/in_1/nsap-ptr_23.c","checknames_in_nsap_ptr",233,243
42,10,264,1,45,"fromtext_in_nsap@30-75@usr.sbin/bind/lib/dns/rdata/in_1/nsap_22.c","usr.sbin/bind/lib/dns/rdata/in_1/nsap_22.c","fromtext_in_nsap",30,75
16,2,120,1,18,"totext_in_nsap@78-96@usr.sbin/bind/lib/dns/rdata/in_1/nsap_22.c","usr.sbin/bind/lib/dns/rdata/in_1/nsap_22.c","totext_in_nsap",78,96
15,2,94,1,18,"fromwire_in_nsap@99-117@usr.sbin/bind/lib/dns/rdata/in_1/nsap_22.c","usr.sbin/bind/lib/dns/rdata/in_1/nsap_22.c","fromwire_in_nsap",99,117
7,1,54,1,8,"towire_in_nsap@120-128@usr.sbin/bind/lib/dns/rdata/in_1/nsap_22.c","usr.sbin/bind/lib/dns/rdata/in_1/nsap_22.c","towire_in_nsap",120,128
13,1,98,1,14,"compare_in_nsap@131-145@usr.sbin/bind/lib/dns/rdata/in_1/nsap_22.c","usr.sbin/bind/lib/dns/rdata/in_1/nsap_22.c","compare_in_nsap",131,145
12,2,96,1,14,"fromstruct_in_nsap@148-162@usr.sbin/bind/lib/dns/rdata/in_1/nsap_22.c","usr.sbin/bind/lib/dns/rdata/in_1/nsap_22.c","fromstruct_in_nsap",148,162
18,2,136,1,21,"tostruct_in_nsap@165-186@usr.sbin/bind/lib/dns/rdata/in_1/nsap_22.c","usr.sbin/bind/lib/dns/rdata/in_1/nsap_22.c","tostruct_in_nsap",165,186
11,3,76,1,13,"freestruct_in_nsap@189-202@usr.sbin/bind/lib/dns/rdata/in_1/nsap_22.c","usr.sbin/bind/lib/dns/rdata/in_1/nsap_22.c","freestruct_in_nsap",189,202
8,1,44,1,9,"additionaldata_in_nsap@205-214@usr.sbin/bind/lib/dns/rdata/in_1/nsap_22.c","usr.sbin/bind/lib/dns/rdata/in_1/nsap_22.c","additionaldata_in_nsap",205,214
7,1,48,1,9,"digest_in_nsap@217-226@usr.sbin/bind/lib/dns/rdata/in_1/nsap_22.c","usr.sbin/bind/lib/dns/rdata/in_1/nsap_22.c","digest_in_nsap",217,226
9,1,45,1,11,"checkowner_in_nsap@229-240@usr.sbin/bind/lib/dns/rdata/in_1/nsap_22.c","usr.sbin/bind/lib/dns/rdata/in_1/nsap_22.c","checkowner_in_nsap",229,240
8,1,44,1,10,"checknames_in_nsap@243-253@usr.sbin/bind/lib/dns/rdata/in_1/nsap_22.c","usr.sbin/bind/lib/dns/rdata/in_1/nsap_22.c","checknames_in_nsap",243,253
28,4,225,1,41,"fromtext_in_px@30-71@usr.sbin/bind/lib/dns/rdata/in_1/px_26.c","usr.sbin/bind/lib/dns/rdata/in_1/px_26.c","fromtext_in_px",30,71
27,1,228,1,40,"totext_in_px@74-114@usr.sbin/bind/lib/dns/rdata/in_1/px_26.c","usr.sbin/bind/lib/dns/rdata/in_1/px_26.c","totext_in_px",74,114
17,2,127,1,32,"fromwire_in_px@117-149@usr.sbin/bind/lib/dns/rdata/in_1/px_26.c","usr.sbin/bind/lib/dns/rdata/in_1/px_26.c","fromwire_in_px",117,149
19,1,151,1,31,"towire_in_px@152-183@usr.sbin/bind/lib/dns/rdata/in_1/px_26.c","usr.sbin/bind/lib/dns/rdata/in_1/px_26.c","towire_in_px",152,183
32,4,254,1,41,"compare_in_px@186-227@usr.sbin/bind/lib/dns/rdata/in_1/px_26.c","usr.sbin/bind/lib/dns/rdata/in_1/px_26.c","compare_in_px",186,227
16,1,124,1,18,"fromstruct_in_px@230-248@usr.sbin/bind/lib/dns/rdata/in_1/px_26.c","usr.sbin/bind/lib/dns/rdata/in_1/px_26.c","fromstruct_in_px",230,248
30,2,230,1,38,"tostruct_in_px@251-289@usr.sbin/bind/lib/dns/rdata/in_1/px_26.c","usr.sbin/bind/lib/dns/rdata/in_1/px_26.c","tostruct_in_px",251,289
11,2,81,1,13,"freestruct_in_px@292-305@usr.sbin/bind/lib/dns/rdata/in_1/px_26.c","usr.sbin/bind/lib/dns/rdata/in_1/px_26.c","freestruct_in_px",292,305
8,1,44,1,9,"additionaldata_in_px@308-317@usr.sbin/bind/lib/dns/rdata/in_1/px_26.c","usr.sbin/bind/lib/dns/rdata/in_1/px_26.c","additionaldata_in_px",308,317
23,3,166,1,25,"digest_in_px@320-345@usr.sbin/bind/lib/dns/rdata/in_1/px_26.c","usr.sbin/bind/lib/dns/rdata/in_1/px_26.c","digest_in_px",320,345
9,1,45,1,11,"checkowner_in_px@348-359@usr.sbin/bind/lib/dns/rdata/in_1/px_26.c","usr.sbin/bind/lib/dns/rdata/in_1/px_26.c","checkowner_in_px",348,359
8,1,44,1,10,"checknames_in_px@362-372@usr.sbin/bind/lib/dns/rdata/in_1/px_26.c","usr.sbin/bind/lib/dns/rdata/in_1/px_26.c","checknames_in_px",362,372
40,10,311,1,57,"fromtext_in_srv@30-87@usr.sbin/bind/lib/dns/rdata/in_1/srv_33.c","usr.sbin/bind/lib/dns/rdata/in_1/srv_33.c","fromtext_in_srv",30,87
32,1,269,1,49,"totext_in_srv@90-139@usr.sbin/bind/lib/dns/rdata/in_1/srv_33.c","usr.sbin/bind/lib/dns/rdata/in_1/srv_33.c","totext_in_srv",90,139
16,2,110,1,27,"fromwire_in_srv@142-169@usr.sbin/bind/lib/dns/rdata/in_1/srv_33.c","usr.sbin/bind/lib/dns/rdata/in_1/srv_33.c","fromwire_in_srv",142,169
14,1,100,1,22,"towire_in_srv@172-194@usr.sbin/bind/lib/dns/rdata/in_1/srv_33.c","usr.sbin/bind/lib/dns/rdata/in_1/srv_33.c","towire_in_srv",172,194
25,3,190,1,37,"compare_in_srv@197-234@usr.sbin/bind/lib/dns/rdata/in_1/srv_33.c","usr.sbin/bind/lib/dns/rdata/in_1/srv_33.c","compare_in_srv",197,234
16,1,126,1,18,"fromstruct_in_srv@237-255@usr.sbin/bind/lib/dns/rdata/in_1/srv_33.c","usr.sbin/bind/lib/dns/rdata/in_1/srv_33.c","fromstruct_in_srv",237,255
25,1,198,1,27,"tostruct_in_srv@258-285@usr.sbin/bind/lib/dns/rdata/in_1/srv_33.c","usr.sbin/bind/lib/dns/rdata/in_1/srv_33.c","tostruct_in_srv",258,285
10,2,69,1,12,"freestruct_in_srv@288-300@usr.sbin/bind/lib/dns/rdata/in_1/srv_33.c","usr.sbin/bind/lib/dns/rdata/in_1/srv_33.c","freestruct_in_srv",288,300
12,1,81,1,14,"additionaldata_in_srv@303-317@usr.sbin/bind/lib/dns/rdata/in_1/srv_33.c","usr.sbin/bind/lib/dns/rdata/in_1/srv_33.c","additionaldata_in_srv",303,317
14,1,101,1,15,"digest_in_srv@320-335@usr.sbin/bind/lib/dns/rdata/in_1/srv_33.c","usr.sbin/bind/lib/dns/rdata/in_1/srv_33.c","digest_in_srv",320,335
9,1,45,1,11,"checkowner_in_srv@338-349@usr.sbin/bind/lib/dns/rdata/in_1/srv_33.c","usr.sbin/bind/lib/dns/rdata/in_1/srv_33.c","checkowner_in_srv",338,349
17,3,105,1,19,"checknames_in_srv@352-371@usr.sbin/bind/lib/dns/rdata/in_1/srv_33.c","usr.sbin/bind/lib/dns/rdata/in_1/srv_33.c","checknames_in_srv",352,371
76,19,558,1,101,"fromtext_in_wks@34-135@usr.sbin/bind/lib/dns/rdata/in_1/wks_11.c","usr.sbin/bind/lib/dns/rdata/in_1/wks_11.c","fromtext_in_wks",34,135
28,5,245,1,33,"totext_in_wks@138-171@usr.sbin/bind/lib/dns/rdata/in_1/wks_11.c","usr.sbin/bind/lib/dns/rdata/in_1/wks_11.c","totext_in_wks",138,171
22,4,145,1,27,"fromwire_in_wks@174-201@usr.sbin/bind/lib/dns/rdata/in_1/wks_11.c","usr.sbin/bind/lib/dns/rdata/in_1/wks_11.c","fromwire_in_wks",174,201
9,1,65,1,11,"towire_in_wks@204-215@usr.sbin/bind/lib/dns/rdata/in_1/wks_11.c","usr.sbin/bind/lib/dns/rdata/in_1/wks_11.c","towire_in_wks",204,215
13,1,98,1,14,"compare_in_wks@218-232@usr.sbin/bind/lib/dns/rdata/in_1/wks_11.c","usr.sbin/bind/lib/dns/rdata/in_1/wks_11.c","compare_in_wks",218,232
16,2,132,1,18,"fromstruct_in_wks@235-253@usr.sbin/bind/lib/dns/rdata/in_1/wks_11.c","usr.sbin/bind/lib/dns/rdata/in_1/wks_11.c","fromstruct_in_wks",235,253
23,2,177,1,25,"tostruct_in_wks@256-281@usr.sbin/bind/lib/dns/rdata/in_1/wks_11.c","usr.sbin/bind/lib/dns/rdata/in_1/wks_11.c","tostruct_in_wks",256,281
11,3,76,1,13,"freestruct_in_wks@284-297@usr.sbin/bind/lib/dns/rdata/in_1/wks_11.c","usr.sbin/bind/lib/dns/rdata/in_1/wks_11.c","freestruct_in_wks",284,297
8,1,44,1,9,"additionaldata_in_wks@300-309@usr.sbin/bind/lib/dns/rdata/in_1/wks_11.c","usr.sbin/bind/lib/dns/rdata/in_1/wks_11.c","additionaldata_in_wks",300,309
7,1,48,1,9,"digest_in_wks@312-321@usr.sbin/bind/lib/dns/rdata/in_1/wks_11.c","usr.sbin/bind/lib/dns/rdata/in_1/wks_11.c","digest_in_wks",312,321
7,1,40,1,9,"checkowner_in_wks@324-333@usr.sbin/bind/lib/dns/rdata/in_1/wks_11.c","usr.sbin/bind/lib/dns/rdata/in_1/wks_11.c","checkowner_in_wks",324,333
8,1,44,1,10,"checknames_in_wks@336-346@usr.sbin/bind/lib/dns/rdata/in_1/wks_11.c","usr.sbin/bind/lib/dns/rdata/in_1/wks_11.c","checknames_in_wks",336,346
11,1,80,1,10,"reset_stats@269-279@usr.sbin/bind/lib/dns/acache.c","usr.sbin/bind/lib/dns/acache.c","reset_stats",269,279
6,3,35,1,6,"check_noentry@285-291@usr.sbin/bind/lib/dns/acache.c","usr.sbin/bind/lib/dns/acache.c","check_noentry",285,291
23,5,164,1,35,"shutdown_entries@297-332@usr.sbin/bind/lib/dns/acache.c","usr.sbin/bind/lib/dns/acache.c","shutdown_entries",297,332
17,4,133,1,22,"shutdown_buckets@338-360@usr.sbin/bind/lib/dns/acache.c","usr.sbin/bind/lib/dns/acache.c","shutdown_buckets",338,360
12,1,73,2,18,"shutdown_task@363-381@usr.sbin/bind/lib/dns/acache.c","usr.sbin/bind/lib/dns/acache.c","shutdown_task",363,381
18,3,131,2,20,"unlink_dbentries@385-405@usr.sbin/bind/lib/dns/acache.c","usr.sbin/bind/lib/dns/acache.c","unlink_dbentries",385,405
9,1,62,1,17,"destroy_entry@409-426@usr.sbin/bind/lib/dns/acache.c","usr.sbin/bind/lib/dns/acache.c","destroy_entry",409,426
21,5,180,1,30,"destroy@429-459@usr.sbin/bind/lib/dns/acache.c","usr.sbin/bind/lib/dns/acache.c","destroy",429,459
20,5,134,3,28,"finddbent@462-490@usr.sbin/bind/lib/dns/acache.c","usr.sbin/bind/lib/dns/acache.c","finddbent",462,490
35,9,265,2,42,"clear_entry@493-535@usr.sbin/bind/lib/dns/acache.c","usr.sbin/bind/lib/dns/acache.c","clear_entry",493,535
74,10,373,3,84,"acache_cleaner_init@538-622@usr.sbin/bind/lib/dns/acache.c","usr.sbin/bind/lib/dns/acache.c","acache_cleaner_init",538,622
22,3,151,1,34,"begin_cleaning@625-659@usr.sbin/bind/lib/dns/acache.c","usr.sbin/bind/lib/dns/acache.c","begin_cleaning",625,659
51,5,328,2,69,"end_cleaning@662-731@usr.sbin/bind/lib/dns/acache.c","usr.sbin/bind/lib/dns/acache.c","end_cleaning",662,731
11,2,74,2,15,"acache_cleaning_timer_action@738-753@usr.sbin/bind/lib/dns/acache.c","usr.sbin/bind/lib/dns/acache.c","acache_cleaning_timer_action",738,753
22,7,138,4,35,"entry_stale@757-792@usr.sbin/bind/lib/dns/acache.c","usr.sbin/bind/lib/dns/acache.c","entry_stale",757,792
76,10,473,2,108,"acache_incremental_cleaning_action@798-906@usr.sbin/bind/lib/dns/acache.c","usr.sbin/bind/lib/dns/acache.c","acache_incremental_cleaning_action",798,906
23,5,141,2,38,"acache_overmem_cleaning_action@913-951@usr.sbin/bind/lib/dns/acache.c","usr.sbin/bind/lib/dns/acache.c","acache_overmem_cleaning_action",913,951
15,3,120,2,20,"water@954-974@usr.sbin/bind/lib/dns/acache.c","usr.sbin/bind/lib/dns/acache.c","water",954,974
25,5,184,2,40,"acache_cleaner_shutdown_action@980-1020@usr.sbin/bind/lib/dns/acache.c","usr.sbin/bind/lib/dns/acache.c","acache_cleaner_shutdown_action",980,1020
91,15,635,4,107,"dns_acache_create@1027-1134@usr.sbin/bind/lib/dns/acache.c","usr.sbin/bind/lib/dns/acache.c","dns_acache_create",1027,1134
7,2,54,2,9,"dns_acache_attach@1137-1146@usr.sbin/bind/lib/dns/acache.c","usr.sbin/bind/lib/dns/acache.c","dns_acache_attach",1137,1146
4,1,22,1,3,"dns_acache_countquerymiss@1149-1152@usr.sbin/bind/lib/dns/acache.c","usr.sbin/bind/lib/dns/acache.c","dns_acache_countquerymiss",1149,1152
20,6,114,1,28,"dns_acache_detach@1155-1183@usr.sbin/bind/lib/dns/acache.c","usr.sbin/bind/lib/dns/acache.c","dns_acache_detach",1155,1183
18,2,122,1,29,"dns_acache_shutdown@1186-1215@usr.sbin/bind/lib/dns/acache.c","usr.sbin/bind/lib/dns/acache.c","dns_acache_shutdown",1186,1215
33,3,211,2,44,"dns_acache_setdb@1218-1262@usr.sbin/bind/lib/dns/acache.c","usr.sbin/bind/lib/dns/acache.c","dns_acache_setdb",1218,1262
57,11,453,2,89,"dns_acache_putdb@1265-1354@usr.sbin/bind/lib/dns/acache.c","usr.sbin/bind/lib/dns/acache.c","dns_acache_putdb",1265,1354
45,5,301,5,69,"dns_acache_createentry@1357-1426@usr.sbin/bind/lib/dns/acache.c","usr.sbin/bind/lib/dns/acache.c","dns_acache_createentry",1357,1426
74,17,524,8,92,"dns_acache_getentry@1429-1521@usr.sbin/bind/lib/dns/acache.c","usr.sbin/bind/lib/dns/acache.c","dns_acache_getentry",1429,1521
88,17,567,7,122,"dns_acache_setentry@1524-1646@usr.sbin/bind/lib/dns/acache.c","usr.sbin/bind/lib/dns/acache.c","dns_acache_setentry",1524,1646
14,1,106,1,24,"dns_acache_cancelentry@1649-1673@usr.sbin/bind/lib/dns/acache.c","usr.sbin/bind/lib/dns/acache.c","dns_acache_cancelentry",1649,1673
8,2,47,2,9,"dns_acache_attachentry@1676-1685@usr.sbin/bind/lib/dns/acache.c","usr.sbin/bind/lib/dns/acache.c","dns_acache_attachentry",1676,1685
13,3,86,1,20,"dns_acache_detachentry@1688-1708@usr.sbin/bind/lib/dns/acache.c","usr.sbin/bind/lib/dns/acache.c","dns_acache_detachentry",1688,1708
33,4,176,2,43,"dns_acache_setcleaninginterval@1711-1754@usr.sbin/bind/lib/dns/acache.c","usr.sbin/bind/lib/dns/acache.c","dns_acache_setcleaninginterval",1711,1754
14,6,106,2,17,"dns_acache_setcachesize@1761-1778@usr.sbin/bind/lib/dns/acache.c","usr.sbin/bind/lib/dns/acache.c","dns_acache_setcachesize",1761,1778
33,5,215,3,43,"dns_acl_create@31-74@usr.sbin/bind/lib/dns/acl.c","usr.sbin/bind/lib/dns/acl.c","dns_acl_create",31,74
21,4,148,2,28,"dns_acl_appendelement@77-105@usr.sbin/bind/lib/dns/acl.c","usr.sbin/bind/lib/dns/acl.c","dns_acl_appendelement",77,105
12,2,85,3,11,"dns_acl_anyornone@108-119@usr.sbin/bind/lib/dns/acl.c","usr.sbin/bind/lib/dns/acl.c","dns_acl_anyornone",108,119
3,1,24,2,2,"dns_acl_any@122-124@usr.sbin/bind/lib/dns/acl.c","usr.sbin/bind/lib/dns/acl.c","dns_acl_any",122,124
3,1,24,2,2,"dns_acl_none@127-129@usr.sbin/bind/lib/dns/acl.c","usr.sbin/bind/lib/dns/acl.c","dns_acl_none",127,129
21,5,143,6,24,"dns_acl_match@132-156@usr.sbin/bind/lib/dns/acl.c","usr.sbin/bind/lib/dns/acl.c","dns_acl_match",132,156
17,5,105,3,20,"dns_acl_elementmatch@159-179@usr.sbin/bind/lib/dns/acl.c","usr.sbin/bind/lib/dns/acl.c","dns_acl_elementmatch",159,179
71,21,323,5,92,"dns_aclelement_match@182-274@usr.sbin/bind/lib/dns/acl.c","usr.sbin/bind/lib/dns/acl.c","dns_aclelement_match",182,274
5,1,35,2,4,"dns_acl_attach@277-281@usr.sbin/bind/lib/dns/acl.c","usr.sbin/bind/lib/dns/acl.c","dns_acl_attach",277,281
24,6,163,1,23,"destroy@284-307@usr.sbin/bind/lib/dns/acl.c","usr.sbin/bind/lib/dns/acl.c","destroy",284,307
9,2,54,1,8,"dns_acl_detach@310-318@usr.sbin/bind/lib/dns/acl.c","usr.sbin/bind/lib/dns/acl.c","dns_acl_detach",310,318
24,9,165,2,23,"dns_aclelement_equal@321-344@usr.sbin/bind/lib/dns/acl.c","usr.sbin/bind/lib/dns/acl.c","dns_aclelement_equal",321,344
13,5,93,2,12,"dns_acl_equal@347-359@usr.sbin/bind/lib/dns/acl.c","usr.sbin/bind/lib/dns/acl.c","dns_acl_equal",347,359
17,7,91,1,16,"is_loopback@362-378@usr.sbin/bind/lib/dns/acl.c","usr.sbin/bind/lib/dns/acl.c","is_loopback",362,378
28,11,138,1,36,"dns_acl_isinsecure@381-417@usr.sbin/bind/lib/dns/acl.c","usr.sbin/bind/lib/dns/acl.c","dns_acl_isinsecure",381,417
17,3,101,2,17,"dns_aclenv_init@420-437@usr.sbin/bind/lib/dns/acl.c","usr.sbin/bind/lib/dns/acl.c","dns_aclenv_init",420,437
7,1,60,2,6,"dns_aclenv_copy@440-446@usr.sbin/bind/lib/dns/acl.c","usr.sbin/bind/lib/dns/acl.c","dns_aclenv_copy",440,446
4,1,24,1,3,"dns_aclenv_destroy@449-452@usr.sbin/bind/lib/dns/acl.c","usr.sbin/bind/lib/dns/acl.c","dns_aclenv_destroy",449,452
8,1,44,3,8,"DP@455-463@usr.sbin/bind/lib/dns/adb.c","usr.sbin/bind/lib/dns/adb.c","DP",455,463
7,3,32,1,7,"ttlclamp@466-473@usr.sbin/bind/lib/dns/adb.c","usr.sbin/bind/lib/dns/adb.c","ttlclamp",466,473
109,19,634,3,129,"import_rdataset@481-610@usr.sbin/bind/lib/dns/adb.c","usr.sbin/bind/lib/dns/adb.c","import_rdataset",481,610
36,7,241,2,52,"kill_name@616-668@usr.sbin/bind/lib/dns/adb.c","usr.sbin/bind/lib/dns/adb.c","kill_name",616,668
42,13,269,3,57,"check_expire_namehooks@674-731@usr.sbin/bind/lib/dns/adb.c","usr.sbin/bind/lib/dns/adb.c","check_expire_namehooks",674,731
6,1,52,3,6,"link_name@737-743@usr.sbin/bind/lib/dns/adb.c","usr.sbin/bind/lib/dns/adb.c","link_name",737,743
13,3,100,2,14,"unlink_name@749-763@usr.sbin/bind/lib/dns/adb.c","usr.sbin/bind/lib/dns/adb.c","unlink_name",749,763
5,1,43,3,4,"link_entry@769-773@usr.sbin/bind/lib/dns/adb.c","usr.sbin/bind/lib/dns/adb.c","link_entry",769,773
13,3,100,2,14,"unlink_entry@779-793@usr.sbin/bind/lib/dns/adb.c","usr.sbin/bind/lib/dns/adb.c","unlink_entry",779,793
7,2,38,2,6,"violate_locking_hierarchy@796-802@usr.sbin/bind/lib/dns/adb.c","usr.sbin/bind/lib/dns/adb.c","violate_locking_hierarchy",796,802
25,4,150,1,38,"shutdown_names@809-847@usr.sbin/bind/lib/dns/adb.c","usr.sbin/bind/lib/dns/adb.c","shutdown_names",809,847
28,7,170,1,39,"shutdown_entries@854-893@usr.sbin/bind/lib/dns/adb.c","usr.sbin/bind/lib/dns/adb.c","shutdown_entries",854,893
6,3,40,1,6,"cancel_fetches_at_name@899-905@usr.sbin/bind/lib/dns/adb.c","usr.sbin/bind/lib/dns/adb.c","cancel_fetches_at_name",899,905
29,6,187,2,41,"clean_namehooks@911-952@usr.sbin/bind/lib/dns/adb.c","usr.sbin/bind/lib/dns/adb.c","clean_namehooks",911,952
6,2,39,2,5,"clean_target@955-960@usr.sbin/bind/lib/dns/adb.c","usr.sbin/bind/lib/dns/adb.c","clean_target",955,960
52,9,348,5,65,"set_target@963-1028@usr.sbin/bind/lib/dns/adb.c","usr.sbin/bind/lib/dns/adb.c","set_target",963,1028
10,1,61,1,11,"event_free@1034-1045@usr.sbin/bind/lib/dns/adb.c","usr.sbin/bind/lib/dns/adb.c","event_free",1034,1045
64,7,362,3,79,"clean_finds_at_name@1051-1130@usr.sbin/bind/lib/dns/adb.c","usr.sbin/bind/lib/dns/adb.c","clean_finds_at_name",1051,1130
9,2,51,1,15,"check_exit@1133-1148@usr.sbin/bind/lib/dns/adb.c","usr.sbin/bind/lib/dns/adb.c","check_exit",1133,1148
22,5,142,1,25,"dec_adb_irefcnt@1151-1176@usr.sbin/bind/lib/dns/adb.c","usr.sbin/bind/lib/dns/adb.c","dec_adb_irefcnt",1151,1176
5,1,29,1,4,"inc_adb_irefcnt@1179-1183@usr.sbin/bind/lib/dns/adb.c","usr.sbin/bind/lib/dns/adb.c","inc_adb_irefcnt",1179,1183
5,1,29,1,4,"inc_adb_erefcnt@1186-1190@usr.sbin/bind/lib/dns/adb.c","usr.sbin/bind/lib/dns/adb.c","inc_adb_erefcnt",1186,1190
9,3,59,3,12,"inc_entry_refcnt@1193-1205@usr.sbin/bind/lib/dns/adb.c","usr.sbin/bind/lib/dns/adb.c","inc_entry_refcnt",1193,1205
25,8,158,3,33,"dec_entry_refcnt@1208-1241@usr.sbin/bind/lib/dns/adb.c","usr.sbin/bind/lib/dns/adb.c","dec_entry_refcnt",1208,1241
30,3,201,2,32,"new_adbname@1244-1276@usr.sbin/bind/lib/dns/adb.c","usr.sbin/bind/lib/dns/adb.c","new_adbname",1244,1276
16,2,132,2,19,"free_adbname@1279-1298@usr.sbin/bind/lib/dns/adb.c","usr.sbin/bind/lib/dns/adb.c","free_adbname",1279,1298
10,2,60,2,12,"new_adbnamehook@1301-1313@usr.sbin/bind/lib/dns/adb.c","usr.sbin/bind/lib/dns/adb.c","new_adbnamehook",1301,1313
10,2,74,2,12,"free_adbnamehook@1316-1328@usr.sbin/bind/lib/dns/adb.c","usr.sbin/bind/lib/dns/adb.c","free_adbnamehook",1316,1328
16,3,113,3,18,"new_adblameinfo@1331-1349@usr.sbin/bind/lib/dns/adb.c","usr.sbin/bind/lib/dns/adb.c","new_adblameinfo",1331,1349
10,2,77,2,14,"free_adblameinfo@1352-1366@usr.sbin/bind/lib/dns/adb.c","usr.sbin/bind/lib/dns/adb.c","free_adblameinfo",1352,1366
17,2,102,1,19,"new_adbentry@1369-1388@usr.sbin/bind/lib/dns/adb.c","usr.sbin/bind/lib/dns/adb.c","new_adbentry",1369,1388
18,3,132,2,22,"free_adbentry@1391-1413@usr.sbin/bind/lib/dns/adb.c","usr.sbin/bind/lib/dns/adb.c","free_adbentry",1391,1413
29,3,187,1,39,"new_adbfind@1416-1455@usr.sbin/bind/lib/dns/adb.c","usr.sbin/bind/lib/dns/adb.c","new_adbfind",1416,1455
26,6,169,1,33,"new_adbfetch@1458-1491@usr.sbin/bind/lib/dns/adb.c","usr.sbin/bind/lib/dns/adb.c","new_adbfetch",1458,1491
14,5,108,2,18,"free_adbfetch@1494-1512@usr.sbin/bind/lib/dns/adb.c","usr.sbin/bind/lib/dns/adb.c","free_adbfetch",1494,1512
15,2,119,2,18,"free_adbfind@1515-1533@usr.sbin/bind/lib/dns/adb.c","usr.sbin/bind/lib/dns/adb.c","free_adbfind",1515,1533
14,2,97,3,16,"new_adbaddrinfo@1541-1557@usr.sbin/bind/lib/dns/adb.c","usr.sbin/bind/lib/dns/adb.c","new_adbaddrinfo",1541,1557
10,2,74,2,13,"free_adbaddrinfo@1560-1573@usr.sbin/bind/lib/dns/adb.c","usr.sbin/bind/lib/dns/adb.c","free_adbaddrinfo",1560,1573
26,8,176,4,29,"find_name_and_lock@1583-1612@usr.sbin/bind/lib/dns/adb.c","usr.sbin/bind/lib/dns/adb.c","find_name_and_lock",1583,1612
20,5,148,3,23,"find_entry_and_lock@1625-1648@usr.sbin/bind/lib/dns/adb.c","usr.sbin/bind/lib/dns/adb.c","find_entry_and_lock",1625,1648
22,8,140,5,36,"entry_is_lame@1654-1690@usr.sbin/bind/lib/dns/adb.c","usr.sbin/bind/lib/dns/adb.c","entry_is_lame",1654,1690
60,11,374,6,71,"copy_namehook_lists@1693-1764@usr.sbin/bind/lib/dns/adb.c","usr.sbin/bind/lib/dns/adb.c","copy_namehook_lists",1693,1764
11,1,70,2,19,"shutdown_task@1767-1786@usr.sbin/bind/lib/dns/adb.c","usr.sbin/bind/lib/dns/adb.c","shutdown_task",1767,1786
19,8,138,2,29,"check_expire_name@1792-1821@usr.sbin/bind/lib/dns/adb.c","usr.sbin/bind/lib/dns/adb.c","check_expire_name",1792,1821
26,8,172,3,35,"check_expire_entry@1827-1862@usr.sbin/bind/lib/dns/adb.c","usr.sbin/bind/lib/dns/adb.c","check_expire_entry",1827,1862
22,4,158,3,24,"cleanup_names@1868-1892@usr.sbin/bind/lib/dns/adb.c","usr.sbin/bind/lib/dns/adb.c","cleanup_names",1868,1892
15,2,114,3,16,"cleanup_entries@1898-1914@usr.sbin/bind/lib/dns/adb.c","usr.sbin/bind/lib/dns/adb.c","cleanup_entries",1898,1914
29,5,193,2,51,"timer_cleanup@1917-1968@usr.sbin/bind/lib/dns/adb.c","usr.sbin/bind/lib/dns/adb.c","timer_cleanup",1917,1968
17,1,135,1,24,"destroy@1971-1995@usr.sbin/bind/lib/dns/adb.c","usr.sbin/bind/lib/dns/adb.c","destroy",1971,1995
121,21,876,5,171,"dns_adb_create@2003-2174@usr.sbin/bind/lib/dns/adb.c","usr.sbin/bind/lib/dns/adb.c","dns_adb_create",2003,2174
6,2,42,2,7,"dns_adb_attach@2177-2184@usr.sbin/bind/lib/dns/adb.c","usr.sbin/bind/lib/dns/adb.c","dns_adb_attach",2177,2184
18,4,119,1,22,"dns_adb_detach@2187-2209@usr.sbin/bind/lib/dns/adb.c","usr.sbin/bind/lib/dns/adb.c","dns_adb_detach",2187,2209
24,4,162,3,36,"dns_adb_whenshutdown@2212-2248@usr.sbin/bind/lib/dns/adb.c","usr.sbin/bind/lib/dns/adb.c","dns_adb_whenshutdown",2212,2248
14,4,85,1,20,"dns_adb_shutdown@2251-2271@usr.sbin/bind/lib/dns/adb.c","usr.sbin/bind/lib/dns/adb.c","dns_adb_shutdown",2251,2271
203,55,1159,12,327,"dns_adb_createfind@2274-2601@usr.sbin/bind/lib/dns/adb.c","usr.sbin/bind/lib/dns/adb.c","dns_adb_createfind",2274,2601
33,4,220,1,53,"dns_adb_destroyfind@2604-2657@usr.sbin/bind/lib/dns/adb.c","usr.sbin/bind/lib/dns/adb.c","dns_adb_destroyfind",2604,2657
41,4,258,1,54,"dns_adb_cancelfind@2660-2714@usr.sbin/bind/lib/dns/adb.c","usr.sbin/bind/lib/dns/adb.c","dns_adb_cancelfind",2660,2714
14,3,120,2,24,"dns_adb_dump@2717-2741@usr.sbin/bind/lib/dns/adb.c","usr.sbin/bind/lib/dns/adb.c","dns_adb_dump",2717,2741
5,2,40,4,4,"dump_ttl@2744-2748@usr.sbin/bind/lib/dns/adb.c","usr.sbin/bind/lib/dns/adb.c","dump_ttl",2744,2748
61,17,482,4,79,"dump_adb@2751-2830@usr.sbin/bind/lib/dns/adb.c","usr.sbin/bind/lib/dns/adb.c","dump_adb",2751,2830
26,4,195,4,28,"dump_entry@2833-2861@usr.sbin/bind/lib/dns/adb.c","usr.sbin/bind/lib/dns/adb.c","dump_entry",2833,2861
38,6,252,2,49,"dns_adb_dumpfind@2864-2913@usr.sbin/bind/lib/dns/adb.c","usr.sbin/bind/lib/dns/adb.c","dns_adb_dumpfind",2864,2913
6,1,46,2,7,"print_dns_name@2916-2923@usr.sbin/bind/lib/dns/adb.c","usr.sbin/bind/lib/dns/adb.c","print_dns_name",2916,2923
13,3,80,5,13,"print_namehook_list@2926-2939@usr.sbin/bind/lib/dns/adb.c","usr.sbin/bind/lib/dns/adb.c","print_namehook_list",2926,2939
4,1,40,3,3,"print_fetch@2942-2945@usr.sbin/bind/lib/dns/adb.c","usr.sbin/bind/lib/dns/adb.c","print_fetch",2942,2945
6,3,48,2,5,"print_fetch_list@2948-2953@usr.sbin/bind/lib/dns/adb.c","usr.sbin/bind/lib/dns/adb.c","print_fetch_list",2948,2953
8,2,49,2,8,"print_find_list@2956-2964@usr.sbin/bind/lib/dns/adb.c","usr.sbin/bind/lib/dns/adb.c","print_find_list",2956,2964
102,23,538,3,131,"dbfind_name@2967-3098@usr.sbin/bind/lib/dns/adb.c","usr.sbin/bind/lib/dns/adb.c","dbfind_name",2967,3098
124,22,802,2,166,"fetch_callback@3101-3267@usr.sbin/bind/lib/dns/adb.c","usr.sbin/bind/lib/dns/adb.c","fetch_callback",3101,3267
60,12,333,3,69,"fetch_name@3270-3339@usr.sbin/bind/lib/dns/adb.c","usr.sbin/bind/lib/dns/adb.c","fetch_name",3270,3339
31,7,209,5,35,"dns_adb_marklame@3346-3381@usr.sbin/bind/lib/dns/adb.c","usr.sbin/bind/lib/dns/adb.c","dns_adb_marklame",3346,3381
22,2,158,4,27,"dns_adb_adjustsrtt@3384-3411@usr.sbin/bind/lib/dns/adb.c","usr.sbin/bind/lib/dns/adb.c","dns_adb_adjustsrtt",3384,3411
12,1,109,4,19,"dns_adb_changeflags@3414-3433@usr.sbin/bind/lib/dns/adb.c","usr.sbin/bind/lib/dns/adb.c","dns_adb_changeflags",3414,3433
41,6,229,4,49,"dns_adb_findaddrinfo@3436-3485@usr.sbin/bind/lib/dns/adb.c","usr.sbin/bind/lib/dns/adb.c","dns_adb_findaddrinfo",3436,3485
27,2,174,2,35,"dns_adb_freeaddrinfo@3488-3523@usr.sbin/bind/lib/dns/adb.c","usr.sbin/bind/lib/dns/adb.c","dns_adb_freeaddrinfo",3488,3523
11,4,101,1,20,"dns_adb_flush@3526-3546@usr.sbin/bind/lib/dns/adb.c","usr.sbin/bind/lib/dns/adb.c","dns_adb_flush",3526,3546
22,4,146,2,23,"dns_adb_flushname@3549-3572@usr.sbin/bind/lib/dns/adb.c","usr.sbin/bind/lib/dns/adb.c","dns_adb_flushname",3549,3572
14,3,95,2,16,"water@3575-3591@usr.sbin/bind/lib/dns/adb.c","usr.sbin/bind/lib/dns/adb.c","water",3575,3591
13,6,106,2,16,"dns_adb_setadbsize@3594-3610@usr.sbin/bind/lib/dns/adb.c","usr.sbin/bind/lib/dns/adb.c","dns_adb_setadbsize",3594,3610
7,1,32,3,10,"dns_byaddr_createptrname@71-81@usr.sbin/bind/lib/dns/byaddr.c","usr.sbin/bind/lib/dns/byaddr.c","dns_byaddr_createptrname",71,81
38,5,297,3,46,"dns_byaddr_createptrname2@84-130@usr.sbin/bind/lib/dns/byaddr.c","usr.sbin/bind/lib/dns/byaddr.c","dns_byaddr_createptrname2",84,130
31,6,206,2,36,"copy_ptr_targets@133-169@usr.sbin/bind/lib/dns/byaddr.c","usr.sbin/bind/lib/dns/byaddr.c","copy_ptr_targets",133,169
17,2,129,2,20,"lookup_done@172-192@usr.sbin/bind/lib/dns/byaddr.c","usr.sbin/bind/lib/dns/byaddr.c","lookup_done",172,192
17,2,118,1,18,"bevent_destroy@195-213@usr.sbin/bind/lib/dns/byaddr.c","usr.sbin/bind/lib/dns/byaddr.c","bevent_destroy",195,213
53,6,364,8,67,"dns_byaddr_create@216-283@usr.sbin/bind/lib/dns/byaddr.c","usr.sbin/bind/lib/dns/byaddr.c","dns_byaddr_create",216,283
10,3,62,1,12,"dns_byaddr_cancel@286-298@usr.sbin/bind/lib/dns/byaddr.c","usr.sbin/bind/lib/dns/byaddr.c","dns_byaddr_cancel",286,298
13,1,92,1,15,"dns_byaddr_destroy@301-316@usr.sbin/bind/lib/dns/byaddr.c","usr.sbin/bind/lib/dns/byaddr.c","dns_byaddr_destroy",301,316
46,8,267,3,64,"adjust_increment@167-231@usr.sbin/bind/lib/dns/cache.c","usr.sbin/bind/lib/dns/cache.c","adjust_increment",167,231
5,1,44,2,4,"cache_create_db@234-238@usr.sbin/bind/lib/dns/cache.c","usr.sbin/bind/lib/dns/cache.c","cache_create_db",234,238
81,15,537,8,94,"dns_cache_create@241-335@usr.sbin/bind/lib/dns/cache.c","usr.sbin/bind/lib/dns/cache.c","dns_cache_create",241,335
37,11,317,1,48,"cache_free@338-386@usr.sbin/bind/lib/dns/cache.c","usr.sbin/bind/lib/dns/cache.c","cache_free",338,386
8,2,58,2,10,"dns_cache_attach@390-400@usr.sbin/bind/lib/dns/cache.c","usr.sbin/bind/lib/dns/cache.c","dns_cache_attach",390,400
30,6,164,1,43,"dns_cache_detach@403-446@usr.sbin/bind/lib/dns/cache.c","usr.sbin/bind/lib/dns/cache.c","dns_cache_detach",403,446
8,2,66,2,9,"dns_cache_attachdb@449-458@usr.sbin/bind/lib/dns/cache.c","usr.sbin/bind/lib/dns/cache.c","dns_cache_attachdb",449,458
14,3,98,2,17,"dns_cache_setfilename@461-478@usr.sbin/bind/lib/dns/cache.c","usr.sbin/bind/lib/dns/cache.c","dns_cache_setfilename",461,478
10,2,66,1,13,"dns_cache_load@481-494@usr.sbin/bind/lib/dns/cache.c","usr.sbin/bind/lib/dns/cache.c","dns_cache_load",481,494
11,2,75,1,14,"dns_cache_dump@497-511@usr.sbin/bind/lib/dns/cache.c","usr.sbin/bind/lib/dns/cache.c","dns_cache_dump",497,511
26,4,145,2,34,"dns_cache_setcleaninginterval@514-548@usr.sbin/bind/lib/dns/cache.c","usr.sbin/bind/lib/dns/cache.c","dns_cache_setcleaninginterval",514,548
89,15,486,4,99,"cache_cleaner_init@556-655@usr.sbin/bind/lib/dns/cache.c","usr.sbin/bind/lib/dns/cache.c","cache_cleaner_init",556,655
38,7,233,1,52,"begin_cleaning@658-710@usr.sbin/bind/lib/dns/cache.c","usr.sbin/bind/lib/dns/cache.c","begin_cleaning",658,710
15,2,105,2,19,"end_cleaning@713-732@usr.sbin/bind/lib/dns/cache.c","usr.sbin/bind/lib/dns/cache.c","end_cleaning",713,732
12,2,83,2,16,"cleaning_timer_action@738-754@usr.sbin/bind/lib/dns/cache.c","usr.sbin/bind/lib/dns/cache.c","cleaning_timer_action",738,754
24,5,150,2,39,"overmem_cleaning_action@761-800@usr.sbin/bind/lib/dns/cache.c","usr.sbin/bind/lib/dns/cache.c","overmem_cleaning_action",761,800
79,9,450,2,114,"incremental_cleaning_action@806-920@usr.sbin/bind/lib/dns/cache.c","usr.sbin/bind/lib/dns/cache.c","incremental_cleaning_action",806,920
29,6,170,2,47,"dns_cache_clean@926-973@usr.sbin/bind/lib/dns/cache.c","usr.sbin/bind/lib/dns/cache.c","dns_cache_clean",926,973
12,2,98,2,16,"water@976-992@usr.sbin/bind/lib/dns/cache.c","usr.sbin/bind/lib/dns/cache.c","water",976,992
13,6,106,2,34,"dns_cache_setcachesize@995-1029@usr.sbin/bind/lib/dns/cache.c","usr.sbin/bind/lib/dns/cache.c","dns_cache_setcachesize",995,1029
22,5,162,2,37,"cleaner_shutdown_action@1035-1072@usr.sbin/bind/lib/dns/cache.c","usr.sbin/bind/lib/dns/cache.c","cleaner_shutdown_action",1035,1072
24,5,171,1,26,"dns_cache_flush@1075-1101@usr.sbin/bind/lib/dns/cache.c","usr.sbin/bind/lib/dns/cache.c","dns_cache_flush",1075,1101
44,10,267,2,50,"dns_cache_flushname@1104-1154@usr.sbin/bind/lib/dns/cache.c","usr.sbin/bind/lib/dns/cache.c","dns_cache_flushname",1104,1154
10,1,51,3,11,"stdio_error_warn_callback@46-57@usr.sbin/bind/lib/dns/callbacks.c","usr.sbin/bind/lib/dns/callbacks.c","stdio_error_warn_callback",46,57
9,1,50,3,10,"isclog_error_callback@60-70@usr.sbin/bind/lib/dns/callbacks.c","usr.sbin/bind/lib/dns/callbacks.c","isclog_error_callback",60,70
9,1,50,3,11,"isclog_warn_callback@73-84@usr.sbin/bind/lib/dns/callbacks.c","usr.sbin/bind/lib/dns/callbacks.c","isclog_warn_callback",73,84
7,1,39,1,7,"dns_rdatacallbacks_initcommon@87-94@usr.sbin/bind/lib/dns/callbacks.c","usr.sbin/bind/lib/dns/callbacks.c","dns_rdatacallbacks_initcommon",87,94
5,1,25,1,4,"dns_rdatacallbacks_init@101-105@usr.sbin/bind/lib/dns/callbacks.c","usr.sbin/bind/lib/dns/callbacks.c","dns_rdatacallbacks_init",101,105
5,1,25,1,4,"dns_rdatacallbacks_init_stdio@108-112@usr.sbin/bind/lib/dns/callbacks.c","usr.sbin/bind/lib/dns/callbacks.c","dns_rdatacallbacks_init_stdio",108,112
13,2,90,3,14,"dns_compress_init@46-60@usr.sbin/bind/lib/dns/compress.c","usr.sbin/bind/lib/dns/compress.c","dns_compress_init",46,60
17,4,121,1,18,"dns_compress_invalidate@63-81@usr.sbin/bind/lib/dns/compress.c","usr.sbin/bind/lib/dns/compress.c","dns_compress_invalidate",63,81
5,1,36,2,5,"dns_compress_setmethods@84-89@usr.sbin/bind/lib/dns/compress.c","usr.sbin/bind/lib/dns/compress.c","dns_compress_setmethods",84,89
4,1,25,1,3,"dns_compress_getmethods@92-95@usr.sbin/bind/lib/dns/compress.c","usr.sbin/bind/lib/dns/compress.c","dns_compress_getmethods",92,95
7,2,36,2,7,"dns_compress_setsensitive@98-105@usr.sbin/bind/lib/dns/compress.c","usr.sbin/bind/lib/dns/compress.c","dns_compress_setsensitive",98,105
4,1,32,1,4,"dns_compress_getsensitive@108-112@usr.sbin/bind/lib/dns/compress.c","usr.sbin/bind/lib/dns/compress.c","dns_compress_getsensitive",108,112
4,1,23,1,3,"dns_compress_getedns@115-118@usr.sbin/bind/lib/dns/compress.c","usr.sbin/bind/lib/dns/compress.c","dns_compress_getedns",115,118
42,10,279,4,52,"dns_compress_findglobal@134-186@usr.sbin/bind/lib/dns/compress.c","usr.sbin/bind/lib/dns/compress.c","dns_compress_findglobal",134,186
5,1,27,1,4,"name_length@189-193@usr.sbin/bind/lib/dns/compress.c","usr.sbin/bind/lib/dns/compress.c","name_length",189,193
48,6,290,4,53,"dns_compress_add@196-249@usr.sbin/bind/lib/dns/compress.c","usr.sbin/bind/lib/dns/compress.c","dns_compress_add",196,249
15,5,113,2,22,"dns_compress_rollback@252-274@usr.sbin/bind/lib/dns/compress.c","usr.sbin/bind/lib/dns/compress.c","dns_compress_rollback",252,274
9,2,57,3,10,"dns_decompress_init@281-291@usr.sbin/bind/lib/dns/compress.c","usr.sbin/bind/lib/dns/compress.c","dns_decompress_init",281,291
4,1,22,1,5,"dns_decompress_invalidate@294-299@usr.sbin/bind/lib/dns/compress.c","usr.sbin/bind/lib/dns/compress.c","dns_decompress_invalidate",294,299
14,4,61,2,15,"dns_decompress_setmethods@302-317@usr.sbin/bind/lib/dns/compress.c","usr.sbin/bind/lib/dns/compress.c","dns_decompress_setmethods",302,317
4,1,23,1,5,"dns_decompress_getmethods@320-325@usr.sbin/bind/lib/dns/compress.c","usr.sbin/bind/lib/dns/compress.c","dns_decompress_getmethods",320,325
4,1,23,1,5,"dns_decompress_edns@328-333@usr.sbin/bind/lib/dns/compress.c","usr.sbin/bind/lib/dns/compress.c","dns_decompress_edns",328,333
4,1,23,1,5,"dns_decompress_type@336-341@usr.sbin/bind/lib/dns/compress.c","usr.sbin/bind/lib/dns/compress.c","dns_decompress_type",336,341
16,1,109,1,18,"initialize@74-92@usr.sbin/bind/lib/dns/db.c","usr.sbin/bind/lib/dns/db.c","initialize",74,92
9,3,58,1,9,"impfind@95-104@usr.sbin/bind/lib/dns/db.c","usr.sbin/bind/lib/dns/db.c","impfind",95,104
24,3,170,8,33,"dns_db_create@112-145@usr.sbin/bind/lib/dns/db.c","usr.sbin/bind/lib/dns/db.c","dns_db_create",112,145
6,2,53,2,12,"dns_db_attach@148-160@usr.sbin/bind/lib/dns/db.c","usr.sbin/bind/lib/dns/db.c","dns_db_attach",148,160
6,1,46,1,12,"dns_db_detach@163-175@usr.sbin/bind/lib/dns/db.c","usr.sbin/bind/lib/dns/db.c","dns_db_detach",163,175
5,1,39,3,5,"dns_db_ondestroy@178-183@usr.sbin/bind/lib/dns/db.c","usr.sbin/bind/lib/dns/db.c","dns_db_ondestroy",178,183
6,2,38,1,12,"dns_db_iscache@187-199@usr.sbin/bind/lib/dns/db.c","usr.sbin/bind/lib/dns/db.c","dns_db_iscache",187,199
6,2,42,1,12,"dns_db_iszone@202-214@usr.sbin/bind/lib/dns/db.c","usr.sbin/bind/lib/dns/db.c","dns_db_iszone",202,214
6,2,38,1,12,"dns_db_isstub@217-229@usr.sbin/bind/lib/dns/db.c","usr.sbin/bind/lib/dns/db.c","dns_db_isstub",217,229
5,1,43,1,10,"dns_db_issecure@232-242@usr.sbin/bind/lib/dns/db.c","usr.sbin/bind/lib/dns/db.c","dns_db_issecure",232,242
4,1,30,1,9,"dns_db_ispersistent@245-254@usr.sbin/bind/lib/dns/db.c","usr.sbin/bind/lib/dns/db.c","dns_db_ispersistent",245,254
4,1,24,1,8,"dns_db_origin@257-265@usr.sbin/bind/lib/dns/db.c","usr.sbin/bind/lib/dns/db.c","dns_db_origin",257,265
4,1,23,1,8,"dns_db_class@268-276@usr.sbin/bind/lib/dns/db.c","usr.sbin/bind/lib/dns/db.c","dns_db_class",268,276
7,3,66,3,11,"dns_db_beginload@279-290@usr.sbin/bind/lib/dns/db.c","usr.sbin/bind/lib/dns/db.c","dns_db_beginload",279,290
5,2,48,2,9,"dns_db_endload@293-302@usr.sbin/bind/lib/dns/db.c","usr.sbin/bind/lib/dns/db.c","dns_db_endload",293,302
3,1,25,2,2,"dns_db_load@305-307@usr.sbin/bind/lib/dns/db.c","usr.sbin/bind/lib/dns/db.c","dns_db_load",305,307
20,6,157,3,33,"dns_db_load2@310-343@usr.sbin/bind/lib/dns/db.c","usr.sbin/bind/lib/dns/db.c","dns_db_load2",310,343
4,1,37,3,3,"dns_db_dump@346-349@usr.sbin/bind/lib/dns/db.c","usr.sbin/bind/lib/dns/db.c","dns_db_dump",346,349
5,1,48,4,11,"dns_db_dump2@352-363@usr.sbin/bind/lib/dns/db.c","usr.sbin/bind/lib/dns/db.c","dns_db_dump2",352,363
6,2,58,2,11,"dns_db_currentversion@370-381@usr.sbin/bind/lib/dns/db.c","usr.sbin/bind/lib/dns/db.c","dns_db_currentversion",370,381
6,2,61,2,11,"dns_db_newversion@384-395@usr.sbin/bind/lib/dns/db.c","usr.sbin/bind/lib/dns/db.c","dns_db_newversion",384,395
10,2,79,3,15,"dns_db_attachversion@398-413@usr.sbin/bind/lib/dns/db.c","usr.sbin/bind/lib/dns/db.c","dns_db_attachversion",398,413
9,2,71,3,15,"dns_db_closeversion@416-431@usr.sbin/bind/lib/dns/db.c","usr.sbin/bind/lib/dns/db.c","dns_db_closeversion",416,431
7,2,59,4,12,"dns_db_findnode@438-450@usr.sbin/bind/lib/dns/db.c","usr.sbin/bind/lib/dns/db.c","dns_db_findnode",438,450
18,7,155,10,24,"dns_db_find@453-477@usr.sbin/bind/lib/dns/db.c","usr.sbin/bind/lib/dns/db.c","dns_db_find",453,477
15,5,130,8,19,"dns_db_findzonecut@480-499@usr.sbin/bind/lib/dns/db.c","usr.sbin/bind/lib/dns/db.c","dns_db_findzonecut",480,499
6,2,58,3,11,"dns_db_attachnode@502-513@usr.sbin/bind/lib/dns/db.c","usr.sbin/bind/lib/dns/db.c","dns_db_attachnode",502,513
6,2,53,2,12,"dns_db_detachnode@516-528@usr.sbin/bind/lib/dns/db.c","usr.sbin/bind/lib/dns/db.c","dns_db_detachnode",516,528
6,1,61,3,11,"dns_db_expirenode@531-542@usr.sbin/bind/lib/dns/db.c","usr.sbin/bind/lib/dns/db.c","dns_db_expirenode",531,542
5,1,46,3,10,"dns_db_printnode@545-555@usr.sbin/bind/lib/dns/db.c","usr.sbin/bind/lib/dns/db.c","dns_db_printnode",545,555
7,2,51,3,11,"dns_db_createiterator@562-573@usr.sbin/bind/lib/dns/db.c","usr.sbin/bind/lib/dns/db.c","dns_db_createiterator",562,573
17,4,131,8,22,"dns_db_findrdataset@580-602@usr.sbin/bind/lib/dns/db.c","usr.sbin/bind/lib/dns/db.c","dns_db_findrdataset",580,602
8,2,65,5,13,"dns_db_allrdatasets@605-618@usr.sbin/bind/lib/dns/db.c","usr.sbin/bind/lib/dns/db.c","dns_db_allrdatasets",605,618
20,8,181,7,24,"dns_db_addrdataset@621-645@usr.sbin/bind/lib/dns/db.c","usr.sbin/bind/lib/dns/db.c","dns_db_addrdataset",621,645
16,4,131,6,21,"dns_db_subtractrdataset@648-669@usr.sbin/bind/lib/dns/db.c","usr.sbin/bind/lib/dns/db.c","dns_db_subtractrdataset",648,669
11,4,94,5,16,"dns_db_deleterdataset@672-688@usr.sbin/bind/lib/dns/db.c","usr.sbin/bind/lib/dns/db.c","dns_db_deleterdataset",672,688
4,1,32,2,5,"dns_db_overmem@691-696@usr.sbin/bind/lib/dns/db.c","usr.sbin/bind/lib/dns/db.c","dns_db_overmem",691,696
34,5,239,3,41,"dns_db_getsoaserial@699-740@usr.sbin/bind/lib/dns/db.c","usr.sbin/bind/lib/dns/db.c","dns_db_getsoaserial",699,740
4,1,30,1,4,"dns_db_nodecount@743-747@usr.sbin/bind/lib/dns/db.c","usr.sbin/bind/lib/dns/db.c","dns_db_nodecount",743,747
4,1,33,2,4,"dns_db_settask@750-754@usr.sbin/bind/lib/dns/db.c","usr.sbin/bind/lib/dns/db.c","dns_db_settask",750,754
29,4,197,5,34,"dns_db_register@757-791@usr.sbin/bind/lib/dns/db.c","usr.sbin/bind/lib/dns/db.c","dns_db_register",757,791
13,2,95,1,15,"dns_db_unregister@794-809@usr.sbin/bind/lib/dns/db.c","usr.sbin/bind/lib/dns/db.c","dns_db_unregister",794,809
8,3,73,2,9,"dns_db_getoriginnode@812-821@usr.sbin/bind/lib/dns/db.c","usr.sbin/bind/lib/dns/db.c","dns_db_getoriginnode",812,821
6,1,44,1,11,"dns_dbiterator_destroy@30-41@usr.sbin/bind/lib/dns/dbiterator.c","usr.sbin/bind/lib/dns/dbiterator.c","dns_dbiterator_destroy",30,41
4,1,28,1,8,"dns_dbiterator_first@44-52@usr.sbin/bind/lib/dns/dbiterator.c","usr.sbin/bind/lib/dns/dbiterator.c","dns_dbiterator_first",44,52
4,1,28,1,8,"dns_dbiterator_last@55-63@usr.sbin/bind/lib/dns/dbiterator.c","usr.sbin/bind/lib/dns/dbiterator.c","dns_dbiterator_last",55,63
4,1,34,2,8,"dns_dbiterator_seek@66-74@usr.sbin/bind/lib/dns/dbiterator.c","usr.sbin/bind/lib/dns/dbiterator.c","dns_dbiterator_seek",66,74
4,1,28,1,8,"dns_dbiterator_prev@77-85@usr.sbin/bind/lib/dns/dbiterator.c","usr.sbin/bind/lib/dns/dbiterator.c","dns_dbiterator_prev",77,85
4,1,28,1,8,"dns_dbiterator_next@88-96@usr.sbin/bind/lib/dns/dbiterator.c","usr.sbin/bind/lib/dns/dbiterator.c","dns_dbiterator_next",88,96
8,3,64,3,12,"dns_dbiterator_current@99-111@usr.sbin/bind/lib/dns/dbiterator.c","usr.sbin/bind/lib/dns/dbiterator.c","dns_dbiterator_current",99,111
4,1,28,1,8,"dns_dbiterator_pause@114-122@usr.sbin/bind/lib/dns/dbiterator.c","usr.sbin/bind/lib/dns/dbiterator.c","dns_dbiterator_pause",114,122
6,1,49,2,11,"dns_dbiterator_origin@125-136@usr.sbin/bind/lib/dns/dbiterator.c","usr.sbin/bind/lib/dns/dbiterator.c","dns_dbiterator_origin",125,136
4,1,25,2,4,"dns_dbiterator_setcleanmode@139-143@usr.sbin/bind/lib/dns/dbiterator.c","usr.sbin/bind/lib/dns/dbiterator.c","dns_dbiterator_setcleanmode",139,143
5,1,29,2,6,"dbdetach@56-62@usr.sbin/bind/lib/dns/dbtable.c","usr.sbin/bind/lib/dns/dbtable.c","dbdetach",56,62
35,6,222,3,46,"dns_dbtable_create@65-111@usr.sbin/bind/lib/dns/dbtable.c","usr.sbin/bind/lib/dns/dbtable.c","dns_dbtable_create",65,111
10,2,81,1,19,"dbtable_free@114-133@usr.sbin/bind/lib/dns/dbtable.c","usr.sbin/bind/lib/dns/dbtable.c","dbtable_free",114,133
10,2,76,2,13,"dns_dbtable_attach@136-149@usr.sbin/bind/lib/dns/dbtable.c","usr.sbin/bind/lib/dns/dbtable.c","dns_dbtable_attach",136,149
16,3,93,1,21,"dns_dbtable_detach@152-173@usr.sbin/bind/lib/dns/dbtable.c","usr.sbin/bind/lib/dns/dbtable.c","dns_dbtable_detach",152,173
12,1,92,2,15,"dns_dbtable_add@176-191@usr.sbin/bind/lib/dns/dbtable.c","usr.sbin/bind/lib/dns/dbtable.c","dns_dbtable_add",176,191
15,2,115,2,29,"dns_dbtable_remove@194-223@usr.sbin/bind/lib/dns/dbtable.c","usr.sbin/bind/lib/dns/dbtable.c","dns_dbtable_remove",194,223
9,1,80,2,11,"dns_dbtable_adddefault@226-237@usr.sbin/bind/lib/dns/dbtable.c","usr.sbin/bind/lib/dns/dbtable.c","dns_dbtable_adddefault",226,237
7,2,61,2,9,"dns_dbtable_getdefault@240-249@usr.sbin/bind/lib/dns/dbtable.c","usr.sbin/bind/lib/dns/dbtable.c","dns_dbtable_getdefault",240,249
6,1,44,1,8,"dns_dbtable_removedefault@252-260@usr.sbin/bind/lib/dns/dbtable.c","usr.sbin/bind/lib/dns/dbtable.c","dns_dbtable_removedefault",252,260
22,6,158,4,28,"dns_dbtable_find@263-291@usr.sbin/bind/lib/dns/dbtable.c","usr.sbin/bind/lib/dns/dbtable.c","dns_dbtable_find",263,291
4,2,24,1,3,"rdata_covers@50-53@usr.sbin/bind/lib/dns/diff.c","usr.sbin/bind/lib/dns/diff.c","rdata_covers",50,53
33,3,257,6,46,"dns_difftuple_create@56-102@usr.sbin/bind/lib/dns/diff.c","usr.sbin/bind/lib/dns/diff.c","dns_difftuple_create",56,102
8,1,51,1,7,"dns_difftuple_free@105-112@usr.sbin/bind/lib/dns/diff.c","usr.sbin/bind/lib/dns/diff.c","dns_difftuple_free",105,112
4,1,42,2,3,"dns_difftuple_copy@115-118@usr.sbin/bind/lib/dns/diff.c","usr.sbin/bind/lib/dns/diff.c","dns_difftuple_copy",115,118
5,1,31,2,4,"dns_diff_init@121-125@usr.sbin/bind/lib/dns/diff.c","usr.sbin/bind/lib/dns/diff.c","dns_diff_init",121,125
9,2,64,1,8,"dns_diff_clear@128-136@usr.sbin/bind/lib/dns/diff.c","usr.sbin/bind/lib/dns/diff.c","dns_diff_clear",128,136
5,1,29,2,4,"dns_diff_append@139-143@usr.sbin/bind/lib/dns/diff.c","usr.sbin/bind/lib/dns/diff.c","dns_diff_append",139,143
30,7,200,2,45,"dns_diff_appendminimal@148-193@usr.sbin/bind/lib/dns/diff.c","usr.sbin/bind/lib/dns/diff.c","dns_diff_appendminimal",148,193
93,18,542,4,142,"diff_apply@196-338@usr.sbin/bind/lib/dns/diff.c","usr.sbin/bind/lib/dns/diff.c","diff_apply",196,338
3,1,30,3,2,"dns_diff_apply@341-343@usr.sbin/bind/lib/dns/diff.c","usr.sbin/bind/lib/dns/diff.c","dns_diff_apply",341,343
3,1,30,3,2,"dns_diff_applysilently@346-348@usr.sbin/bind/lib/dns/diff.c","usr.sbin/bind/lib/dns/diff.c","dns_diff_applysilently",346,348
51,12,319,3,64,"dns_diff_load@353-417@usr.sbin/bind/lib/dns/diff.c","usr.sbin/bind/lib/dns/diff.c","dns_diff_load",353,417
29,6,230,2,29,"dns_diff_sort@424-453@usr.sbin/bind/lib/dns/diff.c","usr.sbin/bind/lib/dns/diff.c","dns_diff_sort",424,453
17,1,127,4,17,"diff_tuple_tordataset@463-480@usr.sbin/bind/lib/dns/diff.c","usr.sbin/bind/lib/dns/diff.c","diff_tuple_tordataset",463,480
61,12,388,2,71,"dns_diff_print@483-554@usr.sbin/bind/lib/dns/diff.c","usr.sbin/bind/lib/dns/diff.c","dns_diff_print",483,554
12,2,82,4,14,"mgr_log@209-223@usr.sbin/bind/lib/dns/dispatch.c","usr.sbin/bind/lib/dns/dispatch.c","mgr_log",209,223
12,2,82,4,14,"dispatch_log@230-244@usr.sbin/bind/lib/dns/dispatch.c","usr.sbin/bind/lib/dns/dispatch.c","dispatch_log",230,244
24,3,142,5,26,"request_log@252-278@usr.sbin/bind/lib/dns/dispatch.c","usr.sbin/bind/lib/dns/dispatch.c","request_log",252,278
8,2,51,1,7,"dispatch_arc4init@303-310@usr.sbin/bind/lib/dns/dispatch.c","usr.sbin/bind/lib/dns/dispatch.c","dispatch_arc4init",303,310
13,2,121,3,13,"dispatch_arc4addrandom@313-326@usr.sbin/bind/lib/dns/dispatch.c","usr.sbin/bind/lib/dns/dispatch.c","dispatch_arc4addrandom",313,326
10,1,97,1,11,"dispatch_arc4get8@329-340@usr.sbin/bind/lib/dns/dispatch.c","usr.sbin/bind/lib/dns/dispatch.c","dispatch_arc4get8",329,340
6,1,33,1,7,"dispatch_arc4get16@343-350@usr.sbin/bind/lib/dns/dispatch.c","usr.sbin/bind/lib/dns/dispatch.c","dispatch_arc4get16",343,350
20,4,149,1,34,"dispatch_arc4stir@353-387@usr.sbin/bind/lib/dns/dispatch.c","usr.sbin/bind/lib/dns/dispatch.c","dispatch_arc4stir",353,387
10,2,68,1,10,"dispatch_arc4random@390-400@usr.sbin/bind/lib/dns/dispatch.c","usr.sbin/bind/lib/dns/dispatch.c","dispatch_arc4random",390,400
15,5,83,2,30,"dispatch_arc4uniformrandom@404-434@usr.sbin/bind/lib/dns/dispatch.c","usr.sbin/bind/lib/dns/dispatch.c","dispatch_arc4uniformrandom",404,434
10,1,63,4,12,"dns_hash@441-453@usr.sbin/bind/lib/dns/dispatch.c","usr.sbin/bind/lib/dns/dispatch.c","dns_hash",441,453
12,3,61,1,14,"linear_first@459-473@usr.sbin/bind/lib/dns/dispatch.c","usr.sbin/bind/lib/dns/dispatch.c","linear_first",459,473
16,4,90,2,18,"linear_next@480-498@usr.sbin/bind/lib/dns/dispatch.c","usr.sbin/bind/lib/dns/dispatch.c","linear_next",480,498
10,4,52,1,12,"destroy_disp_ok@504-516@usr.sbin/bind/lib/dns/dispatch.c","usr.sbin/bind/lib/dns/dispatch.c","destroy_disp_ok",504,516
22,2,141,2,29,"destroy_disp@526-555@usr.sbin/bind/lib/dns/dispatch.c","usr.sbin/bind/lib/dns/dispatch.c","destroy_disp",526,555
15,5,102,5,18,"bucket_search@563-581@usr.sbin/bind/lib/dns/dispatch.c","usr.sbin/bind/lib/dns/dispatch.c","bucket_search",563,581
21,4,141,3,22,"free_buffer@584-606@usr.sbin/bind/lib/dns/dispatch.c","usr.sbin/bind/lib/dns/dispatch.c","free_buffer",584,606
9,2,61,1,11,"allocate_udp_buffer@609-620@usr.sbin/bind/lib/dns/dispatch.c","usr.sbin/bind/lib/dns/dispatch.c","allocate_udp_buffer",609,620
8,2,50,2,9,"free_event@623-632@usr.sbin/bind/lib/dns/dispatch.c","usr.sbin/bind/lib/dns/dispatch.c","free_event",623,632
9,2,66,1,10,"allocate_event@635-645@usr.sbin/bind/lib/dns/dispatch.c","usr.sbin/bind/lib/dns/dispatch.c","allocate_event",635,645
145,24,1083,2,216,"udp_recv@662-878@usr.sbin/bind/lib/dns/dispatch.c","usr.sbin/bind/lib/dns/dispatch.c","udp_recv",662,878
108,14,690,2,168,"tcp_recv@896-1064@usr.sbin/bind/lib/dns/dispatch.c","usr.sbin/bind/lib/dns/dispatch.c","tcp_recv",896,1064
46,10,257,1,54,"startrecv@1070-1124@usr.sbin/bind/lib/dns/dispatch.c","usr.sbin/bind/lib/dns/dispatch.c","startrecv",1070,1124
20,6,136,1,20,"destroy_mgr_ok@1130-1150@usr.sbin/bind/lib/dns/dispatch.c","usr.sbin/bind/lib/dns/dispatch.c","destroy_mgr_ok",1130,1150
28,5,198,1,38,"destroy_mgr@1156-1194@usr.sbin/bind/lib/dns/dispatch.c","usr.sbin/bind/lib/dns/dispatch.c","destroy_mgr",1156,1194
19,3,106,4,23,"create_socket@1197-1220@usr.sbin/bind/lib/dns/dispatch.c","usr.sbin/bind/lib/dns/dispatch.c","create_socket",1197,1220
84,11,541,3,103,"dns_dispatchmgr_create@1227-1330@usr.sbin/bind/lib/dns/dispatch.c","usr.sbin/bind/lib/dns/dispatch.c","dns_dispatchmgr_create",1227,1330
6,2,46,2,5,"dns_dispatchmgr_setblackhole@1333-1338@usr.sbin/bind/lib/dns/dispatch.c","usr.sbin/bind/lib/dns/dispatch.c","dns_dispatchmgr_setblackhole",1333,1338
4,1,23,1,3,"dns_dispatchmgr_getblackhole@1341-1344@usr.sbin/bind/lib/dns/dispatch.c","usr.sbin/bind/lib/dns/dispatch.c","dns_dispatchmgr_getblackhole",1341,1344
9,3,52,2,8,"dns_dispatchmgr_setblackportlist@1347-1355@usr.sbin/bind/lib/dns/dispatch.c","usr.sbin/bind/lib/dns/dispatch.c","dns_dispatchmgr_setblackportlist",1347,1355
4,1,23,1,3,"dns_dispatchmgr_getblackportlist@1358-1361@usr.sbin/bind/lib/dns/dispatch.c","usr.sbin/bind/lib/dns/dispatch.c","dns_dispatchmgr_getblackportlist",1358,1361
39,6,263,5,59,"dns_dispatchmgr_setudp@1364-1423@usr.sbin/bind/lib/dns/dispatch.c","usr.sbin/bind/lib/dns/dispatch.c","dns_dispatchmgr_setudp",1364,1423
15,2,94,1,20,"dns_dispatchmgr_destroy@1426-1446@usr.sbin/bind/lib/dns/dispatch.c","usr.sbin/bind/lib/dns/dispatch.c","dns_dispatchmgr_destroy",1426,1446
20,7,114,3,23,"blacklisted@1449-1472@usr.sbin/bind/lib/dns/dispatch.c","usr.sbin/bind/lib/dns/dispatch.c","blacklisted",1449,1472
21,10,157,2,35,"local_addr_match@1477-1512@usr.sbin/bind/lib/dns/dispatch.c","usr.sbin/bind/lib/dns/dispatch.c","local_addr_match",1477,1512
27,6,142,5,34,"dispatch_find@1525-1559@usr.sbin/bind/lib/dns/dispatch.c","usr.sbin/bind/lib/dns/dispatch.c","dispatch_find",1525,1559
35,6,254,4,40,"qid_allocate@1562-1602@usr.sbin/bind/lib/dns/dispatch.c","usr.sbin/bind/lib/dns/dispatch.c","qid_allocate",1562,1602
12,1,86,2,14,"qid_destroy@1605-1619@usr.sbin/bind/lib/dns/dispatch.c","usr.sbin/bind/lib/dns/dispatch.c","qid_destroy",1605,1619
44,5,264,3,60,"dispatch_allocate@1625-1685@usr.sbin/bind/lib/dns/dispatch.c","usr.sbin/bind/lib/dns/dispatch.c","dispatch_allocate",1625,1685
25,3,164,1,30,"dispatch_free@1692-1722@usr.sbin/bind/lib/dns/dispatch.c","usr.sbin/bind/lib/dns/dispatch.c","dispatch_free",1692,1722
59,5,406,10,87,"dns_dispatch_createtcp@1725-1812@usr.sbin/bind/lib/dns/dispatch.c","usr.sbin/bind/lib/dns/dispatch.c","dns_dispatch_createtcp",1725,1812
59,11,391,12,76,"dns_dispatch_getudp@1815-1891@usr.sbin/bind/lib/dns/dispatch.c","usr.sbin/bind/lib/dns/dispatch.c","dns_dispatch_getudp",1815,1891
117,25,712,7,148,"dispatch_createudp@1902-2050@usr.sbin/bind/lib/dns/dispatch.c","usr.sbin/bind/lib/dns/dispatch.c","dispatch_createudp",1902,2050
8,2,58,2,9,"dns_dispatch_attach@2053-2062@usr.sbin/bind/lib/dns/dispatch.c","usr.sbin/bind/lib/dns/dispatch.c","dns_dispatch_attach",2053,2062
22,5,148,1,27,"dns_dispatch_detach@2072-2099@usr.sbin/bind/lib/dns/dispatch.c","usr.sbin/bind/lib/dns/dispatch.c","dns_dispatch_detach",2072,2099
77,10,522,7,92,"dns_dispatch_addresponse@2102-2194@usr.sbin/bind/lib/dns/dispatch.c","usr.sbin/bind/lib/dns/dispatch.c","dns_dispatch_addresponse",2102,2194
8,1,59,1,10,"dns_dispatch_starttcp@2197-2207@usr.sbin/bind/lib/dns/dispatch.c","usr.sbin/bind/lib/dns/dispatch.c","dns_dispatch_starttcp",2197,2207
79,12,527,2,102,"dns_dispatch_removeresponse@2210-2312@usr.sbin/bind/lib/dns/dispatch.c","usr.sbin/bind/lib/dns/dispatch.c","dns_dispatch_removeresponse",2210,2312
29,5,199,1,41,"do_cancel@2315-2356@usr.sbin/bind/lib/dns/dispatch.c","usr.sbin/bind/lib/dns/dispatch.c","do_cancel",2315,2356
4,1,23,1,4,"dns_dispatch_getsocket@2359-2363@usr.sbin/bind/lib/dns/dispatch.c","usr.sbin/bind/lib/dns/dispatch.c","dns_dispatch_getsocket",2359,2363
9,2,54,2,10,"dns_dispatch_getlocaladdress@2366-2376@usr.sbin/bind/lib/dns/dispatch.c","usr.sbin/bind/lib/dns/dispatch.c","dns_dispatch_getlocaladdress",2366,2376
13,2,71,1,17,"dns_dispatch_cancel@2379-2396@usr.sbin/bind/lib/dns/dispatch.c","usr.sbin/bind/lib/dns/dispatch.c","dns_dispatch_cancel",2379,2396
23,7,151,3,29,"dns_dispatch_changeattributes@2399-2428@usr.sbin/bind/lib/dns/dispatch.c","usr.sbin/bind/lib/dns/dispatch.c","dns_dispatch_changeattributes",2399,2428
30,3,230,2,34,"dns_dispatch_importrecv@2431-2465@usr.sbin/bind/lib/dns/dispatch.c","usr.sbin/bind/lib/dns/dispatch.c","dns_dispatch_importrecv",2431,2465
10,2,68,1,10,"dns_dispatchmgr_dump@2469-2479@usr.sbin/bind/lib/dns/dispatch.c","usr.sbin/bind/lib/dns/dispatch.c","dns_dispatchmgr_dump",2469,2479
4,1,25,1,3,"dlz_initialize@86-89@usr.sbin/bind/lib/dns/dlz.c","usr.sbin/bind/lib/dns/dlz.c","dlz_initialize",86,89
9,3,58,1,9,"dlz_impfind@95-104@usr.sbin/bind/lib/dns/dlz.c","usr.sbin/bind/lib/dns/dlz.c","dlz_impfind",95,104
18,3,123,4,24,"dns_dlzallowzonexfr@111-135@usr.sbin/bind/lib/dns/dlz.c","usr.sbin/bind/lib/dns/dlz.c","dns_dlzallowzonexfr",111,135
51,5,355,6,78,"dns_dlzcreate@138-216@usr.sbin/bind/lib/dns/dlz.c","usr.sbin/bind/lib/dns/dlz.c","dns_dlzcreate",138,216
16,3,125,1,25,"dns_dlzdestroy@219-244@usr.sbin/bind/lib/dns/dlz.c","usr.sbin/bind/lib/dns/dlz.c","dns_dlzdestroy",219,244
33,7,218,4,53,"dns_dlzfindzone@248-301@usr.sbin/bind/lib/dns/dlz.c","usr.sbin/bind/lib/dns/dlz.c","dns_dlzfindzone",248,301
43,4,288,5,82,"dns_dlzregister@308-390@usr.sbin/bind/lib/dns/dlz.c","usr.sbin/bind/lib/dns/dlz.c","dns_dlzregister",308,390
43,17,269,5,54,"dns_dlzstrtoargvsub@397-451@usr.sbin/bind/lib/dns/dlz.c","usr.sbin/bind/lib/dns/dlz.c","dns_dlzstrtoargvsub",397,451
5,1,38,4,4,"dns_dlzstrtoargv@461-465@usr.sbin/bind/lib/dns/dlz.c","usr.sbin/bind/lib/dns/dlz.c","dns_dlzstrtoargv",461,465
16,2,111,1,38,"dns_dlzunregister@472-510@usr.sbin/bind/lib/dns/dlz.c","usr.sbin/bind/lib/dns/dlz.c","dns_dlzunregister",472,510
4,1,28,2,4,"digest_callback@71-75@usr.sbin/bind/lib/dns/dnssec.c","usr.sbin/bind/lib/dns/dnssec.c","digest_callback",71,75
4,1,34,2,3,"rdata_compare_wrapper@81-84@usr.sbin/bind/lib/dns/dnssec.c","usr.sbin/bind/lib/dns/dnssec.c","rdata_compare_wrapper",81,84
24,4,163,4,34,"rdataset_to_sortedarray@90-124@usr.sbin/bind/lib/dns/dnssec.c","usr.sbin/bind/lib/dns/dnssec.c","rdataset_to_sortedarray",90,124
17,2,128,4,18,"dns_dnssec_keyfromrdata@127-145@usr.sbin/bind/lib/dns/dnssec.c","usr.sbin/bind/lib/dns/dnssec.c","dns_dnssec_keyfromrdata",127,145
17,2,119,3,18,"digest_sig@148-166@usr.sbin/bind/lib/dns/dnssec.c","usr.sbin/bind/lib/dns/dnssec.c","digest_sig",148,166
124,20,937,8,170,"dns_dnssec_sign@169-339@usr.sbin/bind/lib/dns/dnssec.c","usr.sbin/bind/lib/dns/dnssec.c","dns_dnssec_sign",169,339
108,24,792,7,155,"dns_dnssec_verify2@342-497@usr.sbin/bind/lib/dns/dnssec.c","usr.sbin/bind/lib/dns/dnssec.c","dns_dnssec_verify2",342,497
11,2,64,6,11,"dns_dnssec_verify@500-511@usr.sbin/bind/lib/dns/dnssec.c","usr.sbin/bind/lib/dns/dnssec.c","dns_dnssec_verify",500,511
68,15,405,9,71,"dns_dnssec_findzonekeys2@517-588@usr.sbin/bind/lib/dns/dnssec.c","usr.sbin/bind/lib/dns/dnssec.c","dns_dnssec_findzonekeys2",517,588
8,1,61,8,7,"dns_dnssec_findzonekeys@591-598@usr.sbin/bind/lib/dns/dnssec.c","usr.sbin/bind/lib/dns/dnssec.c","dns_dnssec_findzonekeys",591,598
96,7,715,2,134,"dns_dnssec_signmessage@601-735@usr.sbin/bind/lib/dns/dnssec.c","usr.sbin/bind/lib/dns/dnssec.c","dns_dnssec_signmessage",601,735
86,12,583,3,127,"dns_dnssec_verifymessage@738-865@usr.sbin/bind/lib/dns/dnssec.c","usr.sbin/bind/lib/dns/dnssec.c","dns_dnssec_verifymessage",738,865
50,4,368,5,56,"dns_ds_buildrdata@42-98@usr.sbin/bind/lib/dns/ds.c","usr.sbin/bind/lib/dns/ds.c","dns_ds_buildrdata",42,98
4,2,22,1,3,"dns_ds_digest_supported@101-104@usr.sbin/bind/lib/dns/ds.c","usr.sbin/bind/lib/dns/ds.c","dns_ds_digest_supported",101,104
6,2,34,2,5,"default_memalloc@113-118@usr.sbin/bind/lib/dns/dst_api.c","usr.sbin/bind/lib/dns/dst_api.c","default_memalloc",113,118
4,1,22,2,3,"default_memfree@121-124@usr.sbin/bind/lib/dns/dst_api.c","usr.sbin/bind/lib/dns/dst_api.c","default_memfree",121,124
34,7,279,3,56,"dst_lib_init@127-183@usr.sbin/bind/lib/dns/dst_api.c","usr.sbin/bind/lib/dns/dst_api.c","dst_lib_init",127,183
13,7,88,1,16,"dst_lib_destroy@186-202@usr.sbin/bind/lib/dns/dst_api.c","usr.sbin/bind/lib/dns/dst_api.c","dst_lib_destroy",186,202
6,3,38,1,6,"dst_algorithm_supported@205-211@usr.sbin/bind/lib/dns/dst_api.c","usr.sbin/bind/lib/dns/dst_api.c","dst_algorithm_supported",205,211
25,6,174,3,27,"dst_context_create@214-241@usr.sbin/bind/lib/dns/dst_api.c","usr.sbin/bind/lib/dns/dst_api.c","dst_context_create",214,241
10,2,79,1,11,"dst_context_destroy@244-255@usr.sbin/bind/lib/dns/dst_api.c","usr.sbin/bind/lib/dns/dst_api.c","dst_context_destroy",244,255
6,1,57,2,6,"dst_context_adddata@258-264@usr.sbin/bind/lib/dns/dst_api.c","usr.sbin/bind/lib/dns/dst_api.c","dst_context_adddata",258,264
15,5,112,2,17,"dst_context_sign@267-284@usr.sbin/bind/lib/dns/dst_api.c","usr.sbin/bind/lib/dns/dst_api.c","dst_context_sign",267,284
10,3,84,2,11,"dst_context_verify@287-298@usr.sbin/bind/lib/dns/dst_api.c","usr.sbin/bind/lib/dns/dst_api.c","dst_context_verify",287,298
18,8,139,3,22,"dst_key_computesecret@301-323@usr.sbin/bind/lib/dns/dst_api.c","usr.sbin/bind/lib/dns/dst_api.c","dst_key_computesecret",301,323
19,6,142,3,23,"dst_key_tofile@326-349@usr.sbin/bind/lib/dns/dst_api.c","usr.sbin/bind/lib/dns/dst_api.c","dst_key_tofile",326,349
38,8,251,7,44,"dst_key_fromfile@352-396@usr.sbin/bind/lib/dns/dst_api.c","usr.sbin/bind/lib/dns/dst_api.c","dst_key_fromfile",352,396
74,14,518,4,88,"dst_key_fromnamedfile@399-487@usr.sbin/bind/lib/dns/dst_api.c","usr.sbin/bind/lib/dns/dst_api.c","dst_key_fromnamedfile",399,487
23,6,183,2,28,"dst_key_todns@490-518@usr.sbin/bind/lib/dns/dst_api.c","usr.sbin/bind/lib/dns/dst_api.c","dst_key_todns",490,518
31,5,193,5,37,"dst_key_fromdns@521-558@usr.sbin/bind/lib/dns/dst_api.c","usr.sbin/bind/lib/dns/dst_api.c","dst_key_fromdns",521,558
20,3,118,8,23,"dst_key_frombuffer@561-584@usr.sbin/bind/lib/dns/dst_api.c","usr.sbin/bind/lib/dns/dst_api.c","dst_key_frombuffer",561,584
9,2,71,2,11,"dst_key_tobuffer@587-598@usr.sbin/bind/lib/dns/dst_api.c","usr.sbin/bind/lib/dns/dst_api.c","dst_key_tobuffer",587,598
17,3,127,2,19,"dst_key_privatefrombuffer@601-620@usr.sbin/bind/lib/dns/dst_api.c","usr.sbin/bind/lib/dns/dst_api.c","dst_key_privatefrombuffer",601,620
14,3,89,4,15,"dst_key_fromgssapi@623-638@usr.sbin/bind/lib/dns/dst_api.c","usr.sbin/bind/lib/dns/dst_api.c","dst_key_fromgssapi",623,638
38,7,230,9,45,"dst_key_generate@641-686@usr.sbin/bind/lib/dns/dst_api.c","usr.sbin/bind/lib/dns/dst_api.c","dst_key_generate",641,686
16,8,113,2,16,"dst_key_compare@689-705@usr.sbin/bind/lib/dns/dst_api.c","usr.sbin/bind/lib/dns/dst_api.c","dst_key_compare",689,705
15,7,105,2,15,"dst_key_paramcompare@708-723@usr.sbin/bind/lib/dns/dst_api.c","usr.sbin/bind/lib/dns/dst_api.c","dst_key_paramcompare",708,723
17,3,129,1,20,"dst_key_free@726-746@usr.sbin/bind/lib/dns/dst_api.c","usr.sbin/bind/lib/dns/dst_api.c","dst_key_free",726,746
5,1,40,1,4,"dst_key_isprivate@749-753@usr.sbin/bind/lib/dns/dst_api.c","usr.sbin/bind/lib/dns/dst_api.c","dst_key_isprivate",749,753
8,3,68,4,9,"dst_key_buildfilename@756-765@usr.sbin/bind/lib/dns/dst_api.c","usr.sbin/bind/lib/dns/dst_api.c","dst_key_buildfilename",756,765
39,12,160,2,40,"dst_key_sigsize@768-808@usr.sbin/bind/lib/dns/dst_api.c","usr.sbin/bind/lib/dns/dst_api.c","dst_key_sigsize",768,808
10,2,68,2,10,"dst_key_secretsize@811-821@usr.sbin/bind/lib/dns/dst_api.c","usr.sbin/bind/lib/dns/dst_api.c","dst_key_secretsize",811,821
34,4,241,7,36,"get_key_struct@831-867@usr.sbin/bind/lib/dns/dst_api.c","usr.sbin/bind/lib/dns/dst_api.c","get_key_struct",831,867
74,18,520,4,108,"dst_key_read_public@873-981@usr.sbin/bind/lib/dns/dst_api.c","usr.sbin/bind/lib/dns/dst_api.c","dst_key_read_public",873,981
16,7,67,1,17,"issymmetric@984-1001@usr.sbin/bind/lib/dns/dst_api.c","usr.sbin/bind/lib/dns/dst_api.c","issymmetric",984,1001
57,9,431,3,78,"write_public_key@1007-1085@usr.sbin/bind/lib/dns/dst_api.c","usr.sbin/bind/lib/dns/dst_api.c","write_public_key",1007,1085
35,10,245,6,35,"buildfilename@1088-1123@usr.sbin/bind/lib/dns/dst_api.c","usr.sbin/bind/lib/dns/dst_api.c","buildfilename",1088,1123
13,2,86,1,14,"computeid@1126-1140@usr.sbin/bind/lib/dns/dst_api.c","usr.sbin/bind/lib/dns/dst_api.c","computeid",1126,1140
32,7,208,8,36,"frombuffer@1143-1179@usr.sbin/bind/lib/dns/dst_api.c","usr.sbin/bind/lib/dns/dst_api.c","frombuffer",1143,1179
10,7,59,1,12,"algorithm_status@1182-1194@usr.sbin/bind/lib/dns/dst_api.c","usr.sbin/bind/lib/dns/dst_api.c","algorithm_status",1182,1194
18,9,149,4,20,"addsuffix@1197-1217@usr.sbin/bind/lib/dns/dst_api.c","usr.sbin/bind/lib/dns/dst_api.c","addsuffix",1197,1217
6,2,45,3,5,"dst__entropy_getdata@1220-1225@usr.sbin/bind/lib/dns/dst_api.c","usr.sbin/bind/lib/dns/dst_api.c","dst__entropy_getdata",1220,1225
3,1,14,1,2,"open_msgcat@54-56@usr.sbin/bind/lib/dns/dst_lib.c","usr.sbin/bind/lib/dns/dst_lib.c","open_msgcat",54,56
3,1,19,1,8,"dst_lib_initmsgcat@59-67@usr.sbin/bind/lib/dns/dst_lib.c","usr.sbin/bind/lib/dns/dst_lib.c","dst_lib_initmsgcat",59,67
10,5,85,2,10,"find_value@91-101@usr.sbin/bind/lib/dns/dst_parse.c","usr.sbin/bind/lib/dns/dst_parse.c","find_value",91,101
9,4,61,1,9,"find_tag@104-113@usr.sbin/bind/lib/dns/dst_parse.c","usr.sbin/bind/lib/dns/dst_parse.c","find_tag",104,113
13,6,97,1,12,"check_rsa@116-128@usr.sbin/bind/lib/dns/dst_parse.c","usr.sbin/bind/lib/dns/dst_parse.c","check_rsa",116,128
13,6,97,1,12,"check_dh@131-143@usr.sbin/bind/lib/dns/dst_parse.c","usr.sbin/bind/lib/dns/dst_parse.c","check_dh",131,143
13,6,97,1,12,"check_dsa@146-158@usr.sbin/bind/lib/dns/dst_parse.c","usr.sbin/bind/lib/dns/dst_parse.c","check_dsa",146,158
17,9,128,2,24,"check_hmac_md5@161-185@usr.sbin/bind/lib/dns/dst_parse.c","usr.sbin/bind/lib/dns/dst_parse.c","check_hmac_md5",161,185
15,6,106,3,14,"check_hmac_sha@188-202@usr.sbin/bind/lib/dns/dst_parse.c","usr.sbin/bind/lib/dns/dst_parse.c","check_hmac_sha",188,202
27,11,154,3,27,"check_data@205-232@usr.sbin/bind/lib/dns/dst_parse.c","usr.sbin/bind/lib/dns/dst_parse.c","check_data",205,232
12,4,93,2,12,"dst__privstruct_free@235-247@usr.sbin/bind/lib/dns/dst_parse.c","usr.sbin/bind/lib/dns/dst_parse.c","dst__privstruct_free",235,247
98,24,614,5,142,"dst__privstruct_parse@250-392@usr.sbin/bind/lib/dns/dst_parse.c","usr.sbin/bind/lib/dns/dst_parse.c","dst__privstruct_parse",250,392
83,16,497,3,96,"dst__privstruct_writefile@395-491@usr.sbin/bind/lib/dns/dst_parse.c","usr.sbin/bind/lib/dns/dst_parse.c","dst__privstruct_writefile",395,491
8,2,41,1,8,"initialize_action@60-68@usr.sbin/bind/lib/dns/dst_result.c","usr.sbin/bind/lib/dns/dst_result.c","initialize_action",60,68
4,1,23,1,3,"initialize@71-74@usr.sbin/bind/lib/dns/dst_result.c","usr.sbin/bind/lib/dns/dst_result.c","initialize",71,74
4,1,19,1,4,"dst_result_totext@77-81@usr.sbin/bind/lib/dns/dst_result.c","usr.sbin/bind/lib/dns/dst_result.c","dst_result_totext",77,81
3,1,10,1,2,"dst_result_register@84-86@usr.sbin/bind/lib/dns/dst_result.c","usr.sbin/bind/lib/dns/dst_result.c","dst_result_register",84,86
25,5,169,2,33,"dns_fwdtable_create@51-84@usr.sbin/bind/lib/dns/forward.c","usr.sbin/bind/lib/dns/forward.c","dns_fwdtable_create",51,84
40,6,271,4,46,"dns_fwdtable_add@87-133@usr.sbin/bind/lib/dns/forward.c","usr.sbin/bind/lib/dns/forward.c","dns_fwdtable_add",87,133
5,1,30,3,4,"dns_fwdtable_find@136-140@usr.sbin/bind/lib/dns/forward.c","usr.sbin/bind/lib/dns/forward.c","dns_fwdtable_find",136,140
13,2,87,4,17,"dns_fwdtable_find2@143-160@usr.sbin/bind/lib/dns/forward.c","usr.sbin/bind/lib/dns/forward.c","dns_fwdtable_find2",143,160
13,2,85,1,16,"dns_fwdtable_destroy@163-179@usr.sbin/bind/lib/dns/forward.c","usr.sbin/bind/lib/dns/forward.c","dns_fwdtable_destroy",163,179
12,2,93,2,13,"auto_detach@186-199@usr.sbin/bind/lib/dns/forward.c","usr.sbin/bind/lib/dns/forward.c","auto_detach",186,199
7,2,41,2,8,"start_directory@59-67@usr.sbin/bind/lib/dns/gen-unix.h","usr.sbin/bind/lib/dns/gen-unix.h","start_directory",59,67
13,4,71,1,15,"next_file@70-85@usr.sbin/bind/lib/dns/gen-unix.h","usr.sbin/bind/lib/dns/gen-unix.h","next_file",70,85
5,2,32,1,5,"end_directory@88-93@usr.sbin/bind/lib/dns/gen-unix.h","usr.sbin/bind/lib/dns/gen-unix.h","end_directory",88,93
15,4,103,1,17,"upper@179-196@usr.sbin/bind/lib/dns/gen.c","usr.sbin/bind/lib/dns/gen.c","upper",179,196
9,3,58,2,9,"funname@199-208@usr.sbin/bind/lib/dns/gen.c","usr.sbin/bind/lib/dns/gen.c","funname",199,208
67,15,404,6,68,"doswitch@211-279@usr.sbin/bind/lib/dns/gen.c","usr.sbin/bind/lib/dns/gen.c","doswitch",211,279
17,3,113,3,17,"dodecl@282-299@usr.sbin/bind/lib/dns/gen.c","usr.sbin/bind/lib/dns/gen.c","dodecl",282,299
9,4,62,1,9,"find_typename@302-311@usr.sbin/bind/lib/dns/gen.c","usr.sbin/bind/lib/dns/gen.c","find_typename",302,311
53,16,416,3,58,"insert_into_typenames@314-372@usr.sbin/bind/lib/dns/gen.c","usr.sbin/bind/lib/dns/gen.c","insert_into_typenames",314,372
58,18,434,5,73,"add@375-448@usr.sbin/bind/lib/dns/gen.c","usr.sbin/bind/lib/dns/gen.c","add",375,448
21,7,177,4,24,"sd@451-475@usr.sbin/bind/lib/dns/gen.c","usr.sbin/bind/lib/dns/gen.c","sd",451,475
12,2,88,1,13,"HASH@478-491@usr.sbin/bind/lib/dns/gen.c","usr.sbin/bind/lib/dns/gen.c","HASH",478,491
306,57,1988,2,390,"main@494-884@usr.sbin/bind/lib/dns/gen.c","usr.sbin/bind/lib/dns/gen.c","main",494,884
18,3,117,2,19,"gssapi_createctx@54-73@usr.sbin/bind/lib/dns/gssapi_link.c","usr.sbin/bind/lib/dns/gssapi_link.c","gssapi_createctx",54,73
9,3,60,1,9,"gssapi_destroyctx@76-85@usr.sbin/bind/lib/dns/gssapi_link.c","usr.sbin/bind/lib/dns/gssapi_link.c","gssapi_destroyctx",76,85
20,3,149,2,25,"gssapi_adddata@88-113@usr.sbin/bind/lib/dns/gssapi_link.c","usr.sbin/bind/lib/dns/gssapi_link.c","gssapi_adddata",88,113
19,3,135,2,24,"gssapi_sign@116-140@usr.sbin/bind/lib/dns/gssapi_link.c","usr.sbin/bind/lib/dns/gssapi_link.c","gssapi_sign",116,140
13,2,95,2,16,"gssapi_verify@143-159@usr.sbin/bind/lib/dns/gssapi_link.c","usr.sbin/bind/lib/dns/gssapi_link.c","gssapi_verify",143,159
5,1,38,2,6,"gssapi_compare@162-168@usr.sbin/bind/lib/dns/gssapi_link.c","usr.sbin/bind/lib/dns/gssapi_link.c","gssapi_compare",162,168
5,1,26,2,6,"gssapi_generate@171-177@usr.sbin/bind/lib/dns/gssapi_link.c","usr.sbin/bind/lib/dns/gssapi_link.c","gssapi_generate",171,177
4,1,19,1,3,"gssapi_isprivate@180-183@usr.sbin/bind/lib/dns/gssapi_link.c","usr.sbin/bind/lib/dns/gssapi_link.c","gssapi_isprivate",180,183
3,1,13,1,3,"gssapi_destroy@186-189@usr.sbin/bind/lib/dns/gssapi_link.c","usr.sbin/bind/lib/dns/gssapi_link.c","gssapi_destroy",186,189
6,2,33,1,5,"dst__gssapi_init@211-216@usr.sbin/bind/lib/dns/gssapi_link.c","usr.sbin/bind/lib/dns/gssapi_link.c","dst__gssapi_init",211,216
20,2,115,3,21,"name_to_gbuffer@71-92@usr.sbin/bind/lib/dns/gssapictx.c","usr.sbin/bind/lib/dns/gssapictx.c","name_to_gbuffer",71,92
30,6,176,3,33,"dst_gssapi_acquirecred@95-128@usr.sbin/bind/lib/dns/gssapictx.c","usr.sbin/bind/lib/dns/gssapictx.c","dst_gssapi_acquirecred",95,128
44,7,272,5,50,"dst_gssapi_initctx@131-181@usr.sbin/bind/lib/dns/gssapictx.c","usr.sbin/bind/lib/dns/gssapictx.c","dst_gssapi_initctx",131,181
34,4,214,5,40,"dst_gssapi_acceptctx@184-224@usr.sbin/bind/lib/dns/gssapictx.c","usr.sbin/bind/lib/dns/gssapictx.c","dst_gssapi_acceptctx",184,224
6,1,35,3,5,"dst_gssapi_acquirecred@229-234@usr.sbin/bind/lib/dns/gssapictx.c","usr.sbin/bind/lib/dns/gssapictx.c","dst_gssapi_acquirecred",229,234
11,1,54,5,10,"dst_gssapi_initctx@237-247@usr.sbin/bind/lib/dns/gssapictx.c","usr.sbin/bind/lib/dns/gssapictx.c","dst_gssapi_initctx",237,247
11,1,54,5,10,"dst_gssapi_acceptctx@250-260@usr.sbin/bind/lib/dns/gssapictx.c","usr.sbin/bind/lib/dns/gssapictx.c","dst_gssapi_acceptctx",250,260
6,2,54,2,8,"getkeybits@51-59@usr.sbin/bind/lib/dns/hmac_link.c","usr.sbin/bind/lib/dns/hmac_link.c","getkeybits",51,59
10,2,71,2,10,"hmacmd5_createctx@62-72@usr.sbin/bind/lib/dns/hmac_link.c","usr.sbin/bind/lib/dns/hmac_link.c","hmacmd5_createctx",62,72
8,2,49,1,8,"hmacmd5_destroyctx@75-83@usr.sbin/bind/lib/dns/hmac_link.c","usr.sbin/bind/lib/dns/hmac_link.c","hmacmd5_destroyctx",75,83
5,1,39,2,5,"hmacmd5_adddata@86-91@usr.sbin/bind/lib/dns/hmac_link.c","usr.sbin/bind/lib/dns/hmac_link.c","hmacmd5_adddata",86,91
10,2,65,2,11,"hmacmd5_sign@94-105@usr.sbin/bind/lib/dns/hmac_link.c","usr.sbin/bind/lib/dns/hmac_link.c","hmacmd5_sign",94,105
9,3,60,2,10,"hmacmd5_verify@108-118@usr.sbin/bind/lib/dns/hmac_link.c","usr.sbin/bind/lib/dns/hmac_link.c","hmacmd5_verify",108,118
13,6,100,2,15,"hmacmd5_compare@121-136@usr.sbin/bind/lib/dns/hmac_link.c","usr.sbin/bind/lib/dns/hmac_link.c","hmacmd5_compare",121,136
20,3,137,2,24,"hmacmd5_generate@139-163@usr.sbin/bind/lib/dns/hmac_link.c","usr.sbin/bind/lib/dns/hmac_link.c","hmacmd5_generate",139,163
4,1,19,1,3,"hmacmd5_isprivate@166-169@usr.sbin/bind/lib/dns/hmac_link.c","usr.sbin/bind/lib/dns/hmac_link.c","hmacmd5_isprivate",166,169
6,1,48,1,5,"hmacmd5_destroy@172-177@usr.sbin/bind/lib/dns/hmac_link.c","usr.sbin/bind/lib/dns/hmac_link.c","hmacmd5_destroy",172,177
11,2,82,2,14,"hmacmd5_todns@180-194@usr.sbin/bind/lib/dns/hmac_link.c","usr.sbin/bind/lib/dns/hmac_link.c","hmacmd5_todns",180,194
26,4,178,2,31,"hmacmd5_fromdns@197-228@usr.sbin/bind/lib/dns/hmac_link.c","usr.sbin/bind/lib/dns/hmac_link.c","hmacmd5_fromdns",197,228
20,2,185,2,24,"hmacmd5_tofile@231-255@usr.sbin/bind/lib/dns/hmac_link.c","usr.sbin/bind/lib/dns/hmac_link.c","hmacmd5_tofile",231,255
34,8,230,2,36,"hmacmd5_parse@258-294@usr.sbin/bind/lib/dns/hmac_link.c","usr.sbin/bind/lib/dns/hmac_link.c","hmacmd5_parse",258,294
6,2,33,1,5,"dst__hmacmd5_init@316-321@usr.sbin/bind/lib/dns/hmac_link.c","usr.sbin/bind/lib/dns/hmac_link.c","dst__hmacmd5_init",316,321
10,2,71,2,10,"hmacsha1_createctx@330-340@usr.sbin/bind/lib/dns/hmac_link.c","usr.sbin/bind/lib/dns/hmac_link.c","hmacsha1_createctx",330,340
8,2,49,1,8,"hmacsha1_destroyctx@343-351@usr.sbin/bind/lib/dns/hmac_link.c","usr.sbin/bind/lib/dns/hmac_link.c","hmacsha1_destroyctx",343,351
5,1,39,2,5,"hmacsha1_adddata@354-359@usr.sbin/bind/lib/dns/hmac_link.c","usr.sbin/bind/lib/dns/hmac_link.c","hmacsha1_adddata",354,359
10,2,67,2,11,"hmacsha1_sign@362-373@usr.sbin/bind/lib/dns/hmac_link.c","usr.sbin/bind/lib/dns/hmac_link.c","hmacsha1_sign",362,373
9,4,66,2,10,"hmacsha1_verify@376-386@usr.sbin/bind/lib/dns/hmac_link.c","usr.sbin/bind/lib/dns/hmac_link.c","hmacsha1_verify",376,386
13,6,100,2,15,"hmacsha1_compare@389-404@usr.sbin/bind/lib/dns/hmac_link.c","usr.sbin/bind/lib/dns/hmac_link.c","hmacsha1_compare",389,404
20,3,137,2,24,"hmacsha1_generate@407-431@usr.sbin/bind/lib/dns/hmac_link.c","usr.sbin/bind/lib/dns/hmac_link.c","hmacsha1_generate",407,431
4,1,19,1,3,"hmacsha1_isprivate@434-437@usr.sbin/bind/lib/dns/hmac_link.c","usr.sbin/bind/lib/dns/hmac_link.c","hmacsha1_isprivate",434,437
6,1,48,1,5,"hmacsha1_destroy@440-445@usr.sbin/bind/lib/dns/hmac_link.c","usr.sbin/bind/lib/dns/hmac_link.c","hmacsha1_destroy",440,445
11,2,82,2,14,"hmacsha1_todns@448-462@usr.sbin/bind/lib/dns/hmac_link.c","usr.sbin/bind/lib/dns/hmac_link.c","hmacsha1_todns",448,462
26,4,178,2,31,"hmacsha1_fromdns@465-496@usr.sbin/bind/lib/dns/hmac_link.c","usr.sbin/bind/lib/dns/hmac_link.c","hmacsha1_fromdns",465,496
20,2,185,2,24,"hmacsha1_tofile@499-523@usr.sbin/bind/lib/dns/hmac_link.c","usr.sbin/bind/lib/dns/hmac_link.c","hmacsha1_tofile",499,523
35,7,226,2,37,"hmacsha1_parse@526-563@usr.sbin/bind/lib/dns/hmac_link.c","usr.sbin/bind/lib/dns/hmac_link.c","hmacsha1_parse",526,563
6,2,33,1,5,"dst__hmacsha1_init@585-590@usr.sbin/bind/lib/dns/hmac_link.c","usr.sbin/bind/lib/dns/hmac_link.c","dst__hmacsha1_init",585,590
10,2,71,2,10,"hmacsha224_createctx@599-609@usr.sbin/bind/lib/dns/hmac_link.c","usr.sbin/bind/lib/dns/hmac_link.c","hmacsha224_createctx",599,609
8,2,49,1,8,"hmacsha224_destroyctx@612-620@usr.sbin/bind/lib/dns/hmac_link.c","usr.sbin/bind/lib/dns/hmac_link.c","hmacsha224_destroyctx",612,620
5,1,39,2,5,"hmacsha224_adddata@623-628@usr.sbin/bind/lib/dns/hmac_link.c","usr.sbin/bind/lib/dns/hmac_link.c","hmacsha224_adddata",623,628
10,2,67,2,11,"hmacsha224_sign@631-642@usr.sbin/bind/lib/dns/hmac_link.c","usr.sbin/bind/lib/dns/hmac_link.c","hmacsha224_sign",631,642
9,4,66,2,10,"hmacsha224_verify@645-655@usr.sbin/bind/lib/dns/hmac_link.c","usr.sbin/bind/lib/dns/hmac_link.c","hmacsha224_verify",645,655
13,6,100,2,15,"hmacsha224_compare@658-673@usr.sbin/bind/lib/dns/hmac_link.c","usr.sbin/bind/lib/dns/hmac_link.c","hmacsha224_compare",658,673
20,3,137,2,24,"hmacsha224_generate@676-700@usr.sbin/bind/lib/dns/hmac_link.c","usr.sbin/bind/lib/dns/hmac_link.c","hmacsha224_generate",676,700
4,1,19,1,3,"hmacsha224_isprivate@703-706@usr.sbin/bind/lib/dns/hmac_link.c","usr.sbin/bind/lib/dns/hmac_link.c","hmacsha224_isprivate",703,706
6,1,48,1,5,"hmacsha224_destroy@709-714@usr.sbin/bind/lib/dns/hmac_link.c","usr.sbin/bind/lib/dns/hmac_link.c","hmacsha224_destroy",709,714
11,2,82,2,14,"hmacsha224_todns@717-731@usr.sbin/bind/lib/dns/hmac_link.c","usr.sbin/bind/lib/dns/hmac_link.c","hmacsha224_todns",717,731
26,4,178,2,31,"hmacsha224_fromdns@734-765@usr.sbin/bind/lib/dns/hmac_link.c","usr.sbin/bind/lib/dns/hmac_link.c","hmacsha224_fromdns",734,765
20,2,185,2,24,"hmacsha224_tofile@768-792@usr.sbin/bind/lib/dns/hmac_link.c","usr.sbin/bind/lib/dns/hmac_link.c","hmacsha224_tofile",768,792
35,7,226,2,37,"hmacsha224_parse@795-832@usr.sbin/bind/lib/dns/hmac_link.c","usr.sbin/bind/lib/dns/hmac_link.c","hmacsha224_parse",795,832
6,2,33,1,5,"dst__hmacsha224_init@854-859@usr.sbin/bind/lib/dns/hmac_link.c","usr.sbin/bind/lib/dns/hmac_link.c","dst__hmacsha224_init",854,859
10,2,71,2,10,"hmacsha256_createctx@868-878@usr.sbin/bind/lib/dns/hmac_link.c","usr.sbin/bind/lib/dns/hmac_link.c","hmacsha256_createctx",868,878
8,2,49,1,8,"hmacsha256_destroyctx@881-889@usr.sbin/bind/lib/dns/hmac_link.c","usr.sbin/bind/lib/dns/hmac_link.c","hmacsha256_destroyctx",881,889
5,1,39,2,5,"hmacsha256_adddata@892-897@usr.sbin/bind/lib/dns/hmac_link.c","usr.sbin/bind/lib/dns/hmac_link.c","hmacsha256_adddata",892,897
10,2,67,2,11,"hmacsha256_sign@900-911@usr.sbin/bind/lib/dns/hmac_link.c","usr.sbin/bind/lib/dns/hmac_link.c","hmacsha256_sign",900,911
9,4,66,2,10,"hmacsha256_verify@914-924@usr.sbin/bind/lib/dns/hmac_link.c","usr.sbin/bind/lib/dns/hmac_link.c","hmacsha256_verify",914,924
13,6,100,2,15,"hmacsha256_compare@927-942@usr.sbin/bind/lib/dns/hmac_link.c","usr.sbin/bind/lib/dns/hmac_link.c","hmacsha256_compare",927,942
20,3,137,2,24,"hmacsha256_generate@945-969@usr.sbin/bind/lib/dns/hmac_link.c","usr.sbin/bind/lib/dns/hmac_link.c","hmacsha256_generate",945,969
4,1,19,1,3,"hmacsha256_isprivate@972-975@usr.sbin/bind/lib/dns/hmac_link.c","usr.sbin/bind/lib/dns/hmac_link.c","hmacsha256_isprivate",972,975
6,1,48,1,5,"hmacsha256_destroy@978-983@usr.sbin/bind/lib/dns/hmac_link.c","usr.sbin/bind/lib/dns/hmac_link.c","hmacsha256_destroy",978,983
11,2,82,2,14,"hmacsha256_todns@986-1000@usr.sbin/bind/lib/dns/hmac_link.c","usr.sbin/bind/lib/dns/hmac_link.c","hmacsha256_todns",986,1000
26,4,178,2,31,"hmacsha256_fromdns@1003-1034@usr.sbin/bind/lib/dns/hmac_link.c","usr.sbin/bind/lib/dns/hmac_link.c","hmacsha256_fromdns",1003,1034
20,2,185,2,24,"hmacsha256_tofile@1037-1061@usr.sbin/bind/lib/dns/hmac_link.c","usr.sbin/bind/lib/dns/hmac_link.c","hmacsha256_tofile",1037,1061
35,7,226,2,37,"hmacsha256_parse@1064-1101@usr.sbin/bind/lib/dns/hmac_link.c","usr.sbin/bind/lib/dns/hmac_link.c","hmacsha256_parse",1064,1101
6,2,33,1,5,"dst__hmacsha256_init@1123-1128@usr.sbin/bind/lib/dns/hmac_link.c","usr.sbin/bind/lib/dns/hmac_link.c","dst__hmacsha256_init",1123,1128
10,2,71,2,10,"hmacsha384_createctx@1137-1147@usr.sbin/bind/lib/dns/hmac_link.c","usr.sbin/bind/lib/dns/hmac_link.c","hmacsha384_createctx",1137,1147
8,2,49,1,8,"hmacsha384_destroyctx@1150-1158@usr.sbin/bind/lib/dns/hmac_link.c","usr.sbin/bind/lib/dns/hmac_link.c","hmacsha384_destroyctx",1150,1158
5,1,39,2,5,"hmacsha384_adddata@1161-1166@usr.sbin/bind/lib/dns/hmac_link.c","usr.sbin/bind/lib/dns/hmac_link.c","hmacsha384_adddata",1161,1166
10,2,67,2,11,"hmacsha384_sign@1169-1180@usr.sbin/bind/lib/dns/hmac_link.c","usr.sbin/bind/lib/dns/hmac_link.c","hmacsha384_sign",1169,1180
9,4,66,2,10,"hmacsha384_verify@1183-1193@usr.sbin/bind/lib/dns/hmac_link.c","usr.sbin/bind/lib/dns/hmac_link.c","hmacsha384_verify",1183,1193
13,6,100,2,15,"hmacsha384_compare@1196-1211@usr.sbin/bind/lib/dns/hmac_link.c","usr.sbin/bind/lib/dns/hmac_link.c","hmacsha384_compare",1196,1211
20,3,137,2,24,"hmacsha384_generate@1214-1238@usr.sbin/bind/lib/dns/hmac_link.c","usr.sbin/bind/lib/dns/hmac_link.c","hmacsha384_generate",1214,1238
4,1,19,1,3,"hmacsha384_isprivate@1241-1244@usr.sbin/bind/lib/dns/hmac_link.c","usr.sbin/bind/lib/dns/hmac_link.c","hmacsha384_isprivate",1241,1244
6,1,48,1,5,"hmacsha384_destroy@1247-1252@usr.sbin/bind/lib/dns/hmac_link.c","usr.sbin/bind/lib/dns/hmac_link.c","hmacsha384_destroy",1247,1252
11,2,82,2,14,"hmacsha384_todns@1255-1269@usr.sbin/bind/lib/dns/hmac_link.c","usr.sbin/bind/lib/dns/hmac_link.c","hmacsha384_todns",1255,1269
26,4,178,2,31,"hmacsha384_fromdns@1272-1303@usr.sbin/bind/lib/dns/hmac_link.c","usr.sbin/bind/lib/dns/hmac_link.c","hmacsha384_fromdns",1272,1303
20,2,185,2,24,"hmacsha384_tofile@1306-1330@usr.sbin/bind/lib/dns/hmac_link.c","usr.sbin/bind/lib/dns/hmac_link.c","hmacsha384_tofile",1306,1330
35,7,226,2,37,"hmacsha384_parse@1333-1370@usr.sbin/bind/lib/dns/hmac_link.c","usr.sbin/bind/lib/dns/hmac_link.c","hmacsha384_parse",1333,1370
6,2,33,1,5,"dst__hmacsha384_init@1392-1397@usr.sbin/bind/lib/dns/hmac_link.c","usr.sbin/bind/lib/dns/hmac_link.c","dst__hmacsha384_init",1392,1397
10,2,71,2,10,"hmacsha512_createctx@1406-1416@usr.sbin/bind/lib/dns/hmac_link.c","usr.sbin/bind/lib/dns/hmac_link.c","hmacsha512_createctx",1406,1416
8,2,49,1,8,"hmacsha512_destroyctx@1419-1427@usr.sbin/bind/lib/dns/hmac_link.c","usr.sbin/bind/lib/dns/hmac_link.c","hmacsha512_destroyctx",1419,1427
5,1,39,2,5,"hmacsha512_adddata@1430-1435@usr.sbin/bind/lib/dns/hmac_link.c","usr.sbin/bind/lib/dns/hmac_link.c","hmacsha512_adddata",1430,1435
10,2,67,2,11,"hmacsha512_sign@1438-1449@usr.sbin/bind/lib/dns/hmac_link.c","usr.sbin/bind/lib/dns/hmac_link.c","hmacsha512_sign",1438,1449
9,4,66,2,10,"hmacsha512_verify@1452-1462@usr.sbin/bind/lib/dns/hmac_link.c","usr.sbin/bind/lib/dns/hmac_link.c","hmacsha512_verify",1452,1462
13,6,100,2,15,"hmacsha512_compare@1465-1480@usr.sbin/bind/lib/dns/hmac_link.c","usr.sbin/bind/lib/dns/hmac_link.c","hmacsha512_compare",1465,1480
20,3,137,2,24,"hmacsha512_generate@1483-1507@usr.sbin/bind/lib/dns/hmac_link.c","usr.sbin/bind/lib/dns/hmac_link.c","hmacsha512_generate",1483,1507
4,1,19,1,3,"hmacsha512_isprivate@1510-1513@usr.sbin/bind/lib/dns/hmac_link.c","usr.sbin/bind/lib/dns/hmac_link.c","hmacsha512_isprivate",1510,1513
6,1,48,1,5,"hmacsha512_destroy@1516-1521@usr.sbin/bind/lib/dns/hmac_link.c","usr.sbin/bind/lib/dns/hmac_link.c","hmacsha512_destroy",1516,1521
11,2,82,2,14,"hmacsha512_todns@1524-1538@usr.sbin/bind/lib/dns/hmac_link.c","usr.sbin/bind/lib/dns/hmac_link.c","hmacsha512_todns",1524,1538
26,4,178,2,31,"hmacsha512_fromdns@1541-1572@usr.sbin/bind/lib/dns/hmac_link.c","usr.sbin/bind/lib/dns/hmac_link.c","hmacsha512_fromdns",1541,1572
20,2,185,2,24,"hmacsha512_tofile@1575-1599@usr.sbin/bind/lib/dns/hmac_link.c","usr.sbin/bind/lib/dns/hmac_link.c","hmacsha512_tofile",1575,1599
35,7,226,2,37,"hmacsha512_parse@1602-1639@usr.sbin/bind/lib/dns/hmac_link.c","usr.sbin/bind/lib/dns/hmac_link.c","hmacsha512_parse",1602,1639
6,2,33,1,5,"dst__hmacsha512_init@1661-1666@usr.sbin/bind/lib/dns/hmac_link.c","usr.sbin/bind/lib/dns/hmac_link.c","dst__hmacsha512_init",1661,1666
6,1,52,1,5,"decode_uint32@117-122@usr.sbin/bind/lib/dns/journal.c","usr.sbin/bind/lib/dns/journal.c","decode_uint32",117,122
6,1,72,2,5,"encode_uint32@125-130@usr.sbin/bind/lib/dns/journal.c","usr.sbin/bind/lib/dns/journal.c","encode_uint32",125,130
33,4,207,5,40,"dns_db_createsoatuple@133-173@usr.sbin/bind/lib/dns/journal.c","usr.sbin/bind/lib/dns/journal.c","dns_db_createsoatuple",133,173
4,1,34,2,3,"journal_pos_decode@338-341@usr.sbin/bind/lib/dns/journal.c","usr.sbin/bind/lib/dns/journal.c","journal_pos_decode",338,341
4,1,34,2,3,"journal_pos_encode@344-347@usr.sbin/bind/lib/dns/journal.c","usr.sbin/bind/lib/dns/journal.c","journal_pos_encode",344,347
7,1,94,2,6,"journal_header_decode@350-356@usr.sbin/bind/lib/dns/journal.c","usr.sbin/bind/lib/dns/journal.c","journal_header_decode",350,356
8,1,112,2,7,"journal_header_encode@359-366@usr.sbin/bind/lib/dns/journal.c","usr.sbin/bind/lib/dns/journal.c","journal_header_encode",359,366
12,2,72,2,11,"journal_seek@372-383@usr.sbin/bind/lib/dns/journal.c","usr.sbin/bind/lib/dns/journal.c","journal_seek",372,383
14,3,88,3,14,"journal_read@386-400@usr.sbin/bind/lib/dns/journal.c","usr.sbin/bind/lib/dns/journal.c","journal_read",386,400
12,2,77,3,12,"journal_write@403-415@usr.sbin/bind/lib/dns/journal.c","usr.sbin/bind/lib/dns/journal.c","journal_write",403,415
18,3,96,1,17,"journal_fsync@418-435@usr.sbin/bind/lib/dns/journal.c","usr.sbin/bind/lib/dns/journal.c","journal_fsync",418,435
11,2,82,2,10,"journal_read_xhdr@442-452@usr.sbin/bind/lib/dns/journal.c","usr.sbin/bind/lib/dns/journal.c","journal_read_xhdr",442,452
9,1,63,4,8,"journal_write_xhdr@455-463@usr.sbin/bind/lib/dns/journal.c","usr.sbin/bind/lib/dns/journal.c","journal_write_xhdr",455,463
9,2,60,2,8,"journal_read_rrhdr@471-479@usr.sbin/bind/lib/dns/journal.c","usr.sbin/bind/lib/dns/journal.c","journal_read_rrhdr",471,479
50,5,314,2,57,"journal_file_create@482-539@usr.sbin/bind/lib/dns/journal.c","usr.sbin/bind/lib/dns/journal.c","journal_file_create",482,539
92,15,670,5,127,"journal_open@542-669@usr.sbin/bind/lib/dns/journal.c","usr.sbin/bind/lib/dns/journal.c","journal_open",542,669
18,5,134,4,19,"dns_journal_open@672-691@usr.sbin/bind/lib/dns/journal.c","usr.sbin/bind/lib/dns/journal.c","dns_journal_open",672,691
16,3,134,2,18,"ixfr_order@706-724@usr.sbin/bind/lib/dns/journal.c","usr.sbin/bind/lib/dns/journal.c","ixfr_order",706,724
29,6,197,2,43,"journal_next@743-786@usr.sbin/bind/lib/dns/journal.c","usr.sbin/bind/lib/dns/journal.c","journal_next",743,786
11,6,100,3,10,"index_find@796-806@usr.sbin/bind/lib/dns/journal.c","usr.sbin/bind/lib/dns/journal.c","index_find",796,806
23,7,177,2,32,"index_add@818-850@usr.sbin/bind/lib/dns/journal.c","usr.sbin/bind/lib/dns/journal.c","index_add",818,850
9,4,71,2,8,"index_invalidate@857-865@usr.sbin/bind/lib/dns/journal.c","usr.sbin/bind/lib/dns/journal.c","index_invalidate",857,865
24,7,172,3,26,"journal_find@887-913@usr.sbin/bind/lib/dns/journal.c","usr.sbin/bind/lib/dns/journal.c","journal_find",887,913
24,2,182,1,37,"dns_journal_begin_transaction@916-953@usr.sbin/bind/lib/dns/journal.c","usr.sbin/bind/lib/dns/journal.c","dns_journal_begin_transaction",916,953
54,7,447,2,81,"dns_journal_writediff@956-1037@usr.sbin/bind/lib/dns/journal.c","usr.sbin/bind/lib/dns/journal.c","dns_journal_writediff",956,1037
62,12,528,1,106,"dns_journal_commit@1040-1146@usr.sbin/bind/lib/dns/journal.c","usr.sbin/bind/lib/dns/journal.c","dns_journal_commit",1040,1146
10,1,62,2,9,"dns_journal_write_transaction@1149-1158@usr.sbin/bind/lib/dns/journal.c","usr.sbin/bind/lib/dns/journal.c","dns_journal_write_transaction",1149,1158
22,6,225,1,23,"dns_journal_destroy@1161-1184@usr.sbin/bind/lib/dns/journal.c","usr.sbin/bind/lib/dns/journal.c","dns_journal_destroy",1161,1184
83,15,534,2,123,"roll_forward@1194-1317@usr.sbin/bind/lib/dns/journal.c","usr.sbin/bind/lib/dns/journal.c","roll_forward",1194,1317
21,4,126,3,24,"dns_journal_rollforward@1320-1344@usr.sbin/bind/lib/dns/journal.c","usr.sbin/bind/lib/dns/journal.c","dns_journal_rollforward",1320,1344
82,14,490,3,103,"dns_journal_print@1347-1450@usr.sbin/bind/lib/dns/journal.c","usr.sbin/bind/lib/dns/journal.c","dns_journal_print",1347,1450
3,1,19,1,2,"dns_journal_first_serial@1456-1458@usr.sbin/bind/lib/dns/journal.c","usr.sbin/bind/lib/dns/journal.c","dns_journal_first_serial",1456,1458
3,1,19,1,2,"dns_journal_last_serial@1460-1462@usr.sbin/bind/lib/dns/journal.c","usr.sbin/bind/lib/dns/journal.c","dns_journal_last_serial",1460,1462
13,4,90,3,12,"size_buffer@1488-1500@usr.sbin/bind/lib/dns/journal.c","usr.sbin/bind/lib/dns/journal.c","size_buffer",1488,1500
13,1,100,3,15,"dns_journal_iter_init@1503-1518@usr.sbin/bind/lib/dns/journal.c","usr.sbin/bind/lib/dns/journal.c","dns_journal_iter_init",1503,1518
10,1,72,1,17,"dns_journal_first_rr@1522-1539@usr.sbin/bind/lib/dns/journal.c","usr.sbin/bind/lib/dns/journal.c","dns_journal_first_rr",1522,1539
68,10,584,1,110,"read_one_rr@1542-1652@usr.sbin/bind/lib/dns/journal.c","usr.sbin/bind/lib/dns/journal.c","read_one_rr",1542,1652
4,1,28,1,3,"dns_journal_next_rr@1655-1658@usr.sbin/bind/lib/dns/journal.c","usr.sbin/bind/lib/dns/journal.c","dns_journal_next_rr",1655,1658
8,1,60,4,7,"dns_journal_current_rr@1661-1668@usr.sbin/bind/lib/dns/journal.c","usr.sbin/bind/lib/dns/journal.c","dns_journal_current_rr",1661,1668
49,8,275,7,57,"get_name_diff@1685-1742@usr.sbin/bind/lib/dns/journal.c","usr.sbin/bind/lib/dns/journal.c","get_name_diff",1685,1742
12,2,98,2,11,"rdata_order@1751-1762@usr.sbin/bind/lib/dns/journal.c","usr.sbin/bind/lib/dns/journal.c","rdata_order",1751,1762
45,10,379,2,51,"dns_diff_subtract@1765-1816@usr.sbin/bind/lib/dns/journal.c","usr.sbin/bind/lib/dns/journal.c","dns_diff_subtract",1765,1816
102,18,806,6,113,"dns_db_diff@1826-1939@usr.sbin/bind/lib/dns/journal.c","usr.sbin/bind/lib/dns/journal.c","dns_db_diff",1826,1939
147,40,1092,4,213,"dns_journal_compact@1942-2155@usr.sbin/bind/lib/dns/journal.c","usr.sbin/bind/lib/dns/journal.c","dns_journal_compact",1942,2155
21,3,157,1,24,"index_to_disk@2158-2182@usr.sbin/bind/lib/dns/journal.c","usr.sbin/bind/lib/dns/journal.c","index_to_disk",2158,2182
17,4,159,2,22,"dst_region_computeid@35-57@usr.sbin/bind/lib/dns/key.c","usr.sbin/bind/lib/dns/key.c","dst_region_computeid",35,57
4,1,24,1,3,"dst_key_name@60-63@usr.sbin/bind/lib/dns/key.c","usr.sbin/bind/lib/dns/key.c","dst_key_name",60,63
4,1,24,1,3,"dst_key_size@66-69@usr.sbin/bind/lib/dns/key.c","usr.sbin/bind/lib/dns/key.c","dst_key_size",66,69
4,1,24,1,3,"dst_key_proto@72-75@usr.sbin/bind/lib/dns/key.c","usr.sbin/bind/lib/dns/key.c","dst_key_proto",72,75
4,1,24,1,3,"dst_key_alg@78-81@usr.sbin/bind/lib/dns/key.c","usr.sbin/bind/lib/dns/key.c","dst_key_alg",78,81
4,1,24,1,3,"dst_key_flags@84-87@usr.sbin/bind/lib/dns/key.c","usr.sbin/bind/lib/dns/key.c","dst_key_flags",84,87
4,1,24,1,3,"dst_key_id@90-93@usr.sbin/bind/lib/dns/key.c","usr.sbin/bind/lib/dns/key.c","dst_key_id",90,93
4,1,24,1,3,"dst_key_class@96-99@usr.sbin/bind/lib/dns/key.c","usr.sbin/bind/lib/dns/key.c","dst_key_class",96,99
11,5,75,1,11,"dst_key_iszonekey@102-113@usr.sbin/bind/lib/dns/key.c","usr.sbin/bind/lib/dns/key.c","dst_key_iszonekey",102,113
11,5,75,1,11,"dst_key_isnullkey@116-127@usr.sbin/bind/lib/dns/key.c","usr.sbin/bind/lib/dns/key.c","dst_key_isnullkey",116,127
10,2,61,2,9,"dst_key_setbits@130-139@usr.sbin/bind/lib/dns/key.c","usr.sbin/bind/lib/dns/key.c","dst_key_setbits",130,139
4,1,24,1,3,"dst_key_getbits@142-145@usr.sbin/bind/lib/dns/key.c","usr.sbin/bind/lib/dns/key.c","dst_key_getbits",142,145
9,2,69,2,9,"free_keynode@60-69@usr.sbin/bind/lib/dns/keytable.c","usr.sbin/bind/lib/dns/keytable.c","free_keynode",60,69
31,6,202,2,45,"dns_keytable_create@72-117@usr.sbin/bind/lib/dns/keytable.c","usr.sbin/bind/lib/dns/keytable.c","dns_keytable_create",72,117
10,2,80,2,18,"dns_keytable_attach@121-139@usr.sbin/bind/lib/dns/keytable.c","usr.sbin/bind/lib/dns/keytable.c","dns_keytable_attach",121,139
22,5,159,1,32,"dns_keytable_detach@142-174@usr.sbin/bind/lib/dns/keytable.c","usr.sbin/bind/lib/dns/keytable.c","dns_keytable_detach",142,174
28,5,192,2,40,"dns_keytable_add@177-217@usr.sbin/bind/lib/dns/keytable.c","usr.sbin/bind/lib/dns/keytable.c","dns_keytable_add",177,217
33,8,217,5,50,"dns_keytable_findkeynode@220-270@usr.sbin/bind/lib/dns/keytable.c","usr.sbin/bind/lib/dns/keytable.c","dns_keytable_findkeynode",220,270
23,6,151,3,30,"dns_keytable_findnextkeynode@273-303@usr.sbin/bind/lib/dns/keytable.c","usr.sbin/bind/lib/dns/keytable.c","dns_keytable_findnextkeynode",273,303
16,3,107,3,25,"dns_keytable_finddeepestmatch@306-331@usr.sbin/bind/lib/dns/keytable.c","usr.sbin/bind/lib/dns/keytable.c","dns_keytable_finddeepestmatch",306,331
10,2,68,2,15,"dns_keytable_detachkeynode@334-349@usr.sbin/bind/lib/dns/keytable.c","usr.sbin/bind/lib/dns/keytable.c","dns_keytable_detachkeynode",334,349
22,4,139,3,31,"dns_keytable_issecuredomain@352-383@usr.sbin/bind/lib/dns/keytable.c","usr.sbin/bind/lib/dns/keytable.c","dns_keytable_issecuredomain",352,383
4,1,23,1,9,"dns_keynode_key@386-395@usr.sbin/bind/lib/dns/keytable.c","usr.sbin/bind/lib/dns/keytable.c","dns_keynode_key",386,395
3,1,14,1,2,"open_msgcat@52-54@usr.sbin/bind/lib/dns/lib.c","usr.sbin/bind/lib/dns/lib.c","open_msgcat",52,54
3,1,19,1,8,"dns_lib_initmsgcat@57-65@usr.sbin/bind/lib/dns/lib.c","usr.sbin/bind/lib/dns/lib.c","dns_lib_initmsgcat",57,65
5,1,29,1,5,"dns_log_init@87-92@usr.sbin/bind/lib/dns/log.c","usr.sbin/bind/lib/dns/log.c","dns_log_init",87,92
3,1,12,1,2,"dns_log_setcontext@95-97@usr.sbin/bind/lib/dns/log.c","usr.sbin/bind/lib/dns/log.c","dns_log_setcontext",95,97
11,1,81,2,12,"fetch_done@67-79@usr.sbin/bind/lib/dns/lookup.c","usr.sbin/bind/lib/dns/lookup.c","fetch_done",67,79
13,1,79,1,19,"start_fetch@82-101@usr.sbin/bind/lib/dns/lookup.c","usr.sbin/bind/lib/dns/lookup.c","start_fetch",82,101
51,11,313,1,56,"build_event@104-160@usr.sbin/bind/lib/dns/lookup.c","usr.sbin/bind/lib/dns/lookup.c","build_event",104,160
14,2,99,2,15,"view_find@163-178@usr.sbin/bind/lib/dns/lookup.c","usr.sbin/bind/lib/dns/lookup.c","view_find",163,178
138,32,881,2,172,"lookup_find@181-353@usr.sbin/bind/lib/dns/lookup.c","usr.sbin/bind/lib/dns/lookup.c","lookup_find",181,353
25,7,190,1,26,"levent_destroy@356-382@usr.sbin/bind/lib/dns/lookup.c","usr.sbin/bind/lib/dns/lookup.c","levent_destroy",356,382
59,5,407,9,73,"dns_lookup_create@385-458@usr.sbin/bind/lib/dns/lookup.c","usr.sbin/bind/lib/dns/lookup.c","dns_lookup_create",385,458
12,3,73,1,14,"dns_lookup_cancel@461-475@usr.sbin/bind/lib/dns/lookup.c","usr.sbin/bind/lib/dns/lookup.c","dns_lookup_cancel",461,475
17,3,129,1,19,"dns_lookup_destroy@478-497@usr.sbin/bind/lib/dns/lookup.c","usr.sbin/bind/lib/dns/lookup.c","dns_lookup_destroy",478,497
35,7,170,5,36,"gettoken@345-381@usr.sbin/bind/lib/dns/master.c","usr.sbin/bind/lib/dns/master.c","gettoken",345,381
10,2,76,2,12,"dns_loadctx_attach@385-397@usr.sbin/bind/lib/dns/master.c","usr.sbin/bind/lib/dns/master.c","dns_loadctx_attach",385,397
16,3,93,1,18,"dns_loadctx_detach@400-418@usr.sbin/bind/lib/dns/master.c","usr.sbin/bind/lib/dns/master.c","dns_loadctx_detach",400,418
11,2,58,2,13,"incctx_destroy@421-434@usr.sbin/bind/lib/dns/master.c","usr.sbin/bind/lib/dns/master.c","incctx_destroy",421,434
26,7,175,1,31,"loadctx_destroy@437-468@usr.sbin/bind/lib/dns/master.c","usr.sbin/bind/lib/dns/master.c","loadctx_destroy",437,468
27,3,197,3,31,"incctx_create@471-502@usr.sbin/bind/lib/dns/master.c","usr.sbin/bind/lib/dns/master.c","incctx_create",471,502
99,14,650,12,108,"loadctx_create@505-613@usr.sbin/bind/lib/dns/master.c","usr.sbin/bind/lib/dns/master.c","loadctx_create",505,613
81,23,520,4,84,"genname@616-700@usr.sbin/bind/lib/dns/master.c","usr.sbin/bind/lib/dns/master.c","genname",616,700
3,1,25,2,2,"openfile_text@703-705@usr.sbin/bind/lib/dns/master.c","usr.sbin/bind/lib/dns/master.c","openfile_text",703,705
10,3,61,2,11,"openfile_raw@708-719@usr.sbin/bind/lib/dns/master.c","usr.sbin/bind/lib/dns/master.c","openfile_raw",708,719
145,31,954,7,167,"generate@722-889@usr.sbin/bind/lib/dns/master.c","usr.sbin/bind/lib/dns/master.c","generate",722,889
14,2,57,4,13,"limit_ttl@892-905@usr.sbin/bind/lib/dns/master.c","usr.sbin/bind/lib/dns/master.c","limit_ttl",892,905
30,9,225,4,35,"check_ns@908-943@usr.sbin/bind/lib/dns/master.c","usr.sbin/bind/lib/dns/master.c","check_ns",908,943
13,3,89,4,14,"check_wildcard@946-960@usr.sbin/bind/lib/dns/master.c","usr.sbin/bind/lib/dns/master.c","check_wildcard",946,960
821,198,4937,1,995,"load_text@963-1958@usr.sbin/bind/lib/dns/master.c","usr.sbin/bind/lib/dns/master.c","load_text",963,1958
38,9,271,3,44,"pushfile@1961-2005@usr.sbin/bind/lib/dns/master.c","usr.sbin/bind/lib/dns/master.c","pushfile",1961,2005
15,4,93,4,16,"read_and_check@2008-2024@usr.sbin/bind/lib/dns/master.c","usr.sbin/bind/lib/dns/master.c","read_and_check",2008,2024
212,37,1383,1,294,"load_raw@2027-2321@usr.sbin/bind/lib/dns/master.c","usr.sbin/bind/lib/dns/master.c","load_raw",2027,2321
8,1,54,7,7,"dns_master_loadfile@2324-2331@usr.sbin/bind/lib/dns/master.c","usr.sbin/bind/lib/dns/master.c","dns_master_loadfile",2324,2331
21,3,138,8,24,"dns_master_loadfile2@2334-2358@usr.sbin/bind/lib/dns/master.c","usr.sbin/bind/lib/dns/master.c","dns_master_loadfile2",2334,2358
11,1,77,11,10,"dns_master_loadfileinc@2361-2371@usr.sbin/bind/lib/dns/master.c","usr.sbin/bind/lib/dns/master.c","dns_master_loadfileinc",2361,2371
27,4,176,12,31,"dns_master_loadfileinc2@2374-2405@usr.sbin/bind/lib/dns/master.c","usr.sbin/bind/lib/dns/master.c","dns_master_loadfileinc2",2374,2405
22,4,143,7,26,"dns_master_loadstream@2408-2434@usr.sbin/bind/lib/dns/master.c","usr.sbin/bind/lib/dns/master.c","dns_master_loadstream",2408,2434
29,5,181,11,33,"dns_master_loadstreaminc@2437-2470@usr.sbin/bind/lib/dns/master.c","usr.sbin/bind/lib/dns/master.c","dns_master_loadstreaminc",2437,2470
22,3,139,7,26,"dns_master_loadbuffer@2473-2499@usr.sbin/bind/lib/dns/master.c","usr.sbin/bind/lib/dns/master.c","dns_master_loadbuffer",2473,2499
29,4,177,11,33,"dns_master_loadbufferinc@2502-2535@usr.sbin/bind/lib/dns/master.c","usr.sbin/bind/lib/dns/master.c","dns_master_loadbufferinc",2502,2535
18,2,117,7,21,"dns_master_loadlexer@2538-2559@usr.sbin/bind/lib/dns/master.c","usr.sbin/bind/lib/dns/master.c","dns_master_loadlexer",2538,2559
25,3,155,11,28,"dns_master_loadlexerinc@2562-2590@usr.sbin/bind/lib/dns/master.c","usr.sbin/bind/lib/dns/master.c","dns_master_loadlexerinc",2562,2590
40,7,298,6,43,"grow_rdatalist@2597-2640@usr.sbin/bind/lib/dns/master.c","usr.sbin/bind/lib/dns/master.c","grow_rdatalist",2597,2640
48,9,357,6,56,"grow_rdata@2647-2703@usr.sbin/bind/lib/dns/master.c","usr.sbin/bind/lib/dns/master.c","grow_rdata",2647,2703
45,8,291,6,46,"commit@2711-2757@usr.sbin/bind/lib/dns/master.c","usr.sbin/bind/lib/dns/master.c","commit",2711,2757
24,6,145,2,28,"is_glue@2764-2792@usr.sbin/bind/lib/dns/master.c","usr.sbin/bind/lib/dns/master.c","is_glue",2764,2792
19,3,112,2,20,"load_quantum@2795-2815@usr.sbin/bind/lib/dns/master.c","usr.sbin/bind/lib/dns/master.c","load_quantum",2795,2815
10,2,61,1,10,"task_send@2818-2828@usr.sbin/bind/lib/dns/master.c","usr.sbin/bind/lib/dns/master.c","task_send",2818,2828
6,1,38,1,6,"dns_loadctx_cancel@2831-2837@usr.sbin/bind/lib/dns/master.c","usr.sbin/bind/lib/dns/master.c","dns_loadctx_cancel",2831,2837
49,10,277,4,57,"indent@194-251@usr.sbin/bind/lib/dns/masterdump.c","usr.sbin/bind/lib/dns/masterdump.c","indent",194,251
38,6,260,2,57,"totext_ctx_init@254-311@usr.sbin/bind/lib/dns/masterdump.c","usr.sbin/bind/lib/dns/masterdump.c","totext_ctx_init",254,311
11,2,71,2,13,"str_totext@323-336@usr.sbin/bind/lib/dns/masterdump.c","usr.sbin/bind/lib/dns/masterdump.c","str_totext",323,336
115,23,682,5,160,"rdataset_totext@346-506@usr.sbin/bind/lib/dns/masterdump.c","usr.sbin/bind/lib/dns/masterdump.c","rdataset_totext",346,506
45,4,229,5,54,"question_totext@514-568@usr.sbin/bind/lib/dns/masterdump.c","usr.sbin/bind/lib/dns/masterdump.c","question_totext",514,568
23,4,113,5,30,"dns_rdataset_totext@571-601@usr.sbin/bind/lib/dns/masterdump.c","usr.sbin/bind/lib/dns/masterdump.c","dns_rdataset_totext",571,601
16,2,76,4,16,"dns_master_rdatasettotext@604-620@usr.sbin/bind/lib/dns/masterdump.c","usr.sbin/bind/lib/dns/masterdump.c","dns_master_rdatasettotext",604,620
16,2,76,4,16,"dns_master_questiontotext@623-639@usr.sbin/bind/lib/dns/masterdump.c","usr.sbin/bind/lib/dns/masterdump.c","dns_master_questiontotext",623,639
54,10,345,6,72,"dump_rdataset@649-721@usr.sbin/bind/lib/dns/masterdump.c","usr.sbin/bind/lib/dns/masterdump.c","dump_rdataset",649,721
23,4,90,1,22,"dump_order@733-755@usr.sbin/bind/lib/dns/masterdump.c","usr.sbin/bind/lib/dns/masterdump.c","dump_order",733,755
4,1,47,2,3,"dump_order_compare@758-761@usr.sbin/bind/lib/dns/masterdump.c","usr.sbin/bind/lib/dns/masterdump.c","dump_order_compare",758,761
59,14,414,6,72,"dump_rdatasets_text@788-860@usr.sbin/bind/lib/dns/masterdump.c","usr.sbin/bind/lib/dns/masterdump.c","dump_rdatasets_text",788,860
70,6,491,5,104,"dump_rdataset_raw@866-970@usr.sbin/bind/lib/dns/masterdump.c","usr.sbin/bind/lib/dns/masterdump.c","dump_rdataset_raw",866,970
23,5,132,6,28,"dump_rdatasets_raw@973-1001@usr.sbin/bind/lib/dns/masterdump.c","usr.sbin/bind/lib/dns/masterdump.c","dump_rdatasets_raw",973,1001
15,5,130,1,15,"dumpctx_destroy@1019-1034@usr.sbin/bind/lib/dns/masterdump.c","usr.sbin/bind/lib/dns/masterdump.c","dumpctx_destroy",1019,1034
10,2,76,2,12,"dns_dumpctx_attach@1037-1049@usr.sbin/bind/lib/dns/masterdump.c","usr.sbin/bind/lib/dns/masterdump.c","dns_dumpctx_attach",1037,1049
16,3,93,1,18,"dns_dumpctx_detach@1052-1070@usr.sbin/bind/lib/dns/masterdump.c","usr.sbin/bind/lib/dns/masterdump.c","dns_dumpctx_detach",1052,1070
4,1,23,1,3,"dns_dumpctx_version@1073-1076@usr.sbin/bind/lib/dns/masterdump.c","usr.sbin/bind/lib/dns/masterdump.c","dns_dumpctx_version",1073,1076
4,1,23,1,3,"dns_dumpctx_db@1079-1082@usr.sbin/bind/lib/dns/masterdump.c","usr.sbin/bind/lib/dns/masterdump.c","dns_dumpctx_db",1079,1082
6,1,38,1,6,"dns_dumpctx_cancel@1085-1091@usr.sbin/bind/lib/dns/masterdump.c","usr.sbin/bind/lib/dns/masterdump.c","dns_dumpctx_cancel",1085,1091
35,10,191,4,35,"closeandrename@1094-1129@usr.sbin/bind/lib/dns/masterdump.c","usr.sbin/bind/lib/dns/masterdump.c","closeandrename",1094,1129
26,6,153,2,27,"dump_quantum@1132-1159@usr.sbin/bind/lib/dns/masterdump.c","usr.sbin/bind/lib/dns/masterdump.c","dump_quantum",1132,1159
9,2,61,1,9,"task_send@1162-1171@usr.sbin/bind/lib/dns/masterdump.c","usr.sbin/bind/lib/dns/masterdump.c","task_send",1162,1171
73,14,456,7,81,"dumpctx_create@1174-1255@usr.sbin/bind/lib/dns/masterdump.c","usr.sbin/bind/lib/dns/masterdump.c","dumpctx_create",1174,1255
133,26,844,1,165,"dumptostreaminc@1258-1423@usr.sbin/bind/lib/dns/masterdump.c","usr.sbin/bind/lib/dns/masterdump.c","dumptostreaminc",1258,1423
28,3,167,9,31,"dns_master_dumptostreaminc@1426-1457@usr.sbin/bind/lib/dns/masterdump.c","usr.sbin/bind/lib/dns/masterdump.c","dns_master_dumptostreaminc",1426,1457
8,1,43,5,7,"dns_master_dumptostream@1463-1470@usr.sbin/bind/lib/dns/masterdump.c","usr.sbin/bind/lib/dns/masterdump.c","dns_master_dumptostream",1463,1470
15,2,93,6,16,"dns_master_dumptostream2@1473-1489@usr.sbin/bind/lib/dns/masterdump.c","usr.sbin/bind/lib/dns/masterdump.c","dns_master_dumptostream2",1473,1489
27,4,158,4,30,"opentmp@1492-1522@usr.sbin/bind/lib/dns/masterdump.c","usr.sbin/bind/lib/dns/masterdump.c","opentmp",1492,1522
9,1,67,9,8,"dns_master_dumpinc@1525-1533@usr.sbin/bind/lib/dns/masterdump.c","usr.sbin/bind/lib/dns/masterdump.c","dns_master_dumpinc",1525,1533
44,8,282,10,49,"dns_master_dumpinc2@1536-1585@usr.sbin/bind/lib/dns/masterdump.c","usr.sbin/bind/lib/dns/masterdump.c","dns_master_dumpinc2",1536,1585
6,1,44,5,5,"dns_master_dump@1588-1593@usr.sbin/bind/lib/dns/masterdump.c","usr.sbin/bind/lib/dns/masterdump.c","dns_master_dump",1588,1593
22,3,150,6,26,"dns_master_dump2@1596-1622@usr.sbin/bind/lib/dns/masterdump.c","usr.sbin/bind/lib/dns/masterdump.c","dns_master_dump2",1596,1622
35,5,206,7,41,"dns_master_dumpnodetostream@1629-1670@usr.sbin/bind/lib/dns/masterdump.c","usr.sbin/bind/lib/dns/masterdump.c","dns_master_dumpnodetostream",1629,1670
26,3,152,7,29,"dns_master_dumpnode@1673-1702@usr.sbin/bind/lib/dns/masterdump.c","usr.sbin/bind/lib/dns/masterdump.c","dns_master_dumpnode",1673,1702
21,3,132,9,23,"dns_master_stylecreate@1705-1728@usr.sbin/bind/lib/dns/masterdump.c","usr.sbin/bind/lib/dns/masterdump.c","dns_master_stylecreate",1705,1728
7,2,51,2,7,"dns_master_styledestroy@1731-1738@usr.sbin/bind/lib/dns/masterdump.c","usr.sbin/bind/lib/dns/masterdump.c","dns_master_styledestroy",1731,1738
14,2,81,3,18,"msgblock_allocate@169-187@usr.sbin/bind/lib/dns/message.c","usr.sbin/bind/lib/dns/message.c","msgblock_allocate",169,187
10,3,69,2,13,"msgblock_internalget@194-207@usr.sbin/bind/lib/dns/message.c","usr.sbin/bind/lib/dns/message.c","msgblock_internalget",194,207
3,1,16,1,2,"msgblock_reset@210-212@usr.sbin/bind/lib/dns/message.c","usr.sbin/bind/lib/dns/message.c","msgblock_reset",210,212
6,1,44,3,7,"msgblock_free@218-225@usr.sbin/bind/lib/dns/message.c","usr.sbin/bind/lib/dns/message.c","msgblock_free",218,225
10,2,64,2,11,"newbuffer@233-244@usr.sbin/bind/lib/dns/message.c","usr.sbin/bind/lib/dns/message.c","newbuffer",233,244
6,1,33,1,7,"currentbuffer@247-254@usr.sbin/bind/lib/dns/message.c","usr.sbin/bind/lib/dns/message.c","currentbuffer",247,254
3,1,23,2,2,"releaserdata@257-259@usr.sbin/bind/lib/dns/message.c","usr.sbin/bind/lib/dns/message.c","releaserdata",257,259
21,4,132,1,25,"newrdata@262-287@usr.sbin/bind/lib/dns/message.c","usr.sbin/bind/lib/dns/message.c","newrdata",262,287
3,1,23,2,2,"releaserdatalist@290-292@usr.sbin/bind/lib/dns/message.c","usr.sbin/bind/lib/dns/message.c","releaserdatalist",290,292
21,4,127,1,25,"newrdatalist@295-320@usr.sbin/bind/lib/dns/message.c","usr.sbin/bind/lib/dns/message.c","newrdatalist",295,320
16,3,94,1,19,"newoffsets@323-342@usr.sbin/bind/lib/dns/message.c","usr.sbin/bind/lib/dns/message.c","newoffsets",323,342
7,1,38,1,6,"msginitheader@345-351@usr.sbin/bind/lib/dns/message.c","usr.sbin/bind/lib/dns/message.c","msginitheader",345,351
17,2,105,1,17,"msginitprivate@354-371@usr.sbin/bind/lib/dns/message.c","usr.sbin/bind/lib/dns/message.c","msginitprivate",354,371
10,1,57,1,9,"msginittsig@374-383@usr.sbin/bind/lib/dns/message.c","usr.sbin/bind/lib/dns/message.c","msginittsig",374,383
19,1,115,1,18,"msginit@390-408@usr.sbin/bind/lib/dns/message.c","usr.sbin/bind/lib/dns/message.c","msginit",390,408
25,5,180,2,30,"msgresetnames@411-441@usr.sbin/bind/lib/dns/message.c","usr.sbin/bind/lib/dns/message.c","msgresetnames",411,441
13,3,77,1,12,"msgresetopt@444-456@usr.sbin/bind/lib/dns/message.c","usr.sbin/bind/lib/dns/message.c","msgresetopt",444,456
42,11,309,2,41,"msgresetsigs@459-500@usr.sbin/bind/lib/dns/message.c","usr.sbin/bind/lib/dns/message.c","msgresetsigs",459,500
93,21,656,2,123,"msgreset@507-630@usr.sbin/bind/lib/dns/message.c","usr.sbin/bind/lib/dns/message.c","msgreset",507,630
15,3,98,2,36,"spacefortsig@633-669@usr.sbin/bind/lib/dns/message.c","usr.sbin/bind/lib/dns/message.c","spacefortsig",633,669
62,10,429,3,85,"dns_message_create@672-757@usr.sbin/bind/lib/dns/message.c","usr.sbin/bind/lib/dns/message.c","dns_message_create",672,757
7,2,44,2,7,"dns_message_reset@760-767@usr.sbin/bind/lib/dns/message.c","usr.sbin/bind/lib/dns/message.c","dns_message_reset",760,767
12,1,81,1,14,"dns_message_destroy@770-784@usr.sbin/bind/lib/dns/message.c","usr.sbin/bind/lib/dns/message.c","dns_message_destroy",770,784
15,4,77,3,16,"findname@787-803@usr.sbin/bind/lib/dns/message.c","usr.sbin/bind/lib/dns/message.c","findname",787,803
20,7,110,5,22,"dns_message_find@806-828@usr.sbin/bind/lib/dns/message.c","usr.sbin/bind/lib/dns/message.c","dns_message_find",806,828
19,6,108,4,21,"dns_message_findtype@831-852@usr.sbin/bind/lib/dns/message.c","usr.sbin/bind/lib/dns/message.c","dns_message_findtype",831,852
25,4,126,4,34,"getname@858-892@usr.sbin/bind/lib/dns/message.c","usr.sbin/bind/lib/dns/message.c","getname",858,892
37,7,188,7,50,"getrdata@895-945@usr.sbin/bind/lib/dns/message.c","usr.sbin/bind/lib/dns/message.c","getrdata",895,945
103,19,577,4,159,"getquestions@958-1117@usr.sbin/bind/lib/dns/message.c","usr.sbin/bind/lib/dns/message.c","getquestions",958,1117
8,4,51,2,7,"update@1120-1127@usr.sbin/bind/lib/dns/message.c","usr.sbin/bind/lib/dns/message.c","update",1120,1127
261,79,1420,5,402,"getsection@1130-1532@usr.sbin/bind/lib/dns/message.c","usr.sbin/bind/lib/dns/message.c","getsection",1130,1532
96,24,625,3,114,"dns_message_parse@1535-1649@usr.sbin/bind/lib/dns/message.c","usr.sbin/bind/lib/dns/message.c","dns_message_parse",1535,1649
19,3,117,3,36,"dns_message_renderbegin@1652-1688@usr.sbin/bind/lib/dns/message.c","usr.sbin/bind/lib/dns/message.c","dns_message_renderbegin",1652,1688
14,1,110,2,26,"dns_message_renderchangebuffer@1691-1717@usr.sbin/bind/lib/dns/message.c","usr.sbin/bind/lib/dns/message.c","dns_message_renderchangebuffer",1691,1717
5,1,35,2,5,"dns_message_renderrelease@1720-1725@usr.sbin/bind/lib/dns/message.c","usr.sbin/bind/lib/dns/message.c","dns_message_renderrelease",1720,1725
11,3,73,2,14,"dns_message_renderreserve@1728-1742@usr.sbin/bind/lib/dns/message.c","usr.sbin/bind/lib/dns/message.c","dns_message_renderreserve",1728,1742
23,8,97,3,29,"wrong_priority@1745-1774@usr.sbin/bind/lib/dns/message.c","usr.sbin/bind/lib/dns/message.c","wrong_priority",1745,1774
159,31,856,3,203,"dns_message_rendersection@1777-1980@usr.sbin/bind/lib/dns/message.c","usr.sbin/bind/lib/dns/message.c","dns_message_rendersection",1777,1980
26,4,200,2,31,"dns_message_renderheader@1983-2014@usr.sbin/bind/lib/dns/message.c","usr.sbin/bind/lib/dns/message.c","dns_message_renderheader",1983,2014
74,16,501,1,113,"dns_message_renderend@2017-2130@usr.sbin/bind/lib/dns/message.c","usr.sbin/bind/lib/dns/message.c","dns_message_renderend",2017,2130
31,7,209,1,37,"dns_message_renderreset@2133-2170@usr.sbin/bind/lib/dns/message.c","usr.sbin/bind/lib/dns/message.c","dns_message_renderreset",2133,2170
8,2,65,2,10,"dns_message_firstname@2173-2183@usr.sbin/bind/lib/dns/message.c","usr.sbin/bind/lib/dns/message.c","dns_message_firstname",2173,2183
9,2,79,2,11,"dns_message_nextname@2186-2197@usr.sbin/bind/lib/dns/message.c","usr.sbin/bind/lib/dns/message.c","dns_message_nextname",2186,2197
9,2,65,3,9,"dns_message_currentname@2200-2209@usr.sbin/bind/lib/dns/message.c","usr.sbin/bind/lib/dns/message.c","dns_message_currentname",2200,2209
33,9,196,7,48,"dns_message_findname@2212-2260@usr.sbin/bind/lib/dns/message.c","usr.sbin/bind/lib/dns/message.c","dns_message_findname",2212,2260
12,1,85,4,15,"dns_message_movename@2263-2278@usr.sbin/bind/lib/dns/message.c","usr.sbin/bind/lib/dns/message.c","dns_message_movename",2263,2278
9,1,60,3,9,"dns_message_addname@2281-2290@usr.sbin/bind/lib/dns/message.c","usr.sbin/bind/lib/dns/message.c","dns_message_addname",2281,2290
9,1,60,3,9,"dns_message_removename@2293-2302@usr.sbin/bind/lib/dns/message.c","usr.sbin/bind/lib/dns/message.c","dns_message_removename",2293,2302
9,3,67,2,10,"dns_message_gettempname@2305-2315@usr.sbin/bind/lib/dns/message.c","usr.sbin/bind/lib/dns/message.c","dns_message_gettempname",2305,2315
8,3,57,2,9,"dns_message_gettempoffsets@2318-2327@usr.sbin/bind/lib/dns/message.c","usr.sbin/bind/lib/dns/message.c","dns_message_gettempoffsets",2318,2327
8,3,57,2,9,"dns_message_gettemprdata@2330-2339@usr.sbin/bind/lib/dns/message.c","usr.sbin/bind/lib/dns/message.c","dns_message_gettemprdata",2330,2339
9,3,65,2,11,"dns_message_gettemprdataset@2342-2353@usr.sbin/bind/lib/dns/message.c","usr.sbin/bind/lib/dns/message.c","dns_message_gettemprdataset",2342,2353
8,3,57,2,9,"dns_message_gettemprdatalist@2356-2365@usr.sbin/bind/lib/dns/message.c","usr.sbin/bind/lib/dns/message.c","dns_message_gettemprdatalist",2356,2365
8,3,65,2,8,"dns_message_puttempname@2368-2376@usr.sbin/bind/lib/dns/message.c","usr.sbin/bind/lib/dns/message.c","dns_message_puttempname",2368,2376
6,2,45,2,6,"dns_message_puttemprdata@2379-2385@usr.sbin/bind/lib/dns/message.c","usr.sbin/bind/lib/dns/message.c","dns_message_puttemprdata",2379,2385
7,2,57,2,7,"dns_message_puttemprdataset@2388-2395@usr.sbin/bind/lib/dns/message.c","usr.sbin/bind/lib/dns/message.c","dns_message_puttemprdataset",2388,2395
6,2,45,2,6,"dns_message_puttemprdatalist@2398-2404@usr.sbin/bind/lib/dns/message.c","usr.sbin/bind/lib/dns/message.c","dns_message_puttemprdatalist",2398,2404
21,4,111,3,26,"dns_message_peekheader@2407-2433@usr.sbin/bind/lib/dns/message.c","usr.sbin/bind/lib/dns/message.c","dns_message_peekheader",2407,2433
46,10,294,2,57,"dns_message_reply@2436-2493@usr.sbin/bind/lib/dns/message.c","usr.sbin/bind/lib/dns/message.c","dns_message_reply",2436,2493
4,1,23,1,9,"dns_message_getopt@2496-2505@usr.sbin/bind/lib/dns/message.c","usr.sbin/bind/lib/dns/message.c","dns_message_getopt",2496,2505
24,3,148,2,48,"dns_message_setopt@2508-2556@usr.sbin/bind/lib/dns/message.c","usr.sbin/bind/lib/dns/message.c","dns_message_setopt",2508,2556
7,3,52,2,12,"dns_message_gettsig@2559-2571@usr.sbin/bind/lib/dns/message.c","usr.sbin/bind/lib/dns/message.c","dns_message_gettsig",2559,2571
27,8,178,2,32,"dns_message_settsigkey@2574-2606@usr.sbin/bind/lib/dns/message.c","usr.sbin/bind/lib/dns/message.c","dns_message_settsigkey",2574,2606
4,1,23,1,9,"dns_message_gettsigkey@2609-2618@usr.sbin/bind/lib/dns/message.c","usr.sbin/bind/lib/dns/message.c","dns_message_gettsigkey",2609,2618
45,10,302,2,52,"dns_message_setquerytsig@2621-2673@usr.sbin/bind/lib/dns/message.c","usr.sbin/bind/lib/dns/message.c","dns_message_setquerytsig",2621,2673
21,5,149,3,24,"dns_message_getquerytsig@2676-2700@usr.sbin/bind/lib/dns/message.c","usr.sbin/bind/lib/dns/message.c","dns_message_getquerytsig",2676,2700
11,5,74,2,20,"dns_message_getsig0@2703-2723@usr.sbin/bind/lib/dns/message.c","usr.sbin/bind/lib/dns/message.c","dns_message_getsig0",2703,2723
25,5,164,2,49,"dns_message_setsig0key@2726-2775@usr.sbin/bind/lib/dns/message.c","usr.sbin/bind/lib/dns/message.c","dns_message_setsig0key",2726,2775
4,1,23,1,9,"dns_message_getsig0key@2778-2787@usr.sbin/bind/lib/dns/message.c","usr.sbin/bind/lib/dns/message.c","dns_message_getsig0key",2778,2787
7,1,53,2,7,"dns_message_takebuffer@2790-2797@usr.sbin/bind/lib/dns/message.c","usr.sbin/bind/lib/dns/message.c","dns_message_takebuffer",2790,2797
60,15,387,2,77,"dns_message_signer@2800-2877@usr.sbin/bind/lib/dns/message.c","usr.sbin/bind/lib/dns/message.c","dns_message_signer",2800,2877
12,2,70,1,11,"dns_message_resetsig@2880-2891@usr.sbin/bind/lib/dns/message.c","usr.sbin/bind/lib/dns/message.c","dns_message_resetsig",2880,2891
4,1,27,2,3,"dns_message_rechecksig@2894-2897@usr.sbin/bind/lib/dns/message.c","usr.sbin/bind/lib/dns/message.c","dns_message_rechecksig",2894,2897
75,21,512,2,93,"dns_message_checksig@2900-2993@usr.sbin/bind/lib/dns/message.c","usr.sbin/bind/lib/dns/message.c","dns_message_checksig",2900,2993
56,12,319,5,59,"dns_message_sectiontotext@2996-3055@usr.sbin/bind/lib/dns/message.c","usr.sbin/bind/lib/dns/message.c","dns_message_sectiontotext",2996,3055
63,16,452,5,64,"dns_message_pseudosectiontotext@3058-3122@usr.sbin/bind/lib/dns/message.c","usr.sbin/bind/lib/dns/message.c","dns_message_pseudosectiontotext",3058,3122
97,20,702,4,102,"dns_message_totext@3125-3227@usr.sbin/bind/lib/dns/message.c","usr.sbin/bind/lib/dns/message.c","dns_message_totext",3125,3227
4,1,24,1,3,"dns_message_getrawmessage@3230-3233@usr.sbin/bind/lib/dns/message.c","usr.sbin/bind/lib/dns/message.c","dns_message_getrawmessage",3230,3233
7,1,36,3,6,"dns_message_setsortorder@3236-3242@usr.sbin/bind/lib/dns/message.c","usr.sbin/bind/lib/dns/message.c","dns_message_setsortorder",3236,3242
4,1,25,2,3,"dns_message_settimeadjust@3245-3248@usr.sbin/bind/lib/dns/message.c","usr.sbin/bind/lib/dns/message.c","dns_message_settimeadjust",3245,3248
4,1,23,1,3,"dns_message_gettimeadjust@3251-3254@usr.sbin/bind/lib/dns/message.c","usr.sbin/bind/lib/dns/message.c","dns_message_gettimeadjust",3251,3254
7,2,53,2,8,"dns_opcode_totext@3257-3265@usr.sbin/bind/lib/dns/message.c","usr.sbin/bind/lib/dns/message.c","dns_opcode_totext",3257,3265
3,1,20,2,5,"dns_name_init@208-213@usr.sbin/bind/lib/dns/name.c","usr.sbin/bind/lib/dns/name.c","dns_name_init",208,213
5,1,29,1,5,"dns_name_reset@216-221@usr.sbin/bind/lib/dns/name.c","usr.sbin/bind/lib/dns/name.c","dns_name_reset",216,221
11,1,65,1,15,"dns_name_invalidate@224-239@usr.sbin/bind/lib/dns/name.c","usr.sbin/bind/lib/dns/name.c","dns_name_invalidate",224,239
6,3,47,2,10,"dns_name_setbuffer@242-252@usr.sbin/bind/lib/dns/name.c","usr.sbin/bind/lib/dns/name.c","dns_name_setbuffer",242,252
6,2,35,1,11,"dns_name_hasbuffer@255-266@usr.sbin/bind/lib/dns/name.c","usr.sbin/bind/lib/dns/name.c","dns_name_hasbuffer",255,266
6,2,39,1,11,"dns_name_isabsolute@269-280@usr.sbin/bind/lib/dns/name.c","usr.sbin/bind/lib/dns/name.c","dns_name_isabsolute",269,280
37,11,218,1,47,"dns_name_ismailbox@292-339@usr.sbin/bind/lib/dns/name.c","usr.sbin/bind/lib/dns/name.c","dns_name_ismailbox",292,339
30,11,187,2,42,"dns_name_ishostname@342-384@usr.sbin/bind/lib/dns/name.c","usr.sbin/bind/lib/dns/name.c","dns_name_ishostname",342,384
11,4,73,1,17,"dns_name_iswildcard@387-404@usr.sbin/bind/lib/dns/name.c","usr.sbin/bind/lib/dns/name.c","dns_name_iswildcard",387,404
21,4,119,1,32,"dns_name_internalwildcard@407-439@usr.sbin/bind/lib/dns/name.c","usr.sbin/bind/lib/dns/name.c","dns_name_internalwildcard",407,439
25,5,126,2,31,"name_hash@442-473@usr.sbin/bind/lib/dns/name.c","usr.sbin/bind/lib/dns/name.c","name_hash",442,473
6,2,42,2,10,"dns_name_hash@476-486@usr.sbin/bind/lib/dns/name.c","usr.sbin/bind/lib/dns/name.c","dns_name_hash",476,486
7,2,54,2,11,"dns_name_fullhash@489-500@usr.sbin/bind/lib/dns/name.c","usr.sbin/bind/lib/dns/name.c","dns_name_fullhash",489,500
4,1,29,2,9,"dns_fullname_hash@503-512@usr.sbin/bind/lib/dns/name.c","usr.sbin/bind/lib/dns/name.c","dns_fullname_hash",503,512
25,5,184,2,31,"dns_name_hashbylabel@515-546@usr.sbin/bind/lib/dns/name.c","usr.sbin/bind/lib/dns/name.c","dns_name_hashbylabel",515,546
69,12,404,4,97,"dns_name_fullcompare@549-646@usr.sbin/bind/lib/dns/name.c","usr.sbin/bind/lib/dns/name.c","dns_name_fullcompare",549,646
6,1,42,2,17,"dns_name_compare@649-666@usr.sbin/bind/lib/dns/name.c","usr.sbin/bind/lib/dns/name.c","dns_name_compare",649,666
30,7,191,2,49,"dns_name_equal@669-718@usr.sbin/bind/lib/dns/name.c","usr.sbin/bind/lib/dns/name.c","dns_name_equal",669,718
11,3,93,2,26,"dns_name_caseequal@721-747@usr.sbin/bind/lib/dns/name.c","usr.sbin/bind/lib/dns/name.c","dns_name_caseequal",721,747
36,9,261,2,55,"dns_name_rdatacompare@750-805@usr.sbin/bind/lib/dns/name.c","usr.sbin/bind/lib/dns/name.c","dns_name_rdatacompare",750,805
10,3,59,2,20,"dns_name_issubdomain@808-828@usr.sbin/bind/lib/dns/name.c","usr.sbin/bind/lib/dns/name.c","dns_name_issubdomain",808,828
17,2,122,2,18,"dns_name_matcheswildcard@831-849@usr.sbin/bind/lib/dns/name.c","usr.sbin/bind/lib/dns/name.c","dns_name_matcheswildcard",831,849
5,1,33,1,10,"dns_name_countlabels@852-862@usr.sbin/bind/lib/dns/name.c","usr.sbin/bind/lib/dns/name.c","dns_name_countlabels",852,862
14,2,122,3,20,"dns_name_getlabel@865-885@usr.sbin/bind/lib/dns/name.c","usr.sbin/bind/lib/dns/name.c","dns_name_getlabel",865,885
33,9,228,4,50,"dns_name_getlabelsequence@888-938@usr.sbin/bind/lib/dns/name.c","usr.sbin/bind/lib/dns/name.c","dns_name_getlabelsequence",888,938
18,4,132,2,23,"dns_name_clone@941-964@usr.sbin/bind/lib/dns/name.c","usr.sbin/bind/lib/dns/name.c","dns_name_clone",941,964
32,7,224,2,40,"dns_name_fromregion@967-1007@usr.sbin/bind/lib/dns/name.c","usr.sbin/bind/lib/dns/name.c","dns_name_fromregion",967,1007
5,1,34,2,9,"dns_name_toregion@1010-1019@usr.sbin/bind/lib/dns/name.c","usr.sbin/bind/lib/dns/name.c","dns_name_toregion",1010,1019
204,49,1058,5,249,"dns_name_fromtext@1023-1272@usr.sbin/bind/lib/dns/name.c","usr.sbin/bind/lib/dns/name.c","dns_name_fromtext",1023,1272
5,1,37,1,5,"free_specific@1276-1281@usr.sbin/bind/lib/dns/name.c","usr.sbin/bind/lib/dns/name.c","free_specific",1276,1281
3,1,17,1,2,"thread_key_mutex_init@1284-1286@usr.sbin/bind/lib/dns/name.c","usr.sbin/bind/lib/dns/name.c","thread_key_mutex_init",1284,1286
24,7,124,1,30,"totext_filter_proc_key_init@1289-1319@usr.sbin/bind/lib/dns/name.c","usr.sbin/bind/lib/dns/name.c","totext_filter_proc_key_init",1289,1319
118,38,606,3,169,"dns_name_totext@1323-1492@usr.sbin/bind/lib/dns/name.c","usr.sbin/bind/lib/dns/name.c","dns_name_totext",1323,1492
80,27,427,3,109,"dns_name_tofilenametext@1495-1604@usr.sbin/bind/lib/dns/name.c","usr.sbin/bind/lib/dns/name.c","dns_name_tofilenametext",1495,1604
59,15,395,3,70,"dns_name_downcase@1607-1677@usr.sbin/bind/lib/dns/name.c","usr.sbin/bind/lib/dns/name.c","dns_name_downcase",1607,1677
37,5,190,3,38,"set_offsets@1680-1718@usr.sbin/bind/lib/dns/name.c","usr.sbin/bind/lib/dns/name.c","set_offsets",1680,1718
114,27,617,5,176,"dns_name_fromwire@1721-1897@usr.sbin/bind/lib/dns/name.c","usr.sbin/bind/lib/dns/name.c","dns_name_fromwire",1721,1897
51,12,365,3,74,"dns_name_towire@1900-1974@usr.sbin/bind/lib/dns/name.c","usr.sbin/bind/lib/dns/name.c","dns_name_towire",1900,1974
84,31,541,4,104,"dns_name_concatenate@1977-2081@usr.sbin/bind/lib/dns/name.c","usr.sbin/bind/lib/dns/name.c","dns_name_concatenate",1977,2081
24,10,153,4,29,"dns_name_split@2084-2113@usr.sbin/bind/lib/dns/name.c","usr.sbin/bind/lib/dns/name.c","dns_name_split",2084,2113
26,5,186,3,37,"dns_name_dup@2116-2153@usr.sbin/bind/lib/dns/name.c","usr.sbin/bind/lib/dns/name.c","dns_name_dup",2116,2153
26,4,204,3,38,"dns_name_dupwithoffsets@2156-2194@usr.sbin/bind/lib/dns/name.c","usr.sbin/bind/lib/dns/name.c","dns_name_dupwithoffsets",2156,2194
10,2,76,2,15,"dns_name_free@2197-2212@usr.sbin/bind/lib/dns/name.c","usr.sbin/bind/lib/dns/name.c","dns_name_free",2197,2212
16,2,116,3,24,"dns_name_digest@2215-2239@usr.sbin/bind/lib/dns/name.c","usr.sbin/bind/lib/dns/name.c","dns_name_digest",2215,2239
5,2,33,1,9,"dns_name_dynamic@2242-2251@usr.sbin/bind/lib/dns/name.c","usr.sbin/bind/lib/dns/name.c","dns_name_dynamic",2242,2251
14,2,107,2,20,"dns_name_print@2254-2274@usr.sbin/bind/lib/dns/name.c","usr.sbin/bind/lib/dns/name.c","dns_name_print",2254,2274
31,9,181,1,40,"dns_name_settotextfilter@2277-2317@usr.sbin/bind/lib/dns/name.c","usr.sbin/bind/lib/dns/name.c","dns_name_settotextfilter",2277,2317
13,2,100,3,21,"dns_name_format@2320-2341@usr.sbin/bind/lib/dns/name.c","usr.sbin/bind/lib/dns/name.c","dns_name_format",2320,2341
31,8,246,3,47,"dns_name_copy@2344-2391@usr.sbin/bind/lib/dns/name.c","usr.sbin/bind/lib/dns/name.c","dns_name_copy",2344,2391
11,3,52,1,14,"dns_name_destroy@2394-2408@usr.sbin/bind/lib/dns/name.c","usr.sbin/bind/lib/dns/name.c","dns_name_destroy",2394,2408
30,6,198,2,41,"copy_rdataset@47-88@usr.sbin/bind/lib/dns/ncache.c","usr.sbin/bind/lib/dns/ncache.c","copy_rdataset",47,88
106,21,640,7,169,"dns_ncache_add@91-260@usr.sbin/bind/lib/dns/ncache.c","usr.sbin/bind/lib/dns/ncache.c","dns_ncache_add",91,260
81,10,575,5,124,"dns_ncache_towire@263-387@usr.sbin/bind/lib/dns/ncache.c","usr.sbin/bind/lib/dns/ncache.c","dns_ncache_towire",263,387
3,1,13,1,2,"rdataset_disassociate@390-392@usr.sbin/bind/lib/dns/ncache.c","usr.sbin/bind/lib/dns/ncache.c","rdataset_disassociate",390,392
14,2,78,1,20,"rdataset_first@395-415@usr.sbin/bind/lib/dns/ncache.c","usr.sbin/bind/lib/dns/ncache.c","rdataset_first",395,415
15,2,84,1,16,"rdataset_next@418-434@usr.sbin/bind/lib/dns/ncache.c","usr.sbin/bind/lib/dns/ncache.c","rdataset_next",418,434
9,1,73,2,10,"rdataset_current@437-447@usr.sbin/bind/lib/dns/ncache.c","usr.sbin/bind/lib/dns/ncache.c","rdataset_current",437,447
5,1,30,2,8,"rdataset_clone@450-458@usr.sbin/bind/lib/dns/ncache.c","usr.sbin/bind/lib/dns/ncache.c","rdataset_clone",450,458
6,1,40,1,7,"rdataset_count@461-468@usr.sbin/bind/lib/dns/ncache.c","usr.sbin/bind/lib/dns/ncache.c","rdataset_count",461,468
62,7,435,4,74,"dns_ncache_getrdataset@485-559@usr.sbin/bind/lib/dns/ncache.c","usr.sbin/bind/lib/dns/ncache.c","dns_ncache_getrdataset",485,559
9,2,69,3,10,"set_bit@43-53@usr.sbin/bind/lib/dns/nsec.c","usr.sbin/bind/lib/dns/nsec.c","set_bit",43,53
7,1,58,2,8,"bit_isset@56-64@usr.sbin/bind/lib/dns/nsec.c","usr.sbin/bind/lib/dns/nsec.c","bit_isset",56,64
69,16,463,6,84,"dns_nsec_buildrdata@67-151@usr.sbin/bind/lib/dns/nsec.c","usr.sbin/bind/lib/dns/nsec.c","dns_nsec_buildrdata",67,151
28,3,189,5,30,"dns_nsec_build@155-185@usr.sbin/bind/lib/dns/nsec.c","usr.sbin/bind/lib/dns/nsec.c","dns_nsec_build",155,185
29,6,213,2,32,"dns_nsec_typepresent@188-220@usr.sbin/bind/lib/dns/nsec.c","usr.sbin/bind/lib/dns/nsec.c","dns_nsec_typepresent",188,220
7,3,54,2,6,"entropy_get@62-68@usr.sbin/bind/lib/dns/openssl_link.c","usr.sbin/bind/lib/dns/openssl_link.c","entropy_get",62,68
7,3,54,2,6,"entropy_getpseudo@71-77@usr.sbin/bind/lib/dns/openssl_link.c","usr.sbin/bind/lib/dns/openssl_link.c","entropy_getpseudo",71,77
5,1,30,3,7,"entropy_add@80-87@usr.sbin/bind/lib/dns/openssl_link.c","usr.sbin/bind/lib/dns/openssl_link.c","entropy_add",80,87
8,2,57,4,7,"lock_callback@90-97@usr.sbin/bind/lib/dns/openssl_link.c","usr.sbin/bind/lib/dns/openssl_link.c","lock_callback",90,97
3,1,17,1,2,"id_callback@100-102@usr.sbin/bind/lib/dns/openssl_link.c","usr.sbin/bind/lib/dns/openssl_link.c","id_callback",100,102
4,1,24,1,3,"mem_alloc@105-108@usr.sbin/bind/lib/dns/openssl_link.c","usr.sbin/bind/lib/dns/openssl_link.c","mem_alloc",105,108
5,2,28,1,4,"mem_free@111-115@usr.sbin/bind/lib/dns/openssl_link.c","usr.sbin/bind/lib/dns/openssl_link.c","mem_free",111,115
13,5,76,2,13,"mem_realloc@118-131@usr.sbin/bind/lib/dns/openssl_link.c","usr.sbin/bind/lib/dns/openssl_link.c","mem_realloc",118,131
44,8,225,0,52,"dst__openssl_init@134-186@usr.sbin/bind/lib/dns/openssl_link.c","usr.sbin/bind/lib/dns/openssl_link.c","dst__openssl_init",134,186
24,11,103,0,47,"dst__openssl_destroy@189-236@usr.sbin/bind/lib/dns/openssl_link.c","usr.sbin/bind/lib/dns/openssl_link.c","dst__openssl_destroy",189,236
13,2,50,1,13,"dst__openssl_toresult@239-252@usr.sbin/bind/lib/dns/openssl_link.c","usr.sbin/bind/lib/dns/openssl_link.c","dst__openssl_toresult",239,252
21,3,142,3,23,"openssldh_computesecret@66-89@usr.sbin/bind/lib/dns/openssldh_link.c","usr.sbin/bind/lib/dns/openssldh_link.c","openssldh_computesecret",66,89
22,13,181,2,26,"openssldh_compare@92-118@usr.sbin/bind/lib/dns/openssldh_link.c","usr.sbin/bind/lib/dns/openssldh_link.c","openssldh_compare",92,118
15,7,115,2,18,"openssldh_paramcompare@121-139@usr.sbin/bind/lib/dns/openssldh_link.c","usr.sbin/bind/lib/dns/openssldh_link.c","openssldh_paramcompare",121,139
44,15,261,2,56,"openssldh_generate@142-198@usr.sbin/bind/lib/dns/openssldh_link.c","usr.sbin/bind/lib/dns/openssldh_link.c","openssldh_generate",142,198
4,2,37,1,3,"openssldh_isprivate@201-204@usr.sbin/bind/lib/dns/openssldh_link.c","usr.sbin/bind/lib/dns/openssldh_link.c","openssldh_isprivate",201,204
11,6,79,1,12,"openssldh_destroy@207-219@usr.sbin/bind/lib/dns/openssldh_link.c","usr.sbin/bind/lib/dns/openssldh_link.c","openssldh_destroy",207,219
4,1,38,2,3,"uint16_toregion@222-225@usr.sbin/bind/lib/dns/openssldh_link.c","usr.sbin/bind/lib/dns/openssldh_link.c","uint16_toregion",222,225
8,1,64,1,9,"uint16_fromregion@228-237@usr.sbin/bind/lib/dns/openssldh_link.c","usr.sbin/bind/lib/dns/openssldh_link.c","uint16_fromregion",228,237
42,10,298,2,50,"openssldh_todns@240-290@usr.sbin/bind/lib/dns/openssldh_link.c","usr.sbin/bind/lib/dns/openssldh_link.c","openssldh_todns",240,290
97,22,545,2,114,"openssldh_fromdns@293-407@usr.sbin/bind/lib/dns/openssldh_link.c","usr.sbin/bind/lib/dns/openssldh_link.c","openssldh_fromdns",293,407
47,6,408,2,55,"openssldh_tofile@410-465@usr.sbin/bind/lib/dns/openssldh_link.c","usr.sbin/bind/lib/dns/openssldh_link.c","openssldh_tofile",410,465
69,19,452,2,79,"openssldh_parse@468-547@usr.sbin/bind/lib/dns/openssldh_link.c","usr.sbin/bind/lib/dns/openssldh_link.c","openssldh_parse",468,547
20,3,196,2,23,"BN_fromhex@550-573@usr.sbin/bind/lib/dns/openssldh_link.c","usr.sbin/bind/lib/dns/openssldh_link.c","BN_fromhex",550,573
6,1,30,1,5,"openssldh_cleanup@576-581@usr.sbin/bind/lib/dns/openssldh_link.c","usr.sbin/bind/lib/dns/openssldh_link.c","openssldh_cleanup",576,581
15,2,91,1,14,"dst__openssldh_init@603-617@usr.sbin/bind/lib/dns/openssldh_link.c","usr.sbin/bind/lib/dns/openssldh_link.c","dst__openssldh_init",603,617
8,1,51,2,9,"openssldsa_createctx@43-52@usr.sbin/bind/lib/dns/openssldsa_link.c","usr.sbin/bind/lib/dns/openssldsa_link.c","openssldsa_createctx",43,52
8,2,49,1,8,"openssldsa_destroyctx@55-63@usr.sbin/bind/lib/dns/openssldsa_link.c","usr.sbin/bind/lib/dns/openssldsa_link.c","openssldsa_destroyctx",55,63
5,1,39,2,5,"openssldsa_adddata@66-71@usr.sbin/bind/lib/dns/openssldsa_link.c","usr.sbin/bind/lib/dns/openssldsa_link.c","openssldsa_adddata",66,71
7,2,51,3,6,"BN_bn2bin_fixed@74-80@usr.sbin/bind/lib/dns/openssldsa_link.c","usr.sbin/bind/lib/dns/openssldsa_link.c","BN_bn2bin_fixed",74,80
23,3,182,2,27,"openssldsa_sign@83-110@usr.sbin/bind/lib/dns/openssldsa_link.c","usr.sbin/bind/lib/dns/openssldsa_link.c","openssldsa_sign",83,110
23,3,166,2,27,"openssldsa_verify@113-140@usr.sbin/bind/lib/dns/openssldsa_link.c","usr.sbin/bind/lib/dns/openssldsa_link.c","openssldsa_verify",113,140
23,14,190,2,27,"openssldsa_compare@143-170@usr.sbin/bind/lib/dns/openssldsa_link.c","usr.sbin/bind/lib/dns/openssldsa_link.c","openssldsa_compare",143,170
34,8,202,2,46,"openssldsa_generate@173-219@usr.sbin/bind/lib/dns/openssldsa_link.c","usr.sbin/bind/lib/dns/openssldsa_link.c","openssldsa_generate",173,219
4,2,37,1,3,"openssldsa_isprivate@222-225@usr.sbin/bind/lib/dns/openssldsa_link.c","usr.sbin/bind/lib/dns/openssldsa_link.c","openssldsa_isprivate",222,225
5,1,27,1,4,"openssldsa_destroy@228-232@usr.sbin/bind/lib/dns/openssldsa_link.c","usr.sbin/bind/lib/dns/openssldsa_link.c","openssldsa_destroy",228,232
27,3,231,2,34,"openssldsa_todns@236-270@usr.sbin/bind/lib/dns/openssldsa_link.c","usr.sbin/bind/lib/dns/openssldsa_link.c","openssldsa_todns",236,270
36,5,266,2,48,"openssldsa_fromdns@273-321@usr.sbin/bind/lib/dns/openssldsa_link.c","usr.sbin/bind/lib/dns/openssldsa_link.c","openssldsa_fromdns",273,321
36,2,358,2,43,"openssldsa_tofile@325-368@usr.sbin/bind/lib/dns/openssldsa_link.c","usr.sbin/bind/lib/dns/openssldsa_link.c","openssldsa_tofile",325,368
47,10,273,2,55,"openssldsa_parse@371-426@usr.sbin/bind/lib/dns/openssldsa_link.c","usr.sbin/bind/lib/dns/openssldsa_link.c","openssldsa_parse",371,426
6,2,33,1,5,"dst__openssldsa_init@448-453@usr.sbin/bind/lib/dns/openssldsa_link.c","usr.sbin/bind/lib/dns/openssldsa_link.c","dst__openssldsa_init",448,453
21,5,136,2,24,"opensslrsa_createctx@103-127@usr.sbin/bind/lib/dns/opensslrsa_link.c","usr.sbin/bind/lib/dns/opensslrsa_link.c","opensslrsa_createctx",103,127
18,5,118,1,20,"opensslrsa_destroyctx@130-150@usr.sbin/bind/lib/dns/opensslrsa_link.c","usr.sbin/bind/lib/dns/opensslrsa_link.c","opensslrsa_destroyctx",130,150
12,3,94,2,12,"opensslrsa_adddata@153-165@usr.sbin/bind/lib/dns/opensslrsa_link.c","usr.sbin/bind/lib/dns/opensslrsa_link.c","opensslrsa_adddata",153,165
42,7,271,2,49,"opensslrsa_sign@168-217@usr.sbin/bind/lib/dns/opensslrsa_link.c","usr.sbin/bind/lib/dns/opensslrsa_link.c","opensslrsa_sign",168,217
28,5,189,2,33,"opensslrsa_verify@220-253@usr.sbin/bind/lib/dns/opensslrsa_link.c","usr.sbin/bind/lib/dns/opensslrsa_link.c","opensslrsa_verify",220,253
24,14,196,2,29,"opensslrsa_compare@256-285@usr.sbin/bind/lib/dns/opensslrsa_link.c","usr.sbin/bind/lib/dns/opensslrsa_link.c","opensslrsa_compare",256,285
39,10,231,2,50,"opensslrsa_generate@288-338@usr.sbin/bind/lib/dns/opensslrsa_link.c","usr.sbin/bind/lib/dns/opensslrsa_link.c","opensslrsa_generate",288,338
4,2,37,1,3,"opensslrsa_isprivate@341-344@usr.sbin/bind/lib/dns/opensslrsa_link.c","usr.sbin/bind/lib/dns/opensslrsa_link.c","opensslrsa_isprivate",341,344
5,1,27,1,4,"opensslrsa_destroy@347-351@usr.sbin/bind/lib/dns/opensslrsa_link.c","usr.sbin/bind/lib/dns/opensslrsa_link.c","opensslrsa_destroy",347,351
29,5,202,2,37,"opensslrsa_todns@355-392@usr.sbin/bind/lib/dns/opensslrsa_link.c","usr.sbin/bind/lib/dns/opensslrsa_link.c","opensslrsa_todns",355,392
39,7,258,2,48,"opensslrsa_fromdns@395-443@usr.sbin/bind/lib/dns/opensslrsa_link.c","usr.sbin/bind/lib/dns/opensslrsa_link.c","opensslrsa_fromdns",395,443
67,6,632,2,79,"opensslrsa_tofile@447-526@usr.sbin/bind/lib/dns/opensslrsa_link.c","usr.sbin/bind/lib/dns/opensslrsa_link.c","opensslrsa_tofile",447,526
56,13,305,2,64,"opensslrsa_parse@529-593@usr.sbin/bind/lib/dns/opensslrsa_link.c","usr.sbin/bind/lib/dns/opensslrsa_link.c","opensslrsa_parse",529,593
6,2,33,1,5,"dst__opensslrsa_init@615-620@usr.sbin/bind/lib/dns/opensslrsa_link.c","usr.sbin/bind/lib/dns/opensslrsa_link.c","dst__opensslrsa_init",615,620
19,4,132,2,24,"dns_order_create@56-80@usr.sbin/bind/lib/dns/order.c","usr.sbin/bind/lib/dns/order.c","dns_order_create",56,80
22,4,144,5,24,"dns_order_add@83-107@usr.sbin/bind/lib/dns/order.c","usr.sbin/bind/lib/dns/order.c","dns_order_add",83,107
5,2,39,2,5,"match@110-115@usr.sbin/bind/lib/dns/order.c","usr.sbin/bind/lib/dns/order.c","match",110,115
18,7,115,4,18,"dns_order_find@118-136@usr.sbin/bind/lib/dns/order.c","usr.sbin/bind/lib/dns/order.c","dns_order_find",118,136
6,2,47,2,5,"dns_order_attach@139-144@usr.sbin/bind/lib/dns/order.c","usr.sbin/bind/lib/dns/order.c","dns_order_attach",139,144
19,3,137,1,20,"dns_order_detach@147-167@usr.sbin/bind/lib/dns/order.c","usr.sbin/bind/lib/dns/order.c","dns_order_detach",147,167
13,2,82,2,17,"dns_peerlist_new@53-70@usr.sbin/bind/lib/dns/peer.c","usr.sbin/bind/lib/dns/peer.c","dns_peerlist_new",53,70
8,1,54,2,10,"dns_peerlist_attach@73-83@usr.sbin/bind/lib/dns/peer.c","usr.sbin/bind/lib/dns/peer.c","dns_peerlist_attach",73,83
12,2,74,1,16,"dns_peerlist_detach@86-102@usr.sbin/bind/lib/dns/peer.c","usr.sbin/bind/lib/dns/peer.c","dns_peerlist_detach",86,102
18,2,122,1,23,"peerlist_delete@105-128@usr.sbin/bind/lib/dns/peer.c","usr.sbin/bind/lib/dns/peer.c","peerlist_delete",105,128
13,4,93,2,19,"dns_peerlist_addpeer@131-150@usr.sbin/bind/lib/dns/peer.c","usr.sbin/bind/lib/dns/peer.c","dns_peerlist_addpeer",131,150
22,4,111,3,26,"dns_peerlist_peerbyaddr@153-179@usr.sbin/bind/lib/dns/peer.c","usr.sbin/bind/lib/dns/peer.c","dns_peerlist_peerbyaddr",153,179
6,1,39,2,8,"dns_peerlist_currpeer@184-192@usr.sbin/bind/lib/dns/peer.c","usr.sbin/bind/lib/dns/peer.c","dns_peerlist_currpeer",184,192
15,3,76,3,16,"dns_peer_new@195-211@usr.sbin/bind/lib/dns/peer.c","usr.sbin/bind/lib/dns/peer.c","dns_peer_new",195,211
27,2,174,4,33,"dns_peer_newprefix@214-247@usr.sbin/bind/lib/dns/peer.c","usr.sbin/bind/lib/dns/peer.c","dns_peer_newprefix",214,247
8,1,54,2,10,"dns_peer_attach@250-260@usr.sbin/bind/lib/dns/peer.c","usr.sbin/bind/lib/dns/peer.c","dns_peer_attach",250,260
12,2,74,1,16,"dns_peer_detach@263-279@usr.sbin/bind/lib/dns/peer.c","usr.sbin/bind/lib/dns/peer.c","dns_peer_detach",263,279
21,3,142,1,28,"peer_delete@282-310@usr.sbin/bind/lib/dns/peer.c","usr.sbin/bind/lib/dns/peer.c","peer_delete",282,310
8,2,59,2,11,"dns_peer_setbogus@313-324@usr.sbin/bind/lib/dns/peer.c","usr.sbin/bind/lib/dns/peer.c","dns_peer_setbogus",313,324
9,2,59,2,9,"dns_peer_getbogus@327-336@usr.sbin/bind/lib/dns/peer.c","usr.sbin/bind/lib/dns/peer.c","dns_peer_getbogus",327,336
8,2,59,2,11,"dns_peer_setprovideixfr@340-351@usr.sbin/bind/lib/dns/peer.c","usr.sbin/bind/lib/dns/peer.c","dns_peer_setprovideixfr",340,351
10,2,61,2,10,"dns_peer_getprovideixfr@354-364@usr.sbin/bind/lib/dns/peer.c","usr.sbin/bind/lib/dns/peer.c","dns_peer_getprovideixfr",354,364
8,2,59,2,11,"dns_peer_setrequestixfr@367-378@usr.sbin/bind/lib/dns/peer.c","usr.sbin/bind/lib/dns/peer.c","dns_peer_setrequestixfr",367,378
9,2,59,2,9,"dns_peer_getrequestixfr@381-390@usr.sbin/bind/lib/dns/peer.c","usr.sbin/bind/lib/dns/peer.c","dns_peer_getrequestixfr",381,390
8,2,59,2,11,"dns_peer_setsupportedns@393-404@usr.sbin/bind/lib/dns/peer.c","usr.sbin/bind/lib/dns/peer.c","dns_peer_setsupportedns",393,404
9,2,59,2,9,"dns_peer_getsupportedns@407-416@usr.sbin/bind/lib/dns/peer.c","usr.sbin/bind/lib/dns/peer.c","dns_peer_getsupportedns",407,416
8,2,59,2,11,"dns_peer_settransfers@419-430@usr.sbin/bind/lib/dns/peer.c","usr.sbin/bind/lib/dns/peer.c","dns_peer_settransfers",419,430
10,2,61,2,10,"dns_peer_gettransfers@433-443@usr.sbin/bind/lib/dns/peer.c","usr.sbin/bind/lib/dns/peer.c","dns_peer_gettransfers",433,443
9,2,59,2,12,"dns_peer_settransferformat@446-458@usr.sbin/bind/lib/dns/peer.c","usr.sbin/bind/lib/dns/peer.c","dns_peer_settransferformat",446,458
10,2,61,2,10,"dns_peer_gettransferformat@461-471@usr.sbin/bind/lib/dns/peer.c","usr.sbin/bind/lib/dns/peer.c","dns_peer_gettransferformat",461,471
8,3,57,2,9,"dns_peer_getkey@474-483@usr.sbin/bind/lib/dns/peer.c","usr.sbin/bind/lib/dns/peer.c","dns_peer_getkey",474,483
11,3,79,2,13,"dns_peer_setkey@486-499@usr.sbin/bind/lib/dns/peer.c","usr.sbin/bind/lib/dns/peer.c","dns_peer_setkey",486,499
26,5,198,2,30,"dns_peer_setkeybycharp@502-532@usr.sbin/bind/lib/dns/peer.c","usr.sbin/bind/lib/dns/peer.c","dns_peer_setkeybycharp",502,532
18,4,109,2,19,"dns_peer_settransfersource@535-554@usr.sbin/bind/lib/dns/peer.c","usr.sbin/bind/lib/dns/peer.c","dns_peer_settransfersource",535,554
8,2,53,2,8,"dns_peer_gettransfersource@557-565@usr.sbin/bind/lib/dns/peer.c","usr.sbin/bind/lib/dns/peer.c","dns_peer_gettransfersource",557,565
18,4,109,2,19,"dns_peer_setnotifysource@568-587@usr.sbin/bind/lib/dns/peer.c","usr.sbin/bind/lib/dns/peer.c","dns_peer_setnotifysource",568,587
8,2,53,2,8,"dns_peer_getnotifysource@590-598@usr.sbin/bind/lib/dns/peer.c","usr.sbin/bind/lib/dns/peer.c","dns_peer_getnotifysource",590,598
16,4,109,2,17,"dns_peer_setquerysource@601-618@usr.sbin/bind/lib/dns/peer.c","usr.sbin/bind/lib/dns/peer.c","dns_peer_setquerysource",601,618
8,2,53,2,8,"dns_peer_getquerysource@621-629@usr.sbin/bind/lib/dns/peer.c","usr.sbin/bind/lib/dns/peer.c","dns_peer_getquerysource",621,629
8,2,59,2,11,"dns_peer_setudpsize@632-643@usr.sbin/bind/lib/dns/peer.c","usr.sbin/bind/lib/dns/peer.c","dns_peer_setudpsize",632,643
10,2,61,2,11,"dns_peer_getudpsize@646-657@usr.sbin/bind/lib/dns/peer.c","usr.sbin/bind/lib/dns/peer.c","dns_peer_getudpsize",646,657
8,2,59,2,11,"dns_peer_setmaxudp@660-671@usr.sbin/bind/lib/dns/peer.c","usr.sbin/bind/lib/dns/peer.c","dns_peer_setmaxudp",660,671
10,2,61,2,11,"dns_peer_getmaxudp@674-685@usr.sbin/bind/lib/dns/peer.c","usr.sbin/bind/lib/dns/peer.c","dns_peer_getmaxudp",674,685
9,3,74,2,9,"compare@62-71@usr.sbin/bind/lib/dns/portlist.c","usr.sbin/bind/lib/dns/portlist.c","compare",62,71
27,5,187,2,28,"dns_portlist_create@74-102@usr.sbin/bind/lib/dns/portlist.c","usr.sbin/bind/lib/dns/portlist.c","dns_portlist_create",74,102
30,8,181,3,30,"find_port@105-135@usr.sbin/bind/lib/dns/portlist.c","usr.sbin/bind/lib/dns/portlist.c","find_port",105,135
46,9,314,3,48,"dns_portlist_add@138-186@usr.sbin/bind/lib/dns/portlist.c","usr.sbin/bind/lib/dns/portlist.c","dns_portlist_add",138,186
22,6,151,3,23,"dns_portlist_remove@189-212@usr.sbin/bind/lib/dns/portlist.c","usr.sbin/bind/lib/dns/portlist.c","dns_portlist_remove",189,212
18,8,136,3,18,"dns_portlist_match@215-233@usr.sbin/bind/lib/dns/portlist.c","usr.sbin/bind/lib/dns/portlist.c","dns_portlist_match",215,233
6,2,47,2,7,"dns_portlist_attach@236-243@usr.sbin/bind/lib/dns/portlist.c","usr.sbin/bind/lib/dns/portlist.c","dns_portlist_attach",236,243
20,3,129,1,20,"dns_portlist_detach@246-266@usr.sbin/bind/lib/dns/portlist.c","usr.sbin/bind/lib/dns/portlist.c","dns_portlist_detach",246,266
7,2,38,1,8,"Name@156-164@usr.sbin/bind/lib/dns/rbt.c","usr.sbin/bind/lib/dns/rbt.c","Name",156,164
6,2,40,1,12,"find_up@170-182@usr.sbin/bind/lib/dns/rbt.c","usr.sbin/bind/lib/dns/rbt.c","find_up",170,182
27,7,187,4,36,"dns_rbt_create@223-259@usr.sbin/bind/lib/dns/rbt.c","usr.sbin/bind/lib/dns/rbt.c","dns_rbt_create",223,259
3,1,20,1,2,"dns_rbt_destroy@265-267@usr.sbin/bind/lib/dns/rbt.c","usr.sbin/bind/lib/dns/rbt.c","dns_rbt_destroy",265,267
16,4,128,2,22,"dns_rbt_destroy2@270-292@usr.sbin/bind/lib/dns/rbt.c","usr.sbin/bind/lib/dns/rbt.c","dns_rbt_destroy2",270,292
4,1,23,1,3,"dns_rbt_nodecount@295-298@usr.sbin/bind/lib/dns/rbt.c","usr.sbin/bind/lib/dns/rbt.c","dns_rbt_nodecount",295,298
22,6,150,3,25,"chain_name@301-326@usr.sbin/bind/lib/dns/rbt.c","usr.sbin/bind/lib/dns/rbt.c","chain_name",301,326
12,4,72,2,19,"move_chain_to_last@329-348@usr.sbin/bind/lib/dns/rbt.c","usr.sbin/bind/lib/dns/rbt.c","move_chain_to_last",329,348
150,23,938,3,276,"dns_rbt_addnode@355-631@usr.sbin/bind/lib/dns/rbt.c","usr.sbin/bind/lib/dns/rbt.c","dns_rbt_addnode",355,631
14,4,92,3,24,"dns_rbt_addname@637-661@usr.sbin/bind/lib/dns/rbt.c","usr.sbin/bind/lib/dns/rbt.c","dns_rbt_addname",637,661
237,50,1249,8,495,"dns_rbt_findnode@667-1162@usr.sbin/bind/lib/dns/rbt.c","usr.sbin/bind/lib/dns/rbt.c","dns_rbt_findnode",667,1162
14,5,108,5,17,"dns_rbt_findname@1168-1185@usr.sbin/bind/lib/dns/rbt.c","usr.sbin/bind/lib/dns/rbt.c","dns_rbt_findname",1168,1185
16,4,111,3,34,"dns_rbt_deletename@1191-1225@usr.sbin/bind/lib/dns/rbt.c","usr.sbin/bind/lib/dns/rbt.c","dns_rbt_deletename",1191,1225
29,9,207,3,82,"dns_rbt_deletenode@1264-1346@usr.sbin/bind/lib/dns/rbt.c","usr.sbin/bind/lib/dns/rbt.c","dns_rbt_deletenode",1264,1346
6,1,43,2,7,"dns_rbt_namefromnode@1349-1356@usr.sbin/bind/lib/dns/rbt.c","usr.sbin/bind/lib/dns/rbt.c","dns_rbt_namefromnode",1349,1356
18,3,116,2,24,"dns_rbt_fullnamefromnode@1359-1383@usr.sbin/bind/lib/dns/rbt.c","usr.sbin/bind/lib/dns/rbt.c","dns_rbt_fullnamefromnode",1359,1383
17,2,99,3,19,"dns_rbt_formatnodename@1386-1405@usr.sbin/bind/lib/dns/rbt.c","usr.sbin/bind/lib/dns/rbt.c","dns_rbt_formatnodename",1386,1405
36,4,264,3,64,"create_node@1408-1472@usr.sbin/bind/lib/dns/rbt.c","usr.sbin/bind/lib/dns/rbt.c","create_node",1408,1472
7,1,64,3,9,"hash_add_node@1476-1485@usr.sbin/bind/lib/dns/rbt.c","usr.sbin/bind/lib/dns/rbt.c","hash_add_node",1476,1485
10,2,72,1,13,"inithash@1488-1501@usr.sbin/bind/lib/dns/rbt.c","usr.sbin/bind/lib/dns/rbt.c","inithash",1488,1501
30,5,213,1,33,"rehash@1504-1537@usr.sbin/bind/lib/dns/rbt.c","usr.sbin/bind/lib/dns/rbt.c","rehash",1504,1537
6,2,52,3,8,"hash_node@1540-1548@usr.sbin/bind/lib/dns/rbt.c","usr.sbin/bind/lib/dns/rbt.c","hash_node",1540,1548
18,4,117,2,20,"unhash_node@1551-1571@usr.sbin/bind/lib/dns/rbt.c","usr.sbin/bind/lib/dns/rbt.c","unhash_node",1551,1571
24,5,166,2,30,"rotate_left@1575-1605@usr.sbin/bind/lib/dns/rbt.c","usr.sbin/bind/lib/dns/rbt.c","rotate_left",1575,1605
24,5,166,2,30,"rotate_right@1608-1638@usr.sbin/bind/lib/dns/rbt.c","usr.sbin/bind/lib/dns/rbt.c","rotate_right",1608,1638
79,14,477,4,99,"dns_rbt_addonlevel@1645-1744@usr.sbin/bind/lib/dns/rbt.c","usr.sbin/bind/lib/dns/rbt.c","dns_rbt_addonlevel",1645,1744
129,33,881,2,225,"dns_rbt_deletefromlevel@1751-1976@usr.sbin/bind/lib/dns/rbt.c","usr.sbin/bind/lib/dns/rbt.c","dns_rbt_deletefromlevel",1751,1976
34,12,232,2,39,"dns_rbt_deletetree@1994-2033@usr.sbin/bind/lib/dns/rbt.c","usr.sbin/bind/lib/dns/rbt.c","dns_rbt_deletetree",1994,2033
45,14,263,3,54,"dns_rbt_deletetreeflat@2036-2090@usr.sbin/bind/lib/dns/rbt.c","usr.sbin/bind/lib/dns/rbt.c","dns_rbt_deletetreeflat",2036,2090
5,2,28,1,5,"dns_rbt_indent@2093-2098@usr.sbin/bind/lib/dns/rbt.c","usr.sbin/bind/lib/dns/rbt.c","dns_rbt_indent",2093,2098
12,1,78,1,15,"dns_rbt_printnodename@2101-2116@usr.sbin/bind/lib/dns/rbt.c","usr.sbin/bind/lib/dns/rbt.c","dns_rbt_printnodename",2101,2116
41,15,275,3,50,"dns_rbt_printtree@2119-2169@usr.sbin/bind/lib/dns/rbt.c","usr.sbin/bind/lib/dns/rbt.c","dns_rbt_printtree",2119,2169
4,1,27,1,4,"dns_rbt_printall@2172-2176@usr.sbin/bind/lib/dns/rbt.c","usr.sbin/bind/lib/dns/rbt.c","dns_rbt_printall",2172,2176
8,1,49,2,13,"dns_rbtnodechain_init@2183-2196@usr.sbin/bind/lib/dns/rbt.c","usr.sbin/bind/lib/dns/rbt.c","dns_rbtnodechain_init",2183,2196
26,7,154,4,40,"dns_rbtnodechain_current@2199-2239@usr.sbin/bind/lib/dns/rbt.c","usr.sbin/bind/lib/dns/rbt.c","dns_rbtnodechain_current",2199,2239
56,19,340,3,114,"dns_rbtnodechain_prev@2242-2356@usr.sbin/bind/lib/dns/rbt.c","usr.sbin/bind/lib/dns/rbt.c","dns_rbtnodechain_prev",2242,2356
59,21,348,3,112,"dns_rbtnodechain_next@2359-2471@usr.sbin/bind/lib/dns/rbt.c","usr.sbin/bind/lib/dns/rbt.c","dns_rbtnodechain_next",2359,2471
13,2,80,4,19,"dns_rbtnodechain_first@2474-2493@usr.sbin/bind/lib/dns/rbt.c","usr.sbin/bind/lib/dns/rbt.c","dns_rbtnodechain_first",2474,2493
15,3,94,4,21,"dns_rbtnodechain_last@2496-2517@usr.sbin/bind/lib/dns/rbt.c","usr.sbin/bind/lib/dns/rbt.c","dns_rbtnodechain_last",2496,2517
6,1,34,1,11,"dns_rbtnodechain_reset@2521-2532@usr.sbin/bind/lib/dns/rbt.c","usr.sbin/bind/lib/dns/rbt.c","dns_rbtnodechain_reset",2521,2532
4,1,19,1,9,"dns_rbtnodechain_invalidate@2535-2544@usr.sbin/bind/lib/dns/rbt.c","usr.sbin/bind/lib/dns/rbt.c","dns_rbtnodechain_invalidate",2535,2544
6,1,45,2,8,"attach@550-558@usr.sbin/bind/lib/dns/rbtdb.c","usr.sbin/bind/lib/dns/rbtdb.c","attach",550,558
5,1,34,2,6,"free_rbtdb_callback@561-567@usr.sbin/bind/lib/dns/rbtdb.c","usr.sbin/bind/lib/dns/rbtdb.c","free_rbtdb_callback",561,567
30,7,171,2,39,"adjust_quantum@576-615@usr.sbin/bind/lib/dns/rbtdb.c","usr.sbin/bind/lib/dns/rbtdb.c","adjust_quantum",576,615
74,17,552,3,76,"free_rbtdb@618-694@usr.sbin/bind/lib/dns/rbtdb.c","usr.sbin/bind/lib/dns/rbtdb.c","free_rbtdb",618,694
37,9,274,1,45,"maybe_free_rbtdb@697-742@usr.sbin/bind/lib/dns/rbtdb.c","usr.sbin/bind/lib/dns/rbtdb.c","maybe_free_rbtdb",697,742
9,2,60,1,12,"detach@745-757@usr.sbin/bind/lib/dns/rbtdb.c","usr.sbin/bind/lib/dns/rbtdb.c","detach",745,757
11,1,84,2,13,"currentversion@760-773@usr.sbin/bind/lib/dns/rbtdb.c","usr.sbin/bind/lib/dns/rbtdb.c","currentversion",760,773
20,3,124,4,21,"allocate_version@776-797@usr.sbin/bind/lib/dns/rbtdb.c","usr.sbin/bind/lib/dns/rbtdb.c","allocate_version",776,797
21,4,149,2,25,"newversion@800-825@usr.sbin/bind/lib/dns/rbtdb.c","usr.sbin/bind/lib/dns/rbtdb.c","newversion",800,825
11,1,67,3,13,"attachversion@828-841@usr.sbin/bind/lib/dns/rbtdb.c","usr.sbin/bind/lib/dns/rbtdb.c","attachversion",828,841
19,2,126,3,29,"add_changed@844-873@usr.sbin/bind/lib/dns/rbtdb.c","usr.sbin/bind/lib/dns/rbtdb.c","add_changed",844,873
14,4,114,3,26,"free_acachearray@876-902@usr.sbin/bind/lib/dns/rbtdb.c","usr.sbin/bind/lib/dns/rbtdb.c","free_acachearray",876,902
12,4,128,2,12,"free_noqname@905-917@usr.sbin/bind/lib/dns/rbtdb.c","usr.sbin/bind/lib/dns/rbtdb.c","free_noqname",905,917
13,3,104,2,15,"free_rdataset@920-935@usr.sbin/bind/lib/dns/rbtdb.c","usr.sbin/bind/lib/dns/rbtdb.c","free_rdataset",920,935
20,6,113,2,29,"rollback_node@938-967@usr.sbin/bind/lib/dns/rbtdb.c","usr.sbin/bind/lib/dns/rbtdb.c","rollback_node",938,967
8,2,56,2,8,"clean_stale_headers@970-978@usr.sbin/bind/lib/dns/rbtdb.c","usr.sbin/bind/lib/dns/rbtdb.c","clean_stale_headers",970,978
19,4,126,2,26,"clean_cache_node@981-1007@usr.sbin/bind/lib/dns/rbtdb.c","usr.sbin/bind/lib/dns/rbtdb.c","clean_cache_node",981,1007
80,18,433,3,123,"clean_zone_node@1010-1133@usr.sbin/bind/lib/dns/rbtdb.c","usr.sbin/bind/lib/dns/rbtdb.c","clean_zone_node",1010,1133
11,2,74,2,11,"new_reference@1140-1151@usr.sbin/bind/lib/dns/rbtdb.c","usr.sbin/bind/lib/dns/rbtdb.c","new_reference",1140,1151
89,28,557,5,133,"decrement_reference@1164-1297@usr.sbin/bind/lib/dns/rbtdb.c","usr.sbin/bind/lib/dns/rbtdb.c","decrement_reference",1164,1297
7,1,38,3,10,"make_least_version@1300-1310@usr.sbin/bind/lib/dns/rbtdb.c","usr.sbin/bind/lib/dns/rbtdb.c","make_least_version",1300,1310
14,3,79,2,28,"cleanup_nondirty@1313-1341@usr.sbin/bind/lib/dns/rbtdb.c","usr.sbin/bind/lib/dns/rbtdb.c","cleanup_nondirty",1313,1341
37,7,213,2,38,"iszonesecure@1344-1382@usr.sbin/bind/lib/dns/rbtdb.c","usr.sbin/bind/lib/dns/rbtdb.c","iszonesecure",1344,1382
118,20,719,3,194,"closeversion@1385-1579@usr.sbin/bind/lib/dns/rbtdb.c","usr.sbin/bind/lib/dns/rbtdb.c","closeversion",1385,1579
18,3,115,2,18,"add_wildcard_magic@1595-1613@usr.sbin/bind/lib/dns/rbtdb.c","usr.sbin/bind/lib/dns/rbtdb.c","add_wildcard_magic",1595,1613
25,6,159,2,25,"add_empty_wildcards@1616-1641@usr.sbin/bind/lib/dns/rbtdb.c","usr.sbin/bind/lib/dns/rbtdb.c","add_empty_wildcards",1616,1641
49,9,345,4,60,"findnode@1644-1704@usr.sbin/bind/lib/dns/rbtdb.c","usr.sbin/bind/lib/dns/rbtdb.c","findnode",1644,1704
74,21,443,3,136,"zone_zonecut_callback@1707-1843@usr.sbin/bind/lib/dns/rbtdb.c","usr.sbin/bind/lib/dns/rbtdb.c","zone_zonecut_callback",1707,1843
30,5,212,5,49,"bind_rdataset@1846-1895@usr.sbin/bind/lib/dns/rbtdb.c","usr.sbin/bind/lib/dns/rbtdb.c","bind_rdataset",1846,1895
36,9,231,5,54,"setup_delegation@1898-1952@usr.sbin/bind/lib/dns/rbtdb.c","usr.sbin/bind/lib/dns/rbtdb.c","setup_delegation",1898,1952
41,10,233,4,62,"valid_glue@1955-2017@usr.sbin/bind/lib/dns/rbtdb.c","usr.sbin/bind/lib/dns/rbtdb.c","valid_glue",1955,2017
47,12,287,3,49,"activeempty@2020-2069@usr.sbin/bind/lib/dns/rbtdb.c","usr.sbin/bind/lib/dns/rbtdb.c","activeempty",2020,2069
95,26,624,3,112,"activeemtpynode@2072-2184@usr.sbin/bind/lib/dns/rbtdb.c","usr.sbin/bind/lib/dns/rbtdb.c","activeemtpynode",2072,2184
101,24,548,3,153,"find_wildcard@2187-2340@usr.sbin/bind/lib/dns/rbtdb.c","usr.sbin/bind/lib/dns/rbtdb.c","find_wildcard",2187,2340
92,24,494,6,135,"find_closest_nsec@2343-2478@usr.sbin/bind/lib/dns/rbtdb.c","usr.sbin/bind/lib/dns/rbtdb.c","find_closest_nsec",2343,2478
272,84,1605,10,481,"zone_find@2481-2962@usr.sbin/bind/lib/dns/rbtdb.c","usr.sbin/bind/lib/dns/rbtdb.c","zone_find",2481,2962
16,1,89,8,17,"zone_findzonecut@2965-2982@usr.sbin/bind/lib/dns/rbtdb.c","usr.sbin/bind/lib/dns/rbtdb.c","zone_findzonecut",2965,2982
65,15,392,3,109,"cache_zonecut_callback@2985-3094@usr.sbin/bind/lib/dns/rbtdb.c","usr.sbin/bind/lib/dns/rbtdb.c","cache_zonecut_callback",2985,3094
112,23,585,6,150,"find_deepest_zonecut@3097-3247@usr.sbin/bind/lib/dns/rbtdb.c","usr.sbin/bind/lib/dns/rbtdb.c","find_deepest_zonecut",3097,3247
99,19,548,6,113,"find_coveringnsec@3250-3363@usr.sbin/bind/lib/dns/rbtdb.c","usr.sbin/bind/lib/dns/rbtdb.c","find_coveringnsec",3250,3363
195,54,1182,10,316,"cache_find@3366-3682@usr.sbin/bind/lib/dns/rbtdb.c","usr.sbin/bind/lib/dns/rbtdb.c","cache_find",3366,3682
101,19,650,8,154,"cache_findzonecut@3685-3839@usr.sbin/bind/lib/dns/rbtdb.c","usr.sbin/bind/lib/dns/rbtdb.c","cache_findzonecut",3685,3839
12,2,110,3,14,"attachnode@3842-3856@usr.sbin/bind/lib/dns/rbtdb.c","usr.sbin/bind/lib/dns/rbtdb.c","attachnode",3842,3856
40,9,271,2,46,"detachnode@3859-3905@usr.sbin/bind/lib/dns/rbtdb.c","usr.sbin/bind/lib/dns/rbtdb.c","detachnode",3859,3905
54,14,354,3,87,"expirenode@3908-3995@usr.sbin/bind/lib/dns/rbtdb.c","usr.sbin/bind/lib/dns/rbtdb.c","expirenode",3908,3995
6,2,36,2,6,"overmem@3998-4004@usr.sbin/bind/lib/dns/rbtdb.c","usr.sbin/bind/lib/dns/rbtdb.c","overmem",3998,4004
36,5,219,3,40,"printnode@4007-4047@usr.sbin/bind/lib/dns/rbtdb.c","usr.sbin/bind/lib/dns/rbtdb.c","printnode",4007,4047
27,2,206,3,31,"createiterator@4050-4081@usr.sbin/bind/lib/dns/rbtdb.c","usr.sbin/bind/lib/dns/rbtdb.c","createiterator",4050,4081
67,17,414,8,83,"zone_findrdataset@4084-4167@usr.sbin/bind/lib/dns/rbtdb.c","usr.sbin/bind/lib/dns/rbtdb.c","zone_findrdataset",4084,4167
66,19,419,8,91,"cache_findrdataset@4170-4261@usr.sbin/bind/lib/dns/rbtdb.c","usr.sbin/bind/lib/dns/rbtdb.c","cache_findrdataset",4170,4261
42,5,297,5,52,"allrdatasets@4264-4316@usr.sbin/bind/lib/dns/rbtdb.c","usr.sbin/bind/lib/dns/rbtdb.c","allrdatasets",4264,4316
46,20,243,2,77,"cname_and_other_data@4319-4396@usr.sbin/bind/lib/dns/rbtdb.c","usr.sbin/bind/lib/dns/rbtdb.c","cname_and_other_data",4319,4396
230,79,1399,8,358,"add@4399-4757@usr.sbin/bind/lib/dns/rbtdb.c","usr.sbin/bind/lib/dns/rbtdb.c","add",4399,4757
14,7,77,3,13,"delegating_type@4760-4773@usr.sbin/bind/lib/dns/rbtdb.c","usr.sbin/bind/lib/dns/rbtdb.c","delegating_type",4760,4773
43,5,276,3,46,"addnoqname@4776-4822@usr.sbin/bind/lib/dns/rbtdb.c","usr.sbin/bind/lib/dns/rbtdb.c","addnoqname",4776,4822
66,15,456,7,86,"addrdataset@4825-4911@usr.sbin/bind/lib/dns/rbtdb.c","usr.sbin/bind/lib/dns/rbtdb.c","addrdataset",4825,4911
120,22,793,6,160,"subtractrdataset@4914-5074@usr.sbin/bind/lib/dns/rbtdb.c","usr.sbin/bind/lib/dns/rbtdb.c","subtractrdataset",4914,5074
38,9,280,5,49,"deleterdataset@5077-5126@usr.sbin/bind/lib/dns/rbtdb.c","usr.sbin/bind/lib/dns/rbtdb.c","deleterdataset",5077,5126
55,15,389,3,77,"loading_addrdataset@5129-5206@usr.sbin/bind/lib/dns/rbtdb.c","usr.sbin/bind/lib/dns/rbtdb.c","loading_addrdataset",5129,5206
22,3,154,3,30,"beginload@5209-5239@usr.sbin/bind/lib/dns/rbtdb.c","usr.sbin/bind/lib/dns/rbtdb.c","beginload",5209,5239
19,2,161,2,31,"endload@5242-5273@usr.sbin/bind/lib/dns/rbtdb.c","usr.sbin/bind/lib/dns/rbtdb.c","endload",5242,5273
9,1,63,4,11,"dump@5276-5287@usr.sbin/bind/lib/dns/rbtdb.c","usr.sbin/bind/lib/dns/rbtdb.c","dump",5276,5287
8,2,58,2,8,"delete_callback@5290-5298@usr.sbin/bind/lib/dns/rbtdb.c","usr.sbin/bind/lib/dns/rbtdb.c","delete_callback",5290,5298
10,1,62,1,13,"issecure@5301-5314@usr.sbin/bind/lib/dns/rbtdb.c","usr.sbin/bind/lib/dns/rbtdb.c","issecure",5301,5314
10,1,66,1,13,"nodecount@5317-5330@usr.sbin/bind/lib/dns/rbtdb.c","usr.sbin/bind/lib/dns/rbtdb.c","nodecount",5317,5330
11,3,84,2,13,"settask@5333-5346@usr.sbin/bind/lib/dns/rbtdb.c","usr.sbin/bind/lib/dns/rbtdb.c","settask",5333,5346
4,1,18,1,3,"ispersistent@5349-5352@usr.sbin/bind/lib/dns/rbtdb.c","usr.sbin/bind/lib/dns/rbtdb.c","ispersistent",5349,5352
18,3,134,2,22,"getoriginnode@5355-5377@usr.sbin/bind/lib/dns/rbtdb.c","usr.sbin/bind/lib/dns/rbtdb.c","getoriginnode",5355,5377
132,21,945,8,197,"dns_rbtdb_create@5445-5642@usr.sbin/bind/lib/dns/rbtdb.c","usr.sbin/bind/lib/dns/rbtdb.c","dns_rbtdb_create",5445,5642
5,1,32,1,5,"rdataset_disassociate@5650-5655@usr.sbin/bind/lib/dns/rbtdb.c","usr.sbin/bind/lib/dns/rbtdb.c","rdataset_disassociate",5650,5655
17,4,101,1,31,"rdataset_first@5658-5689@usr.sbin/bind/lib/dns/rbtdb.c","usr.sbin/bind/lib/dns/rbtdb.c","rdataset_first",5658,5689
18,5,106,1,28,"rdataset_next@5692-5720@usr.sbin/bind/lib/dns/rbtdb.c","usr.sbin/bind/lib/dns/rbtdb.c","rdataset_next",5692,5720
17,5,142,2,30,"rdataset_current@5723-5753@usr.sbin/bind/lib/dns/rbtdb.c","usr.sbin/bind/lib/dns/rbtdb.c","rdataset_current",5723,5753
9,1,62,2,13,"rdataset_clone@5756-5769@usr.sbin/bind/lib/dns/rbtdb.c","usr.sbin/bind/lib/dns/rbtdb.c","rdataset_clone",5756,5769
6,1,40,1,7,"rdataset_count@5772-5779@usr.sbin/bind/lib/dns/rbtdb.c","usr.sbin/bind/lib/dns/rbtdb.c","rdataset_count",5772,5779
38,1,262,4,41,"rdataset_getnoqname@5782-5823@usr.sbin/bind/lib/dns/rbtdb.c","usr.sbin/bind/lib/dns/rbtdb.c","rdataset_getnoqname",5782,5823
11,2,91,1,13,"rdatasetiter_destroy@5830-5843@usr.sbin/bind/lib/dns/rbtdb.c","usr.sbin/bind/lib/dns/rbtdb.c","rdatasetiter_destroy",5830,5843
38,11,247,1,54,"rdatasetiter_first@5846-5900@usr.sbin/bind/lib/dns/rbtdb.c","usr.sbin/bind/lib/dns/rbtdb.c","rdatasetiter_first",5846,5900
54,15,346,1,74,"rdatasetiter_next@5903-5977@usr.sbin/bind/lib/dns/rbtdb.c","usr.sbin/bind/lib/dns/rbtdb.c","rdatasetiter_next",5903,5977
14,1,116,2,17,"rdatasetiter_current@5980-5997@usr.sbin/bind/lib/dns/rbtdb.c","usr.sbin/bind/lib/dns/rbtdb.c","rdatasetiter_current",5980,5997
10,2,84,1,11,"reference_iter_node@6005-6016@usr.sbin/bind/lib/dns/rbtdb.c","usr.sbin/bind/lib/dns/rbtdb.c","reference_iter_node",6005,6016
13,2,91,1,15,"dereference_iter_node@6019-6034@usr.sbin/bind/lib/dns/rbtdb.c","usr.sbin/bind/lib/dns/rbtdb.c","dereference_iter_node",6019,6034
37,5,231,1,49,"flush_deletions@6037-6086@usr.sbin/bind/lib/dns/rbtdb.c","usr.sbin/bind/lib/dns/rbtdb.c","flush_deletions",6037,6086
8,1,60,1,10,"resume_iteration@6089-6099@usr.sbin/bind/lib/dns/rbtdb.c","usr.sbin/bind/lib/dns/rbtdb.c","resume_iteration",6089,6099
18,2,143,1,23,"dbiterator_destroy@6102-6125@usr.sbin/bind/lib/dns/rbtdb.c","usr.sbin/bind/lib/dns/rbtdb.c","dbiterator_destroy",6102,6125
30,7,198,1,37,"dbiterator_first@6128-6165@usr.sbin/bind/lib/dns/rbtdb.c","usr.sbin/bind/lib/dns/rbtdb.c","dbiterator_first",6128,6165
30,7,198,1,36,"dbiterator_last@6168-6204@usr.sbin/bind/lib/dns/rbtdb.c","usr.sbin/bind/lib/dns/rbtdb.c","dbiterator_last",6168,6204
29,7,203,2,36,"dbiterator_seek@6207-6243@usr.sbin/bind/lib/dns/rbtdb.c","usr.sbin/bind/lib/dns/rbtdb.c","dbiterator_seek",6207,6243
23,6,166,1,31,"dbiterator_prev@6246-6277@usr.sbin/bind/lib/dns/rbtdb.c","usr.sbin/bind/lib/dns/rbtdb.c","dbiterator_prev",6246,6277
23,6,166,1,30,"dbiterator_next@6280-6310@usr.sbin/bind/lib/dns/rbtdb.c","usr.sbin/bind/lib/dns/rbtdb.c","dbiterator_next",6280,6310
43,12,333,3,61,"dbiterator_current@6313-6374@usr.sbin/bind/lib/dns/rbtdb.c","usr.sbin/bind/lib/dns/rbtdb.c","dbiterator_current",6313,6374
17,5,113,1,22,"dbiterator_pause@6377-6399@usr.sbin/bind/lib/dns/rbtdb.c","usr.sbin/bind/lib/dns/rbtdb.c","dbiterator_pause",6377,6399
7,2,61,2,8,"dbiterator_origin@6402-6410@usr.sbin/bind/lib/dns/rbtdb.c","usr.sbin/bind/lib/dns/rbtdb.c","dbiterator_origin",6402,6410
59,7,347,11,71,"rdataset_getadditional@6416-6487@usr.sbin/bind/lib/dns/rbtdb.c","usr.sbin/bind/lib/dns/rbtdb.c","rdataset_getadditional",6416,6487
36,4,252,2,48,"acache_callback@6490-6538@usr.sbin/bind/lib/dns/rbtdb.c","usr.sbin/bind/lib/dns/rbtdb.c","acache_callback",6490,6538
14,2,93,3,18,"acache_cancelentry@6541-6559@usr.sbin/bind/lib/dns/rbtdb.c","usr.sbin/bind/lib/dns/rbtdb.c","acache_cancelentry",6541,6559
110,17,693,9,131,"rdataset_setadditional@6562-6693@usr.sbin/bind/lib/dns/rbtdb.c","usr.sbin/bind/lib/dns/rbtdb.c","rdataset_setadditional",6562,6693
55,8,330,4,67,"rdataset_putadditional@6696-6763@usr.sbin/bind/lib/dns/rbtdb.c","usr.sbin/bind/lib/dns/rbtdb.c","rdataset_putadditional",6696,6763
11,2,71,2,13,"str_totext@175-188@usr.sbin/bind/lib/dns/rcode.c","usr.sbin/bind/lib/dns/rcode.c","str_totext",175,188
21,7,147,4,28,"maybe_numeric@191-219@usr.sbin/bind/lib/dns/rcode.c","usr.sbin/bind/lib/dns/rcode.c","maybe_numeric",191,219
19,5,136,4,20,"dns_mnemonic_fromtext@222-242@usr.sbin/bind/lib/dns/rcode.c","usr.sbin/bind/lib/dns/rcode.c","dns_mnemonic_fromtext",222,242
14,3,99,3,13,"dns_mnemonic_totext@245-258@usr.sbin/bind/lib/dns/rcode.c","usr.sbin/bind/lib/dns/rcode.c","dns_mnemonic_totext",245,258
6,1,41,2,5,"dns_rcode_fromtext@261-266@usr.sbin/bind/lib/dns/rcode.c","usr.sbin/bind/lib/dns/rcode.c","dns_rcode_fromtext",261,266
3,1,23,2,2,"dns_rcode_totext@269-271@usr.sbin/bind/lib/dns/rcode.c","usr.sbin/bind/lib/dns/rcode.c","dns_rcode_totext",269,271
6,1,41,2,5,"dns_tsigrcode_fromtext@274-279@usr.sbin/bind/lib/dns/rcode.c","usr.sbin/bind/lib/dns/rcode.c","dns_tsigrcode_fromtext",274,279
3,1,23,2,2,"dns_tsigrcode_totext@282-284@usr.sbin/bind/lib/dns/rcode.c","usr.sbin/bind/lib/dns/rcode.c","dns_tsigrcode_totext",282,284
6,1,41,2,5,"dns_cert_fromtext@287-292@usr.sbin/bind/lib/dns/rcode.c","usr.sbin/bind/lib/dns/rcode.c","dns_cert_fromtext",287,292
3,1,23,2,2,"dns_cert_totext@295-297@usr.sbin/bind/lib/dns/rcode.c","usr.sbin/bind/lib/dns/rcode.c","dns_cert_totext",295,297
6,1,41,2,5,"dns_secalg_fromtext@300-305@usr.sbin/bind/lib/dns/rcode.c","usr.sbin/bind/lib/dns/rcode.c","dns_secalg_fromtext",300,305
3,1,23,2,2,"dns_secalg_totext@308-310@usr.sbin/bind/lib/dns/rcode.c","usr.sbin/bind/lib/dns/rcode.c","dns_secalg_totext",308,310
6,1,41,2,5,"dns_secproto_fromtext@313-318@usr.sbin/bind/lib/dns/rcode.c","usr.sbin/bind/lib/dns/rcode.c","dns_secproto_fromtext",313,318
3,1,23,2,2,"dns_secproto_totext@321-323@usr.sbin/bind/lib/dns/rcode.c","usr.sbin/bind/lib/dns/rcode.c","dns_secproto_totext",321,323
6,1,42,2,5,"dns_hashalg_fromtext@326-331@usr.sbin/bind/lib/dns/rcode.c","usr.sbin/bind/lib/dns/rcode.c","dns_hashalg_fromtext",326,331
40,11,243,2,44,"dns_keyflags_fromtext@334-378@usr.sbin/bind/lib/dns/rcode.c","usr.sbin/bind/lib/dns/rcode.c","dns_keyflags_fromtext",334,378
38,12,229,2,54,"dns_rdataclass_fromtext@385-439@usr.sbin/bind/lib/dns/rcode.c","usr.sbin/bind/lib/dns/rcode.c","dns_rdataclass_fromtext",385,439
20,7,130,2,20,"dns_rdataclass_totext@442-462@usr.sbin/bind/lib/dns/rcode.c","usr.sbin/bind/lib/dns/rcode.c","dns_rdataclass_totext",442,462
18,4,98,3,21,"dns_rdataclass_format@465-486@usr.sbin/bind/lib/dns/rcode.c","usr.sbin/bind/lib/dns/rcode.c","dns_rdataclass_format",465,486
17,5,110,4,17,"getquad@211-228@usr.sbin/bind/lib/dns/rdata.c","usr.sbin/bind/lib/dns/rdata.c","getquad",211,228
6,2,46,3,6,"name_duporclone@231-237@usr.sbin/bind/lib/dns/rdata.c","usr.sbin/bind/lib/dns/rdata.c","name_duporclone",231,237
9,3,59,3,10,"mem_maybedup@240-250@usr.sbin/bind/lib/dns/rdata.c","usr.sbin/bind/lib/dns/rdata.c","mem_maybedup",240,250
9,1,52,1,11,"dns_rdata_init@265-276@usr.sbin/bind/lib/dns/rdata.c","usr.sbin/bind/lib/dns/rdata.c","dns_rdata_init",265,276
10,1,64,1,12,"dns_rdata_reset@295-307@usr.sbin/bind/lib/dns/rdata.c","usr.sbin/bind/lib/dns/rdata.c","dns_rdata_reset",295,307
12,1,91,2,15,"dns_rdata_clone@314-329@usr.sbin/bind/lib/dns/rdata.c","usr.sbin/bind/lib/dns/rdata.c","dns_rdata_clone",314,329
23,8,181,2,28,"dns_rdata_compare@337-365@usr.sbin/bind/lib/dns/rdata.c","usr.sbin/bind/lib/dns/rdata.c","dns_rdata_compare",337,365
13,1,82,4,15,"dns_rdata_fromregion@372-387@usr.sbin/bind/lib/dns/rdata.c","usr.sbin/bind/lib/dns/rdata.c","dns_rdata_fromregion",372,387
7,1,51,2,8,"dns_rdata_toregion@390-398@usr.sbin/bind/lib/dns/rdata.c","usr.sbin/bind/lib/dns/rdata.c","dns_rdata_toregion",390,398
47,10,252,7,58,"dns_rdata_fromwire@401-459@usr.sbin/bind/lib/dns/rdata.c","usr.sbin/bind/lib/dns/rdata.c","dns_rdata_fromwire",401,459
30,5,178,3,37,"dns_rdata_towire@462-499@usr.sbin/bind/lib/dns/rdata.c","usr.sbin/bind/lib/dns/rdata.c","dns_rdata_towire",462,499
13,1,82,4,14,"rdata_validate@507-521@usr.sbin/bind/lib/dns/rdata.c","usr.sbin/bind/lib/dns/rdata.c","rdata_validate",507,521
38,10,239,5,43,"unknown_fromtext@524-567@usr.sbin/bind/lib/dns/rdata.c","usr.sbin/bind/lib/dns/rdata.c","unknown_fromtext",524,567
85,21,523,9,97,"dns_rdata_fromtext@570-667@usr.sbin/bind/lib/dns/rdata.c","usr.sbin/bind/lib/dns/rdata.c","dns_rdata_fromtext",570,667
38,10,262,3,45,"rdata_totext@670-715@usr.sbin/bind/lib/dns/rdata.c","usr.sbin/bind/lib/dns/rdata.c","rdata_totext",670,715
10,1,64,3,14,"dns_rdata_totext@718-732@usr.sbin/bind/lib/dns/rdata.c","usr.sbin/bind/lib/dns/rdata.c","dns_rdata_totext",718,732
17,2,103,6,21,"dns_rdata_tofmttext@735-756@usr.sbin/bind/lib/dns/rdata.c","usr.sbin/bind/lib/dns/rdata.c","dns_rdata_tofmttext",735,756
27,6,149,5,31,"dns_rdata_fromstruct@759-790@usr.sbin/bind/lib/dns/rdata.c","usr.sbin/bind/lib/dns/rdata.c","dns_rdata_fromstruct",759,790
10,2,56,3,13,"dns_rdata_tostruct@793-806@usr.sbin/bind/lib/dns/rdata.c","usr.sbin/bind/lib/dns/rdata.c","dns_rdata_tostruct",793,806
5,1,22,1,5,"dns_rdata_freestruct@809-814@usr.sbin/bind/lib/dns/rdata.c","usr.sbin/bind/lib/dns/rdata.c","dns_rdata_freestruct",809,814
13,2,61,3,22,"dns_rdata_additionaldata@817-839@usr.sbin/bind/lib/dns/rdata.c","usr.sbin/bind/lib/dns/rdata.c","dns_rdata_additionaldata",817,839
14,2,82,3,21,"dns_rdata_digest@842-863@usr.sbin/bind/lib/dns/rdata.c","usr.sbin/bind/lib/dns/rdata.c","dns_rdata_digest",842,863
7,1,26,4,7,"dns_rdata_checkowner@866-873@usr.sbin/bind/lib/dns/rdata.c","usr.sbin/bind/lib/dns/rdata.c","dns_rdata_checkowner",866,873
6,1,25,3,6,"dns_rdata_checknames@876-882@usr.sbin/bind/lib/dns/rdata.c","usr.sbin/bind/lib/dns/rdata.c","dns_rdata_checknames",876,882
7,3,36,1,6,"dns_rdatatype_attributes@885-891@usr.sbin/bind/lib/dns/rdata.c","usr.sbin/bind/lib/dns/rdata.c","dns_rdatatype_attributes",885,891
25,7,216,2,37,"dns_rdatatype_fromtext@894-931@usr.sbin/bind/lib/dns/rdata.c","usr.sbin/bind/lib/dns/rdata.c","dns_rdatatype_fromtext",894,931
6,1,45,2,6,"dns_rdatatype_totext@934-940@usr.sbin/bind/lib/dns/rdata.c","usr.sbin/bind/lib/dns/rdata.c","dns_rdatatype_totext",934,940
18,4,98,3,21,"dns_rdatatype_format@943-964@usr.sbin/bind/lib/dns/rdata.c","usr.sbin/bind/lib/dns/rdata.c","dns_rdatatype_format",943,964
3,1,15,1,2,"name_length@971-973@usr.sbin/bind/lib/dns/rdata.c","usr.sbin/bind/lib/dns/rdata.c","name_length",971,973
47,12,306,2,51,"txt_totext@976-1027@usr.sbin/bind/lib/dns/rdata.c","usr.sbin/bind/lib/dns/rdata.c","txt_totext",976,1027
56,14,326,2,62,"txt_fromtext@1030-1092@usr.sbin/bind/lib/dns/rdata.c","usr.sbin/bind/lib/dns/rdata.c","txt_fromtext",1030,1092
18,4,118,2,20,"txt_fromwire@1095-1115@usr.sbin/bind/lib/dns/rdata.c","usr.sbin/bind/lib/dns/rdata.c","txt_fromwire",1095,1115
18,5,111,3,24,"name_prefix@1118-1142@usr.sbin/bind/lib/dns/rdata.c","usr.sbin/bind/lib/dns/rdata.c","name_prefix",1118,1142
11,2,71,2,13,"str_totext@1145-1158@usr.sbin/bind/lib/dns/rdata.c","usr.sbin/bind/lib/dns/rdata.c","str_totext",1145,1158
9,3,75,3,10,"inet_totext@1161-1171@usr.sbin/bind/lib/dns/rdata.c","usr.sbin/bind/lib/dns/rdata.c","inet_totext",1161,1171
3,2,25,1,2,"buffer_empty@1174-1176@usr.sbin/bind/lib/dns/rdata.c","usr.sbin/bind/lib/dns/rdata.c","buffer_empty",1174,1176
5,1,43,2,4,"buffer_fromregion@1179-1183@usr.sbin/bind/lib/dns/rdata.c","usr.sbin/bind/lib/dns/rdata.c","buffer_fromregion",1179,1183
8,2,47,2,8,"uint32_tobuffer@1186-1194@usr.sbin/bind/lib/dns/rdata.c","usr.sbin/bind/lib/dns/rdata.c","uint32_tobuffer",1186,1194
10,3,61,2,10,"uint16_tobuffer@1197-1207@usr.sbin/bind/lib/dns/rdata.c","usr.sbin/bind/lib/dns/rdata.c","uint16_tobuffer",1197,1207
10,3,61,2,10,"uint8_tobuffer@1210-1220@usr.sbin/bind/lib/dns/rdata.c","usr.sbin/bind/lib/dns/rdata.c","uint8_tobuffer",1210,1220
5,1,34,2,4,"name_tobuffer@1223-1227@usr.sbin/bind/lib/dns/rdata.c","usr.sbin/bind/lib/dns/rdata.c","name_tobuffer",1223,1227
9,1,70,1,9,"uint32_fromregion@1230-1239@usr.sbin/bind/lib/dns/rdata.c","usr.sbin/bind/lib/dns/rdata.c","uint32_fromregion",1230,1239
5,1,26,1,5,"uint16_consume_fromregion@1242-1247@usr.sbin/bind/lib/dns/rdata.c","usr.sbin/bind/lib/dns/rdata.c","uint16_consume_fromregion",1242,1247
4,1,39,1,5,"uint16_fromregion@1250-1255@usr.sbin/bind/lib/dns/rdata.c","usr.sbin/bind/lib/dns/rdata.c","uint16_fromregion",1250,1255
4,1,27,1,5,"uint8_fromregion@1258-1263@usr.sbin/bind/lib/dns/rdata.c","usr.sbin/bind/lib/dns/rdata.c","uint8_fromregion",1258,1263
5,1,26,1,5,"uint8_consume_fromregion@1266-1271@usr.sbin/bind/lib/dns/rdata.c","usr.sbin/bind/lib/dns/rdata.c","uint8_consume_fromregion",1266,1271
9,2,63,3,9,"mem_tobuffer@1274-1283@usr.sbin/bind/lib/dns/rdata.c","usr.sbin/bind/lib/dns/rdata.c","mem_tobuffer",1274,1283
12,4,79,1,13,"hexvalue@1286-1299@usr.sbin/bind/lib/dns/rdata.c","usr.sbin/bind/lib/dns/rdata.c","hexvalue",1286,1299
8,3,53,1,12,"decvalue@1302-1314@usr.sbin/bind/lib/dns/rdata.c","usr.sbin/bind/lib/dns/rdata.c","decvalue",1302,1314
33,6,256,3,32,"byte_atob@1360-1392@usr.sbin/bind/lib/dns/rdata.c","usr.sbin/bind/lib/dns/rdata.c","byte_atob",1360,1392
19,3,104,3,19,"putbyte@1398-1417@usr.sbin/bind/lib/dns/rdata.c","usr.sbin/bind/lib/dns/rdata.c","putbyte",1398,1417
39,10,330,2,57,"atob_tobuffer@1433-1490@usr.sbin/bind/lib/dns/rdata.c","usr.sbin/bind/lib/dns/rdata.c","atob_tobuffer",1433,1490
53,8,367,3,58,"byte_btoa@1497-1555@usr.sbin/bind/lib/dns/rdata.c","usr.sbin/bind/lib/dns/rdata.c","byte_btoa",1497,1555
12,3,127,3,18,"btoa_totext@1563-1581@usr.sbin/bind/lib/dns/rdata.c","usr.sbin/bind/lib/dns/rdata.c","btoa_totext",1563,1581
10,1,51,3,11,"default_fromtext_callback@1585-1596@usr.sbin/bind/lib/dns/rdata.c","usr.sbin/bind/lib/dns/rdata.c","default_fromtext_callback",1585,1596
10,4,64,2,9,"fromtext_warneof@1599-1608@usr.sbin/bind/lib/dns/rdata.c","usr.sbin/bind/lib/dns/rdata.c","fromtext_warneof",1599,1608
13,2,74,3,13,"warn_badmx@1611-1624@usr.sbin/bind/lib/dns/rdata.c","usr.sbin/bind/lib/dns/rdata.c","warn_badmx",1611,1624
15,2,88,3,15,"warn_badname@1627-1642@usr.sbin/bind/lib/dns/rdata.c","usr.sbin/bind/lib/dns/rdata.c","warn_badname",1627,1642
42,8,232,6,42,"fromtext_error@1645-1687@usr.sbin/bind/lib/dns/rdata.c","usr.sbin/bind/lib/dns/rdata.c","fromtext_error",1645,1687
5,2,32,1,4,"dns_rdata_covers@1690-1694@usr.sbin/bind/lib/dns/rdata.c","usr.sbin/bind/lib/dns/rdata.c","dns_rdata_covers",1690,1694
5,2,30,1,4,"dns_rdatatype_ismeta@1697-1701@usr.sbin/bind/lib/dns/rdata.c","usr.sbin/bind/lib/dns/rdata.c","dns_rdatatype_ismeta",1697,1701
6,2,30,1,5,"dns_rdatatype_issingleton@1704-1709@usr.sbin/bind/lib/dns/rdata.c","usr.sbin/bind/lib/dns/rdata.c","dns_rdatatype_issingleton",1704,1709
6,2,30,1,5,"dns_rdatatype_notquestion@1712-1717@usr.sbin/bind/lib/dns/rdata.c","usr.sbin/bind/lib/dns/rdata.c","dns_rdatatype_notquestion",1712,1717
6,2,30,1,5,"dns_rdatatype_questiononly@1720-1725@usr.sbin/bind/lib/dns/rdata.c","usr.sbin/bind/lib/dns/rdata.c","dns_rdatatype_questiononly",1720,1725
5,2,30,1,4,"dns_rdatatype_atparent@1728-1732@usr.sbin/bind/lib/dns/rdata.c","usr.sbin/bind/lib/dns/rdata.c","dns_rdatatype_atparent",1728,1732
7,4,31,1,8,"dns_rdataclass_ismeta@1735-1743@usr.sbin/bind/lib/dns/rdata.c","usr.sbin/bind/lib/dns/rdata.c","dns_rdataclass_ismeta",1735,1743
5,2,30,1,4,"dns_rdatatype_isdnssec@1746-1750@usr.sbin/bind/lib/dns/rdata.c","usr.sbin/bind/lib/dns/rdata.c","dns_rdatatype_isdnssec",1746,1750
7,2,34,1,6,"dns_rdatatype_iszonecutauth@1753-1759@usr.sbin/bind/lib/dns/rdata.c","usr.sbin/bind/lib/dns/rdata.c","dns_rdatatype_iszonecutauth",1753,1759
6,2,30,1,5,"dns_rdatatype_isknown@1762-1767@usr.sbin/bind/lib/dns/rdata.c","usr.sbin/bind/lib/dns/rdata.c","dns_rdatatype_isknown",1762,1767
8,1,46,1,12,"dns_rdatalist_init@50-62@usr.sbin/bind/lib/dns/rdatalist.c","usr.sbin/bind/lib/dns/rdatalist.c","dns_rdatalist_init",50,62
18,1,116,2,24,"dns_rdatalist_tordataset@65-89@usr.sbin/bind/lib/dns/rdatalist.c","usr.sbin/bind/lib/dns/rdatalist.c","dns_rdatalist_tordataset",65,89
3,1,13,1,2,"isc__rdatalist_disassociate@92-94@usr.sbin/bind/lib/dns/rdatalist.c","usr.sbin/bind/lib/dns/rdatalist.c","isc__rdatalist_disassociate",92,94
8,2,47,1,10,"isc__rdatalist_first@97-107@usr.sbin/bind/lib/dns/rdatalist.c","usr.sbin/bind/lib/dns/rdatalist.c","isc__rdatalist_first",97,107
10,3,58,1,13,"isc__rdatalist_next@110-123@usr.sbin/bind/lib/dns/rdatalist.c","usr.sbin/bind/lib/dns/rdatalist.c","isc__rdatalist_next",110,123
6,1,36,2,7,"isc__rdatalist_current@126-133@usr.sbin/bind/lib/dns/rdatalist.c","usr.sbin/bind/lib/dns/rdatalist.c","isc__rdatalist_current",126,133
4,1,24,2,7,"isc__rdatalist_clone@136-143@usr.sbin/bind/lib/dns/rdatalist.c","usr.sbin/bind/lib/dns/rdatalist.c","isc__rdatalist_clone",136,143
12,2,62,1,14,"isc__rdatalist_count@146-160@usr.sbin/bind/lib/dns/rdatalist.c","usr.sbin/bind/lib/dns/rdatalist.c","isc__rdatalist_count",146,160
29,10,179,2,33,"isc__rdatalist_addnoqname@163-196@usr.sbin/bind/lib/dns/rdatalist.c","usr.sbin/bind/lib/dns/rdatalist.c","isc__rdatalist_addnoqname",163,196
28,8,175,4,30,"isc__rdatalist_getnoqname@199-229@usr.sbin/bind/lib/dns/rdatalist.c","usr.sbin/bind/lib/dns/rdatalist.c","isc__rdatalist_getnoqname",199,229
19,1,112,1,24,"dns_rdataset_init@38-62@usr.sbin/bind/lib/dns/rdataset.c","usr.sbin/bind/lib/dns/rdataset.c","dns_rdataset_init",38,62
18,1,110,1,23,"dns_rdataset_invalidate@65-88@usr.sbin/bind/lib/dns/rdataset.c","usr.sbin/bind/lib/dns/rdataset.c","dns_rdataset_invalidate",65,88
20,1,127,1,25,"dns_rdataset_disassociate@91-116@usr.sbin/bind/lib/dns/rdataset.c","usr.sbin/bind/lib/dns/rdataset.c","dns_rdataset_disassociate",91,116
6,2,34,1,11,"dns_rdataset_isassociated@119-130@usr.sbin/bind/lib/dns/rdataset.c","usr.sbin/bind/lib/dns/rdataset.c","dns_rdataset_isassociated",119,130
3,1,13,1,2,"question_disassociate@133-135@usr.sbin/bind/lib/dns/rdataset.c","usr.sbin/bind/lib/dns/rdataset.c","question_disassociate",133,135
4,1,18,1,4,"question_cursor@138-142@usr.sbin/bind/lib/dns/rdataset.c","usr.sbin/bind/lib/dns/rdataset.c","question_cursor",138,142
5,1,27,2,8,"question_current@145-153@usr.sbin/bind/lib/dns/rdataset.c","usr.sbin/bind/lib/dns/rdataset.c","question_current",145,153
3,1,18,2,2,"question_clone@156-158@usr.sbin/bind/lib/dns/rdataset.c","usr.sbin/bind/lib/dns/rdataset.c","question_clone",156,158
5,1,23,1,8,"question_count@161-169@usr.sbin/bind/lib/dns/rdataset.c","usr.sbin/bind/lib/dns/rdataset.c","question_count",161,169
10,1,56,3,16,"dns_rdataset_makequestion@186-202@usr.sbin/bind/lib/dns/rdataset.c","usr.sbin/bind/lib/dns/rdataset.c","dns_rdataset_makequestion",186,202
5,1,39,1,10,"dns_rdataset_count@205-215@usr.sbin/bind/lib/dns/rdataset.c","usr.sbin/bind/lib/dns/rdataset.c","dns_rdataset_count",205,215
7,1,59,2,12,"dns_rdataset_clone@218-230@usr.sbin/bind/lib/dns/rdataset.c","usr.sbin/bind/lib/dns/rdataset.c","dns_rdataset_clone",218,230
5,1,39,1,10,"dns_rdataset_first@233-243@usr.sbin/bind/lib/dns/rdataset.c","usr.sbin/bind/lib/dns/rdataset.c","dns_rdataset_first",233,243
5,1,39,1,10,"dns_rdataset_next@246-256@usr.sbin/bind/lib/dns/rdataset.c","usr.sbin/bind/lib/dns/rdataset.c","dns_rdataset_next",246,256
5,1,42,2,10,"dns_rdataset_current@259-269@usr.sbin/bind/lib/dns/rdataset.c","usr.sbin/bind/lib/dns/rdataset.c","dns_rdataset_current",259,269
5,1,53,2,4,"towire_compare@281-285@usr.sbin/bind/lib/dns/rdataset.c","usr.sbin/bind/lib/dns/rdataset.c","towire_compare",281,285
186,46,1240,10,244,"towiresorted@288-532@usr.sbin/bind/lib/dns/rdataset.c","usr.sbin/bind/lib/dns/rdataset.c","towiresorted",288,532
13,1,64,8,12,"dns_rdataset_towiresorted@535-547@usr.sbin/bind/lib/dns/rdataset.c","usr.sbin/bind/lib/dns/rdataset.c","dns_rdataset_towiresorted",535,547
15,1,75,9,14,"dns_rdataset_towirepartial@550-564@usr.sbin/bind/lib/dns/rdataset.c","usr.sbin/bind/lib/dns/rdataset.c","dns_rdataset_towirepartial",550,564
10,1,55,6,9,"dns_rdataset_towire@567-576@usr.sbin/bind/lib/dns/rdataset.c","usr.sbin/bind/lib/dns/rdataset.c","dns_rdataset_towire",567,576
21,5,127,3,30,"dns_rdataset_additionaldata@579-609@usr.sbin/bind/lib/dns/rdataset.c","usr.sbin/bind/lib/dns/rdataset.c","dns_rdataset_additionaldata",579,609
7,2,60,2,7,"dns_rdataset_addnoqname@612-619@usr.sbin/bind/lib/dns/rdataset.c","usr.sbin/bind/lib/dns/rdataset.c","dns_rdataset_addnoqname",612,619
9,2,72,4,9,"dns_rdataset_getnoqname@622-631@usr.sbin/bind/lib/dns/rdataset.c","usr.sbin/bind/lib/dns/rdataset.c","dns_rdataset_getnoqname",622,631
29,7,179,11,30,"dns_rdataset_getadditional@637-667@usr.sbin/bind/lib/dns/rdataset.c","usr.sbin/bind/lib/dns/rdataset.c","dns_rdataset_getadditional",637,667
20,3,106,9,21,"dns_rdataset_setadditional@670-691@usr.sbin/bind/lib/dns/rdataset.c","usr.sbin/bind/lib/dns/rdataset.c","dns_rdataset_setadditional",670,691
13,3,76,4,14,"dns_rdataset_putadditional@694-708@usr.sbin/bind/lib/dns/rdataset.c","usr.sbin/bind/lib/dns/rdataset.c","dns_rdataset_putadditional",694,708
6,1,44,1,11,"dns_rdatasetiter_destroy@32-43@usr.sbin/bind/lib/dns/rdatasetiter.c","usr.sbin/bind/lib/dns/rdatasetiter.c","dns_rdatasetiter_destroy",32,43
4,1,28,1,8,"dns_rdatasetiter_first@46-54@usr.sbin/bind/lib/dns/rdatasetiter.c","usr.sbin/bind/lib/dns/rdatasetiter.c","dns_rdatasetiter_first",46,54
4,1,28,1,8,"dns_rdatasetiter_next@57-65@usr.sbin/bind/lib/dns/rdatasetiter.c","usr.sbin/bind/lib/dns/rdatasetiter.c","dns_rdatasetiter_next",57,65
8,1,48,2,12,"dns_rdatasetiter_current@68-80@usr.sbin/bind/lib/dns/rdatasetiter.c","usr.sbin/bind/lib/dns/rdatasetiter.c","dns_rdatasetiter_current",68,80
5,1,46,2,4,"compare_rdata@89-93@usr.sbin/bind/lib/dns/rdataslab.c","usr.sbin/bind/lib/dns/rdataslab.c","compare_rdata",89,93
18,3,160,3,27,"fillin_offsets@97-124@usr.sbin/bind/lib/dns/rdataslab.c","usr.sbin/bind/lib/dns/rdataslab.c","fillin_offsets",97,124
93,30,746,4,179,"dns_rdataslab_fromrdataset@128-307@usr.sbin/bind/lib/dns/rdataslab.c","usr.sbin/bind/lib/dns/rdataslab.c","dns_rdataslab_fromrdataset",128,307
3,1,13,1,2,"rdataset_disassociate@310-312@usr.sbin/bind/lib/dns/rdataslab.c","usr.sbin/bind/lib/dns/rdataslab.c","rdataset_disassociate",310,312
15,3,88,1,24,"rdataset_first@315-339@usr.sbin/bind/lib/dns/rdataslab.c","usr.sbin/bind/lib/dns/rdataslab.c","rdataset_first",315,339
16,3,90,1,20,"rdataset_next@342-362@usr.sbin/bind/lib/dns/rdataslab.c","usr.sbin/bind/lib/dns/rdataslab.c","rdataset_next",342,362
10,2,77,2,14,"rdataset_current@365-379@usr.sbin/bind/lib/dns/rdataslab.c","usr.sbin/bind/lib/dns/rdataslab.c","rdataset_current",365,379
5,1,30,2,8,"rdataset_clone@382-390@usr.sbin/bind/lib/dns/rdataslab.c","usr.sbin/bind/lib/dns/rdataslab.c","rdataset_clone",382,390
6,1,40,1,7,"rdataset_count@393-400@usr.sbin/bind/lib/dns/rdataslab.c","usr.sbin/bind/lib/dns/rdataslab.c","rdataset_count",393,400
19,1,114,7,23,"dns_rdataslab_tordataset@417-440@usr.sbin/bind/lib/dns/rdataslab.c","usr.sbin/bind/lib/dns/rdataslab.c","dns_rdataslab_tordataset",417,440
17,4,107,2,24,"dns_rdataslab_size@443-467@usr.sbin/bind/lib/dns/rdataslab.c","usr.sbin/bind/lib/dns/rdataslab.c","dns_rdataslab_size",443,467
14,2,81,4,16,"rdata_from_slab@476-492@usr.sbin/bind/lib/dns/rdataslab.c","usr.sbin/bind/lib/dns/rdataslab.c","rdata_from_slab",476,492
23,5,138,5,28,"rdata_in_slab@500-528@usr.sbin/bind/lib/dns/rdataslab.c","usr.sbin/bind/lib/dns/rdataslab.c","rdata_in_slab",500,528
157,45,1092,8,261,"dns_rdataslab_merge@531-792@usr.sbin/bind/lib/dns/rdataslab.c","usr.sbin/bind/lib/dns/rdataslab.c","dns_rdataslab_merge",531,792
96,27,712,8,170,"dns_rdataslab_subtract@795-965@usr.sbin/bind/lib/dns/rdataslab.c","usr.sbin/bind/lib/dns/rdataslab.c","dns_rdataslab_subtract",795,965
32,7,187,3,45,"dns_rdataslab_equal@968-1013@usr.sbin/bind/lib/dns/rdataslab.c","usr.sbin/bind/lib/dns/rdataslab.c","dns_rdataslab_equal",968,1013
28,5,185,5,34,"dns_rdataslab_equalx@1016-1050@usr.sbin/bind/lib/dns/rdataslab.c","usr.sbin/bind/lib/dns/rdataslab.c","dns_rdataslab_equalx",1016,1050
68,11,440,8,73,"dns_requestmgr_create@136-209@usr.sbin/bind/lib/dns/request.c","usr.sbin/bind/lib/dns/request.c","dns_requestmgr_create",136,209
22,2,129,3,29,"dns_requestmgr_whenshutdown@212-241@usr.sbin/bind/lib/dns/request.c","usr.sbin/bind/lib/dns/request.c","dns_requestmgr_whenshutdown",212,241
7,1,49,1,9,"dns_requestmgr_shutdown@244-253@usr.sbin/bind/lib/dns/request.c","usr.sbin/bind/lib/dns/request.c","dns_requestmgr_shutdown",244,253
15,4,83,1,18,"mgr_shutdown@256-274@usr.sbin/bind/lib/dns/request.c","usr.sbin/bind/lib/dns/request.c","mgr_shutdown",256,274
9,2,70,2,16,"requestmgr_attach@277-293@usr.sbin/bind/lib/dns/request.c","usr.sbin/bind/lib/dns/request.c","requestmgr_attach",277,293
22,5,144,1,26,"requestmgr_detach@296-322@usr.sbin/bind/lib/dns/request.c","usr.sbin/bind/lib/dns/request.c","requestmgr_detach",296,322
11,2,86,2,13,"dns_requestmgr_attach@325-338@usr.sbin/bind/lib/dns/request.c","usr.sbin/bind/lib/dns/request.c","dns_requestmgr_attach",325,338
21,5,137,1,26,"dns_requestmgr_detach@341-367@usr.sbin/bind/lib/dns/request.c","usr.sbin/bind/lib/dns/request.c","dns_requestmgr_detach",341,367
14,2,93,1,18,"send_shutdown_events@370-388@usr.sbin/bind/lib/dns/request.c","usr.sbin/bind/lib/dns/request.c","send_shutdown_events",370,388
18,4,138,1,20,"mgr_destroy@391-411@usr.sbin/bind/lib/dns/request.c","usr.sbin/bind/lib/dns/request.c","mgr_destroy",391,411
5,1,32,1,7,"mgr_gethash@414-421@usr.sbin/bind/lib/dns/request.c","usr.sbin/bind/lib/dns/request.c","mgr_gethash",414,421
14,2,102,3,15,"req_send@424-439@usr.sbin/bind/lib/dns/request.c","usr.sbin/bind/lib/dns/request.c","req_send",424,439
28,2,188,2,34,"new_request@442-476@usr.sbin/bind/lib/dns/request.c","usr.sbin/bind/lib/dns/request.c","new_request",442,476
20,5,121,2,20,"isblackholed@480-500@usr.sbin/bind/lib/dns/request.c","usr.sbin/bind/lib/dns/request.c","isblackholed",480,500
40,5,213,4,42,"create_tcp_dispatch@503-545@usr.sbin/bind/lib/dns/request.c","usr.sbin/bind/lib/dns/request.c","create_tcp_dispatch",503,545
46,7,199,4,50,"find_udp_dispatch@548-598@usr.sbin/bind/lib/dns/request.c","usr.sbin/bind/lib/dns/request.c","find_udp_dispatch",548,598
13,2,62,5,12,"get_dispatch@601-613@usr.sbin/bind/lib/dns/request.c","usr.sbin/bind/lib/dns/request.c","get_dispatch",601,613
14,3,97,3,15,"set_timer@616-631@usr.sbin/bind/lib/dns/request.c","usr.sbin/bind/lib/dns/request.c","set_timer",616,631
10,1,73,10,9,"dns_request_createraw@634-643@usr.sbin/bind/lib/dns/request.c","usr.sbin/bind/lib/dns/request.c","dns_request_createraw",634,643
15,2,95,11,16,"dns_request_createraw2@646-662@usr.sbin/bind/lib/dns/request.c","usr.sbin/bind/lib/dns/request.c","dns_request_createraw2",646,662
127,28,868,12,150,"dns_request_createraw3@665-815@usr.sbin/bind/lib/dns/request.c","usr.sbin/bind/lib/dns/request.c","dns_request_createraw3",665,815
11,1,75,10,10,"dns_request_create@818-828@usr.sbin/bind/lib/dns/request.c","usr.sbin/bind/lib/dns/request.c","dns_request_create",818,828
11,1,79,11,10,"dns_request_createvia@831-841@usr.sbin/bind/lib/dns/request.c","usr.sbin/bind/lib/dns/request.c","dns_request_createvia",831,841
15,2,101,12,15,"dns_request_createvia2@844-859@usr.sbin/bind/lib/dns/request.c","usr.sbin/bind/lib/dns/request.c","dns_request_createvia2",844,859
133,26,865,13,156,"dns_request_createvia3@862-1018@usr.sbin/bind/lib/dns/request.c","usr.sbin/bind/lib/dns/request.c","dns_request_createvia3",862,1018
67,19,421,4,87,"req_render@1021-1108@usr.sbin/bind/lib/dns/request.c","usr.sbin/bind/lib/dns/request.c","req_render",1021,1108
6,4,37,2,5,"send_if_done@1120-1125@usr.sbin/bind/lib/dns/request.c","usr.sbin/bind/lib/dns/request.c","send_if_done",1120,1125
11,2,90,2,10,"do_cancel@1131-1141@usr.sbin/bind/lib/dns/request.c","usr.sbin/bind/lib/dns/request.c","do_cancel",1131,1141
12,3,108,1,14,"dns_request_cancel@1144-1158@usr.sbin/bind/lib/dns/request.c","usr.sbin/bind/lib/dns/request.c","dns_request_cancel",1144,1158
21,5,144,3,23,"dns_request_getresponse@1161-1184@usr.sbin/bind/lib/dns/request.c","usr.sbin/bind/lib/dns/request.c","dns_request_getresponse",1161,1184
4,1,32,1,4,"dns_request_usedtcp@1187-1191@usr.sbin/bind/lib/dns/request.c","usr.sbin/bind/lib/dns/request.c","dns_request_usedtcp",1187,1191
19,2,171,1,29,"dns_request_destroy@1194-1223@usr.sbin/bind/lib/dns/request.c","usr.sbin/bind/lib/dns/request.c","dns_request_destroy",1194,1223
28,5,196,2,35,"req_connected@1230-1265@usr.sbin/bind/lib/dns/request.c","usr.sbin/bind/lib/dns/request.c","req_connected",1230,1265
22,4,168,2,30,"req_senddone@1268-1298@usr.sbin/bind/lib/dns/request.c","usr.sbin/bind/lib/dns/request.c","req_senddone",1268,1298
28,4,211,2,41,"req_response@1301-1342@usr.sbin/bind/lib/dns/request.c","usr.sbin/bind/lib/dns/request.c","req_response",1301,1342
24,5,166,2,26,"req_timeout@1345-1371@usr.sbin/bind/lib/dns/request.c","usr.sbin/bind/lib/dns/request.c","req_timeout",1345,1371
9,1,74,2,14,"req_sendevent@1374-1388@usr.sbin/bind/lib/dns/request.c","usr.sbin/bind/lib/dns/request.c","req_sendevent",1374,1388
27,10,213,1,29,"req_destroy@1391-1420@usr.sbin/bind/lib/dns/request.c","usr.sbin/bind/lib/dns/request.c","req_destroy",1391,1420
19,5,134,1,25,"req_cancel@1426-1451@usr.sbin/bind/lib/dns/request.c","usr.sbin/bind/lib/dns/request.c","req_cancel",1426,1451
7,1,44,3,7,"req_log@1454-1461@usr.sbin/bind/lib/dns/request.c","usr.sbin/bind/lib/dns/request.c","req_log",1454,1461
31,5,226,8,34,"valcreate@376-410@usr.sbin/bind/lib/dns/resolver.c","usr.sbin/bind/lib/dns/resolver.c","valcreate",376,410
61,19,360,2,71,"fix_mustbedelegationornxdomain@413-484@usr.sbin/bind/lib/dns/resolver.c","usr.sbin/bind/lib/dns/resolver.c","fix_mustbedelegationornxdomain",413,484
4,1,29,1,10,"fctx_starttimer@487-497@usr.sbin/bind/lib/dns/resolver.c","usr.sbin/bind/lib/dns/resolver.c","fctx_starttimer",487,497
10,2,50,1,16,"fctx_stoptimer@500-516@usr.sbin/bind/lib/dns/resolver.c","usr.sbin/bind/lib/dns/resolver.c","fctx_stoptimer",500,516
5,1,32,1,8,"fctx_startidletimer@520-528@usr.sbin/bind/lib/dns/resolver.c","usr.sbin/bind/lib/dns/resolver.c","fctx_startidletimer",520,528
13,2,93,1,15,"resquery_destroy@538-553@usr.sbin/bind/lib/dns/resolver.c","usr.sbin/bind/lib/dns/resolver.c","resquery_destroy",538,553
81,28,555,4,128,"fctx_cancelquery@556-684@usr.sbin/bind/lib/dns/resolver.c","usr.sbin/bind/lib/dns/resolver.c","fctx_cancelquery",556,684
10,2,65,2,11,"fctx_cancelqueries@687-698@usr.sbin/bind/lib/dns/resolver.c","usr.sbin/bind/lib/dns/resolver.c","fctx_cancelqueries",687,698
12,2,78,1,13,"fctx_cleanupfinds@701-714@usr.sbin/bind/lib/dns/resolver.c","usr.sbin/bind/lib/dns/resolver.c","fctx_cleanupfinds",701,714
12,2,78,1,13,"fctx_cleanupaltfinds@717-730@usr.sbin/bind/lib/dns/resolver.c","usr.sbin/bind/lib/dns/resolver.c","fctx_cleanupaltfinds",717,730
11,2,76,1,12,"fctx_cleanupforwaddrs@733-745@usr.sbin/bind/lib/dns/resolver.c","usr.sbin/bind/lib/dns/resolver.c","fctx_cleanupforwaddrs",733,745
11,2,76,1,12,"fctx_cleanupaltaddrs@748-760@usr.sbin/bind/lib/dns/resolver.c","usr.sbin/bind/lib/dns/resolver.c","fctx_cleanupaltaddrs",748,760
9,1,48,2,8,"fctx_stopeverything@763-771@usr.sbin/bind/lib/dns/resolver.c","usr.sbin/bind/lib/dns/resolver.c","fctx_stopeverything",763,771
54,19,379,2,66,"fctx_sendevents@774-840@usr.sbin/bind/lib/dns/resolver.c","usr.sbin/bind/lib/dns/resolver.c","fctx_sendevents",774,840
16,2,100,2,21,"fctx_done@843-864@usr.sbin/bind/lib/dns/resolver.c","usr.sbin/bind/lib/dns/resolver.c","fctx_done",843,864
44,12,228,2,73,"resquery_senddone@867-940@usr.sbin/bind/lib/dns/resolver.c","usr.sbin/bind/lib/dns/resolver.c","resquery_senddone",867,940
34,4,219,3,49,"fctx_addopt@943-992@usr.sbin/bind/lib/dns/resolver.c","usr.sbin/bind/lib/dns/resolver.c","fctx_addopt",943,992
16,4,98,2,33,"fctx_setretryinterval@995-1028@usr.sbin/bind/lib/dns/resolver.c","usr.sbin/bind/lib/dns/resolver.c","fctx_setretryinterval",995,1028
186,26,972,3,236,"fctx_query@1031-1267@usr.sbin/bind/lib/dns/resolver.c","usr.sbin/bind/lib/dns/resolver.c","fctx_query",1031,1267
10,3,61,2,11,"triededns@1270-1281@usr.sbin/bind/lib/dns/resolver.c","usr.sbin/bind/lib/dns/resolver.c","triededns",1270,1281
11,3,76,2,13,"add_triededns@1284-1297@usr.sbin/bind/lib/dns/resolver.c","usr.sbin/bind/lib/dns/resolver.c","add_triededns",1284,1297
10,3,61,2,11,"triededns512@1300-1311@usr.sbin/bind/lib/dns/resolver.c","usr.sbin/bind/lib/dns/resolver.c","triededns512",1300,1311
11,3,76,2,13,"add_triededns512@1314-1327@usr.sbin/bind/lib/dns/resolver.c","usr.sbin/bind/lib/dns/resolver.c","add_triededns512",1314,1327
200,50,1371,1,305,"resquery_send@1330-1635@usr.sbin/bind/lib/dns/resolver.c","usr.sbin/bind/lib/dns/resolver.c","resquery_send",1330,1635
69,14,364,2,109,"resquery_connected@1638-1747@usr.sbin/bind/lib/dns/resolver.c","usr.sbin/bind/lib/dns/resolver.c","resquery_connected",1638,1747
41,12,263,2,59,"fctx_finddone@1750-1809@usr.sbin/bind/lib/dns/resolver.c","usr.sbin/bind/lib/dns/resolver.c","fctx_finddone",1750,1809
10,3,61,2,11,"bad_server@1813-1824@usr.sbin/bind/lib/dns/resolver.c","usr.sbin/bind/lib/dns/resolver.c","bad_server",1813,1824
46,11,274,1,64,"mark_bad@1827-1891@usr.sbin/bind/lib/dns/resolver.c","usr.sbin/bind/lib/dns/resolver.c","mark_bad",1827,1891
53,9,384,3,61,"add_bad@1894-1955@usr.sbin/bind/lib/dns/resolver.c","usr.sbin/bind/lib/dns/resolver.c","add_bad",1894,1955
17,4,110,1,21,"sort_adbfind@1958-1979@usr.sbin/bind/lib/dns/resolver.c","usr.sbin/bind/lib/dns/resolver.c","sort_adbfind",1958,1979
43,7,285,1,48,"sort_finds@1982-2030@usr.sbin/bind/lib/dns/resolver.c","usr.sbin/bind/lib/dns/resolver.c","sort_finds",1982,2030
64,24,416,7,98,"findname@2033-2131@usr.sbin/bind/lib/dns/resolver.c","usr.sbin/bind/lib/dns/resolver.c","findname",2033,2131
135,29,818,1,213,"fctx_getaddresses@2134-2347@usr.sbin/bind/lib/dns/resolver.c","usr.sbin/bind/lib/dns/resolver.c","fctx_getaddresses",2134,2347
54,14,345,2,61,"possibly_mark@2350-2411@usr.sbin/bind/lib/dns/resolver.c","usr.sbin/bind/lib/dns/resolver.c","possibly_mark",2350,2411
103,30,566,1,139,"fctx_nextaddress@2414-2553@usr.sbin/bind/lib/dns/resolver.c","usr.sbin/bind/lib/dns/resolver.c","fctx_nextaddress",2414,2553
31,6,167,1,48,"fctx_try@2556-2604@usr.sbin/bind/lib/dns/resolver.c","usr.sbin/bind/lib/dns/resolver.c","fctx_try",2556,2604
59,9,524,1,76,"fctx_destroy@2607-2683@usr.sbin/bind/lib/dns/resolver.c","usr.sbin/bind/lib/dns/resolver.c","fctx_destroy",2607,2683
26,5,162,2,47,"fctx_timeout@2690-2737@usr.sbin/bind/lib/dns/resolver.c","usr.sbin/bind/lib/dns/resolver.c","fctx_timeout",2690,2737
12,3,67,1,29,"fctx_shutdown@2740-2769@usr.sbin/bind/lib/dns/resolver.c","usr.sbin/bind/lib/dns/resolver.c","fctx_shutdown",2740,2769
36,10,246,2,62,"fctx_doshutdown@2772-2834@usr.sbin/bind/lib/dns/resolver.c","usr.sbin/bind/lib/dns/resolver.c","fctx_doshutdown",2772,2834
40,6,260,2,69,"fctx_start@2837-2906@usr.sbin/bind/lib/dns/resolver.c","usr.sbin/bind/lib/dns/resolver.c","fctx_start",2837,2906
36,3,228,9,49,"fctx_join@2913-2962@usr.sbin/bind/lib/dns/resolver.c","usr.sbin/bind/lib/dns/resolver.c","fctx_join",2913,2962
176,21,1214,8,238,"fctx_create@2965-3203@usr.sbin/bind/lib/dns/resolver.c","usr.sbin/bind/lib/dns/resolver.c","fctx_create",2965,3203
37,11,224,1,41,"is_lame@3209-3250@usr.sbin/bind/lib/dns/resolver.c","usr.sbin/bind/lib/dns/resolver.c","is_lame",3209,3250
12,1,94,2,12,"log_lame@3253-3265@usr.sbin/bind/lib/dns/resolver.c","usr.sbin/bind/lib/dns/resolver.c","log_lame",3253,3265
21,6,146,1,30,"same_question@3268-3298@usr.sbin/bind/lib/dns/resolver.c","usr.sbin/bind/lib/dns/resolver.c","same_question",3268,3298
34,9,247,1,42,"clone_results@3301-3343@usr.sbin/bind/lib/dns/resolver.c","usr.sbin/bind/lib/dns/resolver.c","clone_results",3301,3343
25,8,181,1,33,"maybe_destroy@3363-3396@usr.sbin/bind/lib/dns/resolver.c","usr.sbin/bind/lib/dns/resolver.c","maybe_destroy",3363,3396
225,58,1456,2,310,"validated@3402-3712@usr.sbin/bind/lib/dns/resolver.c","usr.sbin/bind/lib/dns/resolver.c","validated",3402,3712
245,76,1348,4,361,"cache_name@3715-4076@usr.sbin/bind/lib/dns/resolver.c","usr.sbin/bind/lib/dns/resolver.c","cache_name",3715,4076
31,7,189,3,36,"cache_message@4079-4115@usr.sbin/bind/lib/dns/resolver.c","usr.sbin/bind/lib/dns/resolver.c","cache_message",4079,4115
28,8,151,8,46,"ncache_adderesult@4121-4167@usr.sbin/bind/lib/dns/resolver.c","usr.sbin/bind/lib/dns/resolver.c","ncache_adderesult",4121,4167
107,21,642,4,149,"ncache_message@4170-4319@usr.sbin/bind/lib/dns/resolver.c","usr.sbin/bind/lib/dns/resolver.c","ncache_message",4170,4319
18,5,95,4,24,"mark_related@4322-4346@usr.sbin/bind/lib/dns/resolver.c","usr.sbin/bind/lib/dns/resolver.c","mark_related",4322,4346
50,10,271,3,55,"check_related@4349-4404@usr.sbin/bind/lib/dns/resolver.c","usr.sbin/bind/lib/dns/resolver.c","check_related",4349,4404
31,6,161,1,32,"chase_additional@4407-4439@usr.sbin/bind/lib/dns/resolver.c","usr.sbin/bind/lib/dns/resolver.c","chase_additional",4407,4439
16,3,101,2,17,"cname_target@4442-4459@usr.sbin/bind/lib/dns/resolver.c","usr.sbin/bind/lib/dns/resolver.c","cname_target",4442,4459
31,4,188,4,39,"dname_target@4462-4501@usr.sbin/bind/lib/dns/resolver.c","usr.sbin/bind/lib/dns/resolver.c","dname_target",4462,4501
199,65,1057,3,335,"noanswer_response@4511-4846@usr.sbin/bind/lib/dns/resolver.c","usr.sbin/bind/lib/dns/resolver.c","noanswer_response",4511,4846
233,59,1107,1,391,"answer_response@4849-5240@usr.sbin/bind/lib/dns/resolver.c","usr.sbin/bind/lib/dns/resolver.c","answer_response",4849,5240
100,16,664,2,115,"resume_dslookup@5243-5358@usr.sbin/bind/lib/dns/resolver.c","usr.sbin/bind/lib/dns/resolver.c","resume_dslookup",5243,5358
31,6,166,2,31,"checknamessection@5361-5392@usr.sbin/bind/lib/dns/resolver.c","usr.sbin/bind/lib/dns/resolver.c","checknamessection",5361,5392
5,1,29,1,5,"checknames@5395-5400@usr.sbin/bind/lib/dns/resolver.c","usr.sbin/bind/lib/dns/resolver.c","checknames",5395,5400
27,7,163,3,34,"log_packet@5403-5437@usr.sbin/bind/lib/dns/resolver.c","usr.sbin/bind/lib/dns/resolver.c","log_packet",5403,5437
371,83,2130,2,618,"resquery_response@5440-6058@usr.sbin/bind/lib/dns/resolver.c","usr.sbin/bind/lib/dns/resolver.c","resquery_response",5440,6058
38,8,336,1,45,"destroy@6066-6111@usr.sbin/bind/lib/dns/resolver.c","usr.sbin/bind/lib/dns/resolver.c","destroy",6066,6111
13,2,81,1,17,"send_shutdown_events@6114-6131@usr.sbin/bind/lib/dns/resolver.c","usr.sbin/bind/lib/dns/resolver.c","send_shutdown_events",6114,6131
9,2,56,1,11,"empty_bucket@6134-6145@usr.sbin/bind/lib/dns/resolver.c","usr.sbin/bind/lib/dns/resolver.c","empty_bucket",6134,6145
27,4,157,2,30,"spillattimer_countdown@6148-6178@usr.sbin/bind/lib/dns/resolver.c","usr.sbin/bind/lib/dns/resolver.c","spillattimer_countdown",6148,6178
141,26,987,10,176,"dns_resolver_create@6181-6357@usr.sbin/bind/lib/dns/resolver.c","usr.sbin/bind/lib/dns/resolver.c","dns_resolver_create",6181,6357
35,7,274,2,43,"prime_done@6360-6403@usr.sbin/bind/lib/dns/resolver.c","usr.sbin/bind/lib/dns/resolver.c","prime_done",6360,6403
43,6,262,1,57,"dns_resolver_prime@6406-6463@usr.sbin/bind/lib/dns/resolver.c","usr.sbin/bind/lib/dns/resolver.c","dns_resolver_prime",6406,6463
5,1,30,1,10,"dns_resolver_freeze@6466-6476@usr.sbin/bind/lib/dns/resolver.c","usr.sbin/bind/lib/dns/resolver.c","dns_resolver_freeze",6466,6476
12,2,91,2,14,"dns_resolver_attach@6479-6493@usr.sbin/bind/lib/dns/resolver.c","usr.sbin/bind/lib/dns/resolver.c","dns_resolver_attach",6479,6493
21,3,125,3,28,"dns_resolver_whenshutdown@6496-6524@usr.sbin/bind/lib/dns/resolver.c","usr.sbin/bind/lib/dns/resolver.c","dns_resolver_whenshutdown",6496,6524
43,8,297,1,48,"dns_resolver_shutdown@6527-6575@usr.sbin/bind/lib/dns/resolver.c","usr.sbin/bind/lib/dns/resolver.c","dns_resolver_shutdown",6527,6575
19,4,113,1,25,"dns_resolver_detach@6578-6603@usr.sbin/bind/lib/dns/resolver.c","usr.sbin/bind/lib/dns/resolver.c","dns_resolver_detach",6578,6603
7,3,51,4,6,"fctx_match@6606-6612@usr.sbin/bind/lib/dns/resolver.c","usr.sbin/bind/lib/dns/resolver.c","fctx_match",6606,6612
12,2,84,2,14,"log_fetch@6615-6629@usr.sbin/bind/lib/dns/resolver.c","usr.sbin/bind/lib/dns/resolver.c","log_fetch",6615,6629
15,1,90,13,14,"dns_resolver_createfetch@6632-6646@usr.sbin/bind/lib/dns/resolver.c","usr.sbin/bind/lib/dns/resolver.c","dns_resolver_createfetch",6632,6646
108,27,687,15,141,"dns_resolver_createfetch2@6649-6790@usr.sbin/bind/lib/dns/resolver.c","usr.sbin/bind/lib/dns/resolver.c","dns_resolver_createfetch2",6649,6790
31,5,195,1,44,"dns_resolver_cancelfetch@6793-6837@usr.sbin/bind/lib/dns/resolver.c","usr.sbin/bind/lib/dns/resolver.c","dns_resolver_cancelfetch",6793,6837
42,9,262,1,63,"dns_resolver_destroyfetch@6840-6903@usr.sbin/bind/lib/dns/resolver.c","usr.sbin/bind/lib/dns/resolver.c","dns_resolver_destroyfetch",6840,6903
4,1,23,1,3,"dns_resolver_dispatchmgr@6906-6909@usr.sbin/bind/lib/dns/resolver.c","usr.sbin/bind/lib/dns/resolver.c","dns_resolver_dispatchmgr",6906,6909
4,1,23,1,3,"dns_resolver_dispatchv4@6912-6915@usr.sbin/bind/lib/dns/resolver.c","usr.sbin/bind/lib/dns/resolver.c","dns_resolver_dispatchv4",6912,6915
4,1,23,1,3,"dns_resolver_dispatchv6@6918-6921@usr.sbin/bind/lib/dns/resolver.c","usr.sbin/bind/lib/dns/resolver.c","dns_resolver_dispatchv6",6918,6921
4,1,23,1,3,"dns_resolver_socketmgr@6924-6927@usr.sbin/bind/lib/dns/resolver.c","usr.sbin/bind/lib/dns/resolver.c","dns_resolver_socketmgr",6924,6927
4,1,23,1,3,"dns_resolver_taskmgr@6930-6933@usr.sbin/bind/lib/dns/resolver.c","usr.sbin/bind/lib/dns/resolver.c","dns_resolver_taskmgr",6930,6933
4,1,23,1,3,"dns_resolver_getlamettl@6936-6939@usr.sbin/bind/lib/dns/resolver.c","usr.sbin/bind/lib/dns/resolver.c","dns_resolver_getlamettl",6936,6939
4,1,25,2,3,"dns_resolver_setlamettl@6942-6945@usr.sbin/bind/lib/dns/resolver.c","usr.sbin/bind/lib/dns/resolver.c","dns_resolver_setlamettl",6942,6945
7,1,39,1,6,"dns_resolver_nrunning@6948-6954@usr.sbin/bind/lib/dns/resolver.c","usr.sbin/bind/lib/dns/resolver.c","dns_resolver_nrunning",6948,6954
27,4,210,4,29,"dns_resolver_addalternate@6957-6986@usr.sbin/bind/lib/dns/resolver.c","usr.sbin/bind/lib/dns/resolver.c","dns_resolver_addalternate",6957,6986
4,1,25,2,3,"dns_resolver_setudpsize@6989-6992@usr.sbin/bind/lib/dns/resolver.c","usr.sbin/bind/lib/dns/resolver.c","dns_resolver_setudpsize",6989,6992
4,1,23,1,3,"dns_resolver_getudpsize@6995-6998@usr.sbin/bind/lib/dns/resolver.c","usr.sbin/bind/lib/dns/resolver.c","dns_resolver_getudpsize",6995,6998
5,1,35,2,5,"free_algorithm@7001-7006@usr.sbin/bind/lib/dns/resolver.c","usr.sbin/bind/lib/dns/resolver.c","free_algorithm",7001,7006
7,4,52,1,12,"dns_resolver_reset_algorithms@7009-7021@usr.sbin/bind/lib/dns/resolver.c","usr.sbin/bind/lib/dns/resolver.c","dns_resolver_reset_algorithms",7009,7021
46,13,293,3,54,"dns_resolver_disable_algorithm@7024-7078@usr.sbin/bind/lib/dns/resolver.c","usr.sbin/bind/lib/dns/resolver.c","dns_resolver_disable_algorithm",7024,7078
26,9,176,3,31,"dns_resolver_algorithm_supported@7081-7112@usr.sbin/bind/lib/dns/resolver.c","usr.sbin/bind/lib/dns/resolver.c","dns_resolver_algorithm_supported",7081,7112
4,1,25,2,4,"dns_resolver_digest_supported@7115-7119@usr.sbin/bind/lib/dns/resolver.c","usr.sbin/bind/lib/dns/resolver.c","dns_resolver_digest_supported",7115,7119
7,4,52,1,12,"dns_resolver_resetmustbesecure@7122-7134@usr.sbin/bind/lib/dns/resolver.c","usr.sbin/bind/lib/dns/resolver.c","dns_resolver_resetmustbesecure",7122,7134
18,6,109,3,23,"dns_resolver_setmustbesecure@7139-7162@usr.sbin/bind/lib/dns/resolver.c","usr.sbin/bind/lib/dns/resolver.c","dns_resolver_setmustbesecure",7139,7162
15,6,109,2,20,"dns_resolver_getmustbesecure@7165-7185@usr.sbin/bind/lib/dns/resolver.c","usr.sbin/bind/lib/dns/resolver.c","dns_resolver_getmustbesecure",7165,7185
13,4,83,4,13,"dns_resolver_getclientsperquery@7188-7201@usr.sbin/bind/lib/dns/resolver.c","usr.sbin/bind/lib/dns/resolver.c","dns_resolver_getclientsperquery",7188,7201
9,1,54,3,9,"dns_resolver_setclientsperquery@7204-7213@usr.sbin/bind/lib/dns/resolver.c","usr.sbin/bind/lib/dns/resolver.c","dns_resolver_setclientsperquery",7204,7213
4,1,23,1,4,"dns_resolver_getzeronosoattl@7216-7220@usr.sbin/bind/lib/dns/resolver.c","usr.sbin/bind/lib/dns/resolver.c","dns_resolver_getzeronosoattl",7216,7220
4,1,25,2,4,"dns_resolver_setzeronosoattl@7223-7227@usr.sbin/bind/lib/dns/resolver.c","usr.sbin/bind/lib/dns/resolver.c","dns_resolver_setzeronosoattl",7223,7227
13,3,62,1,13,"initialize_action@190-203@usr.sbin/bind/lib/dns/result.c","usr.sbin/bind/lib/dns/result.c","initialize_action",190,203
4,1,23,1,3,"initialize@206-209@usr.sbin/bind/lib/dns/result.c","usr.sbin/bind/lib/dns/result.c","initialize",206,209
4,1,19,1,4,"dns_result_totext@212-216@usr.sbin/bind/lib/dns/result.c","usr.sbin/bind/lib/dns/result.c","dns_result_totext",212,216
3,1,10,1,2,"dns_result_register@219-221@usr.sbin/bind/lib/dns/result.c","usr.sbin/bind/lib/dns/result.c","dns_result_register",219,221
42,25,145,1,52,"dns_result_torcode@224-276@usr.sbin/bind/lib/dns/result.c","usr.sbin/bind/lib/dns/result.c","dns_result_torcode",224,276
20,6,124,2,21,"in_rootns@85-106@usr.sbin/bind/lib/dns/rootns.c","usr.sbin/bind/lib/dns/rootns.c","in_rootns",85,106
32,9,154,3,33,"check_node@109-142@usr.sbin/bind/lib/dns/rootns.c","usr.sbin/bind/lib/dns/rootns.c","check_node",109,142
46,11,288,1,49,"check_hints@145-194@usr.sbin/bind/lib/dns/rootns.c","usr.sbin/bind/lib/dns/rootns.c","check_hints",145,194
49,12,321,4,61,"dns_rootns_create@197-258@usr.sbin/bind/lib/dns/rootns.c","usr.sbin/bind/lib/dns/rootns.c","dns_rootns_create",197,258
32,4,217,4,34,"report@261-295@usr.sbin/bind/lib/dns/rootns.c","usr.sbin/bind/lib/dns/rootns.c","report",261,295
13,3,78,2,13,"inrrset@298-311@usr.sbin/bind/lib/dns/rootns.c","usr.sbin/bind/lib/dns/rootns.c","inrrset",298,311
86,27,641,5,91,"check_address_records@320-411@usr.sbin/bind/lib/dns/rootns.c","usr.sbin/bind/lib/dns/rootns.c","check_address_records",320,411
90,13,573,3,106,"dns_root_checkhints@414-520@usr.sbin/bind/lib/dns/rootns.c","usr.sbin/bind/lib/dns/rootns.c","dns_root_checkhints",414,520
38,5,244,6,42,"dns_sdb_register@210-252@usr.sbin/bind/lib/dns/sdb.c","usr.sbin/bind/lib/dns/sdb.c","dns_sdb_register",210,252
12,2,78,1,15,"dns_sdb_unregister@255-270@usr.sbin/bind/lib/dns/sdb.c","usr.sbin/bind/lib/dns/sdb.c","dns_sdb_unregister",255,270
7,3,46,1,7,"initial_size@273-280@usr.sbin/bind/lib/dns/sdb.c","usr.sbin/bind/lib/dns/sdb.c","initial_size",273,280
51,9,341,5,56,"dns_sdb_putrdata@283-339@usr.sbin/bind/lib/dns/sdb.c","usr.sbin/bind/lib/dns/sdb.c","dns_sdb_putrdata",283,339
74,14,441,4,87,"dns_sdb_putrr@343-430@usr.sbin/bind/lib/dns/sdb.c","usr.sbin/bind/lib/dns/sdb.c","dns_sdb_putrr",343,430
50,11,379,3,55,"getnode@433-488@usr.sbin/bind/lib/dns/sdb.c","usr.sbin/bind/lib/dns/sdb.c","getnode",433,488
10,2,72,5,9,"dns_sdb_putnamedrr@491-500@usr.sbin/bind/lib/dns/sdb.c","usr.sbin/bind/lib/dns/sdb.c","dns_sdb_putnamedrr",491,500
11,2,76,6,10,"dns_sdb_putnamedrdata@503-513@usr.sbin/bind/lib/dns/sdb.c","usr.sbin/bind/lib/dns/sdb.c","dns_sdb_putnamedrdata",503,513
15,3,120,4,16,"dns_sdb_putsoa@516-532@usr.sbin/bind/lib/dns/sdb.c","usr.sbin/bind/lib/dns/sdb.c","dns_sdb_putsoa",516,532
9,1,65,2,11,"attach@539-550@usr.sbin/bind/lib/dns/sdb.c","usr.sbin/bind/lib/dns/sdb.c","attach",539,550
18,2,133,1,23,"destroy@553-576@usr.sbin/bind/lib/dns/sdb.c","usr.sbin/bind/lib/dns/sdb.c","destroy",553,576
14,3,90,1,16,"detach@579-595@usr.sbin/bind/lib/dns/sdb.c","usr.sbin/bind/lib/dns/sdb.c","detach",579,595
6,1,36,3,5,"beginload@598-603@usr.sbin/bind/lib/dns/sdb.c","usr.sbin/bind/lib/dns/sdb.c","beginload",598,603
5,1,27,2,4,"endload@606-610@usr.sbin/bind/lib/dns/sdb.c","usr.sbin/bind/lib/dns/sdb.c","endload",606,610
8,1,45,4,7,"dump@613-620@usr.sbin/bind/lib/dns/sdb.c","usr.sbin/bind/lib/dns/sdb.c","dump",613,620
6,2,41,2,7,"currentversion@623-630@usr.sbin/bind/lib/dns/sdb.c","usr.sbin/bind/lib/dns/sdb.c","currentversion",623,630
5,1,27,2,5,"newversion@633-638@usr.sbin/bind/lib/dns/sdb.c","usr.sbin/bind/lib/dns/sdb.c","newversion",633,638
9,3,56,3,9,"attachversion@641-650@usr.sbin/bind/lib/dns/sdb.c","usr.sbin/bind/lib/dns/sdb.c","attachversion",641,650
7,2,54,3,8,"closeversion@653-661@usr.sbin/bind/lib/dns/sdb.c","usr.sbin/bind/lib/dns/sdb.c","closeversion",653,661
23,3,166,2,25,"createnode@664-689@usr.sbin/bind/lib/dns/sdb.c","usr.sbin/bind/lib/dns/sdb.c","createnode",664,689
32,5,241,1,35,"destroynode@692-727@usr.sbin/bind/lib/dns/sdb.c","usr.sbin/bind/lib/dns/sdb.c","destroynode",692,727
59,13,398,4,68,"findnode@730-798@usr.sbin/bind/lib/dns/sdb.c","usr.sbin/bind/lib/dns/sdb.c","findnode",730,798
108,30,611,10,156,"find@801-957@usr.sbin/bind/lib/dns/sdb.c","usr.sbin/bind/lib/dns/sdb.c","find",801,957
14,1,80,8,14,"findzonecut@960-974@usr.sbin/bind/lib/dns/sdb.c","usr.sbin/bind/lib/dns/sdb.c","findzonecut",960,974
12,1,93,3,15,"attachnode@977-992@usr.sbin/bind/lib/dns/sdb.c","usr.sbin/bind/lib/dns/sdb.c","attachnode",977,992
18,4,123,2,23,"detachnode@995-1018@usr.sbin/bind/lib/dns/sdb.c","usr.sbin/bind/lib/dns/sdb.c","detachnode",995,1018
7,1,40,3,6,"expirenode@1021-1027@usr.sbin/bind/lib/dns/sdb.c","usr.sbin/bind/lib/dns/sdb.c","expirenode",1021,1027
6,1,33,3,5,"printnode@1030-1035@usr.sbin/bind/lib/dns/sdb.c","usr.sbin/bind/lib/dns/sdb.c","printnode",1030,1035
35,5,260,3,42,"createiterator@1038-1080@usr.sbin/bind/lib/dns/sdb.c","usr.sbin/bind/lib/dns/sdb.c","createiterator",1038,1080
26,5,154,8,31,"findrdataset@1083-1114@usr.sbin/bind/lib/dns/sdb.c","usr.sbin/bind/lib/dns/sdb.c","findrdataset",1083,1114
20,3,151,5,25,"allrdatasets@1117-1142@usr.sbin/bind/lib/dns/sdb.c","usr.sbin/bind/lib/dns/sdb.c","allrdatasets",1117,1142
13,1,71,7,13,"addrdataset@1145-1158@usr.sbin/bind/lib/dns/sdb.c","usr.sbin/bind/lib/dns/sdb.c","addrdataset",1145,1158
12,1,63,6,12,"subtractrdataset@1161-1173@usr.sbin/bind/lib/dns/sdb.c","usr.sbin/bind/lib/dns/sdb.c","subtractrdataset",1161,1173
10,1,52,5,10,"deleterdataset@1176-1186@usr.sbin/bind/lib/dns/sdb.c","usr.sbin/bind/lib/dns/sdb.c","deleterdataset",1176,1186
4,1,18,1,4,"issecure@1189-1193@usr.sbin/bind/lib/dns/sdb.c","usr.sbin/bind/lib/dns/sdb.c","issecure",1189,1193
4,1,18,1,4,"nodecount@1196-1200@usr.sbin/bind/lib/dns/sdb.c","usr.sbin/bind/lib/dns/sdb.c","nodecount",1196,1200
4,1,18,1,3,"ispersistent@1203-1206@usr.sbin/bind/lib/dns/sdb.c","usr.sbin/bind/lib/dns/sdb.c","ispersistent",1203,1206
4,1,21,2,3,"overmem@1209-1212@usr.sbin/bind/lib/dns/sdb.c","usr.sbin/bind/lib/dns/sdb.c","overmem",1209,1212
4,1,22,2,3,"settask@1215-1218@usr.sbin/bind/lib/dns/sdb.c","usr.sbin/bind/lib/dns/sdb.c","settask",1215,1218
65,9,451,8,81,"dns_sdb_create@1253-1334@usr.sbin/bind/lib/dns/sdb.c","usr.sbin/bind/lib/dns/sdb.c","dns_sdb_create",1253,1334
7,1,51,1,7,"disassociate@1342-1349@usr.sbin/bind/lib/dns/sdb.c","usr.sbin/bind/lib/dns/sdb.c","disassociate",1342,1349
9,1,71,2,9,"rdataset_clone@1352-1361@usr.sbin/bind/lib/dns/sdb.c","usr.sbin/bind/lib/dns/sdb.c","rdataset_clone",1352,1361
9,1,51,4,17,"list_tordataset@1378-1395@usr.sbin/bind/lib/dns/sdb.c","usr.sbin/bind/lib/dns/sdb.c","list_tordataset",1378,1395
13,2,107,1,15,"dbiterator_destroy@1401-1416@usr.sbin/bind/lib/dns/sdb.c","usr.sbin/bind/lib/dns/sdb.c","dbiterator_destroy",1401,1416
8,2,48,1,8,"dbiterator_first@1419-1427@usr.sbin/bind/lib/dns/sdb.c","usr.sbin/bind/lib/dns/sdb.c","dbiterator_first",1419,1427
8,2,48,1,8,"dbiterator_last@1430-1438@usr.sbin/bind/lib/dns/sdb.c","usr.sbin/bind/lib/dns/sdb.c","dbiterator_last",1430,1438
8,3,64,2,8,"dbiterator_seek@1441-1449@usr.sbin/bind/lib/dns/sdb.c","usr.sbin/bind/lib/dns/sdb.c","dbiterator_seek",1441,1449
8,2,50,1,8,"dbiterator_prev@1452-1460@usr.sbin/bind/lib/dns/sdb.c","usr.sbin/bind/lib/dns/sdb.c","dbiterator_prev",1452,1460
8,2,50,1,8,"dbiterator_next@1463-1471@usr.sbin/bind/lib/dns/sdb.c","usr.sbin/bind/lib/dns/sdb.c","dbiterator_next",1463,1471
9,2,66,3,9,"dbiterator_current@1474-1483@usr.sbin/bind/lib/dns/sdb.c","usr.sbin/bind/lib/dns/sdb.c","dbiterator_current",1474,1483
4,1,18,1,3,"dbiterator_pause@1486-1489@usr.sbin/bind/lib/dns/sdb.c","usr.sbin/bind/lib/dns/sdb.c","dbiterator_pause",1486,1489
4,1,29,2,3,"dbiterator_origin@1492-1495@usr.sbin/bind/lib/dns/sdb.c","usr.sbin/bind/lib/dns/sdb.c","dbiterator_origin",1492,1495
7,1,60,1,6,"rdatasetiter_destroy@1502-1508@usr.sbin/bind/lib/dns/sdb.c","usr.sbin/bind/lib/dns/sdb.c","rdatasetiter_destroy",1502,1508
8,2,60,1,8,"rdatasetiter_first@1511-1519@usr.sbin/bind/lib/dns/sdb.c","usr.sbin/bind/lib/dns/sdb.c","rdatasetiter_first",1511,1519
8,2,50,1,8,"rdatasetiter_next@1522-1530@usr.sbin/bind/lib/dns/sdb.c","usr.sbin/bind/lib/dns/sdb.c","rdatasetiter_next",1522,1530
5,1,39,2,5,"rdatasetiter_current@1533-1538@usr.sbin/bind/lib/dns/sdb.c","usr.sbin/bind/lib/dns/sdb.c","rdatasetiter_current",1533,1538
8,4,59,1,10,"dns_sdlz_tolower@231-241@usr.sbin/bind/lib/dns/sdlz.c","usr.sbin/bind/lib/dns/sdlz.c","dns_sdlz_tolower",231,241
4,1,33,1,3,"initial_size@244-247@usr.sbin/bind/lib/dns/sdlz.c","usr.sbin/bind/lib/dns/sdlz.c","initial_size",244,247
8,1,60,1,8,"rdatasetiter_destroy@255-263@usr.sbin/bind/lib/dns/sdlz.c","usr.sbin/bind/lib/dns/sdlz.c","rdatasetiter_destroy",255,263
8,2,60,1,8,"rdatasetiter_first@266-274@usr.sbin/bind/lib/dns/sdlz.c","usr.sbin/bind/lib/dns/sdlz.c","rdatasetiter_first",266,274
8,2,50,1,8,"rdatasetiter_next@277-285@usr.sbin/bind/lib/dns/sdlz.c","usr.sbin/bind/lib/dns/sdlz.c","rdatasetiter_next",277,285
5,1,39,2,5,"rdatasetiter_current@288-293@usr.sbin/bind/lib/dns/sdlz.c","usr.sbin/bind/lib/dns/sdlz.c","rdatasetiter_current",288,293
9,1,65,2,11,"attach@308-319@usr.sbin/bind/lib/dns/sdlz.c","usr.sbin/bind/lib/dns/sdlz.c","attach",308,319
10,1,74,1,13,"destroy@322-335@usr.sbin/bind/lib/dns/sdlz.c","usr.sbin/bind/lib/dns/sdlz.c","destroy",322,335
14,3,90,1,16,"detach@338-354@usr.sbin/bind/lib/dns/sdlz.c","usr.sbin/bind/lib/dns/sdlz.c","detach",338,354
6,1,36,3,5,"beginload@357-362@usr.sbin/bind/lib/dns/sdlz.c","usr.sbin/bind/lib/dns/sdlz.c","beginload",357,362
5,1,27,2,4,"endload@365-369@usr.sbin/bind/lib/dns/sdlz.c","usr.sbin/bind/lib/dns/sdlz.c","endload",365,369
9,1,45,4,8,"dump@372-380@usr.sbin/bind/lib/dns/sdlz.c","usr.sbin/bind/lib/dns/sdlz.c","dump",372,380
6,2,41,2,7,"currentversion@383-390@usr.sbin/bind/lib/dns/sdlz.c","usr.sbin/bind/lib/dns/sdlz.c","currentversion",383,390
5,1,27,2,5,"newversion@393-398@usr.sbin/bind/lib/dns/sdlz.c","usr.sbin/bind/lib/dns/sdlz.c","newversion",393,398
9,2,52,3,9,"attachversion@401-410@usr.sbin/bind/lib/dns/sdlz.c","usr.sbin/bind/lib/dns/sdlz.c","attachversion",401,410
7,2,54,3,8,"closeversion@413-421@usr.sbin/bind/lib/dns/sdlz.c","usr.sbin/bind/lib/dns/sdlz.c","closeversion",413,421
26,3,180,2,28,"createnode@424-452@usr.sbin/bind/lib/dns/sdlz.c","usr.sbin/bind/lib/dns/sdlz.c","createnode",424,452
34,5,244,1,37,"destroynode@455-492@usr.sbin/bind/lib/dns/sdlz.c","usr.sbin/bind/lib/dns/sdlz.c","destroynode",455,492
74,14,517,4,94,"findnode@495-589@usr.sbin/bind/lib/dns/sdlz.c","usr.sbin/bind/lib/dns/sdlz.c","findnode",495,589
14,1,80,8,14,"findzonecut@592-606@usr.sbin/bind/lib/dns/sdlz.c","usr.sbin/bind/lib/dns/sdlz.c","findzonecut",592,606
12,1,93,3,15,"attachnode@609-624@usr.sbin/bind/lib/dns/sdlz.c","usr.sbin/bind/lib/dns/sdlz.c","attachnode",609,624
18,4,123,2,23,"detachnode@627-650@usr.sbin/bind/lib/dns/sdlz.c","usr.sbin/bind/lib/dns/sdlz.c","detachnode",627,650
7,1,40,3,6,"expirenode@653-659@usr.sbin/bind/lib/dns/sdlz.c","usr.sbin/bind/lib/dns/sdlz.c","expirenode",653,659
6,1,33,3,5,"printnode@662-667@usr.sbin/bind/lib/dns/sdlz.c","usr.sbin/bind/lib/dns/sdlz.c","printnode",662,667
45,6,330,3,55,"createiterator@670-725@usr.sbin/bind/lib/dns/sdlz.c","usr.sbin/bind/lib/dns/sdlz.c","createiterator",670,725
26,6,158,8,31,"findrdataset@728-759@usr.sbin/bind/lib/dns/sdlz.c","usr.sbin/bind/lib/dns/sdlz.c","findrdataset",728,759
108,30,611,10,156,"find@762-918@usr.sbin/bind/lib/dns/sdlz.c","usr.sbin/bind/lib/dns/sdlz.c","find",762,918
20,3,151,5,25,"allrdatasets@921-946@usr.sbin/bind/lib/dns/sdlz.c","usr.sbin/bind/lib/dns/sdlz.c","allrdatasets",921,946
13,1,71,7,13,"addrdataset@949-962@usr.sbin/bind/lib/dns/sdlz.c","usr.sbin/bind/lib/dns/sdlz.c","addrdataset",949,962
12,1,63,6,12,"subtractrdataset@965-977@usr.sbin/bind/lib/dns/sdlz.c","usr.sbin/bind/lib/dns/sdlz.c","subtractrdataset",965,977
10,1,52,5,10,"deleterdataset@980-990@usr.sbin/bind/lib/dns/sdlz.c","usr.sbin/bind/lib/dns/sdlz.c","deleterdataset",980,990
4,1,18,1,4,"issecure@993-997@usr.sbin/bind/lib/dns/sdlz.c","usr.sbin/bind/lib/dns/sdlz.c","issecure",993,997
4,1,18,1,4,"nodecount@1000-1004@usr.sbin/bind/lib/dns/sdlz.c","usr.sbin/bind/lib/dns/sdlz.c","nodecount",1000,1004
4,1,18,1,3,"ispersistent@1007-1010@usr.sbin/bind/lib/dns/sdlz.c","usr.sbin/bind/lib/dns/sdlz.c","ispersistent",1007,1010
4,1,21,2,3,"overmem@1013-1016@usr.sbin/bind/lib/dns/sdlz.c","usr.sbin/bind/lib/dns/sdlz.c","overmem",1013,1016
4,1,22,2,3,"settask@1019-1022@usr.sbin/bind/lib/dns/sdlz.c","usr.sbin/bind/lib/dns/sdlz.c","settask",1019,1022
13,2,107,1,15,"dbiterator_destroy@1062-1077@usr.sbin/bind/lib/dns/sdlz.c","usr.sbin/bind/lib/dns/sdlz.c","dbiterator_destroy",1062,1077
8,2,48,1,8,"dbiterator_first@1080-1088@usr.sbin/bind/lib/dns/sdlz.c","usr.sbin/bind/lib/dns/sdlz.c","dbiterator_first",1080,1088
8,2,48,1,8,"dbiterator_last@1091-1099@usr.sbin/bind/lib/dns/sdlz.c","usr.sbin/bind/lib/dns/sdlz.c","dbiterator_last",1091,1099
8,3,64,2,8,"dbiterator_seek@1102-1110@usr.sbin/bind/lib/dns/sdlz.c","usr.sbin/bind/lib/dns/sdlz.c","dbiterator_seek",1102,1110
8,2,50,1,8,"dbiterator_prev@1113-1121@usr.sbin/bind/lib/dns/sdlz.c","usr.sbin/bind/lib/dns/sdlz.c","dbiterator_prev",1113,1121
8,2,50,1,8,"dbiterator_next@1124-1132@usr.sbin/bind/lib/dns/sdlz.c","usr.sbin/bind/lib/dns/sdlz.c","dbiterator_next",1124,1132
9,2,66,3,9,"dbiterator_current@1135-1144@usr.sbin/bind/lib/dns/sdlz.c","usr.sbin/bind/lib/dns/sdlz.c","dbiterator_current",1135,1144
4,1,18,1,3,"dbiterator_pause@1147-1150@usr.sbin/bind/lib/dns/sdlz.c","usr.sbin/bind/lib/dns/sdlz.c","dbiterator_pause",1147,1150
4,1,29,2,3,"dbiterator_origin@1153-1156@usr.sbin/bind/lib/dns/sdlz.c","usr.sbin/bind/lib/dns/sdlz.c","dbiterator_origin",1153,1156
7,1,51,1,7,"disassociate@1164-1171@usr.sbin/bind/lib/dns/sdlz.c","usr.sbin/bind/lib/dns/sdlz.c","disassociate",1164,1171
9,1,71,2,9,"rdataset_clone@1174-1183@usr.sbin/bind/lib/dns/sdlz.c","usr.sbin/bind/lib/dns/sdlz.c","rdataset_clone",1174,1183
9,1,51,4,17,"list_tordataset@1200-1217@usr.sbin/bind/lib/dns/sdlz.c","usr.sbin/bind/lib/dns/sdlz.c","list_tordataset",1200,1217
38,5,282,6,58,"dns_sdlzcreateDBP@1231-1289@usr.sbin/bind/lib/dns/sdlz.c","usr.sbin/bind/lib/dns/sdlz.c","dns_sdlzcreateDBP",1231,1289
42,6,286,7,59,"dns_sdlzallowzonexfr@1292-1351@usr.sbin/bind/lib/dns/sdlz.c","usr.sbin/bind/lib/dns/sdlz.c","dns_sdlzallowzonexfr",1292,1351
30,3,174,6,41,"dns_sdlzcreate@1354-1395@usr.sbin/bind/lib/dns/sdlz.c","usr.sbin/bind/lib/dns/sdlz.c","dns_sdlzcreate",1354,1395
13,2,71,2,18,"dns_sdlzdestroy@1398-1416@usr.sbin/bind/lib/dns/sdlz.c","usr.sbin/bind/lib/dns/sdlz.c","dns_sdlzdestroy",1398,1416
25,4,183,6,41,"dns_sdlzfindzone@1419-1460@usr.sbin/bind/lib/dns/sdlz.c","usr.sbin/bind/lib/dns/sdlz.c","dns_sdlzfindzone",1419,1460
90,18,579,4,107,"dns_sdlz_putrr@1474-1581@usr.sbin/bind/lib/dns/sdlz.c","usr.sbin/bind/lib/dns/sdlz.c","dns_sdlz_putrr",1474,1581
50,11,386,5,56,"dns_sdlz_putnamedrr@1584-1640@usr.sbin/bind/lib/dns/sdlz.c","usr.sbin/bind/lib/dns/sdlz.c","dns_sdlz_putnamedrr",1584,1640
15,3,118,4,16,"dns_sdlz_putsoa@1643-1659@usr.sbin/bind/lib/dns/sdlz.c","usr.sbin/bind/lib/dns/sdlz.c","dns_sdlz_putsoa",1643,1659
48,5,306,6,89,"dns_sdlzregister@1662-1751@usr.sbin/bind/lib/dns/sdlz.c","usr.sbin/bind/lib/dns/sdlz.c","dns_sdlzregister",1662,1751
15,2,94,1,32,"dns_sdlzunregister@1754-1786@usr.sbin/bind/lib/dns/sdlz.c","usr.sbin/bind/lib/dns/sdlz.c","dns_sdlzunregister",1754,1786
6,1,52,1,5,"decode_uint32@30-35@usr.sbin/bind/lib/dns/soa.c","usr.sbin/bind/lib/dns/soa.c","decode_uint32",30,35
6,1,72,2,5,"encode_uint32@38-43@usr.sbin/bind/lib/dns/soa.c","usr.sbin/bind/lib/dns/soa.c","encode_uint32",38,43
6,2,58,2,15,"soa_get@46-61@usr.sbin/bind/lib/dns/soa.c","usr.sbin/bind/lib/dns/soa.c","soa_get",46,61
3,1,16,1,2,"dns_soa_getserial@64-66@usr.sbin/bind/lib/dns/soa.c","usr.sbin/bind/lib/dns/soa.c","dns_soa_getserial",64,66
3,1,16,1,2,"dns_soa_getrefresh@68-70@usr.sbin/bind/lib/dns/soa.c","usr.sbin/bind/lib/dns/soa.c","dns_soa_getrefresh",68,70
3,1,16,1,2,"dns_soa_getretry@72-74@usr.sbin/bind/lib/dns/soa.c","usr.sbin/bind/lib/dns/soa.c","dns_soa_getretry",72,74
3,1,16,1,2,"dns_soa_getexpire@76-78@usr.sbin/bind/lib/dns/soa.c","usr.sbin/bind/lib/dns/soa.c","dns_soa_getexpire",76,78
3,1,16,1,2,"dns_soa_getminimum@80-82@usr.sbin/bind/lib/dns/soa.c","usr.sbin/bind/lib/dns/soa.c","dns_soa_getminimum",80,82
6,2,60,3,5,"soa_set@85-90@usr.sbin/bind/lib/dns/soa.c","usr.sbin/bind/lib/dns/soa.c","soa_set",85,90
3,1,20,2,2,"dns_soa_setserial@93-95@usr.sbin/bind/lib/dns/soa.c","usr.sbin/bind/lib/dns/soa.c","dns_soa_setserial",93,95
3,1,20,2,2,"dns_soa_setrefresh@97-99@usr.sbin/bind/lib/dns/soa.c","usr.sbin/bind/lib/dns/soa.c","dns_soa_setrefresh",97,99
3,1,20,2,2,"dns_soa_setretry@101-103@usr.sbin/bind/lib/dns/soa.c","usr.sbin/bind/lib/dns/soa.c","dns_soa_setretry",101,103
3,1,20,2,2,"dns_soa_setexpire@105-107@usr.sbin/bind/lib/dns/soa.c","usr.sbin/bind/lib/dns/soa.c","dns_soa_setexpire",105,107
3,1,20,2,2,"dns_soa_setminimum@109-111@usr.sbin/bind/lib/dns/soa.c","usr.sbin/bind/lib/dns/soa.c","dns_soa_setminimum",109,111
20,4,131,2,21,"dns_ssutable_create@63-84@usr.sbin/bind/lib/dns/ssu.c","usr.sbin/bind/lib/dns/ssu.c","dns_ssutable_create",63,84
25,5,196,1,26,"destroy@87-113@usr.sbin/bind/lib/dns/ssu.c","usr.sbin/bind/lib/dns/ssu.c","destroy",87,113
10,2,76,2,13,"dns_ssutable_attach@116-129@usr.sbin/bind/lib/dns/ssu.c","usr.sbin/bind/lib/dns/ssu.c","dns_ssutable_attach",116,129
15,3,89,1,19,"dns_ssutable_detach@132-151@usr.sbin/bind/lib/dns/ssu.c","usr.sbin/bind/lib/dns/ssu.c","dns_ssutable_detach",132,151
74,15,502,7,85,"dns_ssutable_addrule@154-239@usr.sbin/bind/lib/dns/ssu.c","usr.sbin/bind/lib/dns/ssu.c","dns_ssutable_addrule",154,239
5,3,25,1,4,"isusertype@242-246@usr.sbin/bind/lib/dns/ssu.c","usr.sbin/bind/lib/dns/ssu.c","isusertype",242,246
65,26,422,4,69,"dns_ssutable_checkrules@249-318@usr.sbin/bind/lib/dns/ssu.c","usr.sbin/bind/lib/dns/ssu.c","dns_ssutable_checkrules",249,318
4,1,24,1,3,"dns_ssurule_isgrant@321-324@usr.sbin/bind/lib/dns/ssu.c","usr.sbin/bind/lib/dns/ssu.c","dns_ssurule_isgrant",321,324
4,1,24,1,3,"dns_ssurule_identity@327-330@usr.sbin/bind/lib/dns/ssu.c","usr.sbin/bind/lib/dns/ssu.c","dns_ssurule_identity",327,330
4,1,24,1,3,"dns_ssurule_matchtype@333-336@usr.sbin/bind/lib/dns/ssu.c","usr.sbin/bind/lib/dns/ssu.c","dns_ssurule_matchtype",333,336
4,1,24,1,3,"dns_ssurule_name@339-342@usr.sbin/bind/lib/dns/ssu.c","usr.sbin/bind/lib/dns/ssu.c","dns_ssurule_name",339,342
6,2,47,2,5,"dns_ssurule_types@345-350@usr.sbin/bind/lib/dns/ssu.c","usr.sbin/bind/lib/dns/ssu.c","dns_ssurule_types",345,350
6,3,55,2,5,"dns_ssutable_firstrule@353-358@usr.sbin/bind/lib/dns/ssu.c","usr.sbin/bind/lib/dns/ssu.c","dns_ssutable_firstrule",353,358
6,3,54,2,5,"dns_ssutable_nextrule@361-366@usr.sbin/bind/lib/dns/ssu.c","usr.sbin/bind/lib/dns/ssu.c","dns_ssutable_nextrule",361,366
11,3,72,2,10,"dns_stats_alloccounters@41-51@usr.sbin/bind/lib/dns/stats.c","usr.sbin/bind/lib/dns/stats.c","dns_stats_alloccounters",41,51
4,1,32,2,3,"dns_stats_freecounters@54-57@usr.sbin/bind/lib/dns/stats.c","usr.sbin/bind/lib/dns/stats.c","dns_stats_freecounters",54,57
44,6,275,2,54,"recv_length@47-101@usr.sbin/bind/lib/dns/tcpmsg.c","usr.sbin/bind/lib/dns/tcpmsg.c","recv_length",47,101
20,2,140,2,26,"recv_message@104-130@usr.sbin/bind/lib/dns/tcpmsg.c","usr.sbin/bind/lib/dns/tcpmsg.c","recv_message",104,130
14,1,95,3,17,"dns_tcpmsg_init@133-150@usr.sbin/bind/lib/dns/tcpmsg.c","usr.sbin/bind/lib/dns/tcpmsg.c","dns_tcpmsg_init",133,150
5,1,33,2,5,"dns_tcpmsg_setmaxsize@154-159@usr.sbin/bind/lib/dns/tcpmsg.c","usr.sbin/bind/lib/dns/tcpmsg.c","dns_tcpmsg_setmaxsize",154,159
29,3,208,4,35,"dns_tcpmsg_readmessage@163-198@usr.sbin/bind/lib/dns/tcpmsg.c","usr.sbin/bind/lib/dns/tcpmsg.c","dns_tcpmsg_readmessage",163,198
4,1,27,1,4,"dns_tcpmsg_cancelread@201-205@usr.sbin/bind/lib/dns/tcpmsg.c","usr.sbin/bind/lib/dns/tcpmsg.c","dns_tcpmsg_cancelread",201,205
7,1,50,2,7,"dns_tcpmsg_keepbuffer@208-215@usr.sbin/bind/lib/dns/tcpmsg.c","usr.sbin/bind/lib/dns/tcpmsg.c","dns_tcpmsg_keepbuffer",208,215
8,2,63,1,9,"dns_tcpmsg_freebuffer@219-228@usr.sbin/bind/lib/dns/tcpmsg.c","usr.sbin/bind/lib/dns/tcpmsg.c","dns_tcpmsg_freebuffer",219,228
10,2,69,1,11,"dns_tcpmsg_invalidate@232-243@usr.sbin/bind/lib/dns/tcpmsg.c","usr.sbin/bind/lib/dns/tcpmsg.c","dns_tcpmsg_invalidate",232,243
46,8,297,2,55,"dns_time64_totext@39-94@usr.sbin/bind/lib/dns/time.c","usr.sbin/bind/lib/dns/time.c","dns_time64_totext",39,94
15,2,78,2,21,"dns_time32_totext@97-118@usr.sbin/bind/lib/dns/time.c","usr.sbin/bind/lib/dns/time.c","dns_time32_totext",97,118
29,10,270,2,41,"dns_time64_fromtext@121-162@usr.sbin/bind/lib/dns/time.c","usr.sbin/bind/lib/dns/time.c","dns_time64_fromtext",121,162
9,2,53,2,9,"dns_time32_fromtext@165-174@usr.sbin/bind/lib/dns/time.c","usr.sbin/bind/lib/dns/time.c","dns_time32_fromtext",165,174
15,1,87,4,23,"dns_timer_setidle@37-60@usr.sbin/bind/lib/dns/timer.c","usr.sbin/bind/lib/dns/timer.c","dns_timer_setidle",37,60
7,1,44,2,7,"tkey_log@60-67@usr.sbin/bind/lib/dns/tkey.c","usr.sbin/bind/lib/dns/tkey.c","tkey_log",60,67
19,3,129,3,21,"dns_tkeyctx_create@70-91@usr.sbin/bind/lib/dns/tkey.c","usr.sbin/bind/lib/dns/tkey.c","dns_tkeyctx_create",70,91
18,5,128,1,20,"dns_tkeyctx_destroy@94-114@usr.sbin/bind/lib/dns/tkey.c","usr.sbin/bind/lib/dns/tkey.c","dns_tkeyctx_destroy",94,114
50,6,384,5,58,"add_rdata_to_list@117-175@usr.sbin/bind/lib/dns/tkey.c","usr.sbin/bind/lib/dns/tkey.c","add_rdata_to_list",117,175
14,3,97,2,14,"free_namelist@178-192@usr.sbin/bind/lib/dns/tkey.c","usr.sbin/bind/lib/dns/tkey.c","free_namelist",178,192
35,6,301,4,48,"compute_secret@195-243@usr.sbin/bind/lib/dns/tkey.c","usr.sbin/bind/lib/dns/tkey.c","compute_secret",195,243
131,20,851,8,157,"process_dhtkey@246-403@usr.sbin/bind/lib/dns/tkey.c","usr.sbin/bind/lib/dns/tkey.c","process_dhtkey",246,403
56,10,373,8,71,"process_gsstkey@406-477@usr.sbin/bind/lib/dns/tkey.c","usr.sbin/bind/lib/dns/tkey.c","process_gsstkey",406,477
25,4,141,7,40,"process_deletetkey@480-520@usr.sbin/bind/lib/dns/tkey.c","usr.sbin/bind/lib/dns/tkey.c","process_deletetkey",480,520
188,30,1196,3,236,"dns_tkey_processquery@523-759@usr.sbin/bind/lib/dns/tkey.c","usr.sbin/bind/lib/dns/tkey.c","dns_tkey_processquery",523,759
55,5,397,3,66,"buildquery@762-828@usr.sbin/bind/lib/dns/tkey.c","usr.sbin/bind/lib/dns/tkey.c","buildquery",762,828
61,4,427,6,70,"dns_tkey_builddhquery@831-901@usr.sbin/bind/lib/dns/tkey.c","usr.sbin/bind/lib/dns/tkey.c","dns_tkey_builddhquery",831,901
37,4,264,6,42,"dns_tkey_buildgssquery@904-946@usr.sbin/bind/lib/dns/tkey.c","usr.sbin/bind/lib/dns/tkey.c","dns_tkey_buildgssquery",904,946
17,1,143,2,19,"dns_tkey_builddeletequery@949-968@usr.sbin/bind/lib/dns/tkey.c","usr.sbin/bind/lib/dns/tkey.c","dns_tkey_builddeletequery",949,968
25,5,139,4,25,"find_tkey@971-996@usr.sbin/bind/lib/dns/tkey.c","usr.sbin/bind/lib/dns/tkey.c","find_tkey",971,996
110,17,753,6,128,"dns_tkey_processdhresponse@999-1127@usr.sbin/bind/lib/dns/tkey.c","usr.sbin/bind/lib/dns/tkey.c","dns_tkey_processdhresponse",999,1127
49,6,346,7,57,"dns_tkey_processgssresponse@1130-1187@usr.sbin/bind/lib/dns/tkey.c","usr.sbin/bind/lib/dns/tkey.c","dns_tkey_processgssresponse",1130,1187
38,7,254,3,53,"dns_tkey_processdeleteresponse@1190-1243@usr.sbin/bind/lib/dns/tkey.c","usr.sbin/bind/lib/dns/tkey.c","dns_tkey_processdeleteresponse",1190,1243
16,3,123,4,16,"tsig_log@182-198@usr.sbin/bind/lib/dns/tsig.c","usr.sbin/bind/lib/dns/tsig.c","tsig_log",182,198
161,47,1035,10,174,"dns_tsigkey_createfromkey@201-375@usr.sbin/bind/lib/dns/tsig.c","usr.sbin/bind/lib/dns/tsig.c","dns_tsigkey_createfromkey",201,375
98,23,581,11,106,"dns_tsigkey_create@378-484@usr.sbin/bind/lib/dns/tsig.c","usr.sbin/bind/lib/dns/tsig.c","dns_tsigkey_create",378,484
6,2,47,2,6,"dns_tsigkey_attach@487-493@usr.sbin/bind/lib/dns/tsig.c","usr.sbin/bind/lib/dns/tsig.c","dns_tsigkey_attach",487,493
17,4,147,1,17,"tsigkey_free@496-513@usr.sbin/bind/lib/dns/tsig.c","usr.sbin/bind/lib/dns/tsig.c","tsigkey_free",496,513
11,2,64,1,14,"dns_tsigkey_detach@516-530@usr.sbin/bind/lib/dns/tsig.c","usr.sbin/bind/lib/dns/tsig.c","dns_tsigkey_detach",516,530
7,1,68,1,7,"dns_tsigkey_setdeleted@533-540@usr.sbin/bind/lib/dns/tsig.c","usr.sbin/bind/lib/dns/tsig.c","dns_tsigkey_setdeleted",533,540
8,1,54,2,8,"buffer_putuint48@543-551@usr.sbin/bind/lib/dns/tsig.c","usr.sbin/bind/lib/dns/tsig.c","buffer_putuint48",543,551
220,42,1444,1,274,"dns_tsig_sign@554-828@usr.sbin/bind/lib/dns/tsig.c","usr.sbin/bind/lib/dns/tsig.c","dns_tsig_sign",554,828
228,63,1610,4,309,"dns_tsig_verify@831-1140@usr.sbin/bind/lib/dns/tsig.c","usr.sbin/bind/lib/dns/tsig.c","dns_tsig_verify",831,1140
155,28,1015,2,219,"tsig_verify_tcp@1143-1362@usr.sbin/bind/lib/dns/tsig.c","usr.sbin/bind/lib/dns/tsig.c","tsig_verify_tcp",1143,1362
34,7,258,4,39,"dns_tsigkey_find@1365-1404@usr.sbin/bind/lib/dns/tsig.c","usr.sbin/bind/lib/dns/tsig.c","dns_tsigkey_find",1365,1404
7,1,38,2,9,"free_tsignode@1407-1416@usr.sbin/bind/lib/dns/tsig.c","usr.sbin/bind/lib/dns/tsig.c","free_tsignode",1407,1416
25,4,174,2,30,"dns_tsigkeyring_create@1419-1449@usr.sbin/bind/lib/dns/tsig.c","usr.sbin/bind/lib/dns/tsig.c","dns_tsigkeyring_create",1419,1449
10,1,67,1,12,"dns_tsigkeyring_destroy@1452-1464@usr.sbin/bind/lib/dns/tsig.c","usr.sbin/bind/lib/dns/tsig.c","dns_tsigkeyring_destroy",1452,1464
21,6,166,5,23,"ttlfmt@52-75@usr.sbin/bind/lib/dns/ttl.c","usr.sbin/bind/lib/dns/ttl.c","ttlfmt",52,75
38,12,316,3,51,"dns_ttl_totext@81-132@usr.sbin/bind/lib/dns/ttl.c","usr.sbin/bind/lib/dns/ttl.c","dns_ttl_totext",81,132
3,1,22,2,2,"dns_counter_fromtext@135-137@usr.sbin/bind/lib/dns/ttl.c","usr.sbin/bind/lib/dns/ttl.c","dns_counter_fromtext",135,137
7,2,39,2,7,"dns_ttl_fromtext@140-147@usr.sbin/bind/lib/dns/ttl.c","usr.sbin/bind/lib/dns/ttl.c","dns_ttl_fromtext",140,147
58,17,289,2,65,"bind_ttl@150-215@usr.sbin/bind/lib/dns/ttl.c","usr.sbin/bind/lib/dns/ttl.c","bind_ttl",150,215
7,3,60,1,6,"markanswer@169-175@usr.sbin/bind/lib/dns/validator.c","usr.sbin/bind/lib/dns/validator.c","markanswer",169,175
12,2,92,2,17,"validator_done@178-195@usr.sbin/bind/lib/dns/validator.c","usr.sbin/bind/lib/dns/validator.c","validator_done",178,195
8,4,54,1,13,"exit_check@198-211@usr.sbin/bind/lib/dns/validator.c","usr.sbin/bind/lib/dns/validator.c","exit_check",198,211
27,5,147,3,30,"isdelegation@218-248@usr.sbin/bind/lib/dns/validator.c","usr.sbin/bind/lib/dns/validator.c","isdelegation",218,248
51,11,337,2,58,"fetch_callback_validator@256-314@usr.sbin/bind/lib/dns/validator.c","usr.sbin/bind/lib/dns/validator.c","fetch_callback_validator",256,314
58,13,368,2,62,"dsfetched@322-384@usr.sbin/bind/lib/dns/validator.c","usr.sbin/bind/lib/dns/validator.c","dsfetched",322,384
64,19,415,2,76,"dsfetched2@398-474@usr.sbin/bind/lib/dns/validator.c","usr.sbin/bind/lib/dns/validator.c","dsfetched2",398,474
37,6,249,2,44,"keyvalidated@482-526@usr.sbin/bind/lib/dns/validator.c","usr.sbin/bind/lib/dns/validator.c","keyvalidated",482,526
38,6,242,2,42,"dsvalidated@534-576@usr.sbin/bind/lib/dns/validator.c","usr.sbin/bind/lib/dns/validator.c","dsvalidated",534,576
118,28,740,7,149,"nsecnoexistnodata@586-735@usr.sbin/bind/lib/dns/validator.c","usr.sbin/bind/lib/dns/validator.c","nsecnoexistnodata",586,735
68,20,428,2,77,"authvalidated@745-822@usr.sbin/bind/lib/dns/validator.c","usr.sbin/bind/lib/dns/validator.c","authvalidated",745,822
95,28,650,3,115,"view_find@839-954@usr.sbin/bind/lib/dns/validator.c","usr.sbin/bind/lib/dns/validator.c","view_find",839,954
15,5,89,3,15,"check_deadlock@961-976@usr.sbin/bind/lib/dns/validator.c","usr.sbin/bind/lib/dns/validator.c","check_deadlock",961,976
18,4,137,5,19,"create_fetch@982-1001@usr.sbin/bind/lib/dns/validator.c","usr.sbin/bind/lib/dns/validator.c","create_fetch",982,1001
18,3,130,7,19,"create_validator@1007-1026@usr.sbin/bind/lib/dns/validator.c","usr.sbin/bind/lib/dns/validator.c","create_validator",1007,1026
51,12,289,3,58,"get_dst_key@1036-1094@usr.sbin/bind/lib/dns/validator.c","usr.sbin/bind/lib/dns/validator.c","get_dst_key",1036,1094
65,22,404,2,115,"get_key@1100-1215@usr.sbin/bind/lib/dns/validator.c","usr.sbin/bind/lib/dns/validator.c","get_key",1100,1215
5,1,36,2,5,"compute_keytag@1218-1223@usr.sbin/bind/lib/dns/validator.c","usr.sbin/bind/lib/dns/validator.c","compute_keytag",1218,1223
33,5,199,1,36,"isselfsigned@1229-1265@usr.sbin/bind/lib/dns/validator.c","usr.sbin/bind/lib/dns/validator.c","isselfsigned",1229,1265
33,9,196,4,33,"verify@1277-1310@usr.sbin/bind/lib/dns/validator.c","usr.sbin/bind/lib/dns/validator.c","verify",1277,1310
128,26,736,2,151,"validate@1322-1473@usr.sbin/bind/lib/dns/validator.c","usr.sbin/bind/lib/dns/validator.c","validate",1322,1473
132,25,791,1,160,"dlv_validatezonekey@1480-1640@usr.sbin/bind/lib/dns/validator.c","usr.sbin/bind/lib/dns/validator.c","dlv_validatezonekey",1480,1640
244,53,1424,1,317,"validatezonekey@1652-1969@usr.sbin/bind/lib/dns/validator.c","usr.sbin/bind/lib/dns/validator.c","validatezonekey",1652,1969
5,3,42,1,8,"start_positive_validation@1981-1989@usr.sbin/bind/lib/dns/validator.c","usr.sbin/bind/lib/dns/validator.c","start_positive_validation",1981,1989
63,23,387,1,69,"checkwildcard@2000-2069@usr.sbin/bind/lib/dns/validator.c","usr.sbin/bind/lib/dns/validator.c","checkwildcard",2000,2069
105,32,646,2,133,"nsecvalidate@2084-2217@usr.sbin/bind/lib/dns/validator.c","usr.sbin/bind/lib/dns/validator.c","nsecvalidate",2084,2217
20,4,125,3,21,"check_ds@2220-2241@usr.sbin/bind/lib/dns/validator.c","usr.sbin/bind/lib/dns/validator.c","check_ds",2220,2241
62,13,427,2,66,"dlvfetched@2249-2315@usr.sbin/bind/lib/dns/validator.c","usr.sbin/bind/lib/dns/validator.c","dlvfetched",2249,2315
31,4,217,2,35,"startfinddlvsep@2326-2361@usr.sbin/bind/lib/dns/validator.c","usr.sbin/bind/lib/dns/validator.c","startfinddlvsep",2326,2361
83,18,574,2,94,"finddlvsep@2373-2467@usr.sbin/bind/lib/dns/validator.c","usr.sbin/bind/lib/dns/validator.c","finddlvsep",2373,2467
171,42,996,2,217,"proveunsecure@2489-2706@usr.sbin/bind/lib/dns/validator.c","usr.sbin/bind/lib/dns/validator.c","proveunsecure",2489,2706
8,1,56,1,13,"dlv_validator_start@2712-2725@usr.sbin/bind/lib/dns/validator.c","usr.sbin/bind/lib/dns/validator.c","dlv_validator_start",2712,2725
67,16,451,2,92,"validator_start@2740-2832@usr.sbin/bind/lib/dns/validator.c","usr.sbin/bind/lib/dns/validator.c","validator_start",2740,2832
82,9,547,11,90,"dns_validator_create@2835-2925@usr.sbin/bind/lib/dns/validator.c","usr.sbin/bind/lib/dns/validator.c","dns_validator_create",2835,2925
10,1,78,1,12,"dns_validator_send@2928-2940@usr.sbin/bind/lib/dns/validator.c","usr.sbin/bind/lib/dns/validator.c","dns_validator_send",2928,2940
19,5,138,1,22,"dns_validator_cancel@2943-2965@usr.sbin/bind/lib/dns/validator.c","usr.sbin/bind/lib/dns/validator.c","dns_validator_cancel",2943,2965
27,9,225,1,28,"destroy@2968-2996@usr.sbin/bind/lib/dns/validator.c","usr.sbin/bind/lib/dns/validator.c","destroy",2968,2996
15,2,92,1,21,"dns_validator_destroy@2999-3020@usr.sbin/bind/lib/dns/validator.c","usr.sbin/bind/lib/dns/validator.c","dns_validator_destroy",2999,3020
24,4,194,6,27,"validator_logv@3023-3050@usr.sbin/bind/lib/dns/validator.c","usr.sbin/bind/lib/dns/validator.c","validator_logv",3023,3050
9,2,60,4,11,"validator_log@3053-3064@usr.sbin/bind/lib/dns/validator.c","usr.sbin/bind/lib/dns/validator.c","validator_log",3053,3064
11,1,81,5,11,"validator_logcreate@3067-3078@usr.sbin/bind/lib/dns/validator.c","usr.sbin/bind/lib/dns/validator.c","validator_logcreate",3067,3078
153,14,947,4,182,"dns_view_create@61-243@usr.sbin/bind/lib/dns/view.c","usr.sbin/bind/lib/dns/view.c","dns_view_create",61,243
88,26,700,1,90,"destroy@246-336@usr.sbin/bind/lib/dns/view.c","usr.sbin/bind/lib/dns/view.c","destroy",246,336
7,6,51,1,8,"all_done@343-351@usr.sbin/bind/lib/dns/view.c","usr.sbin/bind/lib/dns/view.c","all_done",343,351
6,2,47,2,8,"dns_view_attach@354-362@usr.sbin/bind/lib/dns/view.c","usr.sbin/bind/lib/dns/view.c","dns_view_attach",354,362
31,9,193,2,34,"view_flushanddetach@365-399@usr.sbin/bind/lib/dns/view.c","usr.sbin/bind/lib/dns/view.c","view_flushanddetach",365,399
3,1,15,1,2,"dns_view_flushanddetach@402-404@usr.sbin/bind/lib/dns/view.c","usr.sbin/bind/lib/dns/view.c","dns_view_flushanddetach",402,404
3,1,15,1,2,"dns_view_detach@407-409@usr.sbin/bind/lib/dns/view.c","usr.sbin/bind/lib/dns/view.c","dns_view_detach",407,409
5,1,27,2,4,"dialup@412-416@usr.sbin/bind/lib/dns/view.c","usr.sbin/bind/lib/dns/view.c","dialup",412,416
4,1,32,1,3,"dns_view_dialup@419-422@usr.sbin/bind/lib/dns/view.c","usr.sbin/bind/lib/dns/view.c","dns_view_dialup",419,422
8,2,58,2,10,"dns_view_weakattach@425-435@usr.sbin/bind/lib/dns/view.c","usr.sbin/bind/lib/dns/view.c","dns_view_weakattach",425,435
15,2,88,1,20,"dns_view_weakdetach@438-458@usr.sbin/bind/lib/dns/view.c","usr.sbin/bind/lib/dns/view.c","dns_view_weakdetach",438,458
15,2,98,2,21,"resolver_shutdown@461-482@usr.sbin/bind/lib/dns/view.c","usr.sbin/bind/lib/dns/view.c","resolver_shutdown",461,482
15,2,98,2,21,"adb_shutdown@485-506@usr.sbin/bind/lib/dns/view.c","usr.sbin/bind/lib/dns/view.c","adb_shutdown",485,506
15,2,98,2,21,"req_shutdown@509-530@usr.sbin/bind/lib/dns/view.c","usr.sbin/bind/lib/dns/view.c","req_shutdown",509,530
60,6,398,9,66,"dns_view_createresolver@533-599@usr.sbin/bind/lib/dns/view.c","usr.sbin/bind/lib/dns/view.c","dns_view_createresolver",533,599
15,4,122,2,16,"dns_view_setcache@602-618@usr.sbin/bind/lib/dns/view.c","usr.sbin/bind/lib/dns/view.c","dns_view_setcache",602,618
7,1,55,2,7,"dns_view_sethints@621-628@usr.sbin/bind/lib/dns/view.c","usr.sbin/bind/lib/dns/view.c","dns_view_sethints",621,628
7,2,49,2,6,"dns_view_setkeyring@631-637@usr.sbin/bind/lib/dns/view.c","usr.sbin/bind/lib/dns/view.c","dns_view_setkeyring",631,637
4,1,25,2,3,"dns_view_setdstport@640-643@usr.sbin/bind/lib/dns/view.c","usr.sbin/bind/lib/dns/view.c","dns_view_setdstport",640,643
7,1,47,2,9,"dns_view_addzone@646-655@usr.sbin/bind/lib/dns/view.c","usr.sbin/bind/lib/dns/view.c","dns_view_addzone",646,655
9,2,56,1,9,"dns_view_freeze@658-667@usr.sbin/bind/lib/dns/view.c","usr.sbin/bind/lib/dns/view.c","dns_view_freeze",658,667
10,2,66,3,12,"dns_view_findzone@670-682@usr.sbin/bind/lib/dns/view.c","usr.sbin/bind/lib/dns/view.c","dns_view_findzone",670,682
150,53,934,11,205,"dns_view_find@685-890@usr.sbin/bind/lib/dns/view.c","usr.sbin/bind/lib/dns/view.c","dns_view_find",685,890
34,16,186,8,41,"dns_view_simplefind@893-934@usr.sbin/bind/lib/dns/view.c","usr.sbin/bind/lib/dns/view.c","dns_view_simplefind",893,934
9,1,58,8,8,"dns_view_findzonecut@937-945@usr.sbin/bind/lib/dns/view.c","usr.sbin/bind/lib/dns/view.c","dns_view_findzonecut",937,945
116,37,678,9,170,"dns_view_findzonecut2@948-1118@usr.sbin/bind/lib/dns/view.c","usr.sbin/bind/lib/dns/view.c","dns_view_findzonecut2",948,1118
16,5,100,4,19,"dns_viewlist_find@1121-1140@usr.sbin/bind/lib/dns/view.c","usr.sbin/bind/lib/dns/view.c","dns_viewlist_find",1121,1140
4,1,31,2,5,"dns_view_load@1143-1148@usr.sbin/bind/lib/dns/view.c","usr.sbin/bind/lib/dns/view.c","dns_view_load",1143,1148
4,1,31,2,5,"dns_view_loadnew@1151-1156@usr.sbin/bind/lib/dns/view.c","usr.sbin/bind/lib/dns/view.c","dns_view_loadnew",1151,1156
11,3,72,3,11,"dns_view_gettsig@1159-1170@usr.sbin/bind/lib/dns/view.c","usr.sbin/bind/lib/dns/view.c","dns_view_gettsig",1159,1170
14,3,89,3,16,"dns_view_getpeertsig@1173-1189@usr.sbin/bind/lib/dns/view.c","usr.sbin/bind/lib/dns/view.c","dns_view_getpeertsig",1173,1189
6,1,49,3,6,"dns_view_checksig@1192-1198@usr.sbin/bind/lib/dns/view.c","usr.sbin/bind/lib/dns/view.c","dns_view_checksig",1192,1198
11,2,82,2,12,"dns_view_dumpdbtostream@1201-1213@usr.sbin/bind/lib/dns/view.c","usr.sbin/bind/lib/dns/view.c","dns_view_dumpdbtostream",1201,1213
17,5,122,1,19,"dns_view_flushcache@1216-1235@usr.sbin/bind/lib/dns/view.c","usr.sbin/bind/lib/dns/view.c","dns_view_flushcache",1216,1235
8,3,62,2,9,"dns_view_flushname@1238-1247@usr.sbin/bind/lib/dns/view.c","usr.sbin/bind/lib/dns/view.c","dns_view_flushname",1238,1247
31,9,238,2,32,"dns_view_adddelegationonly@1250-1282@usr.sbin/bind/lib/dns/view.c","usr.sbin/bind/lib/dns/view.c","dns_view_adddelegationonly",1250,1282
31,9,238,2,32,"dns_view_excludedelegationonly@1285-1317@usr.sbin/bind/lib/dns/view.c","usr.sbin/bind/lib/dns/view.c","dns_view_excludedelegationonly",1285,1317
25,13,194,2,29,"dns_view_isdelegationonly@1320-1349@usr.sbin/bind/lib/dns/view.c","usr.sbin/bind/lib/dns/view.c","dns_view_isdelegationonly",1320,1349
4,1,25,2,3,"dns_view_setrootdelonly@1352-1355@usr.sbin/bind/lib/dns/view.c","usr.sbin/bind/lib/dns/view.c","dns_view_setrootdelonly",1352,1355
4,1,23,1,3,"dns_view_getrootdelonly@1358-1361@usr.sbin/bind/lib/dns/view.c","usr.sbin/bind/lib/dns/view.c","dns_view_getrootdelonly",1358,1361
4,1,31,2,3,"dns_view_freezezones@1364-1367@usr.sbin/bind/lib/dns/view.c","usr.sbin/bind/lib/dns/view.c","dns_view_freezezones",1364,1367
12,2,81,1,14,"axfr_init@248-262@usr.sbin/bind/lib/dns/xfrin.c","usr.sbin/bind/lib/dns/xfrin.c","axfr_init",248,262
9,1,41,2,8,"axfr_makedb@265-273@usr.sbin/bind/lib/dns/xfrin.c","usr.sbin/bind/lib/dns/xfrin.c","axfr_makedb",265,273
15,2,107,5,16,"axfr_putdata@276-292@usr.sbin/bind/lib/dns/xfrin.c","usr.sbin/bind/lib/dns/xfrin.c","axfr_putdata",276,292
10,1,59,1,10,"axfr_apply@298-308@usr.sbin/bind/lib/dns/xfrin.c","usr.sbin/bind/lib/dns/xfrin.c","axfr_apply",298,308
9,1,63,1,10,"axfr_commit@311-321@usr.sbin/bind/lib/dns/xfrin.c","usr.sbin/bind/lib/dns/xfrin.c","axfr_commit",311,321
19,3,107,1,22,"ixfr_init@329-351@usr.sbin/bind/lib/dns/xfrin.c","usr.sbin/bind/lib/dns/xfrin.c","ixfr_init",329,351
16,3,113,5,16,"ixfr_putdata@354-370@usr.sbin/bind/lib/dns/xfrin.c","usr.sbin/bind/lib/dns/xfrin.c","ixfr_putdata",354,370
19,5,139,1,19,"ixfr_apply@376-395@usr.sbin/bind/lib/dns/xfrin.c","usr.sbin/bind/lib/dns/xfrin.c","ixfr_apply",376,395
13,3,83,1,14,"ixfr_commit@398-412@usr.sbin/bind/lib/dns/xfrin.c","usr.sbin/bind/lib/dns/xfrin.c","ixfr_commit",398,412
126,32,707,4,153,"xfr_rr@424-577@usr.sbin/bind/lib/dns/xfrin.c","usr.sbin/bind/lib/dns/xfrin.c","xfr_rr",424,577
21,3,116,10,22,"dns_xfrin_create@580-602@usr.sbin/bind/lib/dns/xfrin.c","usr.sbin/bind/lib/dns/xfrin.c","dns_xfrin_create",580,602
32,6,228,11,38,"dns_xfrin_create2@605-643@usr.sbin/bind/lib/dns/xfrin.c","usr.sbin/bind/lib/dns/xfrin.c","dns_xfrin_create2",605,643
4,2,24,1,3,"dns_xfrin_shutdown@646-649@usr.sbin/bind/lib/dns/xfrin.c","usr.sbin/bind/lib/dns/xfrin.c","dns_xfrin_shutdown",646,649
5,2,34,2,4,"dns_xfrin_attach@652-656@usr.sbin/bind/lib/dns/xfrin.c","usr.sbin/bind/lib/dns/xfrin.c","dns_xfrin_attach",652,656
7,1,39,1,6,"dns_xfrin_detach@659-665@usr.sbin/bind/lib/dns/xfrin.c","usr.sbin/bind/lib/dns/xfrin.c","dns_xfrin_detach",659,665
11,4,74,1,10,"xfrin_cancelio@668-678@usr.sbin/bind/lib/dns/xfrin.c","usr.sbin/bind/lib/dns/xfrin.c","xfrin_cancelio",668,678
23,7,177,1,31,"xfrin_reset@681-712@usr.sbin/bind/lib/dns/xfrin.c","usr.sbin/bind/lib/dns/xfrin.c","xfrin_reset",681,712
17,5,115,3,20,"xfrin_fail@716-736@usr.sbin/bind/lib/dns/xfrin.c","usr.sbin/bind/lib/dns/xfrin.c","xfrin_fail",716,736
92,9,620,13,116,"xfrin_create@739-855@usr.sbin/bind/lib/dns/xfrin.c","usr.sbin/bind/lib/dns/xfrin.c","xfrin_create",739,855
16,1,102,1,17,"xfrin_start@858-875@usr.sbin/bind/lib/dns/xfrin.c","usr.sbin/bind/lib/dns/xfrin.c","xfrin_start",858,875
18,2,135,3,18,"render@880-898@usr.sbin/bind/lib/dns/xfrin.c","usr.sbin/bind/lib/dns/xfrin.c","render",880,898
30,4,210,2,36,"xfrin_connect_done@904-940@usr.sbin/bind/lib/dns/xfrin.c","usr.sbin/bind/lib/dns/xfrin.c","xfrin_connect_done",904,940
39,5,280,3,47,"tuple2msgname@947-994@usr.sbin/bind/lib/dns/xfrin.c","usr.sbin/bind/lib/dns/xfrin.c","tuple2msgname",947,994
67,9,540,1,90,"xfrin_send_request@1001-1091@usr.sbin/bind/lib/dns/xfrin.c","usr.sbin/bind/lib/dns/xfrin.c","xfrin_send_request",1001,1091
25,3,166,2,30,"xfrin_sendlen_done@1096-1126@usr.sbin/bind/lib/dns/xfrin.c","usr.sbin/bind/lib/dns/xfrin.c","xfrin_sendlen_done",1096,1126
18,2,130,2,22,"xfrin_send_done@1130-1152@usr.sbin/bind/lib/dns/xfrin.c","usr.sbin/bind/lib/dns/xfrin.c","xfrin_send_done",1130,1152
131,34,855,2,190,"xfrin_recv_done@1156-1346@usr.sbin/bind/lib/dns/xfrin.c","usr.sbin/bind/lib/dns/xfrin.c","xfrin_recv_done",1156,1346
7,1,52,2,12,"xfrin_timeout@1349-1361@usr.sbin/bind/lib/dns/xfrin.c","usr.sbin/bind/lib/dns/xfrin.c","xfrin_timeout",1349,1361
34,18,302,1,49,"maybe_free@1364-1413@usr.sbin/bind/lib/dns/xfrin.c","usr.sbin/bind/lib/dns/xfrin.c","maybe_free",1364,1413
12,1,81,5,13,"xfrin_logv@1420-1433@usr.sbin/bind/lib/dns/xfrin.c","usr.sbin/bind/lib/dns/xfrin.c","xfrin_logv",1420,1433
10,2,64,5,11,"xfrin_log1@1440-1451@usr.sbin/bind/lib/dns/xfrin.c","usr.sbin/bind/lib/dns/xfrin.c","xfrin_log1",1440,1451
11,2,84,4,13,"xfrin_log@1458-1471@usr.sbin/bind/lib/dns/xfrin.c","usr.sbin/bind/lib/dns/xfrin.c","xfrin_log",1458,1471
121,8,788,2,137,"dns_zone_create@526-663@usr.sbin/bind/lib/dns/zone.c","usr.sbin/bind/lib/dns/zone.c","dns_zone_create",526,663
60,17,481,1,69,"zone_free@670-739@usr.sbin/bind/lib/dns/zone.c","usr.sbin/bind/lib/dns/zone.c","zone_free",670,739
9,2,57,2,13,"dns_zone_setclass@745-758@usr.sbin/bind/lib/dns/zone.c","usr.sbin/bind/lib/dns/zone.c","dns_zone_setclass",745,758
4,1,23,1,4,"dns_zone_getclass@761-765@usr.sbin/bind/lib/dns/zone.c","usr.sbin/bind/lib/dns/zone.c","dns_zone_getclass",761,765
6,1,35,2,6,"dns_zone_setnotifytype@768-774@usr.sbin/bind/lib/dns/zone.c","usr.sbin/bind/lib/dns/zone.c","dns_zone_setnotifytype",768,774
8,2,57,2,12,"dns_zone_settype@780-792@usr.sbin/bind/lib/dns/zone.c","usr.sbin/bind/lib/dns/zone.c","dns_zone_settype",780,792
11,3,86,1,12,"zone_freedbargs@795-807@usr.sbin/bind/lib/dns/zone.c","usr.sbin/bind/lib/dns/zone.c","zone_freedbargs",795,807
32,5,254,3,33,"dns_zone_getdbtype@810-843@usr.sbin/bind/lib/dns/zone.c","usr.sbin/bind/lib/dns/zone.c","dns_zone_getdbtype",810,843
36,8,252,3,44,"dns_zone_setdbtype@846-890@usr.sbin/bind/lib/dns/zone.c","usr.sbin/bind/lib/dns/zone.c","dns_zone_setdbtype",846,890
8,2,56,2,8,"dns_zone_setview@893-901@usr.sbin/bind/lib/dns/zone.c","usr.sbin/bind/lib/dns/zone.c","dns_zone_setview",893,901
4,1,23,1,4,"dns_zone_getview@905-909@usr.sbin/bind/lib/dns/zone.c","usr.sbin/bind/lib/dns/zone.c","dns_zone_getview",905,909
13,2,96,2,14,"dns_zone_setorigin@913-927@usr.sbin/bind/lib/dns/zone.c","usr.sbin/bind/lib/dns/zone.c","dns_zone_setorigin",913,927
20,5,133,2,27,"dns_zone_setacache@930-957@usr.sbin/bind/lib/dns/zone.c","usr.sbin/bind/lib/dns/zone.c","dns_zone_setacache",930,957
14,4,85,3,16,"dns_zone_setstring@960-976@usr.sbin/bind/lib/dns/zone.c","usr.sbin/bind/lib/dns/zone.c","dns_zone_setstring",960,976
3,1,25,2,2,"dns_zone_setfile@979-981@usr.sbin/bind/lib/dns/zone.c","usr.sbin/bind/lib/dns/zone.c","dns_zone_setfile",979,981
13,2,79,3,15,"dns_zone_setfile2@984-999@usr.sbin/bind/lib/dns/zone.c","usr.sbin/bind/lib/dns/zone.c","dns_zone_setfile2",984,999
4,1,23,1,4,"dns_zone_getfile@1002-1006@usr.sbin/bind/lib/dns/zone.c","usr.sbin/bind/lib/dns/zone.c","dns_zone_getfile",1002,1006
20,4,139,1,22,"default_journal@1009-1031@usr.sbin/bind/lib/dns/zone.c","usr.sbin/bind/lib/dns/zone.c","default_journal",1009,1031
8,1,55,2,10,"dns_zone_setjournal@1034-1044@usr.sbin/bind/lib/dns/zone.c","usr.sbin/bind/lib/dns/zone.c","dns_zone_setjournal",1034,1044
4,1,23,1,4,"dns_zone_getjournal@1047-1051@usr.sbin/bind/lib/dns/zone.c","usr.sbin/bind/lib/dns/zone.c","dns_zone_getjournal",1047,1051
12,9,97,1,12,"zone_isdynamic@1063-1075@usr.sbin/bind/lib/dns/zone.c","usr.sbin/bind/lib/dns/zone.c","zone_isdynamic",1063,1075
108,32,641,2,158,"zone_load@1079-1237@usr.sbin/bind/lib/dns/zone.c","usr.sbin/bind/lib/dns/zone.c","zone_load",1079,1237
3,1,18,1,2,"dns_zone_load@1240-1242@usr.sbin/bind/lib/dns/zone.c","usr.sbin/bind/lib/dns/zone.c","dns_zone_load",1240,1242
3,1,18,1,2,"dns_zone_loadnew@1245-1247@usr.sbin/bind/lib/dns/zone.c","usr.sbin/bind/lib/dns/zone.c","dns_zone_loadnew",1245,1247
43,14,282,2,46,"zone_gotreadhandle@1250-1296@usr.sbin/bind/lib/dns/zone.c","usr.sbin/bind/lib/dns/zone.c","zone_gotreadhandle",1250,1296
29,4,200,2,32,"zone_gotwritehandle@1299-1331@usr.sbin/bind/lib/dns/zone.c","usr.sbin/bind/lib/dns/zone.c","zone_gotwritehandle",1299,1331
74,18,509,3,84,"zone_startload@1334-1418@usr.sbin/bind/lib/dns/zone.c","usr.sbin/bind/lib/dns/zone.c","zone_startload",1334,1418
66,22,436,4,79,"zone_check_mx@1421-1500@usr.sbin/bind/lib/dns/zone.c","usr.sbin/bind/lib/dns/zone.c","zone_check_mx",1421,1500
68,23,450,4,85,"zone_check_srv@1503-1588@usr.sbin/bind/lib/dns/zone.c","usr.sbin/bind/lib/dns/zone.c","zone_check_srv",1503,1588
92,30,593,4,115,"zone_check_glue@1591-1706@usr.sbin/bind/lib/dns/zone.c","usr.sbin/bind/lib/dns/zone.c","zone_check_glue",1591,1706
94,19,626,2,114,"integrity_checks@1709-1823@usr.sbin/bind/lib/dns/zone.c","usr.sbin/bind/lib/dns/zone.c","integrity_checks",1709,1823
56,15,331,2,61,"zone_check_dnskeys@1831-1892@usr.sbin/bind/lib/dns/zone.c","usr.sbin/bind/lib/dns/zone.c","zone_check_dnskeys",1831,1892
207,55,1199,4,255,"zone_postload@1895-2150@usr.sbin/bind/lib/dns/zone.c","usr.sbin/bind/lib/dns/zone.c","zone_postload",1895,2150
10,3,56,1,14,"exit_check@2153-2167@usr.sbin/bind/lib/dns/zone.c","usr.sbin/bind/lib/dns/zone.c","exit_check",2153,2167
47,11,273,3,58,"zone_check_ns@2170-2228@usr.sbin/bind/lib/dns/zone.c","usr.sbin/bind/lib/dns/zone.c","zone_check_ns",2170,2228
44,12,268,6,49,"zone_count_ns_rr@2231-2280@usr.sbin/bind/lib/dns/zone.c","usr.sbin/bind/lib/dns/zone.c","zone_count_ns_rr",2231,2280
65,18,364,9,72,"zone_load_soa_rr@2283-2355@usr.sbin/bind/lib/dns/zone.c","usr.sbin/bind/lib/dns/zone.c","zone_load_soa_rr",2283,2355
39,12,250,10,45,"zone_get_from_db@2361-2406@usr.sbin/bind/lib/dns/zone.c","usr.sbin/bind/lib/dns/zone.c","zone_get_from_db",2361,2406
6,2,47,2,5,"dns_zone_attach@2409-2414@usr.sbin/bind/lib/dns/zone.c","usr.sbin/bind/lib/dns/zone.c","dns_zone_attach",2409,2414
22,5,127,1,45,"dns_zone_detach@2417-2462@usr.sbin/bind/lib/dns/zone.c","usr.sbin/bind/lib/dns/zone.c","dns_zone_detach",2417,2462
7,2,49,2,6,"dns_zone_iattach@2465-2471@usr.sbin/bind/lib/dns/zone.c","usr.sbin/bind/lib/dns/zone.c","dns_zone_iattach",2465,2471
9,2,76,2,12,"zone_iattach@2474-2486@usr.sbin/bind/lib/dns/zone.c","usr.sbin/bind/lib/dns/zone.c","zone_iattach",2474,2486
10,2,75,1,14,"zone_idetach@2489-2503@usr.sbin/bind/lib/dns/zone.c","usr.sbin/bind/lib/dns/zone.c","zone_idetach",2489,2503
14,3,78,1,15,"dns_zone_idetach@2506-2521@usr.sbin/bind/lib/dns/zone.c","usr.sbin/bind/lib/dns/zone.c","dns_zone_idetach",2506,2521
4,1,23,1,4,"dns_zone_getmctx@2524-2528@usr.sbin/bind/lib/dns/zone.c","usr.sbin/bind/lib/dns/zone.c","dns_zone_getmctx",2524,2528
4,1,23,1,4,"dns_zone_getmgr@2531-2535@usr.sbin/bind/lib/dns/zone.c","usr.sbin/bind/lib/dns/zone.c","dns_zone_getmgr",2531,2535
9,2,52,3,9,"dns_zone_setflag@2538-2547@usr.sbin/bind/lib/dns/zone.c","usr.sbin/bind/lib/dns/zone.c","dns_zone_setflag",2538,2547
10,2,50,3,10,"dns_zone_setoption@2550-2560@usr.sbin/bind/lib/dns/zone.c","usr.sbin/bind/lib/dns/zone.c","dns_zone_setoption",2550,2560
4,1,23,1,5,"dns_zone_getoptions@2563-2568@usr.sbin/bind/lib/dns/zone.c","usr.sbin/bind/lib/dns/zone.c","dns_zone_getoptions",2563,2568
7,1,43,2,8,"dns_zone_setxfrsource4@2571-2579@usr.sbin/bind/lib/dns/zone.c","usr.sbin/bind/lib/dns/zone.c","dns_zone_setxfrsource4",2571,2579
4,1,24,1,3,"dns_zone_getxfrsource4@2582-2585@usr.sbin/bind/lib/dns/zone.c","usr.sbin/bind/lib/dns/zone.c","dns_zone_getxfrsource4",2582,2585
7,1,43,2,8,"dns_zone_setxfrsource6@2588-2596@usr.sbin/bind/lib/dns/zone.c","usr.sbin/bind/lib/dns/zone.c","dns_zone_setxfrsource6",2588,2596
4,1,24,1,3,"dns_zone_getxfrsource6@2599-2602@usr.sbin/bind/lib/dns/zone.c","usr.sbin/bind/lib/dns/zone.c","dns_zone_getxfrsource6",2599,2602
9,1,43,2,10,"dns_zone_setaltxfrsource4@2605-2615@usr.sbin/bind/lib/dns/zone.c","usr.sbin/bind/lib/dns/zone.c","dns_zone_setaltxfrsource4",2605,2615
4,1,24,1,3,"dns_zone_getaltxfrsource4@2618-2621@usr.sbin/bind/lib/dns/zone.c","usr.sbin/bind/lib/dns/zone.c","dns_zone_getaltxfrsource4",2618,2621
9,1,43,2,10,"dns_zone_setaltxfrsource6@2624-2634@usr.sbin/bind/lib/dns/zone.c","usr.sbin/bind/lib/dns/zone.c","dns_zone_setaltxfrsource6",2624,2634
4,1,24,1,3,"dns_zone_getaltxfrsource6@2637-2640@usr.sbin/bind/lib/dns/zone.c","usr.sbin/bind/lib/dns/zone.c","dns_zone_getaltxfrsource6",2637,2640
7,1,43,2,8,"dns_zone_setnotifysrc4@2643-2651@usr.sbin/bind/lib/dns/zone.c","usr.sbin/bind/lib/dns/zone.c","dns_zone_setnotifysrc4",2643,2651
4,1,24,1,3,"dns_zone_getnotifysrc4@2654-2657@usr.sbin/bind/lib/dns/zone.c","usr.sbin/bind/lib/dns/zone.c","dns_zone_getnotifysrc4",2654,2657
7,1,43,2,8,"dns_zone_setnotifysrc6@2660-2668@usr.sbin/bind/lib/dns/zone.c","usr.sbin/bind/lib/dns/zone.c","dns_zone_setnotifysrc6",2660,2668
4,1,24,1,3,"dns_zone_getnotifysrc6@2671-2674@usr.sbin/bind/lib/dns/zone.c","usr.sbin/bind/lib/dns/zone.c","dns_zone_getnotifysrc6",2671,2674
26,5,167,3,27,"dns_zone_setalsonotify@2677-2704@usr.sbin/bind/lib/dns/zone.c","usr.sbin/bind/lib/dns/zone.c","dns_zone_setalsonotify",2677,2704
7,1,37,3,7,"dns_zone_setmasters@2707-2714@usr.sbin/bind/lib/dns/zone.c","usr.sbin/bind/lib/dns/zone.c","dns_zone_setmasters",2707,2714
9,3,62,3,9,"same_masters@2717-2726@usr.sbin/bind/lib/dns/zone.c","usr.sbin/bind/lib/dns/zone.c","same_masters",2717,2726
15,11,122,3,16,"same_keynames@2729-2745@usr.sbin/bind/lib/dns/zone.c","usr.sbin/bind/lib/dns/zone.c","same_keynames",2729,2745
112,25,770,4,140,"dns_zone_setmasterswithkeys@2748-2888@usr.sbin/bind/lib/dns/zone.c","usr.sbin/bind/lib/dns/zone.c","dns_zone_setmasterswithkeys",2748,2888
11,2,72,2,13,"dns_zone_getdb@2891-2904@usr.sbin/bind/lib/dns/zone.c","usr.sbin/bind/lib/dns/zone.c","dns_zone_getdb",2891,2904
10,1,53,1,11,"dns_zone_maintenance@2911-2922@usr.sbin/bind/lib/dns/zone.c","usr.sbin/bind/lib/dns/zone.c","dns_zone_maintenance",2911,2922
11,2,62,1,12,"was_dumping@2925-2937@usr.sbin/bind/lib/dns/zone.c","usr.sbin/bind/lib/dns/zone.c","was_dumping",2925,2937
69,23,345,1,94,"zone_maintenance@2940-3034@usr.sbin/bind/lib/dns/zone.c","usr.sbin/bind/lib/dns/zone.c","zone_maintenance",2940,3034
5,1,25,1,5,"dns_zone_markdirty@3037-3042@usr.sbin/bind/lib/dns/zone.c","usr.sbin/bind/lib/dns/zone.c","dns_zone_markdirty",3037,3042
6,1,31,1,6,"dns_zone_expire@3045-3051@usr.sbin/bind/lib/dns/zone.c","usr.sbin/bind/lib/dns/zone.c","dns_zone_expire",3045,3051
9,1,56,1,14,"zone_expire@3054-3068@usr.sbin/bind/lib/dns/zone.c","usr.sbin/bind/lib/dns/zone.c","zone_expire",3054,3068
38,8,251,1,59,"dns_zone_refresh@3071-3130@usr.sbin/bind/lib/dns/zone.c","usr.sbin/bind/lib/dns/zone.c","dns_zone_refresh",3071,3130
17,4,93,1,18,"dns_zone_flush@3133-3151@usr.sbin/bind/lib/dns/zone.c","usr.sbin/bind/lib/dns/zone.c","dns_zone_flush",3133,3151
11,2,60,1,12,"dns_zone_dump@3154-3166@usr.sbin/bind/lib/dns/zone.c","usr.sbin/bind/lib/dns/zone.c","dns_zone_dump",3154,3166
17,6,122,2,28,"zone_needdump@3169-3197@usr.sbin/bind/lib/dns/zone.c","usr.sbin/bind/lib/dns/zone.c","zone_needdump",3169,3197
64,20,375,2,80,"dump_done@3200-3280@usr.sbin/bind/lib/dns/zone.c","usr.sbin/bind/lib/dns/zone.c","dump_done",3200,3280
75,15,431,2,87,"zone_dump@3283-3370@usr.sbin/bind/lib/dns/zone.c","usr.sbin/bind/lib/dns/zone.c","zone_dump",3283,3370
20,3,140,4,22,"dumptostream@3373-3395@usr.sbin/bind/lib/dns/zone.c","usr.sbin/bind/lib/dns/zone.c","dumptostream",3373,3395
4,1,32,4,3,"dns_zone_dumptostream2@3398-3401@usr.sbin/bind/lib/dns/zone.c","usr.sbin/bind/lib/dns/zone.c","dns_zone_dumptostream2",3398,3401
4,1,25,2,3,"dns_zone_dumptostream@3404-3407@usr.sbin/bind/lib/dns/zone.c","usr.sbin/bind/lib/dns/zone.c","dns_zone_dumptostream",3404,3407
4,1,25,2,3,"dns_zone_fulldumptostream@3410-3413@usr.sbin/bind/lib/dns/zone.c","usr.sbin/bind/lib/dns/zone.c","dns_zone_fulldumptostream",3410,3413
6,1,31,1,6,"dns_zone_unload@3416-3422@usr.sbin/bind/lib/dns/zone.c","usr.sbin/bind/lib/dns/zone.c","dns_zone_unload",3416,3422
12,4,76,1,17,"notify_cancel@3425-3442@usr.sbin/bind/lib/dns/zone.c","usr.sbin/bind/lib/dns/zone.c","notify_cancel",3425,3442
8,1,55,1,13,"zone_unload@3445-3458@usr.sbin/bind/lib/dns/zone.c","usr.sbin/bind/lib/dns/zone.c","zone_unload",3445,3458
5,1,32,2,5,"dns_zone_setminrefreshtime@3461-3466@usr.sbin/bind/lib/dns/zone.c","usr.sbin/bind/lib/dns/zone.c","dns_zone_setminrefreshtime",3461,3466
5,1,32,2,5,"dns_zone_setmaxrefreshtime@3469-3474@usr.sbin/bind/lib/dns/zone.c","usr.sbin/bind/lib/dns/zone.c","dns_zone_setmaxrefreshtime",3469,3474
5,1,32,2,5,"dns_zone_setminretrytime@3477-3482@usr.sbin/bind/lib/dns/zone.c","usr.sbin/bind/lib/dns/zone.c","dns_zone_setminretrytime",3477,3482
5,1,32,2,5,"dns_zone_setmaxretrytime@3485-3490@usr.sbin/bind/lib/dns/zone.c","usr.sbin/bind/lib/dns/zone.c","dns_zone_setmaxretrytime",3485,3490
15,8,111,3,15,"notify_isqueued@3493-3508@usr.sbin/bind/lib/dns/zone.c","usr.sbin/bind/lib/dns/zone.c","notify_isqueued",3493,3508
30,7,184,2,37,"notify_isself@3511-3548@usr.sbin/bind/lib/dns/zone.c","usr.sbin/bind/lib/dns/zone.c","notify_isself",3511,3548
26,9,191,2,30,"notify_destroy@3551-3581@usr.sbin/bind/lib/dns/zone.c","usr.sbin/bind/lib/dns/zone.c","notify_destroy",3551,3581
19,3,137,3,21,"notify_create@3584-3605@usr.sbin/bind/lib/dns/zone.c","usr.sbin/bind/lib/dns/zone.c","notify_create",3584,3605
21,3,118,2,22,"process_adb_event@3611-3633@usr.sbin/bind/lib/dns/zone.c","usr.sbin/bind/lib/dns/zone.c","process_adb_event",3611,3633
25,4,152,1,34,"notify_find_address@3636-3670@usr.sbin/bind/lib/dns/zone.c","usr.sbin/bind/lib/dns/zone.c","notify_find_address",3636,3670
17,3,99,1,17,"notify_send_queue@3674-3691@usr.sbin/bind/lib/dns/zone.c","usr.sbin/bind/lib/dns/zone.c","notify_send_queue",3674,3691
83,19,537,2,95,"notify_send_toaddr@3694-3789@usr.sbin/bind/lib/dns/zone.c","usr.sbin/bind/lib/dns/zone.c","notify_send_toaddr",3694,3789
33,7,205,1,38,"notify_send@3792-3830@usr.sbin/bind/lib/dns/zone.c","usr.sbin/bind/lib/dns/zone.c","notify_send",3792,3830
9,1,50,1,11,"dns_zone_notify@3833-3844@usr.sbin/bind/lib/dns/zone.c","usr.sbin/bind/lib/dns/zone.c","dns_zone_notify",3833,3844
145,26,904,2,181,"zone_notify@3847-4028@usr.sbin/bind/lib/dns/zone.c","usr.sbin/bind/lib/dns/zone.c","zone_notify",3847,4028
70,13,423,4,82,"save_nsrrset@4035-4117@usr.sbin/bind/lib/dns/zone.c","usr.sbin/bind/lib/dns/zone.c","save_nsrrset",4035,4117
198,36,1220,2,252,"stub_callback@4120-4372@usr.sbin/bind/lib/dns/zone.c","usr.sbin/bind/lib/dns/zone.c","stub_callback",4120,4372
288,59,1661,2,354,"refresh_callback@4378-4732@usr.sbin/bind/lib/dns/zone.c","usr.sbin/bind/lib/dns/zone.c","refresh_callback",4378,4732
27,4,157,1,38,"queue_soa_query@4735-4773@usr.sbin/bind/lib/dns/zone.c","usr.sbin/bind/lib/dns/zone.c","queue_soa_query",4735,4773
36,7,221,3,45,"create_query@4776-4821@usr.sbin/bind/lib/dns/zone.c","usr.sbin/bind/lib/dns/zone.c","create_query",4776,4821
38,7,241,2,55,"add_opt@4824-4879@usr.sbin/bind/lib/dns/zone.c","usr.sbin/bind/lib/dns/zone.c","add_opt",4824,4879
140,37,883,2,164,"soa_query@4882-5046@usr.sbin/bind/lib/dns/zone.c","usr.sbin/bind/lib/dns/zone.c","soa_query",4882,5046
169,37,1105,3,205,"ns_query@5049-5254@usr.sbin/bind/lib/dns/zone.c","usr.sbin/bind/lib/dns/zone.c","ns_query",5049,5254
56,15,384,2,85,"zone_shutdown@5261-5346@usr.sbin/bind/lib/dns/zone.c","usr.sbin/bind/lib/dns/zone.c","zone_shutdown",5261,5346
9,1,58,2,12,"zone_timer@5349-5361@usr.sbin/bind/lib/dns/zone.c","usr.sbin/bind/lib/dns/zone.c","zone_timer",5349,5361
69,28,463,2,76,"zone_settimer@5364-5440@usr.sbin/bind/lib/dns/zone.c","usr.sbin/bind/lib/dns/zone.c","zone_settimer",5364,5440
10,1,58,1,16,"cancel_refresh@5443-5459@usr.sbin/bind/lib/dns/zone.c","usr.sbin/bind/lib/dns/zone.c","cancel_refresh",5443,5459
130,25,854,3,150,"notify_createmessage@5462-5612@usr.sbin/bind/lib/dns/zone.c","usr.sbin/bind/lib/dns/zone.c","notify_createmessage",5462,5612
100,23,593,3,150,"dns_zone_notifyreceive@5615-5765@usr.sbin/bind/lib/dns/zone.c","usr.sbin/bind/lib/dns/zone.c","dns_zone_notifyreceive",5615,5765
8,2,56,2,9,"dns_zone_setnotifyacl@5768-5777@usr.sbin/bind/lib/dns/zone.c","usr.sbin/bind/lib/dns/zone.c","dns_zone_setnotifyacl",5768,5777
8,2,56,2,9,"dns_zone_setqueryacl@5780-5789@usr.sbin/bind/lib/dns/zone.c","usr.sbin/bind/lib/dns/zone.c","dns_zone_setqueryacl",5780,5789
8,2,56,2,9,"dns_zone_setupdateacl@5792-5801@usr.sbin/bind/lib/dns/zone.c","usr.sbin/bind/lib/dns/zone.c","dns_zone_setupdateacl",5792,5801
8,2,56,2,9,"dns_zone_setforwardacl@5804-5813@usr.sbin/bind/lib/dns/zone.c","usr.sbin/bind/lib/dns/zone.c","dns_zone_setforwardacl",5804,5813
8,2,56,2,9,"dns_zone_setxfracl@5816-5825@usr.sbin/bind/lib/dns/zone.c","usr.sbin/bind/lib/dns/zone.c","dns_zone_setxfracl",5816,5825
4,1,23,1,5,"dns_zone_getnotifyacl@5828-5833@usr.sbin/bind/lib/dns/zone.c","usr.sbin/bind/lib/dns/zone.c","dns_zone_getnotifyacl",5828,5833
4,1,23,1,5,"dns_zone_getqueryacl@5836-5841@usr.sbin/bind/lib/dns/zone.c","usr.sbin/bind/lib/dns/zone.c","dns_zone_getqueryacl",5836,5841
4,1,23,1,5,"dns_zone_getupdateacl@5844-5849@usr.sbin/bind/lib/dns/zone.c","usr.sbin/bind/lib/dns/zone.c","dns_zone_getupdateacl",5844,5849
4,1,23,1,5,"dns_zone_getforwardacl@5852-5857@usr.sbin/bind/lib/dns/zone.c","usr.sbin/bind/lib/dns/zone.c","dns_zone_getforwardacl",5852,5857
4,1,23,1,5,"dns_zone_getxfracl@5860-5865@usr.sbin/bind/lib/dns/zone.c","usr.sbin/bind/lib/dns/zone.c","dns_zone_getxfracl",5860,5865
7,2,42,1,8,"dns_zone_clearupdateacl@5868-5876@usr.sbin/bind/lib/dns/zone.c","usr.sbin/bind/lib/dns/zone.c","dns_zone_clearupdateacl",5868,5876
7,2,42,1,8,"dns_zone_clearforwardacl@5879-5887@usr.sbin/bind/lib/dns/zone.c","usr.sbin/bind/lib/dns/zone.c","dns_zone_clearforwardacl",5879,5887
7,2,42,1,8,"dns_zone_clearnotifyacl@5890-5898@usr.sbin/bind/lib/dns/zone.c","usr.sbin/bind/lib/dns/zone.c","dns_zone_clearnotifyacl",5890,5898
7,2,42,1,8,"dns_zone_clearqueryacl@5901-5909@usr.sbin/bind/lib/dns/zone.c","usr.sbin/bind/lib/dns/zone.c","dns_zone_clearqueryacl",5901,5909
7,2,42,1,8,"dns_zone_clearxfracl@5912-5920@usr.sbin/bind/lib/dns/zone.c","usr.sbin/bind/lib/dns/zone.c","dns_zone_clearxfracl",5912,5920
4,1,23,1,4,"dns_zone_getupdatedisabled@5923-5927@usr.sbin/bind/lib/dns/zone.c","usr.sbin/bind/lib/dns/zone.c","dns_zone_getupdatedisabled",5923,5927
4,1,25,2,3,"dns_zone_setupdatedisabled@5930-5933@usr.sbin/bind/lib/dns/zone.c","usr.sbin/bind/lib/dns/zone.c","dns_zone_setupdatedisabled",5930,5933
4,1,23,1,4,"dns_zone_getzeronosoattl@5936-5940@usr.sbin/bind/lib/dns/zone.c","usr.sbin/bind/lib/dns/zone.c","dns_zone_getzeronosoattl",5936,5940
4,1,25,2,3,"dns_zone_setzeronosoattl@5943-5946@usr.sbin/bind/lib/dns/zone.c","usr.sbin/bind/lib/dns/zone.c","dns_zone_setzeronosoattl",5943,5946
4,1,25,2,5,"dns_zone_setchecknames@5949-5954@usr.sbin/bind/lib/dns/zone.c","usr.sbin/bind/lib/dns/zone.c","dns_zone_setchecknames",5949,5954
4,1,23,1,5,"dns_zone_getchecknames@5957-5962@usr.sbin/bind/lib/dns/zone.c","usr.sbin/bind/lib/dns/zone.c","dns_zone_getchecknames",5957,5962
4,1,25,2,5,"dns_zone_setjournalsize@5965-5970@usr.sbin/bind/lib/dns/zone.c","usr.sbin/bind/lib/dns/zone.c","dns_zone_setjournalsize",5965,5970
4,1,23,1,5,"dns_zone_getjournalsize@5973-5978@usr.sbin/bind/lib/dns/zone.c","usr.sbin/bind/lib/dns/zone.c","dns_zone_getjournalsize",5973,5978
22,9,216,3,29,"zone_tostr@5981-6010@usr.sbin/bind/lib/dns/zone.c","usr.sbin/bind/lib/dns/zone.c","zone_tostr",5981,6010
5,1,39,3,4,"dns_zone_name@6013-6017@usr.sbin/bind/lib/dns/zone.c","usr.sbin/bind/lib/dns/zone.c","dns_zone_name",6013,6017
13,2,103,4,15,"notify_log@6020-6035@usr.sbin/bind/lib/dns/zone.c","usr.sbin/bind/lib/dns/zone.c","notify_log",6020,6035
14,2,107,5,16,"dns_zone_logc@6038-6054@usr.sbin/bind/lib/dns/zone.c","usr.sbin/bind/lib/dns/zone.c","dns_zone_logc",6038,6054
13,2,103,4,15,"dns_zone_log@6057-6072@usr.sbin/bind/lib/dns/zone.c","usr.sbin/bind/lib/dns/zone.c","dns_zone_log",6057,6072
16,2,118,5,18,"zone_debuglog@6075-6093@usr.sbin/bind/lib/dns/zone.c","usr.sbin/bind/lib/dns/zone.c","zone_debuglog",6075,6093
19,4,112,3,21,"message_count@6096-6117@usr.sbin/bind/lib/dns/zone.c","usr.sbin/bind/lib/dns/zone.c","message_count",6096,6117
4,1,25,2,4,"dns_zone_setmaxxfrin@6120-6124@usr.sbin/bind/lib/dns/zone.c","usr.sbin/bind/lib/dns/zone.c","dns_zone_setmaxxfrin",6120,6124
4,1,23,1,4,"dns_zone_getmaxxfrin@6127-6131@usr.sbin/bind/lib/dns/zone.c","usr.sbin/bind/lib/dns/zone.c","dns_zone_getmaxxfrin",6127,6131
4,1,25,2,3,"dns_zone_setmaxxfrout@6134-6137@usr.sbin/bind/lib/dns/zone.c","usr.sbin/bind/lib/dns/zone.c","dns_zone_setmaxxfrout",6134,6137
4,1,23,1,4,"dns_zone_getmaxxfrout@6140-6144@usr.sbin/bind/lib/dns/zone.c","usr.sbin/bind/lib/dns/zone.c","dns_zone_getmaxxfrout",6140,6144
4,1,23,1,4,"dns_zone_gettype@6147-6151@usr.sbin/bind/lib/dns/zone.c","usr.sbin/bind/lib/dns/zone.c","dns_zone_gettype",6147,6151
4,1,24,1,4,"dns_zone_getorigin@6154-6158@usr.sbin/bind/lib/dns/zone.c","usr.sbin/bind/lib/dns/zone.c","dns_zone_getorigin",6154,6158
12,3,95,2,12,"dns_zone_settask@6161-6173@usr.sbin/bind/lib/dns/zone.c","usr.sbin/bind/lib/dns/zone.c","dns_zone_settask",6161,6173
4,1,29,2,3,"dns_zone_gettask@6176-6179@usr.sbin/bind/lib/dns/zone.c","usr.sbin/bind/lib/dns/zone.c","dns_zone_gettask",6176,6179
6,2,35,2,6,"dns_zone_setidlein@6182-6188@usr.sbin/bind/lib/dns/zone.c","usr.sbin/bind/lib/dns/zone.c","dns_zone_setidlein",6182,6188
4,1,23,1,4,"dns_zone_getidlein@6191-6195@usr.sbin/bind/lib/dns/zone.c","usr.sbin/bind/lib/dns/zone.c","dns_zone_getidlein",6191,6195
4,1,25,2,4,"dns_zone_setidleout@6198-6202@usr.sbin/bind/lib/dns/zone.c","usr.sbin/bind/lib/dns/zone.c","dns_zone_setidleout",6198,6202
4,1,23,1,4,"dns_zone_getidleout@6205-6209@usr.sbin/bind/lib/dns/zone.c","usr.sbin/bind/lib/dns/zone.c","dns_zone_getidleout",6205,6209
48,11,334,2,56,"notify_done@6212-6268@usr.sbin/bind/lib/dns/zone.c","usr.sbin/bind/lib/dns/zone.c","notify_done",6212,6268
10,1,72,3,10,"dns_zone_replacedb@6271-6281@usr.sbin/bind/lib/dns/zone.c","usr.sbin/bind/lib/dns/zone.c","dns_zone_replacedb",6271,6281
109,24,642,3,151,"zone_replacedb@6284-6435@usr.sbin/bind/lib/dns/zone.c","usr.sbin/bind/lib/dns/zone.c","zone_replacedb",6284,6435
13,5,85,2,13,"zone_attachdb@6439-6452@usr.sbin/bind/lib/dns/zone.c","usr.sbin/bind/lib/dns/zone.c","zone_attachdb",6439,6452
6,2,47,1,6,"zone_detachdb@6456-6462@usr.sbin/bind/lib/dns/zone.c","usr.sbin/bind/lib/dns/zone.c","zone_detachdb",6456,6462
174,38,1054,2,228,"zone_xfrdone@6465-6693@usr.sbin/bind/lib/dns/zone.c","usr.sbin/bind/lib/dns/zone.c","zone_xfrdone",6465,6693
24,5,195,2,28,"zone_loaddone@6696-6724@usr.sbin/bind/lib/dns/zone.c","usr.sbin/bind/lib/dns/zone.c","zone_loaddone",6696,6724
9,2,62,2,9,"dns_zone_getssutable@6727-6736@usr.sbin/bind/lib/dns/zone.c","usr.sbin/bind/lib/dns/zone.c","dns_zone_getssutable",6727,6736
9,3,62,2,9,"dns_zone_setssutable@6739-6748@usr.sbin/bind/lib/dns/zone.c","usr.sbin/bind/lib/dns/zone.c","dns_zone_setssutable",6739,6748
4,1,25,2,4,"dns_zone_setsigvalidityinterval@6751-6755@usr.sbin/bind/lib/dns/zone.c","usr.sbin/bind/lib/dns/zone.c","dns_zone_setsigvalidityinterval",6751,6755
4,1,23,1,4,"dns_zone_getsigvalidityinterval@6758-6762@usr.sbin/bind/lib/dns/zone.c","usr.sbin/bind/lib/dns/zone.c","dns_zone_getsigvalidityinterval",6758,6762
23,3,146,1,26,"queue_xfrin@6765-6791@usr.sbin/bind/lib/dns/zone.c","usr.sbin/bind/lib/dns/zone.c","queue_xfrin",6765,6791
97,16,584,2,121,"got_transfer_quota@6799-6920@usr.sbin/bind/lib/dns/zone.c","usr.sbin/bind/lib/dns/zone.c","got_transfer_quota",6799,6920
10,4,78,1,10,"forward_destroy@6927-6937@usr.sbin/bind/lib/dns/zone.c","usr.sbin/bind/lib/dns/zone.c","forward_destroy",6927,6937
31,4,167,1,38,"sendtomaster@6940-6978@usr.sbin/bind/lib/dns/zone.c","usr.sbin/bind/lib/dns/zone.c","sendtomaster",6940,6978
76,18,413,2,95,"forward_callback@6981-7076@usr.sbin/bind/lib/dns/zone.c","usr.sbin/bind/lib/dns/zone.c","forward_callback",6981,7076
40,6,244,4,46,"dns_zone_forwardupdate@7079-7125@usr.sbin/bind/lib/dns/zone.c","usr.sbin/bind/lib/dns/zone.c","dns_zone_forwardupdate",7079,7125
9,3,60,2,9,"dns_zone_next@7128-7137@usr.sbin/bind/lib/dns/zone.c","usr.sbin/bind/lib/dns/zone.c","dns_zone_next",7128,7137
9,3,60,2,9,"dns_zone_first@7140-7149@usr.sbin/bind/lib/dns/zone.c","usr.sbin/bind/lib/dns/zone.c","dns_zone_first",7140,7149
68,8,439,5,81,"dns_zonemgr_create@7156-7237@usr.sbin/bind/lib/dns/zone.c","usr.sbin/bind/lib/dns/zone.c","dns_zonemgr_create",7156,7237
33,2,214,2,49,"dns_zonemgr_managezone@7240-7289@usr.sbin/bind/lib/dns/zone.c","usr.sbin/bind/lib/dns/zone.c","dns_zonemgr_managezone",7240,7289
18,3,124,2,22,"dns_zonemgr_releasezone@7292-7314@usr.sbin/bind/lib/dns/zone.c","usr.sbin/bind/lib/dns/zone.c","dns_zonemgr_releasezone",7292,7314
10,2,80,2,10,"dns_zonemgr_attach@7317-7327@usr.sbin/bind/lib/dns/zone.c","usr.sbin/bind/lib/dns/zone.c","dns_zonemgr_attach",7317,7327
14,3,83,1,16,"dns_zonemgr_detach@7330-7346@usr.sbin/bind/lib/dns/zone.c","usr.sbin/bind/lib/dns/zone.c","dns_zonemgr_detach",7330,7346
16,2,103,1,24,"dns_zonemgr_forcemaint@7349-7373@usr.sbin/bind/lib/dns/zone.c","usr.sbin/bind/lib/dns/zone.c","dns_zonemgr_forcemaint",7349,7373
6,1,43,1,7,"dns_zonemgr_resumexfrs@7376-7383@usr.sbin/bind/lib/dns/zone.c","usr.sbin/bind/lib/dns/zone.c","dns_zonemgr_resumexfrs",7376,7383
8,3,55,1,9,"dns_zonemgr_shutdown@7386-7395@usr.sbin/bind/lib/dns/zone.c","usr.sbin/bind/lib/dns/zone.c","dns_zonemgr_shutdown",7386,7395
12,1,88,1,15,"zonemgr_free@7398-7413@usr.sbin/bind/lib/dns/zone.c","usr.sbin/bind/lib/dns/zone.c","zonemgr_free",7398,7413
4,1,25,2,4,"dns_zonemgr_settransfersin@7416-7420@usr.sbin/bind/lib/dns/zone.c","usr.sbin/bind/lib/dns/zone.c","dns_zonemgr_settransfersin",7416,7420
4,1,23,1,4,"dns_zonemgr_getttransfersin@7423-7427@usr.sbin/bind/lib/dns/zone.c","usr.sbin/bind/lib/dns/zone.c","dns_zonemgr_getttransfersin",7423,7427
4,1,25,2,4,"dns_zonemgr_settransfersperns@7430-7434@usr.sbin/bind/lib/dns/zone.c","usr.sbin/bind/lib/dns/zone.c","dns_zonemgr_settransfersperns",7430,7434
4,1,23,1,4,"dns_zonemgr_getttransfersperns@7437-7441@usr.sbin/bind/lib/dns/zone.c","usr.sbin/bind/lib/dns/zone.c","dns_zonemgr_getttransfersperns",7437,7441
24,5,110,2,33,"zmgr_resume_xfrs@7451-7484@usr.sbin/bind/lib/dns/zone.c","usr.sbin/bind/lib/dns/zone.c","zmgr_resume_xfrs",7451,7484
45,7,292,2,73,"zmgr_start_xfrin_ifquota@7500-7573@usr.sbin/bind/lib/dns/zone.c","usr.sbin/bind/lib/dns/zone.c","zmgr_start_xfrin_ifquota",7500,7573
5,1,32,2,6,"dns_zonemgr_setiolimit@7576-7582@usr.sbin/bind/lib/dns/zone.c","usr.sbin/bind/lib/dns/zone.c","dns_zonemgr_setiolimit",7576,7582
4,1,23,1,5,"dns_zonemgr_getiolimit@7585-7590@usr.sbin/bind/lib/dns/zone.c","usr.sbin/bind/lib/dns/zone.c","dns_zonemgr_getiolimit",7585,7590
39,7,275,6,42,"zonemgr_getio@7603-7645@usr.sbin/bind/lib/dns/zone.c","usr.sbin/bind/lib/dns/zone.c","zonemgr_getio",7603,7645
31,5,218,1,35,"zonemgr_putio@7648-7683@usr.sbin/bind/lib/dns/zone.c","usr.sbin/bind/lib/dns/zone.c","zonemgr_putio",7648,7683
18,4,124,1,23,"zonemgr_cancelio@7686-7709@usr.sbin/bind/lib/dns/zone.c","usr.sbin/bind/lib/dns/zone.c","zonemgr_cancelio",7686,7709
19,4,127,3,24,"zone_saveunique@7712-7736@usr.sbin/bind/lib/dns/zone.c","usr.sbin/bind/lib/dns/zone.c","zone_saveunique",7712,7736
8,1,53,2,9,"dns_zonemgr_dbdestroyed@7742-7751@usr.sbin/bind/lib/dns/zone.c","usr.sbin/bind/lib/dns/zone.c","dns_zonemgr_dbdestroyed",7742,7751
27,4,152,2,31,"dns_zonemgr_setserialqueryrate@7755-7786@usr.sbin/bind/lib/dns/zone.c","usr.sbin/bind/lib/dns/zone.c","dns_zonemgr_setserialqueryrate",7755,7786
4,1,23,1,4,"dns_zonemgr_getserialqueryrate@7789-7793@usr.sbin/bind/lib/dns/zone.c","usr.sbin/bind/lib/dns/zone.c","dns_zonemgr_getserialqueryrate",7789,7793
9,2,48,1,10,"dns_zone_forcereload@7796-7806@usr.sbin/bind/lib/dns/zone.c","usr.sbin/bind/lib/dns/zone.c","dns_zone_forcereload",7796,7806
4,1,26,1,4,"dns_zone_isforced@7809-7813@usr.sbin/bind/lib/dns/zone.c","usr.sbin/bind/lib/dns/zone.c","dns_zone_isforced",7809,7813
16,4,90,2,16,"dns_zone_setstatistics@7816-7832@usr.sbin/bind/lib/dns/zone.c","usr.sbin/bind/lib/dns/zone.c","dns_zone_setstatistics",7816,7832
3,1,15,1,2,"dns_zone_getstatscounters@7835-7837@usr.sbin/bind/lib/dns/zone.c","usr.sbin/bind/lib/dns/zone.c","dns_zone_getstatscounters",7835,7837
12,4,75,1,14,"dns_zone_dialup@7840-7854@usr.sbin/bind/lib/dns/zone.c","usr.sbin/bind/lib/dns/zone.c","dns_zone_dialup",7840,7854
33,7,138,2,33,"dns_zone_setdialup@7857-7890@usr.sbin/bind/lib/dns/zone.c","usr.sbin/bind/lib/dns/zone.c","dns_zone_setdialup",7857,7890
8,1,55,2,10,"dns_zone_setkeydirectory@7893-7903@usr.sbin/bind/lib/dns/zone.c","usr.sbin/bind/lib/dns/zone.c","dns_zone_setkeydirectory",7893,7903
4,1,23,1,4,"dns_zone_getkeydirectory@7906-7910@usr.sbin/bind/lib/dns/zone.c","usr.sbin/bind/lib/dns/zone.c","dns_zone_getkeydirectory",7906,7910
41,12,233,2,44,"dns_zonemgr_getcount@7913-7957@usr.sbin/bind/lib/dns/zone.c","usr.sbin/bind/lib/dns/zone.c","dns_zonemgr_getcount",7913,7957
37,7,271,3,42,"dns_zone_checknames@7960-8002@usr.sbin/bind/lib/dns/zone.c","usr.sbin/bind/lib/dns/zone.c","dns_zone_checknames",7960,8002
4,1,25,2,3,"dns_zone_setcheckmx@8005-8008@usr.sbin/bind/lib/dns/zone.c","usr.sbin/bind/lib/dns/zone.c","dns_zone_setcheckmx",8005,8008
4,1,25,2,3,"dns_zone_setchecksrv@8011-8014@usr.sbin/bind/lib/dns/zone.c","usr.sbin/bind/lib/dns/zone.c","dns_zone_setchecksrv",8011,8014
4,1,25,2,3,"dns_zone_setcheckns@8017-8020@usr.sbin/bind/lib/dns/zone.c","usr.sbin/bind/lib/dns/zone.c","dns_zone_setcheckns",8017,8020
7,1,45,3,7,"dns_zone_setisself@8023-8030@usr.sbin/bind/lib/dns/zone.c","usr.sbin/bind/lib/dns/zone.c","dns_zone_setisself",8023,8030
6,1,35,2,6,"dns_zone_setnotifydelay@8033-8039@usr.sbin/bind/lib/dns/zone.c","usr.sbin/bind/lib/dns/zone.c","dns_zone_setnotifydelay",8033,8039
4,1,23,1,4,"dns_zone_getnotifydelay@8042-8046@usr.sbin/bind/lib/dns/zone.c","usr.sbin/bind/lib/dns/zone.c","dns_zone_getnotifydelay",8042,8046
17,6,104,1,20,"dns_zonekey_iszonekey@35-55@usr.sbin/bind/lib/dns/zonekey.c","usr.sbin/bind/lib/dns/zonekey.c","dns_zonekey_iszonekey",35,55
26,5,176,3,34,"dns_zt_create@66-100@usr.sbin/bind/lib/dns/zt.c","usr.sbin/bind/lib/dns/zt.c","dns_zt_create",66,100
13,2,92,2,18,"dns_zt_mount@103-121@usr.sbin/bind/lib/dns/zt.c","usr.sbin/bind/lib/dns/zt.c","dns_zt_mount",103,121
10,1,72,2,15,"dns_zt_unmount@124-139@usr.sbin/bind/lib/dns/zt.c","usr.sbin/bind/lib/dns/zt.c","dns_zt_unmount",124,139
17,4,129,5,22,"dns_zt_find@142-164@usr.sbin/bind/lib/dns/zt.c","usr.sbin/bind/lib/dns/zt.c","dns_zt_find",142,164
10,2,80,2,14,"dns_zt_attach@167-181@usr.sbin/bind/lib/dns/zt.c","usr.sbin/bind/lib/dns/zt.c","dns_zt_attach",167,181
4,1,25,2,3,"flush@184-187@usr.sbin/bind/lib/dns/zt.c","usr.sbin/bind/lib/dns/zt.c","flush",184,187
21,5,150,2,27,"zt_flushanddetach@190-217@usr.sbin/bind/lib/dns/zt.c","usr.sbin/bind/lib/dns/zt.c","zt_flushanddetach",190,217
3,1,15,1,2,"dns_zt_flushanddetach@220-222@usr.sbin/bind/lib/dns/zt.c","usr.sbin/bind/lib/dns/zt.c","dns_zt_flushanddetach",220,222
3,1,15,1,2,"dns_zt_detach@225-227@usr.sbin/bind/lib/dns/zt.c","usr.sbin/bind/lib/dns/zt.c","dns_zt_detach",225,227
8,1,60,2,9,"dns_zt_load@230-239@usr.sbin/bind/lib/dns/zt.c","usr.sbin/bind/lib/dns/zt.c","dns_zt_load",230,239
8,3,46,2,7,"load@242-249@usr.sbin/bind/lib/dns/zt.c","usr.sbin/bind/lib/dns/zt.c","load",242,249
8,1,60,2,9,"dns_zt_loadnew@252-261@usr.sbin/bind/lib/dns/zt.c","usr.sbin/bind/lib/dns/zt.c","dns_zt_loadnew",252,261
9,4,50,2,8,"loadnew@264-272@usr.sbin/bind/lib/dns/zt.c","usr.sbin/bind/lib/dns/zt.c","loadnew",264,272
8,2,74,2,9,"dns_zt_freezezones@275-284@usr.sbin/bind/lib/dns/zt.c","usr.sbin/bind/lib/dns/zt.c","dns_zt_freezezones",275,284
55,15,319,2,56,"freezezones@287-343@usr.sbin/bind/lib/dns/zt.c","usr.sbin/bind/lib/dns/zt.c","freezezones",287,343
5,1,44,4,4,"dns_zt_apply@346-350@usr.sbin/bind/lib/dns/zt.c","usr.sbin/bind/lib/dns/zt.c","dns_zt_apply",346,350
38,12,239,5,44,"dns_zt_apply2@353-397@usr.sbin/bind/lib/dns/zt.c","usr.sbin/bind/lib/dns/zt.c","dns_zt_apply2",353,397
5,1,29,2,6,"auto_detach@404-410@usr.sbin/bind/lib/dns/zt.c","usr.sbin/bind/lib/dns/zt.c","auto_detach",404,410
9,1,28,2,8,"isc_atomic_xadd@68-76@usr.sbin/bind/lib/isc/alpha/include/isc/atomic.h","usr.sbin/bind/lib/isc/alpha/include/isc/atomic.h","isc_atomic_xadd",68,76
8,1,27,2,7,"isc_atomic_store@82-89@usr.sbin/bind/lib/isc/alpha/include/isc/atomic.h","usr.sbin/bind/lib/isc/alpha/include/isc/atomic.h","isc_atomic_store",82,89
12,1,36,3,12,"isc_atomic_cmpxchg@97-109@usr.sbin/bind/lib/isc/alpha/include/isc/atomic.h","usr.sbin/bind/lib/isc/alpha/include/isc/atomic.h","isc_atomic_cmpxchg",97,109
14,1,55,2,15,"isc_atomic_xadd@112-127@usr.sbin/bind/lib/isc/alpha/include/isc/atomic.h","usr.sbin/bind/lib/isc/alpha/include/isc/atomic.h","isc_atomic_xadd",112,127
12,1,42,2,12,"isc_atomic_store@130-142@usr.sbin/bind/lib/isc/alpha/include/isc/atomic.h","usr.sbin/bind/lib/isc/alpha/include/isc/atomic.h","isc_atomic_store",130,142
17,1,66,3,18,"isc_atomic_cmpxchg@145-163@usr.sbin/bind/lib/isc/alpha/include/isc/atomic.h","usr.sbin/bind/lib/isc/alpha/include/isc/atomic.h","isc_atomic_cmpxchg",145,163
15,3,90,2,16,"isc_atomic_xadd@34-50@usr.sbin/bind/lib/isc/ia64/include/isc/atomic.h","usr.sbin/bind/lib/isc/ia64/include/isc/atomic.h","isc_atomic_xadd",34,50
8,1,30,2,7,"isc_atomic_store@56-63@usr.sbin/bind/lib/isc/ia64/include/isc/atomic.h","usr.sbin/bind/lib/isc/ia64/include/isc/atomic.h","isc_atomic_store",56,63
10,1,58,3,11,"isc_atomic_cmpxchg@71-82@usr.sbin/bind/lib/isc/ia64/include/isc/atomic.h","usr.sbin/bind/lib/isc/ia64/include/isc/atomic.h","isc_atomic_cmpxchg",71,82
15,1,50,2,17,"isc_atomic_xadd@31-48@usr.sbin/bind/lib/isc/mips/include/isc/atomic.h","usr.sbin/bind/lib/isc/mips/include/isc/atomic.h","isc_atomic_xadd",31,48
12,1,37,2,11,"isc_atomic_store@54-65@usr.sbin/bind/lib/isc/mips/include/isc/atomic.h","usr.sbin/bind/lib/isc/mips/include/isc/atomic.h","isc_atomic_store",54,65
17,1,60,3,18,"isc_atomic_cmpxchg@73-91@usr.sbin/bind/lib/isc/mips/include/isc/atomic.h","usr.sbin/bind/lib/isc/mips/include/isc/atomic.h","isc_atomic_cmpxchg",73,91
13,4,84,2,27,"isc_msgcat_open@57-84@usr.sbin/bind/lib/isc/nls/msgcat.c","usr.sbin/bind/lib/isc/nls/msgcat.c","isc_msgcat_open",57,84
13,5,84,1,21,"isc_msgcat_close@87-108@usr.sbin/bind/lib/isc/nls/msgcat.c","usr.sbin/bind/lib/isc/nls/msgcat.c","isc_msgcat_close",87,108
12,4,84,4,20,"isc_msgcat_get@111-131@usr.sbin/bind/lib/isc/nls/msgcat.c","usr.sbin/bind/lib/isc/nls/msgcat.c","isc_msgcat_get",111,131
3,1,13,1,2,"isc_thread_setconcurrency@26-28@usr.sbin/bind/lib/isc/nothreads/thread.c","usr.sbin/bind/lib/isc/nothreads/thread.c","isc_thread_setconcurrency",26,28
8,3,49,3,11,"isc_atomic_cmpxchg@57-68@usr.sbin/bind/lib/isc/powerpc/include/isc/atomic.h","usr.sbin/bind/lib/isc/powerpc/include/isc/atomic.h","isc_atomic_cmpxchg",57,68
21,2,55,2,25,"isc_atomic_xadd@72-97@usr.sbin/bind/lib/isc/powerpc/include/isc/atomic.h","usr.sbin/bind/lib/isc/powerpc/include/isc/atomic.h","isc_atomic_xadd",72,97
17,2,41,2,19,"isc_atomic_store@100-119@usr.sbin/bind/lib/isc/powerpc/include/isc/atomic.h","usr.sbin/bind/lib/isc/powerpc/include/isc/atomic.h","isc_atomic_store",100,119
27,2,69,3,31,"isc_atomic_cmpxchg@122-153@usr.sbin/bind/lib/isc/powerpc/include/isc/atomic.h","usr.sbin/bind/lib/isc/powerpc/include/isc/atomic.h","isc_atomic_cmpxchg",122,153
26,8,180,3,40,"isc_condition_waituntil@34-74@usr.sbin/bind/lib/isc/pthreads/condition.c","usr.sbin/bind/lib/isc/pthreads/condition.c","isc_condition_waituntil",34,74
37,8,301,3,43,"isc_mutex_init_profile@87-130@usr.sbin/bind/lib/isc/pthreads/mutex.c","usr.sbin/bind/lib/isc/pthreads/mutex.c","isc_mutex_init_profile",87,130
32,7,243,3,40,"isc_mutex_lock_profile@133-173@usr.sbin/bind/lib/isc/pthreads/mutex.c","usr.sbin/bind/lib/isc/pthreads/mutex.c","isc_mutex_lock_profile",133,173
14,3,121,3,16,"isc_mutex_unlock_profile@176-192@usr.sbin/bind/lib/isc/pthreads/mutex.c","usr.sbin/bind/lib/isc/pthreads/mutex.c","isc_mutex_unlock_profile",176,192
28,5,197,1,27,"isc_mutex_statsprofile@196-223@usr.sbin/bind/lib/isc/pthreads/mutex.c","usr.sbin/bind/lib/isc/pthreads/mutex.c","isc_mutex_statsprofile",196,223
13,5,82,1,15,"isc_mutex_init_errcheck@229-244@usr.sbin/bind/lib/isc/pthreads/mutex.c","usr.sbin/bind/lib/isc/pthreads/mutex.c","isc_mutex_init_errcheck",229,244
15,3,91,3,15,"isc__mutex_init@255-270@usr.sbin/bind/lib/isc/pthreads/mutex.c","usr.sbin/bind/lib/isc/pthreads/mutex.c","isc__mutex_init",255,270
24,8,137,3,35,"isc_thread_create@32-67@usr.sbin/bind/lib/isc/pthreads/thread.c","usr.sbin/bind/lib/isc/pthreads/thread.c","isc_thread_create",32,67
4,2,21,1,6,"isc_thread_setconcurrency@70-76@usr.sbin/bind/lib/isc/pthreads/thread.c","usr.sbin/bind/lib/isc/pthreads/thread.c","isc_thread_setconcurrency",70,76
13,3,80,2,14,"isc_atomic_xadd@69-83@usr.sbin/bind/lib/isc/sparc64/include/isc/atomic.h","usr.sbin/bind/lib/isc/sparc64/include/isc/atomic.h","isc_atomic_xadd",69,83
13,3,75,2,13,"isc_atomic_store@89-102@usr.sbin/bind/lib/isc/sparc64/include/isc/atomic.h","usr.sbin/bind/lib/isc/sparc64/include/isc/atomic.h","isc_atomic_store",89,102
8,1,50,3,9,"isc_atomic_cmpxchg@110-119@usr.sbin/bind/lib/isc/sparc64/include/isc/atomic.h","usr.sbin/bind/lib/isc/sparc64/include/isc/atomic.h","isc_atomic_cmpxchg",110,119
4,1,16,1,3,"exit_action@89-92@usr.sbin/bind/lib/isc/unix/app.c","usr.sbin/bind/lib/isc/unix/app.c","exit_action",89,92
4,1,16,1,3,"reload_action@95-98@usr.sbin/bind/lib/isc/unix/app.c","usr.sbin/bind/lib/isc/unix/app.c","reload_action",95,98
17,3,115,2,19,"handle_signal@102-121@usr.sbin/bind/lib/isc/unix/app.c","usr.sbin/bind/lib/isc/unix/app.c","handle_signal",102,121
70,23,454,1,132,"isc_app_start@124-256@usr.sbin/bind/lib/isc/unix/app.c","usr.sbin/bind/lib/isc/unix/app.c","isc_app_start",124,256
24,3,121,4,34,"isc_app_onrun@259-293@usr.sbin/bind/lib/isc/unix/app.c","usr.sbin/bind/lib/isc/unix/app.c","isc_app_onrun",259,293
47,9,242,0,65,"evloop@300-365@usr.sbin/bind/lib/isc/unix/app.c","usr.sbin/bind/lib/isc/unix/app.c","evloop",300,365
19,3,90,2,23,"isc__nothread_wait_hack@390-413@usr.sbin/bind/lib/isc/unix/app.c","usr.sbin/bind/lib/isc/unix/app.c","isc__nothread_wait_hack",390,413
7,1,31,1,9,"isc__nothread_signal_hack@416-425@usr.sbin/bind/lib/isc/unix/app.c","usr.sbin/bind/lib/isc/unix/app.c","isc__nothread_signal_hack",416,425
71,27,407,1,126,"isc_app_run@430-556@usr.sbin/bind/lib/isc/unix/app.c","usr.sbin/bind/lib/isc/unix/app.c","isc_app_run",430,556
29,6,149,1,38,"isc_app_shutdown@559-597@usr.sbin/bind/lib/isc/unix/app.c","usr.sbin/bind/lib/isc/unix/app.c","isc_app_shutdown",559,597
27,6,144,1,39,"isc_app_reload@600-639@usr.sbin/bind/lib/isc/unix/app.c","usr.sbin/bind/lib/isc/unix/app.c","isc_app_reload",600,639
3,1,12,1,2,"isc_app_finish@642-644@usr.sbin/bind/lib/isc/unix/app.c","usr.sbin/bind/lib/isc/unix/app.c","isc_app_finish",642,644
11,5,76,1,15,"isc_app_block@647-662@usr.sbin/bind/lib/isc/unix/app.c","usr.sbin/bind/lib/isc/unix/app.c","isc_app_block",647,662
11,5,78,1,18,"isc_app_unblock@665-683@usr.sbin/bind/lib/isc/unix/app.c","usr.sbin/bind/lib/isc/unix/app.c","isc_app_unblock",665,683
7,1,46,1,9,"isc_dir_init@43-52@usr.sbin/bind/lib/isc/unix/dir.c","usr.sbin/bind/lib/isc/unix/dir.c","isc_dir_init",43,52
18,5,150,2,34,"isc_dir_open@59-93@usr.sbin/bind/lib/isc/unix/dir.c","usr.sbin/bind/lib/isc/unix/dir.c","isc_dir_open",59,93
12,4,110,1,27,"isc_dir_read@103-130@usr.sbin/bind/lib/isc/unix/dir.c","usr.sbin/bind/lib/isc/unix/dir.c","isc_dir_read",103,130
5,2,38,1,5,"isc_dir_close@136-141@usr.sbin/bind/lib/isc/unix/dir.c","usr.sbin/bind/lib/isc/unix/dir.c","isc_dir_close",136,141
5,2,34,1,6,"isc_dir_reset@147-153@usr.sbin/bind/lib/isc/unix/dir.c","usr.sbin/bind/lib/isc/unix/dir.c","isc_dir_reset",147,153
6,2,38,1,11,"isc_dir_chdir@156-167@usr.sbin/bind/lib/isc/unix/dir.c","usr.sbin/bind/lib/isc/unix/dir.c","isc_dir_chdir",156,167
6,2,38,1,8,"isc_dir_chroot@170-178@usr.sbin/bind/lib/isc/unix/dir.c","usr.sbin/bind/lib/isc/unix/dir.c","isc_dir_chroot",170,178
39,11,200,1,66,"isc_dir_createunique@181-247@usr.sbin/bind/lib/isc/unix/dir.c","usr.sbin/bind/lib/isc/unix/dir.c","isc_dir_createunique",181,247
32,8,207,2,37,"get_from_filesource@70-107@usr.sbin/bind/lib/isc/unix/entropy.c","usr.sbin/bind/lib/isc/unix/entropy.c","get_from_filesource",70,107
96,29,569,2,122,"get_from_usocketsource@110-232@usr.sbin/bind/lib/isc/unix/entropy.c","usr.sbin/bind/lib/isc/unix/entropy.c","get_from_usocketsource",110,232
71,20,436,3,137,"fillpool@239-376@usr.sbin/bind/lib/isc/unix/entropy.c","usr.sbin/bind/lib/isc/unix/entropy.c","fillpool",239,376
47,14,260,1,51,"wait_for_sources@379-430@usr.sbin/bind/lib/isc/unix/entropy.c","usr.sbin/bind/lib/isc/unix/entropy.c","wait_for_sources",379,430
3,1,18,1,2,"destroyfilesource@433-435@usr.sbin/bind/lib/isc/unix/entropy.c","usr.sbin/bind/lib/isc/unix/entropy.c","destroyfilesource",433,435
3,1,15,1,2,"destroyusocketsource@438-440@usr.sbin/bind/lib/isc/unix/entropy.c","usr.sbin/bind/lib/isc/unix/entropy.c","destroyusocketsource",438,440
19,4,114,1,28,"make_nonblock@446-474@usr.sbin/bind/lib/isc/unix/entropy.c","usr.sbin/bind/lib/isc/unix/entropy.c","make_nonblock",446,474
79,17,482,2,116,"isc_entropy_createfilesource@477-593@usr.sbin/bind/lib/isc/unix/entropy.c","usr.sbin/bind/lib/isc/unix/entropy.c","isc_entropy_createfilesource",477,593
58,39,228,1,86,"isc__errno2result@37-123@usr.sbin/bind/lib/isc/unix/errno2result.c","usr.sbin/bind/lib/isc/unix/errno2result.c","isc__errno2result",37,123
8,2,56,2,10,"file_stats@86-96@usr.sbin/bind/lib/isc/unix/file.c","usr.sbin/bind/lib/isc/unix/file.c","file_stats",86,96
10,2,66,2,17,"isc_file_getmodtime@99-116@usr.sbin/bind/lib/isc/unix/file.c","usr.sbin/bind/lib/isc/unix/file.c","isc_file_getmodtime",99,116
13,4,142,2,37,"isc_file_settime@119-156@usr.sbin/bind/lib/isc/unix/file.c","usr.sbin/bind/lib/isc/unix/file.c","isc_file_settime",119,156
3,1,30,3,2,"isc_file_mktemplate@162-164@usr.sbin/bind/lib/isc/unix/file.c","usr.sbin/bind/lib/isc/unix/file.c","isc_file_mktemplate",162,164
22,5,161,4,28,"isc_file_template@167-195@usr.sbin/bind/lib/isc/unix/file.c","usr.sbin/bind/lib/isc/unix/file.c","isc_file_template",167,195
36,11,218,2,38,"isc_file_renameunique@201-239@usr.sbin/bind/lib/isc/unix/file.c","usr.sbin/bind/lib/isc/unix/file.c","isc_file_renameunique",201,239
47,13,299,2,52,"isc_file_openunique@243-295@usr.sbin/bind/lib/isc/unix/file.c","usr.sbin/bind/lib/isc/unix/file.c","isc_file_openunique",243,295
9,2,46,1,10,"isc_file_remove@298-308@usr.sbin/bind/lib/isc/unix/file.c","usr.sbin/bind/lib/isc/unix/file.c","isc_file_remove",298,308
10,2,60,2,11,"isc_file_rename@311-322@usr.sbin/bind/lib/isc/unix/file.c","usr.sbin/bind/lib/isc/unix/file.c","isc_file_rename",311,322
5,1,36,1,6,"isc_file_exists@325-331@usr.sbin/bind/lib/isc/unix/file.c","usr.sbin/bind/lib/isc/unix/file.c","isc_file_exists",325,331
4,1,29,1,3,"isc_file_isabsolute@334-337@usr.sbin/bind/lib/isc/unix/file.c","usr.sbin/bind/lib/isc/unix/file.c","isc_file_isabsolute",334,337
4,2,36,1,3,"isc_file_iscurrentdir@340-343@usr.sbin/bind/lib/isc/unix/file.c","usr.sbin/bind/lib/isc/unix/file.c","isc_file_iscurrentdir",340,343
8,3,45,1,7,"isc_file_ischdiridempotent@346-353@usr.sbin/bind/lib/isc/unix/file.c","usr.sbin/bind/lib/isc/unix/file.c","isc_file_ischdiridempotent",346,353
8,2,47,1,10,"isc_file_basename@356-366@usr.sbin/bind/lib/isc/unix/file.c","usr.sbin/bind/lib/isc/unix/file.c","isc_file_basename",356,366
12,2,79,3,15,"isc_file_progname@369-384@usr.sbin/bind/lib/isc/unix/file.c","usr.sbin/bind/lib/isc/unix/file.c","isc_file_progname",369,384
19,5,111,2,22,"dir_current@393-415@usr.sbin/bind/lib/isc/unix/file.c","usr.sbin/bind/lib/isc/unix/file.c","dir_current",393,415
10,3,74,3,9,"isc_file_absolutepath@418-427@usr.sbin/bind/lib/isc/unix/file.c","usr.sbin/bind/lib/isc/unix/file.c","isc_file_absolutepath",418,427
6,2,40,2,6,"isc_file_truncate@430-436@usr.sbin/bind/lib/isc/unix/file.c","usr.sbin/bind/lib/isc/unix/file.c","isc_file_truncate",430,436
30,6,181,2,57,"isc_fsaccess_set@36-93@usr.sbin/bind/lib/isc/unix/fsaccess.c","usr.sbin/bind/lib/isc/unix/fsaccess.c","isc_fsaccess_set",36,93
37,4,212,2,47,"isc_interfaceiter_create@46-93@usr.sbin/bind/lib/isc/unix/ifiter_getifaddrs.c","usr.sbin/bind/lib/isc/unix/ifiter_getifaddrs.c","isc_interfaceiter_create",46,93
37,11,344,1,53,"internal_current@103-156@usr.sbin/bind/lib/isc/unix/ifiter_getifaddrs.c","usr.sbin/bind/lib/isc/unix/ifiter_getifaddrs.c","internal_current",103,156
6,2,36,1,7,"internal_next@166-173@usr.sbin/bind/lib/isc/unix/ifiter_getifaddrs.c","usr.sbin/bind/lib/isc/unix/ifiter_getifaddrs.c","internal_next",166,173
5,2,27,1,4,"internal_destroy@176-180@usr.sbin/bind/lib/isc/unix/ifiter_getifaddrs.c","usr.sbin/bind/lib/isc/unix/ifiter_getifaddrs.c","internal_destroy",176,180
3,1,16,1,2,"internal_first@183-185@usr.sbin/bind/lib/isc/unix/ifiter_getifaddrs.c","usr.sbin/bind/lib/isc/unix/ifiter_getifaddrs.c","internal_first",183,185
48,7,278,1,69,"getbuf4@115-184@usr.sbin/bind/lib/isc/unix/ifiter_ioctl.c","usr.sbin/bind/lib/isc/unix/ifiter_ioctl.c","getbuf4",115,184
69,12,372,1,101,"getbuf6@188-289@usr.sbin/bind/lib/isc/unix/ifiter_ioctl.c","usr.sbin/bind/lib/isc/unix/ifiter_ioctl.c","getbuf6",188,289
75,16,467,2,107,"isc_interfaceiter_create@293-400@usr.sbin/bind/lib/isc/unix/ifiter_ioctl.c","usr.sbin/bind/lib/isc/unix/ifiter_ioctl.c","isc_interfaceiter_create",293,400
4,1,37,2,3,"get_inaddr@404-407@usr.sbin/bind/lib/isc/unix/ifiter_ioctl.c","usr.sbin/bind/lib/isc/unix/ifiter_ioctl.c","get_inaddr",404,407
13,2,139,1,12,"internal_current_clusteralias@410-422@usr.sbin/bind/lib/isc/unix/ifiter_ioctl.c","usr.sbin/bind/lib/isc/unix/ifiter_ioctl.c","internal_current_clusteralias",410,422
8,3,56,1,7,"linux_if_inet6_next@427-434@usr.sbin/bind/lib/isc/unix/ifiter_ioctl.c","usr.sbin/bind/lib/isc/unix/ifiter_ioctl.c","linux_if_inet6_next",427,434
8,2,46,1,7,"linux_if_inet6_first@437-444@usr.sbin/bind/lib/isc/unix/ifiter_ioctl.c","usr.sbin/bind/lib/isc/unix/ifiter_ioctl.c","linux_if_inet6_first",437,444
57,9,408,1,58,"linux_if_inet6_current@447-505@usr.sbin/bind/lib/isc/unix/ifiter_ioctl.c","usr.sbin/bind/lib/isc/unix/ifiter_ioctl.c","linux_if_inet6_current",447,505
128,30,997,1,196,"internal_current4@517-713@usr.sbin/bind/lib/isc/unix/ifiter_ioctl.c","usr.sbin/bind/lib/isc/unix/ifiter_ioctl.c","internal_current4",517,713
97,24,785,1,159,"internal_current6@717-876@usr.sbin/bind/lib/isc/unix/ifiter_ioctl.c","usr.sbin/bind/lib/isc/unix/ifiter_ioctl.c","internal_current6",717,876
10,6,65,1,13,"internal_current@880-893@usr.sbin/bind/lib/isc/unix/ifiter_ioctl.c","usr.sbin/bind/lib/isc/unix/ifiter_ioctl.c","internal_current",880,893
19,10,170,1,31,"internal_next4@903-934@usr.sbin/bind/lib/isc/unix/ifiter_ioctl.c","usr.sbin/bind/lib/isc/unix/ifiter_ioctl.c","internal_next4",903,934
14,7,142,1,23,"internal_next6@938-961@usr.sbin/bind/lib/isc/unix/ifiter_ioctl.c","usr.sbin/bind/lib/isc/unix/ifiter_ioctl.c","internal_next6",938,961
20,9,113,1,25,"internal_next@965-990@usr.sbin/bind/lib/isc/unix/ifiter_ioctl.c","usr.sbin/bind/lib/isc/unix/ifiter_ioctl.c","internal_next",965,990
10,6,77,1,13,"internal_destroy@993-1006@usr.sbin/bind/lib/isc/unix/ifiter_ioctl.c","usr.sbin/bind/lib/isc/unix/ifiter_ioctl.c","internal_destroy",993,1006
13,6,80,1,20,"internal_first@1009-1029@usr.sbin/bind/lib/isc/unix/ifiter_ioctl.c","usr.sbin/bind/lib/isc/unix/ifiter_ioctl.c","internal_first",1009,1029
59,6,358,2,74,"isc_interfaceiter_create@68-142@usr.sbin/bind/lib/isc/unix/ifiter_sysctl.c","usr.sbin/bind/lib/isc/unix/ifiter_sysctl.c","isc_interfaceiter_create",68,142
79,20,648,1,114,"internal_current@153-267@usr.sbin/bind/lib/isc/unix/ifiter_sysctl.c","usr.sbin/bind/lib/isc/unix/ifiter_sysctl.c","internal_current",153,267
9,2,77,1,12,"internal_next@277-289@usr.sbin/bind/lib/isc/unix/ifiter_sysctl.c","usr.sbin/bind/lib/isc/unix/ifiter_sysctl.c","internal_next",277,289
3,1,13,1,5,"internal_destroy@292-297@usr.sbin/bind/lib/isc/unix/ifiter_sysctl.c","usr.sbin/bind/lib/isc/unix/ifiter_sysctl.c","internal_destroy",292,297
3,1,14,1,2,"internal_first@300-302@usr.sbin/bind/lib/isc/unix/ifiter_sysctl.c","usr.sbin/bind/lib/isc/unix/ifiter_sysctl.c","internal_first",300,302
46,11,278,4,76,"get_addr@66-142@usr.sbin/bind/lib/isc/unix/interfaceiter.c","usr.sbin/bind/lib/isc/unix/interfaceiter.c","get_addr",66,142
7,1,42,2,6,"isc_interfaceiter_current@161-167@usr.sbin/bind/lib/isc/unix/interfaceiter.c","usr.sbin/bind/lib/isc/unix/interfaceiter.c","isc_interfaceiter_current",161,167
15,4,72,1,16,"isc_interfaceiter_first@170-186@usr.sbin/bind/lib/isc/unix/interfaceiter.c","usr.sbin/bind/lib/isc/unix/interfaceiter.c","isc_interfaceiter_first",170,186
15,4,76,1,16,"isc_interfaceiter_next@189-205@usr.sbin/bind/lib/isc/unix/interfaceiter.c","usr.sbin/bind/lib/isc/unix/interfaceiter.c","isc_interfaceiter_next",189,205
13,2,86,1,14,"isc_interfaceiter_destroy@208-222@usr.sbin/bind/lib/isc/unix/interfaceiter.c","usr.sbin/bind/lib/isc/unix/interfaceiter.c","isc_interfaceiter_destroy",208,222
32,4,206,1,42,"isc_keyboard_open@38-80@usr.sbin/bind/lib/isc/unix/keyboard.c","usr.sbin/bind/lib/isc/unix/keyboard.c","isc_keyboard_open",38,80
9,3,78,2,12,"isc_keyboard_close@83-95@usr.sbin/bind/lib/isc/unix/keyboard.c","usr.sbin/bind/lib/isc/unix/keyboard.c","isc_keyboard_close",83,95
19,4,122,2,23,"isc_keyboard_getchar@98-121@usr.sbin/bind/lib/isc/unix/keyboard.c","usr.sbin/bind/lib/isc/unix/keyboard.c","isc_keyboard_getchar",98,121
3,1,20,1,2,"isc_keyboard_canceled@124-126@usr.sbin/bind/lib/isc/unix/keyboard.c","usr.sbin/bind/lib/isc/unix/keyboard.c","isc_keyboard_canceled",124,126
59,14,248,1,78,"try_proto@60-138@usr.sbin/bind/lib/isc/unix/net.c","usr.sbin/bind/lib/isc/unix/net.c","try_proto",60,138
5,5,27,1,12,"initialize_action@141-153@usr.sbin/bind/lib/isc/unix/net.c","usr.sbin/bind/lib/isc/unix/net.c","initialize_action",141,153
3,1,19,1,2,"initialize@156-158@usr.sbin/bind/lib/isc/unix/net.c","usr.sbin/bind/lib/isc/unix/net.c","initialize",156,158
4,1,15,1,3,"isc_net_probeipv4@161-164@usr.sbin/bind/lib/isc/unix/net.c","usr.sbin/bind/lib/isc/unix/net.c","isc_net_probeipv4",161,164
4,1,15,1,3,"isc_net_probeipv6@167-170@usr.sbin/bind/lib/isc/unix/net.c","usr.sbin/bind/lib/isc/unix/net.c","isc_net_probeipv6",167,170
4,1,15,1,3,"isc_net_probeunix@173-176@usr.sbin/bind/lib/isc/unix/net.c","usr.sbin/bind/lib/isc/unix/net.c","isc_net_probeunix",173,176
54,7,261,1,69,"try_ipv6only@181-250@usr.sbin/bind/lib/isc/unix/net.c","usr.sbin/bind/lib/isc/unix/net.c","try_ipv6only",181,250
4,1,19,1,3,"initialize_ipv6only@253-256@usr.sbin/bind/lib/isc/unix/net.c","usr.sbin/bind/lib/isc/unix/net.c","initialize_ipv6only",253,256
36,5,165,1,44,"try_ipv6pktinfo@261-305@usr.sbin/bind/lib/isc/unix/net.c","usr.sbin/bind/lib/isc/unix/net.c","try_ipv6pktinfo",261,305
4,1,19,1,3,"initialize_ipv6pktinfo@308-311@usr.sbin/bind/lib/isc/unix/net.c","usr.sbin/bind/lib/isc/unix/net.c","initialize_ipv6pktinfo",308,311
5,3,19,1,9,"isc_net_probe_ipv6only@316-325@usr.sbin/bind/lib/isc/unix/net.c","usr.sbin/bind/lib/isc/unix/net.c","isc_net_probe_ipv6only",316,325
5,4,19,1,11,"isc_net_probe_ipv6pktinfo@328-339@usr.sbin/bind/lib/isc/unix/net.c","usr.sbin/bind/lib/isc/unix/net.c","isc_net_probe_ipv6pktinfo",328,339
5,2,20,1,4,"isc_net_disableipv4@342-346@usr.sbin/bind/lib/isc/unix/net.c","usr.sbin/bind/lib/isc/unix/net.c","isc_net_disableipv4",342,346
5,2,20,1,4,"isc_net_disableipv6@349-353@usr.sbin/bind/lib/isc/unix/net.c","usr.sbin/bind/lib/isc/unix/net.c","isc_net_disableipv6",349,353
5,2,20,1,4,"isc_net_enableipv4@356-360@usr.sbin/bind/lib/isc/unix/net.c","usr.sbin/bind/lib/isc/unix/net.c","isc_net_enableipv4",356,360
5,2,20,1,4,"isc_net_enableipv6@363-367@usr.sbin/bind/lib/isc/unix/net.c","usr.sbin/bind/lib/isc/unix/net.c","isc_net_enableipv6",363,367
5,3,27,1,8,"sysconf_ncpus@31-39@usr.sbin/bind/lib/isc/unix/os.c","usr.sbin/bind/lib/isc/unix/os.c","sysconf_ncpus",31,39
7,2,43,1,6,"hpux_ncpus@49-55@usr.sbin/bind/lib/isc/unix/os.c","usr.sbin/bind/lib/isc/unix/os.c","hpux_ncpus",49,55
9,2,55,1,9,"sysctl_ncpus@65-74@usr.sbin/bind/lib/isc/unix/os.c","usr.sbin/bind/lib/isc/unix/os.c","sysctl_ncpus",65,74
10,6,54,1,16,"isc_os_ncpus@78-94@usr.sbin/bind/lib/isc/unix/os.c","usr.sbin/bind/lib/isc/unix/os.c","isc_os_ncpus",78,94
42,9,256,1,54,"isc_priv_init@68-122@usr.sbin/bind/lib/isc/unix/privsep.c","usr.sbin/bind/lib/isc/unix/privsep.c","isc_priv_init",68,122
18,8,137,2,22,"isc_drop_privs@125-147@usr.sbin/bind/lib/isc/unix/privsep.c","usr.sbin/bind/lib/isc/unix/privsep.c","isc_drop_privs",125,147
43,13,249,2,48,"check_bind@150-198@usr.sbin/bind/lib/isc/unix/privsep.c","usr.sbin/bind/lib/isc/unix/privsep.c","check_bind",150,198
21,5,155,1,26,"parent_bind@201-227@usr.sbin/bind/lib/isc/unix/privsep.c","usr.sbin/bind/lib/isc/unix/privsep.c","parent_bind",201,227
19,3,138,3,21,"isc_priv_bind@231-252@usr.sbin/bind/lib/isc/unix/privsep.c","usr.sbin/bind/lib/isc/unix/privsep.c","isc_priv_bind",231,252
7,2,30,1,7,"sig_pass_to_chld@256-263@usr.sbin/bind/lib/isc/unix/privsep.c","usr.sbin/bind/lib/isc/unix/privsep.c","sig_pass_to_chld",256,263
13,7,75,1,15,"sig_got_chld@268-283@usr.sbin/bind/lib/isc/unix/privsep.c","usr.sbin/bind/lib/isc/unix/privsep.c","sig_got_chld",268,283
19,6,92,3,19,"may_read@287-306@usr.sbin/bind/lib/isc/unix/privsep.c","usr.sbin/bind/lib/isc/unix/privsep.c","may_read",287,306
18,6,87,3,18,"must_read@311-329@usr.sbin/bind/lib/isc/unix/privsep.c","usr.sbin/bind/lib/isc/unix/privsep.c","must_read",311,329
18,6,89,3,18,"must_write@334-352@usr.sbin/bind/lib/isc/unix/privsep.c","usr.sbin/bind/lib/isc/unix/privsep.c","must_write",334,352
4,1,23,2,3,"write_command@357-360@usr.sbin/bind/lib/isc/unix/privsep.c","usr.sbin/bind/lib/isc/unix/privsep.c","write_command",357,360
13,3,69,3,14,"logmsg@363-377@usr.sbin/bind/lib/isc/unix/privsep.c","usr.sbin/bind/lib/isc/unix/privsep.c","logmsg",363,377
22,6,107,1,24,"fatal@381-405@usr.sbin/bind/lib/isc/unix/privsep.c","usr.sbin/bind/lib/isc/unix/privsep.c","fatal",381,405
32,4,223,2,35,"send_fd@48-83@usr.sbin/bind/lib/isc/unix/privsep_fdpass.c","usr.sbin/bind/lib/isc/unix/privsep_fdpass.c","send_fd",48,83
36,5,228,1,37,"receive_fd@86-123@usr.sbin/bind/lib/isc/unix/privsep_fdpass.c","usr.sbin/bind/lib/isc/unix/privsep_fdpass.c","receive_fd",86,123
42,15,152,2,60,"resource2rlim@42-102@usr.sbin/bind/lib/isc/unix/resource.c","usr.sbin/bind/lib/isc/unix/resource.c","resource2rlim",42,102
59,23,366,2,133,"isc_resource_setlimit@105-238@usr.sbin/bind/lib/isc/unix/resource.c","usr.sbin/bind/lib/isc/unix/resource.c","isc_resource_setlimit",105,238
13,2,71,2,14,"isc_resource_getlimit@241-255@usr.sbin/bind/lib/isc/unix/resource.c","usr.sbin/bind/lib/isc/unix/resource.c","isc_resource_getlimit",241,255
13,2,71,2,14,"isc_resource_curlimit@258-272@usr.sbin/bind/lib/isc/unix/resource.c","usr.sbin/bind/lib/isc/unix/resource.c","isc_resource_curlimit",258,272
14,2,90,6,16,"manager_log@309-325@usr.sbin/bind/lib/isc/unix/socket.c","usr.sbin/bind/lib/isc/unix/socket.c","manager_log",309,325
24,3,164,10,26,"socket_log@333-359@usr.sbin/bind/lib/isc/unix/socket.c","usr.sbin/bind/lib/isc/unix/socket.c","socket_log",333,359
18,6,137,3,30,"wakeup_socket@362-392@usr.sbin/bind/lib/isc/unix/socket.c","usr.sbin/bind/lib/isc/unix/socket.c","wakeup_socket",362,392
24,7,149,3,33,"select_poke@401-434@usr.sbin/bind/lib/isc/unix/socket.c","usr.sbin/bind/lib/isc/unix/socket.c","select_poke",401,434
23,3,139,3,26,"select_readmsg@440-466@usr.sbin/bind/lib/isc/unix/socket.c","usr.sbin/bind/lib/isc/unix/socket.c","select_readmsg",440,466
7,3,40,3,6,"select_poke@472-478@usr.sbin/bind/lib/isc/unix/socket.c","usr.sbin/bind/lib/isc/unix/socket.c","select_poke",472,478
19,4,114,1,28,"make_nonblock@485-513@usr.sbin/bind/lib/isc/unix/socket.c","usr.sbin/bind/lib/isc/unix/socket.c","make_nonblock",485,513
6,2,42,1,13,"cmsg_len@524-537@usr.sbin/bind/lib/isc/unix/socket.c","usr.sbin/bind/lib/isc/unix/socket.c","cmsg_len",524,537
16,3,121,1,25,"cmsg_space@540-565@usr.sbin/bind/lib/isc/unix/socket.c","usr.sbin/bind/lib/isc/unix/socket.c","cmsg_space",540,565
48,21,305,3,88,"process_cmsg@572-660@usr.sbin/bind/lib/isc/unix/socket.c","usr.sbin/bind/lib/isc/unix/socket.c","process_cmsg",572,660
77,12,543,5,104,"build_msghdr_send@675-779@usr.sbin/bind/lib/isc/unix/socket.c","usr.sbin/bind/lib/isc/unix/socket.c","build_msghdr_send",675,779
78,19,609,5,118,"build_msghdr_recv@794-912@usr.sbin/bind/lib/isc/unix/socket.c","usr.sbin/bind/lib/isc/unix/socket.c","build_msghdr_recv",794,912
13,4,74,3,12,"set_dev_address@915-927@usr.sbin/bind/lib/isc/unix/socket.c","usr.sbin/bind/lib/isc/unix/socket.c","set_dev_address",915,927
5,1,37,1,6,"destroy_socketevent@930-936@usr.sbin/bind/lib/isc/unix/socket.c","usr.sbin/bind/lib/isc/unix/socket.c","destroy_socketevent",930,936
21,2,128,4,24,"allocate_socketevent@939-963@usr.sbin/bind/lib/isc/unix/socket.c","usr.sbin/bind/lib/isc/unix/socket.c","allocate_socketevent",939,963
12,3,103,1,14,"dump_msg@967-981@usr.sbin/bind/lib/isc/unix/socket.c","usr.sbin/bind/lib/isc/unix/socket.c","dump_msg",967,981
81,21,519,2,144,"doio_recv@990-1134@usr.sbin/bind/lib/isc/unix/socket.c","usr.sbin/bind/lib/isc/unix/socket.c","doio_recv",990,1134
47,8,306,2,93,"doio_send@1150-1243@usr.sbin/bind/lib/isc/unix/socket.c","usr.sbin/bind/lib/isc/unix/socket.c","doio_send",1150,1243
20,4,178,1,36,"destroy@1252-1288@usr.sbin/bind/lib/isc/unix/socket.c","usr.sbin/bind/lib/isc/unix/socket.c","destroy",1252,1288
70,12,464,3,103,"allocate_socket@1291-1394@usr.sbin/bind/lib/isc/unix/socket.c","usr.sbin/bind/lib/isc/unix/socket.c","allocate_socket",1291,1394
23,3,191,1,28,"free_socket@1404-1432@usr.sbin/bind/lib/isc/unix/socket.c","usr.sbin/bind/lib/isc/unix/socket.c","free_socket",1404,1432
14,6,93,1,18,"clear_bsdcompat@1451-1469@usr.sbin/bind/lib/isc/unix/socket.c","usr.sbin/bind/lib/isc/unix/socket.c","clear_bsdcompat",1451,1469
184,55,1116,4,250,"isc_socket_create@1479-1729@usr.sbin/bind/lib/isc/unix/socket.c","usr.sbin/bind/lib/isc/unix/socket.c","isc_socket_create",1479,1729
8,2,58,2,9,"isc_socket_attach@1735-1744@usr.sbin/bind/lib/isc/unix/socket.c","usr.sbin/bind/lib/isc/unix/socket.c","isc_socket_attach",1735,1744
16,3,94,1,19,"isc_socket_detach@1751-1770@usr.sbin/bind/lib/isc/unix/socket.c","usr.sbin/bind/lib/isc/unix/socket.c","isc_socket_detach",1751,1770
17,2,114,1,22,"dispatch_recv@1781-1803@usr.sbin/bind/lib/isc/unix/socket.c","usr.sbin/bind/lib/isc/unix/socket.c","dispatch_recv",1781,1803
17,2,114,1,22,"dispatch_send@1806-1828@usr.sbin/bind/lib/isc/unix/socket.c","usr.sbin/bind/lib/isc/unix/socket.c","dispatch_send",1806,1828
15,2,91,1,23,"dispatch_accept@1834-1857@usr.sbin/bind/lib/isc/unix/socket.c","usr.sbin/bind/lib/isc/unix/socket.c","dispatch_accept",1834,1857
13,1,80,1,17,"dispatch_connect@1860-1877@usr.sbin/bind/lib/isc/unix/socket.c","usr.sbin/bind/lib/isc/unix/socket.c","dispatch_connect",1860,1877
12,3,95,2,15,"send_recvdone_event@1890-1905@usr.sbin/bind/lib/isc/unix/socket.c","usr.sbin/bind/lib/isc/unix/socket.c","send_recvdone_event",1890,1905
13,4,107,2,16,"send_senddone_event@1913-1929@usr.sbin/bind/lib/isc/unix/socket.c","usr.sbin/bind/lib/isc/unix/socket.c","send_senddone_event",1913,1929
160,33,909,2,224,"internal_accept@1943-2167@usr.sbin/bind/lib/isc/unix/socket.c","usr.sbin/bind/lib/isc/unix/socket.c","internal_accept",1943,2167
43,9,258,2,62,"internal_recv@2170-2232@usr.sbin/bind/lib/isc/unix/socket.c","usr.sbin/bind/lib/isc/unix/socket.c","internal_recv",2170,2232
36,7,223,2,52,"internal_send@2235-2287@usr.sbin/bind/lib/isc/unix/socket.c","usr.sbin/bind/lib/isc/unix/socket.c","internal_send",2235,2287
56,16,316,4,67,"process_fds@2290-2357@usr.sbin/bind/lib/isc/unix/socket.c","usr.sbin/bind/lib/isc/unix/socket.c","process_fds",2290,2357
63,9,331,1,98,"watcher@2368-2466@usr.sbin/bind/lib/isc/unix/socket.c","usr.sbin/bind/lib/isc/unix/socket.c","watcher",2368,2466
4,1,25,2,5,"isc__socketmgr_setreserved@2470-2475@usr.sbin/bind/lib/isc/unix/socket.c","usr.sbin/bind/lib/isc/unix/socket.c","isc__socketmgr_setreserved",2470,2475
37,8,268,2,45,"create_fdsets@2481-2526@usr.sbin/bind/lib/isc/unix/socket.c","usr.sbin/bind/lib/isc/unix/socket.c","create_fdsets",2481,2526
18,7,162,2,17,"cleanup_fdsets@2532-2549@usr.sbin/bind/lib/isc/unix/socket.c","usr.sbin/bind/lib/isc/unix/socket.c","cleanup_fdsets",2532,2549
77,21,681,3,89,"expand_fdsets@2555-2644@usr.sbin/bind/lib/isc/unix/socket.c","usr.sbin/bind/lib/isc/unix/socket.c","expand_fdsets",2555,2644
79,14,594,2,116,"isc_socketmgr_create@2651-2767@usr.sbin/bind/lib/isc/unix/socket.c","usr.sbin/bind/lib/isc/unix/socket.c","isc_socketmgr_create",2651,2767
48,10,321,1,89,"isc_socketmgr_destroy@2770-2859@usr.sbin/bind/lib/isc/unix/socket.c","usr.sbin/bind/lib/isc/unix/socket.c","isc_socketmgr_destroy",2770,2859
47,12,266,4,69,"socket_recv@2862-2931@usr.sbin/bind/lib/isc/unix/socket.c","usr.sbin/bind/lib/isc/unix/socket.c","socket_recv",2862,2931
38,5,239,6,51,"isc_socket_recvv@2934-2985@usr.sbin/bind/lib/isc/unix/socket.c","usr.sbin/bind/lib/isc/unix/socket.c","isc_socket_recvv",2934,2985
15,2,114,6,19,"isc_socket_recv@2988-3007@usr.sbin/bind/lib/isc/unix/socket.c","usr.sbin/bind/lib/isc/unix/socket.c","isc_socket_recv",2988,3007
21,3,124,6,25,"isc_socket_recv2@3010-3035@usr.sbin/bind/lib/isc/unix/socket.c","usr.sbin/bind/lib/isc/unix/socket.c","isc_socket_recv2",3010,3035
62,15,358,6,88,"socket_send@3038-3126@usr.sbin/bind/lib/isc/unix/socket.c","usr.sbin/bind/lib/isc/unix/socket.c","socket_send",3038,3126
6,1,44,5,8,"isc_socket_send@3129-3137@usr.sbin/bind/lib/isc/unix/socket.c","usr.sbin/bind/lib/isc/unix/socket.c","isc_socket_send",3129,3137
20,2,142,7,25,"isc_socket_sendto@3140-3165@usr.sbin/bind/lib/isc/unix/socket.c","usr.sbin/bind/lib/isc/unix/socket.c","isc_socket_sendto",3140,3165
6,1,44,5,5,"isc_socket_sendv@3168-3173@usr.sbin/bind/lib/isc/unix/socket.c","usr.sbin/bind/lib/isc/unix/socket.c","isc_socket_sendv",3168,3173
29,3,205,7,37,"isc_socket_sendtov@3176-3213@usr.sbin/bind/lib/isc/unix/socket.c","usr.sbin/bind/lib/isc/unix/socket.c","isc_socket_sendtov",3176,3213
17,2,129,7,17,"isc_socket_sendto2@3216-3233@usr.sbin/bind/lib/isc/unix/socket.c","usr.sbin/bind/lib/isc/unix/socket.c","isc_socket_sendto2",3216,3233
91,22,528,2,127,"isc_socket_cleanunix@3236-3363@usr.sbin/bind/lib/isc/unix/socket.c","usr.sbin/bind/lib/isc/unix/socket.c","isc_socket_cleanunix",3236,3363
42,8,281,4,51,"isc_socket_permunix@3366-3417@usr.sbin/bind/lib/isc/unix/socket.c","usr.sbin/bind/lib/isc/unix/socket.c","isc_socket_permunix",3366,3417
48,14,314,3,60,"isc_socket_bind@3420-3480@usr.sbin/bind/lib/isc/unix/socket.c","usr.sbin/bind/lib/isc/unix/socket.c","isc_socket_bind",3420,3480
4,1,16,1,3,"isc_socket_privsep@3483-3486@usr.sbin/bind/lib/isc/unix/socket.c","usr.sbin/bind/lib/isc/unix/socket.c","isc_socket_privsep",3483,3486
19,4,140,2,26,"isc_socket_filter@3489-3515@usr.sbin/bind/lib/isc/unix/socket.c","usr.sbin/bind/lib/isc/unix/socket.c","isc_socket_filter",3489,3515
20,4,147,2,28,"isc_socket_listen@3528-3556@usr.sbin/bind/lib/isc/unix/socket.c","usr.sbin/bind/lib/isc/unix/socket.c","isc_socket_listen",3528,3556
40,5,259,4,63,"isc_socket_accept@3562-3625@usr.sbin/bind/lib/isc/unix/socket.c","usr.sbin/bind/lib/isc/unix/socket.c","isc_socket_accept",3562,3625
76,9,507,5,116,"isc_socket_connect@3628-3744@usr.sbin/bind/lib/isc/unix/socket.c","usr.sbin/bind/lib/isc/unix/socket.c","isc_socket_connect",3628,3744
75,8,455,2,108,"internal_connect@3750-3858@usr.sbin/bind/lib/isc/unix/socket.c","usr.sbin/bind/lib/isc/unix/socket.c","internal_connect",3750,3858
14,2,77,2,18,"isc_socket_getpeername@3861-3879@usr.sbin/bind/lib/isc/unix/socket.c","usr.sbin/bind/lib/isc/unix/socket.c","isc_socket_getpeername",3861,3879
25,3,158,2,31,"isc_socket_getsockname@3882-3913@usr.sbin/bind/lib/isc/unix/socket.c","usr.sbin/bind/lib/isc/unix/socket.c","isc_socket_getsockname",3882,3913
77,21,483,3,117,"isc_socket_cancel@3920-4037@usr.sbin/bind/lib/isc/unix/socket.c","usr.sbin/bind/lib/isc/unix/socket.c","isc_socket_cancel",3920,4037
4,1,23,1,4,"isc_socket_gettype@4040-4044@usr.sbin/bind/lib/isc/unix/socket.c","usr.sbin/bind/lib/isc/unix/socket.c","isc_socket_gettype",4040,4044
7,2,46,1,8,"isc_socket_isbound@4047-4055@usr.sbin/bind/lib/isc/unix/socket.c","usr.sbin/bind/lib/isc/unix/socket.c","isc_socket_isbound",4047,4055
10,5,74,2,16,"isc_socket_ipv6only@4058-4074@usr.sbin/bind/lib/isc/unix/socket.c","usr.sbin/bind/lib/isc/unix/socket.c","isc_socket_ipv6only",4058,4074
13,2,83,3,13,"isc__socketmgr_getfdsets@4078-4091@usr.sbin/bind/lib/isc/unix/socket.c","usr.sbin/bind/lib/isc/unix/socket.c","isc__socketmgr_getfdsets",4078,4091
7,2,48,3,8,"isc__socketmgr_dispatch@4094-4102@usr.sbin/bind/lib/isc/unix/socket.c","usr.sbin/bind/lib/isc/unix/socket.c","isc__socketmgr_dispatch",4094,4102
8,2,55,3,8,"isc_stdio_open@30-38@usr.sbin/bind/lib/isc/unix/stdio.c","usr.sbin/bind/lib/isc/unix/stdio.c","isc_stdio_open",30,38
8,2,38,1,8,"isc_stdio_close@41-49@usr.sbin/bind/lib/isc/unix/stdio.c","usr.sbin/bind/lib/isc/unix/stdio.c","isc_stdio_close",41,49
8,2,48,3,8,"isc_stdio_seek@52-60@usr.sbin/bind/lib/isc/unix/stdio.c","usr.sbin/bind/lib/isc/unix/stdio.c","isc_stdio_seek",52,60
15,4,91,5,15,"isc_stdio_read@63-78@usr.sbin/bind/lib/isc/unix/stdio.c","usr.sbin/bind/lib/isc/unix/stdio.c","isc_stdio_read",63,78
13,3,78,5,13,"isc_stdio_write@81-94@usr.sbin/bind/lib/isc/unix/stdio.c","usr.sbin/bind/lib/isc/unix/stdio.c","isc_stdio_write",81,94
8,2,38,1,8,"isc_stdio_flush@97-105@usr.sbin/bind/lib/isc/unix/stdio.c","usr.sbin/bind/lib/isc/unix/stdio.c","isc_stdio_flush",97,105
8,2,41,1,8,"isc_stdio_sync@108-116@usr.sbin/bind/lib/isc/unix/stdio.c","usr.sbin/bind/lib/isc/unix/stdio.c","isc_stdio_sync",108,116
18,6,105,1,21,"fix_tv_usec@41-62@usr.sbin/bind/lib/isc/unix/stdtime.c","usr.sbin/bind/lib/isc/unix/stdtime.c","fix_tv_usec",41,62
9,3,74,1,20,"isc_stdtime_get@66-86@usr.sbin/bind/lib/isc/unix/stdtime.c","usr.sbin/bind/lib/isc/unix/stdtime.c","isc_stdtime_get",66,86
3,1,17,1,2,"init_lock@38-40@usr.sbin/bind/lib/isc/unix/strerror.c","usr.sbin/bind/lib/isc/unix/strerror.c","init_lock",38,40
20,5,147,3,27,"isc__strerror@47-74@usr.sbin/bind/lib/isc/unix/strerror.c","usr.sbin/bind/lib/isc/unix/strerror.c","isc__strerror",47,74
12,3,88,2,14,"isc_syslog_facilityfromstring@70-84@usr.sbin/bind/lib/isc/unix/syslog.c","usr.sbin/bind/lib/isc/unix/syslog.c","isc_syslog_facilityfromstring",70,84
18,6,105,1,21,"fix_tv_usec@62-83@usr.sbin/bind/lib/isc/unix/time.c","usr.sbin/bind/lib/isc/unix/time.c","fix_tv_usec",62,83
8,1,42,3,8,"isc_interval_set@87-95@usr.sbin/bind/lib/isc/unix/time.c","usr.sbin/bind/lib/isc/unix/time.c","isc_interval_set",87,95
7,3,49,1,8,"isc_interval_iszero@98-106@usr.sbin/bind/lib/isc/unix/time.c","usr.sbin/bind/lib/isc/unix/time.c","isc_interval_iszero",98,106
6,1,42,3,6,"isc_time_set@117-123@usr.sbin/bind/lib/isc/unix/time.c","usr.sbin/bind/lib/isc/unix/time.c","isc_time_set",117,123
5,1,27,1,5,"isc_time_settoepoch@126-131@usr.sbin/bind/lib/isc/unix/time.c","usr.sbin/bind/lib/isc/unix/time.c","isc_time_settoepoch",126,131
7,3,49,1,8,"isc_time_isepoch@134-142@usr.sbin/bind/lib/isc/unix/time.c","usr.sbin/bind/lib/isc/unix/time.c","isc_time_isepoch",134,142
21,9,180,1,39,"isc_time_now@146-185@usr.sbin/bind/lib/isc/unix/time.c","usr.sbin/bind/lib/isc/unix/time.c","isc_time_now",146,185
27,11,222,2,48,"isc_time_nowplusinterval@188-236@usr.sbin/bind/lib/isc/unix/time.c","usr.sbin/bind/lib/isc/unix/time.c","isc_time_nowplusinterval",188,236
13,7,107,2,13,"isc_time_compare@239-252@usr.sbin/bind/lib/isc/unix/time.c","usr.sbin/bind/lib/isc/unix/time.c","isc_time_compare",239,252
15,8,135,3,23,"isc_time_add@255-278@usr.sbin/bind/lib/isc/unix/time.c","usr.sbin/bind/lib/isc/unix/time.c","isc_time_add",255,278
19,8,150,3,21,"isc_time_subtract@281-302@usr.sbin/bind/lib/isc/unix/time.c","usr.sbin/bind/lib/isc/unix/time.c","isc_time_subtract",281,302
12,4,109,2,20,"isc_time_microdiff@305-325@usr.sbin/bind/lib/isc/unix/time.c","usr.sbin/bind/lib/isc/unix/time.c","isc_time_microdiff",305,325
5,1,35,1,5,"isc_time_seconds@328-333@usr.sbin/bind/lib/isc/unix/time.c","usr.sbin/bind/lib/isc/unix/time.c","isc_time_seconds",328,333
19,4,150,2,52,"isc_time_secondsastimet@336-388@usr.sbin/bind/lib/isc/unix/time.c","usr.sbin/bind/lib/isc/unix/time.c","isc_time_secondsastimet",336,388
5,1,35,1,6,"isc_time_nanoseconds@391-397@usr.sbin/bind/lib/isc/unix/time.c","usr.sbin/bind/lib/isc/unix/time.c","isc_time_nanoseconds",391,397
13,2,99,3,14,"isc_time_formattimestamp@400-414@usr.sbin/bind/lib/isc/unix/time.c","usr.sbin/bind/lib/isc/unix/time.c","isc_time_formattimestamp",400,414
10,2,48,2,13,"isc_atomic_xadd@31-44@usr.sbin/bind/lib/isc/x86_32/include/isc/atomic.h","usr.sbin/bind/lib/isc/x86_32/include/isc/atomic.h","isc_atomic_xadd",31,44
8,2,32,2,14,"isc_atomic_store@50-64@usr.sbin/bind/lib/isc/x86_32/include/isc/atomic.h","usr.sbin/bind/lib/isc/x86_32/include/isc/atomic.h","isc_atomic_store",50,64
9,2,49,3,11,"isc_atomic_cmpxchg@72-83@usr.sbin/bind/lib/isc/x86_32/include/isc/atomic.h","usr.sbin/bind/lib/isc/x86_32/include/isc/atomic.h","isc_atomic_cmpxchg",72,83
11,2,30,2,19,"isc_atomic_xadd@96-115@usr.sbin/bind/lib/isc/x86_32/include/isc/atomic.h","usr.sbin/bind/lib/isc/x86_32/include/isc/atomic.h","isc_atomic_xadd",96,115
10,2,29,2,12,"isc_atomic_store@118-130@usr.sbin/bind/lib/isc/x86_32/include/isc/atomic.h","usr.sbin/bind/lib/isc/x86_32/include/isc/atomic.h","isc_atomic_store",118,130
12,2,38,3,19,"isc_atomic_cmpxchg@133-152@usr.sbin/bind/lib/isc/x86_32/include/isc/atomic.h","usr.sbin/bind/lib/isc/x86_32/include/isc/atomic.h","isc_atomic_cmpxchg",133,152
10,2,29,2,18,"isc_atomic_xadd@41-59@usr.sbin/bind/lib/isc/x86_64/include/isc/atomic.h","usr.sbin/bind/lib/isc/x86_64/include/isc/atomic.h","isc_atomic_xadd",41,59
10,2,29,2,12,"isc_atomic_store@62-74@usr.sbin/bind/lib/isc/x86_64/include/isc/atomic.h","usr.sbin/bind/lib/isc/x86_64/include/isc/atomic.h","isc_atomic_store",62,74
12,2,38,3,19,"isc_atomic_cmpxchg@77-96@usr.sbin/bind/lib/isc/x86_64/include/isc/atomic.h","usr.sbin/bind/lib/isc/x86_64/include/isc/atomic.h","isc_atomic_cmpxchg",77,96
6,2,22,1,5,"isc_assertion_setcallback@45-50@usr.sbin/bind/lib/isc/assertions.c","usr.sbin/bind/lib/isc/assertions.c","isc_assertion_setcallback",45,50
20,5,65,1,25,"isc_assertion_typetotext@54-79@usr.sbin/bind/lib/isc/assertions.c","usr.sbin/bind/lib/isc/assertions.c","isc_assertion_typetotext",54,79
10,1,58,4,10,"default_callback@86-96@usr.sbin/bind/lib/isc/assertions.c","usr.sbin/bind/lib/isc/assertions.c","default_callback",86,96
60,12,667,6,62,"base32_totext@56-118@usr.sbin/bind/lib/isc/base32.c","usr.sbin/bind/lib/isc/base32.c","base32_totext",56,118
6,1,38,4,5,"isc_base32_totext@121-126@usr.sbin/bind/lib/isc/base32.c","usr.sbin/bind/lib/isc/base32.c","isc_base32_totext",121,126
6,1,38,4,5,"isc_base32hex_totext@129-134@usr.sbin/bind/lib/isc/base32.c","usr.sbin/bind/lib/isc/base32.c","isc_base32hex_totext",129,134
6,1,38,4,5,"isc_base32hexnp_totext@137-142@usr.sbin/bind/lib/isc/base32.c","usr.sbin/bind/lib/isc/base32.c","isc_base32hexnp_totext",137,142
11,1,66,5,10,"base32_decode_init@159-169@usr.sbin/bind/lib/isc/base32.c","usr.sbin/bind/lib/isc/base32.c","base32_decode_init",159,169
68,27,565,2,92,"base32_decode_char@172-264@usr.sbin/bind/lib/isc/base32.c","usr.sbin/bind/lib/isc/base32.c","base32_decode_char",172,264
13,6,82,1,16,"base32_decode_finish@267-283@usr.sbin/bind/lib/isc/base32.c","usr.sbin/bind/lib/isc/base32.c","base32_decode_finish",267,283
27,8,187,5,29,"base32_tobuffer@286-315@usr.sbin/bind/lib/isc/base32.c","usr.sbin/bind/lib/isc/base32.c","base32_tobuffer",286,315
3,1,31,3,2,"isc_base32_tobuffer@318-320@usr.sbin/bind/lib/isc/base32.c","usr.sbin/bind/lib/isc/base32.c","isc_base32_tobuffer",318,320
3,1,31,3,2,"isc_base32hex_tobuffer@323-325@usr.sbin/bind/lib/isc/base32.c","usr.sbin/bind/lib/isc/base32.c","isc_base32hex_tobuffer",323,325
3,1,31,3,2,"isc_base32hexnp_tobuffer@328-330@usr.sbin/bind/lib/isc/base32.c","usr.sbin/bind/lib/isc/base32.c","isc_base32hexnp_tobuffer",328,330
16,7,107,4,16,"base32_decodestring@333-349@usr.sbin/bind/lib/isc/base32.c","usr.sbin/bind/lib/isc/base32.c","base32_decodestring",333,349
3,1,27,2,2,"isc_base32_decodestring@352-354@usr.sbin/bind/lib/isc/base32.c","usr.sbin/bind/lib/isc/base32.c","isc_base32_decodestring",352,354
3,1,27,2,2,"isc_base32hex_decodestring@357-359@usr.sbin/bind/lib/isc/base32.c","usr.sbin/bind/lib/isc/base32.c","isc_base32hex_decodestring",357,359
3,1,27,2,2,"isc_base32hexnp_decodestring@362-364@usr.sbin/bind/lib/isc/base32.c","usr.sbin/bind/lib/isc/base32.c","isc_base32hexnp_decodestring",362,364
13,2,89,4,13,"base32_decoderegion@367-380@usr.sbin/bind/lib/isc/base32.c","usr.sbin/bind/lib/isc/base32.c","base32_decoderegion",367,380
3,1,26,2,2,"isc_base32_decoderegion@383-385@usr.sbin/bind/lib/isc/base32.c","usr.sbin/bind/lib/isc/base32.c","isc_base32_decoderegion",383,385
3,1,26,2,2,"isc_base32hex_decoderegion@388-390@usr.sbin/bind/lib/isc/base32.c","usr.sbin/bind/lib/isc/base32.c","isc_base32hex_decoderegion",388,390
3,1,26,2,2,"isc_base32hexnp_decoderegion@393-395@usr.sbin/bind/lib/isc/base32.c","usr.sbin/bind/lib/isc/base32.c","isc_base32hexnp_decoderegion",393,395
11,2,71,2,13,"str_totext@398-411@usr.sbin/bind/lib/isc/base32.c","usr.sbin/bind/lib/isc/base32.c","str_totext",398,411
9,2,63,3,9,"mem_tobuffer@414-423@usr.sbin/bind/lib/isc/base32.c","usr.sbin/bind/lib/isc/base32.c","mem_tobuffer",414,423
40,7,439,4,42,"isc_base64_totext@53-95@usr.sbin/bind/lib/isc/base64.c","usr.sbin/bind/lib/isc/base64.c","isc_base64_totext",53,95
7,1,39,3,6,"base64_decode_init@109-115@usr.sbin/bind/lib/isc/base64.c","usr.sbin/bind/lib/isc/base64.c","base64_decode_init",109,115
41,19,411,2,48,"base64_decode_char@118-166@usr.sbin/bind/lib/isc/base64.c","usr.sbin/bind/lib/isc/base64.c","base64_decode_char",118,166
7,3,39,1,6,"base64_decode_finish@169-175@usr.sbin/bind/lib/isc/base64.c","usr.sbin/bind/lib/isc/base64.c","base64_decode_finish",169,175
25,8,174,3,27,"isc_base64_tobuffer@178-205@usr.sbin/bind/lib/isc/base64.c","usr.sbin/bind/lib/isc/base64.c","isc_base64_tobuffer",178,205
14,7,94,2,14,"isc_base64_decodestring@208-222@usr.sbin/bind/lib/isc/base64.c","usr.sbin/bind/lib/isc/base64.c","isc_base64_decodestring",208,222
11,2,71,2,13,"str_totext@225-238@usr.sbin/bind/lib/isc/base64.c","usr.sbin/bind/lib/isc/base64.c","str_totext",225,238
9,2,63,3,9,"mem_tobuffer@241-250@usr.sbin/bind/lib/isc/base64.c","usr.sbin/bind/lib/isc/base64.c","mem_tobuffer",241,250
12,1,75,5,19,"isc_bitstring_init@43-62@usr.sbin/bind/lib/isc/bitstring.c","usr.sbin/bind/lib/isc/bitstring.c","isc_bitstring_init",43,62
8,1,46,1,13,"isc_bitstring_invalidate@65-78@usr.sbin/bind/lib/isc/bitstring.c","usr.sbin/bind/lib/isc/bitstring.c","isc_bitstring_invalidate",65,78
35,6,216,5,46,"isc_bitstring_copy@81-127@usr.sbin/bind/lib/isc/bitstring.c","usr.sbin/bind/lib/isc/bitstring.c","isc_bitstring_copy",81,127
4,1,33,3,9,"isc__buffer_init@31-40@usr.sbin/bind/lib/isc/buffer.c","usr.sbin/bind/lib/isc/buffer.c","isc__buffer_init",31,40
6,1,41,1,10,"isc__buffer_invalidate@43-53@usr.sbin/bind/lib/isc/buffer.c","usr.sbin/bind/lib/isc/buffer.c","isc__buffer_invalidate",43,53
5,1,34,2,9,"isc__buffer_region@56-65@usr.sbin/bind/lib/isc/buffer.c","usr.sbin/bind/lib/isc/buffer.c","isc__buffer_region",56,65
5,1,34,2,9,"isc__buffer_usedregion@68-77@usr.sbin/bind/lib/isc/buffer.c","usr.sbin/bind/lib/isc/buffer.c","isc__buffer_usedregion",68,77
5,1,34,2,9,"isc__buffer_availableregion@80-89@usr.sbin/bind/lib/isc/buffer.c","usr.sbin/bind/lib/isc/buffer.c","isc__buffer_availableregion",80,89
5,1,40,2,9,"isc__buffer_add@92-101@usr.sbin/bind/lib/isc/buffer.c","usr.sbin/bind/lib/isc/buffer.c","isc__buffer_add",92,101
5,1,36,2,9,"isc__buffer_subtract@104-113@usr.sbin/bind/lib/isc/buffer.c","usr.sbin/bind/lib/isc/buffer.c","isc__buffer_subtract",104,113
4,1,21,1,8,"isc__buffer_clear@116-124@usr.sbin/bind/lib/isc/buffer.c","usr.sbin/bind/lib/isc/buffer.c","isc__buffer_clear",116,124
5,1,34,2,9,"isc__buffer_consumedregion@127-136@usr.sbin/bind/lib/isc/buffer.c","usr.sbin/bind/lib/isc/buffer.c","isc__buffer_consumedregion",127,136
5,1,34,2,9,"isc__buffer_remainingregion@139-148@usr.sbin/bind/lib/isc/buffer.c","usr.sbin/bind/lib/isc/buffer.c","isc__buffer_remainingregion",139,148
5,1,34,2,9,"isc__buffer_activeregion@151-160@usr.sbin/bind/lib/isc/buffer.c","usr.sbin/bind/lib/isc/buffer.c","isc__buffer_activeregion",151,160
5,1,40,2,9,"isc__buffer_setactive@163-172@usr.sbin/bind/lib/isc/buffer.c","usr.sbin/bind/lib/isc/buffer.c","isc__buffer_setactive",163,172
4,1,21,1,8,"isc__buffer_first@175-183@usr.sbin/bind/lib/isc/buffer.c","usr.sbin/bind/lib/isc/buffer.c","isc__buffer_first",175,183
5,1,40,2,9,"isc__buffer_forward@186-195@usr.sbin/bind/lib/isc/buffer.c","usr.sbin/bind/lib/isc/buffer.c","isc__buffer_forward",186,195
5,1,36,2,9,"isc__buffer_back@198-207@usr.sbin/bind/lib/isc/buffer.c","usr.sbin/bind/lib/isc/buffer.c","isc__buffer_back",198,207
14,2,92,1,22,"isc_buffer_compact@210-232@usr.sbin/bind/lib/isc/buffer.c","usr.sbin/bind/lib/isc/buffer.c","isc_buffer_compact",210,232
10,1,69,1,16,"isc_buffer_getuint8@235-251@usr.sbin/bind/lib/isc/buffer.c","usr.sbin/bind/lib/isc/buffer.c","isc_buffer_getuint8",235,251
5,1,39,2,5,"isc__buffer_putuint8@254-259@usr.sbin/bind/lib/isc/buffer.c","usr.sbin/bind/lib/isc/buffer.c","isc__buffer_putuint8",254,259
11,1,88,1,18,"isc_buffer_getuint16@262-280@usr.sbin/bind/lib/isc/buffer.c","usr.sbin/bind/lib/isc/buffer.c","isc_buffer_getuint16",262,280
5,1,39,2,5,"isc__buffer_putuint16@283-288@usr.sbin/bind/lib/isc/buffer.c","usr.sbin/bind/lib/isc/buffer.c","isc__buffer_putuint16",283,288
13,1,124,1,20,"isc_buffer_getuint32@291-311@usr.sbin/bind/lib/isc/buffer.c","usr.sbin/bind/lib/isc/buffer.c","isc_buffer_getuint32",291,311
5,1,39,2,5,"isc__buffer_putuint32@314-319@usr.sbin/bind/lib/isc/buffer.c","usr.sbin/bind/lib/isc/buffer.c","isc__buffer_putuint32",314,319
7,1,48,3,7,"isc__buffer_putmem@322-329@usr.sbin/bind/lib/isc/buffer.c","usr.sbin/bind/lib/isc/buffer.c","isc__buffer_putmem",322,329
11,1,76,2,17,"isc__buffer_putstr@332-349@usr.sbin/bind/lib/isc/buffer.c","usr.sbin/bind/lib/isc/buffer.c","isc__buffer_putstr",332,349
13,2,90,2,18,"isc_buffer_copyregion@352-370@usr.sbin/bind/lib/isc/buffer.c","usr.sbin/bind/lib/isc/buffer.c","isc_buffer_copyregion",352,370
15,2,97,3,19,"isc_buffer_allocate@373-392@usr.sbin/bind/lib/isc/buffer.c","usr.sbin/bind/lib/isc/buffer.c","isc_buffer_allocate",373,392
15,1,95,1,18,"isc_buffer_free@395-413@usr.sbin/bind/lib/isc/buffer.c","usr.sbin/bind/lib/isc/buffer.c","isc_buffer_free",395,413
13,2,72,1,15,"isc_bufferlist_usedcount@31-46@usr.sbin/bind/lib/isc/bufferlist.c","usr.sbin/bind/lib/isc/bufferlist.c","isc_bufferlist_usedcount",31,46
13,2,72,1,15,"isc_bufferlist_availablecount@49-64@usr.sbin/bind/lib/isc/bufferlist.c","usr.sbin/bind/lib/isc/bufferlist.c","isc_bufferlist_availablecount",49,64
63,22,328,3,123,"isc_commandline_parse@99-222@usr.sbin/bind/lib/isc/commandline.c","usr.sbin/bind/lib/isc/commandline.c","isc_commandline_parse",99,222
8,1,72,2,8,"samplequeue_release@194-202@usr.sbin/bind/lib/isc/entropy.c","usr.sbin/bind/lib/isc/entropy.c","samplequeue_release",194,202
13,3,102,2,15,"samplesource_allocate@205-220@usr.sbin/bind/lib/isc/entropy.c","usr.sbin/bind/lib/isc/entropy.c","samplesource_allocate",205,220
5,1,41,2,7,"add_entropy@227-234@usr.sbin/bind/lib/isc/entropy.c","usr.sbin/bind/lib/isc/entropy.c","add_entropy",227,234
4,1,32,2,3,"subtract_entropy@240-243@usr.sbin/bind/lib/isc/entropy.c","usr.sbin/bind/lib/isc/entropy.c","subtract_entropy",240,243
5,1,45,2,7,"add_pseudo@250-257@usr.sbin/bind/lib/isc/entropy.c","usr.sbin/bind/lib/isc/entropy.c","add_pseudo",250,257
4,1,32,2,3,"subtract_pseudo@263-266@usr.sbin/bind/lib/isc/entropy.c","usr.sbin/bind/lib/isc/entropy.c","subtract_pseudo",263,266
13,2,180,2,29,"entropypool_add_word@272-301@usr.sbin/bind/lib/isc/entropy.c","usr.sbin/bind/lib/isc/entropy.c","entropypool_add_word",272,301
43,10,237,4,50,"entropypool_adddata@309-359@usr.sbin/bind/lib/isc/entropy.c","usr.sbin/bind/lib/isc/entropy.c","entropypool_adddata",309,359
16,4,114,1,23,"reseed@362-385@usr.sbin/bind/lib/isc/entropy.c","usr.sbin/bind/lib/isc/entropy.c","reseed",362,385
23,8,134,2,44,"estimate_entropy@388-432@usr.sbin/bind/lib/isc/entropy.c","usr.sbin/bind/lib/isc/entropy.c","estimate_entropy",388,432
22,5,217,2,37,"crunchsamples@435-472@usr.sbin/bind/lib/isc/entropy.c","usr.sbin/bind/lib/isc/entropy.c","crunchsamples",435,472
33,11,208,3,38,"get_from_callback@475-513@usr.sbin/bind/lib/isc/entropy.c","usr.sbin/bind/lib/isc/entropy.c","get_from_callback",475,513
73,12,504,5,123,"isc_entropy_getdata@527-650@usr.sbin/bind/lib/isc/entropy.c","usr.sbin/bind/lib/isc/entropy.c","isc_entropy_getdata",527,650
7,1,45,1,6,"isc_entropypool_init@653-659@usr.sbin/bind/lib/isc/entropy.c","usr.sbin/bind/lib/isc/entropy.c","isc_entropypool_init",653,659
7,1,43,1,6,"isc_entropypool_invalidate@662-668@usr.sbin/bind/lib/isc/entropy.c","usr.sbin/bind/lib/isc/entropy.c","isc_entropypool_invalidate",662,668
27,4,176,2,40,"isc_entropy_create@671-711@usr.sbin/bind/lib/isc/entropy.c","usr.sbin/bind/lib/isc/entropy.c","isc_entropy_create",671,711
35,9,219,1,39,"destroysource@717-756@usr.sbin/bind/lib/isc/entropy.c","usr.sbin/bind/lib/isc/entropy.c","destroysource",717,756
17,5,79,1,19,"destroy_check@759-778@usr.sbin/bind/lib/isc/entropy.c","usr.sbin/bind/lib/isc/entropy.c","destroy_check",759,778
28,5,177,1,43,"destroy@781-824@usr.sbin/bind/lib/isc/entropy.c","usr.sbin/bind/lib/isc/entropy.c","destroy",781,824
17,2,98,1,24,"isc_entropy_destroysource@827-851@usr.sbin/bind/lib/isc/entropy.c","usr.sbin/bind/lib/isc/entropy.c","isc_entropy_destroysource",827,851
46,5,282,6,64,"isc_entropy_createcallbacksource@854-918@usr.sbin/bind/lib/isc/entropy.c","usr.sbin/bind/lib/isc/entropy.c","isc_entropy_createcallbacksource",854,918
18,5,116,1,22,"isc_entropy_stopcallbacksources@921-943@usr.sbin/bind/lib/isc/entropy.c","usr.sbin/bind/lib/isc/entropy.c","isc_entropy_stopcallbacksources",921,943
35,5,225,2,51,"isc_entropy_createsamplesource@946-997@usr.sbin/bind/lib/isc/entropy.c","usr.sbin/bind/lib/isc/entropy.c","isc_entropy_createsamplesource",946,997
10,3,72,3,12,"addsample@1005-1017@usr.sbin/bind/lib/isc/entropy.c","usr.sbin/bind/lib/isc/entropy.c","addsample",1005,1017
19,2,110,3,24,"isc_entropy_addsample@1020-1044@usr.sbin/bind/lib/isc/entropy.c","usr.sbin/bind/lib/isc/entropy.c","isc_entropy_addsample",1020,1044
11,1,65,3,13,"isc_entropy_addcallbacksample@1047-1060@usr.sbin/bind/lib/isc/entropy.c","usr.sbin/bind/lib/isc/entropy.c","isc_entropy_addcallbacksample",1047,1060
10,2,68,4,13,"isc_entropy_putdata@1063-1076@usr.sbin/bind/lib/isc/entropy.c","usr.sbin/bind/lib/isc/entropy.c","isc_entropy_putdata",1063,1076
13,1,76,2,12,"dumpstats@1079-1091@usr.sbin/bind/lib/isc/entropy.c","usr.sbin/bind/lib/isc/entropy.c","dumpstats",1079,1091
6,1,43,2,6,"isc_entropy_stats@1097-1103@usr.sbin/bind/lib/isc/entropy.c","usr.sbin/bind/lib/isc/entropy.c","isc_entropy_stats",1097,1103
8,2,58,2,10,"isc_entropy_attach@1106-1116@usr.sbin/bind/lib/isc/entropy.c","usr.sbin/bind/lib/isc/entropy.c","isc_entropy_attach",1106,1116
14,3,85,1,19,"isc_entropy_detach@1119-1138@usr.sbin/bind/lib/isc/entropy.c","usr.sbin/bind/lib/isc/entropy.c","isc_entropy_detach",1119,1138
15,4,79,3,23,"kbdstart@1141-1164@usr.sbin/bind/lib/isc/entropy.c","usr.sbin/bind/lib/isc/entropy.c","kbdstart",1141,1164
6,2,48,2,8,"kbdstop@1167-1175@usr.sbin/bind/lib/isc/entropy.c","usr.sbin/bind/lib/isc/entropy.c","kbdstop",1167,1175
24,4,136,3,31,"kbdget@1178-1209@usr.sbin/bind/lib/isc/entropy.c","usr.sbin/bind/lib/isc/entropy.c","kbdget",1178,1209
37,15,196,4,51,"isc_entropy_usebestsource@1212-1263@usr.sbin/bind/lib/isc/entropy.c","usr.sbin/bind/lib/isc/entropy.c","isc_entropy_usebestsource",1212,1263
6,2,22,1,5,"isc_error_setunexpected@45-50@usr.sbin/bind/lib/isc/error.c","usr.sbin/bind/lib/isc/error.c","isc_error_setunexpected",45,50
6,2,22,1,5,"isc_error_setfatal@53-58@usr.sbin/bind/lib/isc/error.c","usr.sbin/bind/lib/isc/error.c","isc_error_setfatal",53,58
6,1,47,4,6,"isc_error_unexpected@61-67@usr.sbin/bind/lib/isc/error.c","usr.sbin/bind/lib/isc/error.c","isc_error_unexpected",61,67
7,1,51,4,7,"isc_error_fatal@70-77@usr.sbin/bind/lib/isc/error.c","usr.sbin/bind/lib/isc/error.c","isc_error_fatal",70,77
5,1,39,3,4,"isc_error_runtimecheck@80-84@usr.sbin/bind/lib/isc/error.c","usr.sbin/bind/lib/isc/error.c","isc_error_runtimecheck",80,84
8,1,52,4,7,"default_unexpected_callback@87-94@usr.sbin/bind/lib/isc/error.c","usr.sbin/bind/lib/isc/error.c","default_unexpected_callback",87,94
10,1,63,4,9,"default_fatal_callback@97-106@usr.sbin/bind/lib/isc/error.c","usr.sbin/bind/lib/isc/error.c","default_fatal_callback",97,106
4,1,27,1,4,"destroy@36-40@usr.sbin/bind/lib/isc/event.c","usr.sbin/bind/lib/isc/event.c","destroy",36,40
15,2,107,6,31,"isc_event_allocate@43-74@usr.sbin/bind/lib/isc/event.c","usr.sbin/bind/lib/isc/event.c","isc_event_allocate",43,74
9,2,53,1,11,"isc_event_free@77-88@usr.sbin/bind/lib/isc/event.c","usr.sbin/bind/lib/isc/event.c","isc_event_free",77,88
10,4,83,3,12,"isc_fsaccess_add@38-50@usr.sbin/bind/lib/isc/fsaccess.c","usr.sbin/bind/lib/isc/fsaccess.c","isc_fsaccess_add",38,50
10,4,83,3,13,"isc_fsaccess_remove@53-66@usr.sbin/bind/lib/isc/fsaccess.c","usr.sbin/bind/lib/isc/fsaccess.c","isc_fsaccess_remove",53,66
21,4,82,2,33,"check_bad_bits@69-102@usr.sbin/bind/lib/isc/fsaccess.c","usr.sbin/bind/lib/isc/fsaccess.c","check_bad_bits",69,102
49,9,318,4,69,"isc_hash_ctxcreate@142-211@usr.sbin/bind/lib/isc/hash.c","usr.sbin/bind/lib/isc/hash.c","isc_hash_ctxcreate",142,211
3,1,17,1,2,"initialize_lock@214-216@usr.sbin/bind/lib/isc/hash.c","usr.sbin/bind/lib/isc/hash.c","initialize_lock",214,216
11,2,84,3,16,"isc_hash_create@219-235@usr.sbin/bind/lib/isc/hash.c","usr.sbin/bind/lib/isc/hash.c","isc_hash_create",219,235
30,5,195,1,36,"isc_hash_ctxinit@238-274@usr.sbin/bind/lib/isc/hash.c","usr.sbin/bind/lib/isc/hash.c","isc_hash_ctxinit",238,274
4,2,22,0,4,"isc_hash_init@277-281@usr.sbin/bind/lib/isc/hash.c","usr.sbin/bind/lib/isc/hash.c","isc_hash_init",277,281
6,2,47,2,6,"isc_hash_ctxattach@284-290@usr.sbin/bind/lib/isc/hash.c","usr.sbin/bind/lib/isc/hash.c","isc_hash_ctxattach",284,290
19,4,143,1,25,"destroy@293-318@usr.sbin/bind/lib/isc/hash.c","usr.sbin/bind/lib/isc/hash.c","destroy",293,318
10,3,62,1,12,"isc_hash_ctxdetach@321-333@usr.sbin/bind/lib/isc/hash.c","usr.sbin/bind/lib/isc/hash.c","isc_hash_ctxdetach",321,333
7,2,45,0,9,"isc_hash_destroy@336-345@usr.sbin/bind/lib/isc/hash.c","usr.sbin/bind/lib/isc/hash.c","isc_hash_destroy",336,345
18,5,141,4,22,"hash_calc@348-370@usr.sbin/bind/lib/isc/hash.c","usr.sbin/bind/lib/isc/hash.c","hash_calc",348,370
7,2,56,4,7,"isc_hash_ctxcalc@373-380@usr.sbin/bind/lib/isc/hash.c","usr.sbin/bind/lib/isc/hash.c","isc_hash_ctxcalc",373,380
7,2,52,3,7,"isc_hash_calc@383-390@usr.sbin/bind/lib/isc/hash.c","usr.sbin/bind/lib/isc/hash.c","isc_hash_calc",383,390
24,4,140,5,27,"isc_heap_create@76-103@usr.sbin/bind/lib/isc/heap.c","usr.sbin/bind/lib/isc/heap.c","isc_heap_create",76,103
12,2,87,1,14,"isc_heap_destroy@106-120@usr.sbin/bind/lib/isc/heap.c","usr.sbin/bind/lib/isc/heap.c","isc_heap_destroy",106,120
17,3,128,1,19,"resize@123-142@usr.sbin/bind/lib/isc/heap.c","usr.sbin/bind/lib/isc/heap.c","resize",123,142
14,5,139,3,15,"float_up@145-160@usr.sbin/bind/lib/isc/heap.c","usr.sbin/bind/lib/isc/heap.c","float_up",145,160
21,7,182,3,22,"sink_down@163-185@usr.sbin/bind/lib/isc/heap.c","usr.sbin/bind/lib/isc/heap.c","sink_down",163,185
9,3,66,2,12,"isc_heap_insert@188-200@usr.sbin/bind/lib/isc/heap.c","usr.sbin/bind/lib/isc/heap.c","isc_heap_insert",188,200
17,4,128,2,18,"isc_heap_delete@203-221@usr.sbin/bind/lib/isc/heap.c","usr.sbin/bind/lib/isc/heap.c","isc_heap_delete",203,221
5,2,47,2,5,"isc_heap_increased@224-229@usr.sbin/bind/lib/isc/heap.c","usr.sbin/bind/lib/isc/heap.c","isc_heap_increased",224,229
5,2,47,2,5,"isc_heap_decreased@232-237@usr.sbin/bind/lib/isc/heap.c","usr.sbin/bind/lib/isc/heap.c","isc_heap_decreased",232,237
5,2,43,2,5,"isc_heap_element@240-245@usr.sbin/bind/lib/isc/heap.c","usr.sbin/bind/lib/isc/heap.c","isc_heap_element",240,245
7,2,63,3,8,"isc_heap_foreach@248-256@usr.sbin/bind/lib/isc/heap.c","usr.sbin/bind/lib/isc/heap.c","isc_heap_foreach",248,256
23,5,169,4,25,"isc_hex_totext@51-76@usr.sbin/bind/lib/isc/hex.c","usr.sbin/bind/lib/isc/hex.c","isc_hex_totext",51,76
6,1,33,3,5,"hex_decode_init@89-94@usr.sbin/bind/lib/isc/hex.c","usr.sbin/bind/lib/isc/hex.c","hex_decode_init",89,94
19,5,145,2,20,"hex_decode_char@97-117@usr.sbin/bind/lib/isc/hex.c","usr.sbin/bind/lib/isc/hex.c","hex_decode_char",97,117
7,3,39,1,6,"hex_decode_finish@120-126@usr.sbin/bind/lib/isc/hex.c","usr.sbin/bind/lib/isc/hex.c","hex_decode_finish",120,126
25,6,162,3,27,"isc_hex_tobuffer@129-156@usr.sbin/bind/lib/isc/hex.c","usr.sbin/bind/lib/isc/hex.c","isc_hex_tobuffer",129,156
14,7,93,2,14,"isc_hex_decodestring@159-173@usr.sbin/bind/lib/isc/hex.c","usr.sbin/bind/lib/isc/hex.c","isc_hex_decodestring",159,173
11,2,71,2,13,"str_totext@176-189@usr.sbin/bind/lib/isc/hex.c","usr.sbin/bind/lib/isc/hex.c","str_totext",176,189
9,2,63,3,9,"mem_tobuffer@192-201@usr.sbin/bind/lib/isc/hex.c","usr.sbin/bind/lib/isc/hex.c","mem_tobuffer",192,201
19,3,158,3,20,"isc_hmacmd5_init@42-62@usr.sbin/bind/lib/isc/hmacmd5.c","usr.sbin/bind/lib/isc/hmacmd5.c","isc_hmacmd5_init",42,62
4,1,32,1,3,"isc_hmacmd5_invalidate@65-68@usr.sbin/bind/lib/isc/hmacmd5.c","usr.sbin/bind/lib/isc/hmacmd5.c","isc_hmacmd5_invalidate",65,68
5,1,30,3,4,"isc_hmacmd5_update@75-79@usr.sbin/bind/lib/isc/hmacmd5.c","usr.sbin/bind/lib/isc/hmacmd5.c","isc_hmacmd5_update",75,79
13,2,120,2,15,"isc_hmacmd5_sign@85-100@usr.sbin/bind/lib/isc/hmacmd5.c","usr.sbin/bind/lib/isc/hmacmd5.c","isc_hmacmd5_sign",85,100
3,1,25,2,2,"isc_hmacmd5_verify@107-109@usr.sbin/bind/lib/isc/hmacmd5.c","usr.sbin/bind/lib/isc/hmacmd5.c","isc_hmacmd5_verify",107,109
6,1,54,3,6,"isc_hmacmd5_verify2@112-118@usr.sbin/bind/lib/isc/hmacmd5.c","usr.sbin/bind/lib/isc/hmacmd5.c","isc_hmacmd5_verify2",112,118
19,3,159,3,20,"isc_hmacsha1_init@42-62@usr.sbin/bind/lib/isc/hmacsha.c","usr.sbin/bind/lib/isc/hmacsha.c","isc_hmacsha1_init",42,62
3,1,21,1,2,"isc_hmacsha1_invalidate@65-67@usr.sbin/bind/lib/isc/hmacsha.c","usr.sbin/bind/lib/isc/hmacsha.c","isc_hmacsha1_invalidate",65,67
5,1,30,3,4,"isc_hmacsha1_update@74-78@usr.sbin/bind/lib/isc/hmacsha.c","usr.sbin/bind/lib/isc/hmacsha.c","isc_hmacsha1_update",74,78
17,2,159,3,19,"isc_hmacsha1_sign@84-103@usr.sbin/bind/lib/isc/hmacsha.c","usr.sbin/bind/lib/isc/hmacsha.c","isc_hmacsha1_sign",84,103
6,1,56,3,6,"isc_hmacsha1_verify@110-116@usr.sbin/bind/lib/isc/hmacsha.c","usr.sbin/bind/lib/isc/hmacsha.c","isc_hmacsha1_verify",110,116
19,3,159,3,20,"isc_hmacsha224_init@122-142@usr.sbin/bind/lib/isc/hmacsha.c","usr.sbin/bind/lib/isc/hmacsha.c","isc_hmacsha224_init",122,142
3,1,21,1,2,"isc_hmacsha224_invalidate@145-147@usr.sbin/bind/lib/isc/hmacsha.c","usr.sbin/bind/lib/isc/hmacsha.c","isc_hmacsha224_invalidate",145,147
5,1,30,3,4,"isc_hmacsha224_update@154-158@usr.sbin/bind/lib/isc/hmacsha.c","usr.sbin/bind/lib/isc/hmacsha.c","isc_hmacsha224_update",154,158
16,2,154,3,18,"isc_hmacsha224_sign@164-182@usr.sbin/bind/lib/isc/hmacsha.c","usr.sbin/bind/lib/isc/hmacsha.c","isc_hmacsha224_sign",164,182
6,1,56,3,6,"isc_hmacsha224_verify@189-195@usr.sbin/bind/lib/isc/hmacsha.c","usr.sbin/bind/lib/isc/hmacsha.c","isc_hmacsha224_verify",189,195
19,3,159,3,20,"isc_hmacsha256_init@201-221@usr.sbin/bind/lib/isc/hmacsha.c","usr.sbin/bind/lib/isc/hmacsha.c","isc_hmacsha256_init",201,221
3,1,21,1,2,"isc_hmacsha256_invalidate@224-226@usr.sbin/bind/lib/isc/hmacsha.c","usr.sbin/bind/lib/isc/hmacsha.c","isc_hmacsha256_invalidate",224,226
5,1,30,3,4,"isc_hmacsha256_update@233-237@usr.sbin/bind/lib/isc/hmacsha.c","usr.sbin/bind/lib/isc/hmacsha.c","isc_hmacsha256_update",233,237
16,2,154,3,18,"isc_hmacsha256_sign@243-261@usr.sbin/bind/lib/isc/hmacsha.c","usr.sbin/bind/lib/isc/hmacsha.c","isc_hmacsha256_sign",243,261
6,1,56,3,6,"isc_hmacsha256_verify@268-274@usr.sbin/bind/lib/isc/hmacsha.c","usr.sbin/bind/lib/isc/hmacsha.c","isc_hmacsha256_verify",268,274
19,3,159,3,20,"isc_hmacsha384_init@280-300@usr.sbin/bind/lib/isc/hmacsha.c","usr.sbin/bind/lib/isc/hmacsha.c","isc_hmacsha384_init",280,300
3,1,21,1,2,"isc_hmacsha384_invalidate@303-305@usr.sbin/bind/lib/isc/hmacsha.c","usr.sbin/bind/lib/isc/hmacsha.c","isc_hmacsha384_invalidate",303,305
5,1,30,3,4,"isc_hmacsha384_update@312-316@usr.sbin/bind/lib/isc/hmacsha.c","usr.sbin/bind/lib/isc/hmacsha.c","isc_hmacsha384_update",312,316
16,2,154,3,18,"isc_hmacsha384_sign@322-340@usr.sbin/bind/lib/isc/hmacsha.c","usr.sbin/bind/lib/isc/hmacsha.c","isc_hmacsha384_sign",322,340
6,1,56,3,6,"isc_hmacsha384_verify@347-353@usr.sbin/bind/lib/isc/hmacsha.c","usr.sbin/bind/lib/isc/hmacsha.c","isc_hmacsha384_verify",347,353
19,3,159,3,20,"isc_hmacsha512_init@359-379@usr.sbin/bind/lib/isc/hmacsha.c","usr.sbin/bind/lib/isc/hmacsha.c","isc_hmacsha512_init",359,379
3,1,21,1,2,"isc_hmacsha512_invalidate@382-384@usr.sbin/bind/lib/isc/hmacsha.c","usr.sbin/bind/lib/isc/hmacsha.c","isc_hmacsha512_invalidate",382,384
5,1,30,3,4,"isc_hmacsha512_update@391-395@usr.sbin/bind/lib/isc/hmacsha.c","usr.sbin/bind/lib/isc/hmacsha.c","isc_hmacsha512_update",391,395
16,2,154,3,18,"isc_hmacsha512_sign@401-419@usr.sbin/bind/lib/isc/hmacsha.c","usr.sbin/bind/lib/isc/hmacsha.c","isc_hmacsha512_sign",401,419
6,1,56,3,6,"isc_hmacsha512_verify@426-432@usr.sbin/bind/lib/isc/hmacsha.c","usr.sbin/bind/lib/isc/hmacsha.c","isc_hmacsha512_verify",426,432
72,31,479,2,103,"isc_net_aton@93-196@usr.sbin/bind/lib/isc/inet_aton.c","usr.sbin/bind/lib/isc/inet_aton.c","isc_net_aton",93,196
12,4,66,4,14,"isc_net_ntop@59-73@usr.sbin/bind/lib/isc/inet_ntop.c","usr.sbin/bind/lib/isc/inet_ntop.c","isc_net_ntop",59,73
12,2,98,3,13,"inet_ntop4@88-101@usr.sbin/bind/lib/isc/inet_ntop.c","usr.sbin/bind/lib/isc/inet_ntop.c","inet_ntop4",88,101
63,28,530,3,87,"inet_ntop6@111-198@usr.sbin/bind/lib/isc/inet_ntop.c","usr.sbin/bind/lib/isc/inet_ntop.c","inet_ntop6",111,198
11,3,60,3,11,"isc_net_pton@58-69@usr.sbin/bind/lib/isc/inet_pton.c","usr.sbin/bind/lib/isc/inet_pton.c","isc_net_pton",58,69
34,12,224,2,36,"inet_pton4@82-118@usr.sbin/bind/lib/isc/inet_pton.c","usr.sbin/bind/lib/isc/inet_pton.c","inet_pton4",82,118
73,20,475,2,80,"inet_pton6@134-214@usr.sbin/bind/lib/isc/inet_pton.c","usr.sbin/bind/lib/isc/inet_pton.c","inet_pton6",134,214
15,3,143,4,15,"grow_data@72-87@usr.sbin/bind/lib/isc/lex.c","usr.sbin/bind/lib/isc/lex.c","grow_data",72,87
25,4,179,3,32,"isc_lex_create@90-122@usr.sbin/bind/lib/isc/lex.c","usr.sbin/bind/lib/isc/lex.c","isc_lex_create",90,122
13,3,103,1,19,"isc_lex_destroy@125-144@usr.sbin/bind/lib/isc/lex.c","usr.sbin/bind/lib/isc/lex.c","isc_lex_destroy",125,144
4,1,23,1,8,"isc_lex_getcomments@147-155@usr.sbin/bind/lib/isc/lex.c","usr.sbin/bind/lib/isc/lex.c","isc_lex_getcomments",147,155
4,1,26,2,8,"isc_lex_setcomments@158-166@usr.sbin/bind/lib/isc/lex.c","usr.sbin/bind/lib/isc/lex.c","isc_lex_setcomments",158,166
4,1,30,2,8,"isc_lex_getspecials@169-177@usr.sbin/bind/lib/isc/lex.c","usr.sbin/bind/lib/isc/lex.c","isc_lex_getspecials",169,177
4,1,30,2,9,"isc_lex_setspecials@180-189@usr.sbin/bind/lib/isc/lex.c","usr.sbin/bind/lib/isc/lex.c","isc_lex_setspecials",180,189
31,4,220,5,32,"new_source@192-224@usr.sbin/bind/lib/isc/lex.c","usr.sbin/bind/lib/isc/lex.c","new_source",192,224
12,3,87,2,18,"isc_lex_openfile@227-245@usr.sbin/bind/lib/isc/lex.c","usr.sbin/bind/lib/isc/lex.c","isc_lex_openfile",227,245
6,1,56,2,12,"isc_lex_openstream@248-260@usr.sbin/bind/lib/isc/lex.c","usr.sbin/bind/lib/isc/lex.c","isc_lex_openstream",248,260
6,1,56,2,12,"isc_lex_openbuffer@263-275@usr.sbin/bind/lib/isc/lex.c","usr.sbin/bind/lib/isc/lex.c","isc_lex_openbuffer",263,275
16,4,120,1,23,"isc_lex_close@278-301@usr.sbin/bind/lib/isc/lex.c","usr.sbin/bind/lib/isc/lex.c","isc_lex_close",278,301
10,3,56,2,9,"pushback@318-327@usr.sbin/bind/lib/isc/lex.c","usr.sbin/bind/lib/isc/lex.c","pushback",318,327
20,3,148,3,20,"pushandgrow@330-350@usr.sbin/bind/lib/isc/lex.c","usr.sbin/bind/lib/isc/lex.c","pushandgrow",330,350
396,129,2086,3,444,"isc_lex_gettoken@353-797@usr.sbin/bind/lib/isc/lex.c","usr.sbin/bind/lib/isc/lex.c","isc_lex_gettoken",353,797
32,14,190,4,33,"isc_lex_getmastertoken@800-833@usr.sbin/bind/lib/isc/lex.c","usr.sbin/bind/lib/isc/lex.c","isc_lex_getmastertoken",800,833
23,9,142,3,24,"isc_lex_getoctaltoken@836-860@usr.sbin/bind/lib/isc/lex.c","usr.sbin/bind/lib/isc/lex.c","isc_lex_getoctaltoken",836,860
14,2,99,2,19,"isc_lex_ungettoken@863-882@usr.sbin/bind/lib/isc/lex.c","usr.sbin/bind/lib/isc/lex.c","isc_lex_ungettoken",863,882
16,2,123,3,18,"isc_lex_getlasttokentext@885-903@usr.sbin/bind/lib/isc/lex.c","usr.sbin/bind/lib/isc/lex.c","isc_lex_getlasttokentext",885,903
8,2,47,1,10,"isc_lex_getsourcename@907-917@usr.sbin/bind/lib/isc/lex.c","usr.sbin/bind/lib/isc/lex.c","isc_lex_getsourcename",907,917
8,2,47,1,10,"isc_lex_getsourceline@920-930@usr.sbin/bind/lib/isc/lex.c","usr.sbin/bind/lib/isc/lex.c","isc_lex_getsourceline",920,930
14,3,93,2,15,"isc_lex_setsourcename@934-949@usr.sbin/bind/lib/isc/lex.c","usr.sbin/bind/lib/isc/lex.c","isc_lex_setsourcename",934,949
8,2,47,1,11,"isc_lex_isfile@952-963@usr.sbin/bind/lib/isc/lex.c","usr.sbin/bind/lib/isc/lex.c","isc_lex_isfile",952,963
18,5,131,7,19,"isc_lfsr_init@34-53@usr.sbin/bind/lib/isc/lfsr.c","usr.sbin/bind/lib/isc/lfsr.c","isc_lfsr_init",34,53
16,5,107,1,24,"lfsr_generate@59-83@usr.sbin/bind/lib/isc/lfsr.c","usr.sbin/bind/lib/isc/lfsr.c","lfsr_generate",59,83
26,6,159,3,29,"isc_lfsr_generate@86-115@usr.sbin/bind/lib/isc/lfsr.c","usr.sbin/bind/lib/isc/lfsr.c","isc_lfsr_generate",86,115
7,2,40,2,8,"lfsr_skipgenerate@118-126@usr.sbin/bind/lib/isc/lfsr.c","usr.sbin/bind/lib/isc/lfsr.c","lfsr_skipgenerate",118,126
6,2,33,2,6,"isc_lfsr_skip@132-138@usr.sbin/bind/lib/isc/lfsr.c","usr.sbin/bind/lib/isc/lfsr.c","isc_lfsr_skip",132,138
12,1,79,2,16,"isc_lfsr_generate32@145-161@usr.sbin/bind/lib/isc/lfsr.c","usr.sbin/bind/lib/isc/lfsr.c","isc_lfsr_generate32",145,161
3,1,14,1,2,"open_msgcat@50-52@usr.sbin/bind/lib/isc/lib.c","usr.sbin/bind/lib/isc/lib.c","open_msgcat",50,52
13,2,64,1,24,"isc_lib_initmsgcat@55-79@usr.sbin/bind/lib/isc/lib.c","usr.sbin/bind/lib/isc/lib.c","isc_lib_initmsgcat",55,79
42,10,270,3,60,"isc_log_create@266-326@usr.sbin/bind/lib/isc/log.c","usr.sbin/bind/lib/isc/log.c","isc_log_create",266,326
61,9,343,2,89,"isc_logconfig_create@329-418@usr.sbin/bind/lib/isc/log.c","usr.sbin/bind/lib/isc/log.c","isc_logconfig_create",329,418
5,1,32,1,6,"isc_logconfig_get@421-427@usr.sbin/bind/lib/isc/log.c","usr.sbin/bind/lib/isc/log.c","isc_logconfig_get",421,427
16,2,101,2,27,"isc_logconfig_use@430-457@usr.sbin/bind/lib/isc/log.c","usr.sbin/bind/lib/isc/log.c","isc_logconfig_use",430,457
30,4,203,1,38,"isc_log_destroy@460-498@usr.sbin/bind/lib/isc/log.c","usr.sbin/bind/lib/isc/log.c","isc_log_destroy",460,498
41,10,332,1,63,"isc_logconfig_destroy@501-564@usr.sbin/bind/lib/isc/log.c","usr.sbin/bind/lib/isc/log.c","isc_logconfig_destroy",501,564
18,6,134,2,41,"isc_log_registercategories@567-608@usr.sbin/bind/lib/isc/log.c","usr.sbin/bind/lib/isc/log.c","isc_log_registercategories",567,608
14,4,93,2,20,"isc_log_categorybyname@611-631@usr.sbin/bind/lib/isc/log.c","usr.sbin/bind/lib/isc/log.c","isc_log_categorybyname",611,631
18,6,134,2,41,"isc_log_registermodules@634-675@usr.sbin/bind/lib/isc/log.c","usr.sbin/bind/lib/isc/log.c","isc_log_registermodules",634,675
14,4,93,2,20,"isc_log_modulebyname@678-698@usr.sbin/bind/lib/isc/log.c","usr.sbin/bind/lib/isc/log.c","isc_log_modulebyname",678,698
58,12,394,6,82,"isc_log_createchannel@701-783@usr.sbin/bind/lib/isc/log.c","usr.sbin/bind/lib/isc/log.c","isc_log_createchannel",701,783
29,9,206,4,40,"isc_log_usechannel@786-826@usr.sbin/bind/lib/isc/log.c","usr.sbin/bind/lib/isc/log.c","isc_log_usechannel",786,826
9,1,64,6,13,"isc_log_write@829-842@usr.sbin/bind/lib/isc/log.c","usr.sbin/bind/lib/isc/log.c","isc_log_write",829,842
7,1,50,6,9,"isc_log_vwrite@845-854@usr.sbin/bind/lib/isc/log.c","usr.sbin/bind/lib/isc/log.c","isc_log_vwrite",845,854
9,1,64,6,13,"isc_log_write1@857-870@usr.sbin/bind/lib/isc/log.c","usr.sbin/bind/lib/isc/log.c","isc_log_write1",857,870
7,1,50,6,9,"isc_log_vwrite1@873-882@usr.sbin/bind/lib/isc/log.c","usr.sbin/bind/lib/isc/log.c","isc_log_vwrite1",873,882
11,1,74,9,15,"isc_log_iwrite@885-900@usr.sbin/bind/lib/isc/log.c","usr.sbin/bind/lib/isc/log.c","isc_log_iwrite",885,900
8,1,60,9,10,"isc_log_ivwrite@903-913@usr.sbin/bind/lib/isc/log.c","usr.sbin/bind/lib/isc/log.c","isc_log_ivwrite",903,913
11,1,74,9,15,"isc_log_iwrite1@916-931@usr.sbin/bind/lib/isc/log.c","usr.sbin/bind/lib/isc/log.c","isc_log_iwrite1",916,931
8,1,60,9,10,"isc_log_ivwrite1@934-944@usr.sbin/bind/lib/isc/log.c","usr.sbin/bind/lib/isc/log.c","isc_log_ivwrite1",934,944
3,1,12,1,2,"isc_log_setcontext@947-949@usr.sbin/bind/lib/isc/log.c","usr.sbin/bind/lib/isc/log.c","isc_log_setcontext",947,949
17,6,125,2,22,"isc_log_setdebuglevel@952-974@usr.sbin/bind/lib/isc/log.c","usr.sbin/bind/lib/isc/log.c","isc_log_setdebuglevel",952,974
4,1,23,1,4,"isc_log_getdebuglevel@977-981@usr.sbin/bind/lib/isc/log.c","usr.sbin/bind/lib/isc/log.c","isc_log_getdebuglevel",977,981
4,1,26,2,4,"isc_log_setduplicateinterval@984-988@usr.sbin/bind/lib/isc/log.c","usr.sbin/bind/lib/isc/log.c","isc_log_setduplicateinterval",984,988
4,1,23,1,4,"isc_log_getduplicateinterval@991-995@usr.sbin/bind/lib/isc/log.c","usr.sbin/bind/lib/isc/log.c","isc_log_getduplicateinterval",991,995
15,6,118,2,17,"isc_log_settag@998-1015@usr.sbin/bind/lib/isc/log.c","usr.sbin/bind/lib/isc/log.c","isc_log_settag",998,1015
4,1,23,1,4,"isc_log_gettag@1018-1022@usr.sbin/bind/lib/isc/log.c","usr.sbin/bind/lib/isc/log.c","isc_log_gettag",1018,1022
3,1,27,3,2,"isc_log_opensyslog@1026-1028@usr.sbin/bind/lib/isc/log.c","usr.sbin/bind/lib/isc/log.c","isc_log_opensyslog",1026,1028
14,4,97,1,16,"isc_log_closefilelogs@1031-1047@usr.sbin/bind/lib/isc/log.c","usr.sbin/bind/lib/isc/log.c","isc_log_closefilelogs",1031,1047
29,7,194,4,44,"assignchannel@1054-1098@usr.sbin/bind/lib/isc/log.c","usr.sbin/bind/lib/isc/log.c","assignchannel",1054,1098
24,4,170,1,34,"sync_channellist@1105-1139@usr.sbin/bind/lib/isc/log.c","usr.sbin/bind/lib/isc/log.c","sync_channellist",1105,1139
45,17,314,2,68,"greatest_version@1142-1210@usr.sbin/bind/lib/isc/log.c","usr.sbin/bind/lib/isc/log.c","greatest_version",1142,1210
69,26,458,1,101,"roll_log@1213-1314@usr.sbin/bind/lib/isc/log.c","usr.sbin/bind/lib/isc/log.c","roll_log",1213,1314
40,14,253,1,55,"isc_log_open@1317-1372@usr.sbin/bind/lib/isc/log.c","usr.sbin/bind/lib/isc/log.c","isc_log_open",1317,1372
7,5,56,2,24,"isc_log_wouldlog@1375-1399@usr.sbin/bind/lib/isc/log.c","usr.sbin/bind/lib/isc/log.c","isc_log_wouldlog",1375,1399
228,73,1382,10,361,"isc_log_doit@1402-1763@usr.sbin/bind/lib/isc/log.c","usr.sbin/bind/lib/isc/log.c","isc_log_doit",1402,1763
9,2,82,2,9,"byteSwap@46-55@usr.sbin/bind/lib/isc/md5.c","usr.sbin/bind/lib/isc/md5.c","byteSwap",46,55
8,1,62,1,8,"isc_md5_init@62-70@usr.sbin/bind/lib/isc/md5.c","usr.sbin/bind/lib/isc/md5.c","isc_md5_init",62,70
3,1,20,1,2,"isc_md5_invalidate@73-75@usr.sbin/bind/lib/isc/md5.c","usr.sbin/bind/lib/isc/md5.c","isc_md5_invalidate",73,75
75,1,1491,2,80,"transform@97-177@usr.sbin/bind/lib/isc/md5.c","usr.sbin/bind/lib/isc/md5.c","transform",97,177
24,4,201,3,32,"isc_md5_update@184-216@usr.sbin/bind/lib/isc/md5.c","usr.sbin/bind/lib/isc/md5.c","isc_md5_update",184,216
21,2,214,2,28,"isc_md5_final@223-251@usr.sbin/bind/lib/isc/md5.c","usr.sbin/bind/lib/isc/md5.c","isc_md5_final",223,251
48,9,331,3,55,"add_trace_entry@207-262@usr.sbin/bind/lib/isc/mem.c","usr.sbin/bind/lib/isc/mem.c","add_trace_entry",207,262
37,8,240,5,46,"delete_trace_entry@265-311@usr.sbin/bind/lib/isc/mem.c","usr.sbin/bind/lib/isc/mem.c","delete_trace_entry",265,311
3,1,20,1,5,"rmsize@315-320@usr.sbin/bind/lib/isc/mem.c","usr.sbin/bind/lib/isc/mem.c","rmsize",315,320
5,2,37,1,10,"quantize@323-333@usr.sbin/bind/lib/isc/mem.c","usr.sbin/bind/lib/isc/mem.c","quantize",323,333
54,11,391,1,67,"more_basic_blocks@336-403@usr.sbin/bind/lib/isc/mem.c","usr.sbin/bind/lib/isc/mem.c","more_basic_blocks",336,403
35,5,247,2,59,"more_frags@406-465@usr.sbin/bind/lib/isc/mem.c","usr.sbin/bind/lib/isc/mem.c","more_frags",406,465
33,10,247,2,63,"mem_getunlocked@468-531@usr.sbin/bind/lib/isc/mem.c","usr.sbin/bind/lib/isc/mem.c","mem_getunlocked",468,531
10,2,54,3,10,"check_overrun@535-545@usr.sbin/bind/lib/isc/mem.c","usr.sbin/bind/lib/isc/mem.c","check_overrun",535,545
21,6,200,3,42,"mem_putunlocked@549-591@usr.sbin/bind/lib/isc/mem.c","usr.sbin/bind/lib/isc/mem.c","mem_putunlocked",549,591
12,7,80,2,22,"mem_get@597-619@usr.sbin/bind/lib/isc/mem.c","usr.sbin/bind/lib/isc/mem.c","mem_get",597,619
6,3,59,3,10,"mem_put@625-635@usr.sbin/bind/lib/isc/mem.c","usr.sbin/bind/lib/isc/mem.c","mem_put",625,635
11,2,80,2,11,"mem_getstats@641-652@usr.sbin/bind/lib/isc/mem.c","usr.sbin/bind/lib/isc/mem.c","mem_getstats",641,652
12,2,100,3,13,"mem_putstats@658-671@usr.sbin/bind/lib/isc/mem.c","usr.sbin/bind/lib/isc/mem.c","mem_putstats",658,671
6,2,34,2,5,"default_memalloc@678-683@usr.sbin/bind/lib/isc/mem.c","usr.sbin/bind/lib/isc/mem.c","default_memalloc",678,683
4,1,22,2,3,"default_memfree@686-689@usr.sbin/bind/lib/isc/mem.c","usr.sbin/bind/lib/isc/mem.c","default_memfree",686,689
4,1,22,1,3,"initialize_action@692-695@usr.sbin/bind/lib/isc/mem.c","usr.sbin/bind/lib/isc/mem.c","initialize_action",692,695
7,1,44,6,7,"isc_mem_createx@702-709@usr.sbin/bind/lib/isc/mem.c","usr.sbin/bind/lib/isc/mem.c","isc_mem_createx",702,709
104,21,720,7,124,"isc_mem_createx2@712-836@usr.sbin/bind/lib/isc/mem.c","usr.sbin/bind/lib/isc/mem.c","isc_mem_createx2",712,836
7,1,34,3,6,"isc_mem_create@839-845@usr.sbin/bind/lib/isc/mem.c","usr.sbin/bind/lib/isc/mem.c","isc_mem_create",839,845
7,1,38,4,6,"isc_mem_create2@848-854@usr.sbin/bind/lib/isc/mem.c","usr.sbin/bind/lib/isc/mem.c","isc_mem_create2",848,854
49,15,415,1,63,"destroy@857-920@usr.sbin/bind/lib/isc/mem.c","usr.sbin/bind/lib/isc/mem.c","destroy",857,920
8,2,62,2,9,"isc_mem_attach@923-932@usr.sbin/bind/lib/isc/mem.c","usr.sbin/bind/lib/isc/mem.c","isc_mem_attach",923,932
16,3,97,1,19,"isc_mem_detach@935-954@usr.sbin/bind/lib/isc/mem.c","usr.sbin/bind/lib/isc/mem.c","isc_mem_detach",935,954
45,9,318,3,57,"isc__mem_putanddetach@967-1024@usr.sbin/bind/lib/isc/mem.c","usr.sbin/bind/lib/isc/mem.c","isc__mem_putanddetach",967,1024
14,3,91,1,24,"isc_mem_destroy@1027-1051@usr.sbin/bind/lib/isc/mem.c","usr.sbin/bind/lib/isc/mem.c","isc_mem_destroy",1027,1051
7,1,58,3,8,"isc_mem_ondestroy@1054-1062@usr.sbin/bind/lib/isc/mem.c","usr.sbin/bind/lib/isc/mem.c","isc_mem_ondestroy",1054,1062
33,12,259,2,38,"isc__mem_get@1066-1104@usr.sbin/bind/lib/isc/mem.c","usr.sbin/bind/lib/isc/mem.c","isc__mem_get",1066,1104
37,10,275,3,48,"isc__mem_put@1107-1155@usr.sbin/bind/lib/isc/mem.c","usr.sbin/bind/lib/isc/mem.c","isc__mem_put",1107,1155
34,8,210,2,36,"print_active@1159-1195@usr.sbin/bind/lib/isc/mem.c","usr.sbin/bind/lib/isc/mem.c","print_active",1159,1195
54,12,387,2,68,"isc_mem_stats@1202-1270@usr.sbin/bind/lib/isc/mem.c","usr.sbin/bind/lib/isc/mem.c","isc_mem_stats",1202,1270
18,5,115,2,20,"isc__mem_allocateunlocked@1278-1298@usr.sbin/bind/lib/isc/mem.c","usr.sbin/bind/lib/isc/mem.c","isc__mem_allocateunlocked",1278,1298
31,12,250,2,37,"isc__mem_allocate@1301-1338@usr.sbin/bind/lib/isc/mem.c","usr.sbin/bind/lib/isc/mem.c","isc__mem_allocate",1301,1338
33,8,265,2,44,"isc__mem_free@1341-1385@usr.sbin/bind/lib/isc/mem.c","usr.sbin/bind/lib/isc/mem.c","isc__mem_free",1341,1385
11,2,77,2,15,"isc__mem_strdup@1393-1408@usr.sbin/bind/lib/isc/mem.c","usr.sbin/bind/lib/isc/mem.c","isc__mem_strdup",1393,1408
6,1,45,2,7,"isc_mem_setdestroycheck@1411-1418@usr.sbin/bind/lib/isc/mem.c","usr.sbin/bind/lib/isc/mem.c","isc_mem_setdestroycheck",1411,1418
6,1,45,2,7,"isc_mem_setquota@1425-1432@usr.sbin/bind/lib/isc/mem.c","usr.sbin/bind/lib/isc/mem.c","isc_mem_setquota",1425,1432
8,1,50,1,11,"isc_mem_getquota@1435-1446@usr.sbin/bind/lib/isc/mem.c","usr.sbin/bind/lib/isc/mem.c","isc_mem_getquota",1435,1446
8,1,50,1,11,"isc_mem_inuse@1449-1460@usr.sbin/bind/lib/isc/mem.c","usr.sbin/bind/lib/isc/mem.c","isc_mem_inuse",1449,1460
33,9,208,5,35,"isc_mem_setwater@1463-1498@usr.sbin/bind/lib/isc/mem.c","usr.sbin/bind/lib/isc/mem.c","isc_mem_setwater",1463,1498
26,4,185,3,37,"isc_mempool_create@1505-1542@usr.sbin/bind/lib/isc/mem.c","usr.sbin/bind/lib/isc/mem.c","isc_mempool_create",1505,1542
10,4,76,2,15,"isc_mempool_setname@1545-1560@usr.sbin/bind/lib/isc/mem.c","usr.sbin/bind/lib/isc/mem.c","isc_mempool_setname",1545,1560
41,7,273,1,59,"isc_mempool_destroy@1563-1622@usr.sbin/bind/lib/isc/mem.c","usr.sbin/bind/lib/isc/mem.c","isc_mempool_destroy",1563,1622
6,1,42,2,6,"isc_mempool_associatelock@1625-1631@usr.sbin/bind/lib/isc/mem.c","usr.sbin/bind/lib/isc/mem.c","isc_mempool_associatelock",1625,1631
54,12,339,1,79,"isc__mempool_get@1634-1713@usr.sbin/bind/lib/isc/mem.c","usr.sbin/bind/lib/isc/mem.c","isc__mempool_get",1634,1713
35,7,267,2,50,"isc__mempool_put@1716-1766@usr.sbin/bind/lib/isc/mem.c","usr.sbin/bind/lib/isc/mem.c","isc__mempool_put",1716,1766
8,3,56,2,10,"isc_mempool_setfreemax@1773-1783@usr.sbin/bind/lib/isc/mem.c","usr.sbin/bind/lib/isc/mem.c","isc_mempool_setfreemax",1773,1783
10,3,61,1,14,"isc_mempool_getfreemax@1786-1800@usr.sbin/bind/lib/isc/mem.c","usr.sbin/bind/lib/isc/mem.c","isc_mempool_getfreemax",1786,1800
10,3,61,1,14,"isc_mempool_getfreecount@1803-1817@usr.sbin/bind/lib/isc/mem.c","usr.sbin/bind/lib/isc/mem.c","isc_mempool_getfreecount",1803,1817
9,3,63,2,12,"isc_mempool_setmaxalloc@1820-1832@usr.sbin/bind/lib/isc/mem.c","usr.sbin/bind/lib/isc/mem.c","isc_mempool_setmaxalloc",1820,1832
10,3,61,1,14,"isc_mempool_getmaxalloc@1835-1849@usr.sbin/bind/lib/isc/mem.c","usr.sbin/bind/lib/isc/mem.c","isc_mempool_getmaxalloc",1835,1849
10,3,61,1,14,"isc_mempool_getallocated@1852-1866@usr.sbin/bind/lib/isc/mem.c","usr.sbin/bind/lib/isc/mem.c","isc_mempool_getallocated",1852,1866
9,3,63,2,11,"isc_mempool_setfillcount@1869-1880@usr.sbin/bind/lib/isc/mem.c","usr.sbin/bind/lib/isc/mem.c","isc_mempool_setfillcount",1869,1880
10,3,61,1,14,"isc_mempool_getfillcount@1883-1897@usr.sbin/bind/lib/isc/mem.c","usr.sbin/bind/lib/isc/mem.c","isc_mempool_getfillcount",1883,1897
7,2,44,2,11,"isc_mem_printactive@1900-1911@usr.sbin/bind/lib/isc/mem.c","usr.sbin/bind/lib/isc/mem.c","isc_mem_printactive",1900,1911
13,3,82,1,17,"isc_mem_printallactive@1914-1931@usr.sbin/bind/lib/isc/mem.c","usr.sbin/bind/lib/isc/mem.c","isc_mem_printallactive",1914,1931
16,4,97,1,20,"isc_mem_checkdestroyed@1934-1954@usr.sbin/bind/lib/isc/mem.c","usr.sbin/bind/lib/isc/mem.c","isc_mem_checkdestroyed",1934,1954
16,4,86,2,17,"isc_mutexblock_init@28-45@usr.sbin/bind/lib/isc/mutexblock.c","usr.sbin/bind/lib/isc/mutexblock.c","isc_mutexblock_init",28,45
10,3,61,2,11,"isc_mutexblock_destroy@48-59@usr.sbin/bind/lib/isc/mutexblock.c","usr.sbin/bind/lib/isc/mutexblock.c","isc_mutexblock_destroy",48,59
26,12,180,2,30,"isc_netaddr_equal@36-66@usr.sbin/bind/lib/isc/netaddr.c","usr.sbin/bind/lib/isc/netaddr.c","isc_netaddr_equal",36,66
48,11,318,3,57,"isc_netaddr_eqprefix@69-126@usr.sbin/bind/lib/isc/netaddr.c","usr.sbin/bind/lib/isc/netaddr.c","isc_netaddr_eqprefix",69,126
44,11,310,2,52,"isc_netaddr_totext@129-181@usr.sbin/bind/lib/isc/netaddr.c","usr.sbin/bind/lib/isc/netaddr.c","isc_netaddr_totext",129,181
20,4,113,3,25,"isc_netaddr_format@184-209@usr.sbin/bind/lib/isc/netaddr.c","usr.sbin/bind/lib/isc/netaddr.c","isc_netaddr_format",184,209
32,8,198,2,32,"isc_netaddr_prefixok@213-245@usr.sbin/bind/lib/isc/netaddr.c","usr.sbin/bind/lib/isc/netaddr.c","isc_netaddr_prefixok",213,245
39,11,235,2,39,"isc_netaddr_masktoprefixlen@248-287@usr.sbin/bind/lib/isc/netaddr.c","usr.sbin/bind/lib/isc/netaddr.c","isc_netaddr_masktoprefixlen",248,287
5,1,42,2,4,"isc_netaddr_fromin@290-294@usr.sbin/bind/lib/isc/netaddr.c","usr.sbin/bind/lib/isc/netaddr.c","isc_netaddr_fromin",290,294
5,1,42,2,4,"isc_netaddr_fromin6@297-301@usr.sbin/bind/lib/isc/netaddr.c","usr.sbin/bind/lib/isc/netaddr.c","isc_netaddr_fromin6",297,301
12,3,101,2,15,"isc_netaddr_frompath@304-319@usr.sbin/bind/lib/isc/netaddr.c","usr.sbin/bind/lib/isc/netaddr.c","isc_netaddr_frompath",304,319
4,1,26,2,5,"isc_netaddr_setzone@323-328@usr.sbin/bind/lib/isc/netaddr.c","usr.sbin/bind/lib/isc/netaddr.c","isc_netaddr_setzone",323,328
3,1,16,1,2,"isc_netaddr_getzone@331-333@usr.sbin/bind/lib/isc/netaddr.c","usr.sbin/bind/lib/isc/netaddr.c","isc_netaddr_getzone",331,333
21,6,149,2,25,"isc_netaddr_fromsockaddr@336-361@usr.sbin/bind/lib/isc/netaddr.c","usr.sbin/bind/lib/isc/netaddr.c","isc_netaddr_fromsockaddr",336,361
5,1,37,1,4,"isc_netaddr_any@364-368@usr.sbin/bind/lib/isc/netaddr.c","usr.sbin/bind/lib/isc/netaddr.c","isc_netaddr_any",364,368
5,1,35,1,4,"isc_netaddr_any6@371-375@usr.sbin/bind/lib/isc/netaddr.c","usr.sbin/bind/lib/isc/netaddr.c","isc_netaddr_any6",371,375
10,3,62,1,9,"isc_netaddr_ismulticast@378-387@usr.sbin/bind/lib/isc/netaddr.c","usr.sbin/bind/lib/isc/netaddr.c","isc_netaddr_ismulticast",378,387
8,2,43,1,7,"isc_netaddr_isexperimental@390-397@usr.sbin/bind/lib/isc/netaddr.c","usr.sbin/bind/lib/isc/netaddr.c","isc_netaddr_isexperimental",390,397
10,3,50,1,9,"isc_netaddr_islinklocal@400-409@usr.sbin/bind/lib/isc/netaddr.c","usr.sbin/bind/lib/isc/netaddr.c","isc_netaddr_islinklocal",400,409
10,3,50,1,9,"isc_netaddr_issitelocal@412-421@usr.sbin/bind/lib/isc/netaddr.c","usr.sbin/bind/lib/isc/netaddr.c","isc_netaddr_issitelocal",412,421
10,1,92,2,12,"isc_netaddr_fromv4mapped@424-436@usr.sbin/bind/lib/isc/netaddr.c","usr.sbin/bind/lib/isc/netaddr.c","isc_netaddr_fromv4mapped",424,436
23,8,146,4,43,"isc_netscope_pton@33-76@usr.sbin/bind/lib/isc/netscope.c","usr.sbin/bind/lib/isc/netscope.c","isc_netscope_pton",33,76
4,1,21,1,3,"isc_ondestroy_init@36-39@usr.sbin/bind/lib/isc/ondestroy.c","usr.sbin/bind/lib/isc/ondestroy.c","isc_ondestroy_init",36,39
15,1,90,3,21,"isc_ondestroy_register@42-63@usr.sbin/bind/lib/isc/ondestroy.c","usr.sbin/bind/lib/isc/ondestroy.c","isc_ondestroy_register",42,63
13,2,86,2,17,"isc_ondestroy_notify@66-83@usr.sbin/bind/lib/isc/ondestroy.c","usr.sbin/bind/lib/isc/ondestroy.c","isc_ondestroy_notify",66,83
14,5,99,3,13,"isc_parse_uint32@33-46@usr.sbin/bind/lib/isc/parseint.c","usr.sbin/bind/lib/isc/parseint.c","isc_parse_uint32",33,46
11,3,69,3,10,"isc_parse_uint16@49-59@usr.sbin/bind/lib/isc/parseint.c","usr.sbin/bind/lib/isc/parseint.c","isc_parse_uint16",49,59
11,3,69,3,10,"isc_parse_uint8@62-72@usr.sbin/bind/lib/isc/parseint.c","usr.sbin/bind/lib/isc/parseint.c","isc_parse_uint8",62,72
7,1,47,3,7,"isc_print_sprintf@38-45@usr.sbin/bind/lib/isc/print.c","usr.sbin/bind/lib/isc/print.c","isc_print_sprintf",38,45
8,1,54,4,9,"isc_print_snprintf@52-61@usr.sbin/bind/lib/isc/print.c","usr.sbin/bind/lib/isc/print.c","isc_print_snprintf",52,61
453,155,2275,4,492,"isc_print_vsnprintf@68-560@usr.sbin/bind/lib/isc/print.c","usr.sbin/bind/lib/isc/print.c","isc_print_vsnprintf",68,560
6,1,40,2,5,"isc_quota_init@30-35@usr.sbin/bind/lib/isc/quota.c","usr.sbin/bind/lib/isc/quota.c","isc_quota_init",30,35
7,1,43,1,6,"isc_quota_destroy@38-44@usr.sbin/bind/lib/isc/quota.c","usr.sbin/bind/lib/isc/quota.c","isc_quota_destroy",38,44
5,1,33,2,4,"isc_quota_soft@47-51@usr.sbin/bind/lib/isc/quota.c","usr.sbin/bind/lib/isc/quota.c","isc_quota_soft",47,51
5,1,33,2,4,"isc_quota_max@54-58@usr.sbin/bind/lib/isc/quota.c","usr.sbin/bind/lib/isc/quota.c","isc_quota_max",54,58
14,5,85,1,13,"isc_quota_reserve@61-74@usr.sbin/bind/lib/isc/quota.c","usr.sbin/bind/lib/isc/quota.c","isc_quota_reserve",61,74
6,1,38,1,5,"isc_quota_release@77-82@usr.sbin/bind/lib/isc/quota.c","usr.sbin/bind/lib/isc/quota.c","isc_quota_release",77,82
9,4,54,2,8,"isc_quota_attach@85-93@usr.sbin/bind/lib/isc/quota.c","usr.sbin/bind/lib/isc/quota.c","isc_quota_attach",85,93
6,2,31,1,5,"isc_quota_detach@96-101@usr.sbin/bind/lib/isc/quota.c","usr.sbin/bind/lib/isc/quota.c","isc_quota_detach",96,101
6,1,48,1,13,"initialize_rand@43-56@usr.sbin/bind/lib/isc/random.c","usr.sbin/bind/lib/isc/random.c","initialize_rand",43,56
4,1,19,1,3,"initialize@59-62@usr.sbin/bind/lib/isc/random.c","usr.sbin/bind/lib/isc/random.c","initialize",59,62
5,1,16,1,7,"isc_random_seed@65-72@usr.sbin/bind/lib/isc/random.c","usr.sbin/bind/lib/isc/random.c","isc_random_seed",65,72
7,1,55,1,15,"isc_random_get@75-90@usr.sbin/bind/lib/isc/random.c","usr.sbin/bind/lib/isc/random.c","isc_random_get",75,90
18,6,82,1,40,"isc_random_uniform@93-133@usr.sbin/bind/lib/isc/random.c","usr.sbin/bind/lib/isc/random.c","isc_random_uniform",93,133
7,2,37,2,6,"isc_random_jitter@136-142@usr.sbin/bind/lib/isc/random.c","usr.sbin/bind/lib/isc/random.c","isc_random_jitter",136,142
38,5,244,4,47,"isc_ratelimiter_create@60-107@usr.sbin/bind/lib/isc/ratelimiter.c","usr.sbin/bind/lib/isc/ratelimiter.c","isc_ratelimiter_create",60,107
11,2,75,2,13,"isc_ratelimiter_setinterval@110-123@usr.sbin/bind/lib/isc/ratelimiter.c","usr.sbin/bind/lib/isc/ratelimiter.c","isc_ratelimiter_setinterval",110,123
5,2,27,2,4,"isc_ratelimiter_setpertic@126-130@usr.sbin/bind/lib/isc/ratelimiter.c","usr.sbin/bind/lib/isc/ratelimiter.c","isc_ratelimiter_setpertic",126,130
32,8,209,3,33,"isc_ratelimiter_enqueue@133-166@usr.sbin/bind/lib/isc/ratelimiter.c","usr.sbin/bind/lib/isc/ratelimiter.c","isc_ratelimiter_enqueue",133,166
30,4,176,2,39,"ratelimiter_tick@169-208@usr.sbin/bind/lib/isc/ratelimiter.c","usr.sbin/bind/lib/isc/ratelimiter.c","ratelimiter_tick",169,208
18,2,129,1,22,"isc_ratelimiter_shutdown@211-233@usr.sbin/bind/lib/isc/ratelimiter.c","usr.sbin/bind/lib/isc/ratelimiter.c","isc_ratelimiter_shutdown",211,233
5,1,35,2,6,"ratelimiter_shutdowncomplete@236-242@usr.sbin/bind/lib/isc/ratelimiter.c","usr.sbin/bind/lib/isc/ratelimiter.c","ratelimiter_shutdowncomplete",236,242
4,1,31,1,3,"ratelimiter_free@245-248@usr.sbin/bind/lib/isc/ratelimiter.c","usr.sbin/bind/lib/isc/ratelimiter.c","ratelimiter_free",245,248
10,2,75,2,10,"isc_ratelimiter_attach@251-261@usr.sbin/bind/lib/isc/ratelimiter.c","usr.sbin/bind/lib/isc/ratelimiter.c","isc_ratelimiter_attach",251,261
13,3,76,1,15,"isc_ratelimiter_detach@264-279@usr.sbin/bind/lib/isc/ratelimiter.c","usr.sbin/bind/lib/isc/ratelimiter.c","isc_ratelimiter_detach",264,279
19,5,92,1,19,"isc_ratelimiter_stall@282-301@usr.sbin/bind/lib/isc/ratelimiter.c","usr.sbin/bind/lib/isc/ratelimiter.c","isc_ratelimiter_stall",282,301
24,7,115,1,24,"isc_ratelimiter_release@304-328@usr.sbin/bind/lib/isc/ratelimiter.c","usr.sbin/bind/lib/isc/ratelimiter.c","isc_ratelimiter_release",304,328
6,2,41,2,9,"isc_refcount_init@28-37@usr.sbin/bind/lib/isc/refcount.c","usr.sbin/bind/lib/isc/refcount.c","isc_refcount_init",28,37
12,6,119,2,14,"isc_region_compare@31-45@usr.sbin/bind/lib/isc/region.c","usr.sbin/bind/lib/isc/region.c","isc_region_compare",31,45
21,2,139,5,30,"register_table@114-144@usr.sbin/bind/lib/isc/result.c","usr.sbin/bind/lib/isc/result.c","register_table",114,144
13,2,68,1,14,"initialize_action@147-161@usr.sbin/bind/lib/isc/result.c","usr.sbin/bind/lib/isc/result.c","initialize_action",147,161
4,1,23,1,3,"initialize@164-167@usr.sbin/bind/lib/isc/result.c","usr.sbin/bind/lib/isc/result.c","initialize",164,167
24,5,149,1,33,"isc_result_totext@170-203@usr.sbin/bind/lib/isc/result.c","usr.sbin/bind/lib/isc/result.c","isc_result_totext",170,203
6,1,44,5,6,"isc_result_register@206-212@usr.sbin/bind/lib/isc/result.c","usr.sbin/bind/lib/isc/result.c","isc_result_register",206,212
20,3,115,3,19,"print_lock@51-70@usr.sbin/bind/lib/isc/rwlock.c","usr.sbin/bind/lib/isc/rwlock.c","print_lock",51,70
61,9,323,3,76,"isc_rwlock_init@74-150@usr.sbin/bind/lib/isc/rwlock.c","usr.sbin/bind/lib/isc/rwlock.c","isc_rwlock_init",74,150
14,6,112,1,18,"isc_rwlock_destroy@153-171@usr.sbin/bind/lib/isc/rwlock.c","usr.sbin/bind/lib/isc/rwlock.c","isc_rwlock_destroy",153,171
57,14,385,2,106,"isc_rwlock_lock@241-347@usr.sbin/bind/lib/isc/rwlock.c","usr.sbin/bind/lib/isc/rwlock.c","isc_rwlock_lock",241,347
32,9,215,2,59,"isc_rwlock_trylock@350-409@usr.sbin/bind/lib/isc/rwlock.c","usr.sbin/bind/lib/isc/rwlock.c","isc_rwlock_trylock",350,409
13,3,85,1,26,"isc_rwlock_tryupgrade@412-438@usr.sbin/bind/lib/isc/rwlock.c","usr.sbin/bind/lib/isc/rwlock.c","isc_rwlock_tryupgrade",412,438
12,2,101,1,19,"isc_rwlock_downgrade@441-460@usr.sbin/bind/lib/isc/rwlock.c","usr.sbin/bind/lib/isc/rwlock.c","isc_rwlock_downgrade",441,460
39,12,265,2,68,"isc_rwlock_unlock@463-531@usr.sbin/bind/lib/isc/rwlock.c","usr.sbin/bind/lib/isc/rwlock.c","isc_rwlock_unlock",463,531
57,17,328,3,67,"doit@536-603@usr.sbin/bind/lib/isc/rwlock.c","usr.sbin/bind/lib/isc/rwlock.c","doit",536,603
3,1,23,2,2,"isc_rwlock_lock@606-608@usr.sbin/bind/lib/isc/rwlock.c","usr.sbin/bind/lib/isc/rwlock.c","isc_rwlock_lock",606,608
3,1,23,2,2,"isc_rwlock_trylock@611-613@usr.sbin/bind/lib/isc/rwlock.c","usr.sbin/bind/lib/isc/rwlock.c","isc_rwlock_trylock",611,613
15,3,97,1,18,"isc_rwlock_tryupgrade@616-634@usr.sbin/bind/lib/isc/rwlock.c","usr.sbin/bind/lib/isc/rwlock.c","isc_rwlock_tryupgrade",616,634
14,6,110,1,20,"isc_rwlock_downgrade@637-657@usr.sbin/bind/lib/isc/rwlock.c","usr.sbin/bind/lib/isc/rwlock.c","isc_rwlock_downgrade",637,657
47,12,302,2,58,"isc_rwlock_unlock@660-718@usr.sbin/bind/lib/isc/rwlock.c","usr.sbin/bind/lib/isc/rwlock.c","isc_rwlock_unlock",660,718
11,1,56,3,13,"isc_rwlock_init@724-737@usr.sbin/bind/lib/isc/rwlock.c","usr.sbin/bind/lib/isc/rwlock.c","isc_rwlock_init",724,737
15,5,90,2,15,"isc_rwlock_lock@740-755@usr.sbin/bind/lib/isc/rwlock.c","usr.sbin/bind/lib/isc/rwlock.c","isc_rwlock_lock",740,755
3,1,21,2,2,"isc_rwlock_trylock@758-760@usr.sbin/bind/lib/isc/rwlock.c","usr.sbin/bind/lib/isc/rwlock.c","isc_rwlock_trylock",758,760
11,2,63,1,13,"isc_rwlock_tryupgrade@763-776@usr.sbin/bind/lib/isc/rwlock.c","usr.sbin/bind/lib/isc/rwlock.c","isc_rwlock_tryupgrade",763,776
6,1,40,1,7,"isc_rwlock_downgrade@779-786@usr.sbin/bind/lib/isc/rwlock.c","usr.sbin/bind/lib/isc/rwlock.c","isc_rwlock_downgrade",779,786
8,1,52,2,10,"isc_rwlock_unlock@789-799@usr.sbin/bind/lib/isc/rwlock.c","usr.sbin/bind/lib/isc/rwlock.c","isc_rwlock_unlock",789,799
5,1,30,1,4,"isc_rwlock_destroy@802-806@usr.sbin/bind/lib/isc/rwlock.c","usr.sbin/bind/lib/isc/rwlock.c","isc_rwlock_destroy",802,806
5,3,45,2,7,"isc_serial_lt@27-34@usr.sbin/bind/lib/isc/serial.c","usr.sbin/bind/lib/isc/serial.c","isc_serial_lt",27,34
3,2,30,2,2,"isc_serial_gt@37-39@usr.sbin/bind/lib/isc/serial.c","usr.sbin/bind/lib/isc/serial.c","isc_serial_gt",37,39
3,2,28,2,2,"isc_serial_le@42-44@usr.sbin/bind/lib/isc/serial.c","usr.sbin/bind/lib/isc/serial.c","isc_serial_le",42,44
3,2,28,2,2,"isc_serial_ge@47-49@usr.sbin/bind/lib/isc/serial.c","usr.sbin/bind/lib/isc/serial.c","isc_serial_ge",47,49
3,2,23,2,2,"isc_serial_eq@52-54@usr.sbin/bind/lib/isc/serial.c","usr.sbin/bind/lib/isc/serial.c","isc_serial_eq",52,54
3,2,23,2,2,"isc_serial_ne@57-59@usr.sbin/bind/lib/isc/serial.c","usr.sbin/bind/lib/isc/serial.c","isc_serial_ne",57,59
11,1,328,6,10,"do_R01@109-119@usr.sbin/bind/lib/isc/sha1.c","usr.sbin/bind/lib/isc/sha1.c","do_R01",109,119
11,1,328,6,10,"do_R2@122-132@usr.sbin/bind/lib/isc/sha1.c","usr.sbin/bind/lib/isc/sha1.c","do_R2",122,132
11,1,328,6,10,"do_R3@135-145@usr.sbin/bind/lib/isc/sha1.c","usr.sbin/bind/lib/isc/sha1.c","do_R3",135,145
11,1,328,6,10,"do_R4@148-158@usr.sbin/bind/lib/isc/sha1.c","usr.sbin/bind/lib/isc/sha1.c","do_R4",148,158
44,2,1429,2,56,"transform@165-221@usr.sbin/bind/lib/isc/sha1.c","usr.sbin/bind/lib/isc/sha1.c","transform",165,221
11,1,78,1,12,"isc_sha1_init@228-240@usr.sbin/bind/lib/isc/sha1.c","usr.sbin/bind/lib/isc/sha1.c","isc_sha1_init",228,240
3,1,20,1,2,"isc_sha1_invalidate@243-245@usr.sbin/bind/lib/isc/sha1.c","usr.sbin/bind/lib/isc/sha1.c","isc_sha1_invalidate",243,245
21,4,200,3,23,"isc_sha1_update@251-274@usr.sbin/bind/lib/isc/sha1.c","usr.sbin/bind/lib/isc/sha1.c","isc_sha1_update",251,274
22,6,213,2,28,"isc_sha1_final@285-313@usr.sbin/bind/lib/isc/sha1.c","usr.sbin/bind/lib/isc/sha1.c","isc_sha1_final",285,313
9,2,50,1,8,"isc_sha224_init@407-415@usr.sbin/bind/lib/isc/sha2.c","usr.sbin/bind/lib/isc/sha2.c","isc_sha224_init",407,415
3,1,29,3,2,"isc_sha224_update@418-420@usr.sbin/bind/lib/isc/sha2.c","usr.sbin/bind/lib/isc/sha2.c","isc_sha224_update",418,420
6,1,48,2,5,"isc_sha224_final@423-428@usr.sbin/bind/lib/isc/sha2.c","usr.sbin/bind/lib/isc/sha2.c","isc_sha224_final",423,428
18,3,141,2,21,"isc_sha224_end@431-452@usr.sbin/bind/lib/isc/sha2.c","usr.sbin/bind/lib/isc/sha2.c","isc_sha224_end",431,452
8,1,48,3,8,"isc_sha224_data@455-463@usr.sbin/bind/lib/isc/sha2.c","usr.sbin/bind/lib/isc/sha2.c","isc_sha224_data",455,463
9,2,50,1,8,"isc_sha256_init@467-475@usr.sbin/bind/lib/isc/sha2.c","usr.sbin/bind/lib/isc/sha2.c","isc_sha256_init",467,475
44,3,545,2,54,"isc_sha256_transform@514-568@usr.sbin/bind/lib/isc/sha2.c","usr.sbin/bind/lib/isc/sha2.c","isc_sha256_transform",514,568
57,4,516,2,76,"isc_sha256_transform@573-649@usr.sbin/bind/lib/isc/sha2.c","usr.sbin/bind/lib/isc/sha2.c","isc_sha256_transform",573,649
37,7,255,3,49,"isc_sha256_update@654-703@usr.sbin/bind/lib/isc/sha2.c","usr.sbin/bind/lib/isc/sha2.c","isc_sha256_update",654,703
42,8,302,2,67,"isc_sha256_final@706-773@usr.sbin/bind/lib/isc/sha2.c","usr.sbin/bind/lib/isc/sha2.c","isc_sha256_final",706,773
18,3,141,2,21,"isc_sha256_end@776-797@usr.sbin/bind/lib/isc/sha2.c","usr.sbin/bind/lib/isc/sha2.c","isc_sha256_end",776,797
8,1,48,3,8,"isc_sha256_data@800-808@usr.sbin/bind/lib/isc/sha2.c","usr.sbin/bind/lib/isc/sha2.c","isc_sha256_data",800,808
9,2,60,1,8,"isc_sha512_init@813-821@usr.sbin/bind/lib/isc/sha2.c","usr.sbin/bind/lib/isc/sha2.c","isc_sha512_init",813,821
43,3,543,2,51,"isc_sha512_transform@859-910@usr.sbin/bind/lib/isc/sha2.c","usr.sbin/bind/lib/isc/sha2.c","isc_sha512_transform",859,910
56,4,514,2,74,"isc_sha512_transform@915-989@usr.sbin/bind/lib/isc/sha2.c","usr.sbin/bind/lib/isc/sha2.c","isc_sha512_transform",915,989
37,7,270,3,49,"isc_sha512_update@993-1042@usr.sbin/bind/lib/isc/sha2.c","usr.sbin/bind/lib/isc/sha2.c","isc_sha512_update",993,1042
28,5,241,1,43,"isc_sha512_last@1044-1087@usr.sbin/bind/lib/isc/sha2.c","usr.sbin/bind/lib/isc/sha2.c","isc_sha512_last",1044,1087
16,4,123,2,27,"isc_sha512_final@1089-1116@usr.sbin/bind/lib/isc/sha2.c","usr.sbin/bind/lib/isc/sha2.c","isc_sha512_final",1089,1116
18,3,141,2,21,"isc_sha512_end@1119-1140@usr.sbin/bind/lib/isc/sha2.c","usr.sbin/bind/lib/isc/sha2.c","isc_sha512_end",1119,1140
8,1,48,3,8,"isc_sha512_data@1143-1151@usr.sbin/bind/lib/isc/sha2.c","usr.sbin/bind/lib/isc/sha2.c","isc_sha512_data",1143,1151
9,2,60,1,8,"isc_sha384_init@1156-1164@usr.sbin/bind/lib/isc/sha2.c","usr.sbin/bind/lib/isc/sha2.c","isc_sha384_init",1156,1164
3,1,29,3,2,"isc_sha384_update@1167-1169@usr.sbin/bind/lib/isc/sha2.c","usr.sbin/bind/lib/isc/sha2.c","isc_sha384_update",1167,1169
16,4,127,2,27,"isc_sha384_final@1172-1199@usr.sbin/bind/lib/isc/sha2.c","usr.sbin/bind/lib/isc/sha2.c","isc_sha384_final",1172,1199
18,3,141,2,21,"isc_sha384_end@1202-1223@usr.sbin/bind/lib/isc/sha2.c","usr.sbin/bind/lib/isc/sha2.c","isc_sha384_end",1202,1223
8,1,48,3,8,"isc_sha384_data@1226-1234@usr.sbin/bind/lib/isc/sha2.c","usr.sbin/bind/lib/isc/sha2.c","isc_sha384_data",1226,1234
11,2,74,1,13,"isc_shuffle_init@32-45@usr.sbin/bind/lib/isc/shuffle.c","usr.sbin/bind/lib/isc/shuffle.c","isc_shuffle_init",32,45
17,2,109,1,19,"isc_shuffle_generate16@48-67@usr.sbin/bind/lib/isc/shuffle.c","usr.sbin/bind/lib/isc/shuffle.c","isc_shuffle_generate16",48,67
5,1,30,2,4,"isc_sockaddr_equal@37-41@usr.sbin/bind/lib/isc/sockaddr.c","usr.sbin/bind/lib/isc/sockaddr.c","isc_sockaddr_equal",37,41
4,1,28,2,3,"isc_sockaddr_eqaddr@44-47@usr.sbin/bind/lib/isc/sockaddr.c","usr.sbin/bind/lib/isc/sockaddr.c","isc_sockaddr_eqaddr",44,47
39,21,345,3,51,"isc_sockaddr_compare@50-101@usr.sbin/bind/lib/isc/sockaddr.c","usr.sbin/bind/lib/isc/sockaddr.c","isc_sockaddr_compare",50,101
8,1,53,3,7,"isc_sockaddr_eqaddrprefix@104-111@usr.sbin/bind/lib/isc/sockaddr.c","usr.sbin/bind/lib/isc/sockaddr.c","isc_sockaddr_eqaddrprefix",104,111
41,8,318,2,64,"isc_sockaddr_totext@114-178@usr.sbin/bind/lib/isc/sockaddr.c","usr.sbin/bind/lib/isc/sockaddr.c","isc_sockaddr_totext",114,178
14,2,86,3,17,"isc_sockaddr_format@181-198@usr.sbin/bind/lib/isc/sockaddr.c","usr.sbin/bind/lib/isc/sockaddr.c","isc_sockaddr_format",181,198
44,5,314,2,47,"isc_sockaddr_hash@201-248@usr.sbin/bind/lib/isc/sockaddr.c","usr.sbin/bind/lib/isc/sockaddr.c","isc_sockaddr_hash",201,248
10,2,90,1,11,"isc_sockaddr_any@251-262@usr.sbin/bind/lib/isc/sockaddr.c","usr.sbin/bind/lib/isc/sockaddr.c","isc_sockaddr_any",251,262
10,2,88,1,11,"isc_sockaddr_any6@265-276@usr.sbin/bind/lib/isc/sockaddr.c","usr.sbin/bind/lib/isc/sockaddr.c","isc_sockaddr_any6",265,276
11,2,101,3,12,"isc_sockaddr_fromin@279-291@usr.sbin/bind/lib/isc/sockaddr.c","usr.sbin/bind/lib/isc/sockaddr.c","isc_sockaddr_fromin",279,291
12,3,44,2,11,"isc_sockaddr_anyofpf@294-305@usr.sbin/bind/lib/isc/sockaddr.c","usr.sbin/bind/lib/isc/sockaddr.c","isc_sockaddr_anyofpf",294,305
11,2,101,3,12,"isc_sockaddr_fromin6@308-320@usr.sbin/bind/lib/isc/sockaddr.c","usr.sbin/bind/lib/isc/sockaddr.c","isc_sockaddr_fromin6",308,320
13,2,141,3,14,"isc_sockaddr_v6fromin@323-337@usr.sbin/bind/lib/isc/sockaddr.c","usr.sbin/bind/lib/isc/sockaddr.c","isc_sockaddr_v6fromin",323,337
15,4,79,1,25,"isc_sockaddr_pf@340-365@usr.sbin/bind/lib/isc/sockaddr.c","usr.sbin/bind/lib/isc/sockaddr.c","isc_sockaddr_pf",340,365
24,6,207,3,29,"isc_sockaddr_fromnetaddr@368-397@usr.sbin/bind/lib/isc/sockaddr.c","usr.sbin/bind/lib/isc/sockaddr.c","isc_sockaddr_fromnetaddr",368,397
16,3,90,2,15,"isc_sockaddr_setport@400-415@usr.sbin/bind/lib/isc/sockaddr.c","usr.sbin/bind/lib/isc/sockaddr.c","isc_sockaddr_setport",400,415
18,3,98,1,19,"isc_sockaddr_getport@418-437@usr.sbin/bind/lib/isc/sockaddr.c","usr.sbin/bind/lib/isc/sockaddr.c","isc_sockaddr_getport",418,437
9,3,58,1,9,"isc_sockaddr_ismulticast@440-449@usr.sbin/bind/lib/isc/sockaddr.c","usr.sbin/bind/lib/isc/sockaddr.c","isc_sockaddr_ismulticast",440,449
8,2,48,1,8,"isc_sockaddr_isexperimental@452-460@usr.sbin/bind/lib/isc/sockaddr.c","usr.sbin/bind/lib/isc/sockaddr.c","isc_sockaddr_isexperimental",452,460
8,2,48,1,8,"isc_sockaddr_issitelocal@463-471@usr.sbin/bind/lib/isc/sockaddr.c","usr.sbin/bind/lib/isc/sockaddr.c","isc_sockaddr_issitelocal",463,471
8,2,48,1,8,"isc_sockaddr_islinklocal@474-482@usr.sbin/bind/lib/isc/sockaddr.c","usr.sbin/bind/lib/isc/sockaddr.c","isc_sockaddr_islinklocal",474,482
14,4,137,2,18,"isc_sockaddr_frompath@485-503@usr.sbin/bind/lib/isc/sockaddr.c","usr.sbin/bind/lib/isc/sockaddr.c","isc_sockaddr_frompath",485,503
55,18,328,3,61,"isc_string_touint64@35-96@usr.sbin/bind/lib/isc/string.c","usr.sbin/bind/lib/isc/string.c","isc_string_touint64",35,96
9,2,67,3,11,"isc_string_copy@99-110@usr.sbin/bind/lib/isc/string.c","usr.sbin/bind/lib/isc/string.c","isc_string_copy",99,110
5,1,42,3,6,"isc_string_copy_truncate@113-119@usr.sbin/bind/lib/isc/string.c","usr.sbin/bind/lib/isc/string.c","isc_string_copy_truncate",113,119
10,2,77,3,12,"isc_string_append@122-134@usr.sbin/bind/lib/isc/string.c","usr.sbin/bind/lib/isc/string.c","isc_string_append",122,134
6,1,52,3,7,"isc_string_append_truncate@137-144@usr.sbin/bind/lib/isc/string.c","usr.sbin/bind/lib/isc/string.c","isc_string_append_truncate",137,144
14,2,93,4,18,"isc_string_printf@147-165@usr.sbin/bind/lib/isc/string.c","usr.sbin/bind/lib/isc/string.c","isc_string_printf",147,165
9,1,66,4,11,"isc_string_printf_truncate@168-179@usr.sbin/bind/lib/isc/string.c","usr.sbin/bind/lib/isc/string.c","isc_string_printf_truncate",168,179
11,2,83,2,13,"isc_string_regiondup@182-195@usr.sbin/bind/lib/isc/string.c","usr.sbin/bind/lib/isc/string.c","isc_string_regiondup",182,195
17,5,115,2,18,"isc_string_separate@198-216@usr.sbin/bind/lib/isc/string.c","usr.sbin/bind/lib/isc/string.c","isc_string_separate",198,216
19,8,109,3,23,"isc_string_strlcpy@219-242@usr.sbin/bind/lib/isc/string.c","usr.sbin/bind/lib/isc/string.c","isc_string_strlcpy",219,242
22,6,126,3,25,"isc_string_strlcat@245-270@usr.sbin/bind/lib/isc/string.c","usr.sbin/bind/lib/isc/string.c","isc_string_strlcat",245,270
52,25,346,3,55,"isc_strtoul@74-129@usr.sbin/bind/lib/isc/strtoul.c","usr.sbin/bind/lib/isc/strtoul.c","isc_strtoul",74,129
31,5,205,6,34,"isc_symtab_create@56-90@usr.sbin/bind/lib/isc/symtab.c","usr.sbin/bind/lib/isc/symtab.c","isc_symtab_create",56,90
24,4,185,1,26,"isc_symtab_destroy@93-119@usr.sbin/bind/lib/isc/symtab.c","usr.sbin/bind/lib/isc/symtab.c","isc_symtab_destroy",93,119
17,4,111,2,23,"hash@122-145@usr.sbin/bind/lib/isc/symtab.c","usr.sbin/bind/lib/isc/symtab.c","hash",122,145
14,3,86,4,18,"isc_symtab_lookup@164-182@usr.sbin/bind/lib/isc/symtab.c","usr.sbin/bind/lib/isc/symtab.c","isc_symtab_lookup",164,182
30,6,221,5,45,"isc_symtab_define@185-230@usr.sbin/bind/lib/isc/symtab.c","usr.sbin/bind/lib/isc/symtab.c","isc_symtab_define",185,230
15,3,129,3,19,"isc_symtab_undefine@233-252@usr.sbin/bind/lib/isc/symtab.c","usr.sbin/bind/lib/isc/symtab.c","isc_symtab_undefine",233,252
17,3,132,1,28,"task_finished@141-169@usr.sbin/bind/lib/isc/task.c","usr.sbin/bind/lib/isc/task.c","task_finished",141,169
47,8,312,3,54,"isc_task_create@172-226@usr.sbin/bind/lib/isc/task.c","usr.sbin/bind/lib/isc/task.c","isc_task_create",172,226
9,2,65,2,16,"isc_task_attach@229-245@usr.sbin/bind/lib/isc/task.c","usr.sbin/bind/lib/isc/task.c","isc_task_attach",229,245
25,5,157,1,34,"task_shutdown@248-282@usr.sbin/bind/lib/isc/task.c","usr.sbin/bind/lib/isc/task.c","task_shutdown",248,282
10,2,73,1,16,"task_ready@285-301@usr.sbin/bind/lib/isc/task.c","usr.sbin/bind/lib/isc/task.c","task_ready",285,301
11,3,69,1,26,"task_detach@304-330@usr.sbin/bind/lib/isc/task.c","usr.sbin/bind/lib/isc/task.c","task_detach",304,330
14,2,77,1,22,"isc_task_detach@333-355@usr.sbin/bind/lib/isc/task.c","usr.sbin/bind/lib/isc/task.c","isc_task_detach",333,355
20,3,129,2,27,"task_send@358-385@usr.sbin/bind/lib/isc/task.c","usr.sbin/bind/lib/isc/task.c","task_send",358,385
11,2,64,2,38,"isc_task_send@388-426@usr.sbin/bind/lib/isc/task.c","usr.sbin/bind/lib/isc/task.c","isc_task_send",388,426
16,4,104,2,31,"isc_task_sendanddetach@429-460@usr.sbin/bind/lib/isc/task.c","usr.sbin/bind/lib/isc/task.c","isc_task_sendanddetach",429,460
24,10,187,7,37,"dequeue_events@465-502@usr.sbin/bind/lib/isc/task.c","usr.sbin/bind/lib/isc/task.c","dequeue_events",465,502
16,2,105,5,28,"isc_task_purgerange@505-533@usr.sbin/bind/lib/isc/task.c","usr.sbin/bind/lib/isc/task.c","isc_task_purgerange",505,533
6,1,40,4,10,"isc_task_purge@536-546@usr.sbin/bind/lib/isc/task.c","usr.sbin/bind/lib/isc/task.c","isc_task_purge",536,546
19,5,121,2,39,"isc_task_purgeevent@549-588@usr.sbin/bind/lib/isc/task.c","usr.sbin/bind/lib/isc/task.c","isc_task_purgeevent",549,588
8,1,51,6,12,"isc_task_unsendrange@591-603@usr.sbin/bind/lib/isc/task.c","usr.sbin/bind/lib/isc/task.c","isc_task_unsendrange",591,603
7,1,48,5,11,"isc_task_unsend@606-617@usr.sbin/bind/lib/isc/task.c","usr.sbin/bind/lib/isc/task.c","isc_task_unsend",606,617
26,4,152,3,35,"isc_task_onshutdown@620-655@usr.sbin/bind/lib/isc/task.c","usr.sbin/bind/lib/isc/task.c","isc_task_onshutdown",620,655
9,2,51,1,15,"isc_task_shutdown@658-673@usr.sbin/bind/lib/isc/task.c","usr.sbin/bind/lib/isc/task.c","isc_task_shutdown",658,673
5,1,26,1,10,"isc_task_destroy@676-686@usr.sbin/bind/lib/isc/task.c","usr.sbin/bind/lib/isc/task.c","isc_task_destroy",676,686
10,2,89,3,19,"isc_task_setname@689-708@usr.sbin/bind/lib/isc/task.c","usr.sbin/bind/lib/isc/task.c","isc_task_setname",689,708
3,1,15,1,2,"isc_task_getname@711-713@usr.sbin/bind/lib/isc/task.c","usr.sbin/bind/lib/isc/task.c","isc_task_getname",711,713
3,1,15,1,2,"isc_task_gettag@716-718@usr.sbin/bind/lib/isc/task.c","usr.sbin/bind/lib/isc/task.c","isc_task_gettag",716,718
7,1,50,2,9,"isc_task_getcurrenttime@721-730@usr.sbin/bind/lib/isc/task.c","usr.sbin/bind/lib/isc/task.c","isc_task_getcurrenttime",721,730
111,25,612,1,261,"dispatch@736-997@usr.sbin/bind/lib/isc/task.c","usr.sbin/bind/lib/isc/task.c","dispatch",736,997
9,1,55,1,12,"run@1004-1016@usr.sbin/bind/lib/isc/task.c","usr.sbin/bind/lib/isc/task.c","run",1004,1016
11,2,84,1,13,"manager_free@1020-1033@usr.sbin/bind/lib/isc/task.c","usr.sbin/bind/lib/isc/task.c","manager_free",1020,1033
85,15,485,4,111,"isc_taskmgr_create@1036-1147@usr.sbin/bind/lib/isc/task.c","usr.sbin/bind/lib/isc/task.c","isc_taskmgr_create",1036,1147
38,8,256,1,90,"isc_taskmgr_destroy@1150-1240@usr.sbin/bind/lib/isc/task.c","usr.sbin/bind/lib/isc/task.c","isc_taskmgr_destroy",1150,1240
5,2,31,1,4,"isc__taskmgr_ready@1244-1248@usr.sbin/bind/lib/isc/task.c","usr.sbin/bind/lib/isc/task.c","isc__taskmgr_ready",1244,1248
7,2,33,1,9,"isc__taskmgr_dispatch@1251-1260@usr.sbin/bind/lib/isc/task.c","usr.sbin/bind/lib/isc/task.c","isc__taskmgr_dispatch",1251,1260
16,4,101,1,18,"isc_task_beginexclusive@1265-1283@usr.sbin/bind/lib/isc/task.c","usr.sbin/bind/lib/isc/task.c","isc_task_beginexclusive",1265,1283
10,2,67,1,12,"isc_task_endexclusive@1286-1298@usr.sbin/bind/lib/isc/task.c","usr.sbin/bind/lib/isc/task.c","isc_task_endexclusive",1286,1298
30,6,206,5,30,"isc_taskpool_create@42-72@usr.sbin/bind/lib/isc/taskpool.c","usr.sbin/bind/lib/isc/taskpool.c","isc_taskpool_create",42,72
5,1,32,3,4,"isc_taskpool_gettask@74-78@usr.sbin/bind/lib/isc/taskpool.c","usr.sbin/bind/lib/isc/taskpool.c","isc_taskpool_gettask",74,78
13,3,101,1,12,"isc_taskpool_destroy@81-93@usr.sbin/bind/lib/isc/taskpool.c","usr.sbin/bind/lib/isc/taskpool.c","isc_taskpool_destroy",81,93
77,25,491,3,131,"schedule@111-242@usr.sbin/bind/lib/isc/timer.c","usr.sbin/bind/lib/isc/timer.c","schedule",111,242
19,5,104,1,25,"deschedule@245-270@usr.sbin/bind/lib/isc/timer.c","usr.sbin/bind/lib/isc/timer.c","deschedule",245,270
16,1,103,1,23,"destroy@273-296@usr.sbin/bind/lib/isc/timer.c","usr.sbin/bind/lib/isc/timer.c","destroy",273,296
72,17,498,8,115,"isc_timer_create@299-414@usr.sbin/bind/lib/isc/timer.c","usr.sbin/bind/lib/isc/timer.c","isc_timer_create",299,414
52,13,304,5,73,"isc_timer_reset@417-490@usr.sbin/bind/lib/isc/timer.c","usr.sbin/bind/lib/isc/timer.c","isc_timer_reset",417,490
8,1,46,1,10,"isc_timer_gettype@493-503@usr.sbin/bind/lib/isc/timer.c","usr.sbin/bind/lib/isc/timer.c","isc_timer_gettype",493,503
10,1,67,1,27,"isc_timer_touch@506-533@usr.sbin/bind/lib/isc/timer.c","usr.sbin/bind/lib/isc/timer.c","isc_timer_touch",506,533
8,2,58,2,13,"isc_timer_attach@536-549@usr.sbin/bind/lib/isc/timer.c","usr.sbin/bind/lib/isc/timer.c","isc_timer_attach",536,549
16,3,93,1,23,"isc_timer_detach@552-575@usr.sbin/bind/lib/isc/timer.c","usr.sbin/bind/lib/isc/timer.c","isc_timer_detach",552,575
99,16,488,2,115,"dispatch@578-693@usr.sbin/bind/lib/isc/timer.c","usr.sbin/bind/lib/isc/timer.c","dispatch",578,693
31,4,190,1,35,"run@700-735@usr.sbin/bind/lib/isc/timer.c","usr.sbin/bind/lib/isc/timer.c","run",700,735
10,2,70,2,11,"sooner@739-750@usr.sbin/bind/lib/isc/timer.c","usr.sbin/bind/lib/isc/timer.c","sooner",739,750
6,1,34,2,7,"set_index@753-760@usr.sbin/bind/lib/isc/timer.c","usr.sbin/bind/lib/isc/timer.c","set_index",753,760
61,9,415,2,75,"isc_timermgr_create@763-838@usr.sbin/bind/lib/isc/timer.c","usr.sbin/bind/lib/isc/timer.c","isc_timermgr_create",763,838
5,2,29,1,8,"isc_timermgr_poke@841-849@usr.sbin/bind/lib/isc/timer.c","usr.sbin/bind/lib/isc/timer.c","isc_timermgr_poke",841,849
34,6,220,1,61,"isc_timermgr_destroy@852-913@usr.sbin/bind/lib/isc/timer.c","usr.sbin/bind/lib/isc/timer.c","isc_timermgr_destroy",852,913
6,3,37,1,5,"isc__timermgr_nextevent@917-922@usr.sbin/bind/lib/isc/timer.c","usr.sbin/bind/lib/isc/timer.c","isc__timermgr_nextevent",917,922
7,2,31,1,6,"isc__timermgr_dispatch@925-931@usr.sbin/bind/lib/isc/timer.c","usr.sbin/bind/lib/isc/timer.c","isc__timermgr_dispatch",925,931
13,3,64,1,14,"isccc_alist_create@44-58@usr.sbin/bind/lib/isccc/alist.c","usr.sbin/bind/lib/isccc/alist.c","isccc_alist_create",44,58
12,6,78,1,12,"isccc_alist_alistp@61-73@usr.sbin/bind/lib/isccc/alist.c","usr.sbin/bind/lib/isccc/alist.c","isccc_alist_alistp",61,73
7,2,35,1,7,"isccc_alist_emptyp@76-83@usr.sbin/bind/lib/isccc/alist.c","usr.sbin/bind/lib/isccc/alist.c","isccc_alist_emptyp",76,83
5,1,24,1,5,"isccc_alist_first@86-91@usr.sbin/bind/lib/isccc/alist.c","usr.sbin/bind/lib/isccc/alist.c","isccc_alist_first",86,91
17,4,113,2,23,"isccc_alist_assq@94-117@usr.sbin/bind/lib/isccc/alist.c","usr.sbin/bind/lib/isccc/alist.c","isccc_alist_assq",94,117
22,5,148,2,23,"isccc_alist_delete@120-143@usr.sbin/bind/lib/isccc/alist.c","usr.sbin/bind/lib/isccc/alist.c","isccc_alist_delete",120,143
24,5,143,3,31,"isccc_alist_define@146-177@usr.sbin/bind/lib/isccc/alist.c","usr.sbin/bind/lib/isccc/alist.c","isccc_alist_define",146,177
11,3,71,3,12,"isccc_alist_definestring@180-192@usr.sbin/bind/lib/isccc/alist.c","usr.sbin/bind/lib/isccc/alist.c","isccc_alist_definestring",180,192
11,3,70,3,12,"isccc_alist_definebinary@195-207@usr.sbin/bind/lib/isccc/alist.c","usr.sbin/bind/lib/isccc/alist.c","isccc_alist_definebinary",195,207
8,2,45,2,8,"isccc_alist_lookup@210-218@usr.sbin/bind/lib/isccc/alist.c","usr.sbin/bind/lib/isccc/alist.c","isccc_alist_lookup",210,218
15,4,87,3,16,"isccc_alist_lookupstring@221-237@usr.sbin/bind/lib/isccc/alist.c","usr.sbin/bind/lib/isccc/alist.c","isccc_alist_lookupstring",221,237
15,4,87,3,16,"isccc_alist_lookupbinary@240-256@usr.sbin/bind/lib/isccc/alist.c","usr.sbin/bind/lib/isccc/alist.c","isccc_alist_lookupbinary",240,256
40,7,292,3,40,"isccc_alist_prettyprint@259-299@usr.sbin/bind/lib/isccc/alist.c","usr.sbin/bind/lib/isccc/alist.c","isccc_alist_prettyprint",259,299
16,2,116,4,17,"isccc_base64_encode@35-52@usr.sbin/bind/lib/isccc/base64.c","usr.sbin/bind/lib/isccc/base64.c","isccc_base64_encode",35,52
10,2,73,2,10,"isccc_base64_decode@55-65@usr.sbin/bind/lib/isccc/base64.c","usr.sbin/bind/lib/isccc/base64.c","isccc_base64_decode",55,65
45,10,325,2,67,"value_towire@74-141@usr.sbin/bind/lib/isccc/cc.c","usr.sbin/bind/lib/isccc/cc.c","value_towire",74,141
25,4,161,2,32,"table_towire@144-176@usr.sbin/bind/lib/isccc/cc.c","usr.sbin/bind/lib/isccc/cc.c","table_towire",144,176
11,3,58,2,12,"list_towire@179-191@usr.sbin/bind/lib/isccc/cc.c","usr.sbin/bind/lib/isccc/cc.c","list_towire",179,191
21,2,153,4,22,"sign@194-216@usr.sbin/bind/lib/isccc/cc.c","usr.sbin/bind/lib/isccc/cc.c","sign",194,216
23,5,155,3,38,"isccc_cc_towire@219-257@usr.sbin/bind/lib/isccc/cc.c","usr.sbin/bind/lib/isccc/cc.c","isccc_cc_towire",219,257
32,5,228,4,45,"verify@260-305@usr.sbin/bind/lib/isccc/cc.c","usr.sbin/bind/lib/isccc/cc.c","verify",260,305
31,7,189,2,32,"value_fromwire@315-347@usr.sbin/bind/lib/isccc/cc.c","usr.sbin/bind/lib/isccc/cc.c","value_fromwire",315,347
48,12,271,3,55,"table_fromwire@350-405@usr.sbin/bind/lib/isccc/cc.c","usr.sbin/bind/lib/isccc/cc.c","table_fromwire",350,405
21,4,111,2,23,"list_fromwire@408-431@usr.sbin/bind/lib/isccc/cc.c","usr.sbin/bind/lib/isccc/cc.c","list_fromwire",408,431
13,3,74,3,14,"isccc_cc_fromwire@434-448@usr.sbin/bind/lib/isccc/cc.c","usr.sbin/bind/lib/isccc/cc.c","isccc_cc_fromwire",434,448
45,16,273,8,55,"createmessage@451-506@usr.sbin/bind/lib/isccc/cc.c","usr.sbin/bind/lib/isccc/cc.c","createmessage",451,506
7,1,52,7,6,"isccc_cc_createmessage@509-515@usr.sbin/bind/lib/isccc/cc.c","usr.sbin/bind/lib/isccc/cc.c","isccc_cc_createmessage",509,515
35,9,236,3,47,"isccc_cc_createack@518-565@usr.sbin/bind/lib/isccc/cc.c","usr.sbin/bind/lib/isccc/cc.c","isccc_cc_createack",518,565
10,3,55,1,10,"isccc_cc_isack@568-578@usr.sbin/bind/lib/isccc/cc.c","usr.sbin/bind/lib/isccc/cc.c","isccc_cc_isack",568,578
10,3,55,1,10,"isccc_cc_isreply@581-591@usr.sbin/bind/lib/isccc/cc.c","usr.sbin/bind/lib/isccc/cc.c","isccc_cc_isreply",581,591
38,11,269,4,47,"isccc_cc_createresponse@594-641@usr.sbin/bind/lib/isccc/cc.c","usr.sbin/bind/lib/isccc/cc.c","isccc_cc_createresponse",594,641
9,1,63,3,10,"isccc_cc_definestring@644-654@usr.sbin/bind/lib/isccc/cc.c","usr.sbin/bind/lib/isccc/cc.c","isccc_cc_definestring",644,654
11,1,86,3,12,"isccc_cc_defineuint32@657-669@usr.sbin/bind/lib/isccc/cc.c","usr.sbin/bind/lib/isccc/cc.c","isccc_cc_defineuint32",657,669
15,4,87,3,16,"isccc_cc_lookupstring@672-688@usr.sbin/bind/lib/isccc/cc.c","usr.sbin/bind/lib/isccc/cc.c","isccc_cc_lookupstring",672,688
18,4,97,3,19,"isccc_cc_lookupuint32@691-710@usr.sbin/bind/lib/isccc/cc.c","usr.sbin/bind/lib/isccc/cc.c","isccc_cc_lookupuint32",691,710
8,1,39,4,8,"symtab_undefine@713-721@usr.sbin/bind/lib/isccc/cc.c","usr.sbin/bind/lib/isccc/cc.c","symtab_undefine",713,721
13,3,74,4,15,"symtab_clean@724-739@usr.sbin/bind/lib/isccc/cc.c","usr.sbin/bind/lib/isccc/cc.c","symtab_clean",724,739
5,1,24,1,4,"isccc_cc_createsymtab@742-746@usr.sbin/bind/lib/isccc/cc.c","usr.sbin/bind/lib/isccc/cc.c","isccc_cc_createsymtab",742,746
4,1,21,2,3,"isccc_cc_cleansymtab@749-752@usr.sbin/bind/lib/isccc/cc.c","usr.sbin/bind/lib/isccc/cc.c","isccc_cc_cleansymtab",749,752
11,6,61,1,11,"has_whitespace@755-766@usr.sbin/bind/lib/isccc/cc.c","usr.sbin/bind/lib/isccc/cc.c","has_whitespace",755,766
41,12,272,3,49,"isccc_cc_checkdup@769-818@usr.sbin/bind/lib/isccc/cc.c","usr.sbin/bind/lib/isccc/cc.c","isccc_cc_checkdup",769,818
42,6,256,2,52,"recv_length@41-93@usr.sbin/bind/lib/isccc/ccmsg.c","usr.sbin/bind/lib/isccc/ccmsg.c","recv_length",41,93
19,2,125,2,24,"recv_message@96-120@usr.sbin/bind/lib/isccc/ccmsg.c","usr.sbin/bind/lib/isccc/ccmsg.c","recv_message",96,120
14,1,95,3,17,"isccc_ccmsg_init@123-140@usr.sbin/bind/lib/isccc/ccmsg.c","usr.sbin/bind/lib/isccc/ccmsg.c","isccc_ccmsg_init",123,140
4,1,26,2,4,"isccc_ccmsg_setmaxsize@144-148@usr.sbin/bind/lib/isccc/ccmsg.c","usr.sbin/bind/lib/isccc/ccmsg.c","isccc_ccmsg_setmaxsize",144,148
29,3,208,4,35,"isccc_ccmsg_readmessage@152-187@usr.sbin/bind/lib/isccc/ccmsg.c","usr.sbin/bind/lib/isccc/ccmsg.c","isccc_ccmsg_readmessage",152,187
4,1,27,1,4,"isccc_ccmsg_cancelread@190-194@usr.sbin/bind/lib/isccc/ccmsg.c","usr.sbin/bind/lib/isccc/ccmsg.c","isccc_ccmsg_cancelread",190,194
8,2,63,1,9,"isccc_ccmsg_freebuffer@198-207@usr.sbin/bind/lib/isccc/ccmsg.c","usr.sbin/bind/lib/isccc/ccmsg.c","isccc_ccmsg_freebuffer",198,207
10,2,69,1,11,"isccc_ccmsg_invalidate@211-222@usr.sbin/bind/lib/isccc/ccmsg.c","usr.sbin/bind/lib/isccc/ccmsg.c","isccc_ccmsg_invalidate",211,222
3,1,14,1,2,"open_msgcat@52-54@usr.sbin/bind/lib/isccc/lib.c","usr.sbin/bind/lib/isccc/lib.c","open_msgcat",52,54
3,1,19,1,8,"isccc_lib_initmsgcat@57-65@usr.sbin/bind/lib/isccc/lib.c","usr.sbin/bind/lib/isccc/lib.c","isccc_lib_initmsgcat",57,65
9,2,41,1,9,"initialize_action@45-54@usr.sbin/bind/lib/isccc/result.c","usr.sbin/bind/lib/isccc/result.c","initialize_action",45,54
4,1,23,1,3,"initialize@57-60@usr.sbin/bind/lib/isccc/result.c","usr.sbin/bind/lib/isccc/result.c","initialize",57,60
4,1,19,1,4,"isccc_result_totext@63-67@usr.sbin/bind/lib/isccc/result.c","usr.sbin/bind/lib/isccc/result.c","isccc_result_totext",63,67
3,1,10,1,2,"isccc_result_register@70-72@usr.sbin/bind/lib/isccc/result.c","usr.sbin/bind/lib/isccc/result.c","isccc_result_register",70,72
11,2,63,2,12,"isccc_sexpr_cons@39-51@usr.sbin/bind/lib/isccc/sexpr.c","usr.sbin/bind/lib/isccc/sexpr.c","isccc_sexpr_cons",39,51
4,1,12,1,3,"isccc_sexpr_tconst@54-57@usr.sbin/bind/lib/isccc/sexpr.c","usr.sbin/bind/lib/isccc/sexpr.c","isccc_sexpr_tconst",54,57
14,3,79,1,15,"isccc_sexpr_fromstring@60-75@usr.sbin/bind/lib/isccc/sexpr.c","usr.sbin/bind/lib/isccc/sexpr.c","isccc_sexpr_fromstring",60,75
20,3,145,1,31,"isccc_sexpr_frombinary@78-109@usr.sbin/bind/lib/isccc/sexpr.c","usr.sbin/bind/lib/isccc/sexpr.c","isccc_sexpr_frombinary",78,109
26,7,120,1,27,"isccc_sexpr_free@112-139@usr.sbin/bind/lib/isccc/sexpr.c","usr.sbin/bind/lib/isccc/sexpr.c","isccc_sexpr_free",112,139
11,3,51,1,12,"printable@142-154@usr.sbin/bind/lib/isccc/sexpr.c","usr.sbin/bind/lib/isccc/sexpr.c","printable",142,154
48,11,270,2,49,"isccc_sexpr_print@157-206@usr.sbin/bind/lib/isccc/sexpr.c","usr.sbin/bind/lib/isccc/sexpr.c","isccc_sexpr_print",157,206
5,1,25,1,5,"isccc_sexpr_car@209-214@usr.sbin/bind/lib/isccc/sexpr.c","usr.sbin/bind/lib/isccc/sexpr.c","isccc_sexpr_car",209,214
5,1,25,1,5,"isccc_sexpr_cdr@217-222@usr.sbin/bind/lib/isccc/sexpr.c","usr.sbin/bind/lib/isccc/sexpr.c","isccc_sexpr_cdr",217,222
5,1,28,2,5,"isccc_sexpr_setcar@225-230@usr.sbin/bind/lib/isccc/sexpr.c","usr.sbin/bind/lib/isccc/sexpr.c","isccc_sexpr_setcar",225,230
5,1,28,2,5,"isccc_sexpr_setcdr@233-238@usr.sbin/bind/lib/isccc/sexpr.c","usr.sbin/bind/lib/isccc/sexpr.c","isccc_sexpr_setcdr",233,238
18,5,118,2,20,"isccc_sexpr_addtolist@241-261@usr.sbin/bind/lib/isccc/sexpr.c","usr.sbin/bind/lib/isccc/sexpr.c","isccc_sexpr_addtolist",241,261
6,3,30,1,5,"isccc_sexpr_listp@264-269@usr.sbin/bind/lib/isccc/sexpr.c","usr.sbin/bind/lib/isccc/sexpr.c","isccc_sexpr_listp",264,269
6,2,24,1,5,"isccc_sexpr_emptyp@272-277@usr.sbin/bind/lib/isccc/sexpr.c","usr.sbin/bind/lib/isccc/sexpr.c","isccc_sexpr_emptyp",272,277
6,3,30,1,5,"isccc_sexpr_stringp@280-285@usr.sbin/bind/lib/isccc/sexpr.c","usr.sbin/bind/lib/isccc/sexpr.c","isccc_sexpr_stringp",280,285
6,3,30,1,5,"isccc_sexpr_binaryp@288-293@usr.sbin/bind/lib/isccc/sexpr.c","usr.sbin/bind/lib/isccc/sexpr.c","isccc_sexpr_binaryp",288,293
9,4,61,1,9,"isccc_sexpr_tostring@296-305@usr.sbin/bind/lib/isccc/sexpr.c","usr.sbin/bind/lib/isccc/sexpr.c","isccc_sexpr_tostring",296,305
5,2,31,1,4,"isccc_sexpr_tobinary@308-312@usr.sbin/bind/lib/isccc/sexpr.c","usr.sbin/bind/lib/isccc/sexpr.c","isccc_sexpr_tobinary",308,312
28,5,168,5,31,"isccc_symtab_create@58-89@usr.sbin/bind/lib/isccc/symtab.c","usr.sbin/bind/lib/isccc/symtab.c","isccc_symtab_create",58,89
7,2,66,3,6,"free_elt@92-98@usr.sbin/bind/lib/isccc/symtab.c","usr.sbin/bind/lib/isccc/symtab.c","free_elt",92,98
20,3,125,1,22,"isccc_symtab_destroy@101-123@usr.sbin/bind/lib/isccc/symtab.c","usr.sbin/bind/lib/isccc/symtab.c","isccc_symtab_destroy",101,123
26,6,181,2,33,"hash@126-159@usr.sbin/bind/lib/isccc/symtab.c","usr.sbin/bind/lib/isccc/symtab.c","hash",126,159
14,3,86,4,18,"isccc_symtab_lookup@182-200@usr.sbin/bind/lib/isccc/symtab.c","usr.sbin/bind/lib/isccc/symtab.c","isccc_symtab_lookup",182,200
30,6,209,5,38,"isccc_symtab_define@203-241@usr.sbin/bind/lib/isccc/symtab.c","usr.sbin/bind/lib/isccc/symtab.c","isccc_symtab_define",203,241
11,2,78,3,15,"isccc_symtab_undefine@244-259@usr.sbin/bind/lib/isccc/symtab.c","usr.sbin/bind/lib/isccc/symtab.c","isccc_symtab_undefine",244,259
17,4,121,3,18,"isccc_symtab_foreach@262-280@usr.sbin/bind/lib/isccc/symtab.c","usr.sbin/bind/lib/isccc/symtab.c","isccc_symtab_foreach",262,280
3,1,15,1,2,"cfg_aclconfctx_init@36-38@usr.sbin/bind/lib/isccfg/aclconf.c","usr.sbin/bind/lib/isccfg/aclconf.c","cfg_aclconfctx_init",36,38
10,2,51,1,9,"cfg_aclconfctx_destroy@41-50@usr.sbin/bind/lib/isccfg/aclconf.c","usr.sbin/bind/lib/isccfg/aclconf.c","cfg_aclconfctx_destroy",41,50
19,4,137,3,19,"get_acl_def@56-75@usr.sbin/bind/lib/isccfg/aclconf.c","usr.sbin/bind/lib/isccfg/aclconf.c","get_acl_def",56,75
47,7,327,6,52,"convert_named_acl@78-130@usr.sbin/bind/lib/isccfg/aclconf.c","usr.sbin/bind/lib/isccfg/aclconf.c","convert_named_acl",78,130
22,2,137,4,22,"convert_keyname@133-155@usr.sbin/bind/lib/isccfg/aclconf.c","usr.sbin/bind/lib/isccfg/aclconf.c","convert_keyname",133,155
86,17,532,6,98,"cfg_acl_fromconfig@158-256@usr.sbin/bind/lib/isccfg/aclconf.c","usr.sbin/bind/lib/isccfg/aclconf.c","cfg_acl_fromconfig",158,256
5,1,29,1,5,"cfg_log_init@47-52@usr.sbin/bind/lib/isccfg/log.c","usr.sbin/bind/lib/isccfg/log.c","cfg_log_init",47,52
4,1,27,2,3,"print_none@462-465@usr.sbin/bind/lib/isccfg/namedconf.c","usr.sbin/bind/lib/isccfg/namedconf.c","print_none",462,465
13,3,89,3,12,"parse_qstringornone@475-487@usr.sbin/bind/lib/isccfg/namedconf.c","usr.sbin/bind/lib/isccfg/namedconf.c","parse_qstringornone",475,487
4,1,27,2,3,"doc_qstringornone@490-493@usr.sbin/bind/lib/isccfg/namedconf.c","usr.sbin/bind/lib/isccfg/namedconf.c","doc_qstringornone",490,493
4,1,27,2,3,"print_hostname@503-506@usr.sbin/bind/lib/isccfg/namedconf.c","usr.sbin/bind/lib/isccfg/namedconf.c","print_hostname",503,506
17,5,126,3,16,"parse_serverid@517-533@usr.sbin/bind/lib/isccfg/namedconf.c","usr.sbin/bind/lib/isccfg/namedconf.c","parse_serverid",517,533
4,1,27,2,3,"doc_serverid@536-539@usr.sbin/bind/lib/isccfg/namedconf.c","usr.sbin/bind/lib/isccfg/namedconf.c","doc_serverid",536,539
12,2,79,3,13,"parse_port@548-561@usr.sbin/bind/lib/isccfg/namedconf.c","usr.sbin/bind/lib/isccfg/namedconf.c","parse_port",548,561
34,11,167,2,36,"parse_unitstring@1057-1093@usr.sbin/bind/lib/isccfg/namedconf.c","usr.sbin/bind/lib/isccfg/namedconf.c","parse_unitstring",1057,1093
19,2,125,3,22,"parse_sizeval@1096-1118@usr.sbin/bind/lib/isccfg/namedconf.c","usr.sbin/bind/lib/isccfg/namedconf.c","parse_sizeval",1096,1118
3,1,32,3,2,"parse_size@1132-1134@usr.sbin/bind/lib/isccfg/namedconf.c","usr.sbin/bind/lib/isccfg/namedconf.c","parse_size",1132,1134
26,4,166,4,26,"parse_maybe_optional_keyvalue@1155-1181@usr.sbin/bind/lib/isccfg/namedconf.c","usr.sbin/bind/lib/isccfg/namedconf.c","parse_maybe_optional_keyvalue",1155,1181
14,3,93,4,13,"parse_enum_or_other@1184-1197@usr.sbin/bind/lib/isccfg/namedconf.c","usr.sbin/bind/lib/isccfg/namedconf.c","parse_enum_or_other",1184,1197
4,2,30,2,6,"doc_enum_or_other@1200-1206@usr.sbin/bind/lib/isccfg/namedconf.c","usr.sbin/bind/lib/isccfg/namedconf.c","doc_enum_or_other",1200,1206
3,1,31,3,2,"parse_keyvalue@1209-1211@usr.sbin/bind/lib/isccfg/namedconf.c","usr.sbin/bind/lib/isccfg/namedconf.c","parse_keyvalue",1209,1211
3,1,31,3,2,"parse_optional_keyvalue@1214-1216@usr.sbin/bind/lib/isccfg/namedconf.c","usr.sbin/bind/lib/isccfg/namedconf.c","parse_optional_keyvalue",1214,1216
6,1,53,2,5,"print_keyvalue@1219-1224@usr.sbin/bind/lib/isccfg/namedconf.c","usr.sbin/bind/lib/isccfg/namedconf.c","print_keyvalue",1219,1224
6,1,49,2,5,"doc_keyvalue@1227-1232@usr.sbin/bind/lib/isccfg/namedconf.c","usr.sbin/bind/lib/isccfg/namedconf.c","doc_keyvalue",1227,1232
8,1,67,2,7,"doc_optional_keyvalue@1235-1242@usr.sbin/bind/lib/isccfg/namedconf.c","usr.sbin/bind/lib/isccfg/namedconf.c","doc_optional_keyvalue",1235,1242
3,1,32,3,2,"parse_dialup_type@1247-1249@usr.sbin/bind/lib/isccfg/namedconf.c","usr.sbin/bind/lib/isccfg/namedconf.c","parse_dialup_type",1247,1249
3,1,32,3,2,"parse_notify_type@1257-1259@usr.sbin/bind/lib/isccfg/namedconf.c","usr.sbin/bind/lib/isccfg/namedconf.c","parse_notify_type",1257,1259
3,1,32,3,2,"parse_ixfrdiff_type@1267-1269@usr.sbin/bind/lib/isccfg/namedconf.c","usr.sbin/bind/lib/isccfg/namedconf.c","parse_ixfrdiff_type",1267,1269
11,2,79,3,10,"parse_optional_class@1383-1393@usr.sbin/bind/lib/isccfg/namedconf.c","usr.sbin/bind/lib/isccfg/namedconf.c","parse_optional_class",1383,1393
56,12,351,3,62,"parse_querysource@1401-1463@usr.sbin/bind/lib/isccfg/namedconf.c","usr.sbin/bind/lib/isccfg/namedconf.c","parse_querysource",1401,1463
8,1,70,2,7,"print_querysource@1466-1473@usr.sbin/bind/lib/isccfg/namedconf.c","usr.sbin/bind/lib/isccfg/namedconf.c","print_querysource",1466,1473
37,9,249,3,39,"parse_addrmatchelt@1494-1533@usr.sbin/bind/lib/isccfg/namedconf.c","usr.sbin/bind/lib/isccfg/namedconf.c","parse_addrmatchelt",1494,1533
4,1,29,2,3,"print_negated@1547-1550@usr.sbin/bind/lib/isccfg/namedconf.c","usr.sbin/bind/lib/isccfg/namedconf.c","print_negated",1547,1550
22,6,151,3,27,"parse_server_key_kludge@1588-1615@usr.sbin/bind/lib/isccfg/namedconf.c","usr.sbin/bind/lib/isccfg/namedconf.c","parse_server_key_kludge",1588,1615
14,3,91,3,14,"parse_optional_facility@1627-1641@usr.sbin/bind/lib/isccfg/namedconf.c","usr.sbin/bind/lib/isccfg/namedconf.c","parse_optional_facility",1627,1641
21,4,163,3,26,"parse_logseverity@1661-1687@usr.sbin/bind/lib/isccfg/namedconf.c","usr.sbin/bind/lib/isccfg/namedconf.c","parse_logseverity",1661,1687
3,1,32,3,2,"parse_logversions@1700-1702@usr.sbin/bind/lib/isccfg/namedconf.c","usr.sbin/bind/lib/isccfg/namedconf.c","parse_logversions",1700,1702
37,9,315,3,45,"parse_logfile@1716-1761@usr.sbin/bind/lib/isccfg/namedconf.c","usr.sbin/bind/lib/isccfg/namedconf.c","parse_logfile",1716,1761
11,3,111,2,10,"print_logfile@1764-1774@usr.sbin/bind/lib/isccfg/namedconf.c","usr.sbin/bind/lib/isccfg/namedconf.c","print_logfile",1764,1774
16,1,123,2,15,"doc_sockaddrnameport@1923-1938@usr.sbin/bind/lib/isccfg/namedconf.c","usr.sbin/bind/lib/isccfg/namedconf.c","doc_sockaddrnameport",1923,1938
32,4,199,3,32,"parse_sockaddrnameport@1941-1973@usr.sbin/bind/lib/isccfg/namedconf.c","usr.sbin/bind/lib/isccfg/namedconf.c","parse_sockaddrnameport",1941,1973
14,1,107,2,13,"doc_masterselement@2007-2020@usr.sbin/bind/lib/isccfg/namedconf.c","usr.sbin/bind/lib/isccfg/namedconf.c","doc_masterselement",2007,2020
22,4,128,3,22,"parse_masterselement@2023-2045@usr.sbin/bind/lib/isccfg/namedconf.c","usr.sbin/bind/lib/isccfg/namedconf.c","parse_masterselement",2023,2045
3,1,24,2,2,"cfg_print_obj@139-141@usr.sbin/bind/lib/isccfg/parser.c","usr.sbin/bind/lib/isccfg/parser.c","cfg_print_obj",139,141
3,1,29,3,2,"cfg_print_chars@144-146@usr.sbin/bind/lib/isccfg/parser.c","usr.sbin/bind/lib/isccfg/parser.c","cfg_print_chars",144,146
4,1,22,1,3,"print_open@149-152@usr.sbin/bind/lib/isccfg/parser.c","usr.sbin/bind/lib/isccfg/parser.c","print_open",149,152
7,2,35,1,6,"print_indent@155-161@usr.sbin/bind/lib/isccfg/parser.c","usr.sbin/bind/lib/isccfg/parser.c","print_indent",155,161
5,1,27,1,4,"print_close@164-168@usr.sbin/bind/lib/isccfg/parser.c","usr.sbin/bind/lib/isccfg/parser.c","print_close",164,168
9,3,69,3,8,"cfg_parse_obj@171-179@usr.sbin/bind/lib/isccfg/parser.c","usr.sbin/bind/lib/isccfg/parser.c","cfg_parse_obj",171,179
10,1,65,3,9,"cfg_print@182-191@usr.sbin/bind/lib/isccfg/parser.c","usr.sbin/bind/lib/isccfg/parser.c","cfg_print",182,191
25,5,191,3,27,"cfg_create_tuple@197-224@usr.sbin/bind/lib/isccfg/parser.c","usr.sbin/bind/lib/isccfg/parser.c","cfg_create_tuple",197,224
16,2,123,3,18,"cfg_parse_tuple@227-245@usr.sbin/bind/lib/isccfg/parser.c","usr.sbin/bind/lib/isccfg/parser.c","cfg_parse_tuple",227,245
13,3,109,2,13,"cfg_print_tuple@248-261@usr.sbin/bind/lib/isccfg/parser.c","usr.sbin/bind/lib/isccfg/parser.c","cfg_print_tuple",248,261
11,3,84,2,11,"cfg_doc_tuple@264-275@usr.sbin/bind/lib/isccfg/parser.c","usr.sbin/bind/lib/isccfg/parser.c","cfg_doc_tuple",264,275
14,3,110,2,15,"free_tuple@278-293@usr.sbin/bind/lib/isccfg/parser.c","usr.sbin/bind/lib/isccfg/parser.c","free_tuple",278,293
4,1,31,1,3,"cfg_obj_istuple@296-299@usr.sbin/bind/lib/isccfg/parser.c","usr.sbin/bind/lib/isccfg/parser.c","cfg_obj_istuple",296,299
13,4,111,2,14,"cfg_tuple_get@302-316@usr.sbin/bind/lib/isccfg/parser.c","usr.sbin/bind/lib/isccfg/parser.c","cfg_tuple_get",302,316
11,3,72,2,11,"cfg_parse_special@319-330@usr.sbin/bind/lib/isccfg/parser.c","usr.sbin/bind/lib/isccfg/parser.c","cfg_parse_special",319,330
11,3,67,1,11,"parse_semicolon@340-351@usr.sbin/bind/lib/isccfg/parser.c","usr.sbin/bind/lib/isccfg/parser.c","parse_semicolon",340,351
10,2,57,1,11,"parse_eof@357-368@usr.sbin/bind/lib/isccfg/parser.c","usr.sbin/bind/lib/isccfg/parser.c","parse_eof",357,368
46,4,336,3,54,"cfg_parser_create@378-432@usr.sbin/bind/lib/isccfg/parser.c","usr.sbin/bind/lib/isccfg/parser.c","cfg_parser_create",378,432
19,2,131,2,21,"parser_openfile@435-456@usr.sbin/bind/lib/isccfg/parser.c","usr.sbin/bind/lib/isccfg/parser.c","parser_openfile",435,456
7,1,27,3,6,"cfg_parser_setcallback@459-465@usr.sbin/bind/lib/isccfg/parser.c","usr.sbin/bind/lib/isccfg/parser.c","cfg_parser_setcallback",459,465
20,4,111,3,27,"parse2@472-499@usr.sbin/bind/lib/isccfg/parser.c","usr.sbin/bind/lib/isccfg/parser.c","parse2",472,499
10,1,61,4,11,"cfg_parse_file@502-513@usr.sbin/bind/lib/isccfg/parser.c","usr.sbin/bind/lib/isccfg/parser.c","cfg_parse_file",502,513
10,1,62,4,9,"cfg_parse_buffer@517-526@usr.sbin/bind/lib/isccfg/parser.c","usr.sbin/bind/lib/isccfg/parser.c","cfg_parse_buffer",517,526
8,1,57,1,12,"cfg_parser_destroy@529-541@usr.sbin/bind/lib/isccfg/parser.c","usr.sbin/bind/lib/isccfg/parser.c","cfg_parser_destroy",529,541
4,1,35,3,3,"cfg_parse_void@547-550@usr.sbin/bind/lib/isccfg/parser.c","usr.sbin/bind/lib/isccfg/parser.c","cfg_parse_void",547,550
4,1,23,2,3,"cfg_print_void@553-556@usr.sbin/bind/lib/isccfg/parser.c","usr.sbin/bind/lib/isccfg/parser.c","cfg_print_void",553,556
4,1,23,2,3,"cfg_doc_void@559-562@usr.sbin/bind/lib/isccfg/parser.c","usr.sbin/bind/lib/isccfg/parser.c","cfg_doc_void",559,562
4,1,31,1,3,"cfg_obj_isvoid@565-568@usr.sbin/bind/lib/isccfg/parser.c","usr.sbin/bind/lib/isccfg/parser.c","cfg_obj_isvoid",565,568
15,2,109,3,17,"cfg_parse_uint32@579-596@usr.sbin/bind/lib/isccfg/parser.c","usr.sbin/bind/lib/isccfg/parser.c","cfg_parse_uint32",579,596
3,1,25,2,2,"cfg_print_cstr@599-601@usr.sbin/bind/lib/isccfg/parser.c","usr.sbin/bind/lib/isccfg/parser.c","cfg_print_cstr",599,601
5,1,39,2,4,"cfg_print_rawuint@604-608@usr.sbin/bind/lib/isccfg/parser.c","usr.sbin/bind/lib/isccfg/parser.c","cfg_print_rawuint",604,608
3,1,24,2,2,"cfg_print_uint32@611-613@usr.sbin/bind/lib/isccfg/parser.c","usr.sbin/bind/lib/isccfg/parser.c","cfg_print_uint32",611,613
4,1,31,1,3,"cfg_obj_isuint32@616-619@usr.sbin/bind/lib/isccfg/parser.c","usr.sbin/bind/lib/isccfg/parser.c","cfg_obj_isuint32",616,619
4,2,34,1,3,"cfg_obj_asuint32@622-625@usr.sbin/bind/lib/isccfg/parser.c","usr.sbin/bind/lib/isccfg/parser.c","cfg_obj_asuint32",622,625
4,1,31,1,3,"cfg_obj_isuint64@637-640@usr.sbin/bind/lib/isccfg/parser.c","usr.sbin/bind/lib/isccfg/parser.c","cfg_obj_isuint64",637,640
4,2,34,1,3,"cfg_obj_asuint64@643-646@usr.sbin/bind/lib/isccfg/parser.c","usr.sbin/bind/lib/isccfg/parser.c","cfg_obj_asuint64",643,646
6,1,46,2,5,"cfg_print_uint64@649-654@usr.sbin/bind/lib/isccfg/parser.c","usr.sbin/bind/lib/isccfg/parser.c","cfg_print_uint64",649,654
20,2,157,4,21,"create_string@668-689@usr.sbin/bind/lib/isccfg/parser.c","usr.sbin/bind/lib/isccfg/parser.c","create_string",668,689
15,2,86,3,15,"cfg_parse_qstring@692-707@usr.sbin/bind/lib/isccfg/parser.c","usr.sbin/bind/lib/isccfg/parser.c","cfg_parse_qstring",692,707
15,2,86,3,15,"parse_ustring@710-725@usr.sbin/bind/lib/isccfg/parser.c","usr.sbin/bind/lib/isccfg/parser.c","parse_ustring",710,725
13,1,58,3,13,"cfg_parse_astring@728-741@usr.sbin/bind/lib/isccfg/parser.c","usr.sbin/bind/lib/isccfg/parser.c","cfg_parse_astring",728,741
8,3,61,2,7,"cfg_is_enum@744-751@usr.sbin/bind/lib/isccfg/parser.c","usr.sbin/bind/lib/isccfg/parser.c","cfg_is_enum",744,751
7,2,62,3,6,"check_enum@754-760@usr.sbin/bind/lib/isccfg/parser.c","usr.sbin/bind/lib/isccfg/parser.c","check_enum",754,760
11,1,75,3,10,"cfg_parse_enum@763-773@usr.sbin/bind/lib/isccfg/parser.c","usr.sbin/bind/lib/isccfg/parser.c","cfg_parse_enum",763,773
10,3,82,2,9,"cfg_doc_enum@776-785@usr.sbin/bind/lib/isccfg/parser.c","usr.sbin/bind/lib/isccfg/parser.c","cfg_doc_enum",776,785
3,1,34,2,2,"cfg_print_ustring@788-790@usr.sbin/bind/lib/isccfg/parser.c","usr.sbin/bind/lib/isccfg/parser.c","cfg_print_ustring",788,790
5,1,38,2,4,"print_qstring@793-797@usr.sbin/bind/lib/isccfg/parser.c","usr.sbin/bind/lib/isccfg/parser.c","print_qstring",793,797
4,1,37,2,3,"free_string@800-803@usr.sbin/bind/lib/isccfg/parser.c","usr.sbin/bind/lib/isccfg/parser.c","free_string",800,803
4,1,31,1,3,"cfg_obj_isstring@806-809@usr.sbin/bind/lib/isccfg/parser.c","usr.sbin/bind/lib/isccfg/parser.c","cfg_obj_isstring",806,809
4,2,36,1,3,"cfg_obj_asstring@812-815@usr.sbin/bind/lib/isccfg/parser.c","usr.sbin/bind/lib/isccfg/parser.c","cfg_obj_asstring",812,815
4,1,31,1,3,"cfg_obj_isboolean@840-843@usr.sbin/bind/lib/isccfg/parser.c","usr.sbin/bind/lib/isccfg/parser.c","cfg_obj_isboolean",840,843
4,2,34,1,3,"cfg_obj_asboolean@846-849@usr.sbin/bind/lib/isccfg/parser.c","usr.sbin/bind/lib/isccfg/parser.c","cfg_obj_asboolean",846,849
32,9,229,3,37,"parse_boolean@852-889@usr.sbin/bind/lib/isccfg/parser.c","usr.sbin/bind/lib/isccfg/parser.c","parse_boolean",852,889
6,2,40,2,5,"print_boolean@892-897@usr.sbin/bind/lib/isccfg/parser.c","usr.sbin/bind/lib/isccfg/parser.c","print_boolean",892,897
7,1,51,3,6,"cfg_create_list@909-915@usr.sbin/bind/lib/isccfg/parser.c","usr.sbin/bind/lib/isccfg/parser.c","cfg_create_list",909,915
10,2,65,2,9,"create_listelt@918-927@usr.sbin/bind/lib/isccfg/parser.c","usr.sbin/bind/lib/isccfg/parser.c","create_listelt",918,927
4,1,37,2,3,"free_list_elt@930-933@usr.sbin/bind/lib/isccfg/parser.c","usr.sbin/bind/lib/isccfg/parser.c","free_list_elt",930,933
10,2,58,2,9,"free_list@936-945@usr.sbin/bind/lib/isccfg/parser.c","usr.sbin/bind/lib/isccfg/parser.c","free_list",936,945
17,2,102,3,21,"cfg_parse_listelt@948-969@usr.sbin/bind/lib/isccfg/parser.c","usr.sbin/bind/lib/isccfg/parser.c","cfg_parse_listelt",948,969
25,5,166,3,27,"parse_list@976-1003@usr.sbin/bind/lib/isccfg/parser.c","usr.sbin/bind/lib/isccfg/parser.c","parse_list",976,1003
11,2,78,2,11,"print_list@1006-1017@usr.sbin/bind/lib/isccfg/parser.c","usr.sbin/bind/lib/isccfg/parser.c","print_list",1006,1017
10,1,59,3,9,"cfg_parse_bracketed_list@1020-1029@usr.sbin/bind/lib/isccfg/parser.c","usr.sbin/bind/lib/isccfg/parser.c","cfg_parse_bracketed_list",1020,1029
5,1,30,2,4,"cfg_print_bracketed_list@1032-1036@usr.sbin/bind/lib/isccfg/parser.c","usr.sbin/bind/lib/isccfg/parser.c","cfg_print_bracketed_list",1032,1036
5,1,40,2,4,"cfg_doc_bracketed_list@1039-1043@usr.sbin/bind/lib/isccfg/parser.c","usr.sbin/bind/lib/isccfg/parser.c","cfg_doc_bracketed_list",1039,1043
22,4,141,3,25,"cfg_parse_spacelist@1051-1076@usr.sbin/bind/lib/isccfg/parser.c","usr.sbin/bind/lib/isccfg/parser.c","cfg_parse_spacelist",1051,1076
11,3,84,2,11,"cfg_print_spacelist@1079-1090@usr.sbin/bind/lib/isccfg/parser.c","usr.sbin/bind/lib/isccfg/parser.c","cfg_print_spacelist",1079,1090
4,1,31,1,3,"cfg_obj_islist@1093-1096@usr.sbin/bind/lib/isccfg/parser.c","usr.sbin/bind/lib/isccfg/parser.c","cfg_obj_islist",1093,1096
6,3,48,1,5,"cfg_list_first@1099-1104@usr.sbin/bind/lib/isccfg/parser.c","usr.sbin/bind/lib/isccfg/parser.c","cfg_list_first",1099,1104
4,1,26,1,3,"cfg_list_next@1107-1110@usr.sbin/bind/lib/isccfg/parser.c","usr.sbin/bind/lib/isccfg/parser.c","cfg_list_next",1107,1110
4,1,23,1,3,"cfg_listelt_value@1113-1116@usr.sbin/bind/lib/isccfg/parser.c","usr.sbin/bind/lib/isccfg/parser.c","cfg_listelt_value",1113,1116
118,17,727,3,159,"cfg_parse_mapbody@1133-1292@usr.sbin/bind/lib/isccfg/parser.c","usr.sbin/bind/lib/isccfg/parser.c","cfg_parse_mapbody",1133,1292
19,3,114,5,22,"parse_symtab_elt@1295-1317@usr.sbin/bind/lib/isccfg/parser.c","usr.sbin/bind/lib/isccfg/parser.c","parse_symtab_elt",1295,1317
8,1,59,3,7,"cfg_parse_map@1323-1330@usr.sbin/bind/lib/isccfg/parser.c","usr.sbin/bind/lib/isccfg/parser.c","cfg_parse_map",1323,1330
15,1,93,4,15,"parse_any_named_map@1336-1351@usr.sbin/bind/lib/isccfg/parser.c","usr.sbin/bind/lib/isccfg/parser.c","parse_any_named_map",1336,1351
3,1,32,3,2,"cfg_parse_named_map@1358-1360@usr.sbin/bind/lib/isccfg/parser.c","usr.sbin/bind/lib/isccfg/parser.c","cfg_parse_named_map",1358,1360
3,1,32,3,2,"cfg_parse_addressed_map@1367-1369@usr.sbin/bind/lib/isccfg/parser.c","usr.sbin/bind/lib/isccfg/parser.c","cfg_parse_addressed_map",1367,1369
3,1,32,3,2,"cfg_parse_netprefix_map@1376-1378@usr.sbin/bind/lib/isccfg/parser.c","usr.sbin/bind/lib/isccfg/parser.c","cfg_parse_netprefix_map",1376,1378
43,7,263,2,47,"cfg_print_mapbody@1381-1428@usr.sbin/bind/lib/isccfg/parser.c","usr.sbin/bind/lib/isccfg/parser.c","cfg_print_mapbody",1381,1428
15,3,106,2,16,"cfg_doc_mapbody@1431-1447@usr.sbin/bind/lib/isccfg/parser.c","usr.sbin/bind/lib/isccfg/parser.c","cfg_doc_mapbody",1431,1447
9,2,66,2,8,"cfg_print_map@1461-1469@usr.sbin/bind/lib/isccfg/parser.c","usr.sbin/bind/lib/isccfg/parser.c","cfg_print_map",1461,1469
14,4,89,2,13,"print_clause_flags@1472-1485@usr.sbin/bind/lib/isccfg/parser.c","usr.sbin/bind/lib/isccfg/parser.c","print_clause_flags",1472,1485
30,7,223,2,32,"cfg_doc_map@1488-1520@usr.sbin/bind/lib/isccfg/parser.c","usr.sbin/bind/lib/isccfg/parser.c","cfg_doc_map",1488,1520
4,1,31,1,3,"cfg_obj_ismap@1523-1526@usr.sbin/bind/lib/isccfg/parser.c","usr.sbin/bind/lib/isccfg/parser.c","cfg_obj_ismap",1523,1526
14,4,113,3,16,"cfg_map_get@1529-1545@usr.sbin/bind/lib/isccfg/parser.c","usr.sbin/bind/lib/isccfg/parser.c","cfg_map_get",1529,1545
4,2,36,1,3,"cfg_map_getname@1548-1551@usr.sbin/bind/lib/isccfg/parser.c","usr.sbin/bind/lib/isccfg/parser.c","cfg_map_getname",1548,1551
28,4,223,3,32,"parse_token@1556-1588@usr.sbin/bind/lib/isccfg/parser.c","usr.sbin/bind/lib/isccfg/parser.c","parse_token",1556,1588
32,9,219,3,36,"parse_unsupported@1601-1637@usr.sbin/bind/lib/isccfg/parser.c","usr.sbin/bind/lib/isccfg/parser.c","parse_unsupported",1601,1637
65,19,419,3,74,"token_addr@1654-1728@usr.sbin/bind/lib/isccfg/parser.c","usr.sbin/bind/lib/isccfg/parser.c","token_addr",1654,1728
27,6,158,3,27,"cfg_parse_rawaddr@1731-1758@usr.sbin/bind/lib/isccfg/parser.c","usr.sbin/bind/lib/isccfg/parser.c","cfg_parse_rawaddr",1731,1758
6,1,40,2,5,"cfg_lookingat_netaddr@1761-1766@usr.sbin/bind/lib/isccfg/parser.c","usr.sbin/bind/lib/isccfg/parser.c","cfg_lookingat_netaddr",1761,1766
24,6,153,3,25,"cfg_parse_rawport@1769-1794@usr.sbin/bind/lib/isccfg/parser.c","usr.sbin/bind/lib/isccfg/parser.c","cfg_parse_rawport",1769,1794
9,1,72,2,9,"cfg_print_rawaddr@1797-1806@usr.sbin/bind/lib/isccfg/parser.c","usr.sbin/bind/lib/isccfg/parser.c","cfg_print_rawaddr",1797,1806
14,1,107,3,14,"parse_netaddr@1817-1831@usr.sbin/bind/lib/isccfg/parser.c","usr.sbin/bind/lib/isccfg/parser.c","parse_netaddr",1817,1831
24,10,159,2,23,"cfg_doc_netaddr@1834-1857@usr.sbin/bind/lib/isccfg/parser.c","usr.sbin/bind/lib/isccfg/parser.c","cfg_doc_netaddr",1834,1857
50,7,273,3,50,"cfg_parse_netprefix@1887-1937@usr.sbin/bind/lib/isccfg/parser.c","usr.sbin/bind/lib/isccfg/parser.c","cfg_parse_netprefix",1887,1937
6,1,53,2,6,"print_netprefix@1940-1946@usr.sbin/bind/lib/isccfg/parser.c","usr.sbin/bind/lib/isccfg/parser.c","print_netprefix",1940,1946
4,1,31,1,3,"cfg_obj_isnetprefix@1949-1952@usr.sbin/bind/lib/isccfg/parser.c","usr.sbin/bind/lib/isccfg/parser.c","cfg_obj_isnetprefix",1949,1952
6,2,56,3,5,"cfg_obj_asnetprefix@1955-1960@usr.sbin/bind/lib/isccfg/parser.c","usr.sbin/bind/lib/isccfg/parser.c","cfg_obj_asnetprefix",1955,1960
22,3,157,4,23,"parse_sockaddrsub@1968-1991@usr.sbin/bind/lib/isccfg/parser.c","usr.sbin/bind/lib/isccfg/parser.c","parse_sockaddrsub",1968,1991
4,1,43,3,3,"cfg_parse_sockaddr@2000-2003@usr.sbin/bind/lib/isccfg/parser.c","usr.sbin/bind/lib/isccfg/parser.c","cfg_parse_sockaddr",2000,2003
13,2,94,2,13,"cfg_print_sockaddr@2006-2019@usr.sbin/bind/lib/isccfg/parser.c","usr.sbin/bind/lib/isccfg/parser.c","cfg_print_sockaddr",2006,2019
27,7,161,2,26,"cfg_doc_sockaddr@2022-2048@usr.sbin/bind/lib/isccfg/parser.c","usr.sbin/bind/lib/isccfg/parser.c","cfg_doc_sockaddr",2022,2048
4,1,31,1,3,"cfg_obj_issockaddr@2051-2054@usr.sbin/bind/lib/isccfg/parser.c","usr.sbin/bind/lib/isccfg/parser.c","cfg_obj_issockaddr",2051,2054
4,2,35,1,3,"cfg_obj_assockaddr@2057-2060@usr.sbin/bind/lib/isccfg/parser.c","usr.sbin/bind/lib/isccfg/parser.c","cfg_obj_assockaddr",2057,2060
44,8,251,2,55,"cfg_gettoken@2063-2118@usr.sbin/bind/lib/isccfg/parser.c","usr.sbin/bind/lib/isccfg/parser.c","cfg_gettoken",2063,2118
6,2,34,1,5,"cfg_ungettoken@2121-2126@usr.sbin/bind/lib/isccfg/parser.c","usr.sbin/bind/lib/isccfg/parser.c","cfg_ungettoken",2121,2126
7,1,36,2,6,"cfg_peektoken@2129-2135@usr.sbin/bind/lib/isccfg/parser.c","usr.sbin/bind/lib/isccfg/parser.c","cfg_peektoken",2129,2135
12,4,70,1,13,"cfg_getstringtoken@2142-2155@usr.sbin/bind/lib/isccfg/parser.c","usr.sbin/bind/lib/isccfg/parser.c","cfg_getstringtoken",2142,2155
7,1,52,4,6,"cfg_parser_error@2158-2164@usr.sbin/bind/lib/isccfg/parser.c","usr.sbin/bind/lib/isccfg/parser.c","cfg_parser_error",2158,2164
7,1,52,4,6,"cfg_parser_warning@2167-2173@usr.sbin/bind/lib/isccfg/parser.c","usr.sbin/bind/lib/isccfg/parser.c","cfg_parser_warning",2167,2173
13,3,88,1,14,"current_file@2178-2192@usr.sbin/bind/lib/isccfg/parser.c","usr.sbin/bind/lib/isccfg/parser.c","current_file",2178,2192
49,11,342,5,56,"parser_complain@2195-2251@usr.sbin/bind/lib/isccfg/parser.c","usr.sbin/bind/lib/isccfg/parser.c","parser_complain",2195,2251
14,3,101,5,16,"cfg_obj_log@2254-2270@usr.sbin/bind/lib/isccfg/parser.c","usr.sbin/bind/lib/isccfg/parser.c","cfg_obj_log",2254,2270
3,1,16,1,2,"cfg_obj_file@2273-2275@usr.sbin/bind/lib/isccfg/parser.c","usr.sbin/bind/lib/isccfg/parser.c","cfg_obj_file",2273,2275
3,1,16,1,2,"cfg_obj_line@2278-2280@usr.sbin/bind/lib/isccfg/parser.c","usr.sbin/bind/lib/isccfg/parser.c","cfg_obj_line",2278,2280
11,2,79,3,11,"cfg_create_obj@2283-2294@usr.sbin/bind/lib/isccfg/parser.c","usr.sbin/bind/lib/isccfg/parser.c","cfg_create_obj",2283,2294
9,1,55,4,10,"map_symtabitem_destroy@2297-2307@usr.sbin/bind/lib/isccfg/parser.c","usr.sbin/bind/lib/isccfg/parser.c","map_symtabitem_destroy",2297,2307
17,2,124,3,19,"create_map@2311-2330@usr.sbin/bind/lib/isccfg/parser.c","usr.sbin/bind/lib/isccfg/parser.c","create_map",2311,2330
4,1,35,2,3,"free_map@2333-2336@usr.sbin/bind/lib/isccfg/parser.c","usr.sbin/bind/lib/isccfg/parser.c","free_map",2333,2336
3,1,26,2,2,"cfg_obj_istype@2339-2341@usr.sbin/bind/lib/isccfg/parser.c","usr.sbin/bind/lib/isccfg/parser.c","cfg_obj_istype",2339,2341
6,1,51,2,5,"cfg_obj_destroy@2347-2352@usr.sbin/bind/lib/isccfg/parser.c","usr.sbin/bind/lib/isccfg/parser.c","cfg_obj_destroy",2347,2352
4,1,22,2,3,"free_noop@2355-2358@usr.sbin/bind/lib/isccfg/parser.c","usr.sbin/bind/lib/isccfg/parser.c","free_noop",2355,2358
3,1,22,2,2,"cfg_doc_obj@2361-2363@usr.sbin/bind/lib/isccfg/parser.c","usr.sbin/bind/lib/isccfg/parser.c","cfg_doc_obj",2361,2363
5,1,40,2,4,"cfg_doc_terminal@2366-2370@usr.sbin/bind/lib/isccfg/parser.c","usr.sbin/bind/lib/isccfg/parser.c","cfg_doc_terminal",2366,2370
10,1,61,3,9,"cfg_print_grammar@2373-2382@usr.sbin/bind/lib/isccfg/parser.c","usr.sbin/bind/lib/isccfg/parser.c","cfg_print_grammar",2373,2382
27,5,155,5,43,"lwres_context_create@151-194@usr.sbin/bind/lib/lwres/context.c","usr.sbin/bind/lib/lwres/context.c","lwres_context_create",151,194
12,4,76,1,17,"lwres_context_destroy@203-220@usr.sbin/bind/lib/lwres/context.c","usr.sbin/bind/lib/lwres/context.c","lwres_context_destroy",203,220
4,1,23,1,4,"lwres_context_nextserial@223-227@usr.sbin/bind/lib/lwres/context.c","usr.sbin/bind/lib/lwres/context.c","lwres_context_nextserial",223,227
4,1,24,2,4,"lwres_context_initserial@231-235@usr.sbin/bind/lib/lwres/context.c","usr.sbin/bind/lib/lwres/context.c","lwres_context_initserial",231,235
5,1,36,3,5,"lwres_context_freemem@239-244@usr.sbin/bind/lib/lwres/context.c","usr.sbin/bind/lib/lwres/context.c","lwres_context_freemem",239,244
4,1,26,2,4,"lwres_context_allocmem@248-252@usr.sbin/bind/lib/lwres/context.c","usr.sbin/bind/lib/lwres/context.c","lwres_context_allocmem",248,252
9,2,52,2,12,"lwres_malloc@255-267@usr.sbin/bind/lib/lwres/context.c","usr.sbin/bind/lib/lwres/context.c","lwres_malloc",255,267
5,1,34,3,5,"lwres_free@270-275@usr.sbin/bind/lib/lwres/context.c","usr.sbin/bind/lib/lwres/context.c","lwres_free",270,275
60,11,414,1,75,"context_connect@278-353@usr.sbin/bind/lib/lwres/context.c","usr.sbin/bind/lib/lwres/context.c","context_connect",278,353
3,1,15,1,2,"lwres_context_getsocket@356-358@usr.sbin/bind/lib/lwres/context.c","usr.sbin/bind/lib/lwres/context.c","lwres_context_getsocket",356,358
16,5,96,3,18,"lwres_context_send@361-379@usr.sbin/bind/lib/lwres/context.c","usr.sbin/bind/lib/lwres/context.c","lwres_context_send",361,379
38,12,256,4,55,"lwres_context_recv@382-437@usr.sbin/bind/lib/lwres/context.c","usr.sbin/bind/lib/lwres/context.c","lwres_context_recv",382,437
30,6,178,6,41,"lwres_context_sendrecv@441-482@usr.sbin/bind/lib/lwres/context.c","usr.sbin/bind/lib/lwres/context.c","lwres_context_sendrecv",441,482
12,3,72,1,12,"lwres_gai_strerror@71-83@usr.sbin/bind/lib/lwres/gai_strerror.c","usr.sbin/bind/lib/lwres/gai_strerror.c","lwres_gai_strerror",71,83
230,80,1435,4,300,"lwres_getaddrinfo@174-474@usr.sbin/bind/lib/lwres/getaddrinfo.c","usr.sbin/bind/lib/lwres/getaddrinfo.c","lwres_getaddrinfo",174,474
19,5,118,2,20,"lwres_strsep@477-497@usr.sbin/bind/lib/lwres/getaddrinfo.c","usr.sbin/bind/lib/lwres/getaddrinfo.c","lwres_strsep",477,497
38,12,219,2,45,"set_order@500-545@usr.sbin/bind/lib/lwres/getaddrinfo.c","usr.sbin/bind/lib/lwres/getaddrinfo.c","set_order",500,545
61,13,381,5,62,"add_ipv4@559-621@usr.sbin/bind/lib/lwres/getaddrinfo.c","usr.sbin/bind/lib/lwres/getaddrinfo.c","add_ipv4",559,621
61,13,381,5,63,"add_ipv6@626-689@usr.sbin/bind/lib/lwres/getaddrinfo.c","usr.sbin/bind/lib/lwres/getaddrinfo.c","add_ipv6",626,689
12,4,65,1,12,"lwres_freeaddrinfo@693-705@usr.sbin/bind/lib/lwres/getaddrinfo.c","usr.sbin/bind/lib/lwres/getaddrinfo.c","lwres_freeaddrinfo",693,705
14,3,103,3,22,"get_local@709-731@usr.sbin/bind/lib/lwres/getaddrinfo.c","usr.sbin/bind/lib/lwres/getaddrinfo.c","get_local",709,731
16,4,111,2,19,"ai_alloc@745-764@usr.sbin/bind/lib/lwres/getaddrinfo.c","usr.sbin/bind/lib/lwres/getaddrinfo.c","ai_alloc",745,764
17,4,114,2,19,"ai_clone@767-786@usr.sbin/bind/lib/lwres/getaddrinfo.c","usr.sbin/bind/lib/lwres/getaddrinfo.c","ai_clone",767,786
11,2,54,1,18,"ai_reverse@789-807@usr.sbin/bind/lib/lwres/getaddrinfo.c","usr.sbin/bind/lib/lwres/getaddrinfo.c","ai_reverse",789,807
6,2,39,1,7,"lwres_gethostbyname@171-178@usr.sbin/bind/lib/lwres/gethost.c","usr.sbin/bind/lib/lwres/gethost.c","lwres_gethostbyname",171,178
6,2,42,2,6,"lwres_gethostbyname2@182-188@usr.sbin/bind/lib/lwres/gethost.c","usr.sbin/bind/lib/lwres/gethost.c","lwres_gethostbyname2",182,188
6,2,45,3,7,"lwres_gethostbyaddr@192-199@usr.sbin/bind/lib/lwres/gethost.c","usr.sbin/bind/lib/lwres/gethost.c","lwres_gethostbyaddr",192,199
5,2,22,1,5,"lwres_gethostent@203-208@usr.sbin/bind/lib/lwres/gethost.c","usr.sbin/bind/lib/lwres/gethost.c","lwres_gethostent",203,208
3,1,12,1,5,"lwres_sethostent@212-217@usr.sbin/bind/lib/lwres/gethost.c","usr.sbin/bind/lib/lwres/gethost.c","lwres_sethostent",212,217
2,1,6,1,4,"lwres_endhostent@221-225@usr.sbin/bind/lib/lwres/gethost.c","usr.sbin/bind/lib/lwres/gethost.c","lwres_endhostent",221,225
16,3,97,5,16,"lwres_gethostbyname_r@229-245@usr.sbin/bind/lib/lwres/gethost.c","usr.sbin/bind/lib/lwres/gethost.c","lwres_gethostbyname_r",229,245
17,3,103,7,17,"lwres_gethostbyaddr_r@249-266@usr.sbin/bind/lib/lwres/gethost.c","usr.sbin/bind/lib/lwres/gethost.c","lwres_gethostbyaddr_r",249,266
7,1,45,4,6,"lwres_gethostent_r@270-276@usr.sbin/bind/lib/lwres/gethost.c","usr.sbin/bind/lib/lwres/gethost.c","lwres_gethostent_r",270,276
3,1,12,1,5,"lwres_sethostent_r@280-285@usr.sbin/bind/lib/lwres/gethost.c","usr.sbin/bind/lib/lwres/gethost.c","lwres_sethostent_r",280,285
2,1,6,1,4,"lwres_endhostent_r@289-293@usr.sbin/bind/lib/lwres/gethost.c","usr.sbin/bind/lib/lwres/gethost.c","lwres_endhostent_r",289,293
54,8,407,4,77,"copytobuf@296-373@usr.sbin/bind/lib/lwres/gethost.c","usr.sbin/bind/lib/lwres/gethost.c","copytobuf",296,373
108,45,790,4,127,"lwres_getipnodebyname@199-326@usr.sbin/bind/lib/lwres/getipnode.c","usr.sbin/bind/lib/lwres/getipnode.c","lwres_getipnodebyname",199,326
89,23,543,4,120,"lwres_getipnodebyaddr@330-450@usr.sbin/bind/lib/lwres/getipnode.c","usr.sbin/bind/lib/lwres/getipnode.c","lwres_getipnodebyaddr",330,450
22,3,108,1,25,"lwres_freehostent@454-479@usr.sbin/bind/lib/lwres/getipnode.c","usr.sbin/bind/lib/lwres/getipnode.c","lwres_freehostent",454,479
93,34,625,2,133,"scan_interfaces6@520-653@usr.sbin/bind/lib/lwres/getipnode.c","usr.sbin/bind/lib/lwres/getipnode.c","scan_interfaces6",520,653
108,43,753,2,171,"scan_interfaces@657-828@usr.sbin/bind/lib/lwres/getipnode.c","usr.sbin/bind/lib/lwres/getipnode.c","scan_interfaces",657,828
121,34,713,4,156,"copyandmerge@831-987@usr.sbin/bind/lib/lwres/getipnode.c","usr.sbin/bind/lib/lwres/getipnode.c","copyandmerge",831,987
56,19,428,3,73,"hostfromaddr@990-1063@usr.sbin/bind/lib/lwres/getipnode.c","usr.sbin/bind/lib/lwres/getipnode.c","hostfromaddr",990,1063
59,18,446,2,76,"hostfromname@1066-1142@usr.sbin/bind/lib/lwres/getipnode.c","usr.sbin/bind/lib/lwres/getipnode.c","hostfromname",1066,1142
151,52,1000,7,185,"lwres_getnameinfo@161-346@usr.sbin/bind/lib/lwres/getnameinfo.c","usr.sbin/bind/lib/lwres/getnameinfo.c","lwres_getnameinfo",161,346
9,5,52,1,8,"lwresult_to_result@106-114@usr.sbin/bind/lib/lwres/getrrset.c","usr.sbin/bind/lib/lwres/getrrset.c","lwresult_to_result",106,114
5,2,25,1,4,"sane_malloc@124-128@usr.sbin/bind/lib/lwres/getrrset.c","usr.sbin/bind/lib/lwres/getrrset.c","sane_malloc",124,128
7,2,46,2,6,"sane_calloc@131-137@usr.sbin/bind/lib/lwres/getrrset.c","usr.sbin/bind/lib/lwres/getrrset.c","sane_calloc",131,137
109,19,716,5,125,"lwres_getrrsetbyname@142-267@usr.sbin/bind/lib/lwres/getrrset.c","usr.sbin/bind/lib/lwres/getrrset.c","lwres_getrrsetbyname",142,267
17,5,127,1,16,"lwres_freerrset@271-287@usr.sbin/bind/lib/lwres/getrrset.c","usr.sbin/bind/lib/lwres/getrrset.c","lwres_freerrset",271,287
3,1,23,1,2,"lwres_herror@107-109@usr.sbin/bind/lib/lwres/herror.c","usr.sbin/bind/lib/lwres/herror.c","lwres_herror",107,109
7,3,38,1,6,"lwres_hstrerror@116-122@usr.sbin/bind/lib/lwres/herror.c","usr.sbin/bind/lib/lwres/herror.c","lwres_hstrerror",116,122
10,1,59,3,14,"lwres_buffer_init@121-135@usr.sbin/bind/lib/lwres/lwbuffer.c","usr.sbin/bind/lib/lwres/lwbuffer.c","lwres_buffer_init",121,135
10,1,52,1,11,"lwres_buffer_invalidate@139-150@usr.sbin/bind/lib/lwres/lwbuffer.c","usr.sbin/bind/lib/lwres/lwbuffer.c","lwres_buffer_invalidate",139,150
6,1,39,2,7,"lwres_buffer_add@154-161@usr.sbin/bind/lib/lwres/lwbuffer.c","usr.sbin/bind/lib/lwres/lwbuffer.c","lwres_buffer_add",154,161
10,3,71,2,11,"lwres_buffer_subtract@165-176@usr.sbin/bind/lib/lwres/lwbuffer.c","usr.sbin/bind/lib/lwres/lwbuffer.c","lwres_buffer_subtract",165,176
7,1,34,1,8,"lwres_buffer_clear@180-188@usr.sbin/bind/lib/lwres/lwbuffer.c","usr.sbin/bind/lib/lwres/lwbuffer.c","lwres_buffer_clear",180,188
5,1,22,1,6,"lwres_buffer_first@192-198@usr.sbin/bind/lib/lwres/lwbuffer.c","usr.sbin/bind/lib/lwres/lwbuffer.c","lwres_buffer_first",192,198
6,1,39,2,7,"lwres_buffer_forward@202-209@usr.sbin/bind/lib/lwres/lwbuffer.c","usr.sbin/bind/lib/lwres/lwbuffer.c","lwres_buffer_forward",202,209
6,1,35,2,7,"lwres_buffer_back@213-220@usr.sbin/bind/lib/lwres/lwbuffer.c","usr.sbin/bind/lib/lwres/lwbuffer.c","lwres_buffer_back",213,220
12,1,75,1,15,"lwres_buffer_getuint8@224-239@usr.sbin/bind/lib/lwres/lwbuffer.c","usr.sbin/bind/lib/lwres/lwbuffer.c","lwres_buffer_getuint8",224,239
10,1,66,2,11,"lwres_buffer_putuint8@243-254@usr.sbin/bind/lib/lwres/lwbuffer.c","usr.sbin/bind/lib/lwres/lwbuffer.c","lwres_buffer_putuint8",243,254
13,1,93,1,16,"lwres_buffer_getuint16@258-274@usr.sbin/bind/lib/lwres/lwbuffer.c","usr.sbin/bind/lib/lwres/lwbuffer.c","lwres_buffer_getuint16",258,274
11,1,80,2,12,"lwres_buffer_putuint16@278-290@usr.sbin/bind/lib/lwres/lwbuffer.c","usr.sbin/bind/lib/lwres/lwbuffer.c","lwres_buffer_putuint16",278,290
15,1,129,1,17,"lwres_buffer_getuint32@294-311@usr.sbin/bind/lib/lwres/lwbuffer.c","usr.sbin/bind/lib/lwres/lwbuffer.c","lwres_buffer_getuint32",294,311
13,1,130,2,14,"lwres_buffer_putuint32@315-329@usr.sbin/bind/lib/lwres/lwbuffer.c","usr.sbin/bind/lib/lwres/lwbuffer.c","lwres_buffer_putuint32",315,329
10,1,74,3,11,"lwres_buffer_putmem@333-344@usr.sbin/bind/lib/lwres/lwbuffer.c","usr.sbin/bind/lib/lwres/lwbuffer.c","lwres_buffer_putmem",333,344
11,1,70,3,13,"lwres_buffer_getmem@348-361@usr.sbin/bind/lib/lwres/lwbuffer.c","usr.sbin/bind/lib/lwres/lwbuffer.c","lwres_buffer_getmem",348,361
13,3,41,1,15,"lwresaddr2af@113-128@usr.sbin/bind/lib/lwres/lwconfig.c","usr.sbin/bind/lib/lwres/lwconfig.c","lwresaddr2af",113,128
7,3,40,1,8,"eatline@135-143@usr.sbin/bind/lib/lwres/lwconfig.c","usr.sbin/bind/lib/lwres/lwconfig.c","eatline",135,143
9,6,66,1,11,"eatwhite@152-163@usr.sbin/bind/lib/lwres/lwconfig.c","usr.sbin/bind/lib/lwres/lwconfig.c","eatwhite",152,163
20,6,133,3,27,"getword@173-200@usr.sbin/bind/lib/lwres/lwconfig.c","usr.sbin/bind/lib/lwres/lwconfig.c","getword",173,200
6,1,38,1,6,"lwres_resetaddr@203-209@usr.sbin/bind/lib/lwres/lwconfig.c","usr.sbin/bind/lib/lwres/lwconfig.c","lwres_resetaddr",203,209
11,2,75,2,13,"lwres_strdup@212-225@usr.sbin/bind/lib/lwres/lwconfig.c","usr.sbin/bind/lib/lwres/lwconfig.c","lwres_strdup",212,225
24,4,175,1,28,"lwres_conf_init@229-257@usr.sbin/bind/lib/lwres/lwconfig.c","usr.sbin/bind/lib/lwres/lwconfig.c","lwres_conf_init",229,257
34,6,248,1,39,"lwres_conf_clear@261-300@usr.sbin/bind/lib/lwres/lwconfig.c","usr.sbin/bind/lib/lwres/lwconfig.c","lwres_conf_clear",261,300
45,14,298,2,54,"lwres_conf_parsenameserver@303-357@usr.sbin/bind/lib/lwres/lwconfig.c","usr.sbin/bind/lib/lwres/lwconfig.c","lwres_conf_parsenameserver",303,357
20,8,142,2,25,"lwres_conf_parselwserver@360-385@usr.sbin/bind/lib/lwres/lwconfig.c","usr.sbin/bind/lib/lwres/lwconfig.c","lwres_conf_parselwserver",360,385
28,10,213,2,38,"lwres_conf_parsedomain@388-426@usr.sbin/bind/lib/lwres/lwconfig.c","usr.sbin/bind/lib/lwres/lwconfig.c","lwres_conf_parsedomain",388,426
38,10,257,2,51,"lwres_conf_parsesearch@429-480@usr.sbin/bind/lib/lwres/lwconfig.c","usr.sbin/bind/lib/lwres/lwconfig.c","lwres_conf_parsesearch",429,480
22,5,186,3,24,"lwres_create_addr@483-507@usr.sbin/bind/lib/lwres/lwconfig.c","usr.sbin/bind/lib/lwres/lwconfig.c","lwres_create_addr",483,507
39,10,273,2,51,"lwres_conf_parsesortlist@510-561@usr.sbin/bind/lib/lwres/lwconfig.c","usr.sbin/bind/lib/lwres/lwconfig.c","lwres_conf_parsesortlist",510,561
31,11,222,2,35,"lwres_conf_parseoption@564-599@usr.sbin/bind/lib/lwres/lwconfig.c","usr.sbin/bind/lib/lwres/lwconfig.c","lwres_conf_parseoption",564,599
48,14,326,2,55,"lwres_conf_parse@603-658@usr.sbin/bind/lib/lwres/lwconfig.c","usr.sbin/bind/lib/lwres/lwconfig.c","lwres_conf_parse",603,658
72,16,577,2,92,"lwres_conf_print@662-754@usr.sbin/bind/lib/lwres/lwconfig.c","usr.sbin/bind/lib/lwres/lwconfig.c","lwres_conf_print",662,754
4,1,23,1,4,"lwres_conf_get@758-762@usr.sbin/bind/lib/lwres/lwconfig.c","usr.sbin/bind/lib/lwres/lwconfig.c","lwres_conf_get",758,762
76,31,488,2,108,"lwres_net_aton@97-205@usr.sbin/bind/lib/lwres/lwinetaton.c","usr.sbin/bind/lib/lwres/lwinetaton.c","lwres_net_aton",97,205
11,4,66,4,13,"lwres_net_ntop@59-72@usr.sbin/bind/lib/lwres/lwinetntop.c","usr.sbin/bind/lib/lwres/lwinetntop.c","lwres_net_ntop",59,72
14,3,118,3,15,"inet_ntop4@86-101@usr.sbin/bind/lib/lwres/lwinetntop.c","usr.sbin/bind/lib/lwres/lwinetntop.c","inet_ntop4",86,101
64,28,542,3,88,"inet_ntop6@111-199@usr.sbin/bind/lib/lwres/lwinetntop.c","usr.sbin/bind/lib/lwres/lwinetntop.c","inet_ntop6",111,199
11,3,60,3,11,"lwres_net_pton@57-68@usr.sbin/bind/lib/lwres/lwinetpton.c","usr.sbin/bind/lib/lwres/lwinetpton.c","lwres_net_pton",57,68
32,10,210,2,34,"inet_pton4@81-115@usr.sbin/bind/lib/lwres/lwinetpton.c","usr.sbin/bind/lib/lwres/lwinetpton.c","inet_pton4",81,115
71,19,464,2,78,"inet_pton6@131-209@usr.sbin/bind/lib/lwres/lwinetpton.c","usr.sbin/bind/lib/lwres/lwinetpton.c","inet_pton6",131,209
16,2,127,2,18,"lwres_lwpacket_renderheader@78-96@usr.sbin/bind/lib/lwres/lwpacket.c","usr.sbin/bind/lib/lwres/lwpacket.c","lwres_lwpacket_renderheader",78,96
20,3,146,2,28,"lwres_lwpacket_parseheader@101-129@usr.sbin/bind/lib/lwres/lwpacket.c","usr.sbin/bind/lib/lwres/lwpacket.c","lwres_lwpacket_parseheader",101,129
42,3,279,4,64,"lwres_gabnrequest_render@121-185@usr.sbin/bind/lib/lwres/lwres_gabn.c","usr.sbin/bind/lib/lwres/lwres_gabn.c","lwres_gabnrequest_render",121,185
70,7,491,4,94,"lwres_gabnresponse_render@188-282@usr.sbin/bind/lib/lwres/lwres_gabn.c","usr.sbin/bind/lib/lwres/lwres_gabn.c","lwres_gabnresponse_render",188,282
34,7,214,4,45,"lwres_gabnrequest_parse@285-330@usr.sbin/bind/lib/lwres/lwres_gabn.c","usr.sbin/bind/lib/lwres/lwres_gabn.c","lwres_gabnrequest_parse",285,330
96,20,615,4,126,"lwres_gabnresponse_parse@335-461@usr.sbin/bind/lib/lwres/lwres_gabn.c","usr.sbin/bind/lib/lwres/lwres_gabn.c","lwres_gabnresponse_parse",335,461
9,2,55,2,11,"lwres_gabnrequest_free@465-476@usr.sbin/bind/lib/lwres/lwres_gabn.c","usr.sbin/bind/lib/lwres/lwres_gabn.c","lwres_gabnrequest_free",465,476
23,5,168,2,25,"lwres_gabnresponse_free@480-505@usr.sbin/bind/lib/lwres/lwres_gabn.c","usr.sbin/bind/lib/lwres/lwres_gabn.c","lwres_gabnresponse_free",480,505
41,3,286,4,53,"lwres_gnbarequest_render@117-170@usr.sbin/bind/lib/lwres/lwres_gnba.c","usr.sbin/bind/lib/lwres/lwres_gnba.c","lwres_gnbarequest_render",117,170
52,5,355,4,68,"lwres_gnbaresponse_render@174-242@usr.sbin/bind/lib/lwres/lwres_gnba.c","usr.sbin/bind/lib/lwres/lwres_gnba.c","lwres_gnbaresponse_render",174,242
31,8,192,4,40,"lwres_gnbarequest_parse@246-286@usr.sbin/bind/lib/lwres/lwres_gnba.c","usr.sbin/bind/lib/lwres/lwres_gnba.c","lwres_gnbarequest_parse",246,286
65,15,417,4,87,"lwres_gnbaresponse_parse@291-378@usr.sbin/bind/lib/lwres/lwres_gnba.c","usr.sbin/bind/lib/lwres/lwres_gnba.c","lwres_gnbaresponse_parse",291,378
9,2,55,2,11,"lwres_gnbarequest_free@382-393@usr.sbin/bind/lib/lwres/lwres_gnba.c","usr.sbin/bind/lib/lwres/lwres_gnba.c","lwres_gnbarequest_free",382,393
16,4,117,2,18,"lwres_gnbaresponse_free@397-415@usr.sbin/bind/lib/lwres/lwres_gnba.c","usr.sbin/bind/lib/lwres/lwres_gnba.c","lwres_gnbaresponse_free",397,415
43,3,290,4,69,"lwres_grbnrequest_render@40-109@usr.sbin/bind/lib/lwres/lwres_grbn.c","usr.sbin/bind/lib/lwres/lwres_grbn.c","lwres_grbnrequest_render",40,109
61,7,468,4,84,"lwres_grbnresponse_render@113-197@usr.sbin/bind/lib/lwres/lwres_grbn.c","usr.sbin/bind/lib/lwres/lwres_grbn.c","lwres_grbnresponse_render",113,197
36,7,231,4,50,"lwres_grbnrequest_parse@201-251@usr.sbin/bind/lib/lwres/lwres_grbn.c","usr.sbin/bind/lib/lwres/lwres_grbn.c","lwres_grbnrequest_parse",201,251
98,22,664,4,130,"lwres_grbnresponse_parse@255-385@usr.sbin/bind/lib/lwres/lwres_grbn.c","usr.sbin/bind/lib/lwres/lwres_grbn.c","lwres_grbnresponse_parse",255,385
9,2,55,2,11,"lwres_grbnrequest_free@389-400@usr.sbin/bind/lib/lwres/lwres_grbn.c","usr.sbin/bind/lib/lwres/lwres_grbn.c","lwres_grbnrequest_free",389,400
20,5,160,2,22,"lwres_grbnresponse_free@404-426@usr.sbin/bind/lib/lwres/lwres_grbn.c","usr.sbin/bind/lib/lwres/lwres_grbn.c","lwres_grbnresponse_free",404,426
36,3,229,4,48,"lwres_nooprequest_render@116-164@usr.sbin/bind/lib/lwres/lwres_noop.c","usr.sbin/bind/lib/lwres/lwres_noop.c","lwres_nooprequest_render",116,164
35,3,223,4,47,"lwres_noopresponse_render@169-216@usr.sbin/bind/lib/lwres/lwres_noop.c","usr.sbin/bind/lib/lwres/lwres_noop.c","lwres_noopresponse_render",169,216
35,7,216,4,44,"lwres_nooprequest_parse@220-264@usr.sbin/bind/lib/lwres/lwres_noop.c","usr.sbin/bind/lib/lwres/lwres_noop.c","lwres_nooprequest_parse",220,264
35,7,216,4,44,"lwres_noopresponse_parse@268-312@usr.sbin/bind/lib/lwres/lwres_noop.c","usr.sbin/bind/lib/lwres/lwres_noop.c","lwres_noopresponse_parse",268,312
9,2,55,2,11,"lwres_noopresponse_free@316-327@usr.sbin/bind/lib/lwres/lwres_noop.c","usr.sbin/bind/lib/lwres/lwres_noop.c","lwres_noopresponse_free",316,327
9,2,55,2,11,"lwres_nooprequest_free@331-342@usr.sbin/bind/lib/lwres/lwres_noop.c","usr.sbin/bind/lib/lwres/lwres_noop.c","lwres_nooprequest_free",331,342
18,5,113,3,29,"lwres_data_parse@130-159@usr.sbin/bind/lib/lwres/lwresutil.c","usr.sbin/bind/lib/lwres/lwresutil.c","lwres_data_parse",130,159
22,7,144,3,37,"lwres_string_parse@178-215@usr.sbin/bind/lib/lwres/lwresutil.c","usr.sbin/bind/lib/lwres/lwresutil.c","lwres_string_parse",178,215
14,4,100,2,18,"lwres_addr_parse@219-237@usr.sbin/bind/lib/lwres/lwresutil.c","usr.sbin/bind/lib/lwres/lwresutil.c","lwres_addr_parse",219,237
80,14,483,4,110,"lwres_getaddrsbyname@241-351@usr.sbin/bind/lib/lwres/lwresutil.c","usr.sbin/bind/lib/lwres/lwresutil.c","lwres_getaddrsbyname",241,351
76,13,462,5,105,"lwres_getnamebyaddr@356-461@usr.sbin/bind/lib/lwres/lwresutil.c","usr.sbin/bind/lib/lwres/lwresutil.c","lwres_getnamebyaddr",356,461
81,14,488,6,111,"lwres_getrdatabyname@465-576@usr.sbin/bind/lib/lwres/lwresutil.c","usr.sbin/bind/lib/lwres/lwresutil.c","lwres_getrdatabyname",465,576
7,1,47,3,7,"lwres__print_sprintf@36-43@usr.sbin/bind/lib/lwres/print.c","usr.sbin/bind/lib/lwres/print.c","lwres__print_sprintf",36,43
8,1,54,4,9,"lwres__print_snprintf@50-59@usr.sbin/bind/lib/lwres/print.c","usr.sbin/bind/lib/lwres/print.c","lwres__print_snprintf",50,59
460,155,2287,4,499,"lwres__print_vsnprintf@66-565@usr.sbin/bind/lib/lwres/print.c","usr.sbin/bind/lib/lwres/print.c","lwres__print_vsnprintf",66,565
52,25,346,3,55,"lwres_strtoul@80-135@usr.sbin/bind/lib/lwres/strtoul.c","usr.sbin/bind/lib/lwres/strtoul.c","lwres_strtoul",80,135
77,28,541,2,88,"main@50-138@usr.sbin/chroot/chroot.c","usr.sbin/chroot/chroot.c","main",50,138
7,1,29,1,7,"usage@141-148@usr.sbin/chroot/chroot.c","usr.sbin/chroot/chroot.c","usage",141,148
9,2,68,1,10,"Xhelp@68-78@usr.sbin/config/cmd.c","usr.sbin/config/cmd.c","Xhelp",68,78
12,3,77,1,12,"Xadd@81-93@usr.sbin/config/cmd.c","usr.sbin/config/cmd.c","Xadd",81,93
15,6,87,1,15,"Xbase@96-111@usr.sbin/config/cmd.c","usr.sbin/config/cmd.c","Xbase",96,111
14,4,99,1,14,"Xchange@114-128@usr.sbin/config/cmd.c","usr.sbin/config/cmd.c","Xchange",114,128
16,5,125,1,16,"Xdisable@131-147@usr.sbin/config/cmd.c","usr.sbin/config/cmd.c","Xdisable",131,147
16,5,125,1,16,"Xenable@150-166@usr.sbin/config/cmd.c","usr.sbin/config/cmd.c","Xenable",150,166
14,4,99,1,14,"Xfind@169-183@usr.sbin/config/cmd.c","usr.sbin/config/cmd.c","Xfind",169,183
11,3,57,1,11,"Xlines@186-197@usr.sbin/config/cmd.c","usr.sbin/config/cmd.c","Xlines",186,197
22,6,100,1,24,"Xlist@200-224@usr.sbin/config/cmd.c","usr.sbin/config/cmd.c","Xlist",200,224
8,2,40,1,7,"Xshow@227-234@usr.sbin/config/cmd.c","usr.sbin/config/cmd.c","Xshow",227,234
4,1,13,1,4,"Xquit@237-241@usr.sbin/config/cmd.c","usr.sbin/config/cmd.c","Xquit",237,241
4,1,13,1,4,"Xexit@244-248@usr.sbin/config/cmd.c","usr.sbin/config/cmd.c","Xexit",244,248
27,8,190,1,28,"Xtimezone@251-279@usr.sbin/config/cmd.c","usr.sbin/config/cmd.c","Xtimezone",251,279
19,4,132,3,21,"int_variable_adjust@282-303@usr.sbin/config/cmd.c","usr.sbin/config/cmd.c","int_variable_adjust",282,303
5,1,22,1,4,"Xbufcachepct@306-310@usr.sbin/config/cmd.c","usr.sbin/config/cmd.c","Xbufcachepct",306,310
5,1,22,1,4,"Xnkmempg@313-317@usr.sbin/config/cmd.c","usr.sbin/config/cmd.c","Xnkmempg",313,317
18,5,137,1,20,"adjust@52-72@usr.sbin/config/exec_elf.c","usr.sbin/config/exec_elf.c","adjust",52,72
16,5,135,1,18,"readjust@75-93@usr.sbin/config/exec_elf.c","usr.sbin/config/exec_elf.c","readjust",75,93
30,9,311,1,40,"loadkernel@96-136@usr.sbin/config/exec_elf.c","usr.sbin/config/exec_elf.c","loadkernel",96,136
9,3,71,1,11,"savekernel@139-150@usr.sbin/config/exec_elf.c","usr.sbin/config/exec_elf.c","savekernel",139,150
8,1,33,1,8,"initfiles@80-88@usr.sbin/config/files.c","usr.sbin/config/files.c","initfiles",80,88
65,17,422,4,79,"addfile@91-170@usr.sbin/config/files.c","usr.sbin/config/files.c","addfile",91,170
22,3,147,3,26,"addobject@173-199@usr.sbin/config/files.c","usr.sbin/config/files.c","addobject",173,199
10,4,78,1,10,"checkfiles@208-218@usr.sbin/config/files.c","usr.sbin/config/files.c","checkfiles",208,218
11,2,59,2,12,"checkaux@225-237@usr.sbin/config/files.c","usr.sbin/config/files.c","checkaux",225,237
44,11,270,1,53,"fixfiles@245-298@usr.sbin/config/files.c","usr.sbin/config/files.c","fixfiles",245,298
22,5,111,1,24,"fixobjects@305-329@usr.sbin/config/files.c","usr.sbin/config/files.c","fixobjects",305,329
14,2,104,2,14,"fixcount@341-355@usr.sbin/config/files.c","usr.sbin/config/files.c","fixcount",341,355
11,1,73,2,11,"fixfsel@362-373@usr.sbin/config/files.c","usr.sbin/config/files.c","fixfsel",362,373
4,1,25,2,4,"fixsel@379-383@usr.sbin/config/files.c","usr.sbin/config/files.c","fixsel",379,383
20,5,162,3,24,"expr_eval@394-418@usr.sbin/config/files.c","usr.sbin/config/files.c","expr_eval",394,418
19,6,80,1,25,"expr_free@424-449@usr.sbin/config/files.c","usr.sbin/config/files.c","expr_free",424,449
7,1,32,1,6,"prexpr@456-462@usr.sbin/config/files.c","usr.sbin/config/files.c","prexpr",456,462
24,6,99,1,24,"pr0@465-489@usr.sbin/config/files.c","usr.sbin/config/files.c","pr0",465,489
17,2,79,1,22,"poolalloc@87-109@usr.sbin/config/hash.c","usr.sbin/config/hash.c","poolalloc",87,109
13,2,87,2,13,"ht_init@115-128@usr.sbin/config/hash.c","usr.sbin/config/hash.c","ht_init",115,128
21,3,156,1,21,"ht_expand@134-155@usr.sbin/config/hash.c","usr.sbin/config/hash.c","ht_expand",134,155
11,1,69,2,11,"newhashent@161-172@usr.sbin/config/hash.c","usr.sbin/config/hash.c","newhashent",161,172
7,2,42,1,7,"hash@178-185@usr.sbin/config/hash.c","usr.sbin/config/hash.c","hash",178,185
4,1,14,1,4,"initintern@188-192@usr.sbin/config/hash.c","usr.sbin/config/hash.c","initintern",188,192
21,5,159,1,21,"intern@199-220@usr.sbin/config/hash.c","usr.sbin/config/hash.c","intern",199,220
7,1,32,1,7,"ht_new@223-230@usr.sbin/config/hash.c","usr.sbin/config/hash.c","ht_new",223,230
20,6,157,2,25,"ht_remove@236-261@usr.sbin/config/hash.c","usr.sbin/config/hash.c","ht_remove",236,261
19,5,138,4,19,"ht_insrep@267-286@usr.sbin/config/hash.c","usr.sbin/config/hash.c","ht_insrep",267,286
11,3,85,2,11,"ht_lookup@289-300@usr.sbin/config/hash.c","usr.sbin/config/hash.c","ht_lookup",289,300
9,1,28,1,10,"usage@79-89@usr.sbin/config/main.c","usr.sbin/config/main.c","usage",79,89
112,38,625,2,169,"main@97-266@usr.sbin/config/main.c","usr.sbin/config/main.c","main",97,266
13,4,72,2,13,"mksymlink@269-282@usr.sbin/config/main.c","usr.sbin/config/main.c","mksymlink",269,282
22,3,127,1,23,"mksymlinks@290-313@usr.sbin/config/main.c","usr.sbin/config/main.c","mksymlinks",290,313
5,1,21,1,4,"stop@316-320@usr.sbin/config/main.c","usr.sbin/config/main.c","stop",316,320
14,3,131,1,27,"defoption@326-353@usr.sbin/config/main.c","usr.sbin/config/main.c","defoption",326,353
31,7,213,1,34,"removeoption@359-393@usr.sbin/config/main.c","usr.sbin/config/main.c","removeoption",359,393
15,4,137,2,17,"addoption@400-417@usr.sbin/config/main.c","usr.sbin/config/main.c","addoption",400,417
4,1,31,2,4,"addmkoption@423-427@usr.sbin/config/main.c","usr.sbin/config/main.c","addmkoption",423,427
19,4,144,5,22,"do_option@433-455@usr.sbin/config/main.c","usr.sbin/config/main.c","do_option",433,455
10,4,68,2,10,"deva_has_instances@462-472@usr.sbin/config/main.c","usr.sbin/config/main.c","deva_has_instances",462,472
8,3,54,2,8,"devbase_has_instances@479-487@usr.sbin/config/main.c","usr.sbin/config/main.c","devbase_has_instances",479,487
12,5,90,1,31,"hasparent@490-521@usr.sbin/config/main.c","usr.sbin/config/main.c","hasparent",490,521
33,12,216,3,34,"cfcrosscheck@524-558@usr.sbin/config/main.c","usr.sbin/config/main.c","cfcrosscheck",524,558
30,8,197,1,30,"crosscheck@567-597@usr.sbin/config/main.c","usr.sbin/config/main.c","crosscheck",567,597
29,9,170,1,29,"badstar@603-632@usr.sbin/config/main.c","usr.sbin/config/main.c","badstar",603,632
41,20,290,1,49,"setupdirs@639-688@usr.sbin/config/main.c","usr.sbin/config/main.c","setupdirs",639,688
16,8,119,2,16,"optcmp@696-712@usr.sbin/config/main.c","usr.sbin/config/main.c","optcmp",696,712
49,16,397,1,53,"optiondelta@715-768@usr.sbin/config/main.c","usr.sbin/config/main.c","optiondelta",715,768
17,3,146,1,21,"ask_cmd@41-62@usr.sbin/config/misc.c","usr.sbin/config/misc.c","ask_cmd",41,62
21,8,116,1,23,"ask_yn@65-88@usr.sbin/config/misc.c","usr.sbin/config/misc.c","ask_yn",65,88
16,7,101,1,18,"mkheaders@62-80@usr.sbin/config/mkheaders.c","usr.sbin/config/mkheaders.c","mkheaders",62,80
37,13,291,1,37,"emitcnt@83-120@usr.sbin/config/mkheaders.c","usr.sbin/config/mkheaders.c","emitcnt",83,120
48,14,333,1,59,"emitopt@123-182@usr.sbin/config/mkheaders.c","usr.sbin/config/mkheaders.c","emitopt",123,182
7,2,43,3,7,"emitwarn@185-192@usr.sbin/config/mkheaders.c","usr.sbin/config/mkheaders.c","emitwarn",185,192
12,3,78,1,12,"cntname@195-207@usr.sbin/config/mkheaders.c","usr.sbin/config/mkheaders.c","cntname",195,207
21,11,140,1,22,"mkioconf@74-96@usr.sbin/config/mkioconf.c","usr.sbin/config/mkioconf.c","mkioconf",74,96
7,1,54,2,7,"cforder@99-106@usr.sbin/config/mkioconf.c","usr.sbin/config/mkioconf.c","cforder",99,106
31,7,180,1,31,"emithdr@109-140@usr.sbin/config/mkioconf.c","usr.sbin/config/mkioconf.c","emithdr",109,140
23,7,129,1,23,"emitexterns@143-166@usr.sbin/config/mkioconf.c","usr.sbin/config/mkioconf.c","emitexterns",143,166
18,5,104,1,18,"emitloc@169-187@usr.sbin/config/mkioconf.c","usr.sbin/config/mkioconf.c","emitloc",169,187
13,5,96,1,14,"addlocname@193-207@usr.sbin/config/mkioconf.c","usr.sbin/config/mkioconf.c","addlocname",193,207
8,3,47,1,7,"addlocnami@213-220@usr.sbin/config/mkioconf.c","usr.sbin/config/mkioconf.c","addlocnami",213,220
47,16,362,1,58,"emitlocnames@228-286@usr.sbin/config/mkioconf.c","usr.sbin/config/mkioconf.c","emitlocnames",228,286
14,5,108,1,14,"emitpv@293-307@usr.sbin/config/mkioconf.c","usr.sbin/config/mkioconf.c","emitpv",293,307
71,21,478,1,74,"emitcfdata@313-387@usr.sbin/config/mkioconf.c","usr.sbin/config/mkioconf.c","emitcfdata",313,387
21,9,159,1,22,"emitroots@393-415@usr.sbin/config/mkioconf.c","usr.sbin/config/mkioconf.c","emitroots",393,415
36,13,267,1,36,"emitpseudo@421-457@usr.sbin/config/mkioconf.c","usr.sbin/config/mkioconf.c","emitpseudo",421,457
72,18,419,1,73,"mkmakefile@71-144@usr.sbin/config/mkmakefile.c","usr.sbin/config/mkmakefile.c","mkmakefile",71,144
38,13,265,1,42,"expandname@147-189@usr.sbin/config/mkmakefile.c","usr.sbin/config/mkmakefile.c","expandname",147,189
32,9,195,1,41,"srcpath@198-239@usr.sbin/config/mkmakefile.c","usr.sbin/config/mkmakefile.c","srcpath",198,239
32,15,255,1,32,"emitdefs@242-274@usr.sbin/config/mkmakefile.c","usr.sbin/config/mkmakefile.c","emitdefs",242,274
24,10,137,1,24,"emitreconfig@277-301@usr.sbin/config/mkmakefile.c","usr.sbin/config/mkmakefile.c","emitreconfig",277,301
46,14,311,1,46,"emitobjs@304-350@usr.sbin/config/mkmakefile.c","usr.sbin/config/mkmakefile.c","emitobjs",304,350
4,1,18,1,4,"emitcfiles@353-357@usr.sbin/config/mkmakefile.c","usr.sbin/config/mkmakefile.c","emitcfiles",353,357
4,1,18,1,4,"emitsfiles@360-364@usr.sbin/config/mkmakefile.c","usr.sbin/config/mkmakefile.c","emitsfiles",360,364
36,13,250,2,36,"emitfiles@367-403@usr.sbin/config/mkmakefile.c","usr.sbin/config/mkmakefile.c","emitfiles",367,403
11,5,91,4,10,"emit_1rule@409-419@usr.sbin/config/mkmakefile.c","usr.sbin/config/mkmakefile.c","emit_1rule",409,419
31,9,157,1,41,"emitrules@422-463@usr.sbin/config/mkmakefile.c","usr.sbin/config/mkmakefile.c","emitrules",422,463
63,19,361,1,65,"emitload@471-536@usr.sbin/config/mkmakefile.c","usr.sbin/config/mkmakefile.c","emitload",471,536
8,4,50,1,8,"mkswap@61-69@usr.sbin/config/mkswap.c","usr.sbin/config/mkswap.c","mkswap",61,69
10,2,60,1,10,"mkdevstr@72-82@usr.sbin/config/mkswap.c","usr.sbin/config/mkswap.c","mkdevstr",72,82
46,13,299,1,48,"mkoneswap@85-133@usr.sbin/config/mkswap.c","usr.sbin/config/mkswap.c","mkoneswap",85,133
22,4,138,1,34,"pack@119-153@usr.sbin/config/pack.c","usr.sbin/config/pack.c","pack",119,153
38,8,274,1,45,"packdevi@162-207@usr.sbin/config/pack.c","usr.sbin/config/pack.c","packdevi",162,207
12,5,91,2,12,"sameas@215-227@usr.sbin/config/pack.c","usr.sbin/config/pack.c","sameas",215,227
54,15,411,2,58,"addparents@234-292@usr.sbin/config/pack.c","usr.sbin/config/pack.c","addparents",234,292
17,7,111,3,19,"nparents@298-317@usr.sbin/config/pack.c","usr.sbin/config/pack.c","nparents",298,317
15,4,128,1,15,"packlocs@320-335@usr.sbin/config/pack.c","usr.sbin/config/pack.c","packlocs",320,335
22,6,183,1,22,"packpvec@338-360@usr.sbin/config/pack.c","usr.sbin/config/pack.c","packpvec",338,360
16,4,127,5,16,"findvec@369-385@usr.sbin/config/pack.c","usr.sbin/config/pack.c","findvec",369,385
8,3,70,3,8,"samelocs@391-399@usr.sbin/config/pack.c","usr.sbin/config/pack.c","samelocs",391,399
11,3,76,2,11,"addlocs@405-416@usr.sbin/config/pack.c","usr.sbin/config/pack.c","addlocs",405,416
7,1,58,2,7,"loclencmp@423-430@usr.sbin/config/pack.c","usr.sbin/config/pack.c","loclencmp",423,430
8,3,68,3,8,"samepv@436-444@usr.sbin/config/pack.c","usr.sbin/config/pack.c","samepv",436,444
18,6,119,2,24,"addpv@450-474@usr.sbin/config/pack.c","usr.sbin/config/pack.c","addpv",450,474
7,1,54,2,7,"pvlencmp@481-488@usr.sbin/config/pack.c","usr.sbin/config/pack.c","pvlencmp",481,488
12,3,73,1,12,"resettails@491-503@usr.sbin/config/pack.c","usr.sbin/config/pack.c","resettails",491,503
20,1,95,1,26,"initsem@94-120@usr.sbin/config/sem.c","usr.sbin/config/sem.c","initsem",94,120
17,4,80,1,17,"enddefs@126-143@usr.sbin/config/sem.c","usr.sbin/config/sem.c","enddefs",126,143
10,4,47,3,10,"setdefmaxusers@146-156@usr.sbin/config/sem.c","usr.sbin/config/sem.c","setdefmaxusers",146,156
13,4,63,1,13,"setmaxusers@159-172@usr.sbin/config/sem.c","usr.sbin/config/sem.c","setmaxusers",159,172
29,4,167,2,29,"defattr@180-209@usr.sbin/config/sem.c","usr.sbin/config/sem.c","defattr",180,209
7,3,44,2,7,"has_errobj@216-223@usr.sbin/config/sem.c","usr.sbin/config/sem.c","has_errobj",216,223
6,1,39,2,6,"addtoattr@231-237@usr.sbin/config/sem.c","usr.sbin/config/sem.c","addtoattr",231,237
34,8,202,4,49,"defdev@244-293@usr.sbin/config/sem.c","usr.sbin/config/sem.c","defdev",244,293
36,8,215,1,36,"getdevbase@300-336@usr.sbin/config/sem.c","usr.sbin/config/sem.c","getdevbase",300,336
63,19,391,4,82,"defdevattach@343-425@usr.sbin/config/sem.c","usr.sbin/config/sem.c","defdevattach",343,425
35,8,211,1,35,"getdevattach@432-467@usr.sbin/config/sem.c","usr.sbin/config/sem.c","getdevattach",432,467
9,2,48,1,9,"getattr@473-482@usr.sbin/config/sem.c","usr.sbin/config/sem.c","getattr",473,482
8,3,45,2,8,"setmajor@489-497@usr.sbin/config/sem.c","usr.sbin/config/sem.c","setmajor",489,497
8,2,46,3,8,"exclude@500-508@usr.sbin/config/sem.c","usr.sbin/config/sem.c","exclude",500,508
61,18,478,5,79,"resolve@516-595@usr.sbin/config/sem.c","usr.sbin/config/sem.c","resolve",516,595
9,3,75,5,9,"lresolve@598-607@usr.sbin/config/sem.c","usr.sbin/config/sem.c","lresolve",598,607
41,8,270,1,49,"addconf@613-662@usr.sbin/config/sem.c","usr.sbin/config/sem.c","addconf",613,662
8,2,46,3,8,"setconf@665-673@usr.sbin/config/sem.c","usr.sbin/config/sem.c","setconf",665,673
23,2,145,3,23,"newdevi@676-699@usr.sbin/config/sem.c","usr.sbin/config/sem.c","newdevi",676,699
41,9,244,2,43,"enabledev@705-748@usr.sbin/config/sem.c","usr.sbin/config/sem.c","enabledev",705,748
81,17,500,5,133,"adddev@755-888@usr.sbin/config/sem.c","usr.sbin/config/sem.c","adddev",755,888
27,5,156,3,27,"addpseudo@891-918@usr.sbin/config/sem.c","usr.sbin/config/sem.c","addpseudo",891,918
36,7,224,1,36,"getdevi@924-960@usr.sbin/config/sem.c","usr.sbin/config/sem.c","getdevi",924,960
14,2,92,2,14,"concat@963-977@usr.sbin/config/sem.c","usr.sbin/config/sem.c","concat",963,977
4,1,19,1,4,"starref@980-984@usr.sbin/config/sem.c","usr.sbin/config/sem.c","starref",980,984
4,1,19,1,4,"wildref@987-991@usr.sbin/config/sem.c","usr.sbin/config/sem.c","wildref",987,991
26,8,178,5,26,"split@999-1025@usr.sbin/config/sem.c","usr.sbin/config/sem.c","split",999,1025
18,4,164,2,18,"selectbase@1032-1050@usr.sbin/config/sem.c","usr.sbin/config/sem.c","selectbase",1032,1050
7,3,44,2,6,"onlist@1056-1062@usr.sbin/config/sem.c","usr.sbin/config/sem.c","onlist",1056,1062
10,1,53,2,10,"extend@1065-1075@usr.sbin/config/sem.c","usr.sbin/config/sem.c","extend",1065,1075
70,19,470,3,76,"fixloc@1082-1158@usr.sbin/config/sem.c","usr.sbin/config/sem.c","fixloc",1082,1158
6,2,31,2,5,"check_int@50-55@usr.sbin/config/ukc.c","usr.sbin/config/ukc.c","check_int",50,55
100,38,691,4,114,"ukc@58-172@usr.sbin/config/ukc.c","usr.sbin/config/ukc.c","ukc",58,172
31,7,160,1,36,"init@175-211@usr.sbin/config/ukc.c","usr.sbin/config/ukc.c","init",175,211
5,1,38,1,4,"get_cfdata@47-51@usr.sbin/config/ukcutil.c","usr.sbin/config/ukcutil.c","get_cfdata",47,51
5,1,36,1,4,"get_locnamp@54-58@usr.sbin/config/ukcutil.c","usr.sbin/config/ukcutil.c","get_locnamp",54,58
5,1,36,1,4,"get_locnames@61-65@usr.sbin/config/ukcutil.c","usr.sbin/config/ukcutil.c","get_locnames",61,65
13,2,110,1,14,"get_extraloc@68-82@usr.sbin/config/ukcutil.c","usr.sbin/config/ukcutil.c","get_extraloc",68,82
7,1,51,1,8,"get_pdevnames@85-93@usr.sbin/config/ukcutil.c","usr.sbin/config/ukcutil.c","get_pdevnames",85,93
5,1,38,1,4,"get_pdevinit@96-100@usr.sbin/config/ukcutil.c","usr.sbin/config/ukcutil.c","get_pdevinit",96,100
17,6,87,1,17,"more@103-120@usr.sbin/config/ukcutil.c","usr.sbin/config/ukcutil.c","more",103,120
19,6,73,1,19,"pnum@123-142@usr.sbin/config/ukcutil.c","usr.sbin/config/ukcutil.c","pnum",123,142
24,6,113,1,26,"pdevnam@145-171@usr.sbin/config/ukcutil.c","usr.sbin/config/ukcutil.c","pdevnam",145,171
66,16,355,1,71,"pdev@174-245@usr.sbin/config/ukcutil.c","usr.sbin/config/ukcutil.c","pdev",174,245
10,7,88,2,10,"numberl@248-258@usr.sbin/config/ukcutil.c","usr.sbin/config/ukcutil.c","numberl",248,258
12,4,64,2,12,"number@261-273@usr.sbin/config/ukcutil.c","usr.sbin/config/ukcutil.c","number",261,273
30,10,168,4,32,"device@276-308@usr.sbin/config/ukcutil.c","usr.sbin/config/ukcutil.c","device",276,308
24,9,158,2,27,"attr@311-338@usr.sbin/config/ukcutil.c","usr.sbin/config/ukcutil.c","attr",311,338
24,5,127,2,26,"modifyl@341-367@usr.sbin/config/ukcutil.c","usr.sbin/config/ukcutil.c","modifyl",341,367
11,4,57,2,11,"modify@370-381@usr.sbin/config/ukcutil.c","usr.sbin/config/ukcutil.c","modify",370,381
81,20,479,1,98,"change@384-482@usr.sbin/config/ukcutil.c","usr.sbin/config/ukcutil.c","change",384,482
97,32,562,2,117,"change_history@485-602@usr.sbin/config/ukcutil.c","usr.sbin/config/ukcutil.c","change_history",485,602
53,13,240,1,61,"disable@605-666@usr.sbin/config/ukcutil.c","usr.sbin/config/ukcutil.c","disable",605,666
53,13,240,1,59,"enable@669-728@usr.sbin/config/ukcutil.c","usr.sbin/config/ukcutil.c","enable",669,728
15,3,68,1,18,"show@731-749@usr.sbin/config/ukcutil.c","usr.sbin/config/ukcutil.c","show",731,749
50,11,216,3,53,"common_attr_val@752-805@usr.sbin/config/ukcutil.c","usr.sbin/config/ukcutil.c","common_attr_val",752,805
37,14,219,1,41,"show_attr@808-849@usr.sbin/config/ukcutil.c","usr.sbin/config/ukcutil.c","show_attr",808,849
84,27,399,5,96,"common_dev@852-948@usr.sbin/config/ukcutil.c","usr.sbin/config/ukcutil.c","common_dev",852,948
23,10,130,3,24,"common_attr@951-975@usr.sbin/config/ukcutil.c","usr.sbin/config/ukcutil.c","common_attr",951,975
45,10,259,5,49,"add_read@978-1027@usr.sbin/config/ukcutil.c","usr.sbin/config/ukcutil.c","add_read",978,1027
126,34,830,4,161,"add@1030-1191@usr.sbin/config/ukcutil.c","usr.sbin/config/ukcutil.c","add",1030,1191
84,19,583,4,101,"add_history@1194-1295@usr.sbin/config/ukcutil.c","usr.sbin/config/ukcutil.c","add_history",1194,1295
32,9,204,1,46,"config@1298-1344@usr.sbin/config/ukcutil.c","usr.sbin/config/ukcutil.c","config",1298,1344
98,32,486,2,102,"process_history@1347-1449@usr.sbin/config/ukcutil.c","usr.sbin/config/ukcutil.c","process_history",1347,1449
7,2,36,1,7,"emalloc@62-69@usr.sbin/config/util.c","usr.sbin/config/util.c","emalloc",62,69
6,2,41,3,6,"ereallocarray@75-81@usr.sbin/config/util.c","usr.sbin/config/util.c","ereallocarray",75,81
7,2,39,2,7,"ecalloc@87-94@usr.sbin/config/util.c","usr.sbin/config/util.c","ecalloc",87,94
7,2,40,1,8,"sourcepath@100-108@usr.sbin/config/util.c","usr.sbin/config/util.c","sourcepath",100,108
19,4,116,5,19,"newnv@113-132@usr.sbin/config/util.c","usr.sbin/config/util.c","newnv",113,132
5,1,19,1,5,"nvfree@138-143@usr.sbin/config/util.c","usr.sbin/config/util.c","nvfree",138,143
9,2,43,1,9,"nvfreel@149-158@usr.sbin/config/util.c","usr.sbin/config/util.c","nvfreel",149,158
8,1,45,2,8,"error@165-173@usr.sbin/config/util.c","usr.sbin/config/util.c","error",165,173
7,1,45,4,7,"xerror@180-187@usr.sbin/config/util.c","usr.sbin/config/util.c","xerror",180,187
7,1,59,4,7,"vxerror@193-200@usr.sbin/config/util.c","usr.sbin/config/util.c","vxerror",193,200
10,1,63,2,10,"panic@206-216@usr.sbin/config/util.c","usr.sbin/config/util.c","panic",206,216
12,6,91,3,12,"strtot@57-69@usr.sbin/cron/atrun.c","usr.sbin/cron/atrun.c","strtot",57,69
74,19,523,2,87,"scan_atjobs@75-162@usr.sbin/cron/atrun.c","usr.sbin/cron/atrun.c","scan_atjobs",75,162
61,16,411,3,76,"atrun@168-244@usr.sbin/cron/atrun.c","usr.sbin/cron/atrun.c","atrun",168,244
249,64,1741,3,339,"run_job@250-589@usr.sbin/cron/atrun.c","usr.sbin/cron/atrun.c","run_job",250,589
20,7,129,3,20,"in_file@45-65@usr.sbin/cron/client.c","usr.sbin/cron/client.c","in_file",45,65
16,4,119,3,16,"allowed@73-89@usr.sbin/cron/client.c","usr.sbin/cron/client.c","allowed",73,89
23,6,166,1,24,"poke_daemon@95-119@usr.sbin/cron/client.c","usr.sbin/cron/client.c","poke_daemon",95,119
5,1,20,1,5,"usage@73-78@usr.sbin/cron/cron.c","usr.sbin/cron/cron.c","usage",73,78
111,21,656,2,186,"main@81-267@usr.sbin/cron/cron.c","usr.sbin/cron/cron.c","main",81,267
12,2,64,1,12,"run_reboot_jobs@270-282@usr.sbin/cron/cron.c","usr.sbin/cron/cron.c","run_reboot_jobs",270,282
30,13,255,4,39,"find_jobs@285-324@usr.sbin/cron/cron.c","usr.sbin/cron/cron.c","find_jobs",285,324
12,3,73,1,14,"set_time@332-346@usr.sbin/cron/cron.c","usr.sbin/cron/cron.c","set_time",332,346
57,14,380,2,69,"cron_sleep@352-421@usr.sbin/cron/cron.c","usr.sbin/cron/cron.c","cron_sleep",352,421
46,8,308,1,51,"open_socket@428-479@usr.sbin/cron/cron.c","usr.sbin/cron/cron.c","open_socket",428,479
4,1,11,1,3,"sigchld_handler@482-485@usr.sbin/cron/cron.c","usr.sbin/cron/cron.c","sigchld_handler",482,485
18,5,64,1,18,"sigchld_reaper@488-506@usr.sbin/cron/cron.c","usr.sbin/cron/cron.c","sigchld_reaper",488,506
23,8,112,2,23,"parse_args@509-532@usr.sbin/cron/cron.c","usr.sbin/cron/cron.c","parse_args",509,532
13,2,55,1,12,"usage@68-80@usr.sbin/cron/crontab.c","usr.sbin/cron/crontab.c","usage",68,80
41,8,192,2,45,"main@83-128@usr.sbin/cron/crontab.c","usr.sbin/cron/crontab.c","main",83,128
67,23,400,2,79,"parse_args@131-210@usr.sbin/cron/crontab.c","usr.sbin/cron/crontab.c","parse_args",131,210
18,4,119,1,22,"list_cmd@213-235@usr.sbin/cron/crontab.c","usr.sbin/cron/crontab.c","list_cmd",213,235
15,4,99,1,15,"delete_cmd@238-253@usr.sbin/cron/crontab.c","usr.sbin/cron/crontab.c","delete_cmd",238,253
5,1,27,1,4,"check_error@256-260@usr.sbin/cron/crontab.c","usr.sbin/cron/crontab.c","check_error",256,260
109,26,635,1,125,"edit_cmd@263-388@usr.sbin/cron/crontab.c","usr.sbin/cron/crontab.c","edit_cmd",263,388
114,24,709,1,138,"replace_cmd@395-533@usr.sbin/cron/crontab.c","usr.sbin/cron/crontab.c","replace_cmd",395,533
46,12,332,1,49,"editit@542-591@usr.sbin/cron/crontab.c","usr.sbin/cron/crontab.c","editit",542,591
6,2,27,1,5,"die@594-599@usr.sbin/cron/crontab.c","usr.sbin/cron/crontab.c","die",594,599
19,8,109,2,24,"copy_crontab@602-626@usr.sbin/cron/crontab.c","usr.sbin/cron/crontab.c","copy_crontab",602,626
59,14,422,1,104,"load_database@48-152@usr.sbin/cron/database.c","usr.sbin/cron/database.c","load_database",48,152
11,3,60,2,11,"find_user@155-166@usr.sbin/cron/database.c","usr.sbin/cron/database.c","find_user",155,166
70,22,530,6,86,"process_crontab@169-255@usr.sbin/cron/database.c","usr.sbin/cron/database.c","process_crontab",169,255
14,3,54,2,23,"do_command@50-73@usr.sbin/cron/do_command.c","usr.sbin/cron/do_command.c","do_command",50,73
220,52,1381,2,387,"child_process@76-463@usr.sbin/cron/do_command.c","usr.sbin/cron/do_command.c","child_process",76,463
15,8,121,2,15,"safe_p@466-481@usr.sbin/cron/do_command.c","usr.sbin/cron/do_command.c","safe_p",466,481
8,2,40,1,7,"free_entry@74-81@usr.sbin/cron/entry.c","usr.sbin/cron/entry.c","free_entry",74,81
217,55,1507,4,302,"load_entry@87-389@usr.sbin/cron/entry.c","usr.sbin/cron/entry.c","load_entry",87,389
18,4,120,6,36,"get_list@392-428@usr.sbin/cron/entry.c","usr.sbin/cron/entry.c","get_list",392,428
46,15,313,6,79,"get_range@432-511@usr.sbin/cron/entry.c","usr.sbin/cron/entry.c","get_range",432,511
41,12,248,6,47,"get_number@514-561@usr.sbin/cron/entry.c","usr.sbin/cron/entry.c","get_number",514,561
7,3,48,4,8,"set_element@564-572@usr.sbin/cron/entry.c","usr.sbin/cron/entry.c","set_element",564,572
7,2,37,1,7,"env_init@36-43@usr.sbin/cron/env.c","usr.sbin/cron/env.c","env_init",36,43
7,2,37,1,7,"env_free@46-53@usr.sbin/cron/env.c","usr.sbin/cron/env.c","env_free",46,53
21,6,141,1,21,"env_copy@56-77@usr.sbin/cron/env.c","usr.sbin/cron/env.c","env_copy",56,77
18,7,147,3,23,"env_find@80-103@usr.sbin/cron/env.c","usr.sbin/cron/env.c","env_find",80,103
5,1,28,2,5,"env_get@106-111@usr.sbin/cron/env.c","usr.sbin/cron/env.c","env_get",106,111
20,4,131,2,24,"env_set@114-138@usr.sbin/cron/env.c","usr.sbin/cron/env.c","env_set",114,138
89,31,449,2,100,"load_env@157-257@usr.sbin/cron/env.c","usr.sbin/cron/env.c","load_env",157,257
12,4,81,2,17,"job_add@41-58@usr.sbin/cron/job.c","usr.sbin/cron/job.c","job_add",41,58
12,2,61,1,12,"job_runqueue@61-73@usr.sbin/cron/job.c","usr.sbin/cron/job.c","job_runqueue",61,73
8,2,35,1,8,"get_char@39-47@usr.sbin/cron/misc.c","usr.sbin/cron/misc.c","get_char",39,47
6,2,30,2,5,"unget_char@52-57@usr.sbin/cron/misc.c","usr.sbin/cron/misc.c","unget_char",52,57
13,5,78,4,15,"get_string@66-81@usr.sbin/cron/misc.c","usr.sbin/cron/misc.c","get_string",66,81
16,10,93,1,33,"skip_comments@86-119@usr.sbin/cron/misc.c","usr.sbin/cron/misc.c","skip_comments",86,119
17,6,127,2,24,"first_word@131-155@usr.sbin/cron/misc.c","usr.sbin/cron/misc.c","first_word",131,155
58,15,418,4,66,"cron_popen@67-133@usr.sbin/cron/popen.c","usr.sbin/cron/popen.c","cron_popen",67,133
20,5,136,2,20,"cron_pclose@136-156@usr.sbin/cron/popen.c","usr.sbin/cron/popen.c","cron_pclose",136,156
10,2,55,1,10,"free_user@38-48@usr.sbin/cron/user.c","usr.sbin/cron/user.c","free_user",38,48
5,1,25,1,4,"parse_error@54-58@usr.sbin/cron/user.c","usr.sbin/cron/user.c","parse_error",54,58
66,12,350,3,78,"load_user@61-139@usr.sbin/cron/user.c","usr.sbin/cron/user.c","load_user",61,139
14,6,106,4,16,"crunched_main2@50-66@usr.sbin/crunchgen/crunched_main.c","usr.sbin/crunchgen/crunched_main.c","crunched_main2",50,66
5,1,34,3,5,"main@69-74@usr.sbin/crunchgen/crunched_main.c","usr.sbin/crunchgen/crunched_main.c","main",69,74
6,2,44,3,5,"crunched_main@77-82@usr.sbin/crunchgen/crunched_main.c","usr.sbin/crunchgen/crunched_main.c","crunched_main",77,82
20,3,104,1,20,"crunched_usage@85-105@usr.sbin/crunchgen/crunched_main.c","usr.sbin/crunchgen/crunched_main.c","crunched_usage",85,105
87,29,517,2,103,"main@114-217@usr.sbin/crunchgen/crunchgen.c","usr.sbin/crunchgen/crunchgen.c","main",114,217
9,1,26,1,8,"usage@220-228@usr.sbin/crunchgen/crunchgen.c","usr.sbin/crunchgen/crunchgen.c","usage",220,228
13,4,57,1,12,"parse_conf_file@243-255@usr.sbin/crunchgen/crunchgen.c","usr.sbin/crunchgen/crunchgen.c","parse_conf_file",243,255
52,12,309,1,54,"parse_one_file@258-312@usr.sbin/crunchgen/crunchgen.c","usr.sbin/crunchgen/crunchgen.c","parse_one_file",258,312
21,12,139,4,22,"parse_line@315-337@usr.sbin/crunchgen/crunchgen.c","usr.sbin/crunchgen/crunchgen.c","parse_line",315,337
35,10,215,2,35,"add_srcdirs@340-375@usr.sbin/crunchgen/crunchgen.c","usr.sbin/crunchgen/crunchgen.c","add_srcdirs",340,375
48,12,289,2,48,"add_libdirs@378-426@usr.sbin/crunchgen/crunchgen.c","usr.sbin/crunchgen/crunchgen.c","add_libdirs",378,426
6,2,35,2,6,"add_progs@430-436@usr.sbin/crunchgen/crunchgen.c","usr.sbin/crunchgen/crunchgen.c","add_progs",430,436
20,7,145,1,25,"add_prog@439-464@usr.sbin/crunchgen/crunchgen.c","usr.sbin/crunchgen/crunchgen.c","add_prog",439,464
14,3,82,2,14,"add_link@467-481@usr.sbin/crunchgen/crunchgen.c","usr.sbin/crunchgen/crunchgen.c","add_link",467,481
6,2,38,2,6,"add_libs@484-490@usr.sbin/crunchgen/crunchgen.c","usr.sbin/crunchgen/crunchgen.c","add_libs",484,490
53,20,405,2,54,"add_special@493-547@usr.sbin/crunchgen/crunchgen.c","usr.sbin/crunchgen/crunchgen.c","add_special",493,547
8,3,46,1,8,"find_prog@550-558@usr.sbin/crunchgen/crunchgen.c","usr.sbin/crunchgen/crunchgen.c","find_prog",550,558
10,2,47,1,11,"gen_outputs@574-585@usr.sbin/crunchgen/crunchgen.c","usr.sbin/crunchgen/crunchgen.c","gen_outputs",574,585
62,24,469,1,67,"fillin_program@588-655@usr.sbin/crunchgen/crunchgen.c","usr.sbin/crunchgen/crunchgen.c","fillin_program",588,655
54,15,357,2,57,"fillin_program_objs@658-715@usr.sbin/crunchgen/crunchgen.c","usr.sbin/crunchgen/crunchgen.c","fillin_program_objs",658,715
19,4,87,1,20,"remove_error_progs@718-738@usr.sbin/crunchgen/crunchgen.c","usr.sbin/crunchgen/crunchgen.c","remove_error_progs",718,738
28,7,196,1,29,"gen_specials_cache@741-770@usr.sbin/crunchgen/crunchgen.c","usr.sbin/crunchgen/crunchgen.c","gen_specials_cache",741,770
17,3,95,1,20,"gen_output_makefile@773-793@usr.sbin/crunchgen/crunchgen.c","usr.sbin/crunchgen/crunchgen.c","gen_output_makefile",773,793
31,6,222,1,35,"gen_output_cfile@796-831@usr.sbin/crunchgen/crunchgen.c","usr.sbin/crunchgen/crunchgen.c","gen_output_cfile",796,831
14,6,98,1,20,"genident@834-854@usr.sbin/crunchgen/crunchgen.c","usr.sbin/crunchgen/crunchgen.c","genident",834,854
11,3,69,1,11,"dir_search@857-868@usr.sbin/crunchgen/crunchgen.c","usr.sbin/crunchgen/crunchgen.c","dir_search",857,868
56,4,415,1,65,"top_makefile_rules@871-936@usr.sbin/crunchgen/crunchgen.c","usr.sbin/crunchgen/crunchgen.c","top_makefile_rules",871,936
29,5,218,2,31,"prog_makefile_rules@939-970@usr.sbin/crunchgen/crunchgen.c","usr.sbin/crunchgen/crunchgen.c","prog_makefile_rules",939,970
6,2,43,2,5,"output_strlst@973-978@usr.sbin/crunchgen/crunchgen.c","usr.sbin/crunchgen/crunchgen.c","output_strlst",973,978
5,1,22,1,4,"out_of_memory@981-985@usr.sbin/crunchgen/crunchgen.c","usr.sbin/crunchgen/crunchgen.c","out_of_memory",981,985
17,7,121,2,21,"add_string@988-1009@usr.sbin/crunchgen/crunchgen.c","usr.sbin/crunchgen/crunchgen.c","add_string",988,1009
7,2,36,1,7,"is_dir@1012-1019@usr.sbin/crunchgen/crunchgen.c","usr.sbin/crunchgen/crunchgen.c","is_dir",1012,1019
7,3,42,1,8,"is_nonempty_file@1022-1030@usr.sbin/crunchgen/crunchgen.c","usr.sbin/crunchgen/crunchgen.c","is_nonempty_file",1022,1030
34,10,135,2,39,"crunchide_main@83-122@usr.sbin/crunchgen/crunchide.c","usr.sbin/crunchgen/crunchide.c","crunchide_main",83,122
22,9,150,1,24,"add_to_keep_list@130-154@usr.sbin/crunchgen/crunchide.c","usr.sbin/crunchgen/crunchide.c","add_to_keep_list",130,154
9,4,58,1,10,"in_keep_list@157-167@usr.sbin/crunchgen/crunchide.c","usr.sbin/crunchgen/crunchide.c","in_keep_list",157,167
17,5,102,1,18,"add_file_to_keep_list@170-188@usr.sbin/crunchgen/crunchide.c","usr.sbin/crunchgen/crunchide.c","add_file_to_keep_list",170,188
32,10,199,1,38,"hide_syms@191-229@usr.sbin/crunchgen/crunchide.c","usr.sbin/crunchgen/crunchide.c","hide_syms",191,229
65,10,525,2,81,"elf_hide@70-151@usr.sbin/crunchgen/elf_hide.c","usr.sbin/crunchgen/elf_hide.c","elf_hide",70,151
10,2,68,2,10,"load_shstr_tab@155-165@usr.sbin/crunchgen/elf_hide.c","usr.sbin/crunchgen/elf_hide.c","load_shstr_tab",155,165
5,2,32,2,4,"fprint_shstr@168-172@usr.sbin/crunchgen/elf_hide.c","usr.sbin/crunchgen/elf_hide.c","fprint_shstr",168,172
4,1,16,1,3,"get_shstr@175-178@usr.sbin/crunchgen/elf_hide.c","usr.sbin/crunchgen/elf_hide.c","get_shstr",175,178
26,7,183,2,34,"load_symtab@181-215@usr.sbin/crunchgen/elf_hide.c","usr.sbin/crunchgen/elf_hide.c","load_symtab",181,215
19,4,154,3,19,"dump_symtab@218-237@usr.sbin/crunchgen/elf_hide.c","usr.sbin/crunchgen/elf_hide.c","dump_symtab",218,237
19,5,128,2,26,"load_strtab@242-268@usr.sbin/crunchgen/elf_hide.c","usr.sbin/crunchgen/elf_hide.c","load_strtab",242,268
16,2,70,0,16,"dump_strtab@271-287@usr.sbin/crunchgen/elf_hide.c","usr.sbin/crunchgen/elf_hide.c","dump_strtab",271,287
5,2,32,2,4,"fprint_str@290-294@usr.sbin/crunchgen/elf_hide.c","usr.sbin/crunchgen/elf_hide.c","fprint_str",290,294
4,1,16,1,3,"get_str@297-300@usr.sbin/crunchgen/elf_hide.c","usr.sbin/crunchgen/elf_hide.c","get_str",297,300
28,8,193,5,32,"hide_sym@305-337@usr.sbin/crunchgen/elf_hide.c","usr.sbin/crunchgen/elf_hide.c","hide_sym",305,337
45,10,316,5,53,"reorder_syms@340-393@usr.sbin/crunchgen/elf_hide.c","usr.sbin/crunchgen/elf_hide.c","reorder_syms",340,393
39,12,305,3,49,"renum_reloc_syms@396-445@usr.sbin/crunchgen/elf_hide.c","usr.sbin/crunchgen/elf_hide.c","renum_reloc_syms",396,445
28,10,161,0,34,"init_mangle_state@54-88@usr.sbin/crunchgen/mangle.c","usr.sbin/crunchgen/mangle.c","init_mangle_state",54,88
17,4,93,0,19,"fini_mangle_state@91-110@usr.sbin/crunchgen/mangle.c","usr.sbin/crunchgen/mangle.c","fini_mangle_state",91,110
7,2,35,0,7,"dump_mangle_state@113-120@usr.sbin/crunchgen/mangle.c","usr.sbin/crunchgen/mangle.c","dump_mangle_state",113,120
17,4,90,1,21,"mangle_str@126-147@usr.sbin/crunchgen/mangle.c","usr.sbin/crunchgen/mangle.c","mangle_str",126,147
65,13,468,2,85,"main@48-133@usr.sbin/dev_mkdb/dev_mkdb.c","usr.sbin/dev_mkdb/dev_mkdb.c","main",48,133
5,1,21,1,5,"usage@136-141@usr.sbin/dev_mkdb/dev_mkdb.c","usr.sbin/dev_mkdb/dev_mkdb.c","usage",136,141
13,3,69,1,13,"new_tree_cache@62-75@usr.sbin/dhcpd/alloc.c","usr.sbin/dhcpd/alloc.c","new_tree_cache",62,75
5,1,24,1,4,"free_tree_cache@78-82@usr.sbin/dhcpd/alloc.c","usr.sbin/dhcpd/alloc.c","free_tree_cache",78,82
13,3,62,1,14,"new_lease_state@85-99@usr.sbin/dhcpd/alloc.c","usr.sbin/dhcpd/alloc.c","new_lease_state",85,99
6,1,30,2,5,"free_lease_state@102-107@usr.sbin/dhcpd/alloc.c","usr.sbin/dhcpd/alloc.c","free_lease_state",102,107
190,54,1554,1,303,"bootp@63-366@usr.sbin/dhcpd/bootp.c","usr.sbin/dhcpd/bootp.c","bootp",63,366
10,3,69,1,13,"if_register_bpf@76-89@usr.sbin/dhcpd/bpf.c","usr.sbin/dhcpd/bpf.c","if_register_bpf",76,89
4,1,17,1,7,"if_register_send@92-99@usr.sbin/dhcpd/bpf.c","usr.sbin/dhcpd/bpf.c","if_register_send",92,99
37,12,302,1,60,"if_register_receive@173-233@usr.sbin/dhcpd/bpf.c","usr.sbin/dhcpd/bpf.c","if_register_receive",173,233
20,2,172,6,24,"send_packet@236-260@usr.sbin/dhcpd/bpf.c","usr.sbin/dhcpd/bpf.c","send_packet",236,260
64,10,403,5,116,"receive_packet@263-379@usr.sbin/dhcpd/bpf.c","usr.sbin/dhcpd/bpf.c","receive_packet",263,379
10,1,46,1,9,"new_parse@88-97@usr.sbin/dhcpd/conflex.c","usr.sbin/dhcpd/conflex.c","new_parse",88,97
26,6,121,1,25,"get_char@100-125@usr.sbin/dhcpd/conflex.c","usr.sbin/dhcpd/conflex.c","get_char",100,125
33,11,175,1,35,"get_token@128-163@usr.sbin/dhcpd/conflex.c","usr.sbin/dhcpd/conflex.c","get_token",128,163
18,4,75,2,19,"next_token@166-185@usr.sbin/dhcpd/conflex.c","usr.sbin/dhcpd/conflex.c","next_token",166,185
20,4,85,2,21,"peek_token@188-209@usr.sbin/dhcpd/conflex.c","usr.sbin/dhcpd/conflex.c","peek_token",188,209
11,4,42,1,11,"skip_to_eol@212-223@usr.sbin/dhcpd/conflex.c","usr.sbin/dhcpd/conflex.c","skip_to_eol",212,223
21,11,133,1,26,"read_string@226-252@usr.sbin/dhcpd/conflex.c","usr.sbin/dhcpd/conflex.c","read_string",226,252
34,13,214,2,39,"read_num_or_name@255-294@usr.sbin/dhcpd/conflex.c","usr.sbin/dhcpd/conflex.c","read_num_or_name",255,294
4,1,34,2,3,"kw_cmp@349-352@usr.sbin/dhcpd/conflex.c","usr.sbin/dhcpd/conflex.c","kw_cmp",349,352
9,2,65,2,9,"intern@355-364@usr.sbin/dhcpd/conflex.c","usr.sbin/dhcpd/conflex.c","intern",355,364
31,4,162,1,38,"readconf@65-103@usr.sbin/dhcpd/confpars.c","usr.sbin/dhcpd/confpars.c","readconf",65,103
30,6,140,1,44,"read_leases@112-156@usr.sbin/dhcpd/confpars.c","usr.sbin/dhcpd/confpars.c","read_leases",112,156
205,56,971,5,255,"parse_statement@189-444@usr.sbin/dhcpd/confpars.c","usr.sbin/dhcpd/confpars.c","parse_statement",189,444
25,5,102,3,29,"parse_allow_deny@453-482@usr.sbin/dhcpd/confpars.c","usr.sbin/dhcpd/confpars.c","parse_allow_deny",453,482
17,5,92,1,17,"parse_boolean@488-505@usr.sbin/dhcpd/confpars.c","usr.sbin/dhcpd/confpars.c","parse_boolean",488,505
12,2,49,1,12,"parse_lbrace@512-524@usr.sbin/dhcpd/confpars.c","usr.sbin/dhcpd/confpars.c","parse_lbrace",512,524
52,10,338,2,58,"parse_host_declaration@531-589@usr.sbin/dhcpd/confpars.c","usr.sbin/dhcpd/confpars.c","parse_host_declaration",531,589
37,7,210,3,40,"parse_class_declaration@595-635@usr.sbin/dhcpd/confpars.c","usr.sbin/dhcpd/confpars.c","parse_class_declaration",595,635
64,11,361,2,70,"parse_shared_net_declaration@642-712@usr.sbin/dhcpd/confpars.c","usr.sbin/dhcpd/confpars.c","parse_shared_net_declaration",642,712
76,14,474,2,93,"parse_subnet_declaration@719-812@usr.sbin/dhcpd/confpars.c","usr.sbin/dhcpd/confpars.c","parse_subnet_declaration",719,812
25,5,135,2,27,"parse_group_declaration@818-845@usr.sbin/dhcpd/confpars.c","usr.sbin/dhcpd/confpars.c","parse_group_declaration",818,845
30,7,175,3,37,"parse_cidr@853-890@usr.sbin/dhcpd/confpars.c","usr.sbin/dhcpd/confpars.c","parse_cidr",853,890
41,11,230,2,44,"parse_ip_addr_or_hostname@901-945@usr.sbin/dhcpd/confpars.c","usr.sbin/dhcpd/confpars.c","parse_ip_addr_or_hostname",901,945
20,5,107,1,21,"parse_fixed_addr_param@954-975@usr.sbin/dhcpd/confpars.c","usr.sbin/dhcpd/confpars.c","parse_fixed_addr_param",954,975
214,55,1168,2,248,"parse_option_param@986-1234@usr.sbin/dhcpd/confpars.c","usr.sbin/dhcpd/confpars.c","parse_option_param",986,1234
148,33,721,1,170,"parse_lease_declaration@1254-1424@usr.sbin/dhcpd/confpars.c","usr.sbin/dhcpd/confpars.c","parse_lease_declaration",1254,1424
31,6,220,2,39,"parse_address_range@1431-1470@usr.sbin/dhcpd/confpars.c","usr.sbin/dhcpd/confpars.c","parse_address_range",1431,1470
6,1,33,1,6,"getULong@62-68@usr.sbin/dhcpd/convert.c","usr.sbin/dhcpd/convert.c","getULong",62,68
6,1,33,1,6,"getUShort@71-77@usr.sbin/dhcpd/convert.c","usr.sbin/dhcpd/convert.c","getUShort",71,77
5,1,33,2,5,"putULong@80-85@usr.sbin/dhcpd/convert.c","usr.sbin/dhcpd/convert.c","putULong",80,85
5,1,33,2,5,"putLong@88-93@usr.sbin/dhcpd/convert.c","usr.sbin/dhcpd/convert.c","putLong",88,93
5,1,34,2,5,"putUShort@96-101@usr.sbin/dhcpd/convert.c","usr.sbin/dhcpd/convert.c","putUShort",96,101
5,1,33,2,5,"putShort@104-109@usr.sbin/dhcpd/convert.c","usr.sbin/dhcpd/convert.c","putShort",104,109
72,30,504,1,85,"write_lease@72-157@usr.sbin/dhcpd/db.c","usr.sbin/dhcpd/db.c","write_lease",72,157
17,6,87,1,28,"commit_leases@163-191@usr.sbin/dhcpd/db.c","usr.sbin/dhcpd/db.c","commit_leases",163,191
12,3,68,1,16,"db_startup@194-210@usr.sbin/dhcpd/db.c","usr.sbin/dhcpd/db.c","db_startup",194,210
11,1,54,1,14,"new_lease_file@213-227@usr.sbin/dhcpd/db.c","usr.sbin/dhcpd/db.c","new_lease_file",213,227
29,10,114,2,35,"dhcp@66-101@usr.sbin/dhcpd/dhcp.c","usr.sbin/dhcpd/dhcp.c","dhcp",66,101
67,20,472,1,99,"dhcpdiscover@104-203@usr.sbin/dhcpd/dhcp.c","usr.sbin/dhcpd/dhcp.c","dhcpdiscover",104,203
82,34,583,1,174,"dhcprequest@206-380@usr.sbin/dhcpd/dhcp.c","usr.sbin/dhcpd/dhcp.c","dhcprequest",206,380
70,15,488,1,100,"dhcprelease@383-483@usr.sbin/dhcpd/dhcp.c","usr.sbin/dhcpd/dhcp.c","dhcprelease",383,483
23,6,153,1,30,"dhcpdecline@486-516@usr.sbin/dhcpd/dhcp.c","usr.sbin/dhcpd/dhcp.c","dhcpdecline",486,516
40,8,295,1,53,"dhcpinform@519-572@usr.sbin/dhcpd/dhcp.c","usr.sbin/dhcpd/dhcp.c","dhcpinform",519,572
96,8,857,2,126,"nak_lease@575-701@usr.sbin/dhcpd/dhcp.c","usr.sbin/dhcpd/dhcp.c","nak_lease",575,701
422,116,3767,4,572,"ack_lease@704-1276@usr.sbin/dhcpd/dhcp.c","usr.sbin/dhcpd/dhcp.c","ack_lease",704,1276
121,32,1009,1,184,"dhcp_reply@1279-1463@usr.sbin/dhcpd/dhcp.c","usr.sbin/dhcpd/dhcp.c","dhcp_reply",1279,1463
211,89,1267,3,298,"find_lease@1466-1764@usr.sbin/dhcpd/dhcp.c","usr.sbin/dhcpd/dhcp.c","find_lease",1466,1764
24,3,169,3,26,"mockup_lease@1772-1798@usr.sbin/dhcpd/dhcp.c","usr.sbin/dhcpd/dhcp.c","mockup_lease",1772,1798
153,50,852,2,181,"main@89-270@usr.sbin/dhcpd/dhcpd.c","usr.sbin/dhcpd/dhcpd.c","main",89,270
11,1,53,1,11,"usage@273-284@usr.sbin/dhcpd/dhcpd.c","usr.sbin/dhcpd/dhcpd.c","usage",273,284
29,6,154,3,47,"lease_pinged@287-334@usr.sbin/dhcpd/dhcpd.c","usr.sbin/dhcpd/dhcpd.c","lease_pinged",287,334
10,2,43,1,10,"lease_ping_timeout@337-347@usr.sbin/dhcpd/dhcpd.c","usr.sbin/dhcpd/dhcpd.c","lease_ping_timeout",337,347
24,11,207,1,30,"periodic_scan@355-385@usr.sbin/dhcpd/dhcpd.c","usr.sbin/dhcpd/dhcpd.c","periodic_scan",355,385
148,41,970,1,210,"discover_interfaces@87-297@usr.sbin/dhcpd/dispatch.c","usr.sbin/dhcpd/dispatch.c","discover_interfaces",87,297
73,27,475,1,97,"dispatch@305-402@usr.sbin/dhcpd/dispatch.c","usr.sbin/dhcpd/dispatch.c","dispatch",305,402
34,6,218,1,38,"got_one@406-444@usr.sbin/dhcpd/dispatch.c","usr.sbin/dhcpd/dispatch.c","got_one",406,444
44,9,261,1,55,"interface_status@447-502@usr.sbin/dhcpd/dispatch.c","usr.sbin/dhcpd/dispatch.c","interface_status",447,502
19,4,103,1,21,"locate_network@505-526@usr.sbin/dhcpd/dispatch.c","usr.sbin/dhcpd/dispatch.c","locate_network",505,526
44,12,254,3,57,"add_timeout@529-586@usr.sbin/dhcpd/dispatch.c","usr.sbin/dhcpd/dispatch.c","add_timeout",529,586
19,6,103,2,22,"cancel_timeout@589-611@usr.sbin/dhcpd/dispatch.c","usr.sbin/dhcpd/dispatch.c","cancel_timeout",589,611
13,2,80,4,13,"add_protocol@615-628@usr.sbin/dhcpd/dispatch.c","usr.sbin/dhcpd/dispatch.c","add_protocol",615,628
14,4,74,1,14,"remove_protocol@631-645@usr.sbin/dhcpd/dispatch.c","usr.sbin/dhcpd/dispatch.c","remove_protocol",631,645
13,3,103,1,15,"get_rdomain@648-663@usr.sbin/dhcpd/dispatch.c","usr.sbin/dhcpd/dispatch.c","get_rdomain",648,663
10,2,46,1,11,"new_hash@62-73@usr.sbin/dhcpd/hash.c","usr.sbin/dhcpd/hash.c","new_hash",62,73
12,3,73,3,14,"do_hash@76-90@usr.sbin/dhcpd/hash.c","usr.sbin/dhcpd/hash.c","do_hash",76,90
21,4,133,4,22,"add_hash@92-114@usr.sbin/dhcpd/hash.c","usr.sbin/dhcpd/hash.c","add_hash",92,114
23,9,171,3,29,"delete_hash_entry@117-146@usr.sbin/dhcpd/hash.c","usr.sbin/dhcpd/hash.c","delete_hash_entry",117,146
14,6,115,3,18,"hash_lookup@149-167@usr.sbin/dhcpd/hash.c","usr.sbin/dhcpd/hash.c","hash_lookup",149,167
18,5,135,2,26,"icmp_startup@67-93@usr.sbin/dhcpd/icmp.c","usr.sbin/dhcpd/icmp.c","icmp_startup",67,93
26,4,194,1,32,"icmp_echorequest@96-128@usr.sbin/dhcpd/icmp.c","usr.sbin/dhcpd/icmp.c","icmp_echorequest",96,128
30,5,227,1,37,"icmp_echoreply@131-168@usr.sbin/dhcpd/icmp.c","usr.sbin/dhcpd/icmp.c","icmp_echoreply",131,168
12,3,89,2,15,"subnet_number@65-80@usr.sbin/dhcpd/inet.c","usr.sbin/dhcpd/inet.c","subnet_number",65,80
28,6,211,3,35,"ip_addr@88-123@usr.sbin/dhcpd/inet.c","usr.sbin/dhcpd/inet.c","ip_addr",88,123
12,2,106,2,18,"host_addr@126-144@usr.sbin/dhcpd/inet.c","usr.sbin/dhcpd/inet.c","host_addr",126,144
6,2,47,2,5,"addr_eq@147-152@usr.sbin/dhcpd/inet.c","usr.sbin/dhcpd/inet.c","addr_eq",147,152
13,3,83,1,13,"piaddr@155-168@usr.sbin/dhcpd/inet.c","usr.sbin/dhcpd/inet.c","piaddr",155,168
10,2,48,2,12,"log_init@34-46@usr.sbin/dhcpd/log.c","usr.sbin/dhcpd/log.c","log_init",34,46
5,2,19,1,4,"log_procinit@49-53@usr.sbin/dhcpd/log.c","usr.sbin/dhcpd/log.c","log_procinit",49,53
4,1,11,1,3,"log_setverbose@56-59@usr.sbin/dhcpd/log.c","usr.sbin/dhcpd/log.c","log_setverbose",56,59
4,1,11,1,3,"log_getverbose@62-65@usr.sbin/dhcpd/log.c","usr.sbin/dhcpd/log.c","log_getverbose",62,65
7,1,38,3,7,"logit@68-75@usr.sbin/dhcpd/log.c","usr.sbin/dhcpd/log.c","logit",68,75
17,3,99,3,19,"vlog@78-97@usr.sbin/dhcpd/log.c","usr.sbin/dhcpd/log.c","vlog",78,97
21,3,120,2,25,"log_warn@100-125@usr.sbin/dhcpd/log.c","usr.sbin/dhcpd/log.c","log_warn",100,125
7,1,35,2,7,"log_warnx@128-135@usr.sbin/dhcpd/log.c","usr.sbin/dhcpd/log.c","log_warnx",128,135
7,1,35,2,7,"log_info@138-145@usr.sbin/dhcpd/log.c","usr.sbin/dhcpd/log.c","log_info",138,145
9,2,41,2,9,"log_debug@148-157@usr.sbin/dhcpd/log.c","usr.sbin/dhcpd/log.c","log_debug",148,157
17,3,106,3,17,"vfatalc@160-177@usr.sbin/dhcpd/log.c","usr.sbin/dhcpd/log.c","vfatalc",160,177
8,1,40,2,8,"fatal@180-188@usr.sbin/dhcpd/log.c","usr.sbin/dhcpd/log.c","fatal",180,188
8,1,40,2,8,"fatalx@191-199@usr.sbin/dhcpd/log.c","usr.sbin/dhcpd/log.c","fatalx",191,199
45,12,286,1,66,"enter_host@74-140@usr.sbin/dhcpd/memory.c","usr.sbin/dhcpd/memory.c","enter_host",74,140
5,1,30,3,4,"find_hosts_by_haddr@143-147@usr.sbin/dhcpd/memory.c","usr.sbin/dhcpd/memory.c","find_hosts_by_haddr",143,147
4,1,27,2,3,"find_hosts_by_uid@150-153@usr.sbin/dhcpd/memory.c","usr.sbin/dhcpd/memory.c","find_hosts_by_uid",150,153
23,6,144,3,23,"find_host_for_network@165-188@usr.sbin/dhcpd/memory.c","usr.sbin/dhcpd/memory.c","find_host_for_network",165,188
104,21,897,4,132,"new_address_range@191-323@usr.sbin/dhcpd/memory.c","usr.sbin/dhcpd/memory.c","new_address_range",191,323
9,3,53,1,9,"find_subnet@326-335@usr.sbin/dhcpd/memory.c","usr.sbin/dhcpd/memory.c","find_subnet",326,335
9,3,60,2,9,"find_grouped_subnet@338-347@usr.sbin/dhcpd/memory.c","usr.sbin/dhcpd/memory.c","find_grouped_subnet",338,347
24,9,213,3,24,"subnet_inner_than@350-374@usr.sbin/dhcpd/memory.c","usr.sbin/dhcpd/memory.c","subnet_inner_than",350,374
17,4,87,1,25,"enter_subnet@378-403@usr.sbin/dhcpd/memory.c","usr.sbin/dhcpd/memory.c","enter_subnet",378,403
5,1,19,1,5,"enter_shared_network@407-412@usr.sbin/dhcpd/memory.c","usr.sbin/dhcpd/memory.c","enter_shared_network",407,412
18,3,108,1,20,"enter_lease@422-442@usr.sbin/dhcpd/memory.c","usr.sbin/dhcpd/memory.c","enter_lease",422,442
5,3,52,2,4,"hwaddrcmp@445-449@usr.sbin/dhcpd/memory.c","usr.sbin/dhcpd/memory.c","hwaddrcmp",445,449
5,2,40,2,4,"uidcmp@452-456@usr.sbin/dhcpd/memory.c","usr.sbin/dhcpd/memory.c","uidcmp",452,456
6,3,46,2,5,"uid_or_hwaddr_cmp@459-464@usr.sbin/dhcpd/memory.c","usr.sbin/dhcpd/memory.c","uid_or_hwaddr_cmp",459,464
116,35,792,3,161,"supersede_lease@473-634@usr.sbin/dhcpd/memory.c","usr.sbin/dhcpd/memory.c","supersede_lease",473,634
12,2,63,1,12,"release_lease@639-651@usr.sbin/dhcpd/memory.c","usr.sbin/dhcpd/memory.c","release_lease",639,651
18,1,116,2,19,"abandon_lease@660-679@usr.sbin/dhcpd/memory.c","usr.sbin/dhcpd/memory.c","abandon_lease",660,679
5,1,27,1,4,"find_lease_by_ip_addr@683-687@usr.sbin/dhcpd/memory.c","usr.sbin/dhcpd/memory.c","find_lease_by_ip_addr",683,687
4,1,27,2,3,"find_lease_by_uid@689-692@usr.sbin/dhcpd/memory.c","usr.sbin/dhcpd/memory.c","find_lease_by_uid",689,692
4,1,27,2,3,"find_lease_by_hw_addr@695-698@usr.sbin/dhcpd/memory.c","usr.sbin/dhcpd/memory.c","find_lease_by_hw_addr",695,698
13,3,81,1,15,"uid_hash_add@702-717@usr.sbin/dhcpd/memory.c","usr.sbin/dhcpd/memory.c","uid_hash_add",702,717
24,6,149,1,32,"uid_hash_delete@721-753@usr.sbin/dhcpd/memory.c","usr.sbin/dhcpd/memory.c","uid_hash_delete",721,753
14,3,89,1,16,"hw_hash_add@757-773@usr.sbin/dhcpd/memory.c","usr.sbin/dhcpd/memory.c","hw_hash_add",757,773
27,6,161,1,37,"hw_hash_delete@777-814@usr.sbin/dhcpd/memory.c","usr.sbin/dhcpd/memory.c","hw_hash_delete",777,814
25,8,160,2,30,"add_class@818-848@usr.sbin/dhcpd/memory.c","usr.sbin/dhcpd/memory.c","add_class",818,848
5,2,34,3,4,"find_class@851-855@usr.sbin/dhcpd/memory.c","usr.sbin/dhcpd/memory.c","find_class",851,855
9,2,52,2,9,"clone_group@858-867@usr.sbin/dhcpd/memory.c","usr.sbin/dhcpd/memory.c","clone_group",858,867
18,9,106,1,18,"write_leases@872-890@usr.sbin/dhcpd/memory.c","usr.sbin/dhcpd/memory.c","write_leases",872,890
21,6,172,1,33,"parse_options@75-108@usr.sbin/dhcpd/options.c","usr.sbin/dhcpd/options.c","parse_options",75,108
65,10,415,3,94,"parse_option_buffer@116-210@usr.sbin/dhcpd/options.c","usr.sbin/dhcpd/options.c","parse_option_buffer",116,210
36,10,260,3,46,"create_priority_list@220-266@usr.sbin/dhcpd/options.c","usr.sbin/dhcpd/options.c","create_priority_list",220,266
59,19,411,9,91,"cons_options@273-364@usr.sbin/dhcpd/options.c","usr.sbin/dhcpd/options.c","cons_options",273,364
15,4,93,5,19,"store_option_fragment@371-390@usr.sbin/dhcpd/options.c","usr.sbin/dhcpd/options.c","store_option_fragment",371,390
86,30,551,6,129,"store_options@398-527@usr.sbin/dhcpd/options.c","usr.sbin/dhcpd/options.c","store_options",398,527
27,6,193,6,32,"do_packet@530-562@usr.sbin/dhcpd/options.c","usr.sbin/dhcpd/options.c","do_packet",530,562
15,5,103,3,23,"checksum@62-85@usr.sbin/dhcpd/packet.c","usr.sbin/dhcpd/packet.c","checksum",62,85
5,1,21,1,4,"wrapsum@88-92@usr.sbin/dhcpd/packet.c","usr.sbin/dhcpd/packet.c","wrapsum",88,92
13,3,119,4,17,"assemble_hw_header@95-112@usr.sbin/dhcpd/packet.c","usr.sbin/dhcpd/packet.c","assemble_hw_header",95,112
31,1,311,8,35,"assemble_udp_ip_header@115-150@usr.sbin/dhcpd/packet.c","usr.sbin/dhcpd/packet.c","assemble_udp_ip_header",115,150
11,2,92,3,14,"decode_hw_header@153-167@usr.sbin/dhcpd/packet.c","usr.sbin/dhcpd/packet.c","decode_hw_header",153,167
83,23,578,3,109,"decode_udp_ip_header@170-279@usr.sbin/dhcpd/packet.c","usr.sbin/dhcpd/packet.c","decode_udp_ip_header",170,279
26,9,142,1,32,"skip_to_semi@83-115@usr.sbin/dhcpd/parse.c","usr.sbin/dhcpd/parse.c","skip_to_semi",83,115
12,2,53,1,12,"parse_semi@118-130@usr.sbin/dhcpd/parse.c","usr.sbin/dhcpd/parse.c","parse_semi",118,130
19,4,96,1,20,"parse_string@136-156@usr.sbin/dhcpd/parse.c","usr.sbin/dhcpd/parse.c","parse_string",136,156
38,8,248,1,49,"parse_host_name@162-211@usr.sbin/dhcpd/parse.c","usr.sbin/dhcpd/parse.c","parse_host_name",162,211
40,7,228,2,51,"parse_hardware_param@218-269@usr.sbin/dhcpd/parse.c","usr.sbin/dhcpd/parse.c","parse_hardware_param",218,269
16,2,83,2,19,"parse_lease_time@275-294@usr.sbin/dhcpd/parse.c","usr.sbin/dhcpd/parse.c","parse_lease_time",275,294
65,19,393,6,74,"parse_numeric_aggregate@305-379@usr.sbin/dhcpd/parse.c","usr.sbin/dhcpd/parse.c","parse_numeric_aggregate",305,379
94,26,486,4,100,"convert_num@382-482@usr.sbin/dhcpd/parse.c","usr.sbin/dhcpd/parse.c","convert_num",382,482
50,14,270,1,56,"parse_date@493-549@usr.sbin/dhcpd/parse.c","usr.sbin/dhcpd/parse.c","parse_date",493,549
26,4,175,2,29,"parse_warn@554-583@usr.sbin/dhcpd/parse.c","usr.sbin/dhcpd/parse.c","parse_warn",554,583
54,19,416,0,84,"pftable_handler@49-133@usr.sbin/dhcpd/pfutils.c","usr.sbin/dhcpd/pfutils.c","pftable_handler",49,133
22,6,162,4,25,"pf_change_table@137-162@usr.sbin/dhcpd/pfutils.c","usr.sbin/dhcpd/pfutils.c","pf_change_table",137,162
24,3,255,2,29,"pf_kill_state@165-194@usr.sbin/dhcpd/pfutils.c","usr.sbin/dhcpd/pfutils.c","pf_kill_state",165,194
21,6,116,4,21,"atomicio@198-219@usr.sbin/dhcpd/pfutils.c","usr.sbin/dhcpd/pfutils.c","atomicio",198,219
19,6,94,2,24,"pfmsg@228-252@usr.sbin/dhcpd/pfutils.c","usr.sbin/dhcpd/pfutils.c","pfmsg",228,252
22,6,145,3,23,"print_hw_addr@58-81@usr.sbin/dhcpd/print.c","usr.sbin/dhcpd/print.c","print_hw_addr",58,81
41,9,291,2,45,"sync_addhost@67-112@usr.sbin/dhcpd/sync.c","usr.sbin/dhcpd/sync.c","sync_addhost",67,112
99,22,704,3,116,"sync_init@115-231@usr.sbin/dhcpd/sync.c","usr.sbin/dhcpd/sync.c","sync_init",115,231
97,21,709,1,116,"sync_recv@234-350@usr.sbin/dhcpd/sync.c","usr.sbin/dhcpd/sync.c","sync_recv",234,350
27,7,179,2,31,"sync_send@353-384@usr.sbin/dhcpd/sync.c","usr.sbin/dhcpd/sync.c","sync_send",353,384
58,2,543,1,71,"sync_lease@387-458@usr.sbin/dhcpd/sync.c","usr.sbin/dhcpd/sync.c","sync_lease",387,458
18,3,126,1,18,"initialize_universes@695-713@usr.sbin/dhcpd/tables.c","usr.sbin/dhcpd/tables.c","initialize_universes",695,713
10,2,49,2,10,"cons@64-74@usr.sbin/dhcpd/tree.c","usr.sbin/dhcpd/tree.c","cons",64,74
12,2,60,1,12,"tree_cache@77-89@usr.sbin/dhcpd/tree.c","usr.sbin/dhcpd/tree.c","tree_cache",77,89
14,3,95,2,17,"tree_const@92-109@usr.sbin/dhcpd/tree.c","usr.sbin/dhcpd/tree.c","tree_const",92,109
32,7,247,2,43,"tree_concat@112-155@usr.sbin/dhcpd/tree.c","usr.sbin/dhcpd/tree.c","tree_concat",112,155
18,4,109,2,21,"tree_limit@158-179@usr.sbin/dhcpd/tree.c","usr.sbin/dhcpd/tree.c","tree_limit",158,179
27,4,153,1,53,"tree_evaluate@182-235@usr.sbin/dhcpd/tree.c","usr.sbin/dhcpd/tree.c","tree_evaluate",182,235
31,5,187,4,34,"tree_evaluate_recurse@238-272@usr.sbin/dhcpd/tree.c","usr.sbin/dhcpd/tree.c","tree_evaluate_recurse",238,272
10,3,68,5,16,"do_data_copy@275-291@usr.sbin/dhcpd/tree.c","usr.sbin/dhcpd/tree.c","do_data_copy",275,291
25,5,206,1,31,"udpsock_startup@51-82@usr.sbin/dhcpd/udpsock.c","usr.sbin/dhcpd/udpsock.c","udpsock_startup",51,82
81,12,609,1,88,"udpsock_handler@85-173@usr.sbin/dhcpd/udpsock.c","usr.sbin/dhcpd/udpsock.c","udpsock_handler",85,173
7,1,60,6,6,"udpsock_send_packet@176-182@usr.sbin/dhcpd/udpsock.c","usr.sbin/dhcpd/udpsock.c","udpsock_send_packet",176,182
9,3,64,1,13,"if_register_bpf@70-83@usr.sbin/dhcrelay/bpf.c","usr.sbin/dhcrelay/bpf.c","if_register_bpf",70,83
4,1,17,1,7,"if_register_send@86-93@usr.sbin/dhcrelay/bpf.c","usr.sbin/dhcrelay/bpf.c","if_register_send",86,93
48,14,350,0,69,"if_register_receive@261-330@usr.sbin/dhcrelay/bpf.c","usr.sbin/dhcrelay/bpf.c","if_register_receive",261,330
30,5,239,0,36,"send_packet@333-369@usr.sbin/dhcrelay/bpf.c","usr.sbin/dhcrelay/bpf.c","send_packet",333,369
59,10,360,0,112,"receive_packet@372-484@usr.sbin/dhcrelay/bpf.c","usr.sbin/dhcrelay/bpf.c","receive_packet",372,484
4,1,19,1,3,"ss2sin@188-191@usr.sbin/dhcrelay/dhcpd.h","usr.sbin/dhcrelay/dhcpd.h","ss2sin",188,191
4,1,19,1,3,"ss2sin6@194-197@usr.sbin/dhcrelay/dhcpd.h","usr.sbin/dhcrelay/dhcpd.h","ss2sin6",194,197
179,56,1193,2,224,"main@98-322@usr.sbin/dhcrelay/dhcrelay.c","usr.sbin/dhcrelay/dhcrelay.c","main",98,322
75,15,520,4,111,"relay@325-436@usr.sbin/dhcrelay/dhcrelay.c","usr.sbin/dhcrelay/dhcrelay.c","relay",325,436
8,1,26,1,8,"usage@439-447@usr.sbin/dhcrelay/dhcrelay.c","usr.sbin/dhcrelay/dhcrelay.c","usage",439,447
25,7,138,1,28,"rdaemon@450-478@usr.sbin/dhcrelay/dhcrelay.c","usr.sbin/dhcrelay/dhcrelay.c","rdaemon",450,478
22,6,145,3,23,"print_hw_addr@481-504@usr.sbin/dhcrelay/dhcrelay.c","usr.sbin/dhcrelay/dhcrelay.c","print_hw_addr",481,504
36,8,286,1,49,"got_response@507-556@usr.sbin/dhcrelay/dhcrelay.c","usr.sbin/dhcrelay/dhcrelay.c","got_response",507,556
32,6,192,3,36,"relay_agentinfo@559-595@usr.sbin/dhcrelay/dhcrelay.c","usr.sbin/dhcrelay/dhcrelay.c","relay_agentinfo",559,595
29,9,192,3,36,"relay_agentinfo_cmp@598-634@usr.sbin/dhcrelay/dhcrelay.c","usr.sbin/dhcrelay/dhcrelay.c","relay_agentinfo_cmp",598,634
90,22,532,3,121,"relay_agentinfo_append@637-758@usr.sbin/dhcrelay/dhcrelay.c","usr.sbin/dhcrelay/dhcrelay.c","relay_agentinfo_append",637,758
64,13,385,3,85,"relay_agentinfo_remove@761-846@usr.sbin/dhcrelay/dhcrelay.c","usr.sbin/dhcrelay/dhcrelay.c","relay_agentinfo_remove",761,846
13,3,101,1,15,"get_rdomain@849-864@usr.sbin/dhcrelay/dhcrelay.c","usr.sbin/dhcrelay/dhcrelay.c","get_rdomain",849,864
44,10,287,4,59,"l2relay@867-926@usr.sbin/dhcrelay/dhcrelay.c","usr.sbin/dhcrelay/dhcrelay.c","l2relay",867,926
10,2,46,1,12,"iflist_getbyname@87-99@usr.sbin/dhcrelay/dispatch.c","usr.sbin/dhcrelay/dispatch.c","iflist_getbyname",87,99
79,19,649,1,106,"setup_iflist@102-208@usr.sbin/dhcrelay/dispatch.c","usr.sbin/dhcrelay/dispatch.c","setup_iflist",102,208
18,5,137,3,25,"register_interface@211-236@usr.sbin/dhcrelay/dispatch.c","usr.sbin/dhcrelay/dispatch.c","register_interface",211,236
67,21,417,1,94,"dispatch@245-339@usr.sbin/dhcrelay/dispatch.c","usr.sbin/dhcrelay/dispatch.c","dispatch",245,339
30,7,188,1,37,"got_one@343-380@usr.sbin/dhcrelay/dispatch.c","usr.sbin/dhcrelay/dispatch.c","got_one",343,380
45,9,263,1,55,"interface_status@383-438@usr.sbin/dhcrelay/dispatch.c","usr.sbin/dhcrelay/dispatch.c","interface_status",383,438
13,2,82,4,14,"add_protocol@442-456@usr.sbin/dhcrelay/dispatch.c","usr.sbin/dhcrelay/dispatch.c","add_protocol",442,456
15,4,76,1,15,"remove_protocol@459-474@usr.sbin/dhcrelay/dispatch.c","usr.sbin/dhcrelay/dispatch.c","remove_protocol",459,474
15,5,102,3,23,"checksum@67-90@usr.sbin/dhcrelay/packet.c","usr.sbin/dhcrelay/packet.c","checksum",67,90
5,1,21,1,4,"wrapsum@93-97@usr.sbin/dhcrelay/packet.c","usr.sbin/dhcrelay/packet.c","wrapsum",93,97
19,3,119,5,24,"assemble_hw_header@100-124@usr.sbin/dhcrelay/packet.c","usr.sbin/dhcrelay/packet.c","assemble_hw_header",100,124
33,2,362,6,39,"assemble_udp_ip_header@127-166@usr.sbin/dhcrelay/packet.c","usr.sbin/dhcrelay/packet.c","assemble_udp_ip_header",127,166
36,7,225,5,44,"decode_hw_header@169-213@usr.sbin/dhcrelay/packet.c","usr.sbin/dhcrelay/packet.c","decode_hw_header",169,213
91,23,696,4,117,"decode_udp_ip_header@216-333@usr.sbin/dhcrelay/packet.c","usr.sbin/dhcrelay/packet.c","decode_udp_ip_header",216,333
9,3,64,1,13,"if_register_bpf@73-86@usr.sbin/dhcrelay6/bpf.c","usr.sbin/dhcrelay6/bpf.c","if_register_bpf",73,86
4,1,17,1,7,"if_register_send@89-96@usr.sbin/dhcrelay6/bpf.c","usr.sbin/dhcrelay6/bpf.c","if_register_send",89,96
41,13,332,1,65,"if_register_receive@148-213@usr.sbin/dhcrelay6/bpf.c","usr.sbin/dhcrelay6/bpf.c","if_register_receive",148,213
44,4,330,4,53,"send_packet_layer3@216-269@usr.sbin/dhcrelay6/bpf.c","usr.sbin/dhcrelay6/bpf.c","send_packet_layer3",216,269
19,3,160,4,25,"send_packet@272-297@usr.sbin/dhcrelay6/bpf.c","usr.sbin/dhcrelay6/bpf.c","send_packet",272,297
59,10,359,4,111,"receive_packet@300-411@usr.sbin/dhcrelay6/bpf.c","usr.sbin/dhcrelay6/bpf.c","receive_packet",300,411
4,1,19,1,3,"ss2sin6@178-181@usr.sbin/dhcrelay6/dhcpd.h","usr.sbin/dhcrelay6/dhcpd.h","ss2sin6",178,181
9,1,27,1,9,"usage@119-128@usr.sbin/dhcrelay6/dhcrelay6.c","usr.sbin/dhcrelay6/dhcrelay6.c","usage",119,128
25,8,213,1,38,"parse_destination@131-169@usr.sbin/dhcrelay6/dhcrelay6.c","usr.sbin/dhcrelay6/dhcrelay6.c","parse_destination",131,169
93,29,510,2,107,"main@172-279@usr.sbin/dhcrelay6/dhcrelay6.c","usr.sbin/dhcrelay6/dhcrelay6.c","main",172,279
25,7,138,1,28,"rdaemon@282-310@usr.sbin/dhcrelay6/dhcrelay6.c","usr.sbin/dhcrelay6/dhcrelay6.c","rdaemon",282,310
21,3,144,4,24,"s6fromaddr@313-337@usr.sbin/dhcrelay6/dhcrelay6.c","usr.sbin/dhcrelay6/dhcrelay6.c","s6fromaddr",313,337
78,23,600,1,104,"relay6_setup@340-444@usr.sbin/dhcrelay6/dhcrelay6.c","usr.sbin/dhcrelay6/dhcrelay6.c","relay6_setup",340,444
22,6,145,3,23,"print_hw_addr@447-470@usr.sbin/dhcrelay6/dhcrelay6.c","usr.sbin/dhcrelay6/dhcrelay6.c","print_hw_addr",447,470
12,2,100,1,14,"v6addr2str@473-487@usr.sbin/dhcrelay6/dhcrelay6.c","usr.sbin/dhcrelay6/dhcrelay6.c","v6addr2str",473,487
33,14,96,1,32,"dhcp6type2str@490-522@usr.sbin/dhcrelay6/dhcrelay6.c","usr.sbin/dhcrelay6/dhcrelay6.c","dhcp6type2str",490,522
59,7,467,5,92,"relay6_pushrelaymsg@525-617@usr.sbin/dhcrelay6/dhcrelay6.c","usr.sbin/dhcrelay6/dhcrelay6.c","relay6_pushrelaymsg",525,617
81,14,520,4,118,"relay6_poprelaymsg@620-738@usr.sbin/dhcrelay6/dhcrelay6.c","usr.sbin/dhcrelay6/dhcrelay6.c","relay6_poprelaymsg",620,738
20,5,104,2,24,"rai_configure@741-765@usr.sbin/dhcrelay6/dhcrelay6.c","usr.sbin/dhcrelay6/dhcrelay6.c","rai_configure",741,765
16,3,106,3,16,"relay6_logsrcaddr@768-784@usr.sbin/dhcrelay6/dhcrelay6.c","usr.sbin/dhcrelay6/dhcrelay6.c","relay6_logsrcaddr",768,784
99,28,562,4,158,"relay6@787-945@usr.sbin/dhcrelay6/dhcrelay6.c","usr.sbin/dhcrelay6/dhcrelay6.c","relay6",787,945
64,10,436,1,80,"mcast6_recv@948-1028@usr.sbin/dhcrelay6/dhcrelay6.c","usr.sbin/dhcrelay6/dhcrelay6.c","mcast6_recv",948,1028
10,2,40,1,12,"iflist_getbyindex@87-99@usr.sbin/dhcrelay6/dispatch.c","usr.sbin/dhcrelay6/dispatch.c","iflist_getbyindex",87,99
10,2,46,1,12,"iflist_getbyname@102-114@usr.sbin/dhcrelay6/dispatch.c","usr.sbin/dhcrelay6/dispatch.c","iflist_getbyname",102,114
9,2,51,1,11,"iflist_getbyaddr6@117-128@usr.sbin/dhcrelay6/dispatch.c","usr.sbin/dhcrelay6/dispatch.c","iflist_getbyaddr6",117,128
74,17,618,1,100,"setup_iflist@131-231@usr.sbin/dhcrelay6/dispatch.c","usr.sbin/dhcrelay6/dispatch.c","setup_iflist",131,231
17,5,132,2,24,"register_interface@234-258@usr.sbin/dhcrelay6/dispatch.c","usr.sbin/dhcrelay6/dispatch.c","register_interface",234,258
67,21,417,1,94,"dispatch@267-361@usr.sbin/dhcrelay6/dispatch.c","usr.sbin/dhcrelay6/dispatch.c","dispatch",267,361
27,7,173,1,30,"got_one@365-395@usr.sbin/dhcrelay6/dispatch.c","usr.sbin/dhcrelay6/dispatch.c","got_one",365,395
45,9,263,1,55,"interface_status@398-453@usr.sbin/dhcrelay6/dispatch.c","usr.sbin/dhcrelay6/dispatch.c","interface_status",398,453
13,2,82,4,14,"add_protocol@457-471@usr.sbin/dhcrelay6/dispatch.c","usr.sbin/dhcrelay6/dispatch.c","add_protocol",457,471
15,4,76,1,15,"remove_protocol@474-489@usr.sbin/dhcrelay6/dispatch.c","usr.sbin/dhcrelay6/dispatch.c","remove_protocol",474,489
10,2,48,2,12,"log_init@34-46@usr.sbin/dhcrelay6/log.c","usr.sbin/dhcrelay6/log.c","log_init",34,46
5,2,19,1,4,"log_procinit@49-53@usr.sbin/dhcrelay6/log.c","usr.sbin/dhcrelay6/log.c","log_procinit",49,53
4,1,11,1,3,"log_setverbose@56-59@usr.sbin/dhcrelay6/log.c","usr.sbin/dhcrelay6/log.c","log_setverbose",56,59
4,1,11,1,3,"log_getverbose@62-65@usr.sbin/dhcrelay6/log.c","usr.sbin/dhcrelay6/log.c","log_getverbose",62,65
7,1,38,3,7,"logit@68-75@usr.sbin/dhcrelay6/log.c","usr.sbin/dhcrelay6/log.c","logit",68,75
17,3,99,3,19,"vlog@78-97@usr.sbin/dhcrelay6/log.c","usr.sbin/dhcrelay6/log.c","vlog",78,97
21,3,120,2,25,"log_warn@100-125@usr.sbin/dhcrelay6/log.c","usr.sbin/dhcrelay6/log.c","log_warn",100,125
7,1,35,2,7,"log_warnx@128-135@usr.sbin/dhcrelay6/log.c","usr.sbin/dhcrelay6/log.c","log_warnx",128,135
7,1,35,2,7,"log_info@138-145@usr.sbin/dhcrelay6/log.c","usr.sbin/dhcrelay6/log.c","log_info",138,145
9,2,41,2,9,"log_debug@148-157@usr.sbin/dhcrelay6/log.c","usr.sbin/dhcrelay6/log.c","log_debug",148,157
17,3,106,3,17,"vfatalc@160-177@usr.sbin/dhcrelay6/log.c","usr.sbin/dhcrelay6/log.c","vfatalc",160,177
8,1,40,2,8,"fatal@180-188@usr.sbin/dhcrelay6/log.c","usr.sbin/dhcrelay6/log.c","fatal",180,188
8,1,40,2,8,"fatalx@191-199@usr.sbin/dhcrelay6/log.c","usr.sbin/dhcrelay6/log.c","fatalx",191,199
15,5,103,3,23,"checksum@67-90@usr.sbin/dhcrelay6/packet.c","usr.sbin/dhcrelay6/packet.c","checksum",67,90
5,1,21,1,4,"wrapsum@93-97@usr.sbin/dhcrelay6/packet.c","usr.sbin/dhcrelay6/packet.c","wrapsum",93,97
9,1,79,3,10,"assemble_hw_header@100-110@usr.sbin/dhcrelay6/packet.c","usr.sbin/dhcrelay6/packet.c","assemble_hw_header",100,110
29,1,287,5,30,"assemble_udp_ip6_header@113-143@usr.sbin/dhcrelay6/packet.c","usr.sbin/dhcrelay6/packet.c","assemble_udp_ip6_header",113,143
11,1,91,3,13,"decode_hw_header@146-159@usr.sbin/dhcrelay6/packet.c","usr.sbin/dhcrelay6/packet.c","decode_hw_header",146,159
55,6,442,4,69,"decode_udp_ip6_header@162-231@usr.sbin/dhcrelay6/packet.c","usr.sbin/dhcrelay6/packet.c","decode_udp_ip6_header",162,231
6,1,25,1,6,"usage@65-71@usr.sbin/dvmrpctl/dvmrpctl.c","usr.sbin/dvmrpctl/dvmrpctl.c","usage",65,71
144,50,895,2,162,"main@74-236@usr.sbin/dvmrpctl/dvmrpctl.c","usr.sbin/dvmrpctl/dvmrpctl.c","main",74,236
17,3,78,1,18,"show_summary_msg@239-257@usr.sbin/dvmrpctl/dvmrpctl.c","usr.sbin/dvmrpctl/dvmrpctl.c","show_summary_msg",239,257
27,6,165,1,29,"show_interface_msg@260-289@usr.sbin/dvmrpctl/dvmrpctl.c","usr.sbin/dvmrpctl/dvmrpctl.c","show_interface_msg",260,289
45,7,267,1,47,"show_interface_detail_msg@292-339@usr.sbin/dvmrpctl/dvmrpctl.c","usr.sbin/dvmrpctl/dvmrpctl.c","show_interface_detail_msg",292,339
35,7,202,1,36,"show_igmp_msg@342-378@usr.sbin/dvmrpctl/dvmrpctl.c","usr.sbin/dvmrpctl/dvmrpctl.c","show_igmp_msg",342,378
11,3,37,1,10,"print_if_type@381-391@usr.sbin/dvmrpctl/dvmrpctl.c","usr.sbin/dvmrpctl/dvmrpctl.c","print_if_type",381,391
13,4,44,1,12,"print_nbr_state@394-406@usr.sbin/dvmrpctl/dvmrpctl.c","usr.sbin/dvmrpctl/dvmrpctl.c","print_nbr_state",394,406
7,2,24,1,6,"print_link@409-415@usr.sbin/dvmrpctl/dvmrpctl.c","usr.sbin/dvmrpctl/dvmrpctl.c","print_link",409,415
7,2,32,1,6,"fmt_timeframe@421-427@usr.sbin/dvmrpctl/dvmrpctl.c","usr.sbin/dvmrpctl/dvmrpctl.c","fmt_timeframe",421,427
29,5,179,1,34,"fmt_timeframe_core@430-464@usr.sbin/dvmrpctl/dvmrpctl.c","usr.sbin/dvmrpctl/dvmrpctl.c","fmt_timeframe_core",430,464
7,2,32,1,6,"mask2prefixlen@468-474@usr.sbin/dvmrpctl/dvmrpctl.c","usr.sbin/dvmrpctl/dvmrpctl.c","mask2prefixlen",468,474
20,3,106,1,21,"show_nbr_msg@477-498@usr.sbin/dvmrpctl/dvmrpctl.c","usr.sbin/dvmrpctl/dvmrpctl.c","show_nbr_msg",477,498
12,7,79,1,12,"print_dvmrp_options@501-513@usr.sbin/dvmrpctl/dvmrpctl.c","usr.sbin/dvmrpctl/dvmrpctl.c","print_dvmrp_options",501,513
15,3,57,1,16,"show_nbr_detail_msg@516-532@usr.sbin/dvmrpctl/dvmrpctl.c","usr.sbin/dvmrpctl/dvmrpctl.c","show_nbr_detail_msg",516,532
26,6,145,1,29,"show_rib_msg@535-564@usr.sbin/dvmrpctl/dvmrpctl.c","usr.sbin/dvmrpctl/dvmrpctl.c","show_rib_msg",535,564
13,3,46,1,14,"show_rib_detail_msg@567-581@usr.sbin/dvmrpctl/dvmrpctl.c","usr.sbin/dvmrpctl/dvmrpctl.c","show_rib_detail_msg",567,581
38,9,238,1,46,"show_mfc_msg@584-630@usr.sbin/dvmrpctl/dvmrpctl.c","usr.sbin/dvmrpctl/dvmrpctl.c","show_mfc_msg",584,630
13,3,46,1,14,"show_mfc_detail_msg@633-647@usr.sbin/dvmrpctl/dvmrpctl.c","usr.sbin/dvmrpctl/dvmrpctl.c","show_mfc_detail_msg",633,647
11,3,77,2,11,"get_linkstate@653-664@usr.sbin/dvmrpctl/dvmrpctl.c","usr.sbin/dvmrpctl/dvmrpctl.c","get_linkstate",653,664
24,6,150,2,30,"parse@114-144@usr.sbin/dvmrpctl/parser.c","usr.sbin/dvmrpctl/parser.c","parse",114,144
74,29,448,3,78,"match_token@147-225@usr.sbin/dvmrpctl/parser.c","usr.sbin/dvmrpctl/parser.c","match_token",147,225
25,9,117,1,25,"show_valid_args@228-253@usr.sbin/dvmrpctl/parser.c","usr.sbin/dvmrpctl/parser.c","show_valid_args",228,253
13,3,83,2,16,"parse_addr@256-272@usr.sbin/dvmrpctl/parser.c","usr.sbin/dvmrpctl/parser.c","parse_addr",256,272
21,4,155,3,24,"parse_prefix@275-299@usr.sbin/dvmrpctl/parser.c","usr.sbin/dvmrpctl/parser.c","parse_prefix",275,299
27,4,206,4,35,"send_ask_nbrs2@35-70@usr.sbin/dvmrpd/ask_nbrs2.c","usr.sbin/dvmrpd/ask_nbrs2.c","send_ask_nbrs2",35,70
5,1,30,3,5,"recv_ask_nbrs2@73-78@usr.sbin/dvmrpd/ask_nbrs2.c","usr.sbin/dvmrpd/ask_nbrs2.c","recv_ask_nbrs2",73,78
36,6,245,1,42,"control_init@43-85@usr.sbin/dvmrpd/control.c","usr.sbin/dvmrpd/control.c","control_init",43,85
12,2,78,1,14,"control_listen@88-102@usr.sbin/dvmrpd/control.c","usr.sbin/dvmrpd/control.c","control_listen",88,102
6,1,27,1,5,"control_cleanup@105-110@usr.sbin/dvmrpd/control.c","usr.sbin/dvmrpd/control.c","control_cleanup",105,110
34,9,268,3,43,"control_accept@114-157@usr.sbin/dvmrpd/control.c","usr.sbin/dvmrpd/control.c","control_accept",114,157
9,2,42,1,10,"control_connbyfd@160-170@usr.sbin/dvmrpd/control.c","usr.sbin/dvmrpd/control.c","control_connbyfd",160,170
9,2,42,1,10,"control_connbypid@173-183@usr.sbin/dvmrpd/control.c","usr.sbin/dvmrpd/control.c","control_connbypid",173,183
17,3,116,1,22,"control_close@186-208@usr.sbin/dvmrpd/control.c","usr.sbin/dvmrpd/control.c","control_close",186,208
85,25,544,3,93,"control_dispatch_imsg@212-305@usr.sbin/dvmrpd/control.c","usr.sbin/dvmrpd/control.c","control_dispatch_imsg",212,305
8,2,76,1,9,"control_imsg_relay@308-317@usr.sbin/dvmrpd/control.c","usr.sbin/dvmrpd/control.c","control_imsg_relay",308,317
12,4,42,3,16,"main_sig_handler@72-88@usr.sbin/dvmrpd/dvmrpd.c","usr.sbin/dvmrpd/dvmrpd.c","main_sig_handler",72,88
6,1,25,1,6,"usage@91-97@usr.sbin/dvmrpd/dvmrpd.c","usr.sbin/dvmrpd/dvmrpd.c","usage",91,97
126,25,862,2,168,"main@100-268@usr.sbin/dvmrpd/dvmrpd.c","usr.sbin/dvmrpd/dvmrpd.c","main",100,268
32,9,199,1,37,"dvmrpd_shutdown@271-308@usr.sbin/dvmrpd/dvmrpd.c","usr.sbin/dvmrpd/dvmrpd.c","dvmrpd_shutdown",271,308
52,17,278,3,58,"main_dispatch_dvmrpe@312-370@usr.sbin/dvmrpd/dvmrpd.c","usr.sbin/dvmrpd/dvmrpd.c","main_dispatch_dvmrpe",312,370
52,17,326,3,60,"main_dispatch_rde@373-433@usr.sbin/dvmrpd/dvmrpd.c","usr.sbin/dvmrpd/dvmrpd.c","main_dispatch_rde",373,433
4,1,35,4,3,"main_imsg_compose_dvmrpe@436-439@usr.sbin/dvmrpd/dvmrpd.c","usr.sbin/dvmrpd/dvmrpd.c","main_imsg_compose_dvmrpe",436,439
4,1,35,4,3,"main_imsg_compose_rde@442-445@usr.sbin/dvmrpd/dvmrpd.c","usr.sbin/dvmrpd/dvmrpd.c","main_imsg_compose_rde",442,445
9,2,73,1,9,"imsg_event_add@448-457@usr.sbin/dvmrpd/dvmrpd.c","usr.sbin/dvmrpd/dvmrpd.c","imsg_event_add",448,457
9,2,70,7,9,"imsg_compose_event@460-469@usr.sbin/dvmrpd/dvmrpd.c","usr.sbin/dvmrpd/dvmrpd.c","imsg_compose_event",460,469
10,3,37,3,10,"dvmrpe_sig_handler@55-65@usr.sbin/dvmrpd/dvmrpe.c","usr.sbin/dvmrpd/dvmrpe.c","dvmrpe_sig_handler",55,65
88,18,673,4,123,"dvmrpe@69-192@usr.sbin/dvmrpd/dvmrpe.c","usr.sbin/dvmrpd/dvmrpe.c","dvmrpe",69,192
22,2,132,1,28,"dvmrpe_shutdown@195-223@usr.sbin/dvmrpd/dvmrpe.c","usr.sbin/dvmrpd/dvmrpe.c","dvmrpe_shutdown",195,223
4,1,38,4,3,"dvmrpe_imsg_compose_parent@226-229@usr.sbin/dvmrpd/dvmrpe.c","usr.sbin/dvmrpd/dvmrpe.c","dvmrpe_imsg_compose_parent",226,229
6,1,41,5,5,"dvmrpe_imsg_compose_rde@232-237@usr.sbin/dvmrpd/dvmrpe.c","usr.sbin/dvmrpd/dvmrpe.c","dvmrpe_imsg_compose_rde",232,237
64,18,366,3,69,"dvmrpe_dispatch_main@240-309@usr.sbin/dvmrpd/dvmrpe.c","usr.sbin/dvmrpd/dvmrpe.c","dvmrpe_dispatch_main",240,309
123,38,797,3,152,"dvmrpe_dispatch_rde@312-464@usr.sbin/dvmrpd/dvmrpe.c","usr.sbin/dvmrpd/dvmrpe.c","dvmrpe_dispatch_rde",312,464
11,3,80,2,11,"dvmrpe_iface_ctl@467-478@usr.sbin/dvmrpd/dvmrpe.c","usr.sbin/dvmrpd/dvmrpe.c","dvmrpe_iface_ctl",467,478
12,3,87,2,13,"dvmrpe_iface_igmp_ctl@481-494@usr.sbin/dvmrpd/dvmrpe.c","usr.sbin/dvmrpd/dvmrpe.c","dvmrpe_iface_igmp_ctl",481,494
13,1,101,1,14,"dvmrpe_nbr_ctl@497-511@usr.sbin/dvmrpd/dvmrpe.c","usr.sbin/dvmrpd/dvmrpe.c","dvmrpe_nbr_ctl",497,511
27,4,206,4,35,"send_graft@35-70@usr.sbin/dvmrpd/graft.c","usr.sbin/dvmrpd/graft.c","send_graft",35,70
5,1,30,3,5,"recv_graft@73-78@usr.sbin/dvmrpd/graft.c","usr.sbin/dvmrpd/graft.c","recv_graft",73,78
27,4,206,4,35,"send_graft_ack@35-70@usr.sbin/dvmrpd/graft_ack.c","usr.sbin/dvmrpd/graft_ack.c","send_graft_ack",35,70
5,1,30,3,5,"recv_graft_ack@73-78@usr.sbin/dvmrpd/graft_ack.c","usr.sbin/dvmrpd/graft_ack.c","recv_graft_ack",73,78
76,19,471,2,85,"group_fsm@143-228@usr.sbin/dvmrpd/group.c","usr.sbin/dvmrpd/group.c","group_fsm",143,228
6,1,40,3,7,"dead_timer@232-239@usr.sbin/dvmrpd/group.c","usr.sbin/dvmrpd/group.c","dead_timer",232,239
9,1,71,1,12,"start_dead_timer@242-254@usr.sbin/dvmrpd/group.c","usr.sbin/dvmrpd/group.c","start_dead_timer",242,254
14,2,92,1,19,"start_dead_timer_all@257-276@usr.sbin/dvmrpd/group.c","usr.sbin/dvmrpd/group.c","start_dead_timer_all",257,276
5,1,32,1,5,"stop_dead_timer@279-284@usr.sbin/dvmrpd/group.c","usr.sbin/dvmrpd/group.c","stop_dead_timer",279,284
6,1,40,3,7,"v1_host_timer@287-294@usr.sbin/dvmrpd/group.c","usr.sbin/dvmrpd/group.c","v1_host_timer",287,294
9,1,71,1,12,"start_v1_host_timer@297-309@usr.sbin/dvmrpd/group.c","usr.sbin/dvmrpd/group.c","start_v1_host_timer",297,309
5,1,32,1,5,"stop_v1_host_timer@312-317@usr.sbin/dvmrpd/group.c","usr.sbin/dvmrpd/group.c","stop_v1_host_timer",312,317
12,2,83,3,15,"retrans_timer@320-335@usr.sbin/dvmrpd/group.c","usr.sbin/dvmrpd/group.c","retrans_timer",320,335
8,1,55,1,10,"start_retrans_timer@338-348@usr.sbin/dvmrpd/group.c","usr.sbin/dvmrpd/group.c","start_retrans_timer",338,348
5,1,32,1,5,"stop_retrans_timer@351-356@usr.sbin/dvmrpd/group.c","usr.sbin/dvmrpd/group.c","stop_retrans_timer",351,356
25,4,193,2,34,"group_list_add@360-394@usr.sbin/dvmrpd/group.c","usr.sbin/dvmrpd/group.c","group_list_add",360,394
11,1,67,2,13,"group_list_remove@397-410@usr.sbin/dvmrpd/group.c","usr.sbin/dvmrpd/group.c","group_list_remove",397,410
11,3,68,2,14,"group_list_find@413-427@usr.sbin/dvmrpd/group.c","usr.sbin/dvmrpd/group.c","group_list_find",413,427
9,2,55,1,9,"group_list_clr@430-439@usr.sbin/dvmrpd/group.c","usr.sbin/dvmrpd/group.c","group_list_clr",430,439
4,1,20,1,3,"group_list_empty@442-445@usr.sbin/dvmrpd/group.c","usr.sbin/dvmrpd/group.c","group_list_empty",442,445
10,1,69,2,10,"group_list_dump@448-458@usr.sbin/dvmrpd/group.c","usr.sbin/dvmrpd/group.c","group_list_dump",448,458
4,1,15,1,3,"group_event_name@462-465@usr.sbin/dvmrpd/group.c","usr.sbin/dvmrpd/group.c","group_event_name",462,465
4,1,15,1,3,"group_action_name@468-471@usr.sbin/dvmrpd/group.c","usr.sbin/dvmrpd/group.c","group_action_name",468,471
18,3,135,1,22,"group_to_ctl@474-496@usr.sbin/dvmrpd/group.c","usr.sbin/dvmrpd/group.c","group_to_ctl",474,496
37,6,247,2,51,"send_igmp_query@38-89@usr.sbin/dvmrpd/igmp.c","usr.sbin/dvmrpd/igmp.c","send_igmp_query",38,89
34,9,207,4,44,"recv_igmp_query@92-136@usr.sbin/dvmrpd/igmp.c","usr.sbin/dvmrpd/igmp.c","recv_igmp_query",92,136
39,8,202,5,49,"recv_igmp_report@139-188@usr.sbin/dvmrpd/igmp.c","usr.sbin/dvmrpd/igmp.c","recv_igmp_report",139,188
28,6,159,4,36,"recv_igmp_leave@191-227@usr.sbin/dvmrpd/igmp.c","usr.sbin/dvmrpd/igmp.c","recv_igmp_leave",191,227
9,2,50,1,11,"igmp_chksum@230-241@usr.sbin/dvmrpd/igmp.c","usr.sbin/dvmrpd/igmp.c","igmp_chksum",230,241
28,6,172,2,31,"in_cksum@51-82@usr.sbin/dvmrpd/in_cksum.c","usr.sbin/dvmrpd/in_cksum.c","in_cksum",51,82
45,11,267,2,54,"if_fsm@92-146@usr.sbin/dvmrpd/interface.c","usr.sbin/dvmrpd/interface.c","if_fsm",92,146
9,2,43,1,10,"if_find_index@149-159@usr.sbin/dvmrpd/interface.c","usr.sbin/dvmrpd/interface.c","if_find_index",149,159
48,11,417,1,65,"if_new@162-227@usr.sbin/dvmrpd/interface.c","usr.sbin/dvmrpd/interface.c","if_new",162,227
10,1,74,2,12,"if_init@230-242@usr.sbin/dvmrpd/interface.c","usr.sbin/dvmrpd/interface.c","if_init",230,242
10,2,57,1,12,"if_del@245-257@usr.sbin/dvmrpd/interface.c","usr.sbin/dvmrpd/interface.c","if_del",245,257
4,1,20,1,3,"if_nbr_list_empty@260-263@usr.sbin/dvmrpd/interface.c","usr.sbin/dvmrpd/interface.c","if_nbr_list_empty",260,263
11,2,64,3,13,"if_probe_timer@267-280@usr.sbin/dvmrpd/interface.c","usr.sbin/dvmrpd/interface.c","if_probe_timer",267,280
6,1,33,1,6,"if_start_probe_timer@283-289@usr.sbin/dvmrpd/interface.c","usr.sbin/dvmrpd/interface.c","if_start_probe_timer",283,289
4,1,20,1,3,"if_stop_probe_timer@292-295@usr.sbin/dvmrpd/interface.c","usr.sbin/dvmrpd/interface.c","if_stop_probe_timer",292,295
15,3,90,3,19,"if_query_timer@298-317@usr.sbin/dvmrpd/interface.c","usr.sbin/dvmrpd/interface.c","if_query_timer",298,317
6,1,33,1,6,"if_start_query_timer@320-326@usr.sbin/dvmrpd/interface.c","usr.sbin/dvmrpd/interface.c","if_start_query_timer",320,326
4,1,20,1,3,"if_stop_query_timer@329-332@usr.sbin/dvmrpd/interface.c","usr.sbin/dvmrpd/interface.c","if_stop_query_timer",329,332
5,1,28,3,5,"if_querier_present_timer@335-340@usr.sbin/dvmrpd/interface.c","usr.sbin/dvmrpd/interface.c","if_querier_present_timer",335,340
8,1,53,1,10,"if_start_querier_present_timer@343-353@usr.sbin/dvmrpd/interface.c","usr.sbin/dvmrpd/interface.c","if_start_querier_present_timer",343,353
4,1,20,1,3,"if_stop_querier_present_timer@356-359@usr.sbin/dvmrpd/interface.c","usr.sbin/dvmrpd/interface.c","if_stop_querier_present_timer",356,359
8,1,53,1,10,"if_reset_querier_present_timer@362-372@usr.sbin/dvmrpd/interface.c","usr.sbin/dvmrpd/interface.c","if_reset_querier_present_timer",362,372
47,9,267,1,52,"if_act_start@376-428@usr.sbin/dvmrpd/interface.c","usr.sbin/dvmrpd/interface.c","if_act_start",376,428
15,3,62,1,16,"if_act_query_seen@431-447@usr.sbin/dvmrpd/interface.c","usr.sbin/dvmrpd/interface.c","if_act_query_seen",431,447
42,7,231,1,47,"if_act_reset@450-497@usr.sbin/dvmrpd/interface.c","usr.sbin/dvmrpd/interface.c","if_act_reset",450,497
4,1,15,1,3,"if_event_name@500-503@usr.sbin/dvmrpd/interface.c","usr.sbin/dvmrpd/interface.c","if_event_name",500,503
4,1,15,1,3,"if_action_name@506-509@usr.sbin/dvmrpd/interface.c","usr.sbin/dvmrpd/interface.c","if_action_name",506,509
10,2,56,2,10,"if_set_mcast_ttl@513-523@usr.sbin/dvmrpd/interface.c","usr.sbin/dvmrpd/interface.c","if_set_mcast_ttl",513,523
9,2,55,2,9,"if_set_tos@526-535@usr.sbin/dvmrpd/interface.c","usr.sbin/dvmrpd/interface.c","if_set_tos",526,535
8,2,40,1,8,"if_set_recvbuf@538-546@usr.sbin/dvmrpd/interface.c","usr.sbin/dvmrpd/interface.c","if_set_recvbuf",538,546
20,4,113,2,22,"if_join_group@549-571@usr.sbin/dvmrpd/interface.c","usr.sbin/dvmrpd/interface.c","if_join_group",549,571
20,4,113,2,22,"if_leave_group@574-596@usr.sbin/dvmrpd/interface.c","usr.sbin/dvmrpd/interface.c","if_leave_group",574,596
18,4,90,1,18,"if_set_mcast@599-617@usr.sbin/dvmrpd/interface.c","usr.sbin/dvmrpd/interface.c","if_set_mcast",599,617
10,2,55,1,11,"if_set_mcast_loop@620-631@usr.sbin/dvmrpd/interface.c","usr.sbin/dvmrpd/interface.c","if_set_mcast_loop",620,631
60,5,512,1,68,"if_to_ctl@634-702@usr.sbin/dvmrpd/interface.c","usr.sbin/dvmrpd/interface.c","if_to_ctl",634,702
18,2,138,1,22,"kmr_init@42-64@usr.sbin/dvmrpd/kmroute.c","usr.sbin/dvmrpd/kmroute.c","kmr_init",42,64
11,1,55,1,14,"kmr_shutdown@67-81@usr.sbin/dvmrpd/kmroute.c","usr.sbin/dvmrpd/kmroute.c","kmr_shutdown",67,81
36,11,203,3,46,"kmr_recv_msg@84-130@usr.sbin/dvmrpd/kmroute.c","usr.sbin/dvmrpd/kmroute.c","kmr_recv_msg",84,130
4,1,11,1,3,"kmr_mfc_couple@133-136@usr.sbin/dvmrpd/kmroute.c","usr.sbin/dvmrpd/kmroute.c","kmr_mfc_couple",133,136
4,1,11,1,3,"kmr_mfc_decouple@139-142@usr.sbin/dvmrpd/kmroute.c","usr.sbin/dvmrpd/kmroute.c","kmr_mfc_decouple",139,142
3,1,6,1,3,"kmroute_clear@145-148@usr.sbin/dvmrpd/kmroute.c","usr.sbin/dvmrpd/kmroute.c","kmroute_clear",145,148
10,2,51,1,11,"mrt_init@151-162@usr.sbin/dvmrpd/kmroute.c","usr.sbin/dvmrpd/kmroute.c","mrt_init",151,162
10,2,51,1,11,"mrt_done@165-176@usr.sbin/dvmrpd/kmroute.c","usr.sbin/dvmrpd/kmroute.c","mrt_done",165,176
16,2,101,2,18,"mrt_add_vif@179-197@usr.sbin/dvmrpd/kmroute.c","usr.sbin/dvmrpd/kmroute.c","mrt_add_vif",179,197
8,2,47,2,9,"mrt_del_vif@200-209@usr.sbin/dvmrpd/kmroute.c","usr.sbin/dvmrpd/kmroute.c","mrt_del_vif",200,209
20,3,138,2,24,"mrt_add_mfc@212-236@usr.sbin/dvmrpd/kmroute.c","usr.sbin/dvmrpd/kmroute.c","mrt_add_mfc",212,236
14,2,90,2,17,"mrt_del_mfc@239-256@usr.sbin/dvmrpd/kmroute.c","usr.sbin/dvmrpd/kmroute.c","mrt_del_mfc",239,256
7,2,32,1,8,"kif_init@72-80@usr.sbin/dvmrpd/kroute.c","usr.sbin/dvmrpd/kroute.c","kif_init",72,80
17,3,120,1,22,"kr_init@83-105@usr.sbin/dvmrpd/kroute.c","usr.sbin/dvmrpd/kroute.c","kr_init",83,105
5,1,23,1,4,"kr_shutdown@108-112@usr.sbin/dvmrpd/kroute.c","usr.sbin/dvmrpd/kroute.c","kr_shutdown",108,112
10,2,59,1,10,"kr_ifinfo@115-125@usr.sbin/dvmrpd/kroute.c","usr.sbin/dvmrpd/kroute.c","kr_ifinfo",115,125
4,1,29,2,3,"kif_compare@129-132@usr.sbin/dvmrpd/kroute.c","usr.sbin/dvmrpd/kroute.c","kif_compare",129,132
7,1,46,1,8,"kif_find@135-143@usr.sbin/dvmrpd/kroute.c","usr.sbin/dvmrpd/kroute.c","kif_find",135,143
8,2,49,1,9,"kif_findname@146-155@usr.sbin/dvmrpd/kroute.c","usr.sbin/dvmrpd/kroute.c","kif_findname",146,155
9,2,46,1,9,"kif_insert@158-167@usr.sbin/dvmrpd/kroute.c","usr.sbin/dvmrpd/kroute.c","kif_insert",158,167
9,2,46,1,9,"kif_remove@170-179@usr.sbin/dvmrpd/kroute.c","usr.sbin/dvmrpd/kroute.c","kif_remove",170,179
6,2,32,1,6,"kif_clear@182-188@usr.sbin/dvmrpd/kroute.c","usr.sbin/dvmrpd/kroute.c","kif_clear",182,188
13,5,60,1,14,"prefixlen_classful@192-206@usr.sbin/dvmrpd/kroute.c","usr.sbin/dvmrpd/kroute.c","prefixlen_classful",192,206
7,2,32,1,6,"mask2prefixlen@209-215@usr.sbin/dvmrpd/kroute.c","usr.sbin/dvmrpd/kroute.c","mask2prefixlen",209,215
6,2,30,1,6,"prefixlen2mask@218-224@usr.sbin/dvmrpd/kroute.c","usr.sbin/dvmrpd/kroute.c","prefixlen2mask",218,224
19,4,139,3,22,"if_change@227-249@usr.sbin/dvmrpd/kroute.c","usr.sbin/dvmrpd/kroute.c","if_change",227,249
21,4,119,1,23,"if_announce@252-275@usr.sbin/dvmrpd/kroute.c","usr.sbin/dvmrpd/kroute.c","if_announce",252,275
12,3,87,3,12,"get_rtaddrs@282-294@usr.sbin/dvmrpd/kroute.c","usr.sbin/dvmrpd/kroute.c","get_rtaddrs",282,294
65,13,518,1,72,"fetchifs@297-369@usr.sbin/dvmrpd/kroute.c","usr.sbin/dvmrpd/kroute.c","fetchifs",297,369
36,11,214,3,40,"kr_dispatch_msg@372-412@usr.sbin/dvmrpd/kroute.c","usr.sbin/dvmrpd/kroute.c","kr_dispatch_msg",372,412
8,2,36,1,10,"log_init@37-47@usr.sbin/dvmrpd/log.c","usr.sbin/dvmrpd/log.c","log_init",37,47
4,1,11,1,3,"log_verbose@50-53@usr.sbin/dvmrpd/log.c","usr.sbin/dvmrpd/log.c","log_verbose",50,53
7,1,38,3,7,"logit@56-63@usr.sbin/dvmrpd/log.c","usr.sbin/dvmrpd/log.c","logit",56,63
15,3,90,3,16,"vlog@66-82@usr.sbin/dvmrpd/log.c","usr.sbin/dvmrpd/log.c","vlog",66,82
18,3,111,2,21,"log_warn@85-106@usr.sbin/dvmrpd/log.c","usr.sbin/dvmrpd/log.c","log_warn",85,106
7,1,35,2,7,"log_warnx@109-116@usr.sbin/dvmrpd/log.c","usr.sbin/dvmrpd/log.c","log_warnx",109,116
7,1,35,2,7,"log_info@119-126@usr.sbin/dvmrpd/log.c","usr.sbin/dvmrpd/log.c","log_info",119,126
9,2,41,2,9,"log_debug@129-138@usr.sbin/dvmrpd/log.c","usr.sbin/dvmrpd/log.c","log_debug",129,138
17,4,79,1,17,"fatal@141-158@usr.sbin/dvmrpd/log.c","usr.sbin/dvmrpd/log.c","fatal",141,158
5,1,18,1,4,"fatalx@161-165@usr.sbin/dvmrpd/log.c","usr.sbin/dvmrpd/log.c","fatalx",161,165
13,4,44,1,12,"nbr_state_name@33-45@usr.sbin/dvmrpd/logmsg.c","usr.sbin/dvmrpd/logmsg.c","nbr_state_name",33,45
13,4,44,1,12,"if_state_name@48-60@usr.sbin/dvmrpd/logmsg.c","usr.sbin/dvmrpd/logmsg.c","if_state_name",48,60
15,5,52,1,14,"group_state_name@63-77@usr.sbin/dvmrpd/logmsg.c","usr.sbin/dvmrpd/logmsg.c","group_state_name",63,77
10,3,35,1,10,"if_type_name@80-90@usr.sbin/dvmrpd/logmsg.c","usr.sbin/dvmrpd/logmsg.c","if_type_name",80,90
27,4,206,4,35,"send_nbrs2@36-71@usr.sbin/dvmrpd/nbrs2.c","usr.sbin/dvmrpd/nbrs2.c","send_nbrs2",36,71
5,1,30,3,5,"recv_nbrs2@74-79@usr.sbin/dvmrpd/nbrs2.c","usr.sbin/dvmrpd/nbrs2.c","recv_nbrs2",74,79
64,17,360,2,77,"nbr_fsm@90-167@usr.sbin/dvmrpd/neighbor.c","usr.sbin/dvmrpd/neighbor.c","nbr_fsm",90,167
12,4,88,1,14,"nbr_init@170-184@usr.sbin/dvmrpd/neighbor.c","usr.sbin/dvmrpd/neighbor.c","nbr_init",170,184
21,3,157,3,31,"nbr_new@187-218@usr.sbin/dvmrpd/neighbor.c","usr.sbin/dvmrpd/neighbor.c","nbr_new",187,218
8,1,41,1,11,"nbr_del@221-232@usr.sbin/dvmrpd/neighbor.c","usr.sbin/dvmrpd/neighbor.c","nbr_del",221,232
11,2,52,1,13,"nbr_find_peerid@235-248@usr.sbin/dvmrpd/neighbor.c","usr.sbin/dvmrpd/neighbor.c","nbr_find_peerid",235,248
10,2,54,2,11,"nbr_find_ip@251-262@usr.sbin/dvmrpd/neighbor.c","usr.sbin/dvmrpd/neighbor.c","nbr_find_ip",251,262
6,1,40,3,7,"nbr_itimer@266-273@usr.sbin/dvmrpd/neighbor.c","usr.sbin/dvmrpd/neighbor.c","nbr_itimer",266,273
8,1,55,1,10,"nbr_start_itimer@276-286@usr.sbin/dvmrpd/neighbor.c","usr.sbin/dvmrpd/neighbor.c","nbr_start_itimer",276,286
4,1,20,1,3,"nbr_stop_itimer@289-292@usr.sbin/dvmrpd/neighbor.c","usr.sbin/dvmrpd/neighbor.c","nbr_stop_itimer",289,292
7,1,43,1,8,"nbr_reset_itimer@295-303@usr.sbin/dvmrpd/neighbor.c","usr.sbin/dvmrpd/neighbor.c","nbr_reset_itimer",295,303
5,1,27,1,5,"nbr_act_start@307-312@usr.sbin/dvmrpd/neighbor.c","usr.sbin/dvmrpd/neighbor.c","nbr_act_start",307,312
9,2,42,1,9,"nbr_act_reset_itimer@315-324@usr.sbin/dvmrpd/neighbor.c","usr.sbin/dvmrpd/neighbor.c","nbr_act_reset_itimer",315,324
16,3,79,1,19,"nbr_act_start_itimer@327-346@usr.sbin/dvmrpd/neighbor.c","usr.sbin/dvmrpd/neighbor.c","nbr_act_start_itimer",327,346
14,2,100,1,19,"nbr_act_delete@349-368@usr.sbin/dvmrpd/neighbor.c","usr.sbin/dvmrpd/neighbor.c","nbr_act_delete",349,368
6,1,34,1,6,"nbr_act_clear_lists@371-377@usr.sbin/dvmrpd/neighbor.c","usr.sbin/dvmrpd/neighbor.c","nbr_act_clear_lists",371,377
4,1,15,1,3,"nbr_event_name@381-384@usr.sbin/dvmrpd/neighbor.c","usr.sbin/dvmrpd/neighbor.c","nbr_event_name",381,384
4,1,15,1,3,"nbr_action_name@387-390@usr.sbin/dvmrpd/neighbor.c","usr.sbin/dvmrpd/neighbor.c","nbr_action_name",387,390
20,3,175,1,24,"nbr_to_ctl@393-417@usr.sbin/dvmrpd/neighbor.c","usr.sbin/dvmrpd/neighbor.c","nbr_to_ctl",393,417
12,1,86,3,13,"gen_dvmrp_hdr@47-60@usr.sbin/dvmrpd/packet.c","usr.sbin/dvmrpd/packet.c","gen_dvmrp_hdr",47,60
21,5,140,4,24,"send_packet@64-88@usr.sbin/dvmrpd/packet.c","usr.sbin/dvmrpd/packet.c","send_packet",64,88
115,29,677,3,141,"recv_packet@91-232@usr.sbin/dvmrpd/packet.c","usr.sbin/dvmrpd/packet.c","recv_packet",91,232
11,3,67,2,13,"ip_hdr_sanity_check@235-248@usr.sbin/dvmrpd/packet.c","usr.sbin/dvmrpd/packet.c","ip_hdr_sanity_check",235,248
9,2,50,4,14,"dvmrp_hdr_sanity_check@251-265@usr.sbin/dvmrpd/packet.c","usr.sbin/dvmrpd/packet.c","dvmrp_hdr_sanity_check",251,265
16,8,120,2,19,"find_iface@268-287@usr.sbin/dvmrpd/packet.c","usr.sbin/dvmrpd/packet.c","find_iface",268,287
7,2,28,1,6,"print_mainconf@36-42@usr.sbin/dvmrpd/printconf.c","usr.sbin/dvmrpd/printconf.c","print_mainconf",36,42
16,2,106,1,18,"print_iface@45-63@usr.sbin/dvmrpd/printconf.c","usr.sbin/dvmrpd/printconf.c","print_iface",45,63
11,1,52,1,13,"print_config@66-79@usr.sbin/dvmrpd/printconf.c","usr.sbin/dvmrpd/printconf.c","print_config",66,79
31,5,241,1,43,"send_probe@38-81@usr.sbin/dvmrpd/probe.c","usr.sbin/dvmrpd/probe.c","send_probe",38,81
42,10,266,6,54,"recv_probe@84-138@usr.sbin/dvmrpd/probe.c","usr.sbin/dvmrpd/probe.c","recv_probe",84,138
34,4,279,2,48,"send_prune@36-84@usr.sbin/dvmrpd/prune.c","usr.sbin/dvmrpd/prune.c","send_prune",36,84
21,3,160,3,29,"recv_prune@87-116@usr.sbin/dvmrpd/prune.c","usr.sbin/dvmrpd/prune.c","recv_prune",87,116
10,3,37,3,14,"rde_sig_handler@55-69@usr.sbin/dvmrpd/rde.c","usr.sbin/dvmrpd/rde.c","rde_sig_handler",55,69
59,11,448,4,79,"rde@73-152@usr.sbin/dvmrpd/rde.c","usr.sbin/dvmrpd/rde.c","rde",73,152
18,1,100,1,23,"rde_shutdown@155-178@usr.sbin/dvmrpd/rde.c","usr.sbin/dvmrpd/rde.c","rde_shutdown",155,178
4,1,38,4,3,"rde_imsg_compose_parent@182-185@usr.sbin/dvmrpd/rde.c","usr.sbin/dvmrpd/rde.c","rde_imsg_compose_parent",182,185
6,1,41,5,5,"rde_imsg_compose_dvmrpe@188-193@usr.sbin/dvmrpd/rde.c","usr.sbin/dvmrpd/rde.c","rde_imsg_compose_dvmrpe",188,193
125,39,841,3,145,"rde_dispatch_imsg@196-341@usr.sbin/dvmrpd/rde.c","usr.sbin/dvmrpd/rde.c","rde_dispatch_imsg",196,341
17,5,110,2,21,"rde_select_ds_ifs@344-365@usr.sbin/dvmrpd/rde.c","usr.sbin/dvmrpd/rde.c","rde_select_ds_ifs",344,365
20,4,125,2,27,"rde_group_list_add@369-396@usr.sbin/dvmrpd/rde.c","usr.sbin/dvmrpd/rde.c","rde_group_list_add",369,396
15,3,90,2,18,"rde_group_list_find@399-417@usr.sbin/dvmrpd/rde.c","usr.sbin/dvmrpd/rde.c","rde_group_list_find",399,417
20,5,134,2,23,"rde_group_list_remove@420-443@usr.sbin/dvmrpd/rde.c","usr.sbin/dvmrpd/rde.c","rde_group_list_remove",420,443
11,1,80,3,14,"mfc_expire_timer@67-81@usr.sbin/dvmrpd/rde_mfc.c","usr.sbin/dvmrpd/rde_mfc.c","mfc_expire_timer",67,81
7,1,39,1,7,"mfc_reset_expire_timer@84-91@usr.sbin/dvmrpd/rde_mfc.c","usr.sbin/dvmrpd/rde_mfc.c","mfc_reset_expire_timer",84,91
8,1,51,1,9,"mfc_start_expire_timer@94-103@usr.sbin/dvmrpd/rde_mfc.c","usr.sbin/dvmrpd/rde_mfc.c","mfc_start_expire_timer",94,103
6,1,41,3,7,"mfc_prune_timer@106-113@usr.sbin/dvmrpd/rde_mfc.c","usr.sbin/dvmrpd/rde_mfc.c","mfc_prune_timer",106,113
8,1,51,1,9,"mfc_start_prune_timer@116-125@usr.sbin/dvmrpd/rde_mfc.c","usr.sbin/dvmrpd/rde_mfc.c","mfc_start_prune_timer",116,125
7,1,39,1,7,"mfc_reset_prune_timer@128-135@usr.sbin/dvmrpd/rde_mfc.c","usr.sbin/dvmrpd/rde_mfc.c","mfc_reset_prune_timer",128,135
4,1,12,1,3,"mfc_init@139-142@usr.sbin/dvmrpd/rde_mfc.c","usr.sbin/dvmrpd/rde_mfc.c","mfc_init",139,142
12,5,121,2,11,"mfc_compare@145-156@usr.sbin/dvmrpd/rde_mfc.c","usr.sbin/dvmrpd/rde_mfc.c","mfc_compare",145,156
7,1,44,2,8,"mfc_find@159-167@usr.sbin/dvmrpd/rde_mfc.c","usr.sbin/dvmrpd/rde_mfc.c","mfc_find",159,167
10,2,53,1,10,"mfc_insert@170-180@usr.sbin/dvmrpd/rde_mfc.c","usr.sbin/dvmrpd/rde_mfc.c","mfc_insert",170,180
10,2,53,1,10,"mfc_remove@183-193@usr.sbin/dvmrpd/rde_mfc.c","usr.sbin/dvmrpd/rde_mfc.c","mfc_remove",183,193
6,2,32,1,6,"mfc_clear@196-202@usr.sbin/dvmrpd/rde_mfc.c","usr.sbin/dvmrpd/rde_mfc.c","mfc_clear",196,202
26,3,192,1,30,"mfc_dump@205-235@usr.sbin/dvmrpd/rde_mfc.c","usr.sbin/dvmrpd/rde_mfc.c","mfc_dump",205,235
8,2,51,1,9,"mfc_find_origin@238-247@usr.sbin/dvmrpd/rde_mfc.c","usr.sbin/dvmrpd/rde_mfc.c","mfc_find_origin",238,247
13,1,125,2,16,"mfc_send_prune@250-266@usr.sbin/dvmrpd/rde_mfc.c","usr.sbin/dvmrpd/rde_mfc.c","mfc_send_prune",250,266
28,7,215,1,35,"mfc_update_source@269-304@usr.sbin/dvmrpd/rde_mfc.c","usr.sbin/dvmrpd/rde_mfc.c","mfc_update_source",269,304
37,8,266,1,45,"mfc_update@307-352@usr.sbin/dvmrpd/rde_mfc.c","usr.sbin/dvmrpd/rde_mfc.c","mfc_update",307,352
7,2,44,1,11,"mfc_delete@355-366@usr.sbin/dvmrpd/rde_mfc.c","usr.sbin/dvmrpd/rde_mfc.c","mfc_delete",355,366
11,3,69,2,12,"mfc_check_members@369-381@usr.sbin/dvmrpd/rde_mfc.c","usr.sbin/dvmrpd/rde_mfc.c","mfc_check_members",369,381
43,8,256,1,48,"mfc_recv_prune@384-432@usr.sbin/dvmrpd/rde_mfc.c","usr.sbin/dvmrpd/rde_mfc.c","mfc_recv_prune",384,432
17,2,130,2,22,"mfc_add_prune@435-457@usr.sbin/dvmrpd/rde_mfc.c","usr.sbin/dvmrpd/rde_mfc.c","mfc_add_prune",435,457
9,2,56,2,10,"mfc_find_prune@460-470@usr.sbin/dvmrpd/rde_mfc.c","usr.sbin/dvmrpd/rde_mfc.c","mfc_find_prune",460,470
10,3,72,2,11,"mfc_delete_prune@473-484@usr.sbin/dvmrpd/rde_mfc.c","usr.sbin/dvmrpd/rde_mfc.c","mfc_delete_prune",473,484
6,2,43,3,6,"prune_compare@487-493@usr.sbin/dvmrpd/rde_mfc.c","usr.sbin/dvmrpd/rde_mfc.c","prune_compare",487,493
7,1,39,1,8,"mfc_reset_prune_expire_timer@496-504@usr.sbin/dvmrpd/rde_mfc.c","usr.sbin/dvmrpd/rde_mfc.c","mfc_reset_prune_expire_timer",496,504
8,1,58,3,10,"prune_expire_timer@507-517@usr.sbin/dvmrpd/rde_mfc.c","usr.sbin/dvmrpd/rde_mfc.c","prune_expire_timer",507,517
13,2,87,3,15,"rt_expire_timer@70-85@usr.sbin/dvmrpd/rde_srt.c","usr.sbin/dvmrpd/rde_srt.c","rt_expire_timer",70,85
11,3,75,1,13,"rt_start_expire_timer@88-101@usr.sbin/dvmrpd/rde_srt.c","usr.sbin/dvmrpd/rde_srt.c","rt_start_expire_timer",88,101
7,1,42,3,8,"rt_holddown_timer@104-112@usr.sbin/dvmrpd/rde_srt.c","usr.sbin/dvmrpd/rde_srt.c","rt_holddown_timer",104,112
11,3,68,1,11,"rt_start_holddown_timer@115-126@usr.sbin/dvmrpd/rde_srt.c","usr.sbin/dvmrpd/rde_srt.c","rt_start_holddown_timer",115,126
4,1,12,1,3,"rt_init@130-133@usr.sbin/dvmrpd/rde_srt.c","usr.sbin/dvmrpd/rde_srt.c","rt_init",130,133
12,5,101,2,15,"rt_compare@136-151@usr.sbin/dvmrpd/rde_srt.c","usr.sbin/dvmrpd/rde_srt.c","rt_compare",136,151
7,1,42,2,8,"rt_find@154-162@usr.sbin/dvmrpd/rde_srt.c","usr.sbin/dvmrpd/rde_srt.c","rt_find",154,162
27,3,224,3,34,"rr_new_rt@165-199@usr.sbin/dvmrpd/rde_srt.c","usr.sbin/dvmrpd/rde_srt.c","rr_new_rt",165,199
12,2,73,1,13,"rt_insert@202-215@usr.sbin/dvmrpd/rde_srt.c","usr.sbin/dvmrpd/rde_srt.c","rt_insert",202,215
15,3,92,1,17,"rt_remove@218-235@usr.sbin/dvmrpd/rde_srt.c","usr.sbin/dvmrpd/rde_srt.c","rt_remove",218,235
11,3,66,1,11,"rt_invalidate@238-249@usr.sbin/dvmrpd/rde_srt.c","usr.sbin/dvmrpd/rde_srt.c","rt_invalidate",238,249
6,2,32,1,6,"rt_clear@252-258@usr.sbin/dvmrpd/rde_srt.c","usr.sbin/dvmrpd/rde_srt.c","rt_clear",252,258
15,2,92,1,16,"rt_snap@261-277@usr.sbin/dvmrpd/rde_srt.c","usr.sbin/dvmrpd/rde_srt.c","rt_snap",261,277
26,3,184,1,30,"rt_dump@280-310@usr.sbin/dvmrpd/rde_srt.c","usr.sbin/dvmrpd/rde_srt.c","rt_dump",280,310
5,2,21,1,4,"rt_update@313-317@usr.sbin/dvmrpd/rde_srt.c","usr.sbin/dvmrpd/rde_srt.c","rt_update",313,317
10,2,55,1,11,"rt_match_origin@320-331@usr.sbin/dvmrpd/rde_srt.c","usr.sbin/dvmrpd/rde_srt.c","rt_match_origin",320,331
81,29,553,2,104,"srt_check_route@334-438@usr.sbin/dvmrpd/rde_srt.c","usr.sbin/dvmrpd/rde_srt.c","srt_check_route",334,438
18,9,149,4,22,"srt_current_forwarder@441-463@usr.sbin/dvmrpd/rde_srt.c","usr.sbin/dvmrpd/rde_srt.c","srt_current_forwarder",441,463
15,6,107,3,15,"srt_update_ds_forwarders@466-481@usr.sbin/dvmrpd/rde_srt.c","usr.sbin/dvmrpd/rde_srt.c","srt_update_ds_forwarders",466,481
7,1,64,2,7,"srt_set_forwarder_self@484-491@usr.sbin/dvmrpd/rde_srt.c","usr.sbin/dvmrpd/rde_srt.c","srt_set_forwarder_self",484,491
8,2,44,2,8,"srt_set_upstream@494-502@usr.sbin/dvmrpd/rde_srt.c","usr.sbin/dvmrpd/rde_srt.c","srt_set_upstream",494,502
13,2,100,3,17,"srt_add_ds@505-522@usr.sbin/dvmrpd/rde_srt.c","usr.sbin/dvmrpd/rde_srt.c","srt_add_ds",505,522
8,2,48,2,9,"srt_find_ds@525-534@usr.sbin/dvmrpd/rde_srt.c","usr.sbin/dvmrpd/rde_srt.c","srt_find_ds",525,534
9,1,64,3,10,"srt_delete_ds@537-547@usr.sbin/dvmrpd/rde_srt.c","usr.sbin/dvmrpd/rde_srt.c","srt_delete_ds",537,547
11,4,77,2,20,"srt_check_downstream_ifaces@550-570@usr.sbin/dvmrpd/rde_srt.c","usr.sbin/dvmrpd/rde_srt.c","srt_check_downstream_ifaces",550,570
23,5,160,2,25,"srt_expire_nbr@573-598@usr.sbin/dvmrpd/rde_srt.c","usr.sbin/dvmrpd/rde_srt.c","srt_expire_nbr",573,598
8,1,70,1,8,"flash_update@601-609@usr.sbin/dvmrpd/rde_srt.c","usr.sbin/dvmrpd/rde_srt.c","flash_update",601,609
8,1,70,1,8,"flash_update_ds@612-620@usr.sbin/dvmrpd/rde_srt.c","usr.sbin/dvmrpd/rde_srt.c","flash_update_ds",612,620
28,4,215,4,37,"send_report@40-77@usr.sbin/dvmrpd/report.c","usr.sbin/dvmrpd/report.c","send_report",40,77
39,6,284,3,74,"recv_report@80-154@usr.sbin/dvmrpd/report.c","usr.sbin/dvmrpd/report.c","recv_report",80,154
8,1,54,3,11,"report_timer@158-169@usr.sbin/dvmrpd/report.c","usr.sbin/dvmrpd/report.c","report_timer",158,169
7,1,36,1,7,"start_report_timer@172-179@usr.sbin/dvmrpd/report.c","usr.sbin/dvmrpd/report.c","start_report_timer",172,179
4,1,17,1,3,"stop_report_timer@182-185@usr.sbin/dvmrpd/report.c","usr.sbin/dvmrpd/report.c","stop_report_timer",182,185
11,3,74,2,13,"rr_list_add@189-202@usr.sbin/dvmrpd/report.c","usr.sbin/dvmrpd/report.c","rr_list_add",189,202
5,2,23,1,4,"rr_list_remove@205-209@usr.sbin/dvmrpd/report.c","usr.sbin/dvmrpd/report.c","rr_list_remove",205,209
9,2,50,1,9,"rr_list_clr@212-221@usr.sbin/dvmrpd/report.c","usr.sbin/dvmrpd/report.c","rr_list_clr",212,221
52,10,367,3,70,"rr_list_send@224-294@usr.sbin/dvmrpd/report.c","usr.sbin/dvmrpd/report.c","rr_list_send",224,294
9,1,29,1,8,"usage@87-95@usr.sbin/edquota/edquota.c","usr.sbin/edquota/edquota.c","usage",87,95
86,23,517,2,86,"main@98-184@usr.sbin/edquota/edquota.c","usr.sbin/edquota/edquota.c","main",98,184
37,9,202,3,37,"getentry@192-229@usr.sbin/edquota/edquota.c","usr.sbin/edquota/edquota.c","getentry",192,229
78,17,514,2,84,"getprivs@235-319@usr.sbin/edquota/edquota.c","usr.sbin/edquota/edquota.c","getprivs",235,319
19,5,163,3,19,"putprivs@325-344@usr.sbin/edquota/edquota.c","usr.sbin/edquota/edquota.c","putprivs",325,344
41,11,303,1,43,"editit@353-396@usr.sbin/edquota/edquota.c","usr.sbin/edquota/edquota.c","editit",353,396
22,3,217,4,22,"writeprivs@402-424@usr.sbin/edquota/edquota.c","usr.sbin/edquota/edquota.c","writeprivs",402,424
91,23,648,2,103,"readprivs@430-533@usr.sbin/edquota/edquota.c","usr.sbin/edquota/edquota.c","readprivs",430,533
22,3,160,3,22,"writetimes@539-561@usr.sbin/edquota/edquota.c","usr.sbin/edquota/edquota.c","writetimes",539,561
58,12,406,2,65,"readtimes@567-632@usr.sbin/edquota/edquota.c","usr.sbin/edquota/edquota.c","readtimes",567,632
20,8,188,1,20,"cvtstoa@638-658@usr.sbin/edquota/edquota.c","usr.sbin/edquota/edquota.c","cvtstoa",638,658
17,5,128,3,17,"cvtatos@664-681@usr.sbin/edquota/edquota.c","usr.sbin/edquota/edquota.c","cvtatos",664,681
8,2,42,1,8,"freeprivs@687-695@usr.sbin/edquota/edquota.c","usr.sbin/edquota/edquota.c","freeprivs",687,695
10,3,57,1,10,"alldigits@701-711@usr.sbin/edquota/edquota.c","usr.sbin/edquota/edquota.c","alldigits",701,711
33,10,245,3,33,"hasquota@717-750@usr.sbin/edquota/edquota.c","usr.sbin/edquota/edquota.c","hasquota",717,750
58,17,266,2,68,"main@62-130@usr.sbin/eeprom/main.c","usr.sbin/eeprom/main.c","main",62,130
12,4,85,1,19,"action@137-156@usr.sbin/eeprom/main.c","usr.sbin/eeprom/main.c","action",137,156
5,1,15,1,8,"dump_prom@162-170@usr.sbin/eeprom/main.c","usr.sbin/eeprom/main.c","dump_prom",162,170
7,1,20,1,7,"usage@173-180@usr.sbin/eeprom/main.c","usr.sbin/eeprom/main.c","usage",173,180
71,18,524,2,84,"op_handler@75-159@usr.sbin/eeprom/ophandlers.c","usr.sbin/eeprom/ophandlers.c","op_handler",75,159
4,1,27,3,4,"op_notsupp@163-167@usr.sbin/eeprom/ophandlers.c","usr.sbin/eeprom/ophandlers.c","op_notsupp",163,167
47,10,418,1,85,"op_dump@174-259@usr.sbin/eeprom/ophandlers.c","usr.sbin/eeprom/ophandlers.c","op_dump",174,259
14,2,74,1,14,"op_print@262-276@usr.sbin/eeprom/ophandlers.c","usr.sbin/eeprom/ophandlers.c","op_print",262,276
64,24,431,2,72,"op_print@36-108@usr.sbin/eeprom/optree.c","usr.sbin/eeprom/optree.c","op_print",36,108
45,12,352,3,62,"op_nodes@111-173@usr.sbin/eeprom/optree.c","usr.sbin/eeprom/optree.c","op_nodes",111,173
8,2,52,1,8,"op_tree@176-184@usr.sbin/eeprom/optree.c","usr.sbin/eeprom/optree.c","op_tree",176,184
7,1,25,1,7,"usage@67-74@usr.sbin/eigrpctl/eigrpctl.c","usr.sbin/eigrpctl/eigrpctl.c","usage",67,74
184,55,1189,2,202,"main@77-279@usr.sbin/eigrpctl/eigrpctl.c","usr.sbin/eigrpctl/eigrpctl.c","main",77,279
15,5,52,1,14,"get_ifms_type@282-296@usr.sbin/eigrpctl/eigrpctl.c","usr.sbin/eigrpctl/eigrpctl.c","get_ifms_type",282,296
34,10,231,2,38,"show_interface_msg@299-337@usr.sbin/eigrpctl/eigrpctl.c","usr.sbin/eigrpctl/eigrpctl.c","show_interface_msg",299,337
44,10,278,2,47,"show_interface_detail_msg@340-387@usr.sbin/eigrpctl/eigrpctl.c","usr.sbin/eigrpctl/eigrpctl.c","show_interface_detail_msg",340,387
7,2,24,1,6,"print_link@390-396@usr.sbin/eigrpctl/eigrpctl.c","usr.sbin/eigrpctl/eigrpctl.c","print_link",390,396
29,5,179,1,34,"fmt_timeframe_core@402-436@usr.sbin/eigrpctl/eigrpctl.c","usr.sbin/eigrpctl/eigrpctl.c","fmt_timeframe_core",402,436
28,9,194,2,32,"show_nbr_msg@439-471@usr.sbin/eigrpctl/eigrpctl.c","usr.sbin/eigrpctl/eigrpctl.c","show_nbr_msg",439,471
16,5,67,2,16,"connected_check@474-490@usr.sbin/eigrpctl/eigrpctl.c","usr.sbin/eigrpctl/eigrpctl.c","connected_check",474,490
57,19,417,2,63,"show_topology_msg@493-556@usr.sbin/eigrpctl/eigrpctl.c","usr.sbin/eigrpctl/eigrpctl.c","show_topology_msg",493,556
90,22,641,2,98,"show_topology_detail_msg@559-657@usr.sbin/eigrpctl/eigrpctl.c","usr.sbin/eigrpctl/eigrpctl.c","show_topology_detail_msg",559,657
6,1,24,1,5,"show_fib_head@660-665@usr.sbin/eigrpctl/eigrpctl.c","usr.sbin/eigrpctl/eigrpctl.c","show_fib_head",660,665
56,17,363,2,64,"show_fib_msg@668-732@usr.sbin/eigrpctl/eigrpctl.c","usr.sbin/eigrpctl/eigrpctl.c","show_fib_msg",668,732
5,1,17,1,4,"show_interface_head@735-739@usr.sbin/eigrpctl/eigrpctl.c","usr.sbin/eigrpctl/eigrpctl.c","show_interface_head",735,739
8,3,48,1,9,"get_media_descr@747-756@usr.sbin/eigrpctl/eigrpctl.c","usr.sbin/eigrpctl/eigrpctl.c","get_media_descr",747,756
11,3,77,2,11,"get_linkstate@759-770@usr.sbin/eigrpctl/eigrpctl.c","usr.sbin/eigrpctl/eigrpctl.c","get_linkstate",759,770
11,4,80,1,10,"print_baudrate@773-783@usr.sbin/eigrpctl/eigrpctl.c","usr.sbin/eigrpctl/eigrpctl.c","print_baudrate",773,783
29,8,179,1,32,"show_fib_interface_msg@786-818@usr.sbin/eigrpctl/eigrpctl.c","usr.sbin/eigrpctl/eigrpctl.c","show_fib_interface_msg",786,818
37,8,256,2,40,"show_stats_msg@821-861@usr.sbin/eigrpctl/eigrpctl.c","usr.sbin/eigrpctl/eigrpctl.c","show_stats_msg",821,861
24,6,152,2,30,"parse@227-257@usr.sbin/eigrpctl/parser.c","usr.sbin/eigrpctl/parser.c","parse",227,257
97,37,576,3,101,"match_token@260-361@usr.sbin/eigrpctl/parser.c","usr.sbin/eigrpctl/parser.c","match_token",260,361
32,11,143,1,32,"show_valid_args@364-396@usr.sbin/eigrpctl/parser.c","usr.sbin/eigrpctl/parser.c","show_valid_args",364,396
12,3,71,2,14,"parse_asnum@399-413@usr.sbin/eigrpctl/parser.c","usr.sbin/eigrpctl/parser.c","parse_asnum",399,413
27,4,202,3,31,"parse_addr@416-447@usr.sbin/eigrpctl/parser.c","usr.sbin/eigrpctl/parser.c","parse_addr",416,447
47,13,306,4,54,"parse_prefix@450-504@usr.sbin/eigrpctl/parser.c","usr.sbin/eigrpctl/parser.c","parse_prefix",450,504
67,15,408,2,78,"getport@112-190@usr.sbin/lpr/common_source/common.c","usr.sbin/lpr/common_source/common.c","getport",112,190
21,7,119,1,21,"get_line@198-219@usr.sbin/lpr/common_source/common.c","usr.sbin/lpr/common_source/common.c","get_line",198,219
59,14,358,1,71,"getq@227-298@usr.sbin/lpr/common_source/common.c","usr.sbin/lpr/common_source/common.c","getq",227,298
6,1,51,2,6,"compar@304-310@usr.sbin/lpr/common_source/common.c","usr.sbin/lpr/common_source/common.c","compar",304,310
82,17,572,1,95,"checkremote@317-412@usr.sbin/lpr/common_source/common.c","usr.sbin/lpr/common_source/common.c","checkremote",317,412
15,3,94,2,15,"fatal@415-430@usr.sbin/lpr/common_source/common.c","usr.sbin/lpr/common_source/common.c","fatal",415,430
22,6,128,3,22,"safe_open@433-455@usr.sbin/lpr/common_source/common.c","usr.sbin/lpr/common_source/common.c","safe_open",433,455
21,6,126,1,22,"ckqueue@462-484@usr.sbin/lpr/common_source/common.c","usr.sbin/lpr/common_source/common.c","ckqueue",462,484
193,66,1420,1,218,"displayq@94-312@usr.sbin/lpr/common_source/displayq.c","usr.sbin/lpr/common_source/displayq.c","displayq",94,312
3,1,7,1,3,"alarmer@315-318@usr.sbin/lpr/common_source/displayq.c","usr.sbin/lpr/common_source/displayq.c","alarmer",315,318
7,2,29,1,6,"nodaemon@324-330@usr.sbin/lpr/common_source/displayq.c","usr.sbin/lpr/common_source/displayq.c","nodaemon",324,330
7,1,36,1,6,"header@336-342@usr.sbin/lpr/common_source/displayq.c","usr.sbin/lpr/common_source/displayq.c","header",336,342
55,14,329,2,60,"inform@345-405@usr.sbin/lpr/common_source/displayq.c","usr.sbin/lpr/common_source/displayq.c","inform",345,405
16,9,152,2,22,"inlist@408-430@usr.sbin/lpr/common_source/displayq.c","usr.sbin/lpr/common_source/displayq.c","inlist",408,430
9,3,53,3,8,"show@433-441@usr.sbin/lpr/common_source/displayq.c","usr.sbin/lpr/common_source/displayq.c","show",433,441
5,2,19,1,4,"blankfill@447-451@usr.sbin/lpr/common_source/displayq.c","usr.sbin/lpr/common_source/displayq.c","blankfill",447,451
24,7,155,3,28,"dump@457-485@usr.sbin/lpr/common_source/displayq.c","usr.sbin/lpr/common_source/displayq.c","dump",457,485
18,4,96,3,18,"ldump@491-509@usr.sbin/lpr/common_source/displayq.c","usr.sbin/lpr/common_source/displayq.c","ldump",491,509
18,3,129,1,18,"prank@516-534@usr.sbin/lpr/common_source/displayq.c","usr.sbin/lpr/common_source/displayq.c","prank",516,534
59,22,376,1,78,"rmjob@75-153@usr.sbin/lpr/common_source/rmjob.c","usr.sbin/lpr/common_source/rmjob.c","rmjob",75,153
35,10,222,1,36,"lockchk@161-197@usr.sbin/lpr/common_source/rmjob.c","usr.sbin/lpr/common_source/rmjob.c","lockchk",161,197
25,9,148,1,25,"process@203-228@usr.sbin/lpr/common_source/rmjob.c","usr.sbin/lpr/common_source/rmjob.c","process",203,228
10,3,46,1,10,"do_unlink@231-241@usr.sbin/lpr/common_source/rmjob.c","usr.sbin/lpr/common_source/rmjob.c","do_unlink",231,241
36,23,332,1,51,"chk@247-298@usr.sbin/lpr/common_source/rmjob.c","usr.sbin/lpr/common_source/rmjob.c","chk",247,298
11,7,93,2,10,"isowner@307-317@usr.sbin/lpr/common_source/rmjob.c","usr.sbin/lpr/common_source/rmjob.c","isowner",307,317
55,14,425,1,64,"rmremote@324-388@usr.sbin/lpr/common_source/rmjob.c","usr.sbin/lpr/common_source/rmjob.c","rmremote",324,388
3,1,7,1,3,"alarmer@391-394@usr.sbin/lpr/common_source/rmjob.c","usr.sbin/lpr/common_source/rmjob.c","alarmer",391,394
4,2,31,1,3,"iscf@400-403@usr.sbin/lpr/common_source/rmjob.c","usr.sbin/lpr/common_source/rmjob.c","iscf",400,403
54,11,359,1,56,"startdaemon@52-108@usr.sbin/lpr/common_source/startdaemon.c","usr.sbin/lpr/common_source/startdaemon.c","startdaemon",52,108
130,42,650,2,145,"main@65-210@usr.sbin/lpr/filters/lpf.c","usr.sbin/lpr/filters/lpf.c","main",65,210
7,1,26,1,7,"usage@213-220@usr.sbin/lpr/filters/lpf.c","usr.sbin/lpr/filters/lpf.c","usage",213,220
35,13,217,2,35,"doabort@77-112@usr.sbin/lpr/lpc/cmds.c","usr.sbin/lpr/lpc/cmds.c","doabort",77,112
61,15,383,1,68,"abortpr@115-183@usr.sbin/lpr/lpc/cmds.c","usr.sbin/lpr/lpc/cmds.c","abortpr",115,183
22,6,177,1,22,"upstat@189-211@usr.sbin/lpr/lpc/cmds.c","usr.sbin/lpr/lpc/cmds.c","upstat",189,211
35,13,215,2,36,"clean@217-253@usr.sbin/lpr/lpc/cmds.c","usr.sbin/lpr/lpc/cmds.c","clean",217,253
7,5,55,1,7,"doselect@256-263@usr.sbin/lpr/lpc/cmds.c","usr.sbin/lpr/lpc/cmds.c","doselect",256,263
15,6,141,2,15,"sortq@270-285@usr.sbin/lpr/lpc/cmds.c","usr.sbin/lpr/lpc/cmds.c","sortq",270,285
54,14,346,1,62,"cleanpr@291-353@usr.sbin/lpr/lpc/cmds.c","usr.sbin/lpr/lpc/cmds.c","cleanpr",291,353
9,2,36,1,8,"unlinkf@356-364@usr.sbin/lpr/lpc/cmds.c","usr.sbin/lpr/lpc/cmds.c","unlinkf",356,364
35,13,215,2,36,"enable@370-406@usr.sbin/lpr/lpc/cmds.c","usr.sbin/lpr/lpc/cmds.c","enable",370,406
19,5,124,1,23,"enablepr@409-432@usr.sbin/lpr/lpc/cmds.c","usr.sbin/lpr/lpc/cmds.c","enablepr",409,432
35,13,215,2,36,"disable@438-474@usr.sbin/lpr/lpc/cmds.c","usr.sbin/lpr/lpc/cmds.c","disable",438,474
29,7,197,1,32,"disablepr@477-509@usr.sbin/lpr/lpc/cmds.c","usr.sbin/lpr/lpc/cmds.c","disablepr",477,509
33,11,219,2,34,"down@516-550@usr.sbin/lpr/lpc/cmds.c","usr.sbin/lpr/lpc/cmds.c","down",516,550
62,14,458,2,69,"putmsg@553-622@usr.sbin/lpr/lpc/cmds.c","usr.sbin/lpr/lpc/cmds.c","putmsg",553,622
4,1,16,2,3,"quit@628-631@usr.sbin/lpr/lpc/cmds.c","usr.sbin/lpr/lpc/cmds.c","quit",628,631
37,13,227,2,38,"restart@637-675@usr.sbin/lpr/lpc/cmds.c","usr.sbin/lpr/lpc/cmds.c","restart",637,675
35,13,217,2,36,"startcmd@681-717@usr.sbin/lpr/lpc/cmds.c","usr.sbin/lpr/lpc/cmds.c","startcmd",681,717
26,8,163,1,31,"startpr@720-751@usr.sbin/lpr/lpc/cmds.c","usr.sbin/lpr/lpc/cmds.c","startpr",720,751
31,13,206,2,32,"status@757-789@usr.sbin/lpr/lpc/cmds.c","usr.sbin/lpr/lpc/cmds.c","status",757,789
69,20,464,1,69,"prstat@795-864@usr.sbin/lpr/lpc/cmds.c","usr.sbin/lpr/lpc/cmds.c","prstat",795,864
35,13,215,2,36,"stop@871-907@usr.sbin/lpr/lpc/cmds.c","usr.sbin/lpr/lpc/cmds.c","stop",871,907
32,7,209,1,36,"stoppr@910-946@usr.sbin/lpr/lpc/cmds.c","usr.sbin/lpr/lpc/cmds.c","stoppr",910,946
58,15,330,2,66,"topq@956-1022@usr.sbin/lpr/lpc/cmds.c","usr.sbin/lpr/lpc/cmds.c","topq",956,1022
11,1,72,1,11,"touch@1029-1040@usr.sbin/lpr/lpc/cmds.c","usr.sbin/lpr/lpc/cmds.c","touch",1029,1040
57,21,403,1,68,"doarg@1047-1115@usr.sbin/lpr/lpc/cmds.c","usr.sbin/lpr/lpc/cmds.c","doarg",1047,1115
35,13,217,2,36,"up@1121-1157@usr.sbin/lpr/lpc/cmds.c","usr.sbin/lpr/lpc/cmds.c","up",1121,1157
31,8,181,2,32,"main@74-106@usr.sbin/lpr/lpc/lpc.c","usr.sbin/lpr/lpc/lpc.c","main",74,106
6,2,21,1,5,"intr@111-116@usr.sbin/lpr/lpc/lpc.c","usr.sbin/lpr/lpc/lpc.c","intr",111,116
41,13,207,1,43,"cmdscanner@122-165@usr.sbin/lpr/lpc/lpc.c","usr.sbin/lpr/lpc/lpc.c","cmdscanner",122,165
25,8,155,1,25,"getcmd@168-193@usr.sbin/lpr/lpc/lpc.c","usr.sbin/lpr/lpc/lpc.c","getcmd",168,193
13,3,67,1,13,"makeargv@199-212@usr.sbin/lpr/lpc/lpc.c","usr.sbin/lpr/lpc/lpc.c","makeargv",199,212
48,13,305,2,51,"help@220-271@usr.sbin/lpr/lpc/lpc.c","usr.sbin/lpr/lpc/lpc.c","help",220,271
21,6,128,1,21,"ingroup@277-298@usr.sbin/lpr/lpc/lpc.c","usr.sbin/lpr/lpc/lpc.c","ingroup",277,298
60,18,366,3,70,"allowedhost@56-126@usr.sbin/lpr/lpd/allowedhost.c","usr.sbin/lpr/lpd/allowedhost.c","allowedhost",56,126
29,6,224,3,37,"checkhost@133-170@usr.sbin/lpr/lpd/allowedhost.c","usr.sbin/lpr/lpd/allowedhost.c","checkhost",133,170
36,8,285,2,47,"gethostloop@178-225@usr.sbin/lpr/lpd/allowedhost.c","usr.sbin/lpr/lpd/allowedhost.c","gethostloop",178,225
19,4,143,2,20,"main@229-249@usr.sbin/lpr/lpd/allowedhost.c","usr.sbin/lpr/lpd/allowedhost.c","main",229,249
4,1,42,2,4,"c_key@89-93@usr.sbin/lpr/lpd/key.c","usr.sbin/lpr/lpd/key.c","c_key",89,93
26,6,188,2,27,"ksearch@96-123@usr.sbin/lpr/lpd/key.c","usr.sbin/lpr/lpd/key.c","ksearch",96,123
12,2,67,1,12,"f_cbreak@126-138@usr.sbin/lpr/lpd/key.c","usr.sbin/lpr/lpd/key.c","f_cbreak",126,138
5,1,28,1,5,"f_columns@141-146@usr.sbin/lpr/lpd/key.c","usr.sbin/lpr/lpd/key.c","f_columns",141,146
10,1,85,1,10,"f_dec@149-159@usr.sbin/lpr/lpd/key.c","usr.sbin/lpr/lpd/key.c","f_dec",149,159
10,2,60,1,10,"f_extproc@162-172@usr.sbin/lpr/lpd/key.c","usr.sbin/lpr/lpd/key.c","f_extproc",162,172
5,1,30,1,5,"f_ispeed@175-180@usr.sbin/lpr/lpd/key.c","usr.sbin/lpr/lpd/key.c","f_ispeed",175,180
11,2,58,1,11,"f_nl@183-194@usr.sbin/lpr/lpd/key.c","usr.sbin/lpr/lpd/key.c","f_nl",183,194
5,1,30,1,5,"f_ospeed@197-202@usr.sbin/lpr/lpd/key.c","usr.sbin/lpr/lpd/key.c","f_ospeed",197,202
11,2,57,1,11,"f_raw@205-216@usr.sbin/lpr/lpd/key.c","usr.sbin/lpr/lpd/key.c","f_raw",205,216
5,1,28,1,5,"f_rows@219-224@usr.sbin/lpr/lpd/key.c","usr.sbin/lpr/lpd/key.c","f_rows",219,224
9,1,79,1,11,"f_sane@227-238@usr.sbin/lpr/lpd/key.c","usr.sbin/lpr/lpd/key.c","f_sane",227,238
7,2,39,1,7,"f_tty@241-248@usr.sbin/lpr/lpd/key.c","usr.sbin/lpr/lpd/key.c","f_tty",241,248
248,63,1496,2,279,"main@117-396@usr.sbin/lpr/lpd/lpd.c","usr.sbin/lpr/lpd/lpd.c","main",117,396
8,2,40,1,8,"reapchild@399-407@usr.sbin/lpr/lpd/lpd.c","usr.sbin/lpr/lpd/lpd.c","reapchild",399,407
9,2,39,1,9,"mcleanup@410-419@usr.sbin/lpr/lpd/lpd.c","usr.sbin/lpr/lpd/lpd.c","mcleanup",410,419
111,37,587,1,111,"doit@442-553@usr.sbin/lpr/lpd/lpd.c","usr.sbin/lpr/lpd/lpd.c","doit",442,553
30,9,147,1,35,"startup@560-595@usr.sbin/lpr/lpd/lpd.c","usr.sbin/lpr/lpd/lpd.c","startup",560,595
60,14,423,1,67,"chkhost@601-668@usr.sbin/lpr/lpd/lpd.c","usr.sbin/lpr/lpd/lpd.c","chkhost",601,668
7,1,26,1,7,"usage@671-678@usr.sbin/lpr/lpd/lpd.c","usr.sbin/lpr/lpd/lpd.c","usage",671,678
76,19,481,3,81,"socksetup@686-767@usr.sbin/lpr/lpd/lpd.c","usr.sbin/lpr/lpd/lpd.c","socksetup",686,767
35,9,254,2,36,"msearch@200-236@usr.sbin/lpr/lpd/modes.c","usr.sbin/lpr/lpd/modes.c","msearch",200,236
159,44,1119,1,189,"printjob@129-318@usr.sbin/lpr/lpd/printjob.c","usr.sbin/lpr/lpd/printjob.c","printjob",129,318
121,50,769,1,186,"printit@335-521@usr.sbin/lpr/lpd/printjob.c","usr.sbin/lpr/lpd/printjob.c","printit",335,521
238,60,1536,2,257,"print@534-791@usr.sbin/lpr/lpd/printjob.c","usr.sbin/lpr/lpd/printjob.c","print",534,791
53,23,367,1,75,"sendit@799-874@usr.sbin/lpr/lpd/printjob.c","usr.sbin/lpr/lpd/printjob.c","sendit",799,874
80,27,581,2,89,"sendfile@881-970@usr.sbin/lpr/lpd/printjob.c","usr.sbin/lpr/lpd/printjob.c","sendfile",881,970
18,2,120,1,18,"response@978-996@usr.sbin/lpr/lpd/printjob.c","usr.sbin/lpr/lpd/printjob.c","response",978,996
36,7,334,2,36,"banner@1002-1038@usr.sbin/lpr/lpd/printjob.c","usr.sbin/lpr/lpd/printjob.c","banner",1002,1038
9,3,51,3,9,"scnline@1041-1050@usr.sbin/lpr/lpd/printjob.c","usr.sbin/lpr/lpd/printjob.c","scnline",1041,1050
31,13,241,3,31,"scan_out@1055-1086@usr.sbin/lpr/lpd/printjob.c","usr.sbin/lpr/lpd/printjob.c","scan_out",1055,1086
16,9,73,1,17,"dropit@1089-1106@usr.sbin/lpr/lpd/printjob.c","usr.sbin/lpr/lpd/printjob.c","dropit",1089,1106
75,21,467,2,75,"sendmail@1113-1188@usr.sbin/lpr/lpd/printjob.c","usr.sbin/lpr/lpd/printjob.c","sendmail",1113,1188
9,3,54,1,9,"delay@1192-1201@usr.sbin/lpr/lpd/printjob.c","usr.sbin/lpr/lpd/printjob.c","delay",1192,1201
36,7,179,1,42,"dofork@1207-1249@usr.sbin/lpr/lpd/printjob.c","usr.sbin/lpr/lpd/printjob.c","dofork",1207,1249
11,3,61,1,10,"abortpr@1255-1265@usr.sbin/lpr/lpd/printjob.c","usr.sbin/lpr/lpd/printjob.c","abortpr",1255,1265
71,17,663,1,77,"init@1268-1345@usr.sbin/lpr/lpd/printjob.c","usr.sbin/lpr/lpd/printjob.c","init",1268,1345
42,11,253,1,47,"openpr@1352-1399@usr.sbin/lpr/lpd/printjob.c","usr.sbin/lpr/lpd/printjob.c","openpr",1352,1399
32,9,175,1,38,"opennet@1406-1444@usr.sbin/lpr/lpd/printjob.c","usr.sbin/lpr/lpd/printjob.c","opennet",1406,1444
22,8,117,1,22,"opentty@1450-1472@usr.sbin/lpr/lpd/printjob.c","usr.sbin/lpr/lpd/printjob.c","opentty",1450,1472
29,9,177,1,29,"openrem@1478-1507@usr.sbin/lpr/lpd/printjob.c","usr.sbin/lpr/lpd/printjob.c","openrem",1478,1507
3,1,7,1,3,"alarmer@1510-1513@usr.sbin/lpr/lpd/printjob.c","usr.sbin/lpr/lpd/printjob.c","alarmer",1510,1513
63,18,448,1,66,"setty@1519-1585@usr.sbin/lpr/lpd/printjob.c","usr.sbin/lpr/lpd/printjob.c","setty",1519,1585
25,4,171,2,25,"pstatus@1588-1613@usr.sbin/lpr/lpd/printjob.c","usr.sbin/lpr/lpd/printjob.c","pstatus",1588,1613
38,13,277,1,47,"recvjob@76-123@usr.sbin/lpr/lpd/recvjob.c","usr.sbin/lpr/lpd/recvjob.c","recvjob",76,123
68,22,440,1,89,"readjob@130-219@usr.sbin/lpr/lpd/recvjob.c","usr.sbin/lpr/lpd/recvjob.c","readjob",130,219
41,11,245,2,41,"readfile@225-266@usr.sbin/lpr/lpd/recvjob.c","usr.sbin/lpr/lpd/recvjob.c","readfile",225,266
9,3,44,1,9,"noresponse@269-278@usr.sbin/lpr/lpd/recvjob.c","usr.sbin/lpr/lpd/recvjob.c","noresponse",269,278
16,4,95,1,16,"chksize@285-301@usr.sbin/lpr/lpd/recvjob.c","usr.sbin/lpr/lpd/recvjob.c","chksize",285,301
13,3,79,1,13,"read_number@304-317@usr.sbin/lpr/lpd/recvjob.c","usr.sbin/lpr/lpd/recvjob.c","read_number",304,317
17,7,106,1,17,"rcleanup@323-340@usr.sbin/lpr/lpd/recvjob.c","usr.sbin/lpr/lpd/recvjob.c","rcleanup",323,340
12,1,65,2,12,"frecverr@343-355@usr.sbin/lpr/lpd/recvjob.c","usr.sbin/lpr/lpd/recvjob.c","frecverr",343,355
73,24,426,2,78,"main@70-148@usr.sbin/lpr/lpq/lpq.c","usr.sbin/lpr/lpq/lpq.c","main",70,148
8,1,25,1,8,"usage@151-159@usr.sbin/lpr/lpq/lpq.c","usr.sbin/lpr/lpq/lpq.c","usage",151,159
234,92,1413,2,286,"main@107-393@usr.sbin/lpr/lpr/lpr.c","usr.sbin/lpr/lpr/lpr.c","main",107,393
33,12,227,2,33,"copy@399-432@usr.sbin/lpr/lpr/lpr.c","usr.sbin/lpr/lpr/lpr.c","copy",399,432
33,11,188,1,34,"linked@439-473@usr.sbin/lpr/lpr/lpr.c","usr.sbin/lpr/lpr/lpr.c","linked",439,473
16,5,117,2,17,"card@479-496@usr.sbin/lpr/lpr/lpr.c","usr.sbin/lpr/lpr/lpr.c","card",479,496
22,5,131,1,22,"nfile@502-524@usr.sbin/lpr/lpr/lpr.c","usr.sbin/lpr/lpr/lpr.c","nfile",502,524
26,8,135,1,26,"cleanup@530-556@usr.sbin/lpr/lpr/lpr.c","usr.sbin/lpr/lpr/lpr.c","cleanup",530,556
46,11,251,1,46,"test@564-610@usr.sbin/lpr/lpr/lpr.c","usr.sbin/lpr/lpr/lpr.c","test",564,610
11,2,52,1,11,"itoa@616-627@usr.sbin/lpr/lpr/lpr.c","usr.sbin/lpr/lpr/lpr.c","itoa",616,627
21,8,186,1,21,"chkprinter@633-654@usr.sbin/lpr/lpr/lpr.c","usr.sbin/lpr/lpr/lpr.c","chkprinter",633,654
35,11,311,1,35,"mktemps@660-695@usr.sbin/lpr/lpr/lpr.c","usr.sbin/lpr/lpr/lpr.c","mktemps",660,695
7,2,48,2,8,"lmktemp@701-709@usr.sbin/lpr/lpr/lpr.c","usr.sbin/lpr/lpr/lpr.c","lmktemp",701,709
10,1,28,1,10,"usage@712-722@usr.sbin/lpr/lpr/lpr.c","usr.sbin/lpr/lpr/lpr.c","usage",712,722
65,19,407,2,74,"main@76-150@usr.sbin/lpr/lprm/lprm.c","usr.sbin/lpr/lprm/lprm.c","main",76,150
7,1,25,1,7,"usage@153-160@usr.sbin/lpr/lprm/lprm.c","usr.sbin/lpr/lprm/lprm.c","usage",153,160
36,6,255,1,42,"control_init@42-84@usr.sbin/eigrpd/control.c","usr.sbin/eigrpd/control.c","control_init",42,84
12,2,80,1,14,"control_listen@87-101@usr.sbin/eigrpd/control.c","usr.sbin/eigrpd/control.c","control_listen",87,101
8,2,37,1,7,"control_cleanup@104-111@usr.sbin/eigrpd/control.c","usr.sbin/eigrpd/control.c","control_cleanup",104,111
34,9,272,3,43,"control_accept@115-158@usr.sbin/eigrpd/control.c","usr.sbin/eigrpd/control.c","control_accept",115,158
9,2,42,1,10,"control_connbyfd@161-171@usr.sbin/eigrpd/control.c","usr.sbin/eigrpd/control.c","control_connbyfd",161,171
9,2,42,1,10,"control_connbypid@174-184@usr.sbin/eigrpd/control.c","usr.sbin/eigrpd/control.c","control_connbypid",174,184
17,3,118,1,22,"control_close@187-209@usr.sbin/eigrpd/control.c","usr.sbin/eigrpd/control.c","control_close",187,209
93,27,597,3,104,"control_dispatch_imsg@213-317@usr.sbin/eigrpd/control.c","usr.sbin/eigrpd/control.c","control_dispatch_imsg",213,317
8,2,76,1,9,"control_imsg_relay@320-329@usr.sbin/eigrpd/control.c","usr.sbin/eigrpd/control.c","control_imsg_relay",320,329
16,5,62,3,18,"main_sig_handler@65-83@usr.sbin/eigrpd/eigrpd.c","usr.sbin/eigrpd/eigrpd.c","main_sig_handler",65,83
8,1,26,1,8,"usage@86-94@usr.sbin/eigrpd/eigrpd.c","usr.sbin/eigrpd/eigrpd.c","usage",86,94
141,33,918,2,180,"main@99-279@usr.sbin/eigrpd/eigrpd.c","usr.sbin/eigrpd/eigrpd.c","main",99,279
26,9,166,1,31,"eigrpd_shutdown@282-313@usr.sbin/eigrpd/eigrpd.c","usr.sbin/eigrpd/eigrpd.c","eigrpd_shutdown",282,313
40,10,207,6,43,"start_child@316-359@usr.sbin/eigrpd/eigrpd.c","usr.sbin/eigrpd/eigrpd.c","start_child",316,359
67,22,365,3,73,"main_dispatch_eigrpe@364-437@usr.sbin/eigrpd/eigrpd.c","usr.sbin/eigrpd/eigrpd.c","main_dispatch_eigrpe",364,437
54,19,310,3,60,"main_dispatch_rde@441-501@usr.sbin/eigrpd/eigrpd.c","usr.sbin/eigrpd/eigrpd.c","main_dispatch_rde",441,501
6,2,50,4,5,"main_imsg_compose_eigrpe@504-509@usr.sbin/eigrpd/eigrpd.c","usr.sbin/eigrpd/eigrpd.c","main_imsg_compose_eigrpe",504,509
6,2,50,4,5,"main_imsg_compose_rde@512-517@usr.sbin/eigrpd/eigrpd.c","usr.sbin/eigrpd/eigrpd.c","main_imsg_compose_rde",512,517
9,2,73,1,9,"imsg_event_add@520-529@usr.sbin/eigrpd/eigrpd.c","usr.sbin/eigrpd/eigrpd.c","imsg_event_add",520,529
9,2,70,7,9,"imsg_compose_event@532-541@usr.sbin/eigrpd/eigrpd.c","usr.sbin/eigrpd/eigrpd.c","imsg_compose_event",532,541
14,4,113,2,16,"main_imsg_send_ipc_sockets@544-560@usr.sbin/eigrpd/eigrpd.c","usr.sbin/eigrpd/eigrpd.c","main_imsg_send_ipc_sockets",544,560
8,3,55,3,9,"eigrp_find@563-572@usr.sbin/eigrpd/eigrpd.c","usr.sbin/eigrpd/eigrpd.c","eigrp_find",563,572
23,6,168,1,28,"main_imsg_send_config@575-603@usr.sbin/eigrpd/eigrpd.c","usr.sbin/eigrpd/eigrpd.c","main_imsg_send_config",575,603
10,3,58,1,13,"eigrp_reload@606-619@usr.sbin/eigrpd/eigrpd.c","usr.sbin/eigrpd/eigrpd.c","eigrp_reload",606,619
8,3,64,3,7,"eigrp_sendboth@622-629@usr.sbin/eigrpd/eigrpd.c","usr.sbin/eigrpd/eigrpd.c","eigrp_sendboth",622,629
61,12,400,2,78,"merge_config@632-710@usr.sbin/eigrpd/eigrpd.c","usr.sbin/eigrpd/eigrpd.c","merge_config",632,710
3,1,19,3,3,"merge_instances@713-716@usr.sbin/eigrpd/eigrpd.c","usr.sbin/eigrpd/eigrpd.c","merge_instances",713,716
10,2,56,1,12,"config_new_empty@719-731@usr.sbin/eigrpd/eigrpd.c","usr.sbin/eigrpd/eigrpd.c","config_new_empty",719,731
7,1,32,1,9,"config_clear@734-743@usr.sbin/eigrpd/eigrpd.c","usr.sbin/eigrpd/eigrpd.c","config_clear",734,743
10,3,37,3,10,"eigrpe_sig_handler@54-64@usr.sbin/eigrpd/eigrpe.c","usr.sbin/eigrpd/eigrpe.c","eigrpe_sig_handler",54,64
80,22,661,3,109,"eigrpe@68-177@usr.sbin/eigrpd/eigrpe.c","usr.sbin/eigrpd/eigrpe.c","eigrpe",68,177
20,1,127,1,25,"eigrpe_shutdown@180-205@usr.sbin/eigrpd/eigrpe.c","usr.sbin/eigrpd/eigrpe.c","eigrpe_shutdown",180,205
4,1,38,4,3,"eigrpe_imsg_compose_parent@209-212@usr.sbin/eigrpd/eigrpe.c","usr.sbin/eigrpd/eigrpe.c","eigrpe_imsg_compose_parent",209,212
6,1,41,5,5,"eigrpe_imsg_compose_rde@215-220@usr.sbin/eigrpd/eigrpe.c","usr.sbin/eigrpd/eigrpe.c","eigrpe_imsg_compose_rde",215,220
156,41,984,3,171,"eigrpe_dispatch_main@224-395@usr.sbin/eigrpd/eigrpe.c","usr.sbin/eigrpd/eigrpe.c","eigrpe_dispatch_main",224,395
147,45,799,3,157,"eigrpe_dispatch_rde@399-556@usr.sbin/eigrpd/eigrpe.c","usr.sbin/eigrpd/eigrpe.c","eigrpe_dispatch_rde",399,556
3,1,9,1,2,"eigrpe_instance_init@559-561@usr.sbin/eigrpd/eigrpe.c","usr.sbin/eigrpd/eigrpe.c","eigrpe_instance_init",559,561
7,2,40,1,8,"eigrpe_instance_del@564-572@usr.sbin/eigrpd/eigrpe.c","usr.sbin/eigrpd/eigrpe.c","eigrpe_instance_del",564,572
9,2,59,2,10,"message_add@575-585@usr.sbin/eigrpd/eigrpe.c","usr.sbin/eigrpd/eigrpe.c","message_add",575,585
8,2,43,1,8,"message_list_clr@588-596@usr.sbin/eigrpd/eigrpe.c","usr.sbin/eigrpd/eigrpe.c","message_list_clr",588,596
8,2,43,1,8,"seq_addr_list_clr@599-607@usr.sbin/eigrpd/eigrpe.c","usr.sbin/eigrpd/eigrpe.c","seq_addr_list_clr",599,607
25,2,200,3,28,"eigrpe_orig_local_route@610-638@usr.sbin/eigrpd/eigrpe.c","usr.sbin/eigrpd/eigrpe.c","eigrpe_orig_local_route",610,638
16,3,102,2,16,"eigrpe_iface_ctl@641-657@usr.sbin/eigrpd/eigrpe.c","usr.sbin/eigrpd/eigrpe.c","eigrpe_iface_ctl",641,657
16,2,117,1,18,"eigrpe_nbr_ctl@660-678@usr.sbin/eigrpd/eigrpe.c","usr.sbin/eigrpd/eigrpe.c","eigrpe_nbr_ctl",660,678
13,1,102,1,14,"eigrpe_stats_ctl@681-695@usr.sbin/eigrpd/eigrpe.c","usr.sbin/eigrpd/eigrpe.c","eigrpe_stats_ctl",681,695
27,10,172,3,35,"send_hello@33-68@usr.sbin/eigrpd/hello.c","usr.sbin/eigrpd/hello.c","send_hello",33,68
19,4,126,1,24,"send_peerterm@71-95@usr.sbin/eigrpd/hello.c","usr.sbin/eigrpd/hello.c","send_peerterm",71,95
23,10,191,4,34,"recv_hello@99-133@usr.sbin/eigrpd/hello.c","usr.sbin/eigrpd/hello.c","recv_hello",99,133
28,6,174,2,31,"in_cksum@51-82@usr.sbin/eigrpd/in_cksum.c","usr.sbin/eigrpd/in_cksum.c","in_cksum",51,82
4,1,25,2,3,"iface_id_compare@55-58@usr.sbin/eigrpd/interface.c","usr.sbin/eigrpd/interface.c","iface_id_compare",55,58
25,6,198,2,33,"if_new@61-94@usr.sbin/eigrpd/interface.c","usr.sbin/eigrpd/interface.c","if_new",61,94
11,2,77,1,13,"if_del@97-110@usr.sbin/eigrpd/interface.c","usr.sbin/eigrpd/interface.c","if_del",97,110
8,2,47,2,9,"if_lookup@113-122@usr.sbin/eigrpd/interface.c","usr.sbin/eigrpd/interface.c","if_lookup",113,122
24,8,200,2,28,"if_addr_new@125-153@usr.sbin/eigrpd/interface.c","usr.sbin/eigrpd/interface.c","if_addr_new",125,153
22,7,170,2,26,"if_addr_del@156-182@usr.sbin/eigrpd/interface.c","usr.sbin/eigrpd/interface.c","if_addr_del",156,182
11,4,86,2,12,"if_addr_lookup@185-197@usr.sbin/eigrpd/interface.c","usr.sbin/eigrpd/interface.c","if_addr_lookup",185,197
8,2,49,1,9,"if_primary_addr@200-209@usr.sbin/eigrpd/interface.c","usr.sbin/eigrpd/interface.c","if_primary_addr",200,209
8,2,45,1,9,"if_primary_addr_prefixlen@212-221@usr.sbin/eigrpd/interface.c","usr.sbin/eigrpd/interface.c","if_primary_addr_prefixlen",212,221
42,14,221,2,51,"if_update@225-276@usr.sbin/eigrpd/interface.c","usr.sbin/eigrpd/interface.c","if_update",225,276
28,6,214,3,33,"eigrp_if_new@279-312@usr.sbin/eigrpd/interface.c","usr.sbin/eigrpd/interface.c","eigrp_if_new",279,312
18,4,140,1,21,"eigrp_if_del@315-336@usr.sbin/eigrpd/interface.c","usr.sbin/eigrpd/interface.c","eigrp_if_del",315,336
9,3,59,3,10,"eigrp_if_lookup@339-349@usr.sbin/eigrpd/interface.c","usr.sbin/eigrpd/interface.c","eigrp_if_lookup",339,349
6,1,31,1,5,"eigrp_if_lookup_id@352-357@usr.sbin/eigrpd/interface.c","usr.sbin/eigrpd/interface.c","eigrp_if_lookup_id",352,357
35,7,225,1,43,"eigrp_if_start@360-403@usr.sbin/eigrpd/interface.c","usr.sbin/eigrpd/interface.c","eigrp_if_start",360,403
22,5,130,1,29,"eigrp_if_reset@406-435@usr.sbin/eigrpd/interface.c","usr.sbin/eigrpd/interface.c","eigrp_if_reset",406,435
10,2,69,3,12,"eigrp_if_hello_timer@440-452@usr.sbin/eigrpd/interface.c","usr.sbin/eigrpd/interface.c","eigrp_if_hello_timer",440,452
8,2,48,1,8,"eigrp_if_start_hello_timer@455-463@usr.sbin/eigrpd/interface.c","usr.sbin/eigrpd/interface.c","eigrp_if_start_hello_timer",455,463
6,3,37,1,5,"eigrp_if_stop_hello_timer@466-471@usr.sbin/eigrpd/interface.c","usr.sbin/eigrpd/interface.c","eigrp_if_stop_hello_timer",466,471
47,7,356,1,50,"if_to_ctl@474-524@usr.sbin/eigrpd/interface.c","usr.sbin/eigrpd/interface.c","if_to_ctl",474,524
16,5,100,1,19,"if_set_sockbuf@528-547@usr.sbin/eigrpd/interface.c","usr.sbin/eigrpd/interface.c","if_set_sockbuf",528,547
17,3,124,2,22,"if_join_ipv4_group@550-572@usr.sbin/eigrpd/interface.c","usr.sbin/eigrpd/interface.c","if_join_ipv4_group",550,572
17,3,125,2,22,"if_leave_ipv4_group@575-597@usr.sbin/eigrpd/interface.c","usr.sbin/eigrpd/interface.c","if_leave_ipv4_group",575,597
10,2,57,2,10,"if_set_ipv4_mcast_ttl@600-610@usr.sbin/eigrpd/interface.c","usr.sbin/eigrpd/interface.c","if_set_ipv4_mcast_ttl",600,610
12,2,66,1,14,"if_set_ipv4_mcast@613-627@usr.sbin/eigrpd/interface.c","usr.sbin/eigrpd/interface.c","if_set_ipv4_mcast",613,627
10,2,57,1,11,"if_set_ipv4_mcast_loop@630-641@usr.sbin/eigrpd/interface.c","usr.sbin/eigrpd/interface.c","if_set_ipv4_mcast_loop",630,641
9,2,51,2,8,"if_set_ipv4_recvif@644-652@usr.sbin/eigrpd/interface.c","usr.sbin/eigrpd/interface.c","if_set_ipv4_recvif",644,652
9,2,53,1,10,"if_set_ipv4_hdrincl@655-665@usr.sbin/eigrpd/interface.c","usr.sbin/eigrpd/interface.c","if_set_ipv4_hdrincl",655,665
17,3,115,2,22,"if_join_ipv6_group@668-690@usr.sbin/eigrpd/interface.c","usr.sbin/eigrpd/interface.c","if_join_ipv6_group",668,690
17,3,119,2,22,"if_leave_ipv6_group@693-715@usr.sbin/eigrpd/interface.c","usr.sbin/eigrpd/interface.c","if_leave_ipv6_group",693,715
10,2,60,1,10,"if_set_ipv6_mcast@718-728@usr.sbin/eigrpd/interface.c","usr.sbin/eigrpd/interface.c","if_set_ipv6_mcast",718,728
10,2,59,1,11,"if_set_ipv6_mcast_loop@731-742@usr.sbin/eigrpd/interface.c","usr.sbin/eigrpd/interface.c","if_set_ipv6_mcast_loop",731,742
9,2,51,2,9,"if_set_ipv6_pktinfo@745-754@usr.sbin/eigrpd/interface.c","usr.sbin/eigrpd/interface.c","if_set_ipv6_pktinfo",745,754
9,2,51,2,9,"if_set_ipv6_dscp@757-766@usr.sbin/eigrpd/interface.c","usr.sbin/eigrpd/interface.c","if_set_ipv6_dscp",757,766
6,2,26,1,6,"kif_init@132-138@usr.sbin/eigrpd/kroute.c","usr.sbin/eigrpd/kroute.c","kif_init",132,138
35,8,251,2,45,"kr_init@141-186@usr.sbin/eigrpd/kroute.c","usr.sbin/eigrpd/kroute.c","kr_init",141,186
13,1,77,1,13,"kif_redistribute@189-202@usr.sbin/eigrpd/kroute.c","usr.sbin/eigrpd/kroute.c","kif_redistribute",189,202
26,5,155,1,30,"kr_change@205-235@usr.sbin/eigrpd/kroute.c","usr.sbin/eigrpd/kroute.c","kr_change",205,235
22,7,162,1,26,"kr_delete@238-264@usr.sbin/eigrpd/kroute.c","usr.sbin/eigrpd/kroute.c","kr_delete",238,264
6,1,18,1,5,"kr_shutdown@267-272@usr.sbin/eigrpd/kroute.c","usr.sbin/eigrpd/kroute.c","kr_shutdown",267,272
17,3,104,1,20,"kr_fib_couple@275-295@usr.sbin/eigrpd/kroute.c","usr.sbin/eigrpd/kroute.c","kr_fib_couple",275,295
17,3,104,1,21,"kr_fib_decouple@298-319@usr.sbin/eigrpd/kroute.c","usr.sbin/eigrpd/kroute.c","kr_fib_decouple",298,319
5,2,28,3,4,"kr_dispatch_msg@323-327@usr.sbin/eigrpd/kroute.c","usr.sbin/eigrpd/kroute.c","kr_dispatch_msg",323,327
26,5,178,1,28,"kr_show_route@330-358@usr.sbin/eigrpd/kroute.c","usr.sbin/eigrpd/kroute.c","kr_show_route",330,358
10,3,75,2,11,"kr_ifinfo@361-372@usr.sbin/eigrpd/kroute.c","usr.sbin/eigrpd/kroute.c","kr_ifinfo",361,372
7,2,43,1,9,"kr_redist_remove@375-384@usr.sbin/eigrpd/kroute.c","usr.sbin/eigrpd/kroute.c","kr_redist_remove",375,384
33,13,206,1,47,"kr_redist_eval@387-434@usr.sbin/eigrpd/kroute.c","usr.sbin/eigrpd/kroute.c","kr_redist_eval",387,434
15,3,93,1,17,"kr_redistribute@437-454@usr.sbin/eigrpd/kroute.c","usr.sbin/eigrpd/kroute.c","kr_redistribute",437,454
16,6,114,2,19,"kroute_compare@457-476@usr.sbin/eigrpd/kroute.c","usr.sbin/eigrpd/kroute.c","kroute_compare",457,476
8,1,52,3,9,"kroute_find_prefix@480-489@usr.sbin/eigrpd/kroute.c","usr.sbin/eigrpd/kroute.c","kroute_find_prefix",480,489
10,3,63,2,13,"kroute_find_prio@492-505@usr.sbin/eigrpd/kroute.c","usr.sbin/eigrpd/kroute.c","kroute_find_prio",492,505
8,2,62,2,9,"kroute_find_gw@508-517@usr.sbin/eigrpd/kroute.c","usr.sbin/eigrpd/kroute.c","kroute_find_gw",508,517
52,11,360,1,60,"kroute_insert@520-580@usr.sbin/eigrpd/kroute.c","usr.sbin/eigrpd/kroute.c","kroute_insert",520,580
36,7,250,1,42,"kroute_remove@583-625@usr.sbin/eigrpd/kroute.c","usr.sbin/eigrpd/kroute.c","kroute_remove",583,625
18,4,124,1,18,"kroute_clear@628-646@usr.sbin/eigrpd/kroute.c","usr.sbin/eigrpd/kroute.c","kroute_clear",628,646
4,1,29,2,3,"kif_compare@649-652@usr.sbin/eigrpd/kroute.c","usr.sbin/eigrpd/kroute.c","kif_compare",649,652
7,1,47,1,8,"kif_find@656-664@usr.sbin/eigrpd/kroute.c","usr.sbin/eigrpd/kroute.c","kif_find",656,664
8,2,49,1,9,"kif_findname@667-676@usr.sbin/eigrpd/kroute.c","usr.sbin/eigrpd/kroute.c","kif_findname",667,676
11,3,77,1,14,"kif_insert@679-693@usr.sbin/eigrpd/kroute.c","usr.sbin/eigrpd/kroute.c","kif_insert",679,693
14,3,94,1,15,"kif_remove@696-711@usr.sbin/eigrpd/kroute.c","usr.sbin/eigrpd/kroute.c","kif_remove",696,711
6,2,32,1,6,"kif_clear@714-720@usr.sbin/eigrpd/kroute.c","usr.sbin/eigrpd/kroute.c","kif_clear",714,720
26,8,221,4,30,"kif_update@723-753@usr.sbin/eigrpd/kroute.c","usr.sbin/eigrpd/kroute.c","kif_update",723,753
7,2,40,1,8,"kif_validate@756-764@usr.sbin/eigrpd/kroute.c","usr.sbin/eigrpd/kroute.c","kif_validate",756,764
16,1,113,1,19,"protect_lo@768-787@usr.sbin/eigrpd/kroute.c","usr.sbin/eigrpd/kroute.c","protect_lo",768,787
13,5,60,1,14,"prefixlen_classful@791-805@usr.sbin/eigrpd/kroute.c","usr.sbin/eigrpd/kroute.c","prefixlen_classful",791,805
12,3,87,3,12,"get_rtaddrs@811-823@usr.sbin/eigrpd/kroute.c","usr.sbin/eigrpd/kroute.c","get_rtaddrs",811,823
34,7,221,4,44,"if_change@826-870@usr.sbin/eigrpd/kroute.c","usr.sbin/eigrpd/kroute.c","if_change",826,870
53,13,383,4,64,"if_newaddr@873-937@usr.sbin/eigrpd/kroute.c","usr.sbin/eigrpd/kroute.c","if_newaddr",873,937
60,16,437,4,72,"if_deladdr@940-1012@usr.sbin/eigrpd/kroute.c","usr.sbin/eigrpd/kroute.c","if_deladdr",940,1012
19,5,93,1,20,"if_announce@1015-1035@usr.sbin/eigrpd/kroute.c","usr.sbin/eigrpd/kroute.c","if_announce",1015,1035
71,9,537,3,85,"send_rtmsg_v4@1039-1124@usr.sbin/eigrpd/kroute.c","usr.sbin/eigrpd/kroute.c","send_rtmsg_v4",1039,1124
74,9,613,3,89,"send_rtmsg_v6@1127-1216@usr.sbin/eigrpd/kroute.c","usr.sbin/eigrpd/kroute.c","send_rtmsg_v6",1127,1216
12,3,63,3,12,"send_rtmsg@1219-1231@usr.sbin/eigrpd/kroute.c","usr.sbin/eigrpd/kroute.c","send_rtmsg",1219,1231
30,4,193,1,33,"fetchtable@1234-1267@usr.sbin/eigrpd/kroute.c","usr.sbin/eigrpd/kroute.c","fetchtable",1234,1267
29,4,184,1,32,"fetchifs@1270-1302@usr.sbin/eigrpd/kroute.c","usr.sbin/eigrpd/kroute.c","fetchifs",1270,1302
16,5,98,1,18,"dispatch_rtmsg@1305-1323@usr.sbin/eigrpd/kroute.c","usr.sbin/eigrpd/kroute.c","dispatch_rtmsg",1305,1323
70,21,440,2,82,"rtmsg_process@1326-1408@usr.sbin/eigrpd/kroute.c","usr.sbin/eigrpd/kroute.c","rtmsg_process",1326,1408
119,40,866,2,136,"rtmsg_process_route@1411-1547@usr.sbin/eigrpd/kroute.c","usr.sbin/eigrpd/kroute.c","rtmsg_process_route",1411,1547
8,2,36,1,10,"log_init@42-52@usr.sbin/eigrpd/log.c","usr.sbin/eigrpd/log.c","log_init",42,52
4,1,11,1,3,"log_verbose@55-58@usr.sbin/eigrpd/log.c","usr.sbin/eigrpd/log.c","log_verbose",55,58
7,1,38,3,7,"logit@61-68@usr.sbin/eigrpd/log.c","usr.sbin/eigrpd/log.c","logit",61,68
15,3,90,3,16,"vlog@71-87@usr.sbin/eigrpd/log.c","usr.sbin/eigrpd/log.c","vlog",71,87
18,3,111,2,21,"log_warn@90-111@usr.sbin/eigrpd/log.c","usr.sbin/eigrpd/log.c","log_warn",90,111
7,1,35,2,7,"log_warnx@114-121@usr.sbin/eigrpd/log.c","usr.sbin/eigrpd/log.c","log_warnx",114,121
7,1,35,2,7,"log_info@124-131@usr.sbin/eigrpd/log.c","usr.sbin/eigrpd/log.c","log_info",124,131
9,2,41,2,9,"log_debug@134-143@usr.sbin/eigrpd/log.c","usr.sbin/eigrpd/log.c","log_debug",134,143
14,3,76,1,14,"fatal@146-160@usr.sbin/eigrpd/log.c","usr.sbin/eigrpd/log.c","fatal",146,160
5,1,18,1,4,"fatalx@163-167@usr.sbin/eigrpd/log.c","usr.sbin/eigrpd/log.c","fatalx",163,167
12,2,79,1,13,"log_sockaddr@35-48@usr.sbin/eigrpd/logmsg.c","usr.sbin/eigrpd/logmsg.c","log_sockaddr",35,48
10,1,64,1,12,"log_in6addr@51-63@usr.sbin/eigrpd/logmsg.c","usr.sbin/eigrpd/logmsg.c","log_in6addr",51,63
10,1,70,2,12,"log_in6addr_scope@66-78@usr.sbin/eigrpd/logmsg.c","usr.sbin/eigrpd/logmsg.c","log_in6addr_scope",66,78
18,4,110,2,19,"log_addr@81-100@usr.sbin/eigrpd/logmsg.c","usr.sbin/eigrpd/logmsg.c","log_addr",81,100
8,2,61,1,9,"log_prefix@103-112@usr.sbin/eigrpd/logmsg.c","usr.sbin/eigrpd/logmsg.c","log_prefix",103,112
12,4,67,2,12,"log_route_origin@115-127@usr.sbin/eigrpd/logmsg.c","usr.sbin/eigrpd/logmsg.c","log_route_origin",115,127
23,9,84,1,22,"opcode_name@130-152@usr.sbin/eigrpd/logmsg.c","usr.sbin/eigrpd/logmsg.c","opcode_name",130,152
11,3,36,1,10,"af_name@155-165@usr.sbin/eigrpd/logmsg.c","usr.sbin/eigrpd/logmsg.c","af_name",155,165
11,3,37,1,10,"if_type_name@168-178@usr.sbin/eigrpd/logmsg.c","usr.sbin/eigrpd/logmsg.c","if_type_name",168,178
17,6,60,1,16,"dual_state_name@181-197@usr.sbin/eigrpd/logmsg.c","usr.sbin/eigrpd/logmsg.c","dual_state_name",181,197
29,12,108,1,28,"ext_proto_name@200-228@usr.sbin/eigrpd/logmsg.c","usr.sbin/eigrpd/logmsg.c","ext_proto_name",200,228
8,3,85,2,8,"nbr_compare@41-49@usr.sbin/eigrpd/neighbor.c","usr.sbin/eigrpd/neighbor.c","nbr_compare",41,49
4,1,25,2,3,"nbr_pid_compare@52-55@usr.sbin/eigrpd/neighbor.c","usr.sbin/eigrpd/neighbor.c","nbr_pid_compare",52,55
31,6,236,4,37,"nbr_new@58-95@usr.sbin/eigrpd/neighbor.c","usr.sbin/eigrpd/neighbor.c","nbr_new",58,95
16,2,110,1,21,"nbr_init@98-119@usr.sbin/eigrpd/neighbor.c","usr.sbin/eigrpd/neighbor.c","nbr_init",98,119
17,4,143,1,23,"nbr_del@122-145@usr.sbin/eigrpd/neighbor.c","usr.sbin/eigrpd/neighbor.c","nbr_del",122,145
11,4,65,1,14,"nbr_update_peerid@148-162@usr.sbin/eigrpd/neighbor.c","usr.sbin/eigrpd/neighbor.c","nbr_update_peerid",148,162
13,1,93,2,14,"nbr_find@165-179@usr.sbin/eigrpd/neighbor.c","usr.sbin/eigrpd/neighbor.c","nbr_find",165,179
6,1,31,1,5,"nbr_find_peerid@182-187@usr.sbin/eigrpd/neighbor.c","usr.sbin/eigrpd/neighbor.c","nbr_find_peerid",182,187
13,1,106,1,14,"nbr_to_ctl@190-204@usr.sbin/eigrpd/neighbor.c","usr.sbin/eigrpd/neighbor.c","nbr_to_ctl",190,204
22,8,162,1,24,"nbr_clear_ctl@207-231@usr.sbin/eigrpd/neighbor.c","usr.sbin/eigrpd/neighbor.c","nbr_clear_ctl",207,231
7,1,56,3,8,"nbr_timeout@237-245@usr.sbin/eigrpd/neighbor.c","usr.sbin/eigrpd/neighbor.c","nbr_timeout",237,245
8,2,48,1,9,"nbr_start_timeout@248-257@usr.sbin/eigrpd/neighbor.c","usr.sbin/eigrpd/neighbor.c","nbr_start_timeout",248,257
6,3,37,1,5,"nbr_stop_timeout@260-265@usr.sbin/eigrpd/neighbor.c","usr.sbin/eigrpd/neighbor.c","nbr_stop_timeout",260,265
13,1,102,5,16,"gen_eigrp_hdr@47-63@usr.sbin/eigrpd/packet.c","usr.sbin/eigrpd/packet.c","gen_eigrp_hdr",47,63
46,5,350,3,55,"send_packet_v4@67-122@usr.sbin/eigrpd/packet.c","usr.sbin/eigrpd/packet.c","send_packet_v4",67,122
25,5,185,3,30,"send_packet_v6@125-155@usr.sbin/eigrpd/packet.c","usr.sbin/eigrpd/packet.c","send_packet_v6",125,155
71,19,453,4,80,"send_packet@158-238@usr.sbin/eigrpd/packet.c","usr.sbin/eigrpd/packet.c","send_packet",158,238
54,16,316,4,68,"recv_packet_nbr@241-309@usr.sbin/eigrpd/packet.c","usr.sbin/eigrpd/packet.c","recv_packet_nbr",241,309
129,42,809,7,152,"recv_packet_eigrp@312-464@usr.sbin/eigrpd/packet.c","usr.sbin/eigrpd/packet.c","recv_packet_eigrp",312,464
116,26,730,3,138,"recv_packet@468-606@usr.sbin/eigrpd/packet.c","usr.sbin/eigrpd/packet.c","recv_packet",468,606
41,10,227,5,44,"eigrp_hdr_sanity_check@609-653@usr.sbin/eigrpd/packet.c","usr.sbin/eigrpd/packet.c","eigrp_hdr_sanity_check",609,653
28,7,153,3,44,"find_iface@656-700@usr.sbin/eigrpd/packet.c","usr.sbin/eigrpd/packet.c","find_iface",656,700
12,2,76,1,13,"print_mainconf@36-49@usr.sbin/eigrpd/printconf.c","usr.sbin/eigrpd/printconf.c","print_mainconf",36,49
7,2,24,1,6,"print_no@52-58@usr.sbin/eigrpd/printconf.c","usr.sbin/eigrpd/printconf.c","print_no",52,58
5,1,34,1,4,"print_redist_metric@61-65@usr.sbin/eigrpd/printconf.c","usr.sbin/eigrpd/printconf.c","print_redist_metric",61,65
39,9,205,1,41,"print_redistribute@68-109@usr.sbin/eigrpd/printconf.c","usr.sbin/eigrpd/printconf.c","print_redistribute",68,109
16,3,126,1,16,"print_iface@112-128@usr.sbin/eigrpd/printconf.c","usr.sbin/eigrpd/printconf.c","print_iface",112,128
17,1,137,1,17,"print_as@131-148@usr.sbin/eigrpd/printconf.c","usr.sbin/eigrpd/printconf.c","print_as",131,148
9,2,56,2,9,"print_af@151-160@usr.sbin/eigrpd/printconf.c","usr.sbin/eigrpd/printconf.c","print_af",151,160
8,1,38,1,8,"print_config@163-171@usr.sbin/eigrpd/printconf.c","usr.sbin/eigrpd/printconf.c","print_config",163,171
54,13,305,4,63,"send_query@33-96@usr.sbin/eigrpd/query.c","usr.sbin/eigrpd/query.c","send_query",33,96
13,2,75,3,15,"recv_query@99-114@usr.sbin/eigrpd/query.c","usr.sbin/eigrpd/query.c","recv_query",99,114
10,3,37,3,14,"rde_sig_handler@55-69@usr.sbin/eigrpd/rde.c","usr.sbin/eigrpd/rde.c","rde_sig_handler",55,69
42,9,324,2,56,"rde@73-129@usr.sbin/eigrpd/rde.c","usr.sbin/eigrpd/rde.c","rde",73,129
12,1,69,1,15,"rde_shutdown@132-147@usr.sbin/eigrpd/rde.c","usr.sbin/eigrpd/rde.c","rde_shutdown",132,147
5,1,38,4,4,"rde_imsg_compose_parent@150-154@usr.sbin/eigrpd/rde.c","usr.sbin/eigrpd/rde.c","rde_imsg_compose_parent",150,154
6,1,41,5,5,"rde_imsg_compose_eigrpe@157-162@usr.sbin/eigrpd/rde.c","usr.sbin/eigrpd/rde.c","rde_imsg_compose_eigrpe",157,162
119,35,653,3,130,"rde_dispatch_imsg@166-296@usr.sbin/eigrpd/rde.c","usr.sbin/eigrpd/rde.c","rde_dispatch_imsg",166,296
139,35,878,3,149,"rde_dispatch_parent@300-449@usr.sbin/eigrpd/rde.c","usr.sbin/eigrpd/rde.c","rde_dispatch_parent",300,449
11,1,82,1,11,"rde_instance_init@452-463@usr.sbin/eigrpd/rde.c","usr.sbin/eigrpd/rde.c","rde_instance_init",452,463
13,3,94,1,17,"rde_instance_del@466-483@usr.sbin/eigrpd/rde.c","usr.sbin/eigrpd/rde.c","rde_instance_del",466,483
39,6,254,2,42,"rde_send_change_kroute@486-528@usr.sbin/eigrpd/rde.c","usr.sbin/eigrpd/rde.c","rde_send_change_kroute",486,528
39,6,254,2,42,"rde_send_delete_kroute@531-573@usr.sbin/eigrpd/rde.c","usr.sbin/eigrpd/rde.c","rde_send_delete_kroute",531,573
55,30,340,2,59,"eigrp_redistribute@576-635@usr.sbin/eigrpd/rde.c","usr.sbin/eigrpd/rde.c","eigrp_redistribute",576,635
53,10,387,2,61,"rt_redist_set@638-699@usr.sbin/eigrpd/rde.c","usr.sbin/eigrpd/rde.c","rt_redist_set",638,699
12,1,83,3,13,"rt_summary_set@702-715@usr.sbin/eigrpd/rde.c","usr.sbin/eigrpd/rde.c","rt_summary_set",702,715
15,3,107,1,16,"rt_snap@719-735@usr.sbin/eigrpd/rde.c","usr.sbin/eigrpd/rde.c","rt_snap",719,735
35,5,340,2,40,"rt_to_ctl@738-778@usr.sbin/eigrpd/rde.c","usr.sbin/eigrpd/rde.c","rt_to_ctl",738,778
35,10,215,2,38,"rt_dump@781-819@usr.sbin/eigrpd/rde.c","usr.sbin/eigrpd/rde.c","rt_dump",781,819
31,9,199,2,37,"dual_fsm@133-170@usr.sbin/eigrpd/rde_dual.c","usr.sbin/eigrpd/rde_dual.c","dual_fsm",133,170
12,4,85,2,14,"rt_compare@173-187@usr.sbin/eigrpd/rde_dual.c","usr.sbin/eigrpd/rde_dual.c","rt_compare",173,187
8,1,56,2,9,"rt_find@190-199@usr.sbin/eigrpd/rde_dual.c","usr.sbin/eigrpd/rde_dual.c","rt_find",190,199
20,3,151,2,24,"rt_new@202-226@usr.sbin/eigrpd/rde_dual.c","usr.sbin/eigrpd/rde_dual.c","rt_new",202,226
12,3,94,1,13,"rt_del@229-242@usr.sbin/eigrpd/rde_dual.c","usr.sbin/eigrpd/rde_dual.c","rt_del",229,242
8,2,48,2,9,"route_find@245-254@usr.sbin/eigrpd/rde_dual.c","usr.sbin/eigrpd/rde_dual.c","route_find",245,254
26,5,210,3,31,"route_new@257-288@usr.sbin/eigrpd/rde_dual.c","usr.sbin/eigrpd/rde_dual.c","route_new",257,288
10,2,78,2,12,"route_del@291-303@usr.sbin/eigrpd/rde_dual.c","usr.sbin/eigrpd/rde_dual.c","route_del",291,303
8,2,50,2,10,"safe_sum_uint32@306-316@usr.sbin/eigrpd/rde_dual.c","usr.sbin/eigrpd/rde_dual.c","safe_sum_uint32",306,316
8,2,50,2,10,"safe_mul_uint32@319-329@usr.sbin/eigrpd/rde_dual.c","usr.sbin/eigrpd/rde_dual.c","safe_mul_uint32",319,329
5,1,30,1,5,"eigrp_composite_delay@332-337@usr.sbin/eigrpd/rde_dual.c","usr.sbin/eigrpd/rde_dual.c","eigrp_composite_delay",332,337
4,1,14,1,3,"eigrp_real_delay@340-343@usr.sbin/eigrpd/rde_dual.c","usr.sbin/eigrpd/rde_dual.c","eigrp_real_delay",340,343
5,1,20,1,5,"eigrp_composite_bandwidth@346-351@usr.sbin/eigrpd/rde_dual.c","usr.sbin/eigrpd/rde_dual.c","eigrp_composite_bandwidth",346,351
4,1,21,1,7,"eigrp_real_bandwidth@354-361@usr.sbin/eigrpd/rde_dual.c","usr.sbin/eigrpd/rde_dual.c","eigrp_real_bandwidth",354,361
21,3,162,5,32,"route_composite_metric@364-396@usr.sbin/eigrpd/rde_dual.c","usr.sbin/eigrpd/rde_dual.c","route_composite_metric",364,396
29,3,239,3,40,"route_update_metrics@399-439@usr.sbin/eigrpd/rde_dual.c","usr.sbin/eigrpd/rde_dual.c","route_update_metrics",399,439
18,3,137,2,20,"reply_outstanding_add@442-462@usr.sbin/eigrpd/rde_dual.c","usr.sbin/eigrpd/rde_dual.c","reply_outstanding_add",442,462
8,2,48,2,9,"reply_outstanding_find@465-474@usr.sbin/eigrpd/rde_dual.c","usr.sbin/eigrpd/rde_dual.c","reply_outstanding_find",465,474
8,1,52,1,7,"reply_outstanding_remove@477-484@usr.sbin/eigrpd/rde_dual.c","usr.sbin/eigrpd/rde_dual.c","reply_outstanding_remove",477,484
8,1,60,3,9,"reply_active_timer@488-497@usr.sbin/eigrpd/rde_dual.c","usr.sbin/eigrpd/rde_dual.c","reply_active_timer",488,497
9,2,61,1,9,"reply_active_start_timer@500-509@usr.sbin/eigrpd/rde_dual.c","usr.sbin/eigrpd/rde_dual.c","reply_active_start_timer",500,509
6,3,37,1,5,"reply_active_stop_timer@512-517@usr.sbin/eigrpd/rde_dual.c","usr.sbin/eigrpd/rde_dual.c","reply_active_stop_timer",512,517
24,4,170,3,37,"reply_sia_timer@521-558@usr.sbin/eigrpd/rde_dual.c","usr.sbin/eigrpd/rde_dual.c","reply_sia_timer",521,558
9,2,65,1,14,"reply_sia_start_timer@561-575@usr.sbin/eigrpd/rde_dual.c","usr.sbin/eigrpd/rde_dual.c","reply_sia_start_timer",561,575
6,3,37,1,5,"reply_sia_stop_timer@578-583@usr.sbin/eigrpd/rde_dual.c","usr.sbin/eigrpd/rde_dual.c","reply_sia_stop_timer",578,583
15,3,114,2,15,"rinfo_fill_successor@586-601@usr.sbin/eigrpd/rde_dual.c","usr.sbin/eigrpd/rde_dual.c","rinfo_fill_successor",586,601
9,1,71,3,8,"rinfo_fill_infinite@604-612@usr.sbin/eigrpd/rde_dual.c","usr.sbin/eigrpd/rde_dual.c","rinfo_fill_infinite",604,612
37,12,221,1,51,"rt_update_fib@615-666@usr.sbin/eigrpd/rde_dual.c","usr.sbin/eigrpd/rde_dual.c","rt_update_fib",615,666
29,3,235,2,30,"rt_set_successor@669-699@usr.sbin/eigrpd/rde_dual.c","usr.sbin/eigrpd/rde_dual.c","rt_set_successor",669,699
22,7,130,1,36,"rt_get_successor_fc@702-738@usr.sbin/eigrpd/rde_dual.c","usr.sbin/eigrpd/rde_dual.c","rt_get_successor_fc",702,738
15,5,104,3,18,"rde_summary_check@741-759@usr.sbin/eigrpd/rde_dual.c","usr.sbin/eigrpd/rde_dual.c","rde_summary_check",741,759
10,3,84,2,10,"rde_send_update@762-772@usr.sbin/eigrpd/rde_dual.c","usr.sbin/eigrpd/rde_dual.c","rde_send_update",762,772
11,4,72,2,12,"rde_send_update_all@775-787@usr.sbin/eigrpd/rde_dual.c","usr.sbin/eigrpd/rde_dual.c","rde_send_update_all",775,787
8,2,55,3,7,"rde_send_query@790-797@usr.sbin/eigrpd/rde_dual.c","usr.sbin/eigrpd/rde_dual.c","rde_send_query",790,797
7,1,48,2,6,"rde_send_siaquery@800-806@usr.sbin/eigrpd/rde_dual.c","usr.sbin/eigrpd/rde_dual.c","rde_send_siaquery",800,806
22,9,159,3,28,"rde_send_query_all@809-837@usr.sbin/eigrpd/rde_dual.c","usr.sbin/eigrpd/rde_dual.c","rde_send_query_all",809,837
9,1,53,1,9,"rde_flush_queries@840-849@usr.sbin/eigrpd/rde_dual.c","usr.sbin/eigrpd/rde_dual.c","rde_flush_queries",840,849
14,4,106,3,16,"rde_send_reply@852-868@usr.sbin/eigrpd/rde_dual.c","usr.sbin/eigrpd/rde_dual.c","rde_send_reply",852,868
50,13,296,2,65,"rde_check_update@871-936@usr.sbin/eigrpd/rde_dual.c","usr.sbin/eigrpd/rde_dual.c","rde_check_update",871,936
80,19,493,3,104,"rde_check_query@939-1043@usr.sbin/eigrpd/rde_dual.c","usr.sbin/eigrpd/rde_dual.c","rde_check_query",939,1043
60,11,360,1,86,"rde_last_reply@1046-1132@usr.sbin/eigrpd/rde_dual.c","usr.sbin/eigrpd/rde_dual.c","rde_last_reply",1046,1132
34,9,195,3,40,"rde_check_reply@1135-1175@usr.sbin/eigrpd/rde_dual.c","usr.sbin/eigrpd/rde_dual.c","rde_check_reply",1135,1175
43,10,244,3,54,"rde_check_link_down_rn@1178-1232@usr.sbin/eigrpd/rde_dual.c","usr.sbin/eigrpd/rde_dual.c","rde_check_link_down_rn",1178,1232
14,3,88,1,14,"rde_check_link_down_nbr@1235-1249@usr.sbin/eigrpd/rde_dual.c","usr.sbin/eigrpd/rde_dual.c","rde_check_link_down_nbr",1235,1249
8,2,43,1,9,"rde_check_link_down@1252-1261@usr.sbin/eigrpd/rde_dual.c","usr.sbin/eigrpd/rde_dual.c","rde_check_link_down",1252,1261
3,1,14,2,2,"rde_check_link_cost_change@1264-1266@usr.sbin/eigrpd/rde_dual.c","usr.sbin/eigrpd/rde_dual.c","rde_check_link_cost_change",1264,1266
4,1,25,2,3,"rde_nbr_compare@1269-1272@usr.sbin/eigrpd/rde_dual.c","usr.sbin/eigrpd/rde_dual.c","rde_nbr_compare",1269,1272
6,1,31,1,7,"rde_nbr_find@1275-1282@usr.sbin/eigrpd/rde_dual.c","usr.sbin/eigrpd/rde_dual.c","rde_nbr_find",1275,1282
18,5,136,2,21,"rde_nbr_new@1285-1306@usr.sbin/eigrpd/rde_dual.c","usr.sbin/eigrpd/rde_dual.c","rde_nbr_new",1285,1306
12,4,80,2,14,"rde_nbr_del@1309-1323@usr.sbin/eigrpd/rde_dual.c","usr.sbin/eigrpd/rde_dual.c","rde_nbr_del",1309,1323
53,13,300,3,63,"send_reply@33-96@usr.sbin/eigrpd/reply.c","usr.sbin/eigrpd/reply.c","send_reply",33,96
13,2,75,3,21,"recv_reply@99-120@usr.sbin/eigrpd/reply.c","usr.sbin/eigrpd/reply.c","recv_reply",99,120
8,2,49,1,9,"rtp_buf_new@41-50@usr.sbin/eigrpd/rtp.c","usr.sbin/eigrpd/rtp.c","rtp_buf_new",41,50
5,1,19,1,4,"rtp_buf_hold@53-57@usr.sbin/eigrpd/rtp.c","usr.sbin/eigrpd/rtp.c","rtp_buf_hold",53,57
7,2,32,1,6,"rtp_buf_release@60-66@usr.sbin/eigrpd/rtp.c","usr.sbin/eigrpd/rtp.c","rtp_buf_release",60,66
12,2,90,3,14,"rtp_packet_new@69-83@usr.sbin/eigrpd/rtp.c","usr.sbin/eigrpd/rtp.c","rtp_packet_new",69,83
7,1,40,1,6,"rtp_packet_del@86-92@usr.sbin/eigrpd/rtp.c","usr.sbin/eigrpd/rtp.c","rtp_packet_del",86,92
14,4,95,2,19,"rtp_process_ack@95-114@usr.sbin/eigrpd/rtp.c","usr.sbin/eigrpd/rtp.c","rtp_process_ack",95,114
5,1,35,1,4,"rtp_send_packet@117-121@usr.sbin/eigrpd/rtp.c","usr.sbin/eigrpd/rtp.c","rtp_send_packet",117,121
6,2,40,1,7,"rtp_enqueue_packet@124-131@usr.sbin/eigrpd/rtp.c","usr.sbin/eigrpd/rtp.c","rtp_enqueue_packet",124,131
6,2,28,1,8,"rtp_seq_inc@134-142@usr.sbin/eigrpd/rtp.c","usr.sbin/eigrpd/rtp.c","rtp_seq_inc",134,142
10,1,65,2,10,"rtp_send_ucast@145-155@usr.sbin/eigrpd/rtp.c","usr.sbin/eigrpd/rtp.c","rtp_send_ucast",145,155
44,8,289,2,58,"rtp_send_mcast@158-216@usr.sbin/eigrpd/rtp.c","usr.sbin/eigrpd/rtp.c","rtp_send_mcast",158,216
7,2,38,3,6,"rtp_send@219-225@usr.sbin/eigrpd/rtp.c","usr.sbin/eigrpd/rtp.c","rtp_send",219,225
15,3,102,1,19,"rtp_send_ack@228-247@usr.sbin/eigrpd/rtp.c","usr.sbin/eigrpd/rtp.c","rtp_send_ack",228,247
13,2,84,3,15,"rtp_retrans_timer@253-268@usr.sbin/eigrpd/rtp.c","usr.sbin/eigrpd/rtp.c","rtp_retrans_timer",253,268
8,2,46,1,8,"rtp_retrans_start_timer@271-279@usr.sbin/eigrpd/rtp.c","usr.sbin/eigrpd/rtp.c","rtp_retrans_start_timer",271,279
6,3,37,1,5,"rtp_retrans_stop_timer@282-287@usr.sbin/eigrpd/rtp.c","usr.sbin/eigrpd/rtp.c","rtp_retrans_stop_timer",282,287
5,1,26,3,5,"rtp_ack_timer@291-296@usr.sbin/eigrpd/rtp.c","usr.sbin/eigrpd/rtp.c","rtp_ack_timer",291,296
8,2,46,1,8,"rtp_ack_start_timer@299-307@usr.sbin/eigrpd/rtp.c","usr.sbin/eigrpd/rtp.c","rtp_ack_start_timer",299,307
6,3,37,1,5,"rtp_ack_stop_timer@310-315@usr.sbin/eigrpd/rtp.c","usr.sbin/eigrpd/rtp.c","rtp_ack_stop_timer",310,315
17,2,142,3,18,"gen_parameter_tlv@31-49@usr.sbin/eigrpd/tlv.c","usr.sbin/eigrpd/tlv.c","gen_parameter_tlv",31,49
36,7,225,2,41,"gen_sequence_tlv@52-93@usr.sbin/eigrpd/tlv.c","usr.sbin/eigrpd/tlv.c","gen_sequence_tlv",52,93
20,3,135,1,21,"gen_sw_version_tlv@96-117@usr.sbin/eigrpd/tlv.c","usr.sbin/eigrpd/tlv.c","gen_sw_version_tlv",96,117
8,1,59,2,9,"gen_mcast_seq_tlv@120-129@usr.sbin/eigrpd/tlv.c","usr.sbin/eigrpd/tlv.c","gen_mcast_seq_tlv",120,129
21,4,116,1,24,"len_route_tlv@132-156@usr.sbin/eigrpd/tlv.c","usr.sbin/eigrpd/tlv.c","len_route_tlv",132,156
87,19,585,2,100,"gen_route_tlv@159-259@usr.sbin/eigrpd/tlv.c","usr.sbin/eigrpd/tlv.c","gen_route_tlv",159,259
10,2,57,2,10,"tlv_decode_parameter@262-272@usr.sbin/eigrpd/tlv.c","usr.sbin/eigrpd/tlv.c","tlv_decode_parameter",262,272
49,9,255,4,53,"tlv_decode_seq@275-328@usr.sbin/eigrpd/tlv.c","usr.sbin/eigrpd/tlv.c","tlv_decode_seq",275,328
10,2,57,2,10,"tlv_decode_sw_version@331-341@usr.sbin/eigrpd/tlv.c","usr.sbin/eigrpd/tlv.c","tlv_decode_sw_version",331,341
10,2,57,2,10,"tlv_decode_mcast_seq@344-354@usr.sbin/eigrpd/tlv.c","usr.sbin/eigrpd/tlv.c","tlv_decode_mcast_seq",344,354
86,15,669,4,114,"tlv_decode_route@357-471@usr.sbin/eigrpd/tlv.c","usr.sbin/eigrpd/tlv.c","tlv_decode_route",357,471
6,1,50,2,5,"metric_encode_mtu@474-479@usr.sbin/eigrpd/tlv.c","usr.sbin/eigrpd/tlv.c","metric_encode_mtu",474,479
4,1,36,1,3,"metric_decode_mtu@482-485@usr.sbin/eigrpd/tlv.c","usr.sbin/eigrpd/tlv.c","metric_decode_mtu",482,485
50,11,283,4,58,"send_update@33-91@usr.sbin/eigrpd/update.c","usr.sbin/eigrpd/update.c","send_update",33,91
16,3,103,3,24,"recv_update@94-118@usr.sbin/eigrpd/update.c","usr.sbin/eigrpd/update.c","recv_update",94,118
7,2,32,1,6,"mask2prefixlen@30-36@usr.sbin/eigrpd/util.c","usr.sbin/eigrpd/util.c","mask2prefixlen",30,36
39,11,175,1,45,"mask2prefixlen6@39-84@usr.sbin/eigrpd/util.c","usr.sbin/eigrpd/util.c","mask2prefixlen6",39,84
6,2,33,1,6,"prefixlen2mask@87-93@usr.sbin/eigrpd/util.c","usr.sbin/eigrpd/util.c","prefixlen2mask",87,93
12,3,82,1,13,"prefixlen2mask6@96-109@usr.sbin/eigrpd/util.c","usr.sbin/eigrpd/util.c","prefixlen2mask6",96,109
24,6,167,4,25,"eigrp_applymask@112-137@usr.sbin/eigrpd/util.c","usr.sbin/eigrpd/util.c","eigrp_applymask",112,137
13,5,109,3,12,"eigrp_addrcmp@140-152@usr.sbin/eigrpd/util.c","usr.sbin/eigrpd/util.c","eigrp_addrcmp",140,152
18,6,80,2,18,"eigrp_addrisset@155-173@usr.sbin/eigrpd/util.c","usr.sbin/eigrpd/util.c","eigrp_addrisset",155,173
38,11,292,4,38,"eigrp_prefixcmp@176-214@usr.sbin/eigrpd/util.c","usr.sbin/eigrpd/util.c","eigrp_prefixcmp",176,214
9,5,62,1,10,"bad_addr_v4@217-227@usr.sbin/eigrpd/util.c","usr.sbin/eigrpd/util.c","bad_addr_v4",217,227
11,7,51,1,11,"bad_addr_v6@230-241@usr.sbin/eigrpd/util.c","usr.sbin/eigrpd/util.c","bad_addr_v6",230,241
11,3,52,2,10,"bad_addr@244-254@usr.sbin/eigrpd/util.c","usr.sbin/eigrpd/util.c","bad_addr",244,254
14,3,106,1,14,"embedscope@257-271@usr.sbin/eigrpd/util.c","usr.sbin/eigrpd/util.c","embedscope",257,271
13,3,100,1,14,"recoverscope@274-288@usr.sbin/eigrpd/util.c","usr.sbin/eigrpd/util.c","recoverscope",274,288
8,3,52,2,8,"addscope@291-299@usr.sbin/eigrpd/util.c","usr.sbin/eigrpd/util.c","addscope",291,299
7,2,36,1,6,"clearscope@302-308@usr.sbin/eigrpd/util.c","usr.sbin/eigrpd/util.c","clearscope",302,308
18,3,106,3,18,"sa2addr@311-329@usr.sbin/eigrpd/util.c","usr.sbin/eigrpd/util.c","sa2addr",311,329
30,5,238,9,32,"format_track@61-93@usr.sbin/fdformat/fdformat.c","usr.sbin/fdformat/fdformat.c","format_track",61,93
32,9,211,3,34,"verify_track@96-130@usr.sbin/fdformat/fdformat.c","usr.sbin/fdformat/fdformat.c","verify_track",96,130
24,1,108,1,23,"usage@133-156@usr.sbin/fdformat/fdformat.c","usr.sbin/fdformat/fdformat.c","usage",133,156
16,11,117,1,16,"yes@159-175@usr.sbin/fdformat/fdformat.c","usr.sbin/fdformat/fdformat.c","yes",159,175
165,57,1051,2,191,"main@178-369@usr.sbin/fdformat/fdformat.c","usr.sbin/fdformat/fdformat.c","main",178,369
14,2,136,2,13,"add_addr@53-66@usr.sbin/ftp-proxy/filter.c","usr.sbin/ftp-proxy/filter.c","add_addr",53,66
22,11,198,8,25,"add_nat@69-94@usr.sbin/ftp-proxy/filter.c","usr.sbin/ftp-proxy/filter.c","add_nat",69,94
20,10,181,8,23,"add_rdr@97-120@usr.sbin/ftp-proxy/filter.c","usr.sbin/ftp-proxy/filter.c","add_rdr",97,120
6,2,32,1,6,"do_commit@123-129@usr.sbin/ftp-proxy/filter.c","usr.sbin/ftp-proxy/filter.c","do_commit",123,129
6,2,32,1,6,"do_rollback@132-138@usr.sbin/ftp-proxy/filter.c","usr.sbin/ftp-proxy/filter.c","do_rollback",132,138
17,6,107,3,19,"init_filter@141-160@usr.sbin/ftp-proxy/filter.c","usr.sbin/ftp-proxy/filter.c","init_filter",141,160
16,2,115,1,19,"prepare_commit@163-182@usr.sbin/ftp-proxy/filter.c","usr.sbin/ftp-proxy/filter.c","prepare_commit",163,182
56,8,578,4,68,"prepare_rule@185-253@usr.sbin/ftp-proxy/filter.c","usr.sbin/ftp-proxy/filter.c","prepare_rule",185,253
15,5,119,3,16,"client_error@127-143@usr.sbin/ftp-proxy/ftp-proxy.c","usr.sbin/ftp-proxy/ftp-proxy.c","client_error",127,143
17,12,132,1,29,"client_parse@146-175@usr.sbin/ftp-proxy/ftp-proxy.c","usr.sbin/ftp-proxy/ftp-proxy.c","client_parse",146,175
14,3,88,1,18,"client_parse_anon@178-196@usr.sbin/ftp-proxy/ftp-proxy.c","usr.sbin/ftp-proxy/ftp-proxy.c","client_parse_anon",178,196
29,11,226,1,31,"client_parse_cmd@199-230@usr.sbin/ftp-proxy/ftp-proxy.c","usr.sbin/ftp-proxy/ftp-proxy.c","client_parse_cmd",199,230
26,5,163,2,28,"client_read@233-261@usr.sbin/ftp-proxy/ftp-proxy.c","usr.sbin/ftp-proxy/ftp-proxy.c","client_read",233,261
14,7,105,1,16,"drop_privs@264-280@usr.sbin/ftp-proxy/ftp-proxy.c","usr.sbin/ftp-proxy/ftp-proxy.c","drop_privs",264,280
30,12,208,1,37,"end_session@283-320@usr.sbin/ftp-proxy/ftp-proxy.c","usr.sbin/ftp-proxy/ftp-proxy.c","end_session",283,320
11,3,61,1,13,"exit_daemon@323-336@usr.sbin/ftp-proxy/ftp-proxy.c","usr.sbin/ftp-proxy/ftp-proxy.c","exit_daemon",323,336
26,8,162,2,34,"get_line@339-373@usr.sbin/ftp-proxy/ftp-proxy.c","usr.sbin/ftp-proxy/ftp-proxy.c","get_line",339,373
121,24,906,3,165,"handle_connection@376-541@usr.sbin/ftp-proxy/ftp-proxy.c","usr.sbin/ftp-proxy/ftp-proxy.c","handle_connection",376,541
5,1,27,3,9,"handle_signal@544-553@usr.sbin/ftp-proxy/ftp-proxy.c","usr.sbin/ftp-proxy/ftp-proxy.c","handle_signal",544,553
21,2,128,1,24,"init_session@557-581@usr.sbin/ftp-proxy/ftp-proxy.c","usr.sbin/ftp-proxy/ftp-proxy.c","init_session",557,581
17,3,102,3,23,"logmsg@584-607@usr.sbin/ftp-proxy/ftp-proxy.c","usr.sbin/ftp-proxy/ftp-proxy.c","logmsg",584,607
176,45,1098,2,207,"main@610-817@usr.sbin/ftp-proxy/ftp-proxy.c","usr.sbin/ftp-proxy/ftp-proxy.c","main",610,817
45,33,456,1,48,"parse_port@820-868@usr.sbin/ftp-proxy/ftp-proxy.c","usr.sbin/ftp-proxy/ftp-proxy.c","parse_port",820,868
5,1,18,1,5,"pick_proxy_port@871-876@usr.sbin/ftp-proxy/ftp-proxy.c","usr.sbin/ftp-proxy/ftp-proxy.c","pick_proxy_port",871,876
40,13,248,3,43,"proxy_reply@879-922@usr.sbin/ftp-proxy/ftp-proxy.c","usr.sbin/ftp-proxy/ftp-proxy.c","proxy_reply",879,922
15,5,119,3,16,"server_error@925-941@usr.sbin/ftp-proxy/ftp-proxy.c","usr.sbin/ftp-proxy/ftp-proxy.c","server_error",925,941
12,8,98,1,14,"server_parse@944-958@usr.sbin/ftp-proxy/ftp-proxy.c","usr.sbin/ftp-proxy/ftp-proxy.c","server_parse",944,958
70,21,543,1,111,"allow_data_connection@961-1072@usr.sbin/ftp-proxy/ftp-proxy.c","usr.sbin/ftp-proxy/ftp-proxy.c","allow_data_connection",961,1072
27,5,172,2,30,"server_read@1075-1105@usr.sbin/ftp-proxy/ftp-proxy.c","usr.sbin/ftp-proxy/ftp-proxy.c","server_read",1075,1105
17,3,132,1,23,"sock_ntop@1108-1131@usr.sbin/ftp-proxy/ftp-proxy.c","usr.sbin/ftp-proxy/ftp-proxy.c","sock_ntop",1108,1131
8,1,23,1,7,"usage@1134-1141@usr.sbin/ftp-proxy/ftp-proxy.c","usr.sbin/ftp-proxy/ftp-proxy.c","usage",1134,1141
25,7,138,1,28,"rdaemon@1144-1172@usr.sbin/ftp-proxy/ftp-proxy.c","usr.sbin/ftp-proxy/ftp-proxy.c","rdaemon",1144,1172
105,34,754,2,118,"main@70-188@usr.sbin/gpioctl/gpioctl.c","usr.sbin/gpioctl/gpioctl.c","main",70,188
10,3,62,1,12,"getinfo@191-203@usr.sbin/gpioctl/gpioctl.c","usr.sbin/gpioctl/gpioctl.c","getinfo",191,203
17,5,112,2,20,"pinread@206-226@usr.sbin/gpioctl/gpioctl.c","usr.sbin/gpioctl/gpioctl.c","pinread",206,226
27,12,209,3,30,"pinwrite@229-259@usr.sbin/gpioctl/gpioctl.c","usr.sbin/gpioctl/gpioctl.c","pinwrite",229,259
35,13,270,4,39,"pinset@262-301@usr.sbin/gpioctl/gpioctl.c","usr.sbin/gpioctl/gpioctl.c","pinset",262,301
11,3,79,2,12,"unset@304-316@usr.sbin/gpioctl/gpioctl.c","usr.sbin/gpioctl/gpioctl.c","unset",304,316
11,2,90,4,11,"devattach@319-330@usr.sbin/gpioctl/gpioctl.c","usr.sbin/gpioctl/gpioctl.c","devattach",319,330
8,2,63,1,8,"devdetach@333-341@usr.sbin/gpioctl/gpioctl.c","usr.sbin/gpioctl/gpioctl.c","devdetach",333,341
13,1,63,1,14,"usage@343-357@usr.sbin/gpioctl/gpioctl.c","usr.sbin/gpioctl/gpioctl.c","usage",343,357
20,4,141,2,24,"hostapd_apme_add@52-76@usr.sbin/hostapd/apme.c","usr.sbin/hostapd/apme.c","hostapd_apme_add",52,76
27,2,219,1,30,"hostapd_apme_deauth@79-109@usr.sbin/hostapd/apme.c","usr.sbin/hostapd/apme.c","hostapd_apme_deauth",79,109
9,2,55,2,10,"hostapd_apme_lookup@112-122@usr.sbin/hostapd/apme.c","usr.sbin/hostapd/apme.c","hostapd_apme_lookup",112,122
17,4,141,2,18,"hostapd_apme_addhopper@125-143@usr.sbin/hostapd/apme.c","usr.sbin/hostapd/apme.c","hostapd_apme_addhopper",125,143
12,4,106,2,13,"hostapd_apme_sethopper@146-159@usr.sbin/hostapd/apme.c","usr.sbin/hostapd/apme.c","hostapd_apme_sethopper",146,159
24,5,161,3,28,"hostapd_apme_hopper@162-190@usr.sbin/hostapd/apme.c","usr.sbin/hostapd/apme.c","hostapd_apme_hopper",162,190
19,4,128,1,27,"hostapd_apme_term@193-220@usr.sbin/hostapd/apme.c","usr.sbin/hostapd/apme.c","hostapd_apme_term",193,220
23,4,164,3,36,"hostapd_apme_input@223-259@usr.sbin/hostapd/apme.c","usr.sbin/hostapd/apme.c","hostapd_apme_input",223,259
43,8,355,2,49,"hostapd_apme_output@262-311@usr.sbin/hostapd/apme.c","usr.sbin/hostapd/apme.c","hostapd_apme_output",262,311
20,6,135,3,24,"hostapd_apme_offset@314-338@usr.sbin/hostapd/apme.c","usr.sbin/hostapd/apme.c","hostapd_apme_offset",314,338
48,15,359,3,71,"hostapd_apme_frame@341-412@usr.sbin/hostapd/apme.c","usr.sbin/hostapd/apme.c","hostapd_apme_frame",341,412
28,6,261,1,38,"hostapd_apme_init@415-453@usr.sbin/hostapd/apme.c","usr.sbin/hostapd/apme.c","hostapd_apme_init",415,453
4,1,26,2,3,"hostapd_apme_addnode@456-459@usr.sbin/hostapd/apme.c","usr.sbin/hostapd/apme.c","hostapd_apme_addnode",456,459
4,1,26,2,3,"hostapd_apme_delnode@462-465@usr.sbin/hostapd/apme.c","usr.sbin/hostapd/apme.c","hostapd_apme_delnode",462,465
11,2,80,3,12,"hostapd_handle_input@60-72@usr.sbin/hostapd/handle.c","usr.sbin/hostapd/handle.c","hostapd_handle_input",60,72
13,8,117,5,14,"hostapd_handle_addr@75-89@usr.sbin/hostapd/handle.c","usr.sbin/hostapd/handle.c","hostapd_handle_addr",75,89
14,5,116,6,14,"hostapd_handle_ref@92-106@usr.sbin/hostapd/handle.c","usr.sbin/hostapd/handle.c","hostapd_handle_ref",92,106
136,47,951,4,169,"hostapd_handle_frame@109-278@usr.sbin/hostapd/handle.c","usr.sbin/hostapd/handle.c","hostapd_handle_frame",109,278
84,21,525,7,106,"hostapd_handle_action@281-387@usr.sbin/hostapd/handle.c","usr.sbin/hostapd/handle.c","hostapd_handle_action",281,387
49,7,347,3,68,"hostapd_handle_radiotap@390-458@usr.sbin/hostapd/handle.c","usr.sbin/hostapd/handle.c","hostapd_handle_radiotap",390,458
11,13,86,3,10,"hostapd_cmp@461-471@usr.sbin/hostapd/handle.c","usr.sbin/hostapd/handle.c","hostapd_cmp",461,471
6,1,20,1,5,"hostapd_usage@65-70@usr.sbin/hostapd/hostapd.c","usr.sbin/hostapd/hostapd.c","hostapd_usage",65,70
20,4,116,3,22,"hostapd_log@73-95@usr.sbin/hostapd/hostapd.c","usr.sbin/hostapd/hostapd.c","hostapd_log",73,95
24,6,167,2,27,"hostapd_printf@98-125@usr.sbin/hostapd/hostapd.c","usr.sbin/hostapd/hostapd.c","hostapd_printf",98,125
13,2,69,2,14,"hostapd_fatal@128-142@usr.sbin/hostapd/hostapd.c","usr.sbin/hostapd/hostapd.c","hostapd_fatal",128,142
20,5,110,2,23,"hostapd_check_file_secrecy@145-168@usr.sbin/hostapd/hostapd.c","usr.sbin/hostapd/hostapd.c","hostapd_check_file_secrecy",145,168
16,5,94,1,23,"hostapd_bpf_open@171-194@usr.sbin/hostapd/hostapd.c","usr.sbin/hostapd/hostapd.c","hostapd_bpf_open",171,194
64,11,580,1,96,"hostapd_udp_init@197-293@usr.sbin/hostapd/hostapd.c","usr.sbin/hostapd/hostapd.c","hostapd_udp_init",197,293
10,5,40,3,9,"hostapd_sig_handler@297-306@usr.sbin/hostapd/hostapd.c","usr.sbin/hostapd/hostapd.c","hostapd_sig_handler",297,306
42,11,304,1,56,"hostapd_cleanup@309-365@usr.sbin/hostapd/hostapd.c","usr.sbin/hostapd/hostapd.c","hostapd_cleanup",309,365
102,22,664,2,151,"main@368-519@usr.sbin/hostapd/hostapd.c","usr.sbin/hostapd/hostapd.c","main",368,519
11,3,68,2,11,"hostapd_randval@522-533@usr.sbin/hostapd/hostapd.c","usr.sbin/hostapd/hostapd.c","hostapd_randval",522,533
18,4,134,2,19,"hostapd_table_add@536-555@usr.sbin/hostapd/hostapd.c","usr.sbin/hostapd/hostapd.c","hostapd_table_add",536,555
9,2,55,2,10,"hostapd_table_lookup@558-568@usr.sbin/hostapd/hostapd.c","usr.sbin/hostapd/hostapd.c","hostapd_table_lookup",558,568
12,3,91,2,15,"hostapd_entry_add@571-586@usr.sbin/hostapd/hostapd.c","usr.sbin/hostapd/hostapd.c","hostapd_entry_add",571,586
12,3,89,2,15,"hostapd_entry_lookup@589-604@usr.sbin/hostapd/hostapd.c","usr.sbin/hostapd/hostapd.c","hostapd_entry_lookup",589,604
10,2,74,2,11,"hostapd_entry_update@607-618@usr.sbin/hostapd/hostapd.c","usr.sbin/hostapd/hostapd.c","hostapd_entry_update",607,618
4,1,30,2,3,"hostapd_entry_cmp@621-624@usr.sbin/hostapd/hostapd.c","usr.sbin/hostapd/hostapd.c","hostapd_entry_cmp",621,624
15,2,86,1,19,"hostapd_iapp_init@46-65@usr.sbin/hostapd/iapp.c","usr.sbin/hostapd/iapp.c","hostapd_iapp_init",46,65
12,2,66,1,13,"hostapd_iapp_term@68-81@usr.sbin/hostapd/iapp.c","usr.sbin/hostapd/iapp.c","hostapd_iapp_term",68,81
35,4,278,2,47,"hostapd_iapp_add_notify@84-131@usr.sbin/hostapd/iapp.c","usr.sbin/hostapd/iapp.c","hostapd_iapp_add_notify",84,131
44,6,298,3,54,"hostapd_iapp_radiotap@134-188@usr.sbin/hostapd/iapp.c","usr.sbin/hostapd/iapp.c","hostapd_iapp_radiotap",134,188
91,28,557,3,129,"hostapd_iapp_input@191-320@usr.sbin/hostapd/iapp.c","usr.sbin/hostapd/iapp.c","hostapd_iapp_input",191,320
20,4,166,1,26,"hostapd_llc_init@45-71@usr.sbin/hostapd/llc.c","usr.sbin/hostapd/llc.c","hostapd_llc_init",45,71
20,2,183,2,26,"hostapd_llc_send_xid@74-100@usr.sbin/hostapd/llc.c","usr.sbin/hostapd/llc.c","hostapd_llc_send_xid",74,100
48,6,349,1,51,"ieee80211_hdr@82-133@usr.sbin/hostapd/print-802_11.c","usr.sbin/hostapd/print-802_11.c","ieee80211_hdr",82,133
8,2,51,2,8,"ieee80211_print_element@137-145@usr.sbin/hostapd/print-802_11.c","usr.sbin/hostapd/print-802_11.c","ieee80211_print_element",137,145
18,7,118,2,20,"ieee80211_print_essid@149-169@usr.sbin/hostapd/print-802_11.c","usr.sbin/hostapd/print-802_11.c","ieee80211_print_essid",149,169
136,39,688,1,154,"ieee80211_elements@172-326@usr.sbin/hostapd/print-802_11.c","usr.sbin/hostapd/print-802_11.c","ieee80211_elements",172,326
68,17,293,1,75,"ieee80211_frame@329-404@usr.sbin/hostapd/print-802_11.c","usr.sbin/hostapd/print-802_11.c","ieee80211_frame",329,404
15,5,82,2,15,"ieee80211_any2ieee@407-422@usr.sbin/hostapd/print-802_11.c","usr.sbin/hostapd/print-802_11.c","ieee80211_any2ieee",407,422
7,3,33,1,7,"ieee80211_print@425-432@usr.sbin/hostapd/print-802_11.c","usr.sbin/hostapd/print-802_11.c","ieee80211_print",425,432
8,2,48,2,10,"ieee802_11_if_print@435-445@usr.sbin/hostapd/print-802_11.c","usr.sbin/hostapd/print-802_11.c","ieee802_11_if_print",435,445
155,41,982,2,194,"ieee802_11_radio_if_print@448-642@usr.sbin/hostapd/print-802_11.c","usr.sbin/hostapd/print-802_11.c","ieee802_11_radio_if_print",448,642
11,3,51,4,11,"hostapd_print_ieee80211@645-656@usr.sbin/hostapd/print-802_11.c","usr.sbin/hostapd/print-802_11.c","hostapd_print_ieee80211",645,656
68,17,551,1,104,"hostapd_priv_init@81-185@usr.sbin/hostapd/privsep.c","usr.sbin/hostapd/privsep.c","hostapd_priv_init",81,185
14,3,89,2,14,"hostapd_priv_getapme@188-202@usr.sbin/hostapd/privsep.c","usr.sbin/hostapd/privsep.c","hostapd_priv_getapme",188,202
91,21,669,3,123,"hostapd_priv@205-328@usr.sbin/hostapd/privsep.c","usr.sbin/hostapd/privsep.c","hostapd_priv",205,328
18,4,149,2,21,"hostapd_priv_apme_getnode@334-355@usr.sbin/hostapd/privsep.c","usr.sbin/hostapd/privsep.c","hostapd_priv_apme_getnode",334,355
25,6,181,3,29,"hostapd_priv_apme_setnode@358-387@usr.sbin/hostapd/privsep.c","usr.sbin/hostapd/privsep.c","hostapd_priv_apme_setnode",358,387
18,4,142,1,21,"hostapd_priv_apme_bssid@390-411@usr.sbin/hostapd/privsep.c","usr.sbin/hostapd/privsep.c","hostapd_priv_apme_bssid",390,411
13,3,93,2,15,"hostapd_priv_llc_xid@414-429@usr.sbin/hostapd/privsep.c","usr.sbin/hostapd/privsep.c","hostapd_priv_llc_xid",414,429
19,4,137,3,23,"hostapd_priv_roaming@432-455@usr.sbin/hostapd/privsep.c","usr.sbin/hostapd/privsep.c","hostapd_priv_roaming",432,455
9,3,51,3,9,"hostapd_sig_relay@462-471@usr.sbin/hostapd/privsep.c","usr.sbin/hostapd/privsep.c","hostapd_sig_relay",462,471
5,2,28,3,8,"hostapd_sig_chld@475-483@usr.sbin/hostapd/privsep.c","usr.sbin/hostapd/privsep.c","hostapd_sig_chld",475,483
18,6,94,3,19,"hostapd_may_read@491-510@usr.sbin/hostapd/privsep.c","usr.sbin/hostapd/privsep.c","hostapd_may_read",491,510
18,6,91,3,19,"hostapd_must_read@517-536@usr.sbin/hostapd/privsep.c","usr.sbin/hostapd/privsep.c","hostapd_must_read",517,536
18,6,91,3,19,"hostapd_must_write@543-562@usr.sbin/hostapd/privsep.c","usr.sbin/hostapd/privsep.c","hostapd_must_write",543,562
31,6,248,1,34,"hostapd_roaming_init@49-83@usr.sbin/hostapd/roaming.c","usr.sbin/hostapd/roaming.c","hostapd_roaming_init",49,83
22,7,158,1,23,"hostapd_roaming_term@86-109@usr.sbin/hostapd/roaming.c","usr.sbin/hostapd/roaming.c","hostapd_roaming_term",86,109
28,11,204,3,30,"hostapd_roaming@112-142@usr.sbin/hostapd/roaming.c","usr.sbin/hostapd/roaming.c","hostapd_roaming",112,142
50,8,373,3,56,"hostapd_roaming_addr@146-202@usr.sbin/hostapd/roaming.c","usr.sbin/hostapd/roaming.c","hostapd_roaming_addr",146,202
68,11,490,3,80,"hostapd_roaming_rt@205-285@usr.sbin/hostapd/roaming.c","usr.sbin/hostapd/roaming.c","hostapd_roaming_rt",205,285
4,1,26,2,3,"hostapd_roaming_add@288-291@usr.sbin/hostapd/roaming.c","usr.sbin/hostapd/roaming.c","hostapd_roaming_add",288,291
4,1,26,2,3,"hostapd_roaming_del@294-297@usr.sbin/hostapd/roaming.c","usr.sbin/hostapd/roaming.c","hostapd_roaming_del",294,297
7,1,26,1,6,"usage@44-50@usr.sbin/hostctl/hostctl.c","usr.sbin/hostctl/hostctl.c","usage",44,50
9,3,71,3,13,"kvsetstr@53-66@usr.sbin/hostctl/hostctl.c","usr.sbin/hostctl/hostctl.c","kvsetstr",53,66
22,7,151,3,24,"kvsetfile@69-93@usr.sbin/hostctl/hostctl.c","usr.sbin/hostctl/hostctl.c","kvsetfile",69,93
94,33,675,2,115,"main@96-211@usr.sbin/hostctl/hostctl.c","usr.sbin/hostctl/hostctl.c","main",96,211
67,13,419,2,80,"main@58-138@usr.sbin/hotplugd/hotplugd.c","usr.sbin/hotplugd/hotplugd.c","main",58,138
20,5,138,3,24,"exec_script@141-165@usr.sbin/hotplugd/hotplugd.c","usr.sbin/hotplugd/hotplugd.c","exec_script",141,165
30,7,150,1,34,"sigchild@169-203@usr.sbin/hotplugd/hotplugd.c","usr.sbin/hotplugd/hotplugd.c","sigchild",169,203
4,1,11,1,3,"sigquit@207-210@usr.sbin/hotplugd/hotplugd.c","usr.sbin/hotplugd/hotplugd.c","sigquit",207,210
6,1,25,1,6,"usage@213-219@usr.sbin/hotplugd/hotplugd.c","usr.sbin/hotplugd/hotplugd.c","usage",213,219
31,8,211,1,39,"config_init@38-77@usr.sbin/httpd/config.c","usr.sbin/httpd/config.c","config_init",38,77
20,9,145,2,23,"config_purge@80-103@usr.sbin/httpd/config.c","usr.sbin/httpd/config.c","config_purge",80,103
13,4,83,2,14,"config_setreset@106-120@usr.sbin/httpd/config.c","usr.sbin/httpd/config.c","config_setreset",106,120
8,1,53,2,10,"config_getreset@123-133@usr.sbin/httpd/config.c","usr.sbin/httpd/config.c","config_getreset",123,133
17,3,132,2,22,"config_getcfg@136-158@usr.sbin/httpd/config.c","usr.sbin/httpd/config.c","config_getcfg",136,158
70,16,503,2,86,"config_setserver@161-247@usr.sbin/httpd/config.c","usr.sbin/httpd/config.c","config_setserver",161,247
38,6,295,6,45,"config_settls@250-295@usr.sbin/httpd/config.c","usr.sbin/httpd/config.c","config_settls",250,295
17,5,144,2,22,"config_setserver_tls@298-320@usr.sbin/httpd/config.c","usr.sbin/httpd/config.c","config_setserver_tls",298,320
11,4,85,2,13,"config_getserver_auth@323-336@usr.sbin/httpd/config.c","usr.sbin/httpd/config.c","config_getserver_auth",323,336
130,22,974,3,163,"config_getserver_config@339-502@usr.sbin/httpd/config.c","usr.sbin/httpd/config.c","config_getserver_config",339,502
56,13,441,2,79,"config_getserver@505-584@usr.sbin/httpd/config.c","usr.sbin/httpd/config.c","config_getserver",505,584
34,7,235,8,43,"config_gettls@587-630@usr.sbin/httpd/config.c","usr.sbin/httpd/config.c","config_gettls",587,630
44,9,276,2,54,"config_getserver_tls@633-687@usr.sbin/httpd/config.c","usr.sbin/httpd/config.c","config_getserver_tls",633,687
15,4,110,2,19,"config_setmedia@690-709@usr.sbin/httpd/config.c","usr.sbin/httpd/config.c","config_setmedia",690,709
17,3,116,2,22,"config_getmedia@712-734@usr.sbin/httpd/config.c","usr.sbin/httpd/config.c","config_getmedia",712,734
15,4,114,2,19,"config_setauth@737-756@usr.sbin/httpd/config.c","usr.sbin/httpd/config.c","config_setauth",737,756
17,3,124,2,22,"config_getauth@759-781@usr.sbin/httpd/config.c","usr.sbin/httpd/config.c","config_getauth",759,781
49,9,367,2,57,"control_init@43-100@usr.sbin/httpd/control.c","usr.sbin/httpd/control.c","control_init",43,100
14,3,96,1,16,"control_listen@103-119@usr.sbin/httpd/control.c","usr.sbin/httpd/control.c","control_listen",103,119
7,2,35,1,6,"control_cleanup@122-128@usr.sbin/httpd/control.c","usr.sbin/httpd/control.c","control_cleanup",122,128
36,9,282,3,45,"control_accept@132-177@usr.sbin/httpd/control.c","usr.sbin/httpd/control.c","control_accept",132,177
9,2,42,1,10,"control_connbyfd@180-190@usr.sbin/httpd/control.c","usr.sbin/httpd/control.c","control_connbyfd",180,190
17,3,123,2,22,"control_close@193-215@usr.sbin/httpd/control.c","usr.sbin/httpd/control.c","control_close",193,215
75,19,456,3,85,"control_dispatch_imsg@219-304@usr.sbin/httpd/control.c","usr.sbin/httpd/control.c","control_dispatch_imsg",219,304
9,2,73,2,9,"control_imsg_forward@307-316@usr.sbin/httpd/control.c","usr.sbin/httpd/control.c","control_imsg_forward",307,316
22,6,96,3,29,"parent_sig_handler@71-100@usr.sbin/httpd/httpd.c","usr.sbin/httpd/httpd.c","parent_sig_handler",71,100
7,1,25,1,7,"usage@103-110@usr.sbin/httpd/httpd.c","usr.sbin/httpd/httpd.c","usage",103,110
123,32,846,2,156,"main@113-269@usr.sbin/httpd/httpd.c","usr.sbin/httpd/httpd.c","main",113,269
44,11,306,1,55,"parent_configure@272-327@usr.sbin/httpd/httpd.c","usr.sbin/httpd/httpd.c","parent_configure",272,327
24,7,141,3,30,"parent_reload@330-360@usr.sbin/httpd/httpd.c","usr.sbin/httpd/httpd.c","parent_reload",330,360
4,1,24,1,3,"parent_reopen@363-366@usr.sbin/httpd/httpd.c","usr.sbin/httpd/httpd.c","parent_reopen",363,366
16,5,84,1,18,"parent_configure_done@369-387@usr.sbin/httpd/httpd.c","usr.sbin/httpd/httpd.c","parent_configure_done",369,387
12,2,85,1,15,"parent_shutdown@390-405@usr.sbin/httpd/httpd.c","usr.sbin/httpd/httpd.c","parent_shutdown",390,405
13,2,68,3,14,"parent_dispatch_server@408-422@usr.sbin/httpd/httpd.c","usr.sbin/httpd/httpd.c","parent_dispatch_server",408,422
36,9,197,3,37,"parent_dispatch_logger@425-462@usr.sbin/httpd/httpd.c","usr.sbin/httpd/httpd.c","parent_dispatch_logger",425,462
9,1,62,1,10,"parent_tls_ticket_rekey_start@465-475@usr.sbin/httpd/httpd.c","usr.sbin/httpd/httpd.c","parent_tls_ticket_rekey_start",465,475
15,1,129,3,16,"parent_tls_ticket_rekey@478-494@usr.sbin/httpd/httpd.c","usr.sbin/httpd/httpd.c","parent_tls_ticket_rekey",478,494
16,2,159,7,18,"event_again@501-519@usr.sbin/httpd/httpd.c","usr.sbin/httpd/httpd.c","event_again",501,519
29,6,204,4,30,"expand_string@522-552@usr.sbin/httpd/httpd.c","usr.sbin/httpd/httpd.c","expand_string",522,552
36,12,260,3,50,"canonicalize_host@555-605@usr.sbin/httpd/httpd.c","usr.sbin/httpd/httpd.c","canonicalize_host",555,605
29,5,162,1,38,"url_decode@608-646@usr.sbin/httpd/httpd.c","usr.sbin/httpd/httpd.c","url_decode",608,646
39,18,252,3,52,"canonicalize_path@649-701@usr.sbin/httpd/httpd.c","usr.sbin/httpd/httpd.c","canonicalize_path",649,701
19,5,108,1,26,"path_info@704-730@usr.sbin/httpd/httpd.c","usr.sbin/httpd/httpd.c","path_info",704,730
19,12,160,1,21,"url_encode@733-754@usr.sbin/httpd/httpd.c","usr.sbin/httpd/httpd.c","url_encode",733,754
27,6,175,1,29,"escape_html@757-786@usr.sbin/httpd/httpd.c","usr.sbin/httpd/httpd.c","escape_html",757,786
13,4,94,1,18,"socket_rlimit@789-807@usr.sbin/httpd/httpd.c","usr.sbin/httpd/httpd.c","socket_rlimit",789,807
24,9,160,1,31,"evbuffer_getline@810-841@usr.sbin/httpd/httpd.c","usr.sbin/httpd/httpd.c","evbuffer_getline",810,841
9,4,66,2,10,"get_string@844-854@usr.sbin/httpd/httpd.c","usr.sbin/httpd/httpd.c","get_string",844,854
8,2,47,2,9,"get_data@857-866@usr.sbin/httpd/httpd.c","usr.sbin/httpd/httpd.c","get_data",857,866
53,20,578,3,60,"sockaddr_cmp@869-929@usr.sbin/httpd/httpd.c","usr.sbin/httpd/httpd.c","sockaddr_cmp",869,929
8,3,43,1,9,"prefixlen2mask@932-941@usr.sbin/httpd/httpd.c","usr.sbin/httpd/httpd.c","prefixlen2mask",932,941
15,4,109,2,18,"prefixlen2mask6@944-962@usr.sbin/httpd/httpd.c","usr.sbin/httpd/httpd.c","prefixlen2mask6",944,962
15,3,97,5,15,"accept_reserve@965-980@usr.sbin/httpd/httpd.c","usr.sbin/httpd/httpd.c","accept_reserve",965,980
24,6,175,3,26,"kv_add@983-1009@usr.sbin/httpd/httpd.c","usr.sbin/httpd/httpd.c","kv_add",983,1009
20,3,127,3,25,"kv_set@1012-1037@usr.sbin/httpd/httpd.c","usr.sbin/httpd/httpd.c","kv_set",1012,1037
14,2,82,3,16,"kv_setkey@1040-1056@usr.sbin/httpd/httpd.c","usr.sbin/httpd/httpd.c","kv_setkey",1040,1056
12,2,78,2,15,"kv_delete@1059-1074@usr.sbin/httpd/httpd.c","usr.sbin/httpd/httpd.c","kv_delete",1059,1074
14,5,109,3,16,"kv_extend@1077-1093@usr.sbin/httpd/httpd.c","usr.sbin/httpd/httpd.c","kv_extend",1077,1093
6,2,36,1,6,"kv_purge@1096-1102@usr.sbin/httpd/httpd.c","usr.sbin/httpd/httpd.c","kv_purge",1096,1102
8,1,48,1,7,"kv_free@1105-1112@usr.sbin/httpd/httpd.c","usr.sbin/httpd/httpd.c","kv_free",1105,1112
19,5,131,2,20,"kv_inherit@1115-1135@usr.sbin/httpd/httpd.c","usr.sbin/httpd/httpd.c","kv_inherit",1115,1135
17,7,122,2,18,"kv_log@1138-1156@usr.sbin/httpd/httpd.c","usr.sbin/httpd/httpd.c","kv_log",1138,1156
15,4,94,2,18,"kv_find@1159-1177@usr.sbin/httpd/httpd.c","usr.sbin/httpd/httpd.c","kv_find",1159,1177
4,1,28,2,3,"kv_cmp@1180-1183@usr.sbin/httpd/httpd.c","usr.sbin/httpd/httpd.c","kv_cmp",1180,1183
19,4,138,2,22,"media_add@1188-1210@usr.sbin/httpd/httpd.c","usr.sbin/httpd/httpd.c","media_add",1188,1210
6,1,35,2,6,"media_delete@1213-1219@usr.sbin/httpd/httpd.c","usr.sbin/httpd/httpd.c","media_delete",1213,1219
6,2,36,1,6,"media_purge@1222-1228@usr.sbin/httpd/httpd.c","usr.sbin/httpd/httpd.c","media_purge",1222,1228
17,6,120,2,22,"media_find@1231-1253@usr.sbin/httpd/httpd.c","usr.sbin/httpd/httpd.c","media_find",1231,1253
10,3,71,3,12,"media_find_config@1256-1268@usr.sbin/httpd/httpd.c","usr.sbin/httpd/httpd.c","media_find_config",1256,1268
4,1,28,2,3,"media_cmp@1271-1274@usr.sbin/httpd/httpd.c","usr.sbin/httpd/httpd.c","media_cmp",1271,1274
13,3,100,2,17,"auth_add@1279-1296@usr.sbin/httpd/httpd.c","usr.sbin/httpd/httpd.c","auth_add",1279,1296
9,2,45,2,10,"auth_byid@1299-1309@usr.sbin/httpd/httpd.c","usr.sbin/httpd/httpd.c","auth_byid",1299,1309
4,1,23,2,3,"auth_free@1312-1315@usr.sbin/httpd/httpd.c","usr.sbin/httpd/httpd.c","auth_free",1312,1315
9,2,63,3,8,"print_host@1319-1327@usr.sbin/httpd/httpd.c","usr.sbin/httpd/httpd.c","print_host",1319,1327
12,1,97,4,13,"print_time@1330-1343@usr.sbin/httpd/httpd.c","usr.sbin/httpd/httpd.c","print_time",1330,1343
31,8,187,2,33,"printb_flags@1346-1379@usr.sbin/httpd/httpd.c","usr.sbin/httpd/httpd.c","printb_flags",1346,1379
7,2,36,1,8,"getmonotime@1382-1390@usr.sbin/httpd/httpd.c","usr.sbin/httpd/httpd.c","getmonotime",1382,1390
10,2,48,2,12,"log_init@53-65@usr.sbin/httpd/log.c","usr.sbin/httpd/log.c","log_init",53,65
5,2,19,1,4,"log_procinit@68-72@usr.sbin/httpd/log.c","usr.sbin/httpd/log.c","log_procinit",68,72
4,1,11,1,3,"log_setverbose@75-78@usr.sbin/httpd/log.c","usr.sbin/httpd/log.c","log_setverbose",75,78
4,1,11,1,3,"log_getverbose@81-84@usr.sbin/httpd/log.c","usr.sbin/httpd/log.c","log_getverbose",81,84
7,1,38,3,7,"logit@87-94@usr.sbin/httpd/log.c","usr.sbin/httpd/log.c","logit",87,94
17,3,99,3,19,"vlog@97-116@usr.sbin/httpd/log.c","usr.sbin/httpd/log.c","vlog",97,116
21,3,120,2,25,"log_warn@119-144@usr.sbin/httpd/log.c","usr.sbin/httpd/log.c","log_warn",119,144
7,1,35,2,7,"log_warnx@147-154@usr.sbin/httpd/log.c","usr.sbin/httpd/log.c","log_warnx",147,154
7,1,35,2,7,"log_info@157-164@usr.sbin/httpd/log.c","usr.sbin/httpd/log.c","log_info",157,164
9,2,43,2,9,"log_debug@167-176@usr.sbin/httpd/log.c","usr.sbin/httpd/log.c","log_debug",167,176
17,3,106,3,17,"vfatalc@179-196@usr.sbin/httpd/log.c","usr.sbin/httpd/log.c","vfatalc",179,196
8,1,40,2,8,"fatal@199-207@usr.sbin/httpd/log.c","usr.sbin/httpd/log.c","fatal",199,207
8,1,40,2,8,"fatalx@210-218@usr.sbin/httpd/log.c","usr.sbin/httpd/log.c","fatalx",210,218
4,1,32,2,3,"logger@54-57@usr.sbin/httpd/logger.c","usr.sbin/httpd/logger.c","logger",54,57
5,1,17,1,4,"logger_shutdown@60-64@usr.sbin/httpd/logger.c","usr.sbin/httpd/logger.c","logger_shutdown",60,64
9,3,64,3,12,"logger_init@67-79@usr.sbin/httpd/logger.c","usr.sbin/httpd/logger.c","logger_init",67,79
11,2,62,1,11,"logger_close@82-93@usr.sbin/httpd/logger.c","usr.sbin/httpd/logger.c","logger_close",82,93
26,3,198,1,35,"logger_open_file@96-131@usr.sbin/httpd/logger.c","usr.sbin/httpd/logger.c","logger_open_file",96,131
16,2,95,1,18,"logger_open_fd@134-152@usr.sbin/httpd/logger.c","usr.sbin/httpd/logger.c","logger_open_fd",134,152
30,5,253,1,38,"logger_open_priv@155-193@usr.sbin/httpd/logger.c","usr.sbin/httpd/logger.c","logger_open_priv",155,193
26,8,186,3,32,"logger_open@196-228@usr.sbin/httpd/logger.c","usr.sbin/httpd/logger.c","logger_open",196,228
7,2,32,1,6,"logger_start@231-237@usr.sbin/httpd/logger.c","usr.sbin/httpd/logger.c","logger_start",231,237
26,8,183,1,35,"logger_log@240-275@usr.sbin/httpd/logger.c","usr.sbin/httpd/logger.c","logger_log",240,275
23,7,99,3,23,"logger_dispatch_parent@278-301@usr.sbin/httpd/logger.c","usr.sbin/httpd/logger.c","logger_dispatch_parent",278,301
12,3,53,3,12,"logger_dispatch_server@304-316@usr.sbin/httpd/logger.c","usr.sbin/httpd/logger.c","logger_dispatch_server",304,316
5,2,36,2,4,"match_error@69-73@usr.sbin/httpd/patterns.c","usr.sbin/httpd/patterns.c","match_error",69,73
7,4,52,2,6,"check_capture@76-82@usr.sbin/httpd/patterns.c","usr.sbin/httpd/patterns.c","check_capture",76,82
8,3,54,1,7,"capture_to_close@85-92@usr.sbin/httpd/patterns.c","usr.sbin/httpd/patterns.c","capture_to_close",85,92
26,9,119,2,27,"classend@95-122@usr.sbin/httpd/patterns.c","usr.sbin/httpd/patterns.c","classend",95,122
39,12,164,2,38,"match_class@125-163@usr.sbin/httpd/patterns.c","usr.sbin/httpd/patterns.c","match_class",125,163
21,10,150,3,21,"matchbracketclass@166-187@usr.sbin/httpd/patterns.c","usr.sbin/httpd/patterns.c","matchbracketclass",166,187
19,5,109,4,19,"singlematch@190-209@usr.sbin/httpd/patterns.c","usr.sbin/httpd/patterns.c","singlematch",190,209
23,7,128,3,24,"matchbalance@212-236@usr.sbin/httpd/patterns.c","usr.sbin/httpd/patterns.c","matchbalance",212,236
13,4,88,4,15,"max_expand@239-254@usr.sbin/httpd/patterns.c","usr.sbin/httpd/patterns.c","max_expand",239,254
12,4,77,4,11,"min_expand@257-268@usr.sbin/httpd/patterns.c","usr.sbin/httpd/patterns.c","min_expand",257,268
15,3,111,4,16,"start_capture@271-287@usr.sbin/httpd/patterns.c","usr.sbin/httpd/patterns.c","start_capture",271,287
11,3,93,3,12,"end_capture@290-302@usr.sbin/httpd/patterns.c","usr.sbin/httpd/patterns.c","end_capture",290,302
13,4,92,3,12,"match_capture@305-317@usr.sbin/httpd/patterns.c","usr.sbin/httpd/patterns.c","match_capture",305,317
123,40,617,3,162,"match@320-482@usr.sbin/httpd/patterns.c","usr.sbin/httpd/patterns.c","match",320,482
24,5,134,4,34,"lmemfind@485-519@usr.sbin/httpd/patterns.c","usr.sbin/httpd/patterns.c","lmemfind",485,519
19,6,173,5,19,"push_onecapture@522-541@usr.sbin/httpd/patterns.c","usr.sbin/httpd/patterns.c","push_onecapture",522,541
12,6,101,5,14,"push_captures@544-558@usr.sbin/httpd/patterns.c","usr.sbin/httpd/patterns.c","push_captures",544,558
11,3,59,2,15,"nospecials@562-577@usr.sbin/httpd/patterns.c","usr.sbin/httpd/patterns.c","nospecials",562,577
53,12,381,6,58,"str_find_aux@580-638@usr.sbin/httpd/patterns.c","usr.sbin/httpd/patterns.c","str_find_aux",580,638
15,2,112,5,18,"str_find@641-659@usr.sbin/httpd/patterns.c","usr.sbin/httpd/patterns.c","str_find",641,659
35,7,282,4,40,"str_match@662-702@usr.sbin/httpd/patterns.c","usr.sbin/httpd/patterns.c","str_match",662,702
9,2,59,1,8,"str_match_free@705-713@usr.sbin/httpd/patterns.c","usr.sbin/httpd/patterns.c","str_match_free",705,713
9,3,55,3,9,"proc_ispeer@52-61@usr.sbin/httpd/proc.c","usr.sbin/httpd/proc.c","proc_ispeer",52,61
13,3,75,3,15,"proc_getid@64-79@usr.sbin/httpd/proc.c","usr.sbin/httpd/proc.c","proc_getid",64,79
52,11,398,5,73,"proc_exec@82-155@usr.sbin/httpd/proc.c","usr.sbin/httpd/proc.c","proc_exec",82,155
24,9,191,1,32,"proc_connect@158-190@usr.sbin/httpd/proc.c","usr.sbin/httpd/proc.c","proc_connect",158,190
42,11,301,6,59,"proc_init@193-252@usr.sbin/httpd/proc.c","usr.sbin/httpd/proc.c","proc_init",193,252
24,4,185,4,28,"proc_accept@255-283@usr.sbin/httpd/proc.c","usr.sbin/httpd/proc.c","proc_accept",255,283
42,13,451,3,70,"proc_setup@286-356@usr.sbin/httpd/proc.c","usr.sbin/httpd/proc.c","proc_setup",286,356
30,11,180,1,35,"proc_kill@359-394@usr.sbin/httpd/proc.c","usr.sbin/httpd/proc.c","proc_kill",359,394
34,10,319,3,45,"proc_open@397-442@usr.sbin/httpd/proc.c","usr.sbin/httpd/proc.c","proc_open",397,442
21,6,171,1,26,"proc_close@445-471@usr.sbin/httpd/proc.c","usr.sbin/httpd/proc.c","proc_close",445,471
11,4,76,1,15,"proc_shutdown@474-489@usr.sbin/httpd/proc.c","usr.sbin/httpd/proc.c","proc_shutdown",474,489
17,7,63,3,19,"proc_sig_handler@492-511@usr.sbin/httpd/proc.c","usr.sbin/httpd/proc.c","proc_sig_handler",492,511
64,17,574,6,83,"proc_run@514-597@usr.sbin/httpd/proc.c","usr.sbin/httpd/proc.c","proc_run",514,597
66,16,439,3,83,"proc_dispatch@600-683@usr.sbin/httpd/proc.c","usr.sbin/httpd/proc.c","proc_dispatch",600,683
4,1,23,3,3,"proc_dispatch_null@686-689@usr.sbin/httpd/proc.c","usr.sbin/httpd/proc.c","proc_dispatch_null",686,689
13,3,95,1,14,"imsg_event_add@696-710@usr.sbin/httpd/proc.c","usr.sbin/httpd/proc.c","imsg_event_add",696,710
10,2,75,7,10,"imsg_compose_event@713-723@usr.sbin/httpd/proc.c","usr.sbin/httpd/proc.c","imsg_compose_event",713,723
10,2,77,7,10,"imsg_composev_event@726-736@usr.sbin/httpd/proc.c","usr.sbin/httpd/proc.c","imsg_composev_event",726,736
9,2,57,4,10,"proc_range@739-749@usr.sbin/httpd/proc.c","usr.sbin/httpd/proc.c","proc_range",739,749
12,3,106,8,13,"proc_compose_imsg@752-765@usr.sbin/httpd/proc.c","usr.sbin/httpd/proc.c","proc_compose_imsg",752,765
5,1,48,5,4,"proc_compose@768-772@usr.sbin/httpd/proc.c","usr.sbin/httpd/proc.c","proc_compose",768,772
11,3,106,8,12,"proc_composev_imsg@775-787@usr.sbin/httpd/proc.c","usr.sbin/httpd/proc.c","proc_composev_imsg",775,787
5,1,50,5,4,"proc_composev@790-794@usr.sbin/httpd/proc.c","usr.sbin/httpd/proc.c","proc_composev",790,794
6,1,58,4,5,"proc_forward_imsg@797-802@usr.sbin/httpd/proc.c","usr.sbin/httpd/proc.c","proc_forward_imsg",797,802
6,1,48,3,6,"proc_ibuf@805-811@usr.sbin/httpd/proc.c","usr.sbin/httpd/proc.c","proc_ibuf",805,811
6,1,46,3,6,"proc_iev@814-820@usr.sbin/httpd/proc.c","usr.sbin/httpd/proc.c","proc_iev",814,820
17,6,126,3,18,"proc_flush_imsg@824-842@usr.sbin/httpd/proc.c","usr.sbin/httpd/proc.c","proc_flush_imsg",824,842
5,1,36,2,4,"server@85-89@usr.sbin/httpd/server.c","usr.sbin/httpd/server.c","server",85,89
5,1,18,1,4,"server_shutdown@92-96@usr.sbin/httpd/server.c","usr.sbin/httpd/server.c","server_shutdown",92,96
19,7,162,1,28,"server_privinit@99-127@usr.sbin/httpd/server.c","usr.sbin/httpd/server.c","server_privinit",99,127
23,9,187,3,26,"server_tls_cmp@130-156@usr.sbin/httpd/server.c","usr.sbin/httpd/server.c","server_tls_cmp",130,156
16,4,131,1,19,"server_tls_load_keypair@159-178@usr.sbin/httpd/server.c","usr.sbin/httpd/server.c","server_tls_load_keypair",159,178
22,5,142,1,26,"server_tls_load_ocsp@181-207@usr.sbin/httpd/server.c","usr.sbin/httpd/server.c","server_tls_load_ocsp",181,207
100,17,704,1,113,"server_tls_init@210-323@usr.sbin/httpd/server.c","usr.sbin/httpd/server.c","server_tls_init",210,323
7,1,49,1,7,"server_generate_ticket_key@326-333@usr.sbin/httpd/server.c","usr.sbin/httpd/server.c","server_generate_ticket_key",326,333
13,4,113,3,22,"server_init@336-358@usr.sbin/httpd/server.c","usr.sbin/httpd/server.c","server_init",336,358
16,1,99,1,19,"server_launch@361-380@usr.sbin/httpd/server.c","usr.sbin/httpd/server.c","server_launch",361,380
26,7,175,1,36,"server_purge@383-419@usr.sbin/httpd/server.c","usr.sbin/httpd/server.c","server_purge",383,419
10,1,66,1,9,"serverconfig_free@422-431@usr.sbin/httpd/server.c","usr.sbin/httpd/server.c","serverconfig_free",422,431
11,1,57,1,10,"serverconfig_reset@434-444@usr.sbin/httpd/server.c","usr.sbin/httpd/server.c","serverconfig_reset",434,444
11,3,74,2,12,"server_byaddr@447-459@usr.sbin/httpd/server.c","usr.sbin/httpd/server.c","server_byaddr",447,459
14,3,78,1,15,"serverconfig_byid@462-477@usr.sbin/httpd/server.c","usr.sbin/httpd/server.c","serverconfig_byid",462,477
9,2,44,1,9,"server_byid@480-489@usr.sbin/httpd/server.c","usr.sbin/httpd/server.c","server_byid",480,489
15,3,113,2,16,"server_foreach@492-508@usr.sbin/httpd/server.c","usr.sbin/httpd/server.c","server_foreach",492,508
21,6,137,2,24,"server_match@511-535@usr.sbin/httpd/server.c","usr.sbin/httpd/server.c","server_match",511,535
18,3,103,2,18,"server_socket_af@538-556@usr.sbin/httpd/server.c","usr.sbin/httpd/server.c","server_socket_af",538,556
12,3,63,1,13,"server_socket_getport@559-572@usr.sbin/httpd/server.c","usr.sbin/httpd/server.c","server_socket_getport",559,572
84,27,538,5,99,"server_socket@575-674@usr.sbin/httpd/server.c","usr.sbin/httpd/server.c","server_socket",575,674
15,4,108,3,18,"server_socket_listen@677-695@usr.sbin/httpd/server.c","usr.sbin/httpd/server.c","server_socket_listen",677,695
15,4,99,3,18,"server_socket_connect@698-716@usr.sbin/httpd/server.c","usr.sbin/httpd/server.c","server_socket_connect",698,716
50,13,328,3,59,"server_tls_readcb@719-778@usr.sbin/httpd/server.c","usr.sbin/httpd/server.c","server_tls_readcb",719,778
36,9,228,3,41,"server_tls_writecb@781-822@usr.sbin/httpd/server.c","usr.sbin/httpd/server.c","server_tls_writecb",781,822
37,5,258,1,48,"server_input@825-873@usr.sbin/httpd/server.c","usr.sbin/httpd/server.c","server_input",825,873
19,6,114,2,23,"server_write@876-899@usr.sbin/httpd/server.c","usr.sbin/httpd/server.c","server_write",876,899
9,3,61,3,15,"server_dump@902-917@usr.sbin/httpd/server.c","usr.sbin/httpd/server.c","server_dump",902,917
23,5,144,2,26,"server_read@920-946@usr.sbin/httpd/server.c","usr.sbin/httpd/server.c","server_read",920,946
34,7,172,3,38,"server_error@949-987@usr.sbin/httpd/server.c","usr.sbin/httpd/server.c","server_error",949,987
81,15,558,3,108,"server_accept@990-1098@usr.sbin/httpd/server.c","usr.sbin/httpd/server.c","server_accept",990,1098
28,7,207,3,30,"server_tls_handshake@1101-1131@usr.sbin/httpd/server.c","usr.sbin/httpd/server.c","server_tls_handshake",1101,1131
11,3,52,2,13,"server_inflight_dec@1134-1147@usr.sbin/httpd/server.c","usr.sbin/httpd/server.c","server_inflight_dec",1134,1147
31,5,206,4,34,"server_sendlog@1150-1184@usr.sbin/httpd/server.c","usr.sbin/httpd/server.c","server_sendlog",1150,1184
41,12,314,2,42,"server_log@1187-1229@usr.sbin/httpd/server.c","usr.sbin/httpd/server.c","server_log",1187,1229
32,11,237,2,42,"server_close@1232-1274@usr.sbin/httpd/server.c","usr.sbin/httpd/server.c","server_close",1232,1274
40,10,197,3,42,"server_dispatch_parent@1277-1319@usr.sbin/httpd/server.c","usr.sbin/httpd/server.c","server_dispatch_parent",1277,1319
8,1,40,3,8,"server_dispatch_logger@1322-1330@usr.sbin/httpd/server.c","usr.sbin/httpd/server.c","server_dispatch_logger",1322,1330
10,2,54,2,11,"server_bufferevent_add@1333-1344@usr.sbin/httpd/server.c","usr.sbin/httpd/server.c","server_bufferevent_add",1333,1344
14,2,81,3,17,"server_bufferevent_printf@1347-1364@usr.sbin/httpd/server.c","usr.sbin/httpd/server.c","server_bufferevent_printf",1347,1364
6,2,56,2,5,"server_bufferevent_print@1367-1372@usr.sbin/httpd/server.c","usr.sbin/httpd/server.c","server_bufferevent_print",1367,1372
6,2,46,2,5,"server_bufferevent_write_buffer@1375-1380@usr.sbin/httpd/server.c","usr.sbin/httpd/server.c","server_bufferevent_write_buffer",1375,1380
9,2,52,3,8,"server_bufferevent_write_chunk@1383-1391@usr.sbin/httpd/server.c","usr.sbin/httpd/server.c","server_bufferevent_write_chunk",1383,1391
6,2,52,3,5,"server_bufferevent_write@1394-1399@usr.sbin/httpd/server.c","usr.sbin/httpd/server.c","server_bufferevent_write",1394,1399
4,1,28,2,3,"server_client_cmp@1402-1405@usr.sbin/httpd/server.c","usr.sbin/httpd/server.c","server_client_cmp",1402,1405
267,52,1821,2,320,"server_fcgi@88-408@usr.sbin/httpd/server_fcgi.c","usr.sbin/httpd/server_fcgi.c","server_fcgi",88,408
21,3,144,2,22,"fcgi_add_stdin@411-433@usr.sbin/httpd/server_fcgi.c","usr.sbin/httpd/server_fcgi.c","fcgi_add_stdin",411,433
44,8,376,4,53,"fcgi_add_param@436-489@usr.sbin/httpd/server_fcgi.c","usr.sbin/httpd/server_fcgi.c","fcgi_add_param",436,489
102,20,592,2,107,"server_fcgi_read@492-599@usr.sbin/httpd/server_fcgi.c","usr.sbin/httpd/server_fcgi.c","server_fcgi_read",492,599
54,25,473,2,76,"server_fcgi_header@602-678@usr.sbin/httpd/server_fcgi.c","usr.sbin/httpd/server_fcgi.c","server_fcgi_header",602,678
34,25,313,3,49,"server_fcgi_writeheader@681-730@usr.sbin/httpd/server_fcgi.c","usr.sbin/httpd/server_fcgi.c","server_fcgi_writeheader",681,730
19,9,135,1,22,"server_fcgi_writechunk@733-755@usr.sbin/httpd/server_fcgi.c","usr.sbin/httpd/server_fcgi.c","server_fcgi_writechunk",733,755
30,8,225,1,36,"server_fcgi_getheaders@758-794@usr.sbin/httpd/server_fcgi.c","usr.sbin/httpd/server_fcgi.c","server_fcgi_getheaders",758,794
78,20,492,4,106,"server_file_access@55-161@usr.sbin/httpd/server_file.c","usr.sbin/httpd/server_file.c","server_file_access",55,161
30,7,211,2,36,"server_file@164-200@usr.sbin/httpd/server_file.c","usr.sbin/httpd/server_file.c","server_file",164,200
12,3,48,1,14,"server_file_method@203-217@usr.sbin/httpd/server_file.c","usr.sbin/httpd/server_file.c","server_file_method",203,217
58,10,383,4,69,"server_file_request@220-289@usr.sbin/httpd/server_file.c","usr.sbin/httpd/server_file.c","server_file_request",220,289
104,15,737,5,131,"server_partial_file_request@292-423@usr.sbin/httpd/server_file.c","usr.sbin/httpd/server_file.c","server_partial_file_request",292,423
132,30,849,3,160,"server_file_index@426-586@usr.sbin/httpd/server_file.c","usr.sbin/httpd/server_file.c","server_file_index",426,586
46,11,264,3,57,"server_file_error@589-646@usr.sbin/httpd/server_file.c","usr.sbin/httpd/server_file.c","server_file_error",589,646
15,5,111,2,21,"server_file_modified_since@649-670@usr.sbin/httpd/server_file.c","usr.sbin/httpd/server_file.c","server_file_modified_since",649,670
26,7,197,3,37,"parse_ranges@673-710@usr.sbin/httpd/server_file.c","usr.sbin/httpd/server_file.c","parse_ranges",673,710
36,11,250,3,45,"parse_range_spec@713-758@usr.sbin/httpd/server_file.c","usr.sbin/httpd/server_file.c","parse_range_spec",713,758
10,1,77,1,11,"server_http@56-67@usr.sbin/httpd/server_http.c","usr.sbin/httpd/server_http.c","server_http",56,67
3,1,9,1,3,"server_http_init@70-73@usr.sbin/httpd/server_http.c","usr.sbin/httpd/server_http.c","server_http_init",70,73
14,3,99,1,17,"server_httpdesc_init@76-93@usr.sbin/httpd/server_http.c","usr.sbin/httpd/server_http.c","server_httpdesc_init",76,93
19,2,108,1,20,"server_httpdesc_free@96-116@usr.sbin/httpd/server_http.c","usr.sbin/httpd/server_http.c","server_httpdesc_free",96,116
62,17,454,2,76,"server_http_authenticate@119-195@usr.sbin/httpd/server_http.c","usr.sbin/httpd/server_http.c","server_http_authenticate",119,195
204,74,1095,2,268,"server_read_http@198-466@usr.sbin/httpd/server_http.c","usr.sbin/httpd/server_http.c","server_read_http",198,466
42,9,241,2,46,"server_read_httpcontent@469-515@usr.sbin/httpd/server_http.c","usr.sbin/httpd/server_http.c","server_read_httpcontent",469,515
93,23,521,2,110,"server_read_httpchunks@518-628@usr.sbin/httpd/server_http.c","usr.sbin/httpd/server_http.c","server_read_httpchunks",518,628
77,18,448,2,92,"server_read_httprange@631-723@usr.sbin/httpd/server_http.c","usr.sbin/httpd/server_http.c","server_read_httprange",631,723
17,1,107,1,18,"server_reset_http@726-744@usr.sbin/httpd/server_http.c","usr.sbin/httpd/server_http.c","server_reset_http",726,744
8,3,58,3,9,"server_http_time@747-756@usr.sbin/httpd/server_http.c","usr.sbin/httpd/server_http.c","server_http_time",747,756
25,8,169,3,29,"server_http_host@759-788@usr.sbin/httpd/server_http.c","usr.sbin/httpd/server_http.c","server_http_host",759,788
37,8,252,4,46,"server_http_parsehost@791-837@usr.sbin/httpd/server_http.c","usr.sbin/httpd/server_http.c","server_http_parsehost",791,837
129,31,663,3,155,"server_abort_http@840-995@usr.sbin/httpd/server_http.c","usr.sbin/httpd/server_http.c","server_abort_http",840,995
15,1,79,1,17,"server_close_http@998-1015@usr.sbin/httpd/server_http.c","usr.sbin/httpd/server_http.c","server_close_http",998,1015
137,44,1018,4,145,"server_expand_http@1018-1163@usr.sbin/httpd/server_http.c","usr.sbin/httpd/server_http.c","server_expand_http",1018,1163
106,35,759,2,134,"server_response@1166-1300@usr.sbin/httpd/server_http.c","usr.sbin/httpd/server_http.c","server_response",1166,1300
10,4,67,2,12,"server_root_strip@1303-1315@usr.sbin/httpd/server_http.c","usr.sbin/httpd/server_http.c","server_root_strip",1303,1315
29,8,177,2,34,"server_getlocation@1318-1352@usr.sbin/httpd/server_http.c","usr.sbin/httpd/server_http.c","server_getlocation",1318,1352
65,31,571,5,86,"server_response_http@1355-1441@usr.sbin/httpd/server_http.c","usr.sbin/httpd/server_http.c","server_response_http",1355,1441
13,6,104,1,15,"server_writeresponse_http@1444-1459@usr.sbin/httpd/server_http.c","usr.sbin/httpd/server_http.c","server_writeresponse_http",1444,1459
21,10,159,3,25,"server_writeheader_http@1462-1487@usr.sbin/httpd/server_http.c","usr.sbin/httpd/server_http.c","server_writeheader_http",1462,1487
15,3,125,4,16,"server_headers@1490-1506@usr.sbin/httpd/server_http.c","usr.sbin/httpd/server_http.c","server_headers",1490,1506
11,2,82,1,14,"server_httpmethod_byname@1509-1523@usr.sbin/httpd/server_http.c","usr.sbin/httpd/server_http.c","server_httpmethod_byname",1509,1523
12,3,67,1,13,"server_httpmethod_byid@1526-1539@usr.sbin/httpd/server_http.c","usr.sbin/httpd/server_http.c","server_httpmethod_byid",1526,1539
6,1,44,2,10,"server_httpmethod_cmp@1542-1552@usr.sbin/httpd/server_http.c","usr.sbin/httpd/server_http.c","server_httpmethod_cmp",1542,1552
10,2,77,1,13,"server_httperror_byid@1555-1568@usr.sbin/httpd/server_http.c","usr.sbin/httpd/server_http.c","server_httperror_byid",1555,1568
6,1,41,2,5,"server_httperror_cmp@1571-1576@usr.sbin/httpd/server_http.c","usr.sbin/httpd/server_http.c","server_httperror_cmp",1571,1576
115,46,838,3,145,"server_log_http@1579-1724@usr.sbin/httpd/server_http.c","usr.sbin/httpd/server_http.c","server_log_http",1579,1724
7,1,25,1,6,"usage@194-200@usr.sbin/identd/identd.c","usr.sbin/identd/identd.c","usage",194,200
124,34,718,2,153,"main@222-375@usr.sbin/identd/identd.c","usr.sbin/identd/identd.c","main",222,375
47,13,251,3,53,"parent_rd@378-431@usr.sbin/identd/identd.c","usr.sbin/identd/identd.c","parent_rd",378,431
4,1,31,2,3,"parent_username@434-437@usr.sbin/identd/identd.c","usr.sbin/identd/identd.c","parent_username",434,437
4,1,34,2,3,"parent_uid@440-443@usr.sbin/identd/identd.c","usr.sbin/identd/identd.c","parent_uid",440,443
15,3,86,2,16,"parent_token@446-462@usr.sbin/identd/identd.c","usr.sbin/identd/identd.c","parent_token",446,462
14,4,92,2,16,"parent_noident@465-481@usr.sbin/identd/identd.c","usr.sbin/identd/identd.c","parent_noident",465,481
34,8,236,3,41,"parent_wr@484-525@usr.sbin/identd/identd.c","usr.sbin/identd/identd.c","parent_wr",484,525
68,14,398,3,77,"child_rd@528-605@usr.sbin/identd/identd.c","usr.sbin/identd/identd.c","child_rd",528,605
33,9,202,3,35,"child_wr@608-643@usr.sbin/identd/identd.c","usr.sbin/identd/identd.c","child_wr",608,643
44,9,343,3,54,"identd_listen@646-700@usr.sbin/identd/identd.c","usr.sbin/identd/identd.c","identd_listen",646,700
5,1,31,3,4,"identd_paused@703-707@usr.sbin/identd/identd.c","usr.sbin/identd/identd.c","identd_paused",703,707
42,9,302,3,48,"identd_accept@710-758@usr.sbin/identd/identd.c","usr.sbin/identd/identd.c","identd_accept",710,758
11,2,61,3,12,"identd_timeout@761-773@usr.sbin/identd/identd.c","usr.sbin/identd/identd.c","identd_timeout",761,773
53,16,335,3,65,"identd_request@776-841@usr.sbin/identd/identd.c","usr.sbin/identd/identd.c","identd_request",776,841
15,2,116,2,18,"identd_error@844-862@usr.sbin/identd/identd.c","usr.sbin/identd/identd.c","identd_error",844,862
9,1,53,1,9,"identd_close@865-874@usr.sbin/identd/identd.c","usr.sbin/identd/identd.c","identd_close",865,874
32,6,146,3,40,"identd_resolving@877-917@usr.sbin/identd/identd.c","usr.sbin/identd/identd.c","identd_resolving",877,917
60,34,377,2,81,"identd_parse@920-1001@usr.sbin/identd/identd.c","usr.sbin/identd/identd.c","identd_parse",920,1001
50,13,228,3,57,"identd_response@1004-1061@usr.sbin/identd/identd.c","usr.sbin/identd/identd.c","identd_response",1004,1061
10,2,70,4,10,"syslog_vstrerror@1064-1074@usr.sbin/identd/identd.c","usr.sbin/identd/identd.c","syslog_vstrerror",1064,1074
8,1,45,3,8,"syslog_err@1077-1085@usr.sbin/identd/identd.c","usr.sbin/identd/identd.c","syslog_err",1077,1085
8,1,43,3,8,"syslog_errx@1088-1096@usr.sbin/identd/identd.c","usr.sbin/identd/identd.c","syslog_errx",1088,1096
7,1,37,2,7,"syslog_warn@1099-1106@usr.sbin/identd/identd.c","usr.sbin/identd/identd.c","syslog_warn",1099,1106
7,1,35,2,7,"syslog_warnx@1109-1116@usr.sbin/identd/identd.c","usr.sbin/identd/identd.c","syslog_warnx",1109,1116
7,1,35,2,7,"syslog_notice@1119-1126@usr.sbin/identd/identd.c","usr.sbin/identd/identd.c","syslog_notice",1119,1126
9,2,42,2,10,"syslog_debug@1129-1139@usr.sbin/identd/identd.c","usr.sbin/identd/identd.c","syslog_debug",1129,1139
9,2,64,1,10,"gethost@1142-1152@usr.sbin/identd/identd.c","usr.sbin/identd/identd.c","gethost",1142,1152
13,3,89,1,14,"gentoken@1155-1169@usr.sbin/identd/identd.c","usr.sbin/identd/identd.c","gentoken",1155,1169
36,5,321,1,42,"fetchuid@1172-1214@usr.sbin/identd/identd.c","usr.sbin/identd/identd.c","fetchuid",1172,1214
7,1,25,1,7,"usage@79-86@usr.sbin/ifstated/ifstated.c","usr.sbin/ifstated/ifstated.c","usage",79,86
74,19,423,2,87,"main@89-176@usr.sbin/ifstated/ifstated.c","usr.sbin/ifstated/ifstated.c","main",89,176
13,2,94,3,16,"startup_handler@179-195@usr.sbin/ifstated/ifstated.c","usr.sbin/ifstated/ifstated.c","startup_handler",179,195
6,2,32,3,5,"sighup_handler@198-203@usr.sbin/ifstated/ifstated.c","usr.sbin/ifstated/ifstated.c","sighup_handler",198,203
24,5,161,1,23,"load_config@206-229@usr.sbin/ifstated/ifstated.c","usr.sbin/ifstated/ifstated.c","load_config",206,229
45,12,254,3,50,"rt_msg_handler@232-282@usr.sbin/ifstated/ifstated.c","usr.sbin/ifstated/ifstated.c","rt_msg_handler",232,282
6,2,37,3,5,"sigchld_handler@285-290@usr.sbin/ifstated/ifstated.c","usr.sbin/ifstated/ifstated.c","sigchld_handler",285,290
10,1,74,3,13,"external_handler@293-306@usr.sbin/ifstated/ifstated.c","usr.sbin/ifstated/ifstated.c","external_handler",293,306
30,6,192,2,32,"external_exec@309-341@usr.sbin/ifstated/ifstated.c","usr.sbin/ifstated/ifstated.c","external_exec",309,341
17,2,95,1,19,"adjust_external_expressions@344-363@usr.sbin/ifstated/ifstated.c","usr.sbin/ifstated/ifstated.c","adjust_external_expressions",344,363
37,11,228,1,44,"check_external_status@366-410@usr.sbin/ifstated/ifstated.c","usr.sbin/ifstated/ifstated.c","check_external_status",366,410
32,5,163,2,36,"external_evtimer_setup@413-449@usr.sbin/ifstated/ifstated.c","usr.sbin/ifstated/ifstated.c","external_evtimer_setup",413,449
34,11,193,3,38,"scan_ifstate_single@454-492@usr.sbin/ifstated/ifstated.c","usr.sbin/ifstated/ifstated.c","scan_ifstate_single",454,492
14,7,98,3,15,"scan_ifstate@495-510@usr.sbin/ifstated/ifstated.c","usr.sbin/ifstated/ifstated.c","scan_ifstate",495,510
40,13,222,2,41,"adjust_expressions@518-559@usr.sbin/ifstated/ifstated.c","usr.sbin/ifstated/ifstated.c","adjust_expressions",518,559
13,5,79,1,13,"eval_state@562-575@usr.sbin/ifstated/ifstated.c","usr.sbin/ifstated/ifstated.c","eval_state",562,575
18,4,115,1,17,"state_change@578-595@usr.sbin/ifstated/ifstated.c","usr.sbin/ifstated/ifstated.c","state_change",578,595
25,7,138,1,25,"do_action@601-626@usr.sbin/ifstated/ifstated.c","usr.sbin/ifstated/ifstated.c","do_action",601,626
14,4,85,1,16,"fetch_ifstate@632-648@usr.sbin/ifstated/ifstated.c","usr.sbin/ifstated/ifstated.c","fetch_ifstate",632,648
12,2,64,1,12,"check_ifdeparture@651-663@usr.sbin/ifstated/ifstated.c","usr.sbin/ifstated/ifstated.c","check_ifdeparture",651,663
17,4,138,1,17,"clear_config@666-683@usr.sbin/ifstated/ifstated.c","usr.sbin/ifstated/ifstated.c","clear_config",666,683
23,8,136,2,24,"remove_action@686-710@usr.sbin/ifstated/ifstated.c","usr.sbin/ifstated/ifstated.c","remove_action",686,710
33,7,210,2,32,"remove_expression@713-745@usr.sbin/ifstated/ifstated.c","usr.sbin/ifstated/ifstated.c","remove_expression",713,745
10,2,48,2,12,"log_init@34-46@usr.sbin/ifstated/log.c","usr.sbin/ifstated/log.c","log_init",34,46
5,2,19,1,4,"log_procinit@49-53@usr.sbin/ifstated/log.c","usr.sbin/ifstated/log.c","log_procinit",49,53
4,1,11,1,3,"log_setverbose@56-59@usr.sbin/ifstated/log.c","usr.sbin/ifstated/log.c","log_setverbose",56,59
4,1,11,1,3,"log_getverbose@62-65@usr.sbin/ifstated/log.c","usr.sbin/ifstated/log.c","log_getverbose",62,65
7,1,38,3,7,"logit@68-75@usr.sbin/ifstated/log.c","usr.sbin/ifstated/log.c","logit",68,75
17,3,99,3,19,"vlog@78-97@usr.sbin/ifstated/log.c","usr.sbin/ifstated/log.c","vlog",78,97
21,3,120,2,25,"log_warn@100-125@usr.sbin/ifstated/log.c","usr.sbin/ifstated/log.c","log_warn",100,125
7,1,35,2,7,"log_warnx@128-135@usr.sbin/ifstated/log.c","usr.sbin/ifstated/log.c","log_warnx",128,135
7,1,35,2,7,"log_info@138-145@usr.sbin/ifstated/log.c","usr.sbin/ifstated/log.c","log_info",138,145
9,2,41,2,9,"log_debug@148-157@usr.sbin/ifstated/log.c","usr.sbin/ifstated/log.c","log_debug",148,157
17,3,106,3,17,"vfatalc@160-177@usr.sbin/ifstated/log.c","usr.sbin/ifstated/log.c","vfatalc",160,177
8,1,40,2,8,"fatal@180-188@usr.sbin/ifstated/log.c","usr.sbin/ifstated/log.c","fatal",180,188
8,1,40,2,8,"fatalx@191-199@usr.sbin/ifstated/log.c","usr.sbin/ifstated/log.c","fatalx",191,199
4,1,19,1,3,"ca_delete@124-127@usr.sbin/ikectl/ikeca.c","usr.sbin/ikectl/ikeca.c","ca_delete",124,127
16,2,101,2,20,"ca_key_create@130-150@usr.sbin/ikectl/ikeca.c","usr.sbin/ikectl/ikeca.c","ca_key_create",130,150
12,2,85,3,14,"ca_key_import@153-167@usr.sbin/ikectl/ikeca.c","usr.sbin/ikectl/ikeca.c","ca_key_import",153,167
7,1,47,2,8,"ca_key_delete@170-178@usr.sbin/ikectl/ikeca.c","usr.sbin/ikectl/ikeca.c","ca_key_delete",170,178
13,1,116,2,17,"ca_delkey@181-198@usr.sbin/ikectl/ikeca.c","usr.sbin/ikectl/ikeca.c","ca_delkey",181,198
32,5,236,3,38,"ca_request@201-239@usr.sbin/ikectl/ikeca.c","usr.sbin/ikectl/ikeca.c","ca_request",201,239
29,3,164,3,34,"ca_sign@242-276@usr.sbin/ikectl/ikeca.c","usr.sbin/ikectl/ikeca.c","ca_sign",242,276
29,4,134,4,31,"ca_certificate@279-310@usr.sbin/ikectl/ikeca.c","usr.sbin/ikectl/ikeca.c","ca_certificate",279,310
26,4,183,3,32,"ca_key_install@313-345@usr.sbin/ikectl/ikeca.c","usr.sbin/ikectl/ikeca.c","ca_key_install",313,345
19,3,140,3,24,"ca_cert_install@348-372@usr.sbin/ikectl/ikeca.c","usr.sbin/ikectl/ikeca.c","ca_cert_install",348,372
23,7,158,2,28,"ca_newpass@375-403@usr.sbin/ikectl/ikeca.c","usr.sbin/ikectl/ikeca.c","ca_newpass",375,403
31,1,213,1,38,"ca_create@406-444@usr.sbin/ikectl/ikeca.c","usr.sbin/ikectl/ikeca.c","ca_create",406,444
28,6,216,2,34,"ca_install@447-481@usr.sbin/ikectl/ikeca.c","usr.sbin/ikectl/ikeca.c","ca_install",447,481
38,7,256,2,42,"ca_show_certs@484-526@usr.sbin/ikectl/ikeca.c","usr.sbin/ikectl/ikeca.c","ca_show_certs",484,526
19,4,148,3,23,"fcopy@529-552@usr.sbin/ikectl/ikeca.c","usr.sbin/ikectl/ikeca.c","fcopy",529,552
32,10,263,3,36,"fcopy_env@555-591@usr.sbin/ikectl/ikeca.c","usr.sbin/ikectl/ikeca.c","fcopy_env",555,591
30,10,165,1,32,"rm_dir@594-626@usr.sbin/ikectl/ikeca.c","usr.sbin/ikectl/ikeca.c","rm_dir",594,626
13,5,108,1,13,"ca_hier@629-642@usr.sbin/ikectl/ikeca.c","usr.sbin/ikectl/ikeca.c","ca_hier",629,642
138,30,1180,4,164,"ca_export@645-809@usr.sbin/ikectl/ikeca.c","usr.sbin/ikectl/ikeca.c","ca_export",645,809
31,10,250,1,33,"ca_create_index@813-846@usr.sbin/ikectl/ikeca.c","usr.sbin/ikectl/ikeca.c","ca_create_index",813,846
41,5,229,2,47,"ca_revoke@849-896@usr.sbin/ikectl/ikeca.c","usr.sbin/ikectl/ikeca.c","ca_revoke",849,896
8,2,51,1,7,"ca_clrenv@899-906@usr.sbin/ikectl/ikeca.c","usr.sbin/ikectl/ikeca.c","ca_clrenv",899,906
17,5,127,2,17,"ca_setenv@909-926@usr.sbin/ikectl/ikeca.c","usr.sbin/ikectl/ikeca.c","ca_setenv",909,926
18,2,125,2,20,"ca_setcnf@929-949@usr.sbin/ikectl/ikeca.c","usr.sbin/ikectl/ikeca.c","ca_setcnf",929,949
30,13,314,4,37,"ca_setup@952-989@usr.sbin/ikectl/ikeca.c","usr.sbin/ikectl/ikeca.c","ca_setup",952,989
7,1,25,1,7,"usage@69-76@usr.sbin/ikectl/ikectl.c","usr.sbin/ikectl/ikectl.c","usage",69,76
68,23,396,1,72,"ca_opt@79-151@usr.sbin/ikectl/ikectl.c","usr.sbin/ikectl/ikectl.c","ca_opt",79,151
177,66,943,2,197,"main@154-351@usr.sbin/ikectl/ikectl.c","usr.sbin/ikectl/ikectl.c","main",154,351
8,3,54,1,8,"monitor_lookup@354-362@usr.sbin/ikectl/ikectl.c","usr.sbin/ikectl/ikectl.c","monitor_lookup",354,362
16,3,126,1,18,"monitor@365-383@usr.sbin/ikectl/ikectl.c","usr.sbin/ikectl/ikectl.c","monitor",365,383
23,6,142,2,29,"parse@235-264@usr.sbin/ikectl/parser.c","usr.sbin/ikectl/parser.c","parse",235,264
12,2,74,1,13,"parse_addr@267-280@usr.sbin/ikectl/parser.c","usr.sbin/ikectl/parser.c","parse_addr",267,280
77,36,463,2,79,"match_token@284-363@usr.sbin/ikectl/parser.c","usr.sbin/ikectl/parser.c","match_token",284,363
34,11,153,1,34,"show_valid_args@366-400@usr.sbin/ikectl/parser.c","usr.sbin/ikectl/parser.c","show_valid_args",366,400
78,17,453,2,94,"main@296-390@usr.sbin/inetd/inetd.c","usr.sbin/inetd/inetd.c","main",296,390
35,13,239,3,41,"gettcp@393-434@usr.sbin/inetd/inetd.c","usr.sbin/inetd/inetd.c","gettcp",393,434
35,14,215,1,44,"dg_badinput@437-481@usr.sbin/inetd/inetd.c","usr.sbin/inetd/inetd.c","dg_badinput",437,481
19,6,120,1,19,"dg_broadcast@484-503@usr.sbin/inetd/inetd.c","usr.sbin/inetd/inetd.c","dg_broadcast",484,503
34,13,207,3,35,"reap@506-541@usr.sbin/inetd/inetd.c","usr.sbin/inetd/inetd.c","reap",506,541
198,48,1243,3,221,"config@544-765@usr.sbin/inetd/inetd.c","usr.sbin/inetd/inetd.c","config",544,765
18,8,93,3,18,"retry@768-786@usr.sbin/inetd/inetd.c","usr.sbin/inetd/inetd.c","retry",768,786
20,8,110,3,21,"die@789-810@usr.sbin/inetd/inetd.c","usr.sbin/inetd/inetd.c","die",789,810
67,21,470,1,83,"setup@813-896@usr.sbin/inetd/inetd.c","usr.sbin/inetd/inetd.c","setup",813,896
29,6,213,1,30,"register_rpc@899-929@usr.sbin/inetd/inetd.c","usr.sbin/inetd/inetd.c","register_rpc",899,929
12,4,73,1,12,"unregister_rpc@932-944@usr.sbin/inetd/inetd.c","usr.sbin/inetd/inetd.c","unregister_rpc",932,944
15,2,80,1,15,"enter@948-963@usr.sbin/inetd/inetd.c","usr.sbin/inetd/inetd.c","enter",948,963
24,13,204,2,35,"matchconf@966-1001@usr.sbin/inetd/inetd.c","usr.sbin/inetd/inetd.c","matchconf",966,1001
11,2,56,1,10,"setconfig@1012-1022@usr.sbin/inetd/inetd.c","usr.sbin/inetd/inetd.c","setconfig",1012,1022
11,3,39,1,10,"endconfig@1025-1035@usr.sbin/inetd/inetd.c","usr.sbin/inetd/inetd.c","endconfig",1025,1035
206,61,1437,1,242,"getconfigent@1038-1280@usr.sbin/inetd/inetd.c","usr.sbin/inetd/inetd.c","getconfigent",1038,1280
20,2,124,1,20,"freeconfig@1283-1303@usr.sbin/inetd/inetd.c","usr.sbin/inetd/inetd.c","freeconfig",1283,1303
32,14,181,2,35,"skip@1306-1341@usr.sbin/inetd/inetd.c","usr.sbin/inetd/inetd.c","skip",1306,1341
7,2,46,1,6,"nextline@1344-1350@usr.sbin/inetd/inetd.c","usr.sbin/inetd/inetd.c","nextline",1344,1350
7,3,40,1,6,"newstr@1353-1359@usr.sbin/inetd/inetd.c","usr.sbin/inetd/inetd.c","newstr",1353,1359
27,9,243,1,31,"dupconfig@1362-1393@usr.sbin/inetd/inetd.c","usr.sbin/inetd/inetd.c","dupconfig",1362,1393
15,3,108,2,15,"inetd_setproctitle@1396-1411@usr.sbin/inetd/inetd.c","usr.sbin/inetd/inetd.c","inetd_setproctitle",1396,1411
22,4,129,1,26,"bump_nofile@1414-1440@usr.sbin/inetd/inetd.c","usr.sbin/inetd/inetd.c","bump_nofile",1414,1440
10,3,67,2,10,"echo_stream@1448-1458@usr.sbin/inetd/inetd.c","usr.sbin/inetd/inetd.c","echo_stream",1448,1458
14,3,109,2,14,"echo_dg@1461-1475@usr.sbin/inetd/inetd.c","usr.sbin/inetd/inetd.c","echo_dg",1461,1475
9,3,59,2,9,"discard_stream@1478-1487@usr.sbin/inetd/inetd.c","usr.sbin/inetd/inetd.c","discard_stream",1478,1487
5,1,33,2,5,"discard_dg@1490-1495@usr.sbin/inetd/inetd.c","usr.sbin/inetd/inetd.c","discard_dg",1490,1495
8,3,44,1,9,"initring@1503-1512@usr.sbin/inetd/inetd.c","usr.sbin/inetd/inetd.c","initring",1503,1512
26,6,160,2,28,"chargen_stream@1515-1543@usr.sbin/inetd/inetd.c","usr.sbin/inetd/inetd.c","chargen_stream",1515,1543
29,6,204,2,31,"chargen_dg@1546-1577@usr.sbin/inetd/inetd.c","usr.sbin/inetd/inetd.c","chargen_dg",1546,1577
7,2,42,1,8,"machtime@1587-1595@usr.sbin/inetd/inetd.c","usr.sbin/inetd/inetd.c","machtime",1587,1595
6,1,37,2,6,"machtime_stream@1598-1604@usr.sbin/inetd/inetd.c","usr.sbin/inetd/inetd.c","machtime_stream",1598,1604
15,3,110,2,15,"machtime_dg@1607-1622@usr.sbin/inetd/inetd.c","usr.sbin/inetd/inetd.c","machtime_dg",1607,1622
8,1,62,2,9,"daytime_stream@1626-1635@usr.sbin/inetd/inetd.c","usr.sbin/inetd/inetd.c","daytime_stream",1626,1635
17,3,134,2,18,"daytime_dg@1639-1657@usr.sbin/inetd/inetd.c","usr.sbin/inetd/inetd.c","daytime_dg",1639,1657
19,4,139,2,20,"print_service@1664-1684@usr.sbin/inetd/inetd.c","usr.sbin/inetd/inetd.c","print_service",1664,1684
130,38,798,3,140,"spawn@1687-1827@usr.sbin/inetd/inetd.c","usr.sbin/inetd/inetd.c","spawn",1687,1827
3,1,6,1,2,"md_init@60-62@usr.sbin/installboot/armv7_installboot.c","usr.sbin/installboot/armv7_installboot.c","md_init",60,62
3,1,6,1,2,"md_loadboot@65-67@usr.sbin/installboot/armv7_installboot.c","usr.sbin/installboot/armv7_installboot.c","md_loadboot",65,67
16,5,105,2,20,"md_installboot@70-90@usr.sbin/installboot/armv7_installboot.c","usr.sbin/installboot/armv7_installboot.c","md_installboot",70,90
124,28,825,2,149,"write_efisystem@94-243@usr.sbin/installboot/armv7_installboot.c","usr.sbin/installboot/armv7_installboot.c","write_efisystem",94,243
31,12,235,2,37,"findmbrfat@246-283@usr.sbin/installboot/armv7_installboot.c","usr.sbin/installboot/armv7_installboot.c","findmbrfat",246,283
72,22,507,4,95,"bootstrap@35-130@usr.sbin/installboot/bootstrap.c","usr.sbin/installboot/bootstrap.c","bootstrap",35,130
5,1,14,1,4,"md_init@22-26@usr.sbin/installboot/hppa_installboot.c","usr.sbin/installboot/hppa_installboot.c","md_init",22,26
3,1,6,1,2,"md_loadboot@29-31@usr.sbin/installboot/hppa_installboot.c","usr.sbin/installboot/hppa_installboot.c","md_loadboot",29,31
4,1,22,2,3,"md_installboot@34-37@usr.sbin/installboot/hppa_installboot.c","usr.sbin/installboot/hppa_installboot.c","md_installboot",34,37
7,1,22,1,7,"md_init@102-109@usr.sbin/installboot/i386_installboot.c","usr.sbin/installboot/i386_installboot.c","md_init",102,109
9,4,63,1,12,"md_loadboot@112-124@usr.sbin/installboot/i386_installboot.c","usr.sbin/installboot/i386_installboot.c","md_loadboot",112,124
28,11,199,2,37,"md_installboot@127-164@usr.sbin/installboot/i386_installboot.c","usr.sbin/installboot/i386_installboot.c","md_installboot",127,164
36,11,266,3,50,"write_bootblocks@167-217@usr.sbin/installboot/i386_installboot.c","usr.sbin/installboot/i386_installboot.c","write_bootblocks",167,217
133,31,893,2,155,"write_efisystem@220-375@usr.sbin/installboot/i386_installboot.c","usr.sbin/installboot/i386_installboot.c","write_efisystem",220,375
59,21,394,2,68,"findopenbsd@378-446@usr.sbin/installboot/i386_installboot.c","usr.sbin/installboot/i386_installboot.c","findopenbsd",378,446
23,9,137,2,24,"gpt_chk_mbr@457-481@usr.sbin/installboot/i386_installboot.c","usr.sbin/installboot/i386_installboot.c","gpt_chk_mbr",457,481
79,21,643,2,96,"findgptefisys@484-580@usr.sbin/installboot/i386_installboot.c","usr.sbin/installboot/i386_installboot.c","findgptefisys",484,580
34,9,287,2,57,"loadproto@586-643@usr.sbin/installboot/i386_installboot.c","usr.sbin/installboot/i386_installboot.c","loadproto",586,643
5,2,54,5,4,"devread@646-650@usr.sbin/installboot/i386_installboot.c","usr.sbin/installboot/i386_installboot.c","devread",646,650
90,19,785,3,145,"getbootparams@657-802@usr.sbin/installboot/i386_installboot.c","usr.sbin/installboot/i386_installboot.c","getbootparams",657,802
12,4,82,3,14,"sym_set_value@805-819@usr.sbin/installboot/i386_installboot.c","usr.sbin/installboot/i386_installboot.c","sym_set_value",805,819
48,11,313,3,58,"pbr_set_symbols@826-884@usr.sbin/installboot/i386_installboot.c","usr.sbin/installboot/i386_installboot.c","pbr_set_symbols",826,884
13,7,71,1,28,"__elf_is_okay__@63-91@usr.sbin/installboot/i386_nlist.c","usr.sbin/installboot/i386_nlist.c","__elf_is_okay__",63,91
143,44,934,2,202,"__elf_fdnlist@94-296@usr.sbin/installboot/i386_nlist.c","usr.sbin/installboot/i386_nlist.c","__elf_fdnlist",94,296
10,2,61,2,11,"nlist_elf32@299-310@usr.sbin/installboot/i386_nlist.c","usr.sbin/installboot/i386_nlist.c","nlist_elf32",299,310
51,15,393,3,68,"sr_install_bootblk@43-111@usr.sbin/installboot/i386_softraid.c","usr.sbin/installboot/i386_softraid.c","sr_install_bootblk",43,111
61,10,482,2,85,"sr_install_bootldr@114-199@usr.sbin/installboot/i386_softraid.c","usr.sbin/installboot/i386_softraid.c","sr_install_bootldr",114,199
7,2,35,1,8,"usage@38-46@usr.sbin/installboot/installboot.c","usr.sbin/installboot/installboot.c","usage",38,46
60,24,348,2,74,"main@49-123@usr.sbin/installboot/installboot.c","usr.sbin/installboot/installboot.c","main",49,123
7,1,22,1,7,"md_init@27-34@usr.sbin/installboot/landisk_installboot.c","usr.sbin/installboot/landisk_installboot.c","md_init",27,34
3,1,6,1,2,"md_loadboot@37-39@usr.sbin/installboot/landisk_installboot.c","usr.sbin/installboot/landisk_installboot.c","md_loadboot",37,39
11,4,68,2,14,"md_installboot@42-56@usr.sbin/installboot/landisk_installboot.c","usr.sbin/installboot/landisk_installboot.c","md_installboot",42,56
11,3,79,2,16,"sr_installboot@32-48@usr.sbin/installboot/softraid.c","usr.sbin/installboot/softraid.c","sr_installboot",32,48
26,7,193,4,43,"sr_volume@51-94@usr.sbin/installboot/softraid.c","usr.sbin/installboot/softraid.c","sr_volume",51,94
7,1,22,1,7,"md_init@41-48@usr.sbin/installboot/sparc64_installboot.c","usr.sbin/installboot/sparc64_installboot.c","md_init",41,48
36,11,276,1,39,"md_loadboot@51-90@usr.sbin/installboot/sparc64_installboot.c","usr.sbin/installboot/sparc64_installboot.c","md_loadboot",51,90
17,8,109,2,20,"md_installboot@93-113@usr.sbin/installboot/sparc64_installboot.c","usr.sbin/installboot/sparc64_installboot.c","md_installboot",93,113
31,10,240,3,41,"sr_install_bootblk@37-78@usr.sbin/installboot/sparc64_softraid.c","usr.sbin/installboot/sparc64_softraid.c","sr_install_bootblk",37,78
17,4,111,2,20,"sr_install_bootldr@81-101@usr.sbin/installboot/sparc64_softraid.c","usr.sbin/installboot/sparc64_softraid.c","sr_install_bootldr",81,101
4,1,13,1,3,"md_init@24-27@usr.sbin/installboot/stubs.c","usr.sbin/installboot/stubs.c","md_init",24,27
3,1,6,1,2,"md_loadboot@30-32@usr.sbin/installboot/stubs.c","usr.sbin/installboot/stubs.c","md_loadboot",30,32
3,1,11,2,2,"md_installboot@35-37@usr.sbin/installboot/stubs.c","usr.sbin/installboot/stubs.c","md_installboot",35,37
54,11,335,2,60,"filecopy@36-96@usr.sbin/installboot/util.c","usr.sbin/installboot/util.c","filecopy",36,96
22,5,133,2,23,"fileprefix@99-122@usr.sbin/installboot/util.c","usr.sbin/installboot/util.c","fileprefix",99,122
15,3,99,2,17,"crc32@136-153@usr.sbin/installboot/util.c","usr.sbin/installboot/util.c","crc32",136,153
70,22,346,2,78,"main@114-192@usr.sbin/iostat/iostat.c","usr.sbin/iostat/iostat.c","main",114,192
4,1,11,1,3,"sigheader@196-199@usr.sbin/iostat/iostat.c","usr.sbin/iostat/iostat.c","sigheader",196,199
49,23,326,1,57,"header@202-259@usr.sbin/iostat/iostat.c","usr.sbin/iostat/iostat.c","header",202,259
30,7,271,1,39,"disk_stats@262-301@usr.sbin/iostat/iostat.c","usr.sbin/iostat/iostat.c","disk_stats",262,301
15,3,134,1,21,"disk_stats2@304-325@usr.sbin/iostat/iostat.c","usr.sbin/iostat/iostat.c","disk_stats2",304,325
11,4,77,1,12,"cpustats@328-340@usr.sbin/iostat/iostat.c","usr.sbin/iostat/iostat.c","cpustats",328,340
6,1,18,1,5,"usage@343-348@usr.sbin/iostat/iostat.c","usr.sbin/iostat/iostat.c","usage",343,348
29,9,182,1,40,"display@351-391@usr.sbin/iostat/iostat.c","usr.sbin/iostat/iostat.c","display",351,391
44,18,269,1,56,"selectdrives@394-450@usr.sbin/iostat/iostat.c","usr.sbin/iostat/iostat.c","selectdrives",394,450
7,1,25,1,7,"usage@52-59@usr.sbin/iscsictl/iscsictl.c","usr.sbin/iscsictl/iscsictl.c","usage",52,59
98,26,719,2,118,"main@62-180@usr.sbin/iscsictl/iscsictl.c","usr.sbin/iscsictl/iscsictl.c","main",62,180
4,1,25,2,3,"control_queue@183-186@usr.sbin/iscsictl/iscsictl.c","usr.sbin/iscsictl/iscsictl.c","control_queue",183,186
8,2,46,1,8,"run@189-197@usr.sbin/iscsictl/iscsictl.c","usr.sbin/iscsictl/iscsictl.c","run",189,197
40,14,211,1,42,"run_command@200-242@usr.sbin/iscsictl/iscsictl.c","usr.sbin/iscsictl/iscsictl.c","run_command",200,242
40,9,230,2,45,"ctl_getpdu@245-290@usr.sbin/iscsictl/iscsictl.c","usr.sbin/iscsictl/iscsictl.c","ctl_getpdu",245,290
16,3,121,2,16,"ctl_sendpdu@293-309@usr.sbin/iscsictl/iscsictl.c","usr.sbin/iscsictl/iscsictl.c","ctl_sendpdu",293,309
37,11,251,2,39,"show_config@312-351@usr.sbin/iscsictl/iscsictl.c","usr.sbin/iscsictl/iscsictl.c","show_config",312,351
28,5,215,2,31,"show_vscsi_stats@354-385@usr.sbin/iscsictl/iscsictl.c","usr.sbin/iscsictl/iscsictl.c","show_vscsi_stats",354,385
23,6,142,2,29,"parse@101-130@usr.sbin/iscsictl/parser.c","usr.sbin/iscsictl/parser.c","parse",101,130
62,24,378,2,65,"match_token@133-198@usr.sbin/iscsictl/parser.c","usr.sbin/iscsictl/parser.c","match_token",133,198
23,8,107,1,23,"show_valid_args@201-224@usr.sbin/iscsictl/parser.c","usr.sbin/iscsictl/parser.c","show_valid_args",201,224
17,3,130,2,19,"parse_addr@227-246@usr.sbin/iscsictl/parser.c","usr.sbin/iscsictl/parser.c","parse_addr",227,246
42,6,318,2,51,"conn_new@55-106@usr.sbin/iscsid/connection.c","usr.sbin/iscsid/connection.c","conn_new",55,106
13,2,89,1,16,"conn_free@109-125@usr.sbin/iscsid/connection.c","usr.sbin/iscsid/connection.c","conn_free",109,125
22,7,110,3,23,"conn_dispatch@128-151@usr.sbin/iscsid/connection.c","usr.sbin/iscsid/connection.c","conn_dispatch",128,151
36,8,195,3,39,"conn_write_dispatch@154-193@usr.sbin/iscsid/connection.c","usr.sbin/iscsid/connection.c","conn_write_dispatch",154,193
5,1,21,1,4,"conn_fail@196-200@usr.sbin/iscsid/connection.c","usr.sbin/iscsid/connection.c","conn_fail",196,200
6,3,33,1,5,"conn_task_ready@203-208@usr.sbin/iscsid/connection.c","usr.sbin/iscsid/connection.c","conn_task_ready",203,208
5,1,31,2,4,"conn_task_issue@211-215@usr.sbin/iscsid/connection.c","usr.sbin/iscsid/connection.c","conn_task_issue",211,215
18,4,116,1,21,"conn_task_schedule@218-239@usr.sbin/iscsid/connection.c","usr.sbin/iscsid/connection.c","conn_task_schedule",218,239
12,3,72,2,12,"conn_task_cleanup@242-254@usr.sbin/iscsid/connection.c","usr.sbin/iscsid/connection.c","conn_task_cleanup",242,254
28,3,237,2,31,"conn_parse_kvp@283-314@usr.sbin/iscsid/connection.c","usr.sbin/iscsid/connection.c","conn_parse_kvp",283,314
34,11,228,3,35,"conn_gen_kvp@320-355@usr.sbin/iscsid/connection.c","usr.sbin/iscsid/connection.c","conn_gen_kvp",320,355
19,9,100,2,21,"conn_pdu_write@358-379@usr.sbin/iscsid/connection.c","usr.sbin/iscsid/connection.c","conn_pdu_write",358,379
22,5,169,2,23,"conn_fsm@409-432@usr.sbin/iscsid/connection.c","usr.sbin/iscsid/connection.c","conn_fsm",409,432
33,6,251,2,33,"c_do_connect@435-468@usr.sbin/iscsid/connection.c","usr.sbin/iscsid/connection.c","c_do_connect",435,468
5,1,21,2,5,"c_do_login@471-476@usr.sbin/iscsid/connection.c","usr.sbin/iscsid/connection.c","c_do_login",471,476
6,1,47,2,6,"c_do_loggedin@479-485@usr.sbin/iscsid/connection.c","usr.sbin/iscsid/connection.c","c_do_loggedin",479,485
7,2,28,2,8,"c_do_req_logout@488-496@usr.sbin/iscsid/connection.c","usr.sbin/iscsid/connection.c","c_do_req_logout",488,496
4,1,16,2,4,"c_do_logout@499-503@usr.sbin/iscsid/connection.c","usr.sbin/iscsid/connection.c","c_do_logout",499,503
4,1,16,2,7,"c_do_loggedout@506-513@usr.sbin/iscsid/connection.c","usr.sbin/iscsid/connection.c","c_do_loggedout",506,513
13,3,87,2,19,"c_do_fail@516-535@usr.sbin/iscsid/connection.c","usr.sbin/iscsid/connection.c","c_do_fail",516,535
4,1,16,2,4,"c_do_cleanup@538-542@usr.sbin/iscsid/connection.c","usr.sbin/iscsid/connection.c","c_do_cleanup",538,542
27,10,93,1,28,"conn_state@545-573@usr.sbin/iscsid/connection.c","usr.sbin/iscsid/connection.c","conn_state",545,573
28,11,98,1,29,"conn_event@576-605@usr.sbin/iscsid/connection.c","usr.sbin/iscsid/connection.c","conn_event",576,605
51,9,331,1,59,"control_init@56-115@usr.sbin/iscsid/control.c","usr.sbin/iscsid/control.c","control_init",56,115
9,2,45,1,9,"control_cleanup@118-127@usr.sbin/iscsid/control.c","usr.sbin/iscsid/control.c","control_cleanup",118,127
7,1,46,1,6,"control_event_init@130-136@usr.sbin/iscsid/control.c","usr.sbin/iscsid/control.c","control_event_init",130,136
31,9,217,3,39,"control_accept@140-179@usr.sbin/iscsid/control.c","usr.sbin/iscsid/control.c","control_accept",140,179
11,2,69,1,13,"control_close@182-195@usr.sbin/iscsid/control.c","usr.sbin/iscsid/control.c","control_close",182,195
57,15,372,3,58,"control_dispatch@201-259@usr.sbin/iscsid/control.c","usr.sbin/iscsid/control.c","control_dispatch",201,259
40,9,230,2,45,"control_getpdu@262-307@usr.sbin/iscsid/control.c","usr.sbin/iscsid/control.c","control_getpdu",262,307
8,1,70,2,9,"control_queue@310-319@usr.sbin/iscsid/control.c","usr.sbin/iscsid/control.c","control_queue",310,319
14,2,84,1,17,"initiator_init@66-83@usr.sbin/iscsid/initiator.c","usr.sbin/iscsid/initiator.c","initiator_init",66,83
9,2,54,1,9,"initiator_cleanup@86-95@usr.sbin/iscsid/initiator.c","usr.sbin/iscsid/initiator.c","initiator_cleanup",86,95
7,1,35,1,8,"initiator_shutdown@98-106@usr.sbin/iscsid/initiator.c","usr.sbin/iscsid/initiator.c","initiator_shutdown",98,106
10,3,59,1,10,"initiator_isdown@109-119@usr.sbin/iscsid/initiator.c","usr.sbin/iscsid/initiator.c","initiator_isdown",109,119
9,2,39,1,9,"initiator_t2s@122-131@usr.sbin/iscsid/initiator.c","usr.sbin/iscsid/initiator.c","initiator_t2s",122,131
21,3,136,1,23,"initiator_login@134-157@usr.sbin/iscsid/initiator.c","usr.sbin/iscsid/initiator.c","initiator_login",134,157
21,3,125,1,25,"initiator_discovery@160-185@usr.sbin/iscsid/initiator.c","usr.sbin/iscsid/initiator.c","initiator_discovery",160,185
33,7,216,3,39,"initiator_logout@188-227@usr.sbin/iscsid/initiator.c","usr.sbin/iscsid/initiator.c","initiator_logout",188,227
17,2,118,2,21,"initiator_nop_in_imm@230-251@usr.sbin/iscsid/initiator.c","usr.sbin/iscsid/initiator.c","initiator_nop_in_imm",230,251
37,8,239,2,38,"initiator_login_kvp@254-292@usr.sbin/iscsid/initiator.c","usr.sbin/iscsid/initiator.c","initiator_login_kvp",254,292
44,8,293,2,50,"initiator_login_build@295-345@usr.sbin/iscsid/initiator.c","usr.sbin/iscsid/initiator.c","initiator_login_build",295,345
18,4,124,3,21,"initiator_text_build@348-369@usr.sbin/iscsid/initiator.c","usr.sbin/iscsid/initiator.c","initiator_text_build",348,369
70,13,389,3,80,"initiator_login_cb@372-452@usr.sbin/iscsid/initiator.c","usr.sbin/iscsid/initiator.c","initiator_login_cb",372,452
41,7,255,3,42,"initiator_discovery_cb@455-497@usr.sbin/iscsid/initiator.c","usr.sbin/iscsid/initiator.c","initiator_discovery_cb",455,497
36,6,212,3,40,"initiator_logout_cb@500-540@usr.sbin/iscsid/initiator.c","usr.sbin/iscsid/initiator.c","initiator_logout_cb",500,540
11,4,83,1,11,"default_initiator_name@543-554@usr.sbin/iscsid/initiator.c","usr.sbin/iscsid/initiator.c","default_initiator_name",543,554
72,17,469,2,93,"main@65-158@usr.sbin/iscsid/iscsid.c","usr.sbin/iscsid/iscsid.c","main",65,158
10,4,66,3,12,"shutdown_cb@161-173@usr.sbin/iscsid/iscsid.c","usr.sbin/iscsid/iscsid.c","shutdown_cb",161,173
17,5,82,3,19,"main_sig_handler@176-195@usr.sbin/iscsid/iscsid.c","usr.sbin/iscsid/iscsid.c","main_sig_handler",176,195
7,1,25,1,7,"usage@198-205@usr.sbin/iscsid/iscsid.c","usr.sbin/iscsid/iscsid.c","usage",198,205
97,18,674,2,107,"iscsid_ctrl_dispatch@208-315@usr.sbin/iscsid/iscsid.c","usr.sbin/iscsid/iscsid.c","iscsid_ctrl_dispatch",208,315
16,1,148,3,16,"iscsi_merge_sess_params@327-343@usr.sbin/iscsid/iscsid.c","usr.sbin/iscsid/iscsid.c","iscsi_merge_sess_params",327,343
5,1,27,3,5,"iscsi_merge_conn_params@346-351@usr.sbin/iscsid/iscsid.c","usr.sbin/iscsid/iscsid.c","iscsi_merge_conn_params",346,351
8,2,36,1,10,"log_init@34-44@usr.sbin/iscsid/log.c","usr.sbin/iscsid/log.c","log_init",34,44
4,1,11,1,3,"log_verbose@47-50@usr.sbin/iscsid/log.c","usr.sbin/iscsid/log.c","log_verbose",47,50
7,1,38,3,7,"logit@53-60@usr.sbin/iscsid/log.c","usr.sbin/iscsid/log.c","logit",53,60
15,3,90,3,16,"vlog@63-79@usr.sbin/iscsid/log.c","usr.sbin/iscsid/log.c","vlog",63,79
18,3,111,2,21,"log_warn@82-103@usr.sbin/iscsid/log.c","usr.sbin/iscsid/log.c","log_warn",82,103
7,1,35,2,7,"log_warnx@106-113@usr.sbin/iscsid/log.c","usr.sbin/iscsid/log.c","log_warnx",106,113
7,1,35,2,7,"log_info@116-123@usr.sbin/iscsid/log.c","usr.sbin/iscsid/log.c","log_info",116,123
9,2,41,2,9,"log_debug@126-135@usr.sbin/iscsid/log.c","usr.sbin/iscsid/log.c","log_debug",126,135
19,3,104,2,21,"fatal@138-159@usr.sbin/iscsid/log.c","usr.sbin/iscsid/log.c","fatal",138,159
5,1,20,1,4,"fatalx@162-166@usr.sbin/iscsid/log.c","usr.sbin/iscsid/log.c","fatalx",162,166
30,11,233,2,32,"log_hexdump@37-69@usr.sbin/iscsid/logmsg.c","usr.sbin/iscsid/logmsg.c","log_hexdump",37,69
24,5,249,2,27,"log_pdu@72-99@usr.sbin/iscsid/logmsg.c","usr.sbin/iscsid/logmsg.c","log_pdu",72,99
11,3,64,1,11,"pdu_gethdr@42-53@usr.sbin/iscsid/pdu.c","usr.sbin/iscsid/pdu.c","pdu_gethdr",42,53
29,8,202,2,32,"text_to_pdu@56-88@usr.sbin/iscsid/pdu.c","usr.sbin/iscsid/pdu.c","text_to_pdu",56,88
32,9,206,2,36,"pdu_to_text@91-127@usr.sbin/iscsid/pdu.c","usr.sbin/iscsid/pdu.c","pdu_to_text",91,127
35,10,200,4,42,"text_to_num@147-189@usr.sbin/iscsid/pdu.c","usr.sbin/iscsid/pdu.c","text_to_num",147,189
18,5,87,2,19,"text_to_bool@192-211@usr.sbin/iscsid/pdu.c","usr.sbin/iscsid/pdu.c","text_to_bool",192,211
8,2,41,1,8,"pdu_free_queue@219-227@usr.sbin/iscsid/pdu.c","usr.sbin/iscsid/pdu.c","pdu_free_queue",219,227
26,6,223,1,30,"pdu_read@230-260@usr.sbin/iscsid/pdu.c","usr.sbin/iscsid/pdu.c","pdu_read",230,260
58,17,412,1,61,"pdu_write@263-324@usr.sbin/iscsid/pdu.c","usr.sbin/iscsid/pdu.c","pdu_write",263,324
7,2,26,1,6,"pdu_pending@327-333@usr.sbin/iscsid/pdu.c","usr.sbin/iscsid/pdu.c","pdu_pending",327,333
55,16,394,1,66,"pdu_parse@336-402@usr.sbin/iscsid/pdu.c","usr.sbin/iscsid/pdu.c","pdu_parse",336,402
22,5,170,3,22,"pdu_readbuf_read@405-427@usr.sbin/iscsid/pdu.c","usr.sbin/iscsid/pdu.c","pdu_readbuf_read",405,427
7,2,44,1,6,"pdu_readbuf_len@430-436@usr.sbin/iscsid/pdu.c","usr.sbin/iscsid/pdu.c","pdu_readbuf_len",430,436
13,3,72,2,14,"pdu_readbuf_set@439-453@usr.sbin/iscsid/pdu.c","usr.sbin/iscsid/pdu.c","pdu_readbuf_set",439,453
4,1,16,1,3,"pdu_readbuf_free@456-459@usr.sbin/iscsid/pdu.c","usr.sbin/iscsid/pdu.c","pdu_readbuf_free",456,459
9,2,52,2,9,"session_find@51-60@usr.sbin/iscsid/session.c","usr.sbin/iscsid/session.c","session_find",51,60
20,3,141,2,25,"session_new@63-88@usr.sbin/iscsid/session.c","usr.sbin/iscsid/session.c","session_new",63,88
10,2,66,1,12,"session_cleanup@91-103@usr.sbin/iscsid/session.c","usr.sbin/iscsid/session.c","session_cleanup",91,103
14,3,89,1,18,"session_shutdown@106-124@usr.sbin/iscsid/session.c","usr.sbin/iscsid/session.c","session_shutdown",106,124
19,5,138,2,20,"session_config@127-147@usr.sbin/iscsid/session.c","usr.sbin/iscsid/session.c","session_config",127,147
5,1,31,2,4,"session_task_issue@150-154@usr.sbin/iscsid/session.c","usr.sbin/iscsid/session.c","session_task_issue",150,154
19,4,101,2,23,"session_logout_issue@157-180@usr.sbin/iscsid/session.c","usr.sbin/iscsid/session.c","session_logout_issue",157,180
13,3,75,1,18,"session_schedule@183-201@usr.sbin/iscsid/session.c","usr.sbin/iscsid/session.c","session_schedule",183,201
18,3,133,4,20,"session_fsm@207-227@usr.sbin/iscsid/session.c","usr.sbin/iscsid/session.c","session_fsm",207,227
30,6,210,3,31,"session_fsm_callback@251-282@usr.sbin/iscsid/session.c","usr.sbin/iscsid/session.c","session_fsm_callback",251,282
16,4,106,2,21,"sess_do_start@285-306@usr.sbin/iscsid/session.c","usr.sbin/iscsid/session.c","sess_do_start",285,306
13,3,84,2,15,"sess_do_conn_loggedin@309-324@usr.sbin/iscsid/session.c","usr.sbin/iscsid/session.c","sess_do_conn_loggedin",309,324
30,9,172,2,43,"sess_do_conn_fail@327-370@usr.sbin/iscsid/session.c","usr.sbin/iscsid/session.c","sess_do_conn_fail",327,370
18,5,101,2,20,"sess_do_conn_closed@373-393@usr.sbin/iscsid/session.c","usr.sbin/iscsid/session.c","sess_do_conn_closed",373,393
7,2,43,2,11,"sess_do_stop@396-407@usr.sbin/iscsid/session.c","usr.sbin/iscsid/session.c","sess_do_stop",396,407
7,2,43,2,8,"sess_do_free@410-418@usr.sbin/iscsid/session.c","usr.sbin/iscsid/session.c","sess_do_free",410,418
14,2,92,2,16,"sess_do_reinstatement@424-440@usr.sbin/iscsid/session.c","usr.sbin/iscsid/session.c","sess_do_reinstatement",424,440
17,5,63,1,18,"sess_state@443-461@usr.sbin/iscsid/session.c","usr.sbin/iscsid/session.c","sess_state",443,461
28,11,98,1,29,"sess_event@464-493@usr.sbin/iscsid/session.c","usr.sbin/iscsid/session.c","sess_event",464,493
16,4,130,6,16,"task_init@41-57@usr.sbin/iscsid/task.c","usr.sbin/iscsid/task.c","task_init",41,57
11,3,63,1,11,"taskq_cleanup@60-71@usr.sbin/iscsid/task.c","usr.sbin/iscsid/task.c","taskq_cleanup",60,71
17,7,95,2,19,"task_pdu_add@74-93@usr.sbin/iscsid/task.c","usr.sbin/iscsid/task.c","task_pdu_add",74,93
40,11,212,2,46,"task_pdu_cb@96-142@usr.sbin/iscsid/task.c","usr.sbin/iscsid/task.c","task_pdu_cb",96,142
7,2,35,1,7,"pdu_new@38-45@usr.sbin/iscsid/util.c","usr.sbin/iscsid/util.c","pdu_new",38,45
4,1,16,1,3,"pdu_alloc@48-51@usr.sbin/iscsid/util.c","usr.sbin/iscsid/util.c","pdu_alloc",48,51
7,2,41,2,7,"pdu_dup@54-61@usr.sbin/iscsid/util.c","usr.sbin/iscsid/util.c","pdu_dup",54,61
14,4,106,4,16,"pdu_addbuf@64-80@usr.sbin/iscsid/util.c","usr.sbin/iscsid/util.c","pdu_addbuf",64,80
12,5,74,3,12,"pdu_getbuf@83-95@usr.sbin/iscsid/util.c","usr.sbin/iscsid/util.c","pdu_getbuf",83,95
7,2,43,1,7,"pdu_free@98-105@usr.sbin/iscsid/util.c","usr.sbin/iscsid/util.c","pdu_free",98,105
13,4,71,2,15,"socket_setblockmode@108-123@usr.sbin/iscsid/util.c","usr.sbin/iscsid/util.c","socket_setblockmode",108,123
17,4,132,1,17,"log_sockaddr@126-143@usr.sbin/iscsid/util.c","usr.sbin/iscsid/util.c","log_sockaddr",126,143
4,1,37,4,3,"control_compose@146-149@usr.sbin/iscsid/util.c","usr.sbin/iscsid/util.c","control_compose",146,149
34,9,290,4,39,"control_build@152-191@usr.sbin/iscsid/util.c","usr.sbin/iscsid/util.c","control_build",152,191
7,2,61,1,7,"vscsi_open@56-63@usr.sbin/iscsid/vscsi.c","usr.sbin/iscsid/vscsi.c","vscsi_open",56,63
61,17,494,3,79,"vscsi_dispatch@66-145@usr.sbin/iscsid/vscsi.c","usr.sbin/iscsid/vscsi.c","vscsi_dispatch",66,145
16,4,109,4,17,"vscsi_data@149-166@usr.sbin/iscsid/vscsi.c","usr.sbin/iscsid/vscsi.c","vscsi_data",149,166
17,5,137,4,19,"vscsi_status@169-188@usr.sbin/iscsid/vscsi.c","usr.sbin/iscsid/vscsi.c","vscsi_status",169,188
12,4,79,3,14,"vscsi_event@191-205@usr.sbin/iscsid/vscsi.c","usr.sbin/iscsid/vscsi.c","vscsi_event",191,205
71,13,444,3,75,"vscsi_callback@208-283@usr.sbin/iscsid/vscsi.c","usr.sbin/iscsid/vscsi.c","vscsi_callback",208,283
6,1,33,1,6,"vscsi_fail@286-292@usr.sbin/iscsid/vscsi.c","usr.sbin/iscsid/vscsi.c","vscsi_fail",286,292
32,7,264,5,39,"vscsi_dataout@295-334@usr.sbin/iscsid/vscsi.c","usr.sbin/iscsid/vscsi.c","vscsi_dataout",295,334
4,1,12,1,3,"vscsi_stats@337-340@usr.sbin/iscsid/vscsi.c","usr.sbin/iscsid/vscsi.c","vscsi_stats",337,340
59,15,277,2,73,"main@76-149@usr.sbin/kgmon/kgmon.c","usr.sbin/kgmon/kgmon.c","main",76,149
20,7,125,4,20,"kgmon@152-172@usr.sbin/kgmon/kgmon.c","usr.sbin/kgmon/kgmon.c","kgmon",152,172
39,19,308,4,39,"openfiles@178-217@usr.sbin/kgmon/kgmon.c","usr.sbin/kgmon/kgmon.c","openfiles",178,217
14,6,92,1,14,"kern_readonly@223-237@usr.sbin/kgmon/kgmon.c","usr.sbin/kgmon/kgmon.c","kern_readonly",223,237
21,5,157,2,21,"getprof@243-264@usr.sbin/kgmon/kgmon.c","usr.sbin/kgmon/kgmon.c","getprof",243,264
24,7,185,3,24,"setprof@270-294@usr.sbin/kgmon/kgmon.c","usr.sbin/kgmon/kgmon.c","setprof",270,294
101,23,871,2,114,"dumpstate@300-414@usr.sbin/kgmon/kgmon.c","usr.sbin/kgmon/kgmon.c","dumpstate",300,414
20,4,134,1,20,"getprofhz@420-440@usr.sbin/kgmon/kgmon.c","usr.sbin/kgmon/kgmon.c","getprofhz",420,440
40,11,388,2,41,"reset@446-487@usr.sbin/kgmon/kgmon.c","usr.sbin/kgmon/kgmon.c","reset",446,487
12,2,69,1,13,"getncpu@490-503@usr.sbin/kgmon/kgmon.c","usr.sbin/kgmon/kgmon.c","getncpu",490,503
68,20,511,2,78,"main@64-142@usr.sbin/kvm_mkdb/kvm_mkdb.c","usr.sbin/kvm_mkdb/kvm_mkdb.c","main",64,142
53,14,372,6,60,"kvm_mkdb@145-205@usr.sbin/kvm_mkdb/kvm_mkdb.c","usr.sbin/kvm_mkdb/kvm_mkdb.c","kvm_mkdb",145,205
5,1,21,1,4,"usage@208-212@usr.sbin/kvm_mkdb/kvm_mkdb.c","usr.sbin/kvm_mkdb/kvm_mkdb.c","usage",208,212
193,48,1266,3,239,"__elf_knlist@65-304@usr.sbin/kvm_mkdb/nlist.c","usr.sbin/kvm_mkdb/nlist.c","__elf_knlist",65,304
15,3,85,3,19,"create_knlist@307-326@usr.sbin/kvm_mkdb/nlist.c","usr.sbin/kvm_mkdb/nlist.c","create_knlist",307,326
26,7,200,1,32,"testdb@48-80@usr.sbin/kvm_mkdb/testdb.c","usr.sbin/kvm_mkdb/testdb.c","testdb",48,80
9,1,26,1,9,"usage@68-77@usr.sbin/ldapctl/ldapctl.c","usr.sbin/ldapctl/ldapctl.c","usage",68,77
15,6,93,1,17,"compact_db@80-97@usr.sbin/ldapctl/ldapctl.c","usr.sbin/ldapctl/ldapctl.c","compact_db",80,97
21,5,129,2,23,"compact_namespace@100-123@usr.sbin/ldapctl/ldapctl.c","usr.sbin/ldapctl/ldapctl.c","compact_namespace",100,123
11,3,57,1,12,"compact_namespaces@126-138@usr.sbin/ldapctl/ldapctl.c","usr.sbin/ldapctl/ldapctl.c","compact_namespaces",126,138
67,17,418,2,78,"index_namespace@141-219@usr.sbin/ldapctl/ldapctl.c","usr.sbin/ldapctl/ldapctl.c","index_namespace",141,219
11,3,57,1,12,"index_namespaces@222-234@usr.sbin/ldapctl/ldapctl.c","usr.sbin/ldapctl/ldapctl.c","index_namespaces",222,234
4,1,20,3,3,"ssl_load_certfile@237-240@usr.sbin/ldapctl/ldapctl.c","usr.sbin/ldapctl/ldapctl.c","ssl_load_certfile",237,240
130,44,794,2,151,"main@243-394@usr.sbin/ldapctl/ldapctl.c","usr.sbin/ldapctl/ldapctl.c","main",243,394
14,1,105,1,15,"show_stats@397-412@usr.sbin/ldapctl/ldapctl.c","usr.sbin/ldapctl/ldapctl.c","show_stats",397,412
16,1,161,2,16,"show_dbstats@417-433@usr.sbin/ldapctl/ldapctl.c","usr.sbin/ldapctl/ldapctl.c","show_dbstats",417,433
8,1,49,1,9,"show_nsstats@436-445@usr.sbin/ldapctl/ldapctl.c","usr.sbin/ldapctl/ldapctl.c","show_nsstats",436,445
15,6,102,2,17,"ldap_get_attribute@30-47@usr.sbin/ldapd/attributes.c","usr.sbin/ldapd/attributes.c","ldap_get_attribute",30,47
12,3,78,2,13,"ldap_find_attribute@50-63@usr.sbin/ldapd/attributes.c","usr.sbin/ldapd/attributes.c","ldap_find_attribute",50,63
12,5,79,2,14,"ldap_find_value@66-80@usr.sbin/ldapd/attributes.c","usr.sbin/ldapd/attributes.c","ldap_find_value",66,80
29,8,167,3,34,"ldap_add_attribute@83-117@usr.sbin/ldapd/attributes.c","usr.sbin/ldapd/attributes.c","ldap_add_attribute",83,117
18,2,104,2,22,"ldap_set_values@120-142@usr.sbin/ldapd/attributes.c","usr.sbin/ldapd/attributes.c","ldap_set_values",120,142
20,4,123,2,25,"ldap_merge_values@145-170@usr.sbin/ldapd/attributes.c","usr.sbin/ldapd/attributes.c","ldap_merge_values",145,170
26,5,137,2,30,"ldap_del_attribute@174-204@usr.sbin/ldapd/attributes.c","usr.sbin/ldapd/attributes.c","ldap_del_attribute",174,204
35,8,214,2,38,"ldap_del_values@207-245@usr.sbin/ldapd/attributes.c","usr.sbin/ldapd/attributes.c","ldap_del_values",207,245
7,1,42,1,7,"ldap_strftime@248-255@usr.sbin/ldapd/attributes.c","usr.sbin/ldapd/attributes.c","ldap_strftime",248,255
4,1,15,1,3,"ldap_now@258-261@usr.sbin/ldapd/attributes.c","usr.sbin/ldapd/attributes.c","ldap_now",258,261
62,27,348,6,67,"aci_matches@35-102@usr.sbin/ldapd/auth.c","usr.sbin/ldapd/auth.c","aci_matches",35,102
46,23,332,5,53,"authorized@107-160@usr.sbin/ldapd/auth.c","usr.sbin/ldapd/auth.c","authorized",107,160
22,4,170,3,25,"send_auth_request@163-188@usr.sbin/ldapd/auth.c","usr.sbin/ldapd/auth.c","send_auth_request",163,188
41,14,368,3,42,"check_password@195-237@usr.sbin/ldapd/auth.c","usr.sbin/ldapd/auth.c","check_password",195,237
33,10,242,3,40,"ldap_auth_sasl@240-280@usr.sbin/ldapd/auth.c","usr.sbin/ldapd/auth.c","ldap_auth_sasl",240,280
71,25,488,3,80,"ldap_auth_simple@283-363@usr.sbin/ldapd/auth.c","usr.sbin/ldapd/auth.c","ldap_auth_simple",283,363
15,2,77,2,16,"ldap_bind_continue@366-382@usr.sbin/ldapd/auth.c","usr.sbin/ldapd/auth.c","ldap_bind_continue",366,382
35,7,191,1,40,"ldap_bind@385-425@usr.sbin/ldapd/auth.c","usr.sbin/ldapd/auth.c","ldap_bind",385,425
9,2,53,1,11,"ber_get_element@62-73@usr.sbin/ldapd/ber.c","usr.sbin/ldapd/ber.c","ber_get_element",62,73
7,2,42,3,6,"ber_set_header@76-82@usr.sbin/ldapd/ber.c","usr.sbin/ldapd/ber.c","ber_set_header",76,82
11,5,57,2,10,"ber_link_elements@85-95@usr.sbin/ldapd/ber.c","usr.sbin/ldapd/ber.c","ber_link_elements",85,95
14,4,70,1,15,"ber_unlink_elements@98-113@usr.sbin/ldapd/ber.c","usr.sbin/ldapd/ber.c","ber_unlink_elements",98,113
9,1,55,2,11,"ber_replace_elements@116-127@usr.sbin/ldapd/ber.c","usr.sbin/ldapd/ber.c","ber_replace_elements",116,127
8,2,40,1,10,"ber_add_sequence@130-140@usr.sbin/ldapd/ber.c","usr.sbin/ldapd/ber.c","ber_add_sequence",130,140
8,2,40,1,10,"ber_add_set@143-153@usr.sbin/ldapd/ber.c","usr.sbin/ldapd/ber.c","ber_add_set",143,153
22,9,150,2,26,"ber_add_enumerated@156-182@usr.sbin/ldapd/ber.c","usr.sbin/ldapd/ber.c","ber_add_enumerated",156,182
22,9,150,2,26,"ber_add_integer@185-211@usr.sbin/ldapd/ber.c","usr.sbin/ldapd/ber.c","ber_add_integer",185,211
7,2,36,2,7,"ber_get_integer@214-221@usr.sbin/ldapd/ber.c","usr.sbin/ldapd/ber.c","ber_get_integer",214,221
7,2,36,2,7,"ber_get_enumerated@224-231@usr.sbin/ldapd/ber.c","usr.sbin/ldapd/ber.c","ber_get_enumerated",224,231
10,3,59,2,13,"ber_add_boolean@235-248@usr.sbin/ldapd/ber.c","usr.sbin/ldapd/ber.c","ber_add_boolean",235,248
7,2,40,2,7,"ber_get_boolean@251-258@usr.sbin/ldapd/ber.c","usr.sbin/ldapd/ber.c","ber_get_boolean",251,258
4,1,27,2,3,"ber_add_string@261-264@usr.sbin/ldapd/ber.c","usr.sbin/ldapd/ber.c","ber_add_string",261,264
17,3,106,3,20,"ber_add_nstring@267-287@usr.sbin/ldapd/ber.c","usr.sbin/ldapd/ber.c","ber_add_nstring",267,287
7,2,35,2,7,"ber_get_string@290-297@usr.sbin/ldapd/ber.c","usr.sbin/ldapd/ber.c","ber_get_string",290,297
8,2,46,3,8,"ber_get_nstring@300-308@usr.sbin/ldapd/ber.c","usr.sbin/ldapd/ber.c","ber_get_nstring",300,308
17,3,104,3,20,"ber_add_bitstring@311-331@usr.sbin/ldapd/ber.c","usr.sbin/ldapd/ber.c","ber_add_bitstring",311,331
8,2,46,3,8,"ber_get_bitstring@334-342@usr.sbin/ldapd/ber.c","usr.sbin/ldapd/ber.c","ber_get_bitstring",334,342
8,2,40,1,10,"ber_add_null@345-355@usr.sbin/ldapd/ber.c","usr.sbin/ldapd/ber.c","ber_add_null",345,355
6,2,24,1,6,"ber_get_null@358-364@usr.sbin/ldapd/ber.c","usr.sbin/ldapd/ber.c","ber_get_null",358,364
8,2,40,1,10,"ber_add_eoc@367-377@usr.sbin/ldapd/ber.c","usr.sbin/ldapd/ber.c","ber_add_eoc",367,377
6,2,24,1,6,"ber_get_eoc@380-386@usr.sbin/ldapd/ber.c","usr.sbin/ldapd/ber.c","ber_get_eoc",380,386
22,10,187,3,24,"ber_oid2ber@389-413@usr.sbin/ldapd/ber.c","usr.sbin/ldapd/ber.c","ber_oid2ber",389,413
16,6,151,2,19,"ber_string2oid@416-435@usr.sbin/ldapd/ber.c","usr.sbin/ldapd/ber.c","ber_string2oid",416,435
22,5,140,2,29,"ber_add_oid@438-467@usr.sbin/ldapd/ber.c","usr.sbin/ldapd/ber.c","ber_add_oid",438,467
9,2,69,3,10,"ber_add_noid@470-480@usr.sbin/ldapd/ber.c","usr.sbin/ldapd/ber.c","ber_add_noid",470,480
7,2,47,2,8,"ber_add_oidstring@483-491@usr.sbin/ldapd/ber.c","usr.sbin/ldapd/ber.c","ber_add_oidstring",483,491
22,6,182,2,26,"ber_get_oid@494-520@usr.sbin/ldapd/ber.c","usr.sbin/ldapd/ber.c","ber_get_oid",494,520
101,32,583,3,102,"ber_printf_elements@523-625@usr.sbin/ldapd/ber.c","usr.sbin/ldapd/ber.c","ber_printf_elements",523,625
115,34,626,3,120,"ber_scanf_elements@628-748@usr.sbin/ldapd/ber.c","usr.sbin/ldapd/ber.c","ber_scanf_elements",628,748
21,7,155,2,29,"ber_write_elements@762-791@usr.sbin/ldapd/ber.c","usr.sbin/ldapd/ber.c","ber_write_elements",762,791
15,5,83,2,19,"ber_read_elements@807-826@usr.sbin/ldapd/ber.c","usr.sbin/ldapd/ber.c","ber_read_elements",807,826
11,8,74,1,10,"ber_free_element@829-839@usr.sbin/ldapd/ber.c","usr.sbin/ldapd/ber.c","ber_free_element",829,839
13,9,87,1,12,"ber_free_elements@842-854@usr.sbin/ldapd/ber.c","usr.sbin/ldapd/ber.c","ber_free_elements",842,854
20,11,151,1,28,"ber_calc_len@857-885@usr.sbin/ldapd/ber.c","usr.sbin/ldapd/ber.c","ber_calc_len",857,885
35,15,192,2,37,"ber_dump_element@892-929@usr.sbin/ldapd/ber.c","usr.sbin/ldapd/ber.c","ber_dump_element",892,929
35,12,266,2,45,"ber_dump_header@932-977@usr.sbin/ldapd/ber.c","usr.sbin/ldapd/ber.c","ber_dump_header",932,977
6,2,36,2,5,"ber_putc@980-985@usr.sbin/ldapd/ber.c","usr.sbin/ldapd/ber.c","ber_putc",980,985
6,2,45,3,5,"ber_write@988-993@usr.sbin/ldapd/ber.c","usr.sbin/ldapd/ber.c","ber_write",988,993
26,6,173,4,31,"get_id@999-1030@usr.sbin/ldapd/ber.c","usr.sbin/ldapd/ber.c","get_id",999,1030
32,8,174,2,40,"get_len@1036-1076@usr.sbin/ldapd/ber.c","usr.sbin/ldapd/ber.c","get_len",1036,1076
97,34,605,2,112,"ber_read_element@1079-1191@usr.sbin/ldapd/ber.c","usr.sbin/ldapd/ber.c","ber_read_element",1079,1191
16,3,93,3,19,"ber_readbuf@1194-1213@usr.sbin/ldapd/ber.c","usr.sbin/ldapd/ber.c","ber_readbuf",1194,1213
5,1,38,3,4,"ber_set_readbuf@1216-1220@usr.sbin/ldapd/ber.c","usr.sbin/ldapd/ber.c","ber_set_readbuf",1216,1220
7,2,43,2,6,"ber_get_writebuf@1223-1229@usr.sbin/ldapd/ber.c","usr.sbin/ldapd/ber.c","ber_get_writebuf",1223,1229
4,1,27,2,3,"ber_set_application@1232-1235@usr.sbin/ldapd/ber.c","usr.sbin/ldapd/ber.c","ber_set_application",1232,1235
4,1,16,1,3,"ber_free@1238-1241@usr.sbin/ldapd/ber.c","usr.sbin/ldapd/ber.c","ber_free",1238,1241
9,2,53,2,13,"ber_getc@1244-1257@usr.sbin/ldapd/ber.c","usr.sbin/ldapd/ber.c","ber_getc",1244,1257
21,7,132,3,27,"ber_read@1260-1287@usr.sbin/ldapd/ber.c","usr.sbin/ldapd/ber.c","ber_read",1260,1287
94,25,715,2,102,"main@30-132@usr.sbin/ldapd/btest.c","usr.sbin/ldapd/btest.c","main",30,132
12,5,80,4,11,"memncmp@316-327@usr.sbin/ldapd/btree.c","usr.sbin/ldapd/btree.c","memncmp",316,327
20,10,149,4,23,"memnrcmp@330-353@usr.sbin/ldapd/btree.c","usr.sbin/ldapd/btree.c","memnrcmp",330,353
4,1,31,3,3,"btree_cmp@356-359@usr.sbin/ldapd/btree.c","usr.sbin/ldapd/btree.c","btree_cmp",356,359
38,10,251,4,43,"common_prefix@362-405@usr.sbin/ldapd/btree.c","usr.sbin/ldapd/btree.c","common_prefix",362,405
11,4,94,3,11,"remove_prefix@408-419@usr.sbin/ldapd/btree.c","usr.sbin/ldapd/btree.c","remove_prefix",408,419
9,1,82,4,9,"expand_prefix@422-431@usr.sbin/ldapd/btree.c","usr.sbin/ldapd/btree.c","expand_prefix",422,431
10,2,94,4,9,"bt_cmp@434-443@usr.sbin/ldapd/btree.c","usr.sbin/ldapd/btree.c","bt_cmp",434,443
10,4,54,1,9,"btval_reset@446-455@usr.sbin/ldapd/btree.c","usr.sbin/ldapd/btree.c","btval_reset",446,455
8,3,44,2,7,"mpage_cmp@458-465@usr.sbin/ldapd/btree.c","usr.sbin/ldapd/btree.c","mpage_cmp",458,465
12,2,77,2,13,"mpage_lookup@468-481@usr.sbin/ldapd/btree.c","usr.sbin/ldapd/btree.c","mpage_lookup",468,481
6,1,48,2,5,"mpage_add@484-489@usr.sbin/ldapd/btree.c","usr.sbin/ldapd/btree.c","mpage_add",484,489
7,2,29,1,6,"mpage_free@492-498@usr.sbin/ldapd/btree.c","usr.sbin/ldapd/btree.c","mpage_free",492,498
7,1,59,2,6,"mpage_del@501-507@usr.sbin/ldapd/btree.c","usr.sbin/ldapd/btree.c","mpage_del",501,507
8,2,45,1,8,"mpage_flush@510-518@usr.sbin/ldapd/btree.c","usr.sbin/ldapd/btree.c","mpage_flush",510,518
16,3,134,2,17,"mpage_copy@521-538@usr.sbin/ldapd/btree.c","usr.sbin/ldapd/btree.c","mpage_copy",521,538
13,5,88,1,13,"mpage_prune@545-558@usr.sbin/ldapd/btree.c","usr.sbin/ldapd/btree.c","mpage_prune",545,558
9,2,58,2,9,"mpage_dirty@563-572@usr.sbin/ldapd/btree.c","usr.sbin/ldapd/btree.c","mpage_dirty",563,572
22,5,157,2,25,"mpage_touch@577-602@usr.sbin/ldapd/btree.c","usr.sbin/ldapd/btree.c","mpage_touch",577,602
23,5,165,3,26,"btree_read_page@605-631@usr.sbin/ldapd/btree.c","usr.sbin/ldapd/btree.c","btree_read_page",605,631
6,2,32,1,5,"btree_sync@634-639@usr.sbin/ldapd/btree.c","usr.sbin/ldapd/btree.c","btree_sync",634,639
41,8,251,2,48,"btree_txn_begin@642-690@usr.sbin/ldapd/btree.c","usr.sbin/ldapd/btree.c","btree_txn_begin",642,690
27,5,176,1,33,"btree_txn_abort@693-726@usr.sbin/ldapd/btree.c","usr.sbin/ldapd/btree.c","btree_txn_abort",693,726
87,17,510,1,105,"btree_txn_commit@729-834@usr.sbin/ldapd/btree.c","usr.sbin/ldapd/btree.c","btree_txn_commit",729,834
30,5,193,2,38,"btree_write_header@837-875@usr.sbin/ldapd/btree.c","usr.sbin/ldapd/btree.c","btree_write_header",837,875
37,7,219,1,46,"btree_read_header@878-924@usr.sbin/ldapd/btree.c","usr.sbin/ldapd/btree.c","btree_read_header",878,924
32,5,271,3,40,"btree_write_meta@927-967@usr.sbin/ldapd/btree.c","usr.sbin/ldapd/btree.c","btree_write_meta",927,967
23,5,142,1,26,"btree_is_meta_page@972-998@usr.sbin/ldapd/btree.c","usr.sbin/ldapd/btree.c","btree_is_meta_page",972,998
67,15,368,2,79,"btree_read_meta@1001-1080@usr.sbin/ldapd/btree.c","usr.sbin/ldapd/btree.c","btree_read_meta",1001,1080
47,8,370,2,55,"btree_open_fd@1083-1138@usr.sbin/ldapd/btree.c","usr.sbin/ldapd/btree.c","btree_open_fd",1083,1138
18,4,111,3,21,"btree_open@1141-1162@usr.sbin/ldapd/btree.c","usr.sbin/ldapd/btree.c","btree_open",1141,1162
5,1,25,1,4,"btree_ref@1165-1169@usr.sbin/ldapd/btree.c","usr.sbin/ldapd/btree.c","btree_ref",1165,1169
15,3,85,1,15,"btree_close@1172-1187@usr.sbin/ldapd/btree.c","usr.sbin/ldapd/btree.c","btree_close",1172,1187
50,12,360,5,60,"btree_search_node@1197-1257@usr.sbin/ldapd/btree.c","usr.sbin/ldapd/btree.c","btree_search_node",1197,1257
9,1,51,1,11,"cursor_pop_page@1260-1271@usr.sbin/ldapd/btree.c","usr.sbin/ldapd/btree.c","cursor_pop_page",1260,1271
11,2,73,2,12,"cursor_push_page@1274-1286@usr.sbin/ldapd/btree.c","usr.sbin/ldapd/btree.c","cursor_push_page",1274,1286
21,5,134,2,22,"btree_get_mpage@1289-1311@usr.sbin/ldapd/btree.c","usr.sbin/ldapd/btree.c","btree_get_mpage",1289,1311
13,2,104,7,12,"concat_prefix@1314-1326@usr.sbin/ldapd/btree.c","usr.sbin/ldapd/btree.c","concat_prefix",1314,1326
34,9,262,2,38,"find_common_prefix@1329-1367@usr.sbin/ldapd/btree.c","usr.sbin/ldapd/btree.c","find_common_prefix",1329,1367
53,17,391,6,64,"btree_search_page_root@1370-1434@usr.sbin/ldapd/btree.c","usr.sbin/ldapd/btree.c","btree_search_page_root",1370,1434
37,11,249,6,49,"btree_search_page@1443-1492@usr.sbin/ldapd/btree.c","usr.sbin/ldapd/btree.c","btree_search_page",1443,1492
52,10,371,4,57,"btree_read_data@1495-1552@usr.sbin/ldapd/btree.c","usr.sbin/ldapd/btree.c","btree_read_data",1495,1552
36,11,227,4,42,"btree_txn_get@1555-1597@usr.sbin/ldapd/btree.c","usr.sbin/ldapd/btree.c","btree_txn_get",1555,1597
39,9,262,2,44,"btree_sibling@1600-1644@usr.sbin/ldapd/btree.c","usr.sbin/ldapd/btree.c","btree_sibling",1600,1644
24,4,163,4,25,"bt_set_key@1647-1672@usr.sbin/ldapd/btree.c","usr.sbin/ldapd/btree.c","bt_set_key",1647,1672
34,7,236,3,43,"btree_cursor_next@1675-1718@usr.sbin/ldapd/btree.c","usr.sbin/ldapd/btree.c","btree_cursor_next",1675,1718
40,9,285,4,48,"btree_cursor_set@1721-1769@usr.sbin/ldapd/btree.c","usr.sbin/ldapd/btree.c","btree_cursor_set",1721,1769
18,5,137,3,22,"btree_cursor_first@1772-1794@usr.sbin/ldapd/btree.c","usr.sbin/ldapd/btree.c","btree_cursor_first",1772,1794
38,12,217,4,41,"btree_cursor_get@1797-1838@usr.sbin/ldapd/btree.c","usr.sbin/ldapd/btree.c","btree_cursor_get",1797,1838
27,6,207,2,31,"btree_new_page@1841-1872@usr.sbin/ldapd/btree.c","usr.sbin/ldapd/btree.c","btree_new_page",1841,1872
9,2,66,3,11,"bt_leaf_size@1875-1886@usr.sbin/ldapd/btree.c","usr.sbin/ldapd/btree.c","bt_leaf_size",1875,1886
8,2,46,2,12,"bt_branch_size@1889-1901@usr.sbin/ldapd/btree.c","usr.sbin/ldapd/btree.c","bt_branch_size",1889,1901
28,6,187,3,31,"btree_write_overflow_data@1904-1935@usr.sbin/ldapd/btree.c","usr.sbin/ldapd/btree.c","btree_write_overflow_data",1904,1935
75,19,580,7,90,"btree_add_node@1940-2030@usr.sbin/ldapd/btree.c","usr.sbin/ldapd/btree.c","btree_add_node",1940,2030
32,7,261,3,36,"btree_del_node@2033-2069@usr.sbin/ldapd/btree.c","usr.sbin/ldapd/btree.c","btree_del_node",2033,2069
22,7,122,2,25,"btree_txn_cursor_open@2072-2097@usr.sbin/ldapd/btree.c","usr.sbin/ldapd/btree.c","btree_txn_cursor_open",2072,2097
9,3,42,1,9,"btree_cursor_close@2100-2109@usr.sbin/ldapd/btree.c","usr.sbin/ldapd/btree.c","btree_cursor_close",2100,2109
36,6,284,4,42,"btree_update_key@2112-2154@usr.sbin/ldapd/btree.c","usr.sbin/ldapd/btree.c","btree_update_key",2112,2154
37,6,281,3,39,"btree_adjust_prefix@2157-2196@usr.sbin/ldapd/btree.c","usr.sbin/ldapd/btree.c","btree_adjust_prefix",2157,2196
127,29,1044,5,168,"btree_move_node@2201-2369@usr.sbin/ldapd/btree.c","usr.sbin/ldapd/btree.c","btree_move_node",2201,2369
63,12,532,3,89,"btree_merge@2372-2461@usr.sbin/ldapd/btree.c","usr.sbin/ldapd/btree.c","btree_merge",2372,2461
67,14,510,2,96,"btree_rebalance@2466-2562@usr.sbin/ldapd/btree.c","usr.sbin/ldapd/btree.c","btree_rebalance",2466,2562
58,19,367,4,69,"btree_txn_del@2565-2634@usr.sbin/ldapd/btree.c","usr.sbin/ldapd/btree.c","btree_txn_del",2565,2634
35,7,265,3,44,"bt_reduce_separator@2644-2688@usr.sbin/ldapd/btree.c","usr.sbin/ldapd/btree.c","bt_reduce_separator",2644,2688
141,26,1153,6,185,"btree_split@2696-2881@usr.sbin/ldapd/btree.c","usr.sbin/ldapd/btree.c","btree_split",2696,2881
90,23,581,5,107,"btree_txn_put@2884-2991@usr.sbin/ldapd/btree.c","usr.sbin/ldapd/btree.c","btree_txn_put",2884,2991
54,14,408,3,61,"btree_compact_tree@2994-3055@usr.sbin/ldapd/btree.c","usr.sbin/ldapd/btree.c","btree_compact_tree",2994,3055
59,12,372,1,74,"btree_compact@3058-3132@usr.sbin/ldapd/btree.c","usr.sbin/ldapd/btree.c","btree_compact",3058,3132
7,2,55,1,7,"btree_revert@3137-3144@usr.sbin/ldapd/btree.c","usr.sbin/ldapd/btree.c","btree_revert",3137,3144
4,1,21,2,3,"btree_set_cache_size@3147-3150@usr.sbin/ldapd/btree.c","usr.sbin/ldapd/btree.c","btree_set_cache_size",3147,3150
4,1,18,1,3,"btree_get_flags@3153-3156@usr.sbin/ldapd/btree.c","usr.sbin/ldapd/btree.c","btree_get_flags",3153,3156
4,1,14,1,3,"btree_get_path@3159-3162@usr.sbin/ldapd/btree.c","usr.sbin/ldapd/btree.c","btree_get_path",3159,3162
14,2,120,1,15,"btree_stat@3165-3180@usr.sbin/ldapd/btree.c","usr.sbin/ldapd/btree.c","btree_stat",3165,3180
4,1,12,1,3,"ldap_application@36-39@usr.sbin/ldapd/conn.c","usr.sbin/ldapd/conn.c","ldap_application",36,39
6,2,29,1,5,"request_free@42-47@usr.sbin/ldapd/conn.c","usr.sbin/ldapd/conn.c","request_free",42,47
25,4,177,1,35,"conn_close@50-85@usr.sbin/ldapd/conn.c","usr.sbin/ldapd/conn.c","conn_close",50,85
5,1,24,1,4,"conn_disconnect@91-95@usr.sbin/ldapd/conn.c","usr.sbin/ldapd/conn.c","conn_disconnect",91,95
34,6,205,1,40,"request_dispatch@98-138@usr.sbin/ldapd/conn.c","usr.sbin/ldapd/conn.c","request_dispatch",98,138
40,5,266,1,48,"conn_dispatch@141-189@usr.sbin/ldapd/conn.c","usr.sbin/ldapd/conn.c","conn_dispatch",141,189
16,3,106,2,18,"conn_read@192-210@u